"prv_code","city_code","area_code","dept_code","li_code","tbox_no","valid_ticket","agree_ticket","disagree_ticket","invalid_ticket","vote_ticket","votable_population","population","vote_to_votable","agree_to_votable"
"00","000","00","000","0000","0000","10064910","7955753","2109157","715140","10780050","19757067","23580833","54.56","40.27"
"63","000","00","000","0000","0000","1201098","924026","277072","77356","1278454","2228430","2669874","57.37","41.47"
"63","000","00","001","0000","0000","94042","72344","21698","5769","99811","169278","205826","58.96","42.74"
"63","000","00","001","0102","0000","2534","2019","515","163","2697","4660","0","57.88","43.33"
"63","000","00","001","0102","0527","874","702","172","49","923","1583","0","58.31","44.35"
"63","000","00","001","0102","0528","909","712","197","72","981","1691","0","58.01","42.11"
"63","000","00","001","0102","0529","751","605","146","42","793","1386","0","57.22","43.65"
"63","000","00","001","0103","0000","3881","2868","1013","272","4153","6767","0","61.37","42.38"
"63","000","00","001","0103","0530","766","575","191","60","826","1362","0","60.65","42.22"
"63","000","00","001","0103","0531","788","594","194","54","842","1399","0","60.19","42.46"
"63","000","00","001","0103","0532","753","552","201","52","805","1324","0","60.8","41.69"
"63","000","00","001","0103","0533","773","560","213","57","830","1296","0","64.04","43.21"
"63","000","00","001","0103","0534","801","587","214","49","850","1386","0","61.33","42.35"
"63","000","00","001","0104","0000","3304","2520","784","236","3540","5950","0","59.5","42.35"
"63","000","00","001","0104","0535","902","674","228","77","979","1529","0","64.03","44.08"
"63","000","00","001","0104","0536","779","619","160","38","817","1416","0","57.7","43.71"
"63","000","00","001","0104","0537","842","648","194","64","906","1619","0","55.96","40.02"
"63","000","00","001","0104","0538","781","579","202","57","838","1386","0","60.46","41.77"
"63","000","00","001","0105","0000","2374","1833","541","144","2518","4033","0","62.43","45.45"
"63","000","00","001","0105","0539","842","646","196","47","889","1380","0","64.42","46.81"
"63","000","00","001","0105","0540","767","579","188","45","812","1357","0","59.84","42.67"
"63","000","00","001","0105","0541","765","608","157","52","817","1296","0","63.04","46.91"
"63","000","00","001","0106","0000","2481","1918","563","170","2651","4450","0","59.57","43.1"
"63","000","00","001","0106","0542","907","727","180","74","981","1632","0","60.11","44.55"
"63","000","00","001","0106","0543","778","597","181","45","823","1414","0","58.2","42.22"
"63","000","00","001","0106","0544","796","594","202","51","847","1404","0","60.33","42.31"
"63","000","00","001","0107","0000","2407","1831","576","205","2612","4279","0","61.04","42.79"
"63","000","00","001","0107","0545","775","615","160","74","849","1365","0","62.2","45.05"
"63","000","00","001","0107","0546","794","595","199","67","861","1431","0","60.17","41.58"
"63","000","00","001","0107","0547","838","621","217","64","902","1483","0","60.82","41.87"
"63","000","00","001","0108","0000","2263","1779","484","146","2409","4010","0","60.07","44.36"
"63","000","00","001","0108","0548","761","596","165","51","812","1293","0","62.8","46.09"
"63","000","00","001","0108","0549","756","601","155","49","805","1410","0","57.09","42.62"
"63","000","00","001","0108","0550","746","582","164","46","792","1307","0","60.6","44.53"
"63","000","00","001","0109","0000","2176","1630","546","137","2313","3710","0","62.35","43.94"
"63","000","00","001","0109","0551","732","531","201","55","787","1242","0","63.37","42.75"
"63","000","00","001","0109","0552","701","537","164","27","728","1192","0","61.07","45.05"
"63","000","00","001","0109","0553","743","562","181","55","798","1276","0","62.54","44.04"
"63","000","00","001","0110","0000","2096","1574","522","117","2213","3676","0","60.2","42.82"
"63","000","00","001","0110","0554","667","492","175","31","698","1201","0","58.12","40.97"
"63","000","00","001","0110","0555","747","573","174","45","792","1318","0","60.09","43.47"
"63","000","00","001","0110","0556","682","509","173","41","723","1157","0","62.49","43.99"
"63","000","00","001","0111","0000","3459","2627","832","176","3635","6311","0","57.6","41.63"
"63","000","00","001","0111","0557","647","465","182","13","660","1157","0","57.04","40.19"
"63","000","00","001","0111","0558","777","621","156","56","833","1357","0","61.39","45.76"
"63","000","00","001","0111","0559","583","451","132","32","615","1215","0","50.62","37.12"
"63","000","00","001","0111","0560","745","559","186","34","779","1345","0","57.92","41.56"
"63","000","00","001","0111","0561","707","531","176","41","748","1237","0","60.47","42.93"
"63","000","00","001","0112","0000","4982","4034","948","239","5221","8478","0","61.58","47.58"
"63","000","00","001","0112","0562","852","718","134","32","884","1393","0","63.46","51.54"
"63","000","00","001","0112","0563","808","603","205","47","855","1331","0","64.24","45.3"
"63","000","00","001","0112","0564","919","715","204","55","974","1550","0","62.84","46.13"
"63","000","00","001","0112","0565","727","612","115","15","742","1308","0","56.73","46.79"
"63","000","00","001","0112","0566","829","714","115","45","874","1490","0","58.66","47.92"
"63","000","00","001","0112","0567","847","672","175","45","892","1406","0","63.44","47.8"
"63","000","00","001","0113","0000","1347","990","357","78","1425","2286","0","62.34","43.31"
"63","000","00","001","0113","0568","727","537","190","41","768","1191","0","64.48","45.09"
"63","000","00","001","0113","0569","620","453","167","37","657","1095","0","60.0","41.37"
"63","000","00","001","0114","0000","2034","1552","482","136","2170","3688","0","58.84","42.08"
"63","000","00","001","0114","0570","662","494","168","44","706","1198","0","58.93","41.24"
"63","000","00","001","0114","0571","697","545","152","48","745","1265","0","58.89","43.08"
"63","000","00","001","0114","0572","675","513","162","44","719","1225","0","58.69","41.88"
"63","000","00","001","0115","0000","2979","2295","684","169","3148","5271","0","59.72","43.54"
"63","000","00","001","0115","0573","998","752","246","52","1050","1698","0","61.84","44.29"
"63","000","00","001","0115","0574","982","777","205","56","1038","1819","0","57.06","42.72"
"63","000","00","001","0115","0575","999","766","233","61","1060","1754","0","60.43","43.67"
"63","000","00","001","0116","0000","4380","3299","1081","260","4640","7675","0","60.46","42.98"
"63","000","00","001","0116","0576","807","586","221","38","845","1361","0","62.09","43.06"
"63","000","00","001","0116","0577","704","553","151","28","732","1189","0","61.56","46.51"
"63","000","00","001","0116","0578","695","515","180","51","746","1214","0","61.45","42.42"
"63","000","00","001","0116","0579","701","544","157","61","762","1284","0","59.35","42.37"
"63","000","00","001","0116","0580","752","574","178","49","801","1297","0","61.76","44.26"
"63","000","00","001","0116","0581","721","527","194","33","754","1330","0","56.69","39.62"
"63","000","00","001","0117","0000","3220","2567","653","173","3393","5685","0","59.68","45.15"
"63","000","00","001","0117","0582","810","655","155","54","864","1396","0","61.89","46.92"
"63","000","00","001","0117","0583","796","647","149","27","823","1480","0","55.61","43.72"
"63","000","00","001","0117","0584","828","650","178","34","862","1419","0","60.75","45.81"
"63","000","00","001","0117","0585","786","615","171","58","844","1390","0","60.72","44.24"
"63","000","00","001","0118","0000","3114","2321","793","233","3347","7127","0","46.96","32.57"
"63","000","00","001","0118","0588","841","625","216","49","890","2677","0","33.25","23.35"
"63","000","00","001","0118","0589","713","530","183","62","775","1281","0","60.5","41.37"
"63","000","00","001","0118","0590","666","491","175","52","718","1469","0","48.88","33.42"
"63","000","00","001","0118","0591","894","675","219","70","964","1700","0","56.71","39.71"
"63","000","00","001","0119","0000","3968","3039","929","279","4247","7443","0","57.06","40.83"
"63","000","00","001","0119","0592","778","605","173","38","816","1503","0","54.29","40.25"
"63","000","00","001","0119","0593","697","529","168","46","743","1309","0","56.76","40.41"
"63","000","00","001","0119","0594","770","592","178","64","834","1376","0","60.61","43.02"
"63","000","00","001","0119","0595","892","678","214","52","944","1654","0","57.07","40.99"
"63","000","00","001","0119","0596","831","635","196","79","910","1601","0","56.84","39.66"
"63","000","00","001","0120","0000","2774","2214","560","172","2946","4845","0","60.8","45.7"
"63","000","00","001","0120","0597","840","695","145","38","878","1496","0","58.69","46.46"
"63","000","00","001","0120","0598","939","735","204","74","1013","1598","0","63.39","45.99"
"63","000","00","001","0120","0599","995","784","211","60","1055","1751","0","60.25","44.77"
"63","000","00","001","0121","0000","5050","4292","758","257","5307","8544","0","62.11","50.23"
"63","000","00","001","0121","0600","926","771","155","43","969","1557","0","62.24","49.52"
"63","000","00","001","0121","0601","1069","900","169","49","1118","1686","0","66.31","53.38"
"63","000","00","001","0121","0602","1001","874","127","51","1052","1707","0","61.63","51.2"
"63","000","00","001","0121","0603","1124","1038","86","66","1190","1854","0","64.19","55.99"
"63","000","00","001","0121","0604","930","709","221","48","978","1740","0","56.21","40.75"
"63","000","00","001","0122","0000","4138","3160","978","261","4399","7404","0","59.41","42.68"
"63","000","00","001","0122","0605","816","607","209","70","886","1494","0","59.3","40.63"
"63","000","00","001","0122","0606","826","652","174","47","873","1453","0","60.08","44.87"
"63","000","00","001","0122","0607","813","619","194","52","865","1458","0","59.33","42.46"
"63","000","00","001","0122","0608","841","645","196","52","893","1536","0","58.14","41.99"
"63","000","00","001","0122","0609","842","637","205","40","882","1463","0","60.29","43.54"
"63","000","00","001","0124","0000","3679","2705","974","238","3917","7047","0","55.58","38.39"
"63","000","00","001","0124","0610","918","696","222","40","958","1790","0","53.52","38.88"
"63","000","00","001","0124","0611","954","670","284","53","1007","1679","0","59.98","39.9"
"63","000","00","001","0124","0612","868","646","222","74","942","1785","0","52.77","36.19"
"63","000","00","001","0124","0613","939","693","246","71","1010","1793","0","56.33","38.65"
"63","000","00","001","0125","0000","3175","2447","728","207","3382","5573","0","60.69","43.91"
"63","000","00","001","0125","0614","777","585","192","44","821","1381","0","59.45","42.36"
"63","000","00","001","0125","0615","726","570","156","47","773","1279","0","60.44","44.57"
"63","000","00","001","0125","0616","944","717","227","70","1014","1681","0","60.32","42.65"
"63","000","00","001","0125","0617","728","575","153","46","774","1232","0","62.82","46.67"
"63","000","00","001","0126","0000","4234","3154","1080","252","4486","7803","0","57.49","40.42"
"63","000","00","001","0126","0618","826","628","198","59","885","1533","0","57.73","40.97"
"63","000","00","001","0126","0619","890","652","238","55","945","1540","0","61.36","42.34"
"63","000","00","001","0126","0620","908","672","236","48","956","1716","0","55.71","39.16"
"63","000","00","001","0126","0621","873","637","236","51","924","1664","0","55.53","38.28"
"63","000","00","001","0126","0622","737","565","172","39","776","1350","0","57.48","41.85"
"63","000","00","001","0127","0000","1779","1353","426","123","1902","3395","0","56.02","39.85"
"63","000","00","001","0127","0623","999","758","241","47","1046","1837","0","56.94","41.26"
"63","000","00","001","0127","0624","780","595","185","76","856","1558","0","54.94","38.19"
"63","000","00","001","0128","0000","1611","1261","350","101","1712","2894","0","59.16","43.57"
"63","000","00","001","0128","0625","819","637","182","51","870","1420","0","61.27","44.86"
"63","000","00","001","0128","0626","792","624","168","50","842","1474","0","57.12","42.33"
"63","000","00","001","0129","0000","1797","1367","430","111","1908","3317","0","57.52","41.21"
"63","000","00","001","0129","0627","857","640","217","52","909","1591","0","57.13","40.23"
"63","000","00","001","0129","0628","940","727","213","59","999","1726","0","57.88","42.12"
"63","000","00","001","0130","0000","3157","2334","823","187","3344","5792","0","57.73","40.3"
"63","000","00","001","0130","0629","807","604","203","41","848","1452","0","58.4","41.6"
"63","000","00","001","0130","0630","785","579","206","46","831","1482","0","56.07","39.07"
"63","000","00","001","0130","0631","818","598","220","47","865","1460","0","59.25","40.96"
"63","000","00","001","0130","0632","747","553","194","53","800","1398","0","57.22","39.56"
"63","000","00","001","0131","0000","1516","1181","335","66","1582","2649","0","59.72","44.58"
"63","000","00","001","0131","0633","804","618","186","46","850","1423","0","59.73","43.43"
"63","000","00","001","0131","0634","712","563","149","20","732","1226","0","59.71","45.92"
"63","000","00","001","0132","0000","2108","1618","490","110","2218","3761","0","58.97","43.02"
"63","000","00","001","0132","0635","658","516","142","46","704","1158","0","60.79","44.56"
"63","000","00","001","0132","0636","779","591","188","43","822","1426","0","57.64","41.44"
"63","000","00","001","0132","0637","671","511","160","21","692","1177","0","58.79","43.42"
"63","000","00","001","0133","0000","3045","2301","744","199","3244","5355","0","60.58","42.97"
"63","000","00","001","0133","0638","739","542","197","57","796","1363","0","58.4","39.77"
"63","000","00","001","0133","0639","730","557","173","41","771","1240","0","62.18","44.92"
"63","000","00","001","0133","0640","796","609","187","57","853","1375","0","62.04","44.29"
"63","000","00","001","0133","0641","780","593","187","44","824","1377","0","59.84","43.06"
"63","000","00","001","0134","0000","1252","934","318","66","1318","2242","0","58.79","41.66"
"63","000","00","001","0134","0642","644","500","144","28","672","1225","0","54.86","40.82"
"63","000","00","001","0134","0643","608","434","174","38","646","1017","0","63.52","42.67"
"63","000","00","001","0135","0000","1728","1327","401","86","1814","3158","0","57.44","42.02"
"63","000","00","001","0135","0586","866","664","202","47","913","1525","0","59.87","43.54"
"63","000","00","001","0135","0587","862","663","199","39","901","1633","0","55.17","40.6"
"63","000","00","002","0000","0000","103405","80160","23245","6057","109462","190444","223594","57.48","42.09"
"63","000","00","002","0201","0000","2378","1944","434","107","2485","5151","0","48.24","37.74"
"63","000","00","002","0201","0644","765","592","173","30","795","2476","0","32.11","23.91"
"63","000","00","002","0201","0645","850","713","137","21","871","1381","0","63.07","51.63"
"63","000","00","002","0201","0646","763","639","124","56","819","1294","0","63.29","49.38"
"63","000","00","002","0202","0000","2228","1756","472","134","2362","3949","0","59.81","44.47"
"63","000","00","002","0202","0647","754","580","174","43","797","1351","0","58.99","42.93"
"63","000","00","002","0202","0648","723","578","145","40","763","1296","0","58.87","44.6"
"63","000","00","002","0202","0649","751","598","153","51","802","1302","0","61.6","45.93"
"63","000","00","002","0203","0000","1270","983","287","97","1367","2446","0","55.89","40.19"
"63","000","00","002","0203","0650","523","414","109","64","587","1025","0","57.27","40.39"
"63","000","00","002","0203","0651","747","569","178","33","780","1421","0","54.89","40.04"
"63","000","00","002","0204","0000","1579","1222","357","83","1662","3076","0","54.03","39.73"
"63","000","00","002","0204","0652","804","629","175","45","849","1501","0","56.56","41.91"
"63","000","00","002","0204","0653","775","593","182","38","813","1575","0","51.62","37.65"
"63","000","00","002","0205","0000","1618","1280","338","56","1674","2898","0","57.76","44.17"
"63","000","00","002","0205","0654","840","675","165","28","868","1516","0","57.26","44.53"
"63","000","00","002","0205","0655","778","605","173","28","806","1382","0","58.32","43.78"
"63","000","00","002","0206","0000","2835","2261","574","192","3027","5054","0","59.89","44.74"
"63","000","00","002","0206","0656","605","477","128","52","657","1128","0","58.24","42.29"
"63","000","00","002","0206","0657","740","555","185","53","793","1397","0","56.76","39.73"
"63","000","00","002","0206","0658","741","582","159","47","788","1161","0","67.87","50.13"
"63","000","00","002","0206","0659","749","647","102","40","789","1368","0","57.68","47.3"
"63","000","00","002","0207","0000","2637","2039","598","142","2779","4589","0","60.56","44.43"
"63","000","00","002","0207","0660","596","480","116","26","622","1049","0","59.29","45.76"
"63","000","00","002","0207","0661","723","562","161","42","765","1308","0","58.49","42.97"
"63","000","00","002","0207","0662","675","516","159","52","727","1154","0","63.0","44.71"
"63","000","00","002","0207","0663","643","481","162","22","665","1078","0","61.69","44.62"
"63","000","00","002","0208","0000","3771","2907","864","212","3983","6667","0","59.74","43.6"
"63","000","00","002","0208","0664","754","579","175","54","808","1375","0","58.76","42.11"
"63","000","00","002","0208","0665","811","624","187","46","857","1448","0","59.19","43.09"
"63","000","00","002","0208","0666","720","552","168","26","746","1250","0","59.68","44.16"
"63","000","00","002","0208","0667","786","607","179","35","821","1381","0","59.45","43.95"
"63","000","00","002","0208","0668","700","545","155","51","751","1213","0","61.91","44.93"
"63","000","00","002","0209","0000","4855","3741","1114","267","5122","8706","0","58.83","42.97"
"63","000","00","002","0209","0669","810","599","211","43","853","1373","0","62.13","43.63"
"63","000","00","002","0209","0670","709","546","163","43","752","1226","0","61.34","44.54"
"63","000","00","002","0209","0671","627","473","154","25","652","1117","0","58.37","42.35"
"63","000","00","002","0209","0672","654","521","133","45","699","1123","0","62.24","46.39"
"63","000","00","002","0209","0673","683","529","154","44","727","1200","0","60.58","44.08"
"63","000","00","002","0209","0674","677","527","150","33","710","1335","0","53.18","39.48"
"63","000","00","002","0209","0675","695","546","149","34","729","1332","0","54.73","40.99"
"63","000","00","002","0210","0000","1764","1351","413","141","1905","3190","0","59.72","42.35"
"63","000","00","002","0210","0676","957","740","217","70","1027","1648","0","62.32","44.9"
"63","000","00","002","0210","0677","807","611","196","71","878","1542","0","56.94","39.62"
"63","000","00","002","0211","0000","2399","1810","589","163","2562","4362","0","58.73","41.49"
"63","000","00","002","0211","0678","672","504","168","60","732","1228","0","59.61","41.04"
"63","000","00","002","0211","0679","937","681","256","59","996","1731","0","57.54","39.34"
"63","000","00","002","0211","0680","790","625","165","44","834","1403","0","59.44","44.55"
"63","000","00","002","0212","0000","1730","1344","386","136","1866","3229","0","57.79","41.62"
"63","000","00","002","0212","0681","985","766","219","85","1070","1929","0","55.47","39.71"
"63","000","00","002","0212","0682","745","578","167","51","796","1300","0","61.23","44.46"
"63","000","00","002","0213","0000","2259","1726","533","162","2421","4405","0","54.96","39.18"
"63","000","00","002","0213","0683","745","590","155","37","782","1486","0","52.62","39.7"
"63","000","00","002","0213","0684","710","539","171","63","773","1532","0","50.46","35.18"
"63","000","00","002","0213","0685","804","597","207","62","866","1387","0","62.44","43.04"
"63","000","00","002","0214","0000","1763","1354","409","151","1914","3536","0","54.13","38.29"
"63","000","00","002","0214","0686","594","462","132","63","657","1195","0","54.98","38.66"
"63","000","00","002","0214","0687","550","433","117","39","589","1068","0","55.15","40.54"
"63","000","00","002","0214","0688","619","459","160","49","668","1273","0","52.47","36.06"
"63","000","00","002","0215","0000","2086","1619","467","166","2252","3898","0","57.77","41.53"
"63","000","00","002","0215","0689","778","609","169","62","840","1329","0","63.21","45.82"
"63","000","00","002","0215","0690","661","513","148","50","711","1311","0","54.23","39.13"
"63","000","00","002","0215","0691","647","497","150","54","701","1258","0","55.72","39.51"
"63","000","00","002","0216","0000","2846","2149","697","210","3056","5022","0","60.85","42.79"
"63","000","00","002","0216","0692","706","533","173","68","774","1277","0","60.61","41.74"
"63","000","00","002","0216","0693","759","592","167","54","813","1285","0","63.27","46.07"
"63","000","00","002","0216","0694","696","515","181","46","742","1161","0","63.91","44.36"
"63","000","00","002","0216","0695","685","509","176","42","727","1299","0","55.97","39.18"
"63","000","00","002","0217","0000","2659","2024","635","142","2801","4811","0","58.22","42.07"
"63","000","00","002","0217","0696","675","523","152","43","718","1243","0","57.76","42.08"
"63","000","00","002","0217","0697","662","497","165","31","693","1197","0","57.89","41.52"
"63","000","00","002","0217","0698","739","550","189","24","763","1224","0","62.34","44.93"
"63","000","00","002","0217","0699","583","454","129","44","627","1147","0","54.66","39.58"
"63","000","00","002","0218","0000","2449","1903","546","97","2546","4373","0","58.22","43.52"
"63","000","00","002","0218","0700","578","450","128","20","598","1045","0","57.22","43.06"
"63","000","00","002","0218","0701","651","533","118","23","674","1096","0","61.5","48.63"
"63","000","00","002","0218","0702","621","476","145","11","632","1115","0","56.68","42.69"
"63","000","00","002","0218","0703","599","444","155","43","642","1117","0","57.48","39.75"
"63","000","00","002","0219","0000","1983","1591","392","125","2108","3770","0","55.92","42.2"
"63","000","00","002","0219","0704","505","395","110","26","531","1019","0","52.11","38.76"
"63","000","00","002","0219","0705","739","601","138","53","792","1346","0","58.84","44.65"
"63","000","00","002","0219","0706","739","595","144","46","785","1405","0","55.87","42.35"
"63","000","00","002","0220","0000","3731","2902","829","195","3926","6448","0","60.89","45.01"
"63","000","00","002","0220","0707","753","582","171","40","793","1356","0","58.48","42.92"
"63","000","00","002","0220","0708","770","584","186","31","801","1250","0","64.08","46.72"
"63","000","00","002","0220","0709","734","576","158","43","777","1254","0","61.96","45.93"
"63","000","00","002","0220","0710","718","576","142","33","751","1317","0","57.02","43.74"
"63","000","00","002","0220","0711","756","584","172","48","804","1271","0","63.26","45.95"
"63","000","00","002","0221","0000","1051","806","245","72","1123","2004","0","56.04","40.22"
"63","000","00","002","0221","0712","518","393","125","31","549","979","0","56.08","40.14"
"63","000","00","002","0221","0713","533","413","120","41","574","1025","0","56.0","40.29"
"63","000","00","002","0222","0000","3167","2465","702","132","3299","5741","0","57.46","42.94"
"63","000","00","002","0222","0714","718","579","139","32","750","1512","0","49.6","38.29"
"63","000","00","002","0222","0715","853","649","204","37","890","1483","0","60.01","43.76"
"63","000","00","002","0222","0716","792","617","175","40","832","1359","0","61.22","45.4"
"63","000","00","002","0222","0717","804","620","184","23","827","1387","0","59.63","44.7"
"63","000","00","002","0223","0000","2436","1867","569","109","2545","4448","0","57.22","41.97"
"63","000","00","002","0223","0718","757","579","178","29","786","1455","0","54.02","39.79"
"63","000","00","002","0223","0719","812","602","210","31","843","1461","0","57.7","41.2"
"63","000","00","002","0223","0720","867","686","181","49","916","1532","0","59.79","44.78"
"63","000","00","002","0224","0000","2248","1721","527","177","2425","3964","0","61.18","43.42"
"63","000","00","002","0224","0721","627","477","150","42","669","1043","0","64.14","45.73"
"63","000","00","002","0224","0722","508","380","128","45","553","875","0","63.2","43.43"
"63","000","00","002","0224","0723","498","399","99","22","520","927","0","56.09","43.04"
"63","000","00","002","0224","0724","615","465","150","68","683","1119","0","61.04","41.55"
"63","000","00","002","0225","0000","3916","2605","1311","259","4175","7061","0","59.13","36.89"
"63","000","00","002","0225","0725","806","606","200","58","864","1463","0","59.06","41.42"
"63","000","00","002","0225","0726","777","572","205","42","819","1293","0","63.34","44.24"
"63","000","00","002","0225","0727","823","646","177","56","879","1553","0","56.6","41.6"
"63","000","00","002","0225","0728","744","182","562","35","779","1360","0","57.28","13.38"
"63","000","00","002","0225","0729","766","599","167","68","834","1392","0","59.91","43.03"
"63","000","00","002","0226","0000","2941","2261","680","134","3075","5430","0","56.63","41.64"
"63","000","00","002","0226","0730","765","598","167","23","788","1377","0","57.23","43.43"
"63","000","00","002","0226","0731","756","586","170","17","773","1377","0","56.14","42.56"
"63","000","00","002","0226","0732","642","453","189","29","671","1269","0","52.88","35.7"
"63","000","00","002","0226","0733","778","624","154","65","843","1407","0","59.91","44.35"
"63","000","00","002","0227","0000","1993","1547","446","120","2113","3609","0","58.55","42.87"
"63","000","00","002","0227","0734","645","492","153","39","684","1172","0","58.36","41.98"
"63","000","00","002","0227","0735","653","527","126","23","676","1182","0","57.19","44.59"
"63","000","00","002","0227","0736","695","528","167","58","753","1255","0","60.0","42.07"
"63","000","00","002","0228","0000","2292","1807","485","103","2395","4437","0","53.98","40.73"
"63","000","00","002","0228","0737","833","658","175","37","870","1689","0","51.51","38.96"
"63","000","00","002","0228","0738","835","648","187","30","865","1605","0","53.89","40.37"
"63","000","00","002","0228","0739","624","501","123","36","660","1143","0","57.74","43.83"
"63","000","00","002","0229","0000","3137","2482","655","198","3335","5898","0","56.54","42.08"
"63","000","00","002","0229","0740","740","583","157","37","777","1440","0","53.96","40.49"
"63","000","00","002","0229","0741","809","643","166","52","861","1495","0","57.59","43.01"
"63","000","00","002","0229","0742","856","665","191","56","912","1514","0","60.24","43.92"
"63","000","00","002","0229","0743","732","591","141","53","785","1449","0","54.18","40.79"
"63","000","00","002","0230","0000","4380","3484","896","194","4574","7867","0","58.14","44.29"
"63","000","00","002","0230","0744","790","618","172","59","849","1401","0","60.6","44.11"
"63","000","00","002","0230","0745","602","483","119","24","626","1181","0","53.01","40.9"
"63","000","00","002","0230","0746","834","674","160","16","850","1376","0","61.77","48.98"
"63","000","00","002","0230","0747","822","643","179","49","871","1422","0","61.25","45.22"
"63","000","00","002","0230","0748","705","580","125","20","725","1267","0","57.22","45.78"
"63","000","00","002","0230","0749","627","486","141","26","653","1220","0","53.52","39.84"
"63","000","00","002","0231","0000","2366","1875","491","98","2464","4622","0","53.31","40.57"
"63","000","00","002","0231","0750","771","606","165","24","795","1562","0","50.9","38.8"
"63","000","00","002","0231","0751","763","605","158","27","790","1455","0","54.3","41.58"
"63","000","00","002","0231","0752","832","664","168","47","879","1605","0","54.77","41.37"
"63","000","00","002","0232","0000","3286","2650","636","135","3421","6070","0","56.36","43.66"
"63","000","00","002","0232","0753","956","793","163","25","981","1626","0","60.33","48.77"
"63","000","00","002","0232","0754","881","702","179","52","933","1561","0","59.77","44.97"
"63","000","00","002","0232","0755","719","563","156","27","746","1547","0","48.22","36.39"
"63","000","00","002","0232","0756","730","592","138","31","761","1336","0","56.96","44.31"
"63","000","00","002","0233","0000","3569","2805","764","236","3805","6899","0","55.15","40.66"
"63","000","00","002","0233","0757","629","511","118","42","671","1314","0","51.07","38.89"
"63","000","00","002","0233","0758","654","522","132","44","698","1297","0","53.82","40.25"
"63","000","00","002","0233","0759","698","541","157","60","758","1366","0","55.49","39.6"
"63","000","00","002","0233","0760","800","597","203","41","841","1472","0","57.13","40.56"
"63","000","00","002","0233","0761","788","634","154","49","837","1450","0","57.72","43.72"
"63","000","00","002","0234","0000","2285","1749","536","186","2471","4100","0","60.27","42.66"
"63","000","00","002","0234","0762","719","561","158","53","772","1328","0","58.13","42.24"
"63","000","00","002","0234","0763","800","608","192","57","857","1399","0","61.26","43.46"
"63","000","00","002","0234","0764","766","580","186","76","842","1373","0","61.33","42.24"
"63","000","00","002","0235","0000","1893","1520","373","95","1988","3592","0","55.35","42.32"
"63","000","00","002","0235","0765","577","472","105","30","607","1099","0","55.23","42.95"
"63","000","00","002","0235","0766","665","515","150","43","708","1226","0","57.75","42.01"
"63","000","00","002","0235","0767","651","533","118","22","673","1267","0","53.12","42.07"
"63","000","00","002","0236","0000","3448","2689","759","189","3637","6247","0","58.22","43.04"
"63","000","00","002","0236","0768","849","651","198","59","908","1531","0","59.31","42.52"
"63","000","00","002","0236","0769","825","655","170","48","873","1438","0","60.71","45.55"
"63","000","00","002","0236","0770","855","681","174","31","886","1657","0","53.47","41.1"
"63","000","00","002","0236","0771","919","702","217","51","970","1621","0","59.84","43.31"
"63","000","00","002","0237","0000","1628","1233","395","61","1689","2842","0","59.43","43.38"
"63","000","00","002","0237","0772","854","639","215","26","880","1508","0","58.36","42.37"
"63","000","00","002","0237","0773","774","594","180","35","809","1334","0","60.64","44.53"
"63","000","00","002","0238","0000","1953","1505","448","111","2064","3662","0","56.36","41.1"
"63","000","00","002","0238","0774","545","424","121","47","592","1246","0","47.51","34.03"
"63","000","00","002","0238","0775","713","546","167","43","756","1196","0","63.21","45.65"
"63","000","00","002","0238","0776","695","535","160","21","716","1220","0","58.69","43.85"
"63","000","00","002","0239","0000","3236","2540","696","233","3469","6210","0","55.86","40.9"
"63","000","00","002","0239","0777","812","634","178","28","840","1538","0","54.62","41.22"
"63","000","00","002","0239","0778","851","670","181","62","913","1565","0","58.34","42.81"
"63","000","00","002","0239","0779","789","617","172","89","878","1621","0","54.16","38.06"
"63","000","00","002","0239","0780","784","619","165","54","838","1486","0","56.39","41.66"
"63","000","00","002","0240","0000","2365","1881","484","154","2519","4310","0","58.45","43.64"
"63","000","00","002","0240","0781","774","631","143","29","803","1507","0","53.28","41.87"
"63","000","00","002","0240","0782","838","653","185","59","897","1516","0","59.17","43.07"
"63","000","00","002","0240","0783","753","597","156","66","819","1287","0","63.64","46.39"
"63","000","00","002","0241","0000","975","762","213","83","1058","1851","0","57.16","41.17"
"63","000","00","002","0241","0784","514","392","122","47","561","1050","0","53.43","37.33"
"63","000","00","002","0241","0785","461","370","91","36","497","801","0","62.05","46.19"
"63","000","00","003","0000","0000","136975","104681","32294","7388","144363","252645","308835","57.14","41.43"
"63","000","00","003","0301","0000","2613","2008","605","121","2734","4848","0","56.39","41.42"
"63","000","00","003","0301","1214","617","457","160","29","646","1184","0","54.56","38.6"
"63","000","00","003","0301","1215","614","469","145","38","652","1197","0","54.47","39.18"
"63","000","00","003","0301","1216","672","504","168","25","697","1221","0","57.08","41.28"
"63","000","00","003","0301","1217","710","578","132","29","739","1246","0","59.31","46.39"
"63","000","00","003","0302","0000","2484","1848","636","148","2632","4386","0","60.01","42.13"
"63","000","00","003","0302","1218","874","652","222","45","919","1478","0","62.18","44.11"
"63","000","00","003","0302","1219","696","505","191","56","752","1314","0","57.23","38.43"
"63","000","00","003","0302","1220","914","691","223","47","961","1594","0","60.29","43.35"
"63","000","00","003","0303","0000","3305","2496","809","137","3442","5767","0","59.68","43.28"
"63","000","00","003","0303","1221","825","610","215","28","853","1429","0","59.69","42.69"
"63","000","00","003","0303","1222","851","661","190","26","877","1452","0","60.4","45.52"
"63","000","00","003","0303","1223","856","627","229","29","885","1551","0","57.06","40.43"
"63","000","00","003","0303","1224","773","598","175","54","827","1335","0","61.95","44.79"
"63","000","00","003","0304","0000","3598","2712","886","217","3815","6795","0","56.14","39.91"
"63","000","00","003","0304","1225","612","474","138","29","641","1196","0","53.6","39.63"
"63","000","00","003","0304","1226","702","505","197","30","732","1339","0","54.67","37.71"
"63","000","00","003","0304","1227","772","559","213","33","805","1448","0","55.59","38.6"
"63","000","00","003","0304","1228","744","580","164","54","798","1373","0","58.12","42.24"
"63","000","00","003","0304","1229","768","594","174","71","839","1439","0","58.3","41.28"
"63","000","00","003","0305","0000","2212","1669","543","107","2319","4461","0","51.98","37.41"
"63","000","00","003","0305","1230","606","444","162","12","618","1174","0","52.64","37.82"
"63","000","00","003","0305","1231","578","420","158","24","602","1144","0","52.62","36.71"
"63","000","00","003","0305","1232","566","448","118","34","600","1119","0","53.62","40.04"
"63","000","00","003","0305","1233","462","357","105","37","499","1024","0","48.73","34.86"
"63","000","00","003","0306","0000","2904","2279","625","159","3063","5067","0","60.45","44.98"
"63","000","00","003","0306","1234","608","492","116","20","628","1032","0","60.85","47.67"
"63","000","00","003","0306","1235","754","646","108","40","794","1319","0","60.2","48.98"
"63","000","00","003","0306","1236","795","623","172","45","840","1369","0","61.36","45.51"
"63","000","00","003","0306","1237","747","518","229","54","801","1347","0","59.47","38.46"
"63","000","00","003","0307","0000","2980","2173","807","148","3128","5988","0","52.24","36.29"
"63","000","00","003","0307","1238","813","556","257","50","863","1655","0","52.15","33.6"
"63","000","00","003","0307","1239","772","569","203","33","805","1595","0","50.47","35.67"
"63","000","00","003","0307","1240","738","552","186","40","778","1429","0","54.44","38.63"
"63","000","00","003","0307","1241","657","496","161","25","682","1309","0","52.1","37.89"
"63","000","00","003","0308","0000","1469","1051","418","75","1544","2818","0","54.79","37.3"
"63","000","00","003","0308","1242","783","559","224","42","825","1508","0","54.71","37.07"
"63","000","00","003","0308","1243","686","492","194","33","719","1310","0","54.89","37.56"
"63","000","00","003","0309","0000","1807","1326","481","117","1924","3667","0","52.47","36.16"
"63","000","00","003","0309","1244","602","439","163","34","636","1233","0","51.58","35.6"
"63","000","00","003","0309","1245","642","482","160","49","691","1287","0","53.69","37.45"
"63","000","00","003","0309","1246","563","405","158","34","597","1147","0","52.05","35.31"
"63","000","00","003","0310","0000","3305","2490","815","196","3501","6508","0","53.8","38.26"
"63","000","00","003","0310","1247","642","476","166","33","675","1260","0","53.57","37.78"
"63","000","00","003","0310","1248","721","558","163","41","762","1377","0","55.34","40.52"
"63","000","00","003","0310","1249","652","485","167","62","714","1284","0","55.61","37.77"
"63","000","00","003","0310","1250","643","484","159","28","671","1314","0","51.07","36.83"
"63","000","00","003","0310","1251","647","487","160","32","679","1273","0","53.34","38.26"
"63","000","00","003","0311","0000","2774","2097","677","117","2891","4829","0","59.87","43.43"
"63","000","00","003","0311","1252","644","472","172","23","667","1146","0","58.2","41.19"
"63","000","00","003","0311","1253","727","541","186","29","756","1285","0","58.83","42.1"
"63","000","00","003","0311","1254","747","559","188","35","782","1297","0","60.29","43.1"
"63","000","00","003","0311","1255","656","525","131","30","686","1101","0","62.31","47.68"
"63","000","00","003","0312","0000","2248","1654","594","138","2386","4047","0","58.96","40.87"
"63","000","00","003","0312","1256","711","524","187","52","763","1310","0","58.24","40.0"
"63","000","00","003","0312","1257","787","571","216","58","845","1365","0","61.9","41.83"
"63","000","00","003","0312","1258","750","559","191","28","778","1372","0","56.71","40.74"
"63","000","00","003","0313","0000","2045","1526","519","103","2148","3596","0","59.73","42.44"
"63","000","00","003","0313","1259","677","508","169","26","703","1189","0","59.13","42.72"
"63","000","00","003","0313","1260","705","525","180","42","747","1256","0","59.47","41.8"
"63","000","00","003","0313","1261","663","493","170","35","698","1151","0","60.64","42.83"
"63","000","00","003","0314","0000","3567","2698","869","187","3754","6129","0","61.25","44.02"
"63","000","00","003","0314","1262","898","705","193","37","935","1501","0","62.29","46.97"
"63","000","00","003","0314","1263","862","666","196","45","907","1520","0","59.67","43.82"
"63","000","00","003","0314","1264","898","652","246","55","953","1529","0","62.33","42.64"
"63","000","00","003","0314","1265","909","675","234","50","959","1579","0","60.73","42.75"
"63","000","00","003","0315","0000","2989","2244","745","120","3109","6705","0","46.37","33.47"
"63","000","00","003","0315","1266","644","476","168","35","679","2619","0","25.93","18.17"
"63","000","00","003","0315","1267","742","557","185","21","763","1290","0","59.15","43.18"
"63","000","00","003","0315","1268","773","563","210","31","804","1307","0","61.51","43.08"
"63","000","00","003","0315","1269","830","648","182","33","863","1489","0","57.96","43.52"
"63","000","00","003","0316","0000","2766","2084","682","121","2887","4884","0","59.11","42.67"
"63","000","00","003","0316","1270","650","511","139","35","685","1097","0","62.44","46.58"
"63","000","00","003","0316","1271","738","559","179","39","777","1328","0","58.51","42.09"
"63","000","00","003","0316","1272","664","490","174","20","684","1189","0","57.53","41.21"
"63","000","00","003","0316","1273","714","524","190","27","741","1270","0","58.35","41.26"
"63","000","00","003","0317","0000","2879","2139","740","133","3012","5155","0","58.43","41.49"
"63","000","00","003","0317","1274","739","534","205","18","757","1349","0","56.12","39.58"
"63","000","00","003","0317","1275","687","516","171","31","718","1292","0","55.57","39.94"
"63","000","00","003","0317","1276","773","589","184","35","808","1314","0","61.49","44.82"
"63","000","00","003","0317","1277","680","500","180","49","729","1200","0","60.75","41.67"
"63","000","00","003","0318","0000","1718","1260","458","83","1801","3119","0","57.74","40.4"
"63","000","00","003","0318","1278","860","630","230","43","903","1558","0","57.96","40.44"
"63","000","00","003","0318","1279","858","630","228","40","898","1561","0","57.53","40.36"
"63","000","00","003","0319","0000","1661","1272","389","78","1739","2945","0","59.05","43.19"
"63","000","00","003","0319","1280","810","632","178","44","854","1446","0","59.06","43.71"
"63","000","00","003","0319","1281","851","640","211","34","885","1499","0","59.04","42.7"
"63","000","00","003","0320","0000","1616","1223","393","86","1702","2978","0","57.15","41.07"
"63","000","00","003","0320","1282","824","618","206","36","860","1467","0","58.62","42.13"
"63","000","00","003","0320","1283","792","605","187","50","842","1511","0","55.72","40.04"
"63","000","00","003","0321","0000","2641","1974","667","149","2790","4640","0","60.13","42.54"
"63","000","00","003","0321","1284","906","685","221","56","962","1600","0","60.13","42.81"
"63","000","00","003","0321","1285","889","636","253","43","932","1573","0","59.25","40.43"
"63","000","00","003","0321","1286","846","653","193","50","896","1467","0","61.08","44.51"
"63","000","00","003","0322","0000","3194","2453","741","196","3390","5891","0","57.55","41.64"
"63","000","00","003","0322","1287","741","598","143","61","802","1358","0","59.06","44.04"
"63","000","00","003","0322","1288","840","636","204","61","901","1568","0","57.46","40.56"
"63","000","00","003","0322","1289","792","593","199","45","837","1411","0","59.32","42.03"
"63","000","00","003","0322","1290","821","626","195","29","850","1554","0","54.7","40.28"
"63","000","00","003","0323","0000","3320","2716","604","121","3441","5712","0","60.24","47.55"
"63","000","00","003","0323","1291","730","620","110","33","763","1345","0","56.73","46.1"
"63","000","00","003","0323","1292","805","659","146","27","832","1435","0","57.98","45.92"
"63","000","00","003","0323","1293","898","710","188","27","925","1481","0","62.46","47.94"
"63","000","00","003","0323","1294","887","727","160","34","921","1451","0","63.47","50.1"
"63","000","00","003","0326","0000","1713","1276","437","100","1813","3091","0","58.65","41.28"
"63","000","00","003","0326","1295","861","638","223","62","923","1566","0","58.94","40.74"
"63","000","00","003","0326","1296","852","638","214","38","890","1525","0","58.36","41.84"
"63","000","00","003","0327","0000","2188","1670","518","129","2317","4215","0","54.97","39.62"
"63","000","00","003","0327","1297","700","532","168","41","741","1336","0","55.46","39.82"
"63","000","00","003","0327","1298","810","604","206","57","867","1483","0","58.46","40.73"
"63","000","00","003","0327","1299","678","534","144","31","709","1396","0","50.79","38.25"
"63","000","00","003","0328","0000","3109","2375","734","165","3274","5535","0","59.15","42.91"
"63","000","00","003","0328","1300","803","605","198","59","862","1406","0","61.31","43.03"
"63","000","00","003","0328","1301","801","621","180","34","835","1434","0","58.23","43.31"
"63","000","00","003","0328","1302","711","533","178","36","747","1288","0","58.0","41.38"
"63","000","00","003","0328","1303","794","616","178","36","830","1407","0","58.99","43.78"
"63","000","00","003","0329","0000","2210","1787","423","146","2356","4554","0","51.73","39.24"
"63","000","00","003","0329","1304","775","585","190","38","813","1514","0","53.7","38.64"
"63","000","00","003","0329","1305","714","568","146","58","772","1550","0","49.81","36.65"
"63","000","00","003","0329","1306","721","634","87","50","771","1490","0","51.74","42.55"
"63","000","00","003","0330","0000","2548","1965","583","141","2689","4663","0","57.67","42.14"
"63","000","00","003","0330","1307","678","535","143","30","708","1284","0","55.14","41.67"
"63","000","00","003","0330","1308","636","505","131","42","678","1129","0","60.05","44.73"
"63","000","00","003","0330","1309","674","512","162","30","704","1193","0","59.01","42.92"
"63","000","00","003","0330","1310","560","413","147","39","599","1057","0","56.67","39.07"
"63","000","00","003","0331","0000","2793","2161","632","228","3021","5453","0","55.4","39.63"
"63","000","00","003","0331","1311","726","551","175","50","776","1361","0","57.02","40.48"
"63","000","00","003","0331","1312","732","582","150","61","793","1412","0","56.16","41.22"
"63","000","00","003","0331","1313","670","511","159","47","717","1423","0","50.39","35.91"
"63","000","00","003","0331","1314","665","517","148","70","735","1257","0","58.47","41.13"
"63","000","00","003","0332","0000","2746","2100","646","160","2906","4829","0","60.18","43.49"
"63","000","00","003","0332","1315","665","504","161","37","702","1133","0","61.96","44.48"
"63","000","00","003","0332","1316","574","432","142","29","603","1077","0","55.99","40.11"
"63","000","00","003","0332","1317","741","567","174","39","780","1300","0","60.0","43.62"
"63","000","00","003","0332","1318","766","597","169","55","821","1319","0","62.24","45.26"
"63","000","00","003","0333","0000","1963","1558","405","132","2095","3633","0","57.67","42.88"
"63","000","00","003","0333","1319","690","555","135","71","761","1265","0","60.16","43.87"
"63","000","00","003","0333","1320","654","499","155","27","681","1265","0","53.83","39.45"
"63","000","00","003","0333","1321","619","504","115","34","653","1103","0","59.2","45.69"
"63","000","00","003","0334","0000","2227","1789","438","132","2359","3958","0","59.6","45.2"
"63","000","00","003","0334","1322","747","614","133","42","789","1341","0","58.84","45.79"
"63","000","00","003","0334","1323","775","631","144","49","824","1357","0","60.72","46.5"
"63","000","00","003","0334","1324","705","544","161","41","746","1260","0","59.21","43.17"
"63","000","00","003","0335","0000","2071","1602","469","104","2175","3844","0","56.58","41.68"
"63","000","00","003","0335","1325","728","566","162","42","770","1295","0","59.46","43.71"
"63","000","00","003","0335","1326","712","550","162","26","738","1399","0","52.75","39.31"
"63","000","00","003","0335","1327","631","486","145","36","667","1150","0","58.0","42.26"
"63","000","00","003","0336","0000","2756","2255","501","136","2892","5149","0","56.17","43.79"
"63","000","00","003","0336","1328","681","541","140","34","715","1351","0","52.92","40.04"
"63","000","00","003","0336","1329","741","570","171","50","791","1341","0","58.99","42.51"
"63","000","00","003","0336","1330","607","560","47","21","628","1129","0","55.62","49.6"
"63","000","00","003","0336","1331","727","584","143","31","758","1328","0","57.08","43.98"
"63","000","00","003","0337","0000","3381","2773","608","163","3544","6080","0","58.29","45.61"
"63","000","00","003","0337","1332","936","799","137","39","975","1557","0","62.62","51.32"
"63","000","00","003","0337","1333","876","711","165","46","922","1461","0","63.11","48.67"
"63","000","00","003","0337","1334","782","611","171","34","816","1589","0","51.35","38.45"
"63","000","00","003","0337","1335","787","652","135","44","831","1473","0","56.42","44.26"
"63","000","00","003","0338","0000","1828","1417","411","98","1926","3311","0","58.17","42.8"
"63","000","00","003","0338","1336","797","609","188","42","839","1479","0","56.73","41.18"
"63","000","00","003","0338","1337","494","372","122","29","523","833","0","62.79","44.66"
"63","000","00","003","0338","1338","537","436","101","27","564","999","0","56.46","43.64"
"63","000","00","003","0339","0000","999","785","214","42","1041","1757","0","59.25","44.68"
"63","000","00","003","0339","1339","999","785","214","42","1041","1757","0","59.25","44.68"
"63","000","00","003","0340","0000","4375","3291","1084","241","4616","7674","0","60.15","42.89"
"63","000","00","003","0340","1340","886","685","201","37","923","1573","0","58.68","43.55"
"63","000","00","003","0340","1341","936","707","229","44","980","1587","0","61.75","44.55"
"63","000","00","003","0340","1342","859","634","225","55","914","1496","0","61.1","42.38"
"63","000","00","003","0340","1343","801","598","203","44","845","1440","0","58.68","41.53"
"63","000","00","003","0340","1344","893","667","226","61","954","1578","0","60.46","42.27"
"63","000","00","003","0341","0000","2019","1504","515","93","2112","3594","0","58.76","41.85"
"63","000","00","003","0341","1345","675","494","181","32","707","1223","0","57.81","40.39"
"63","000","00","003","0341","1346","622","460","162","21","643","1119","0","57.46","41.11"
"63","000","00","003","0341","1347","722","550","172","40","762","1252","0","60.86","43.93"
"63","000","00","003","0343","0000","3948","2937","1011","184","4132","7232","0","57.13","40.61"
"63","000","00","003","0343","1348","876","644","232","46","922","1576","0","58.5","40.86"
"63","000","00","003","0343","1349","764","574","190","38","802","1425","0","56.28","40.28"
"63","000","00","003","0343","1350","745","548","197","29","774","1450","0","53.38","37.79"
"63","000","00","003","0343","1351","771","577","194","38","809","1444","0","56.02","39.96"
"63","000","00","003","0343","1352","792","594","198","33","825","1337","0","61.71","44.43"
"63","000","00","003","0344","0000","2783","2177","606","175","2958","5100","0","58.0","42.69"
"63","000","00","003","0344","1353","737","580","157","31","768","1417","0","54.2","40.93"
"63","000","00","003","0344","1354","682","529","153","45","727","1250","0","58.16","42.32"
"63","000","00","003","0344","1355","629","490","139","51","680","1176","0","57.82","41.67"
"63","000","00","003","0344","1356","735","578","157","48","783","1257","0","62.29","45.98"
"63","000","00","003","0346","0000","2638","2042","596","162","2800","4851","0","57.72","42.09"
"63","000","00","003","0346","1357","697","539","158","50","747","1257","0","59.43","42.88"
"63","000","00","003","0346","1358","633","486","147","27","660","1148","0","57.49","42.33"
"63","000","00","003","0346","1359","761","587","174","59","820","1418","0","57.83","41.4"
"63","000","00","003","0346","1360","547","430","117","26","573","1028","0","55.74","41.83"
"63","000","00","003","0347","0000","3781","2895","886","244","4025","6796","0","59.23","42.6"
"63","000","00","003","0347","1361","839","628","211","49","888","1445","0","61.45","43.46"
"63","000","00","003","0347","1362","762","599","163","49","811","1361","0","59.59","44.01"
"63","000","00","003","0347","1363","766","577","189","56","822","1343","0","61.21","42.96"
"63","000","00","003","0347","1364","703","547","156","50","753","1267","0","59.43","43.17"
"63","000","00","003","0347","1365","711","544","167","40","751","1380","0","54.42","39.42"
"63","000","00","003","0348","0000","2271","1792","479","140","2411","4312","0","55.91","41.56"
"63","000","00","003","0348","1366","800","623","177","54","854","1524","0","56.04","40.88"
"63","000","00","003","0348","1367","818","638","180","40","858","1470","0","58.37","43.4"
"63","000","00","003","0348","1368","653","531","122","46","699","1318","0","53.03","40.29"
"63","000","00","003","0349","0000","2219","1689","530","113","2332","4254","0","54.82","39.7"
"63","000","00","003","0349","1369","723","560","163","42","765","1430","0","53.5","39.16"
"63","000","00","003","0349","1370","755","569","186","42","797","1386","0","57.5","41.05"
"63","000","00","003","0349","1371","741","560","181","29","770","1438","0","53.55","38.94"
"63","000","00","003","0350","0000","2725","2082","643","175","2900","5267","0","55.06","39.53"
"63","000","00","003","0350","1372","629","479","150","24","653","1270","0","51.42","37.72"
"63","000","00","003","0350","1373","716","559","157","60","776","1395","0","55.63","40.07"
"63","000","00","003","0350","1374","693","537","156","45","738","1292","0","57.12","41.56"
"63","000","00","003","0350","1375","687","507","180","46","733","1310","0","55.95","38.7"
"63","000","00","003","0351","0000","2829","2149","680","122","2951","5321","0","55.46","40.39"
"63","000","00","003","0351","1376","696","511","185","42","738","1319","0","55.95","38.74"
"63","000","00","003","0351","1377","763","561","202","22","785","1355","0","57.93","41.4"
"63","000","00","003","0351","1378","655","511","144","29","684","1312","0","52.13","38.95"
"63","000","00","003","0351","1379","715","566","149","29","744","1335","0","55.73","42.4"
"63","000","00","003","0352","0000","2150","1611","539","76","2226","4124","0","53.98","39.06"
"63","000","00","003","0352","1380","752","555","197","31","783","1489","0","52.59","37.27"
"63","000","00","003","0352","1381","719","561","158","26","745","1307","0","57.0","42.92"
"63","000","00","003","0352","1382","679","495","184","19","698","1328","0","52.56","37.27"
"63","000","00","003","0353","0000","2780","2069","711","159","2939","5169","0","56.86","40.03"
"63","000","00","003","0353","1383","656","499","157","11","667","1277","0","52.23","39.08"
"63","000","00","003","0353","1384","709","543","166","40","749","1314","0","57.0","41.32"
"63","000","00","003","0353","1385","715","509","206","50","765","1270","0","60.24","40.08"
"63","000","00","003","0353","1386","700","518","182","58","758","1308","0","57.95","39.6"
"63","000","00","003","0354","0000","2000","1543","457","99","2099","3647","0","57.55","42.31"
"63","000","00","003","0354","1387","648","497","151","26","674","1138","0","59.23","43.67"
"63","000","00","003","0354","1388","707","565","142","31","738","1333","0","55.36","42.39"
"63","000","00","003","0354","1389","645","481","164","42","687","1176","0","58.42","40.9"
"63","000","00","003","0355","0000","2923","2222","701","164","3087","5436","0","56.79","40.88"
"63","000","00","003","0355","1390","706","532","174","49","755","1311","0","57.59","40.58"
"63","000","00","003","0355","1391","694","521","173","28","722","1295","0","55.75","40.23"
"63","000","00","003","0355","1392","780","605","175","48","828","1421","0","58.27","42.58"
"63","000","00","003","0355","1393","743","564","179","39","782","1409","0","55.5","40.03"
"63","000","00","003","0356","0000","3634","2792","842","201","3835","6534","0","58.69","42.73"
"63","000","00","003","0356","1394","801","622","179","34","835","1434","0","58.23","43.38"
"63","000","00","003","0356","1395","730","552","178","52","782","1449","0","53.97","38.1"
"63","000","00","003","0356","1396","704","540","164","53","757","1284","0","58.96","42.06"
"63","000","00","003","0356","1397","689","546","143","33","722","1248","0","57.85","43.75"
"63","000","00","003","0356","1398","710","532","178","29","739","1119","0","66.04","47.54"
"63","000","00","003","0357","0000","1273","981","292","107","1380","2327","0","59.3","42.16"
"63","000","00","003","0357","1399","501","404","97","35","536","883","0","60.7","45.75"
"63","000","00","003","0357","1400","320","250","70","40","360","630","0","57.14","39.68"
"63","000","00","003","0357","1401","452","327","125","32","484","814","0","59.46","40.17"
"63","000","00","004","0000","0000","103699","78649","25050","7022","110721","195148","229680","56.74","40.3"
"63","000","00","004","0401","0000","1528","1165","363","78","1606","2854","0","56.27","40.82"
"63","000","00","004","0401","0786","825","655","170","41","866","1522","0","56.9","43.04"
"63","000","00","004","0401","0787","703","510","193","37","740","1332","0","55.56","38.29"
"63","000","00","004","0402","0000","2276","1700","576","159","2435","4755","0","51.21","35.75"
"63","000","00","004","0402","0788","782","588","194","54","836","1656","0","50.48","35.51"
"63","000","00","004","0402","0789","663","492","171","48","711","1367","0","52.01","35.99"
"63","000","00","004","0402","0790","831","620","211","57","888","1732","0","51.27","35.8"
"63","000","00","004","0403","0000","1721","1306","415","110","1831","3284","0","55.76","39.77"
"63","000","00","004","0403","0791","879","695","184","58","937","1634","0","57.34","42.53"
"63","000","00","004","0403","0792","842","611","231","52","894","1650","0","54.18","37.03"
"63","000","00","004","0404","0000","2280","1668","612","126","2406","4046","0","59.47","41.23"
"63","000","00","004","0404","0793","776","559","217","37","813","1392","0","58.41","40.16"
"63","000","00","004","0404","0794","692","496","196","34","726","1177","0","61.68","42.14"
"63","000","00","004","0404","0795","812","613","199","55","867","1477","0","58.7","41.5"
"63","000","00","004","0405","0000","1194","921","273","92","1286","2359","0","54.51","39.04"
"63","000","00","004","0405","0796","531","398","133","50","581","1063","0","54.66","37.44"
"63","000","00","004","0405","0797","663","523","140","42","705","1296","0","54.4","40.35"
"63","000","00","004","0406","0000","3096","2368","728","191","3287","6065","0","54.2","39.04"
"63","000","00","004","0406","0798","681","542","139","30","711","1330","0","53.46","40.75"
"63","000","00","004","0406","0799","753","537","216","52","805","1483","0","54.28","36.21"
"63","000","00","004","0406","0800","788","619","169","43","831","1542","0","53.89","40.14"
"63","000","00","004","0406","0801","874","670","204","66","940","1710","0","54.97","39.18"
"63","000","00","004","0407","0000","1919","1474","445","135","2054","3822","0","53.74","38.57"
"63","000","00","004","0407","0802","638","472","166","32","670","1315","0","50.95","35.89"
"63","000","00","004","0407","0803","634","484","150","66","700","1245","0","56.22","38.88"
"63","000","00","004","0407","0804","647","518","129","37","684","1262","0","54.2","41.05"
"63","000","00","004","0408","0000","3185","2353","832","240","3425","6149","0","55.7","38.27"
"63","000","00","004","0408","0805","812","594","218","58","870","1518","0","57.31","39.13"
"63","000","00","004","0408","0806","810","608","202","69","879","1522","0","57.75","39.95"
"63","000","00","004","0408","0807","752","525","227","76","828","1580","0","52.41","33.23"
"63","000","00","004","0408","0808","811","626","185","37","848","1529","0","55.46","40.94"
"63","000","00","004","0409","0000","1837","1413","424","127","1964","3581","0","54.85","39.46"
"63","000","00","004","0409","0809","622","460","162","43","665","1221","0","54.46","37.67"
"63","000","00","004","0409","0810","670","507","163","55","725","1221","0","59.38","41.52"
"63","000","00","004","0409","0811","545","446","99","29","574","1139","0","50.4","39.16"
"63","000","00","004","0410","0000","2176","1668","508","151","2327","4306","0","54.04","38.74"
"63","000","00","004","0410","0812","733","534","199","69","802","1407","0","57.0","37.95"
"63","000","00","004","0410","0813","697","551","146","40","737","1321","0","55.79","41.71"
"63","000","00","004","0410","0814","746","583","163","42","788","1578","0","49.94","36.95"
"63","000","00","004","0411","0000","2416","1840","576","176","2592","4917","0","52.72","37.42"
"63","000","00","004","0411","0815","838","656","182","51","889","1739","0","51.12","37.72"
"63","000","00","004","0411","0816","807","605","202","52","859","1637","0","52.47","36.96"
"63","000","00","004","0411","0817","771","579","192","73","844","1541","0","54.77","37.57"
"63","000","00","004","0412","0000","1928","1465","463","164","2092","3765","0","55.56","38.91"
"63","000","00","004","0412","0818","664","503","161","56","720","1210","0","59.5","41.57"
"63","000","00","004","0412","0819","674","506","168","48","722","1331","0","54.24","38.02"
"63","000","00","004","0412","0820","590","456","134","60","650","1224","0","53.1","37.25"
"63","000","00","004","0413","0000","1763","1518","245","94","1857","3209","0","57.87","47.3"
"63","000","00","004","0413","0824","975","837","138","55","1030","1805","0","57.06","46.37"
"63","000","00","004","0413","0825","788","681","107","39","827","1404","0","58.9","48.5"
"63","000","00","004","0414","0000","4423","3395","1028","293","4716","7819","0","60.31","43.42"
"63","000","00","004","0414","0826","1019","753","266","47","1066","1708","0","62.41","44.09"
"63","000","00","004","0414","0827","832","641","191","57","889","1451","0","61.27","44.18"
"63","000","00","004","0414","0828","954","731","223","81","1035","1684","0","61.46","43.41"
"63","000","00","004","0414","0829","851","689","162","38","889","1585","0","56.09","43.47"
"63","000","00","004","0414","0830","767","581","186","70","837","1391","0","60.17","41.77"
"63","000","00","004","0415","0000","3183","2485","698","172","3355","5575","0","60.18","44.57"
"63","000","00","004","0415","0831","841","650","191","72","913","1375","0","66.4","47.27"
"63","000","00","004","0415","0832","865","653","212","19","884","1472","0","60.05","44.36"
"63","000","00","004","0415","0833","694","542","152","46","740","1327","0","55.76","40.84"
"63","000","00","004","0415","0834","783","640","143","35","818","1401","0","58.39","45.68"
"63","000","00","004","0416","0000","4410","3415","995","224","4634","7980","0","58.07","42.79"
"63","000","00","004","0416","0835","781","614","167","54","835","1423","0","58.68","43.15"
"63","000","00","004","0416","0836","875","630","245","48","923","1569","0","58.83","40.15"
"63","000","00","004","0416","0837","916","690","226","34","950","1651","0","57.54","41.79"
"63","000","00","004","0416","0838","852","749","103","31","883","1624","0","54.37","46.12"
"63","000","00","004","0416","0839","986","732","254","57","1043","1713","0","60.89","42.73"
"63","000","00","004","0417","0000","483","352","131","55","538","944","0","56.99","37.29"
"63","000","00","004","0417","0862","483","352","131","55","538","944","0","56.99","37.29"
"63","000","00","004","0418","0000","2464","1887","577","189","2653","4693","0","56.53","40.21"
"63","000","00","004","0418","0846","768","612","156","58","826","1472","0","56.11","41.58"
"63","000","00","004","0418","0847","752","539","213","55","807","1517","0","53.2","35.53"
"63","000","00","004","0418","0848","944","736","208","76","1020","1704","0","59.86","43.19"
"63","000","00","004","0419","0000","2489","1906","583","203","2692","4476","0","60.14","42.58"
"63","000","00","004","0419","0821","839","651","188","65","904","1585","0","57.03","41.07"
"63","000","00","004","0419","0822","870","641","229","80","950","1523","0","62.38","42.09"
"63","000","00","004","0419","0823","780","614","166","58","838","1368","0","61.26","44.88"
"63","000","00","004","0420","0000","2402","1737","665","209","2611","4535","0","57.57","38.3"
"63","000","00","004","0420","0849","866","586","280","67","933","1603","0","58.2","36.56"
"63","000","00","004","0420","0850","705","538","167","78","783","1432","0","54.68","37.57"
"63","000","00","004","0420","0851","831","613","218","64","895","1500","0","59.67","40.87"
"63","000","00","004","0421","0000","3121","2308","813","176","3297","5635","0","58.51","40.96"
"63","000","00","004","0421","0852","756","575","181","40","796","1332","0","59.76","43.17"
"63","000","00","004","0421","0853","823","598","225","54","877","1450","0","60.48","41.24"
"63","000","00","004","0421","0854","808","596","212","51","859","1434","0","59.9","41.56"
"63","000","00","004","0421","0855","734","539","195","31","765","1419","0","53.91","37.98"
"63","000","00","004","0422","0000","2170","1585","585","157","2327","4400","0","52.89","36.02"
"63","000","00","004","0422","0856","673","479","194","41","714","1292","0","55.26","37.07"
"63","000","00","004","0422","0857","777","573","204","57","834","1526","0","54.65","37.55"
"63","000","00","004","0422","0858","720","533","187","59","779","1582","0","49.24","33.69"
"63","000","00","004","0423","0000","2242","1655","587","206","2448","4584","0","53.4","36.1"
"63","000","00","004","0423","0859","754","567","187","70","824","1588","0","51.89","35.71"
"63","000","00","004","0423","0860","762","566","196","77","839","1463","0","57.35","38.69"
"63","000","00","004","0423","0861","726","522","204","59","785","1533","0","51.21","34.05"
"63","000","00","004","0424","0000","2553","1880","673","178","2731","6843","0","39.91","27.47"
"63","000","00","004","0424","0863","1015","737","278","72","1087","1745","0","62.29","42.23"
"63","000","00","004","0424","0864","788","581","207","53","841","1679","0","50.09","34.6"
"63","000","00","004","0424","0865","750","562","188","53","803","3419","0","23.49","16.44"
"63","000","00","004","0425","0000","3821","2894","927","331","4152","7203","0","57.64","40.18"
"63","000","00","004","0425","0866","755","570","185","75","830","1387","0","59.84","41.1"
"63","000","00","004","0425","0867","908","699","209","71","979","1672","0","58.55","41.81"
"63","000","00","004","0425","0868","694","519","175","74","768","1319","0","58.23","39.35"
"63","000","00","004","0425","0869","704","532","172","60","764","1364","0","56.01","39.0"
"63","000","00","004","0425","0870","760","574","186","51","811","1461","0","55.51","39.29"
"63","000","00","004","0426","0000","1919","1438","481","145","2064","3654","0","56.49","39.35"
"63","000","00","004","0426","0871","651","484","167","44","695","1173","0","59.25","41.26"
"63","000","00","004","0426","0872","575","440","135","50","625","1171","0","53.37","37.57"
"63","000","00","004","0426","0873","693","514","179","51","744","1310","0","56.79","39.24"
"63","000","00","004","0427","0000","3758","2863","895","249","4007","6655","0","60.21","43.02"
"63","000","00","004","0427","0874","780","621","159","46","826","1373","0","60.16","45.23"
"63","000","00","004","0427","0875","729","556","173","33","762","1290","0","59.07","43.1"
"63","000","00","004","0427","0876","757","573","184","62","819","1346","0","60.85","42.57"
"63","000","00","004","0427","0877","826","598","228","70","896","1468","0","61.04","40.74"
"63","000","00","004","0427","0878","666","515","151","38","704","1178","0","59.76","43.72"
"63","000","00","004","0428","0000","3264","2424","840","229","3493","6102","0","57.24","39.72"
"63","000","00","004","0428","0879","916","681","235","59","975","1654","0","58.95","41.17"
"63","000","00","004","0428","0880","791","612","179","68","859","1464","0","58.67","41.8"
"63","000","00","004","0428","0881","754","541","213","34","788","1450","0","54.34","37.31"
"63","000","00","004","0428","0882","803","590","213","68","871","1534","0","56.78","38.46"
"63","000","00","004","0429","0000","3562","2594","968","266","3828","6660","0","57.48","38.95"
"63","000","00","004","0429","0883","912","678","234","39","951","1703","0","55.84","39.81"
"63","000","00","004","0429","0884","863","650","213","83","946","1610","0","58.76","40.37"
"63","000","00","004","0429","0885","849","608","241","77","926","1653","0","56.02","36.78"
"63","000","00","004","0429","0886","938","658","280","67","1005","1694","0","59.33","38.84"
"63","000","00","004","0430","0000","2554","1841","713","181","2735","4824","0","56.7","38.16"
"63","000","00","004","0430","0887","850","628","222","66","916","1623","0","56.44","38.69"
"63","000","00","004","0430","0888","887","621","266","62","949","1618","0","58.65","38.38"
"63","000","00","004","0430","0889","817","592","225","53","870","1583","0","54.96","37.4"
"63","000","00","004","0431","0000","2643","1915","728","181","2824","4529","0","62.35","42.28"
"63","000","00","004","0431","0890","895","629","266","68","963","1605","0","60.0","39.19"
"63","000","00","004","0431","0891","828","600","228","52","880","1398","0","62.95","42.92"
"63","000","00","004","0431","0892","920","686","234","61","981","1526","0","64.29","44.95"
"63","000","00","004","0432","0000","2537","1874","663","184","2721","4739","0","57.42","39.54"
"63","000","00","004","0432","0893","845","603","242","60","905","1555","0","58.2","38.78"
"63","000","00","004","0432","0894","840","646","194","45","885","1597","0","55.42","40.45"
"63","000","00","004","0432","0895","852","625","227","79","931","1587","0","58.66","39.38"
"63","000","00","004","0433","0000","1756","1339","417","142","1898","3133","0","60.58","42.74"
"63","000","00","004","0433","0896","891","693","198","65","956","1587","0","60.24","43.67"
"63","000","00","004","0433","0897","865","646","219","77","942","1546","0","60.93","41.79"
"63","000","00","004","0434","0000","2741","2155","586","174","2915","5094","0","57.22","42.3"
"63","000","00","004","0434","0898","700","550","150","52","752","1322","0","56.88","41.6"
"63","000","00","004","0434","0899","694","533","161","45","739","1267","0","58.33","42.07"
"63","000","00","004","0434","0900","658","526","132","20","678","1210","0","56.03","43.47"
"63","000","00","004","0434","0901","689","546","143","57","746","1295","0","57.61","42.16"
"63","000","00","004","0435","0000","2662","2189","473","159","2821","4474","0","63.05","48.93"
"63","000","00","004","0435","0902","831","650","181","57","888","1467","0","60.53","44.31"
"63","000","00","004","0435","0903","856","700","156","43","899","1491","0","60.3","46.95"
"63","000","00","004","0435","0904","975","839","136","59","1034","1516","0","68.21","55.34"
"63","000","00","004","0436","0000","2153","1595","558","120","2273","4035","0","56.33","39.53"
"63","000","00","004","0436","0905","709","526","183","40","749","1384","0","54.12","38.01"
"63","000","00","004","0436","0906","681","509","172","45","726","1138","0","63.8","44.73"
"63","000","00","004","0436","0907","763","560","203","35","798","1513","0","52.74","37.01"
"63","000","00","004","0437","0000","1665","1284","381","133","1798","2988","0","60.17","42.97"
"63","000","00","004","0437","0908","863","677","186","60","923","1559","0","59.2","43.43"
"63","000","00","004","0437","0909","802","607","195","73","875","1429","0","61.23","42.48"
"63","000","00","004","0438","0000","1449","1081","368","83","1532","2459","0","62.3","43.96"
"63","000","00","004","0438","0910","736","538","198","35","771","1245","0","61.93","43.21"
"63","000","00","004","0438","0911","713","543","170","48","761","1214","0","62.69","44.73"
"63","000","00","004","0439","0000","2909","2169","740","145","3054","5339","0","57.2","40.63"
"63","000","00","004","0439","0912","790","574","216","45","835","1394","0","59.9","41.18"
"63","000","00","004","0439","0913","665","529","136","20","685","1336","0","51.27","39.6"
"63","000","00","004","0439","0914","675","483","192","42","717","1227","0","58.44","39.36"
"63","000","00","004","0439","0915","779","583","196","38","817","1382","0","59.12","42.19"
"63","000","00","004","0440","0000","2159","1679","480","130","2289","4100","0","55.83","40.95"
"63","000","00","004","0440","0916","764","586","178","63","827","1436","0","57.59","40.81"
"63","000","00","004","0440","0917","705","539","166","31","736","1405","0","52.38","38.36"
"63","000","00","004","0440","0918","690","554","136","36","726","1259","0","57.66","44.0"
"63","000","00","004","0441","0000","3527","2777","750","186","3713","6297","0","58.96","44.1"
"63","000","00","004","0441","0840","934","746","188","50","984","1647","0","59.74","45.29"
"63","000","00","004","0441","0841","910","693","217","46","956","1762","0","54.26","39.33"
"63","000","00","004","0441","0842","818","666","152","43","861","1399","0","61.54","47.61"
"63","000","00","004","0441","0843","865","672","193","47","912","1489","0","61.25","45.13"
"63","000","00","004","0442","0000","1361","1074","287","79","1440","2267","0","63.52","47.38"
"63","000","00","004","0442","0844","775","596","179","35","810","1269","0","63.83","46.97"
"63","000","00","004","0442","0845","586","478","108","44","630","998","0","63.13","47.9"
"63","000","00","005","0000","0000","70448","54089","16359","4232","74680","128292","159026","58.21","42.16"
"63","000","00","005","0501","0000","1412","1054","358","109","1521","2625","0","57.94","40.15"
"63","000","00","005","0501","1001","745","553","192","39","784","1308","0","59.94","42.28"
"63","000","00","005","0501","1002","667","501","166","70","737","1317","0","55.96","38.04"
"63","000","00","005","0502","0000","1219","1005","214","74","1293","2197","0","58.85","45.74"
"63","000","00","005","0502","1003","628","515","113","33","661","1069","0","61.83","48.18"
"63","000","00","005","0502","1004","591","490","101","41","632","1128","0","56.03","43.44"
"63","000","00","005","0503","0000","1173","879","294","71","1244","2101","0","59.21","41.84"
"63","000","00","005","0503","1005","594","437","157","49","643","1053","0","61.06","41.5"
"63","000","00","005","0503","1006","579","442","137","22","601","1048","0","57.35","42.18"
"63","000","00","005","0504","0000","2297","1819","478","127","2424","3990","0","60.75","45.59"
"63","000","00","005","0504","1007","684","561","123","52","736","1297","0","56.75","43.25"
"63","000","00","005","0504","1008","694","571","123","23","717","1193","0","60.1","47.86"
"63","000","00","005","0504","1009","919","687","232","52","971","1500","0","64.73","45.8"
"63","000","00","005","0505","0000","2196","1709","487","104","2300","4079","0","56.39","41.9"
"63","000","00","005","0505","1010","710","548","162","36","746","1346","0","55.42","40.71"
"63","000","00","005","0505","1011","705","541","164","23","728","1283","0","56.74","42.17"
"63","000","00","005","0505","1012","781","620","161","45","826","1450","0","56.97","42.76"
"63","000","00","005","0506","0000","3086","2333","753","166","3252","5329","0","61.02","43.78"
"63","000","00","005","0506","1013","807","601","206","44","851","1433","0","59.39","41.94"
"63","000","00","005","0506","1014","814","603","211","45","859","1309","0","65.62","46.07"
"63","000","00","005","0506","1015","778","603","175","32","810","1386","0","58.44","43.51"
"63","000","00","005","0506","1016","687","526","161","45","732","1201","0","60.95","43.8"
"63","000","00","005","0507","0000","2972","2257","715","176","3148","5107","0","61.64","44.19"
"63","000","00","005","0507","1017","770","596","174","48","818","1336","0","61.23","44.61"
"63","000","00","005","0507","1018","781","566","215","48","829","1358","0","61.05","41.68"
"63","000","00","005","0507","1019","665","500","165","49","714","1177","0","60.66","42.48"
"63","000","00","005","0507","1020","756","595","161","31","787","1236","0","63.67","48.14"
"63","000","00","005","0508","0000","1651","1259","392","79","1730","2952","0","58.6","42.65"
"63","000","00","005","0508","1021","809","610","199","48","857","1478","0","57.98","41.27"
"63","000","00","005","0508","1022","842","649","193","31","873","1474","0","59.23","44.03"
"63","000","00","005","0509","0000","2748","2078","670","175","2923","4914","0","59.48","42.29"
"63","000","00","005","0509","1023","650","487","163","40","690","1172","0","58.87","41.55"
"63","000","00","005","0509","1024","736","549","187","35","771","1310","0","58.85","41.91"
"63","000","00","005","0509","1025","706","563","143","55","761","1263","0","60.25","44.58"
"63","000","00","005","0509","1026","656","479","177","45","701","1169","0","59.97","40.98"
"63","000","00","005","0510","0000","2139","1691","448","100","2239","3916","0","57.18","43.18"
"63","000","00","005","0510","1027","745","620","125","29","774","1391","0","55.64","44.57"
"63","000","00","005","0510","1028","650","507","143","30","680","1201","0","56.62","42.21"
"63","000","00","005","0510","1029","744","564","180","41","785","1324","0","59.29","42.6"
"63","000","00","005","0511","0000","2839","2162","677","233","3072","5279","0","58.19","40.95"
"63","000","00","005","0511","1030","623","475","148","60","683","1216","0","56.17","39.06"
"63","000","00","005","0511","1031","637","493","144","44","681","1183","0","57.57","41.67"
"63","000","00","005","0511","1032","814","600","214","75","889","1469","0","60.52","40.84"
"63","000","00","005","0511","1033","765","594","171","54","819","1411","0","58.04","42.1"
"63","000","00","005","0512","0000","2369","1899","470","222","2591","4497","0","57.62","42.23"
"63","000","00","005","0512","1034","767","598","169","77","844","1398","0","60.37","42.78"
"63","000","00","005","0512","1035","776","624","152","68","844","1479","0","57.07","42.19"
"63","000","00","005","0512","1036","826","677","149","77","903","1620","0","55.74","41.79"
"63","000","00","005","0513","0000","1774","1330","444","73","1847","3160","0","58.45","42.09"
"63","000","00","005","0513","1037","569","438","131","18","587","1041","0","56.39","42.07"
"63","000","00","005","0513","1038","568","410","158","14","582","1056","0","55.11","38.83"
"63","000","00","005","0513","1039","637","482","155","41","678","1063","0","63.78","45.34"
"63","000","00","005","0514","0000","2719","2140","579","267","2986","5865","0","50.91","36.49"
"63","000","00","005","0514","1040","686","535","151","60","746","1591","0","46.89","33.63"
"63","000","00","005","0514","1041","637","499","138","71","708","1502","0","47.14","33.22"
"63","000","00","005","0514","1042","644","518","126","70","714","1331","0","53.64","38.92"
"63","000","00","005","0514","1043","752","588","164","66","818","1441","0","56.77","40.8"
"63","000","00","005","0515","0000","2010","1564","446","151","2161","3562","0","60.67","43.91"
"63","000","00","005","0515","1044","732","571","161","56","788","1273","0","61.9","44.85"
"63","000","00","005","0515","1045","628","478","150","56","684","1133","0","60.37","42.19"
"63","000","00","005","0515","1046","650","515","135","39","689","1156","0","59.6","44.55"
"63","000","00","005","0516","0000","1447","1078","369","128","1575","2643","0","59.59","40.79"
"63","000","00","005","0516","1047","739","548","191","58","797","1377","0","57.88","39.8"
"63","000","00","005","0516","1048","708","530","178","70","778","1266","0","61.45","41.86"
"63","000","00","005","0517","0000","1293","1017","276","74","1367","2235","0","61.16","45.5"
"63","000","00","005","0517","1049","661","526","135","48","709","1111","0","63.82","47.34"
"63","000","00","005","0517","1050","632","491","141","26","658","1124","0","58.54","43.68"
"63","000","00","005","0518","0000","1589","1249","340","93","1682","2724","0","61.75","45.85"
"63","000","00","005","0518","1051","803","645","158","43","846","1373","0","61.62","46.98"
"63","000","00","005","0518","1052","786","604","182","50","836","1351","0","61.88","44.71"
"63","000","00","005","0519","0000","4883","3794","1089","253","5136","8679","0","59.18","43.71"
"63","000","00","005","0519","1053","843","642","201","35","878","1495","0","58.73","42.94"
"63","000","00","005","0519","1054","914","716","198","55","969","1436","0","67.48","49.86"
"63","000","00","005","0519","1055","830","664","166","34","864","1516","0","56.99","43.8"
"63","000","00","005","0519","1056","761","589","172","43","804","1374","0","58.52","42.87"
"63","000","00","005","0519","1057","781","604","177","47","828","1522","0","54.4","39.68"
"63","000","00","005","0519","1058","754","579","175","39","793","1336","0","59.36","43.34"
"63","000","00","005","0520","0000","2559","1930","629","178","2737","4648","0","58.89","41.52"
"63","000","00","005","0520","1059","868","671","197","41","909","1551","0","58.61","43.26"
"63","000","00","005","0520","1060","885","660","225","67","952","1594","0","59.72","41.41"
"63","000","00","005","0520","1061","806","599","207","70","876","1503","0","58.28","39.85"
"63","000","00","005","0521","0000","4113","3226","887","206","4319","7237","0","59.68","44.58"
"63","000","00","005","0521","1062","818","642","176","46","864","1455","0","59.38","44.12"
"63","000","00","005","0521","1063","819","635","184","25","844","1439","0","58.65","44.13"
"63","000","00","005","0521","1064","820","629","191","44","864","1469","0","58.82","42.82"
"63","000","00","005","0521","1065","823","675","148","39","862","1430","0","60.28","47.2"
"63","000","00","005","0521","1066","833","645","188","52","885","1444","0","61.29","44.67"
"63","000","00","005","0522","0000","709","554","155","21","730","1254","0","58.21","44.18"
"63","000","00","005","0522","1067","709","554","155","21","730","1254","0","58.21","44.18"
"63","000","00","005","0523","0000","1811","1394","417","128","1939","3213","0","60.35","43.39"
"63","000","00","005","0523","1068","527","428","99","47","574","932","0","61.59","45.92"
"63","000","00","005","0523","1069","598","447","151","46","644","1055","0","61.04","42.37"
"63","000","00","005","0523","1070","686","519","167","35","721","1226","0","58.81","42.33"
"63","000","00","005","0524","0000","1417","1101","316","90","1507","2726","0","55.28","40.39"
"63","000","00","005","0524","1071","684","526","158","48","732","1390","0","52.66","37.84"
"63","000","00","005","0524","1072","733","575","158","42","775","1336","0","58.01","43.04"
"63","000","00","005","0525","0000","1499","1105","394","96","1595","2780","0","57.37","39.75"
"63","000","00","005","0525","1073","701","513","188","49","750","1419","0","52.85","36.15"
"63","000","00","005","0525","1074","798","592","206","47","845","1361","0","62.09","43.5"
"63","000","00","005","0526","0000","2423","1898","525","75","2498","5016","0","49.8","37.84"
"63","000","00","005","0526","1075","1092","900","192","49","1141","2520","0","45.28","35.71"
"63","000","00","005","0526","1076","681","515","166","21","702","1224","0","57.35","42.08"
"63","000","00","005","0526","1077","650","483","167","5","655","1272","0","51.49","37.97"
"63","000","00","005","0527","0000","2172","1559","613","118","2290","3951","0","57.96","39.46"
"63","000","00","005","0527","1078","768","515","253","42","810","1400","0","57.86","36.79"
"63","000","00","005","0527","1079","692","508","184","30","722","1319","0","54.74","38.51"
"63","000","00","005","0527","1080","712","536","176","46","758","1232","0","61.53","43.51"
"63","000","00","005","0528","0000","1945","1479","466","95","2040","3274","0","62.31","45.17"
"63","000","00","005","0528","1081","758","587","171","41","799","1265","0","63.16","46.4"
"63","000","00","005","0528","1082","648","502","146","27","675","1055","0","63.98","47.58"
"63","000","00","005","0528","1083","539","390","149","27","566","954","0","59.33","40.88"
"63","000","00","005","0529","0000","2547","1926","621","177","2724","4703","0","57.92","40.95"
"63","000","00","005","0529","1084","579","454","125","33","612","1018","0","60.12","44.6"
"63","000","00","005","0529","1085","781","593","188","48","829","1431","0","57.93","41.44"
"63","000","00","005","0529","1086","618","464","154","52","670","1271","0","52.71","36.51"
"63","000","00","005","0529","1087","569","415","154","44","613","983","0","62.36","42.22"
"63","000","00","005","0530","0000","3411","2677","734","179","3590","6409","0","56.01","41.77"
"63","000","00","005","0530","1088","856","622","234","44","900","1594","0","56.46","39.02"
"63","000","00","005","0530","1089","812","747","65","53","865","1565","0","55.27","47.73"
"63","000","00","005","0530","1090","907","691","216","38","945","1650","0","57.27","41.88"
"63","000","00","005","0530","1091","836","617","219","44","880","1600","0","55.0","38.56"
"63","000","00","005","0531","0000","4026","2923","1103","194","4220","7227","0","58.39","40.45"
"63","000","00","005","0531","1092","754","559","195","24","778","1391","0","55.93","40.19"
"63","000","00","005","0531","1093","958","703","255","42","1000","1769","0","56.53","39.74"
"63","000","00","005","0531","1094","824","580","244","54","878","1487","0","59.05","39.0"
"63","000","00","005","0531","1095","749","554","195","41","790","1291","0","61.19","42.91"
"63","000","00","005","0531","1096","741","527","214","33","774","1289","0","60.05","40.88"
"63","000","00","006","0000","0000","57266","42497","14769","4486","61752","107557","127833","57.41","39.51"
"63","000","00","006","0601","0000","1451","1033","418","133","1584","2613","0","60.62","39.53"
"63","000","00","006","0601","0919","679","488","191","72","751","1261","0","59.56","38.7"
"63","000","00","006","0601","0920","772","545","227","61","833","1352","0","61.61","40.31"
"63","000","00","006","0602","0000","1578","1184","394","125","1703","2972","0","57.3","39.84"
"63","000","00","006","0602","0921","775","566","209","61","836","1462","0","57.18","38.71"
"63","000","00","006","0602","0922","803","618","185","64","867","1510","0","57.42","40.93"
"63","000","00","006","0603","0000","2137","1569","568","158","2295","4132","0","55.54","37.97"
"63","000","00","006","0603","0923","741","530","211","36","777","1496","0","51.94","35.43"
"63","000","00","006","0603","0924","703","520","183","49","752","1329","0","56.58","39.13"
"63","000","00","006","0603","0925","693","519","174","73","766","1307","0","58.61","39.71"
"63","000","00","006","0604","0000","1761","1285","476","141","1902","3197","0","59.49","40.19"
"63","000","00","006","0604","0926","577","440","137","52","629","1065","0","59.06","41.31"
"63","000","00","006","0604","0927","577","424","153","37","614","1085","0","56.59","39.08"
"63","000","00","006","0604","0928","607","421","186","52","659","1047","0","62.94","40.21"
"63","000","00","006","0605","0000","2575","1888","687","193","2768","4703","0","58.86","40.14"
"63","000","00","006","0605","0929","594","452","142","37","631","1215","0","51.93","37.2"
"63","000","00","006","0605","0930","651","457","194","33","684","1117","0","61.24","40.91"
"63","000","00","006","0605","0931","666","506","160","66","732","1186","0","61.72","42.66"
"63","000","00","006","0605","0932","664","473","191","57","721","1185","0","60.84","39.92"
"63","000","00","006","0606","0000","2138","1621","517","128","2266","3923","0","57.76","41.32"
"63","000","00","006","0606","0933","718","546","172","43","761","1359","0","56.0","40.18"
"63","000","00","006","0606","0934","682","508","174","33","715","1273","0","56.17","39.91"
"63","000","00","006","0606","0935","738","567","171","52","790","1291","0","61.19","43.92"
"63","000","00","006","0607","0000","2825","2111","714","181","3006","5142","0","58.46","41.05"
"63","000","00","006","0607","0936","667","487","180","43","710","1288","0","55.12","37.81"
"63","000","00","006","0607","0937","724","542","182","51","775","1245","0","62.25","43.53"
"63","000","00","006","0607","0938","735","553","182","58","793","1261","0","62.89","43.85"
"63","000","00","006","0607","0939","699","529","170","29","728","1348","0","54.01","39.24"
"63","000","00","006","0608","0000","2359","1748","611","216","2575","4303","0","59.84","40.62"
"63","000","00","006","0608","0940","894","640","254","86","980","1676","0","58.47","38.19"
"63","000","00","006","0608","0941","753","567","186","50","803","1311","0","61.25","43.25"
"63","000","00","006","0608","0942","712","541","171","80","792","1316","0","60.18","41.11"
"63","000","00","006","0609","0000","2338","1689","649","196","2534","4253","0","59.58","39.71"
"63","000","00","006","0609","0943","755","556","199","71","826","1409","0","58.62","39.46"
"63","000","00","006","0609","0944","810","592","218","63","873","1436","0","60.79","41.23"
"63","000","00","006","0609","0945","773","541","232","62","835","1408","0","59.3","38.42"
"63","000","00","006","0610","0000","2015","1505","510","97","2112","3710","0","56.93","40.57"
"63","000","00","006","0610","0946","686","492","194","45","731","1276","0","57.29","38.56"
"63","000","00","006","0610","0947","610","491","119","16","626","1110","0","56.4","44.23"
"63","000","00","006","0610","0948","719","522","197","36","755","1324","0","57.02","39.43"
"63","000","00","006","0611","0000","4482","3397","1085","348","4830","7949","0","60.76","42.73"
"63","000","00","006","0611","0949","539","405","134","49","588","1016","0","57.87","39.86"
"63","000","00","006","0611","0950","602","444","158","38","640","1028","0","62.26","43.19"
"63","000","00","006","0611","0951","669","514","155","54","723","1158","0","62.44","44.39"
"63","000","00","006","0611","0952","639","497","142","59","698","1138","0","61.34","43.67"
"63","000","00","006","0611","0953","675","514","161","62","737","1214","0","60.71","42.34"
"63","000","00","006","0611","0954","587","428","159","28","615","1090","0","56.42","39.27"
"63","000","00","006","0611","0955","771","595","176","58","829","1305","0","63.52","45.59"
"63","000","00","006","0612","0000","1896","1459","437","133","2029","3518","0","57.67","41.47"
"63","000","00","006","0612","0956","592","460","132","29","621","1167","0","53.21","39.42"
"63","000","00","006","0612","0957","632","476","156","53","685","1148","0","59.67","41.46"
"63","000","00","006","0612","0958","672","523","149","51","723","1203","0","60.1","43.47"
"63","000","00","006","0613","0000","2911","2171","740","238","3149","5427","0","58.02","40.0"
"63","000","00","006","0613","0959","724","532","192","43","767","1441","0","53.23","36.92"
"63","000","00","006","0613","0960","759","549","210","64","823","1315","0","62.59","41.75"
"63","000","00","006","0613","0961","725","561","164","72","797","1393","0","57.21","40.27"
"63","000","00","006","0613","0962","703","529","174","59","762","1278","0","59.62","41.39"
"63","000","00","006","0614","0000","1202","900","302","119","1321","2388","0","55.32","37.69"
"63","000","00","006","0614","0963","614","467","147","51","665","1246","0","53.37","37.48"
"63","000","00","006","0614","0964","588","433","155","68","656","1142","0","57.44","37.92"
"63","000","00","006","0615","0000","1534","1133","401","120","1654","2699","0","61.28","41.98"
"63","000","00","006","0615","0965","764","568","196","56","820","1336","0","61.38","42.51"
"63","000","00","006","0615","0966","770","565","205","64","834","1363","0","61.19","41.45"
"63","000","00","006","0616","0000","2320","1712","608","122","2442","4354","0","56.09","39.32"
"63","000","00","006","0616","0967","792","598","194","36","828","1476","0","56.1","40.51"
"63","000","00","006","0616","0968","783","559","224","52","835","1418","0","58.89","39.42"
"63","000","00","006","0616","0969","745","555","190","34","779","1460","0","53.36","38.01"
"63","000","00","006","0617","0000","1126","832","294","139","1265","2468","0","51.26","33.71"
"63","000","00","006","0617","0970","561","407","154","51","612","1222","0","50.08","33.31"
"63","000","00","006","0617","0971","565","425","140","88","653","1246","0","52.41","34.11"
"63","000","00","006","0618","0000","2078","1523","555","125","2203","3885","0","56.71","39.2"
"63","000","00","006","0618","0972","694","487","207","71","765","1256","0","60.91","38.77"
"63","000","00","006","0618","0973","706","536","170","31","737","1289","0","57.18","41.58"
"63","000","00","006","0618","0974","678","500","178","23","701","1340","0","52.31","37.31"
"63","000","00","006","0619","0000","1524","1136","388","134","1658","4014","0","41.31","28.3"
"63","000","00","006","0619","0975","774","554","220","64","838","1555","0","53.89","35.63"
"63","000","00","006","0619","0976","750","582","168","70","820","2459","0","33.35","23.67"
"63","000","00","006","0620","0000","2291","1673","618","202","2493","4466","0","55.82","37.46"
"63","000","00","006","0620","0977","479","356","123","58","537","1108","0","48.47","32.13"
"63","000","00","006","0620","0978","431","317","114","53","484","867","0","55.82","36.56"
"63","000","00","006","0620","0979","759","548","211","60","819","1329","0","61.63","41.23"
"63","000","00","006","0620","0980","622","452","170","31","653","1162","0","56.2","38.9"
"63","000","00","006","0621","0000","2913","2140","773","194","3107","5823","0","53.36","36.75"
"63","000","00","006","0621","0981","716","525","191","69","785","1434","0","54.74","36.61"
"63","000","00","006","0621","0982","725","548","177","64","789","1351","0","58.4","40.56"
"63","000","00","006","0621","0983","750","545","205","43","793","1531","0","51.8","35.6"
"63","000","00","006","0621","0984","722","522","200","18","740","1507","0","49.1","34.64"
"63","000","00","006","0622","0000","3845","2878","967","320","4165","7142","0","58.32","40.3"
"63","000","00","006","0622","0985","785","565","220","56","841","1488","0","56.52","37.97"
"63","000","00","006","0622","0986","764","578","186","88","852","1384","0","61.56","41.76"
"63","000","00","006","0622","0987","767","586","181","79","846","1460","0","57.95","40.14"
"63","000","00","006","0622","0988","781","590","191","62","843","1371","0","61.49","43.03"
"63","000","00","006","0622","0989","748","559","189","35","783","1439","0","54.41","38.85"
"63","000","00","006","0624","0000","2838","2099","739","274","3112","5195","0","59.9","40.4"
"63","000","00","006","0624","0990","753","533","220","73","826","1376","0","60.03","38.74"
"63","000","00","006","0624","0991","689","513","176","83","772","1366","0","56.52","37.55"
"63","000","00","006","0624","0992","727","526","201","59","786","1218","0","64.53","43.19"
"63","000","00","006","0624","0993","669","527","142","59","728","1235","0","58.95","42.67"
"63","000","00","006","0625","0000","3108","2351","757","237","3345","5651","0","59.19","41.6"
"63","000","00","006","0625","0994","689","544","145","28","717","1364","0","52.57","39.88"
"63","000","00","006","0625","0995","816","604","212","79","895","1408","0","63.57","42.9"
"63","000","00","006","0625","0996","784","584","200","62","846","1450","0","58.34","40.28"
"63","000","00","006","0625","0997","819","619","200","68","887","1429","0","62.07","43.32"
"63","000","00","006","0626","0000","2021","1460","561","213","2234","3630","0","61.54","40.22"
"63","000","00","006","0626","0998","650","482","168","65","715","1170","0","61.11","41.2"
"63","000","00","006","0626","0999","654","464","190","79","733","1245","0","58.88","37.27"
"63","000","00","006","0626","1000","717","514","203","69","786","1215","0","64.69","42.3"
"63","000","00","007","0000","0000","83970","64385","19585","6622","90592","164020","189875","55.23","39.25"
"63","000","00","007","0701","0000","2455","1849","606","185","2640","4833","0","54.62","38.26"
"63","000","00","007","0701","1097","753","568","185","56","809","1305","0","61.99","43.52"
"63","000","00","007","0701","1098","536","395","141","69","605","1183","0","51.14","33.39"
"63","000","00","007","0701","1099","604","474","130","30","634","1176","0","53.91","40.31"
"63","000","00","007","0701","1100","562","412","150","30","592","1169","0","50.64","35.24"
"63","000","00","007","0702","0000","1374","1006","368","110","1484","3020","0","49.14","33.31"
"63","000","00","007","0702","1101","688","500","188","46","734","1457","0","50.38","34.32"
"63","000","00","007","0702","1102","686","506","180","64","750","1563","0","47.98","32.37"
"63","000","00","007","0703","0000","1581","1196","385","89","1670","3386","0","49.32","35.32"
"63","000","00","007","0703","1103","800","608","192","36","836","1771","0","47.2","34.33"
"63","000","00","007","0703","1104","781","588","193","53","834","1615","0","51.64","36.41"
"63","000","00","007","0704","0000","2900","2187","713","225","3125","5794","0","53.94","37.75"
"63","000","00","007","0704","1105","746","564","182","78","824","1478","0","55.75","38.16"
"63","000","00","007","0704","1106","744","569","175","27","771","1462","0","52.74","38.92"
"63","000","00","007","0704","1107","666","517","149","69","735","1507","0","48.77","34.31"
"63","000","00","007","0704","1108","744","537","207","51","795","1347","0","59.02","39.87"
"63","000","00","007","0705","0000","2874","2069","805","210","3084","5489","0","56.19","37.69"
"63","000","00","007","0705","1109","669","492","177","54","723","1367","0","52.89","35.99"
"63","000","00","007","0705","1110","730","522","208","51","781","1277","0","61.16","40.88"
"63","000","00","007","0705","1111","752","525","227","50","802","1395","0","57.49","37.63"
"63","000","00","007","0705","1112","723","530","193","55","778","1450","0","53.66","36.55"
"63","000","00","007","0706","0000","2536","1885","651","231","2767","5192","0","53.29","36.31"
"63","000","00","007","0706","1113","641","487","154","51","692","1340","0","51.64","36.34"
"63","000","00","007","0706","1114","613","448","165","52","665","1242","0","53.54","36.07"
"63","000","00","007","0706","1115","633","449","184","78","711","1286","0","55.29","34.91"
"63","000","00","007","0706","1116","649","501","148","50","699","1324","0","52.79","37.84"
"63","000","00","007","0707","0000","2083","1504","579","200","2283","4411","0","51.76","34.1"
"63","000","00","007","0707","1117","780","557","223","78","858","1619","0","53.0","34.4"
"63","000","00","007","0707","1118","606","436","170","68","674","1352","0","49.85","32.25"
"63","000","00","007","0707","1119","697","511","186","54","751","1440","0","52.15","35.49"
"63","000","00","007","0708","0000","1891","1403","488","193","2084","3514","0","59.31","39.93"
"63","000","00","007","0708","1120","665","486","179","51","716","1194","0","59.97","40.7"
"63","000","00","007","0708","1121","618","475","143","73","691","1083","0","63.8","43.86"
"63","000","00","007","0708","1122","608","442","166","69","677","1237","0","54.73","35.73"
"63","000","00","007","0709","0000","2289","1714","575","190","2479","4301","0","57.64","39.85"
"63","000","00","007","0709","1123","826","616","210","60","886","1625","0","54.52","37.91"
"63","000","00","007","0709","1124","729","539","190","72","801","1324","0","60.5","40.71"
"63","000","00","007","0709","1125","734","559","175","58","792","1352","0","58.58","41.35"
"63","000","00","007","0710","0000","2222","1611","611","190","2412","5559","0","43.39","28.98"
"63","000","00","007","0710","1126","683","490","193","57","740","2630","0","28.14","18.63"
"63","000","00","007","0710","1127","831","606","225","69","900","1504","0","59.84","40.29"
"63","000","00","007","0710","1128","708","515","193","64","772","1425","0","54.18","36.14"
"63","000","00","007","0711","0000","3206","2344","862","280","3486","6398","0","54.49","36.64"
"63","000","00","007","0711","1144","507","365","142","42","549","1052","0","52.19","34.7"
"63","000","00","007","0711","1145","576","411","165","57","633","1135","0","55.77","36.21"
"63","000","00","007","0711","1146","634","450","184","59","693","1225","0","56.57","36.73"
"63","000","00","007","0711","1147","766","585","181","68","834","1583","0","52.68","36.96"
"63","000","00","007","0711","1148","723","533","190","54","777","1403","0","55.38","37.99"
"63","000","00","007","0712","0000","2138","1609","529","186","2324","3995","0","58.17","40.28"
"63","000","00","007","0712","1149","745","550","195","64","809","1406","0","57.54","39.12"
"63","000","00","007","0712","1150","758","575","183","56","814","1401","0","58.1","41.04"
"63","000","00","007","0712","1151","635","484","151","66","701","1188","0","59.01","40.74"
"63","000","00","007","0713","0000","1690","1431","259","95","1785","3076","0","58.03","46.52"
"63","000","00","007","0713","1198","752","626","126","52","804","1485","0","54.14","42.15"
"63","000","00","007","0713","1199","938","805","133","43","981","1591","0","61.66","50.6"
"63","000","00","007","0714","0000","4426","3632","794","189","4615","7544","0","61.17","48.14"
"63","000","00","007","0714","1200","882","729","153","34","916","1394","0","65.71","52.3"
"63","000","00","007","0714","1201","821","661","160","38","859","1522","0","56.44","43.43"
"63","000","00","007","0714","1202","965","816","149","38","1003","1661","0","60.39","49.13"
"63","000","00","007","0714","1203","911","750","161","26","937","1561","0","60.03","48.05"
"63","000","00","007","0714","1204","847","676","171","53","900","1406","0","64.01","48.08"
"63","000","00","007","0715","0000","2625","1986","639","197","2822","4891","0","57.7","40.61"
"63","000","00","007","0715","1137","623","466","157","32","655","1228","0","53.34","37.95"
"63","000","00","007","0715","1138","663","510","153","64","727","1268","0","57.33","40.22"
"63","000","00","007","0715","1139","665","511","154","62","727","1207","0","60.23","42.34"
"63","000","00","007","0715","1140","674","499","175","39","713","1188","0","60.02","42.0"
"63","000","00","007","0716","0000","3004","2272","732","212","3216","6228","0","51.64","36.48"
"63","000","00","007","0716","1152","764","572","192","80","844","1597","0","52.85","35.82"
"63","000","00","007","0716","1153","723","554","169","69","792","1290","0","61.4","42.95"
"63","000","00","007","0716","1154","805","602","203","22","827","1746","0","47.37","34.48"
"63","000","00","007","0716","1155","712","544","168","41","753","1595","0","47.21","34.11"
"63","000","00","007","0717","0000","1723","1356","367","122","1845","3860","0","47.8","35.13"
"63","000","00","007","0717","1141","738","551","187","54","792","1474","0","53.73","37.38"
"63","000","00","007","0717","1142","573","471","102","23","596","1304","0","45.71","36.12"
"63","000","00","007","0717","1143","412","334","78","45","457","1082","0","42.24","30.87"
"63","000","00","007","0718","0000","4056","3109","947","346","4402","7643","0","57.6","40.68"
"63","000","00","007","0718","1132","741","559","182","65","806","1447","0","55.7","38.63"
"63","000","00","007","0718","1133","813","639","174","53","866","1491","0","58.08","42.86"
"63","000","00","007","0718","1134","825","635","190","55","880","1500","0","58.67","42.33"
"63","000","00","007","0718","1135","863","664","199","71","934","1582","0","59.04","41.97"
"63","000","00","007","0718","1136","814","612","202","102","916","1623","0","56.44","37.71"
"63","000","00","007","0719","0000","2187","1695","492","243","2430","4677","0","51.96","36.24"
"63","000","00","007","0719","1129","723","542","181","79","802","1591","0","50.41","34.07"
"63","000","00","007","0719","1130","723","578","145","81","804","1474","0","54.55","39.21"
"63","000","00","007","0719","1131","741","575","166","83","824","1612","0","51.12","35.67"
"63","000","00","007","0720","0000","1806","1391","415","161","1967","3212","0","61.24","43.31"
"63","000","00","007","0720","1163","563","443","120","39","602","1036","0","58.11","42.76"
"63","000","00","007","0720","1164","598","442","156","67","665","1035","0","64.25","42.71"
"63","000","00","007","0720","1165","645","506","139","55","700","1141","0","61.35","44.35"
"63","000","00","007","0721","0000","2649","2088","561","218","2867","5522","0","51.92","37.81"
"63","000","00","007","0721","1205","652","508","144","40","692","1498","0","46.19","33.91"
"63","000","00","007","0721","1206","636","488","148","67","703","1478","0","47.56","33.02"
"63","000","00","007","0721","1207","588","456","132","67","655","1170","0","55.98","38.97"
"63","000","00","007","0721","1208","773","636","137","44","817","1376","0","59.38","46.22"
"63","000","00","007","0722","0000","2133","1620","513","164","2297","3885","0","59.12","41.7"
"63","000","00","007","0722","1166","702","550","152","36","738","1271","0","58.06","43.27"
"63","000","00","007","0722","1167","716","531","185","88","804","1328","0","60.54","39.98"
"63","000","00","007","0722","1168","715","539","176","40","755","1286","0","58.71","41.91"
"63","000","00","007","0723","0000","1527","1168","359","143","1670","2903","0","57.53","40.23"
"63","000","00","007","0723","1172","876","663","213","73","949","1623","0","58.47","40.85"
"63","000","00","007","0723","1173","651","505","146","70","721","1280","0","56.33","39.45"
"63","000","00","007","0724","0000","2891","2297","594","349","3240","6128","0","52.87","37.48"
"63","000","00","007","0724","1156","823","727","96","109","932","1701","0","54.79","42.74"
"63","000","00","007","0724","1157","578","419","159","85","663","1339","0","49.51","31.29"
"63","000","00","007","0724","1158","657","514","143","76","733","1484","0","49.39","34.64"
"63","000","00","007","0724","1159","833","637","196","79","912","1604","0","56.86","39.71"
"63","000","00","007","0725","0000","2493","1944","549","228","2721","4923","0","55.27","39.49"
"63","000","00","007","0725","1169","907","687","220","89","996","1679","0","59.32","40.92"
"63","000","00","007","0725","1170","844","648","196","69","913","1619","0","56.39","40.02"
"63","000","00","007","0725","1171","742","609","133","70","812","1625","0","49.97","37.48"
"63","000","00","007","0726","0000","2044","1539","505","165","2209","3767","0","58.64","40.85"
"63","000","00","007","0726","1160","650","479","171","41","691","1197","0","57.73","40.02"
"63","000","00","007","0726","1161","663","485","178","76","739","1347","0","54.86","36.01"
"63","000","00","007","0726","1162","731","575","156","48","779","1223","0","63.7","47.02"
"63","000","00","007","0727","0000","1610","1209","401","143","1753","2911","0","60.22","41.53"
"63","000","00","007","0727","1180","762","555","207","61","823","1342","0","61.33","41.36"
"63","000","00","007","0727","1181","848","654","194","82","930","1569","0","59.27","41.68"
"63","000","00","007","0728","0000","2154","1663","491","141","2295","4194","0","54.72","39.65"
"63","000","00","007","0728","1177","761","570","191","35","796","1373","0","57.98","41.51"
"63","000","00","007","0728","1178","698","546","152","73","771","1394","0","55.31","39.17"
"63","000","00","007","0728","1179","695","547","148","33","728","1427","0","51.02","38.33"
"63","000","00","007","0729","0000","1479","1134","345","97","1576","3234","0","48.73","35.06"
"63","000","00","007","0729","1182","695","523","172","55","750","1514","0","49.54","34.54"
"63","000","00","007","0729","1183","784","611","173","42","826","1720","0","48.02","35.52"
"63","000","00","007","0730","0000","2468","1895","573","185","2653","4533","0","58.53","41.8"
"63","000","00","007","0730","1174","825","649","176","66","891","1608","0","55.41","40.36"
"63","000","00","007","0730","1175","790","592","198","62","852","1453","0","58.64","40.74"
"63","000","00","007","0730","1176","853","654","199","57","910","1472","0","61.82","44.43"
"63","000","00","007","0731","0000","2092","1621","471","159","2251","4154","0","54.19","39.02"
"63","000","00","007","0731","1188","635","491","144","41","676","1307","0","51.72","37.57"
"63","000","00","007","0731","1189","753","586","167","84","837","1420","0","58.94","41.27"
"63","000","00","007","0731","1190","704","544","160","34","738","1427","0","51.72","38.12"
"63","000","00","007","0732","0000","3028","2289","739","205","3233","5505","0","58.73","41.58"
"63","000","00","007","0732","1184","843","641","202","77","920","1461","0","62.97","43.87"
"63","000","00","007","0732","1185","646","490","156","32","678","1264","0","53.64","38.77"
"63","000","00","007","0732","1186","764","572","192","57","821","1334","0","61.54","42.88"
"63","000","00","007","0732","1187","775","586","189","39","814","1446","0","56.29","40.53"
"63","000","00","007","0733","0000","2645","2180","465","202","2847","4900","0","58.1","44.49"
"63","000","00","007","0733","1191","502","403","99","42","544","956","0","56.9","42.15"
"63","000","00","007","0733","1192","729","579","150","65","794","1352","0","58.73","42.83"
"63","000","00","007","0733","1193","722","597","125","54","776","1370","0","56.64","43.58"
"63","000","00","007","0733","1194","692","601","91","41","733","1222","0","59.98","49.18"
"63","000","00","007","0734","0000","2259","1728","531","157","2416","4365","0","55.35","39.59"
"63","000","00","007","0734","1195","726","619","107","52","778","1375","0","56.58","45.02"
"63","000","00","007","0734","1196","797","528","269","62","859","1463","0","58.71","36.09"
"63","000","00","007","0734","1197","736","581","155","43","779","1527","0","51.02","38.05"
"63","000","00","007","0735","0000","1841","1494","347","128","1969","3296","0","59.74","45.33"
"63","000","00","007","0735","1209","591","492","99","21","612","1093","0","55.99","45.01"
"63","000","00","007","0735","1210","623","495","128","58","681","1084","0","62.82","45.66"
"63","000","00","007","0735","1211","627","507","120","49","676","1119","0","60.41","45.31"
"63","000","00","007","0736","0000","1591","1267","324","84","1675","2777","0","60.32","45.62"
"63","000","00","007","0736","1212","815","646","169","44","859","1381","0","62.2","46.78"
"63","000","00","007","0736","1213","776","621","155","40","816","1396","0","58.45","44.48"
"63","000","00","008","0000","0000","127462","101174","26288","7798","135260","227211","273883","59.53","44.53"
"63","000","00","008","0801","0000","3377","2582","795","197","3574","6228","0","57.39","41.46"
"63","000","00","008","0801","1402","830","612","218","33","863","1539","0","56.08","39.77"
"63","000","00","008","0801","1403","776","623","153","42","818","1548","0","52.84","40.25"
"63","000","00","008","0801","1404","833","621","212","68","901","1493","0","60.35","41.59"
"63","000","00","008","0801","1405","938","726","212","54","992","1648","0","60.19","44.05"
"63","000","00","008","0802","0000","3418","2764","654","222","3640","6155","0","59.14","44.91"
"63","000","00","008","0802","1406","842","667","175","55","897","1544","0","58.1","43.2"
"63","000","00","008","0802","1407","852","698","154","57","909","1557","0","58.38","44.83"
"63","000","00","008","0802","1408","802","657","145","46","848","1514","0","56.01","43.39"
"63","000","00","008","0802","1409","922","742","180","64","986","1540","0","64.03","48.18"
"63","000","00","008","0803","0000","2539","1994","545","143","2682","4365","0","61.44","45.68"
"63","000","00","008","0803","1410","860","681","179","48","908","1466","0","61.94","46.45"
"63","000","00","008","0803","1411","854","677","177","38","892","1444","0","61.77","46.88"
"63","000","00","008","0803","1412","825","636","189","57","882","1455","0","60.62","43.71"
"63","000","00","008","0804","0000","3070","2392","678","184","3254","5676","0","57.33","42.14"
"63","000","00","008","0804","1413","749","558","191","57","806","1440","0","55.97","38.75"
"63","000","00","008","0804","1414","805","636","169","55","860","1398","0","61.52","45.49"
"63","000","00","008","0804","1415","737","583","154","28","765","1412","0","54.18","41.29"
"63","000","00","008","0804","1416","779","615","164","44","823","1426","0","57.71","43.13"
"63","000","00","008","0805","0000","2423","1904","519","123","2546","4345","0","58.6","43.82"
"63","000","00","008","0805","1417","803","617","186","50","853","1437","0","59.36","42.94"
"63","000","00","008","0805","1418","767","617","150","43","810","1340","0","60.45","46.04"
"63","000","00","008","0805","1419","853","670","183","30","883","1568","0","56.31","42.73"
"63","000","00","008","0806","0000","2731","2139","592","139","2870","5016","0","57.22","42.64"
"63","000","00","008","0806","1420","750","592","158","27","777","1372","0","56.63","43.15"
"63","000","00","008","0806","1421","566","442","124","31","597","1046","0","57.07","42.26"
"63","000","00","008","0806","1422","690","536","154","45","735","1274","0","57.69","42.07"
"63","000","00","008","0806","1423","725","569","156","36","761","1324","0","57.48","42.98"
"63","000","00","008","0807","0000","2751","2172","579","131","2882","4829","0","59.68","44.98"
"63","000","00","008","0807","1424","938","715","223","50","988","1722","0","57.38","41.52"
"63","000","00","008","0807","1425","987","781","206","58","1045","1737","0","60.16","44.96"
"63","000","00","008","0807","1426","826","676","150","23","849","1370","0","61.97","49.34"
"63","000","00","008","0808","0000","2233","1724","509","157","2390","3961","0","60.34","43.52"
"63","000","00","008","0808","1427","830","630","200","51","881","1495","0","58.93","42.14"
"63","000","00","008","0808","1428","752","588","164","49","801","1328","0","60.32","44.28"
"63","000","00","008","0808","1429","651","506","145","57","708","1138","0","62.21","44.46"
"63","000","00","008","0809","0000","3651","2856","795","204","3855","6217","0","62.01","45.94"
"63","000","00","008","0809","1430","836","671","165","40","876","1471","0","59.55","45.62"
"63","000","00","008","0809","1431","678","529","149","35","713","1144","0","62.33","46.24"
"63","000","00","008","0809","1432","707","547","160","49","756","1176","0","64.29","46.51"
"63","000","00","008","0809","1433","711","539","172","49","760","1212","0","62.71","44.47"
"63","000","00","008","0809","1434","719","570","149","31","750","1214","0","61.78","46.95"
"63","000","00","008","0810","0000","2679","2025","654","185","2864","4778","0","59.94","42.38"
"63","000","00","008","0810","1435","637","465","172","38","675","1170","0","57.69","39.74"
"63","000","00","008","0810","1436","752","551","201","46","798","1308","0","61.01","42.13"
"63","000","00","008","0810","1437","672","522","150","53","725","1190","0","60.92","43.87"
"63","000","00","008","0810","1438","618","487","131","48","666","1110","0","60.0","43.87"
"63","000","00","008","0811","0000","1635","1337","298","116","1751","2899","0","60.4","46.12"
"63","000","00","008","0811","1439","834","653","181","57","891","1512","0","58.93","43.19"
"63","000","00","008","0811","1440","801","684","117","59","860","1387","0","62.0","49.32"
"63","000","00","008","0812","0000","2325","1816","509","168","2493","4209","0","59.23","43.15"
"63","000","00","008","0812","1441","760","605","155","51","811","1355","0","59.85","44.65"
"63","000","00","008","0812","1442","772","575","197","53","825","1370","0","60.22","41.97"
"63","000","00","008","0812","1443","793","636","157","64","857","1484","0","57.75","42.86"
"63","000","00","008","0813","0000","2454","1945","509","130","2584","4240","0","60.94","45.87"
"63","000","00","008","0813","1444","985","772","213","58","1043","1786","0","58.4","43.23"
"63","000","00","008","0813","1445","720","595","125","45","765","1260","0","60.71","47.22"
"63","000","00","008","0813","1446","749","578","171","27","776","1194","0","64.99","48.41"
"63","000","00","008","0814","0000","1635","1326","309","130","1765","2936","0","60.12","45.16"
"63","000","00","008","0814","1450","779","625","154","78","857","1450","0","59.1","43.1"
"63","000","00","008","0814","1451","856","701","155","52","908","1486","0","61.1","47.17"
"63","000","00","008","0815","0000","3807","3021","786","202","4009","6643","0","60.35","45.48"
"63","000","00","008","0815","1452","733","582","151","39","772","1259","0","61.32","46.23"
"63","000","00","008","0815","1453","792","626","166","19","811","1317","0","61.58","47.53"
"63","000","00","008","0815","1454","788","627","161","42","830","1321","0","62.83","47.46"
"63","000","00","008","0815","1455","808","640","168","54","862","1475","0","58.44","43.39"
"63","000","00","008","0815","1456","686","546","140","48","734","1271","0","57.75","42.96"
"63","000","00","008","0816","0000","2886","2282","604","144","3030","5159","0","58.73","44.23"
"63","000","00","008","0816","1457","925","696","229","43","968","1609","0","60.16","43.26"
"63","000","00","008","0816","1458","800","655","145","29","829","1501","0","55.23","43.64"
"63","000","00","008","0816","1459","512","403","109","39","551","997","0","55.27","40.42"
"63","000","00","008","0816","1460","649","528","121","33","682","1052","0","64.83","50.19"
"63","000","00","008","0817","0000","2980","2405","575","157","3137","4847","0","64.72","49.62"
"63","000","00","008","0817","1461","728","594","134","36","764","1247","0","61.27","47.63"
"63","000","00","008","0817","1462","839","687","152","47","886","1167","0","75.92","58.87"
"63","000","00","008","0817","1463","739","569","170","36","775","1280","0","60.55","44.45"
"63","000","00","008","0817","1464","674","555","119","38","712","1153","0","61.75","48.14"
"63","000","00","008","0818","0000","3317","2781","536","205","3522","5817","0","60.55","47.81"
"63","000","00","008","0818","1465","808","737","71","47","855","1557","0","54.91","47.33"
"63","000","00","008","0818","1466","808","655","153","55","863","1444","0","59.76","45.36"
"63","000","00","008","0818","1467","885","734","151","51","936","1459","0","64.15","50.31"
"63","000","00","008","0818","1468","816","655","161","52","868","1357","0","63.96","48.27"
"63","000","00","008","0819","0000","2946","2351","595","191","3137","4847","0","64.72","48.5"
"63","000","00","008","0819","1469","753","596","157","41","794","1194","0","66.5","49.92"
"63","000","00","008","0819","1470","713","576","137","52","765","1184","0","64.61","48.65"
"63","000","00","008","0819","1471","664","517","147","51","715","1119","0","63.9","46.2"
"63","000","00","008","0819","1472","816","662","154","47","863","1350","0","63.93","49.04"
"63","000","00","008","0820","0000","4181","3361","820","235","4416","7265","0","60.78","46.26"
"63","000","00","008","0820","1473","793","634","159","51","844","1502","0","56.19","42.21"
"63","000","00","008","0820","1474","852","693","159","55","907","1511","0","60.03","45.86"
"63","000","00","008","0820","1475","892","709","183","39","931","1481","0","62.86","47.87"
"63","000","00","008","0820","1476","894","730","164","39","933","1477","0","63.17","49.42"
"63","000","00","008","0820","1477","750","595","155","51","801","1294","0","61.9","45.98"
"63","000","00","008","0821","0000","2125","1658","467","125","2250","3516","0","63.99","47.16"
"63","000","00","008","0821","1478","678","532","146","32","710","1040","0","68.27","51.15"
"63","000","00","008","0821","1479","789","628","161","41","830","1323","0","62.74","47.47"
"63","000","00","008","0821","1480","658","498","160","52","710","1153","0","61.58","43.19"
"63","000","00","008","0822","0000","3327","2619","708","193","3520","5896","0","59.7","44.42"
"63","000","00","008","0822","1481","848","686","162","58","906","1525","0","59.41","44.98"
"63","000","00","008","0822","1482","749","604","145","51","800","1412","0","56.66","42.78"
"63","000","00","008","0822","1483","878","678","200","56","934","1473","0","63.41","46.03"
"63","000","00","008","0822","1484","852","651","201","28","880","1486","0","59.22","43.81"
"63","000","00","008","0823","0000","3556","2862","694","220","3776","6013","0","62.8","47.6"
"63","000","00","008","0823","1485","961","793","168","53","1014","1616","0","62.75","49.07"
"63","000","00","008","0823","1486","889","708","181","57","946","1489","0","63.53","47.55"
"63","000","00","008","0823","1487","795","627","168","54","849","1414","0","60.04","44.34"
"63","000","00","008","0823","1488","911","734","177","56","967","1494","0","64.73","49.13"
"63","000","00","008","0824","0000","4592","3625","967","238","4830","7764","0","62.21","46.69"
"63","000","00","008","0824","1489","905","720","185","50","955","1547","0","61.73","46.54"
"63","000","00","008","0824","1490","907","689","218","60","967","1587","0","60.93","43.42"
"63","000","00","008","0824","1491","933","748","185","33","966","1515","0","63.76","49.37"
"63","000","00","008","0824","1492","928","725","203","57","985","1573","0","62.62","46.09"
"63","000","00","008","0824","1493","919","743","176","38","957","1542","0","62.06","48.18"
"63","000","00","008","0825","0000","1715","1350","365","149","1864","3536","0","52.71","38.18"
"63","000","00","008","0825","1494","750","603","147","62","812","1465","0","55.43","41.16"
"63","000","00","008","0825","1495","313","228","85","29","342","699","0","48.93","32.62"
"63","000","00","008","0825","1496","652","519","133","58","710","1372","0","51.75","37.83"
"63","000","00","008","0826","0000","3316","2670","646","191","3507","6057","0","57.9","44.08"
"63","000","00","008","0826","1497","691","563","128","59","750","1448","0","51.8","38.88"
"63","000","00","008","0826","1498","859","687","172","54","913","1548","0","58.98","44.38"
"63","000","00","008","0826","1499","858","687","171","38","896","1501","0","59.69","45.77"
"63","000","00","008","0826","1500","908","733","175","40","948","1560","0","60.77","46.99"
"63","000","00","008","0827","0000","4415","3554","861","224","4639","7736","0","59.97","45.94"
"63","000","00","008","0827","1501","868","688","180","40","908","1567","0","57.95","43.91"
"63","000","00","008","0827","1502","868","705","163","48","916","1554","0","58.94","45.37"
"63","000","00","008","0827","1503","862","693","169","54","916","1544","0","59.33","44.88"
"63","000","00","008","0827","1504","883","726","157","48","931","1528","0","60.93","47.51"
"63","000","00","008","0827","1505","934","742","192","34","968","1543","0","62.73","48.09"
"63","000","00","008","0828","0000","4163","3264","899","332","4495","9127","0","49.25","35.76"
"63","000","00","008","0828","1506","905","695","210","59","964","2754","0","35.0","25.24"
"63","000","00","008","0828","1507","824","649","175","70","894","1709","0","52.31","37.98"
"63","000","00","008","0828","1508","798","630","168","72","870","1515","0","57.43","41.58"
"63","000","00","008","0828","1509","794","623","171","66","860","1571","0","54.74","39.66"
"63","000","00","008","0828","1510","842","667","175","65","907","1578","0","57.48","42.27"
"63","000","00","008","0829","0000","3628","2855","773","274","3902","6503","0","60.0","43.9"
"63","000","00","008","0829","1511","765","591","174","58","823","1454","0","56.6","40.65"
"63","000","00","008","0829","1512","793","625","168","61","854","1436","0","59.47","43.52"
"63","000","00","008","0829","1513","822","653","169","54","876","1402","0","62.48","46.58"
"63","000","00","008","0829","1514","658","517","141","42","700","1117","0","62.67","46.28"
"63","000","00","008","0829","1515","590","469","121","59","649","1094","0","59.32","42.87"
"63","000","00","008","0830","0000","4207","3437","770","253","4460","7402","0","60.25","46.43"
"63","000","00","008","0830","1519","742","596","146","43","785","1385","0","56.68","43.03"
"63","000","00","008","0830","1520","805","629","176","52","857","1416","0","60.52","44.42"
"63","000","00","008","0830","1521","851","788","63","48","899","1412","0","63.67","55.81"
"63","000","00","008","0830","1522","809","622","187","61","870","1535","0","56.68","40.52"
"63","000","00","008","0830","1523","1000","802","198","49","1049","1654","0","63.42","48.49"
"63","000","00","008","0831","0000","2811","2287","524","162","2973","4781","0","62.18","47.84"
"63","000","00","008","0831","1524","678","552","126","39","717","1156","0","62.02","47.75"
"63","000","00","008","0831","1525","728","594","134","45","773","1231","0","62.79","48.25"
"63","000","00","008","0831","1526","680","548","132","47","727","1218","0","59.69","44.99"
"63","000","00","008","0831","1527","725","593","132","31","756","1176","0","64.29","50.43"
"63","000","00","008","0832","0000","2699","2133","566","195","2894","4889","0","59.19","43.63"
"63","000","00","008","0832","1532","869","674","195","62","931","1613","0","57.72","41.79"
"63","000","00","008","0832","1533","964","749","215","63","1027","1697","0","60.52","44.14"
"63","000","00","008","0832","1534","866","710","156","70","936","1579","0","59.28","44.97"
"63","000","00","008","0833","0000","3913","3039","874","253","4166","6932","0","60.1","43.84"
"63","000","00","008","0833","1538","922","690","232","65","987","1646","0","59.96","41.92"
"63","000","00","008","0833","1539","736","579","157","44","780","1286","0","60.65","45.02"
"63","000","00","008","0833","1540","709","558","151","40","749","1219","0","61.44","45.78"
"63","000","00","008","0833","1541","757","586","171","46","803","1292","0","62.15","45.36"
"63","000","00","008","0833","1542","789","626","163","58","847","1489","0","56.88","42.04"
"63","000","00","008","0834","0000","2810","2244","566","130","2940","5133","0","57.28","43.72"
"63","000","00","008","0834","1547","859","682","177","32","891","1816","0","49.06","37.56"
"63","000","00","008","0834","1548","529","405","124","36","565","985","0","57.36","41.12"
"63","000","00","008","0834","1549","793","662","131","26","819","1314","0","62.33","50.38"
"63","000","00","008","0834","1550","629","495","134","36","665","1018","0","65.32","48.62"
"63","000","00","008","0835","0000","4013","3156","857","238","4251","7131","0","59.61","44.26"
"63","000","00","008","0835","1551","887","685","202","45","932","1578","0","59.06","43.41"
"63","000","00","008","0835","1552","833","650","183","26","859","1457","0","58.96","44.61"
"63","000","00","008","0835","1553","766","616","150","52","818","1326","0","61.69","46.46"
"63","000","00","008","0835","1554","800","636","164","54","854","1393","0","61.31","45.66"
"63","000","00","008","0835","1555","727","569","158","61","788","1377","0","57.23","41.32"
"63","000","00","008","0836","0000","1813","1407","406","166","1979","3454","0","57.3","40.74"
"63","000","00","008","0836","1560","747","588","159","45","792","1288","0","61.49","45.65"
"63","000","00","008","0836","1561","645","504","141","69","714","1301","0","54.88","38.74"
"63","000","00","008","0836","1562","421","315","106","52","473","865","0","54.68","36.42"
"63","000","00","008","0837","0000","401","297","104","38","439","789","0","55.64","37.64"
"63","000","00","008","0837","1563","401","297","104","38","439","789","0","55.64","37.64"
"63","000","00","008","0838","0000","2183","1763","420","131","2314","3615","0","64.01","48.77"
"63","000","00","008","0838","1516","640","508","132","46","686","1070","0","64.11","47.48"
"63","000","00","008","0838","1517","807","660","147","35","842","1319","0","63.84","50.04"
"63","000","00","008","0838","1518","736","595","141","50","786","1226","0","64.11","48.53"
"63","000","00","008","0839","0000","3332","2690","642","245","3577","6498","0","55.05","41.4"
"63","000","00","008","0839","1543","919","713","206","64","983","1611","0","61.02","44.26"
"63","000","00","008","0839","1544","660","584","76","51","711","1549","0","45.9","37.7"
"63","000","00","008","0839","1545","875","705","170","63","938","1678","0","55.9","42.01"
"63","000","00","008","0839","1546","878","688","190","67","945","1660","0","56.93","41.45"
"63","000","00","008","0840","0000","3604","2853","751","183","3787","6091","0","62.17","46.84"
"63","000","00","008","0840","1556","830","646","184","39","869","1448","0","60.01","44.61"
"63","000","00","008","0840","1557","866","688","178","47","913","1447","0","63.1","47.55"
"63","000","00","008","0840","1558","1070","837","233","60","1130","1739","0","64.98","48.13"
"63","000","00","008","0840","1559","838","682","156","37","875","1457","0","60.05","46.81"
"63","000","00","008","0841","0000","2961","2328","633","240","3201","5308","0","60.31","43.86"
"63","000","00","008","0841","1528","817","636","181","29","846","1392","0","60.78","45.69"
"63","000","00","008","0841","1529","701","553","148","93","794","1323","0","60.02","41.8"
"63","000","00","008","0841","1530","690","524","166","53","743","1297","0","57.29","40.4"
"63","000","00","008","0841","1531","753","615","138","65","818","1296","0","63.12","47.45"
"63","000","00","008","0842","0000","2495","2016","479","149","2644","4385","0","60.3","45.97"
"63","000","00","008","0842","1447","820","631","189","44","864","1444","0","59.83","43.7"
"63","000","00","008","0842","1448","847","694","153","52","899","1495","0","60.13","46.42"
"63","000","00","008","0842","1449","828","691","137","53","881","1446","0","60.93","47.79"
"63","000","00","008","0843","0000","2345","1890","455","106","2451","4223","0","58.04","44.75"
"63","000","00","008","0843","1535","790","629","161","46","836","1320","0","63.33","47.65"
"63","000","00","008","0843","1536","791","646","145","31","822","1438","0","57.16","44.92"
"63","000","00","008","0843","1537","764","615","149","29","793","1465","0","54.13","41.98"
"63","000","00","009","0000","0000","55226","43217","12009","3158","58384","101907","121769","57.29","42.41"
"63","000","00","009","0901","0000","2785","2151","634","146","2931","5655","0","51.83","38.04"
"63","000","00","009","0901","0455","633","495","138","29","662","1280","0","51.72","38.67"
"63","000","00","009","0901","0456","720","557","163","28","748","1351","0","55.37","41.23"
"63","000","00","009","0901","0457","733","584","149","42","775","1345","0","57.62","43.42"
"63","000","00","009","0901","0458","699","515","184","47","746","1679","0","44.43","30.67"
"63","000","00","009","0902","0000","1613","1239","374","126","1739","3315","0","52.46","37.38"
"63","000","00","009","0902","0459","827","613","214","77","904","1680","0","53.81","36.49"
"63","000","00","009","0902","0460","786","626","160","49","835","1635","0","51.07","38.29"
"63","000","00","009","0903","0000","2050","1604","446","158","2208","3486","0","63.34","46.01"
"63","000","00","009","0903","0465","663","521","142","42","705","1086","0","64.92","47.97"
"63","000","00","009","0903","0466","722","575","147","57","779","1202","0","64.81","47.84"
"63","000","00","009","0903","0467","665","508","157","59","724","1198","0","60.43","42.4"
"63","000","00","009","0904","0000","3329","2717","612","201","3530","6330","0","55.77","42.92"
"63","000","00","009","0904","0461","765","587","178","46","811","1459","0","55.59","40.23"
"63","000","00","009","0904","0462","916","720","196","32","948","1706","0","55.57","42.2"
"63","000","00","009","0904","0463","841","656","185","103","944","1674","0","56.39","39.19"
"63","000","00","009","0904","0464","807","754","53","20","827","1491","0","55.47","50.57"
"63","000","00","009","0905","0000","3335","2567","768","206","3541","6336","0","55.89","40.51"
"63","000","00","009","0905","0483","740","558","182","52","792","1518","0","52.17","36.76"
"63","000","00","009","0905","0484","887","679","208","69","956","1552","0","61.6","43.75"
"63","000","00","009","0905","0485","828","660","168","27","855","1658","0","51.57","39.81"
"63","000","00","009","0905","0486","880","670","210","58","938","1608","0","58.33","41.67"
"63","000","00","009","0906","0000","1729","1370","359","77","1806","3337","0","54.12","41.05"
"63","000","00","009","0906","0504","794","627","167","28","822","1649","0","49.85","38.02"
"63","000","00","009","0906","0505","935","743","192","49","984","1688","0","58.29","44.02"
"63","000","00","009","0907","0000","2292","1816","476","147","2439","4093","0","59.59","44.37"
"63","000","00","009","0907","0490","779","626","153","45","824","1397","0","58.98","44.81"
"63","000","00","009","0907","0491","750","588","162","56","806","1352","0","59.62","43.49"
"63","000","00","009","0907","0492","763","602","161","46","809","1344","0","60.19","44.79"
"63","000","00","009","0908","0000","2105","1609","496","115","2220","4165","0","53.3","38.63"
"63","000","00","009","0908","0493","689","517","172","28","717","1385","0","51.77","37.33"
"63","000","00","009","0908","0494","741","575","166","49","790","1399","0","56.47","41.1"
"63","000","00","009","0908","0495","675","517","158","38","713","1381","0","51.63","37.44"
"63","000","00","009","0909","0000","2257","1759","498","110","2367","4228","0","55.98","41.6"
"63","000","00","009","0909","0496","821","636","185","41","862","1548","0","55.68","41.09"
"63","000","00","009","0909","0497","610","493","117","31","641","1190","0","53.87","41.43"
"63","000","00","009","0909","0498","826","630","196","38","864","1490","0","57.99","42.28"
"63","000","00","009","0910","0000","3378","2634","744","164","3542","5983","0","59.2","44.02"
"63","000","00","009","0910","0499","638","494","144","24","662","1096","0","60.4","45.07"
"63","000","00","009","0910","0500","724","573","151","24","748","1238","0","60.42","46.28"
"63","000","00","009","0910","0501","736","586","150","29","765","1271","0","60.19","46.11"
"63","000","00","009","0910","0502","622","493","129","49","671","1146","0","58.55","43.02"
"63","000","00","009","0910","0503","658","488","170","38","696","1232","0","56.49","39.61"
"63","000","00","009","0911","0000","3852","3071","781","237","4089","6741","0","60.66","45.56"
"63","000","00","009","0911","0518","720","574","146","43","763","1225","0","62.29","46.86"
"63","000","00","009","0911","0519","750","583","167","52","802","1264","0","63.45","46.12"
"63","000","00","009","0911","0520","925","730","195","81","1006","1649","0","61.01","44.27"
"63","000","00","009","0911","0521","728","594","134","23","751","1267","0","59.27","46.88"
"63","000","00","009","0911","0522","729","590","139","38","767","1336","0","57.41","44.16"
"63","000","00","009","0912","0000","2136","1630","506","137","2273","3805","0","59.74","42.84"
"63","000","00","009","0912","0509","679","517","162","74","753","1195","0","63.01","43.26"
"63","000","00","009","0912","0510","723","509","214","15","738","1254","0","58.85","40.59"
"63","000","00","009","0912","0511","734","604","130","48","782","1356","0","57.67","44.54"
"63","000","00","009","0913","0000","2301","1799","502","131","2432","4011","0","60.63","44.85"
"63","000","00","009","0913","0512","778","598","180","56","834","1363","0","61.19","43.87"
"63","000","00","009","0913","0513","784","614","170","44","828","1317","0","62.87","46.62"
"63","000","00","009","0913","0514","739","587","152","31","770","1331","0","57.85","44.1"
"63","000","00","009","0914","0000","2542","1958","584","159","2701","4733","0","57.07","41.37"
"63","000","00","009","0914","0515","866","662","204","64","930","1610","0","57.76","41.12"
"63","000","00","009","0914","0516","811","629","182","27","838","1542","0","54.35","40.79"
"63","000","00","009","0914","0517","865","667","198","68","933","1581","0","59.01","42.19"
"63","000","00","009","0915","0000","2478","1916","562","127","2605","4508","0","57.79","42.5"
"63","000","00","009","0915","0506","851","664","187","39","890","1503","0","59.21","44.18"
"63","000","00","009","0915","0507","812","618","194","35","847","1542","0","54.93","40.08"
"63","000","00","009","0915","0508","815","634","181","53","868","1463","0","59.33","43.34"
"63","000","00","009","0916","0000","3907","3032","875","268","4175","7922","0","52.7","38.27"
"63","000","00","009","0916","0478","775","582","193","61","836","1529","0","54.68","38.06"
"63","000","00","009","0916","0479","803","623","180","51","854","1618","0","52.78","38.5"
"63","000","00","009","0916","0480","688","527","161","64","752","1545","0","48.67","34.11"
"63","000","00","009","0916","0481","843","663","180","56","899","1569","0","57.3","42.26"
"63","000","00","009","0916","0482","798","637","161","36","834","1661","0","50.21","38.35"
"63","000","00","009","0917","0000","4538","3515","1023","252","4790","8171","0","58.62","43.02"
"63","000","00","009","0917","0468","706","543","163","33","739","1430","0","51.68","37.97"
"63","000","00","009","0917","0469","730","520","210","56","786","1275","0","61.65","40.78"
"63","000","00","009","0917","0470","815","634","181","52","867","1344","0","64.51","47.17"
"63","000","00","009","0917","0471","777","594","183","43","820","1391","0","58.95","42.7"
"63","000","00","009","0917","0472","792","656","136","30","822","1342","0","61.25","48.88"
"63","000","00","009","0917","0473","718","568","150","38","756","1389","0","54.43","40.89"
"63","000","00","009","0918","0000","3158","2514","644","141","3299","5592","0","58.99","44.96"
"63","000","00","009","0918","0474","813","621","192","40","853","1426","0","59.82","43.55"
"63","000","00","009","0918","0475","794","665","129","22","816","1359","0","60.04","48.93"
"63","000","00","009","0918","0476","739","581","158","53","792","1366","0","57.98","42.53"
"63","000","00","009","0918","0477","812","647","165","26","838","1441","0","58.15","44.9"
"63","000","00","009","0919","0000","2813","2279","534","142","2955","4916","0","60.11","46.36"
"63","000","00","009","0919","0523","685","554","131","27","712","1162","0","61.27","47.68"
"63","000","00","009","0919","0524","580","463","117","30","610","1045","0","58.37","44.31"
"63","000","00","009","0919","0525","807","649","158","56","863","1351","0","63.88","48.04"
"63","000","00","009","0919","0526","741","613","128","29","770","1358","0","56.7","45.14"
"63","000","00","009","0920","0000","2628","2037","591","114","2742","4580","0","59.87","44.48"
"63","000","00","009","0920","0487","762","595","167","39","801","1475","0","54.31","40.34"
"63","000","00","009","0920","0488","1014","782","232","44","1058","1722","0","61.44","45.41"
"63","000","00","009","0920","0489","852","660","192","31","883","1383","0","63.85","47.72"
"63","000","00","010","0000","0000","129812","101149","28663","7239","137051","236824","287227","57.87","42.71"
"63","000","00","010","1001","0000","3443","2637","806","248","3691","6500","0","56.78","40.57"
"63","000","00","010","1001","0305","803","628","175","34","837","1661","0","50.39","37.81"
"63","000","00","010","1001","0306","829","610","219","64","893","1602","0","55.74","38.08"
"63","000","00","010","1001","0307","912","717","195","99","1011","1655","0","61.09","43.32"
"63","000","00","010","1001","0308","899","682","217","51","950","1582","0","60.05","43.11"
"63","000","00","010","1002","0000","4516","3447","1069","308","4824","8357","0","57.72","41.25"
"63","000","00","010","1002","0309","884","701","183","37","921","1688","0","54.56","41.53"
"63","000","00","010","1002","0310","935","621","314","58","993","1737","0","57.17","35.75"
"63","000","00","010","1002","0311","1001","788","213","63","1064","1809","0","58.82","43.56"
"63","000","00","010","1002","0312","727","567","160","59","786","1376","0","57.12","41.21"
"63","000","00","010","1002","0313","969","770","199","91","1060","1747","0","60.68","44.08"
"63","000","00","010","1003","0000","3501","2681","820","170","3671","5914","0","62.07","45.33"
"63","000","00","010","1003","0314","806","621","185","27","833","1389","0","59.97","44.71"
"63","000","00","010","1003","0315","860","681","179","43","903","1454","0","62.1","46.84"
"63","000","00","010","1003","0316","877","645","232","54","931","1468","0","63.42","43.94"
"63","000","00","010","1003","0317","958","734","224","46","1004","1603","0","62.63","45.79"
"63","000","00","010","1005","0000","2942","2272","670","171","3113","5276","0","59.0","43.06"
"63","000","00","010","1005","0318","955","729","226","31","986","1795","0","54.93","40.61"
"63","000","00","010","1005","0319","1024","795","229","60","1084","1737","0","62.41","45.77"
"63","000","00","010","1005","0320","963","748","215","80","1043","1744","0","59.81","42.89"
"63","000","00","010","1006","0000","2661","2031","630","140","2801","4732","0","59.19","42.92"
"63","000","00","010","1006","0321","912","720","192","64","976","1661","0","58.76","43.35"
"63","000","00","010","1006","0322","868","636","232","50","918","1577","0","58.21","40.33"
"63","000","00","010","1006","0323","881","675","206","26","907","1494","0","60.71","45.18"
"63","000","00","010","1007","0000","4585","3575","1010","307","4892","8285","0","59.05","43.15"
"63","000","00","010","1007","0324","890","703","187","60","950","1626","0","58.43","43.23"
"63","000","00","010","1007","0325","900","702","198","72","972","1641","0","59.23","42.78"
"63","000","00","010","1007","0326","858","680","178","62","920","1554","0","59.2","43.76"
"63","000","00","010","1007","0327","1012","772","240","55","1067","1728","0","61.75","44.68"
"63","000","00","010","1007","0328","925","718","207","58","983","1736","0","56.62","41.36"
"63","000","00","010","1008","0000","4308","3238","1070","185","4493","7740","0","58.05","41.83"
"63","000","00","010","1008","0329","890","600","290","44","934","1461","0","63.93","41.07"
"63","000","00","010","1008","0330","832","646","186","41","873","1509","0","57.85","42.81"
"63","000","00","010","1008","0331","738","537","201","25","763","1358","0","56.19","39.54"
"63","000","00","010","1008","0332","949","753","196","42","991","1761","0","56.27","42.76"
"63","000","00","010","1008","0333","899","702","197","33","932","1651","0","56.45","42.52"
"63","000","00","010","1009","0000","2971","2392","579","179","3150","5472","0","57.57","43.71"
"63","000","00","010","1009","0334","1009","817","192","71","1080","1809","0","59.7","45.16"
"63","000","00","010","1009","0335","969","781","188","58","1027","1773","0","57.92","44.05"
"63","000","00","010","1009","0336","993","794","199","50","1043","1890","0","55.19","42.01"
"63","000","00","010","1010","0000","4251","3159","1092","193","4444","7310","0","60.79","43.21"
"63","000","00","010","1010","0337","1077","804","273","62","1139","1760","0","64.72","45.68"
"63","000","00","010","1010","0338","937","751","186","35","972","1645","0","59.09","45.65"
"63","000","00","010","1010","0339","788","632","156","25","813","1324","0","61.4","47.73"
"63","000","00","010","1010","0340","637","515","122","32","669","1072","0","62.41","48.04"
"63","000","00","010","1010","0341","812","457","355","39","851","1509","0","56.39","30.28"
"63","000","00","010","1011","0000","3956","3026","930","218","4174","7069","0","59.05","42.81"
"63","000","00","010","1011","0342","934","712","222","58","992","1715","0","57.84","41.52"
"63","000","00","010","1011","0343","981","762","219","57","1038","1774","0","58.51","42.95"
"63","000","00","010","1011","0344","1066","818","248","67","1133","1796","0","63.08","45.55"
"63","000","00","010","1011","0345","975","734","241","36","1011","1784","0","56.67","41.14"
"63","000","00","010","1012","0000","2771","2082","689","157","2928","4835","0","60.56","43.06"
"63","000","00","010","1012","0346","817","599","218","61","878","1417","0","61.96","42.27"
"63","000","00","010","1012","0347","931","695","236","40","971","1699","0","57.15","40.91"
"63","000","00","010","1012","0348","1023","788","235","56","1079","1719","0","62.77","45.84"
"63","000","00","010","1013","0000","2485","1932","553","136","2621","4784","0","54.79","40.38"
"63","000","00","010","1013","0349","952","718","234","28","980","1715","0","57.14","41.87"
"63","000","00","010","1013","0350","790","627","163","34","824","1634","0","50.43","38.37"
"63","000","00","010","1013","0351","743","587","156","74","817","1435","0","56.93","40.91"
"63","000","00","010","1014","0000","3180","2523","657","187","3367","5804","0","58.01","43.47"
"63","000","00","010","1014","0352","783","632","151","27","810","1440","0","56.25","43.89"
"63","000","00","010","1014","0353","850","674","176","30","880","1446","0","60.86","46.61"
"63","000","00","010","1014","0354","838","659","179","60","898","1657","0","54.19","39.77"
"63","000","00","010","1014","0355","709","558","151","70","779","1261","0","61.78","44.25"
"63","000","00","010","1015","0000","3567","2767","800","200","3767","6183","0","60.93","44.75"
"63","000","00","010","1015","0356","208","152","56","28","236","456","0","51.75","33.33"
"63","000","00","010","1015","0357","902","712","190","40","942","1433","0","65.74","49.69"
"63","000","00","010","1015","0358","858","643","215","39","897","1485","0","60.4","43.3"
"63","000","00","010","1015","0359","870","676","194","41","911","1590","0","57.3","42.52"
"63","000","00","010","1015","0360","729","584","145","52","781","1219","0","64.07","47.91"
"63","000","00","010","1016","0000","2799","2238","561","142","2941","5096","0","57.71","43.92"
"63","000","00","010","1016","0361","913","723","190","58","971","1732","0","56.06","41.74"
"63","000","00","010","1016","0362","971","801","170","29","1000","1727","0","57.9","46.38"
"63","000","00","010","1016","0363","915","714","201","55","970","1637","0","59.25","43.62"
"63","000","00","010","1017","0000","4146","3259","887","180","4326","7433","0","58.2","43.85"
"63","000","00","010","1017","0364","786","619","167","47","833","1453","0","57.33","42.6"
"63","000","00","010","1017","0365","869","690","179","30","899","1617","0","55.6","42.67"
"63","000","00","010","1017","0366","872","709","163","27","899","1604","0","56.05","44.2"
"63","000","00","010","1017","0367","852","657","195","33","885","1406","0","62.94","46.73"
"63","000","00","010","1017","0368","767","584","183","43","810","1353","0","59.87","43.16"
"63","000","00","010","1018","0000","3412","2715","697","170","3582","6052","0","59.19","44.86"
"63","000","00","010","1018","0369","988","797","191","52","1040","1724","0","60.32","46.23"
"63","000","00","010","1018","0370","788","602","186","44","832","1378","0","60.38","43.69"
"63","000","00","010","1018","0371","810","658","152","39","849","1403","0","60.51","46.9"
"63","000","00","010","1018","0372","826","658","168","35","861","1547","0","55.66","42.53"
"63","000","00","010","1019","0000","4087","3131","956","221","4308","7177","0","60.03","43.63"
"63","000","00","010","1019","0373","976","738","238","55","1031","1718","0","60.01","42.96"
"63","000","00","010","1019","0374","986","748","238","50","1036","1813","0","57.14","41.26"
"63","000","00","010","1019","0375","1052","819","233","64","1116","1791","0","62.31","45.73"
"63","000","00","010","1019","0376","1073","826","247","52","1125","1855","0","60.65","44.53"
"63","000","00","010","1020","0000","3836","3099","737","202","4038","6880","0","58.69","45.04"
"63","000","00","010","1020","0377","960","770","190","32","992","1731","0","57.31","44.48"
"63","000","00","010","1020","0378","963","767","196","57","1020","1593","0","64.03","48.15"
"63","000","00","010","1020","0379","955","795","160","56","1011","1869","0","54.09","42.54"
"63","000","00","010","1020","0380","958","767","191","57","1015","1687","0","60.17","45.47"
"63","000","00","010","1021","0000","2402","1917","485","133","2535","4144","0","61.17","46.26"
"63","000","00","010","1021","0381","859","650","209","33","892","1530","0","58.3","42.48"
"63","000","00","010","1021","0382","745","602","143","55","800","1300","0","61.54","46.31"
"63","000","00","010","1021","0383","798","665","133","45","843","1314","0","64.16","50.61"
"63","000","00","010","1022","0000","4689","3743","946","257","4946","8925","0","55.42","41.94"
"63","000","00","010","1022","0384","700","546","154","28","728","1433","0","50.8","38.1"
"63","000","00","010","1022","0385","746","621","125","45","791","1450","0","54.55","42.83"
"63","000","00","010","1022","0386","858","679","179","67","925","1608","0","57.52","42.23"
"63","000","00","010","1022","0387","792","641","151","42","834","1414","0","58.98","45.33"
"63","000","00","010","1022","0388","823","647","176","41","864","1492","0","57.91","43.36"
"63","000","00","010","1022","0389","770","609","161","34","804","1528","0","52.62","39.86"
"63","000","00","010","1023","0000","3567","2755","812","173","3740","6634","0","56.38","41.53"
"63","000","00","010","1023","0390","927","721","206","50","977","1692","0","57.74","42.61"
"63","000","00","010","1023","0391","873","668","205","52","925","1556","0","59.45","42.93"
"63","000","00","010","1023","0392","866","680","186","27","893","1637","0","54.55","41.54"
"63","000","00","010","1023","0393","901","686","215","44","945","1749","0","54.03","39.22"
"63","000","00","010","1024","0000","3951","3113","838","244","4195","7348","0","57.09","42.37"
"63","000","00","010","1024","0394","638","504","134","36","674","1220","0","55.25","41.31"
"63","000","00","010","1024","0395","863","659","204","57","920","1600","0","57.5","41.19"
"63","000","00","010","1024","0396","800","639","161","49","849","1473","0","57.64","43.38"
"63","000","00","010","1024","0397","803","619","184","58","861","1498","0","57.48","41.32"
"63","000","00","010","1024","0398","847","692","155","44","891","1557","0","57.23","44.44"
"63","000","00","010","1025","0000","2204","1711","493","127","2331","4190","0","55.63","40.84"
"63","000","00","010","1025","0399","861","675","186","38","899","1674","0","53.7","40.32"
"63","000","00","010","1025","0400","985","776","209","49","1034","1728","0","59.84","44.91"
"63","000","00","010","1025","0401","358","260","98","40","398","788","0","50.51","32.99"
"63","000","00","010","1026","0000","3710","2827","883","192","3902","7138","0","54.67","39.6"
"63","000","00","010","1026","0402","803","571","232","66","869","1542","0","56.36","37.03"
"63","000","00","010","1026","0403","785","596","189","58","843","1676","0","50.3","35.56"
"63","000","00","010","1026","0404","664","481","183","23","687","1360","0","50.51","35.37"
"63","000","00","010","1026","0405","761","612","149","30","791","1259","0","62.83","48.61"
"63","000","00","010","1026","0406","697","567","130","15","712","1301","0","54.73","43.58"
"63","000","00","010","1027","0000","3153","2462","691","161","3314","5998","0","55.25","41.05"
"63","000","00","010","1027","0407","608","454","154","35","643","1251","0","51.4","36.29"
"63","000","00","010","1027","0408","787","619","168","63","850","1502","0","56.59","41.21"
"63","000","00","010","1027","0409","848","679","169","42","890","1596","0","55.76","42.54"
"63","000","00","010","1027","0410","910","710","200","21","931","1649","0","56.46","43.06"
"63","000","00","010","1028","0000","1793","1432","361","100","1893","3520","0","53.78","40.68"
"63","000","00","010","1028","0411","918","744","174","57","975","1774","0","54.96","41.94"
"63","000","00","010","1028","0412","875","688","187","43","918","1746","0","52.58","39.4"
"63","000","00","010","1029","0000","3351","2595","756","213","3564","7676","0","46.43","33.81"
"63","000","00","010","1029","0413","772","613","159","25","797","1473","0","54.11","41.62"
"63","000","00","010","1029","0414","898","710","188","71","969","2824","0","34.31","25.14"
"63","000","00","010","1029","0415","904","671","233","48","952","1849","0","51.49","36.29"
"63","000","00","010","1029","0416","777","601","176","69","846","1530","0","55.29","39.28"
"63","000","00","010","1030","0000","2640","2043","597","159","2799","4808","0","58.22","42.49"
"63","000","00","010","1030","0417","876","682","194","61","937","1656","0","56.58","41.18"
"63","000","00","010","1030","0418","808","609","199","41","849","1457","0","58.27","41.8"
"63","000","00","010","1030","0419","956","752","204","57","1013","1695","0","59.76","44.37"
"63","000","00","010","1031","0000","3677","2887","790","185","3862","6644","0","58.13","43.45"
"63","000","00","010","1031","0420","945","744","201","39","984","1663","0","59.17","44.74"
"63","000","00","010","1031","0421","890","709","181","54","944","1654","0","57.07","42.87"
"63","000","00","010","1031","0422","926","726","200","54","980","1642","0","59.68","44.21"
"63","000","00","010","1031","0423","916","708","208","38","954","1685","0","56.62","42.02"
"63","000","00","010","1032","0000","3127","2439","688","182","3309","5552","0","59.6","43.93"
"63","000","00","010","1032","0424","990","745","245","56","1046","1862","0","56.18","40.01"
"63","000","00","010","1032","0425","1069","847","222","59","1128","1900","0","59.37","44.58"
"63","000","00","010","1032","0426","1068","847","221","67","1135","1790","0","63.41","47.32"
"63","000","00","010","1033","0000","2515","1981","534","178","2693","4787","0","56.26","41.38"
"63","000","00","010","1033","0427","755","610","145","59","814","1417","0","57.45","43.05"
"63","000","00","010","1033","0428","914","707","207","52","966","1694","0","57.02","41.74"
"63","000","00","010","1033","0429","846","664","182","67","913","1676","0","54.47","39.62"
"63","000","00","010","1034","0000","4519","3588","931","234","4753","8109","0","58.61","44.25"
"63","000","00","010","1034","0430","886","670","216","26","912","1643","0","55.51","40.78"
"63","000","00","010","1034","0431","880","696","184","50","930","1588","0","58.56","43.83"
"63","000","00","010","1034","0432","895","719","176","58","953","1603","0","59.45","44.85"
"63","000","00","010","1034","0433","899","730","169","46","945","1629","0","58.01","44.81"
"63","000","00","010","1034","0434","959","773","186","54","1013","1646","0","61.54","46.96"
"63","000","00","010","1035","0000","4022","3201","821","272","4294","7457","0","57.58","42.93"
"63","000","00","010","1035","0435","991","784","207","50","1041","1883","0","55.28","41.64"
"63","000","00","010","1035","0436","765","590","175","53","818","1434","0","57.04","41.14"
"63","000","00","010","1035","0437","766","619","147","35","801","1418","0","56.49","43.65"
"63","000","00","010","1035","0438","752","603","149","65","817","1373","0","59.5","43.92"
"63","000","00","010","1035","0439","748","605","143","69","817","1349","0","60.56","44.85"
"63","000","00","010","1036","0000","2631","2083","548","173","2804","4624","0","60.64","45.05"
"63","000","00","010","1036","0440","874","680","194","60","934","1511","0","61.81","45.0"
"63","000","00","010","1036","0441","902","722","180","64","966","1563","0","61.8","46.19"
"63","000","00","010","1036","0442","855","681","174","49","904","1550","0","58.32","43.94"
"63","000","00","010","1037","0000","602","472","130","52","654","1157","0","56.53","40.8"
"63","000","00","010","1037","0443","602","472","130","52","654","1157","0","56.53","40.8"
"63","000","00","010","1038","0000","2839","2203","636","173","3012","5175","0","58.2","42.57"
"63","000","00","010","1038","0444","967","720","247","50","1017","1768","0","57.52","40.72"
"63","000","00","010","1038","0445","919","745","174","54","973","1664","0","58.47","44.77"
"63","000","00","010","1038","0446","953","738","215","69","1022","1743","0","58.63","42.34"
"63","000","00","010","1039","0000","4229","3319","910","175","4404","7392","0","59.58","44.9"
"63","000","00","010","1039","0447","841","672","169","24","865","1480","0","58.45","45.41"
"63","000","00","010","1039","0448","916","693","223","57","973","1589","0","61.23","43.61"
"63","000","00","010","1039","0449","759","592","167","34","793","1371","0","57.84","43.18"
"63","000","00","010","1039","0450","928","728","200","46","974","1575","0","61.84","46.22"
"63","000","00","010","1039","0451","785","634","151","14","799","1377","0","58.02","46.04"
"63","000","00","010","1040","0000","2774","2174","600","142","2916","4647","0","62.75","46.78"
"63","000","00","010","1040","0452","907","713","194","65","972","1469","0","66.17","48.54"
"63","000","00","010","1040","0453","918","709","209","21","939","1529","0","61.41","46.37"
"63","000","00","010","1040","0454","949","752","197","56","1005","1649","0","60.95","45.6"
"63","000","00","011","0000","0000","127649","96156","31493","9864","137513","241854","286695","56.86","39.76"
"63","000","00","011","1101","0000","1778","1319","459","176","1954","3415","0","57.22","38.62"
"63","000","00","011","1101","0142","856","613","243","83","939","1695","0","55.4","36.17"
"63","000","00","011","1101","0143","922","706","216","93","1015","1720","0","59.01","41.05"
"63","000","00","011","1102","0000","1465","1095","370","139","1604","2834","0","56.6","38.64"
"63","000","00","011","1102","0144","669","519","150","76","745","1288","0","57.84","40.3"
"63","000","00","011","1102","0145","796","576","220","63","859","1546","0","55.56","37.26"
"63","000","00","011","1103","0000","1483","1097","386","119","1602","2659","0","60.25","41.26"
"63","000","00","011","1103","0146","380","303","77","31","411","652","0","63.04","46.47"
"63","000","00","011","1103","0147","447","352","95","38","485","870","0","55.75","40.46"
"63","000","00","011","1103","0148","656","442","214","50","706","1137","0","62.09","38.87"
"63","000","00","011","1104","0000","2256","1698","558","204","2460","5331","0","46.15","31.85"
"63","000","00","011","1104","0149","601","444","157","63","664","1050","0","63.24","42.29"
"63","000","00","011","1104","0150","583","449","134","59","642","1031","0","62.27","43.55"
"63","000","00","011","1104","0151","601","442","159","33","634","1075","0","58.98","41.12"
"63","000","00","011","1104","0152","471","363","108","49","520","2175","0","23.91","16.69"
"63","000","00","011","1105","0000","3622","2781","841","247","3869","6757","0","57.26","41.16"
"63","000","00","011","1105","0153","880","678","202","70","950","1775","0","53.52","38.2"
"63","000","00","011","1105","0154","838","731","107","44","882","1669","0","52.85","43.8"
"63","000","00","011","1105","0155","949","689","260","68","1017","1665","0","61.08","41.38"
"63","000","00","011","1105","0156","955","683","272","65","1020","1648","0","61.89","41.44"
"63","000","00","011","1106","0000","3008","2220","788","263","3271","5565","0","58.78","39.89"
"63","000","00","011","1106","0157","678","521","157","30","708","1246","0","56.82","41.81"
"63","000","00","011","1106","0158","735","541","194","77","812","1419","0","57.22","38.13"
"63","000","00","011","1106","0159","698","515","183","77","775","1327","0","58.4","38.81"
"63","000","00","011","1106","0160","897","643","254","79","976","1573","0","62.05","40.88"
"63","000","00","011","1107","0000","3696","2777","919","211","3907","6779","0","57.63","40.96"
"63","000","00","011","1107","0161","798","628","170","73","871","1470","0","59.25","42.72"
"63","000","00","011","1107","0162","948","695","253","27","975","1775","0","54.93","39.15"
"63","000","00","011","1107","0163","938","705","233","55","993","1692","0","58.69","41.67"
"63","000","00","011","1107","0164","1012","749","263","56","1068","1842","0","57.98","40.66"
"63","000","00","011","1108","0000","3837","2869","968","346","4183","7204","0","58.06","39.83"
"63","000","00","011","1108","0165","665","512","153","50","715","1166","0","61.32","43.91"
"63","000","00","011","1108","0166","798","601","197","76","874","1687","0","51.81","35.63"
"63","000","00","011","1108","0167","849","634","215","71","920","1624","0","56.65","39.04"
"63","000","00","011","1108","0168","826","622","204","97","923","1477","0","62.49","42.11"
"63","000","00","011","1108","0169","699","500","199","52","751","1250","0","60.08","40.0"
"63","000","00","011","1109","0000","3316","2504","812","301","3617","5934","0","60.95","42.2"
"63","000","00","011","1109","0170","765","580","185","92","857","1434","0","59.76","40.45"
"63","000","00","011","1109","0171","810","602","208","62","872","1452","0","60.06","41.46"
"63","000","00","011","1109","0172","891","670","221","70","961","1533","0","62.69","43.71"
"63","000","00","011","1109","0173","850","652","198","77","927","1515","0","61.19","43.04"
"63","000","00","011","1110","0000","2193","1660","533","177","2370","3942","0","60.12","42.11"
"63","000","00","011","1110","0174","672","494","178","59","731","1203","0","60.76","41.06"
"63","000","00","011","1110","0175","846","652","194","81","927","1487","0","62.34","43.85"
"63","000","00","011","1110","0176","675","514","161","37","712","1252","0","56.87","41.05"
"63","000","00","011","1111","0000","3386","2467","919","261","3647","6175","0","59.06","39.95"
"63","000","00","011","1111","0177","800","595","205","58","858","1536","0","55.86","38.74"
"63","000","00","011","1111","0178","866","589","277","77","943","1556","0","60.6","37.85"
"63","000","00","011","1111","0179","827","618","209","52","879","1511","0","58.17","40.9"
"63","000","00","011","1111","0180","893","665","228","74","967","1572","0","61.51","42.3"
"63","000","00","011","1112","0000","2551","1987","564","254","2805","4921","0","57.0","40.38"
"63","000","00","011","1112","0181","880","693","187","79","959","1668","0","57.49","41.55"
"63","000","00","011","1112","0182","857","668","189","102","959","1685","0","56.91","39.64"
"63","000","00","011","1112","0183","814","626","188","73","887","1568","0","56.57","39.92"
"63","000","00","011","1113","0000","2909","2210","699","218","3127","5632","0","55.52","39.24"
"63","000","00","011","1113","0184","682","508","174","47","729","1327","0","54.94","38.28"
"63","000","00","011","1113","0185","676","520","156","42","718","1338","0","53.66","38.86"
"63","000","00","011","1113","0186","745","564","181","60","805","1515","0","53.14","37.23"
"63","000","00","011","1113","0187","806","618","188","69","875","1452","0","60.26","42.56"
"63","000","00","011","1114","0000","2398","1795","603","157","2555","4430","0","57.67","40.52"
"63","000","00","011","1114","0188","787","606","181","60","847","1448","0","58.49","41.85"
"63","000","00","011","1114","0189","833","628","205","56","889","1521","0","58.45","41.29"
"63","000","00","011","1114","0190","778","561","217","41","819","1461","0","56.06","38.4"
"63","000","00","011","1115","0000","2281","1670","611","202","2483","4747","0","52.31","35.18"
"63","000","00","011","1115","0191","764","547","217","68","832","1541","0","53.99","35.5"
"63","000","00","011","1115","0192","691","499","192","59","750","1611","0","46.55","30.97"
"63","000","00","011","1115","0193","826","624","202","75","901","1595","0","56.49","39.12"
"63","000","00","011","1116","0000","2582","1946","636","214","2796","5188","0","53.89","37.51"
"63","000","00","011","1116","0194","827","647","180","39","866","1685","0","51.39","38.4"
"63","000","00","011","1116","0195","886","660","226","84","970","1816","0","53.41","36.34"
"63","000","00","011","1116","0196","869","639","230","91","960","1687","0","56.91","37.88"
"63","000","00","011","1117","0000","3466","2687","779","288","3754","6631","0","56.61","40.52"
"63","000","00","011","1117","0197","845","643","202","88","933","1646","0","56.68","39.06"
"63","000","00","011","1117","0198","818","644","174","64","882","1643","0","53.68","39.2"
"63","000","00","011","1117","0199","910","733","177","57","967","1687","0","57.32","43.45"
"63","000","00","011","1117","0200","893","667","226","79","972","1655","0","58.73","40.3"
"63","000","00","011","1118","0000","1892","1386","506","98","1990","3634","0","54.76","38.14"
"63","000","00","011","1118","0201","886","646","240","30","916","1779","0","51.49","36.31"
"63","000","00","011","1118","0202","1006","740","266","68","1074","1855","0","57.9","39.89"
"63","000","00","011","1119","0000","2678","2022","656","226","2904","5700","0","50.95","35.47"
"63","000","00","011","1119","0203","723","547","176","58","781","1350","0","57.85","40.52"
"63","000","00","011","1119","0204","706","548","158","30","736","1455","0","50.58","37.66"
"63","000","00","011","1119","0205","646","485","161","74","720","1497","0","48.1","32.4"
"63","000","00","011","1119","0206","603","442","161","64","667","1398","0","47.71","31.62"
"63","000","00","011","1120","0000","4116","3069","1047","393","4509","8041","0","56.08","38.17"
"63","000","00","011","1120","0207","946","699","247","80","1026","1747","0","58.73","40.01"
"63","000","00","011","1120","0208","746","564","182","81","827","1465","0","56.45","38.5"
"63","000","00","011","1120","0209","795","585","210","71","866","1530","0","56.6","38.24"
"63","000","00","011","1120","0210","884","671","213","83","967","1855","0","52.13","36.17"
"63","000","00","011","1120","0211","745","550","195","78","823","1444","0","56.99","38.09"
"63","000","00","011","1121","0000","3211","2415","796","339","3550","6387","0","55.58","37.81"
"63","000","00","011","1121","0212","746","572","174","85","831","1563","0","53.17","36.6"
"63","000","00","011","1121","0213","769","574","195","78","847","1482","0","57.15","38.73"
"63","000","00","011","1121","0214","764","565","199","98","862","1552","0","55.54","36.4"
"63","000","00","011","1121","0215","932","704","228","78","1010","1790","0","56.42","39.33"
"63","000","00","011","1122","0000","3136","2463","673","359","3495","6383","0","54.75","38.59"
"63","000","00","011","1122","0216","771","599","172","83","854","1628","0","52.46","36.79"
"63","000","00","011","1122","0217","680","590","90","78","758","1337","0","56.69","44.13"
"63","000","00","011","1122","0218","896","682","214","93","989","1750","0","56.51","38.97"
"63","000","00","011","1122","0219","789","592","197","105","894","1668","0","53.6","35.49"
"63","000","00","011","1123","0000","1886","1354","532","182","2068","4342","0","47.63","31.18"
"63","000","00","011","1123","0220","586","433","153","83","669","1403","0","47.68","30.86"
"63","000","00","011","1123","0221","645","441","204","58","703","1468","0","47.89","30.04"
"63","000","00","011","1123","0222","655","480","175","41","696","1471","0","47.31","32.63"
"63","000","00","011","1124","0000","2433","1837","596","226","2659","5240","0","50.74","35.06"
"63","000","00","011","1124","0223","790","611","179","94","884","1666","0","53.06","36.67"
"63","000","00","011","1124","0224","762","559","203","61","823","1587","0","51.86","35.22"
"63","000","00","011","1124","0225","881","667","214","71","952","1987","0","47.91","33.57"
"63","000","00","011","1125","0000","1563","1208","355","97","1660","2999","0","55.35","40.28"
"63","000","00","011","1125","0226","602","470","132","22","624","1271","0","49.1","36.98"
"63","000","00","011","1125","0227","961","738","223","75","1036","1728","0","59.95","42.71"
"63","000","00","011","1126","0000","3500","2636","864","245","3745","6297","0","59.47","41.86"
"63","000","00","011","1126","0228","905","688","217","72","977","1630","0","59.94","42.21"
"63","000","00","011","1126","0229","892","657","235","61","953","1619","0","58.86","40.58"
"63","000","00","011","1126","0230","775","598","177","43","818","1425","0","57.4","41.96"
"63","000","00","011","1126","0231","928","693","235","69","997","1623","0","61.43","42.7"
"63","000","00","011","1127","0000","2194","1620","574","171","2365","3862","0","61.24","41.95"
"63","000","00","011","1127","0242","763","552","211","68","831","1273","0","65.28","43.36"
"63","000","00","011","1127","0243","711","546","165","49","760","1273","0","59.7","42.89"
"63","000","00","011","1127","0244","720","522","198","54","774","1316","0","58.81","39.67"
"63","000","00","011","1128","0000","2620","1943","677","179","2799","4960","0","56.43","39.17"
"63","000","00","011","1128","0245","889","672","217","68","957","1659","0","57.69","40.51"
"63","000","00","011","1128","0246","916","676","240","41","957","1749","0","54.72","38.65"
"63","000","00","011","1128","0247","815","595","220","70","885","1552","0","57.02","38.34"
"63","000","00","011","1129","0000","2606","2008","598","294","2900","4457","0","65.07","45.05"
"63","000","00","011","1129","0232","872","639","233","50","922","1564","0","58.95","40.86"
"63","000","00","011","1129","0233","837","636","201","201","1038","1376","0","75.44","46.22"
"63","000","00","011","1129","0234","897","733","164","43","940","1517","0","61.96","48.32"
"63","000","00","011","1130","0000","2663","2033","630","149","2812","4952","0","56.79","41.05"
"63","000","00","011","1130","0248","846","671","175","50","896","1529","0","58.6","43.88"
"63","000","00","011","1130","0249","872","655","217","37","909","1644","0","55.29","39.84"
"63","000","00","011","1130","0250","945","707","238","62","1007","1779","0","56.6","39.74"
"63","000","00","011","1131","0000","3586","2763","823","188","3774","6584","0","57.32","41.97"
"63","000","00","011","1131","0235","873","638","235","43","916","1729","0","52.98","36.9"
"63","000","00","011","1131","0236","877","692","185","49","926","1511","0","61.28","45.8"
"63","000","00","011","1131","0237","1017","787","230","52","1069","1811","0","59.03","43.46"
"63","000","00","011","1131","0238","819","646","173","44","863","1533","0","56.29","42.14"
"63","000","00","011","1132","0000","2560","2005","555","170","2730","4558","0","59.89","43.99"
"63","000","00","011","1132","0239","1013","786","227","61","1074","1657","0","64.82","47.44"
"63","000","00","011","1132","0240","803","633","170","44","847","1499","0","56.5","42.23"
"63","000","00","011","1132","0241","744","586","158","65","809","1402","0","57.7","41.8"
"63","000","00","011","1133","0000","2696","2036","660","195","2891","5127","0","56.39","39.71"
"63","000","00","011","1133","0260","944","704","240","68","1012","1826","0","55.42","38.55"
"63","000","00","011","1133","0261","875","653","222","61","936","1647","0","56.83","39.65"
"63","000","00","011","1133","0262","877","679","198","66","943","1654","0","57.01","41.05"
"63","000","00","011","1134","0000","4137","3079","1058","241","4378","7652","0","57.21","40.24"
"63","000","00","011","1134","0251","860","635","225","50","910","1597","0","56.98","39.76"
"63","000","00","011","1134","0252","764","578","186","70","834","1454","0","57.36","39.75"
"63","000","00","011","1134","0253","914","662","252","48","962","1582","0","60.81","41.85"
"63","000","00","011","1134","0254","854","649","205","47","901","1518","0","59.35","42.75"
"63","000","00","011","1134","0255","745","555","190","26","771","1501","0","51.37","36.98"
"63","000","00","011","1135","0000","3230","2424","806","214","3444","5690","0","60.53","42.6"
"63","000","00","011","1135","0256","803","606","197","51","854","1420","0","60.14","42.68"
"63","000","00","011","1135","0257","804","616","188","63","867","1494","0","58.03","41.23"
"63","000","00","011","1135","0258","900","685","215","58","958","1568","0","61.1","43.69"
"63","000","00","011","1135","0259","723","517","206","42","765","1208","0","63.33","42.8"
"63","000","00","011","1136","0000","3097","2365","732","200","3297","5497","0","59.98","43.02"
"63","000","00","011","1136","0263","878","676","202","47","925","1550","0","59.68","43.61"
"63","000","00","011","1136","0264","762","574","188","53","815","1298","0","62.79","44.22"
"63","000","00","011","1136","0265","743","558","185","51","794","1297","0","61.22","43.02"
"63","000","00","011","1136","0266","714","557","157","49","763","1352","0","56.43","41.2"
"63","000","00","011","1137","0000","2417","1734","683","200","2617","4565","0","57.33","37.98"
"63","000","00","011","1137","0267","822","608","214","49","871","1522","0","57.23","39.95"
"63","000","00","011","1137","0268","823","577","246","88","911","1602","0","56.87","36.02"
"63","000","00","011","1137","0269","772","549","223","63","835","1441","0","57.95","38.1"
"63","000","00","011","1138","0000","2335","1745","590","108","2443","4410","0","55.4","39.57"
"63","000","00","011","1138","0270","674","503","171","26","700","1325","0","52.83","37.96"
"63","000","00","011","1138","0271","851","642","209","48","899","1567","0","57.37","40.97"
"63","000","00","011","1138","0272","810","600","210","34","844","1518","0","55.6","39.53"
"63","000","00","011","1139","0000","3625","2733","892","193","3818","6605","0","57.8","41.38"
"63","000","00","011","1139","0273","890","667","223","54","944","1549","0","60.94","43.06"
"63","000","00","011","1139","0274","888","660","228","34","922","1652","0","55.81","39.95"
"63","000","00","011","1139","0275","989","768","221","74","1063","1766","0","60.19","43.49"
"63","000","00","011","1139","0276","858","638","220","31","889","1638","0","54.27","38.95"
"63","000","00","011","1140","0000","3322","2553","769","181","3503","6105","0","57.38","41.82"
"63","000","00","011","1140","0277","843","657","186","53","896","1491","0","60.09","44.06"
"63","000","00","011","1140","0278","836","638","198","38","874","1521","0","57.46","41.95"
"63","000","00","011","1140","0279","769","604","165","56","825","1351","0","61.07","44.71"
"63","000","00","011","1140","0280","874","654","220","34","908","1742","0","52.12","37.54"
"63","000","00","011","1141","0000","4137","3141","996","255","4392","7594","0","57.84","41.36"
"63","000","00","011","1141","0281","850","630","220","63","913","1585","0","57.6","39.75"
"63","000","00","011","1141","0282","835","644","191","54","889","1521","0","58.45","42.34"
"63","000","00","011","1141","0283","815","623","192","49","864","1543","0","55.99","40.38"
"63","000","00","011","1141","0284","786","607","179","45","831","1404","0","59.19","43.23"
"63","000","00","011","1141","0285","851","637","214","44","895","1541","0","58.08","41.34"
"63","000","00","011","1142","0000","3071","2310","761","208","3279","5828","0","56.26","39.64"
"63","000","00","011","1142","0286","827","633","194","62","889","1584","0","56.12","39.96"
"63","000","00","011","1142","0287","849","625","224","59","908","1519","0","59.78","41.15"
"63","000","00","011","1142","0288","736","547","189","30","766","1482","0","51.69","36.91"
"63","000","00","011","1142","0289","659","505","154","57","716","1243","0","57.6","40.63"
"63","000","00","011","1143","0000","611","451","160","53","664","1156","0","57.44","39.01"
"63","000","00","011","1143","0290","611","451","160","53","664","1156","0","57.44","39.01"
"63","000","00","011","1144","0000","613","452","161","69","682","1262","0","54.04","35.82"
"63","000","00","011","1144","0291","613","452","161","69","682","1262","0","54.04","35.82"
"63","000","00","011","1145","0000","1028","690","338","86","1114","1747","0","63.77","39.5"
"63","000","00","011","1145","0292","491","353","138","40","531","889","0","59.73","39.71"
"63","000","00","011","1145","0293","537","337","200","46","583","858","0","67.95","39.28"
"63","000","00","011","1146","0000","1416","1057","359","127","1543","2781","0","55.48","38.01"
"63","000","00","011","1146","0294","484","328","156","51","535","945","0","56.61","34.71"
"63","000","00","011","1146","0295","480","370","110","32","512","960","0","53.33","38.54"
"63","000","00","011","1146","0296","452","359","93","44","496","876","0","56.62","40.98"
"63","000","00","011","1147","0000","845","630","215","90","935","1475","0","63.39","42.71"
"63","000","00","011","1147","0297","334","234","100","29","363","556","0","65.29","42.09"
"63","000","00","011","1147","0298","511","396","115","61","572","919","0","62.24","43.09"
"63","000","00","011","1148","0000","799","568","231","102","901","1360","0","66.25","41.76"
"63","000","00","011","1148","0299","799","568","231","102","901","1360","0","66.25","41.76"
"63","000","00","011","1149","0000","736","534","202","90","826","1355","0","60.96","39.41"
"63","000","00","011","1149","0300","736","534","202","90","826","1355","0","60.96","39.41"
"63","000","00","011","1150","0000","1388","1109","279","94","1482","2434","0","60.89","45.56"
"63","000","00","011","1150","0301","699","548","151","44","743","1252","0","59.35","43.77"
"63","000","00","011","1150","0302","689","561","128","50","739","1182","0","62.52","47.46"
"63","000","00","011","1151","0000","1275","1001","274","65","1340","2671","0","50.17","37.48"
"63","000","00","011","1151","0303","646","516","130","29","675","1431","0","47.17","36.06"
"63","000","00","011","1151","0304","629","485","144","36","665","1240","0","53.63","39.11"
"63","000","00","012","0000","0000","111144","85525","25619","7721","118865","213250","255631","55.74","40.11"
"63","000","00","012","1201","0000","2164","1565","599","168","2332","3797","0","61.42","41.22"
"63","000","00","012","1201","0001","734","556","178","68","802","1313","0","61.08","42.35"
"63","000","00","012","1201","0002","819","582","237","45","864","1403","0","61.58","41.48"
"63","000","00","012","1201","0003","611","427","184","55","666","1081","0","61.61","39.5"
"63","000","00","012","1202","0000","2095","1565","530","168","2263","3798","0","59.58","41.21"
"63","000","00","012","1202","0004","674","510","164","52","726","1209","0","60.05","42.18"
"63","000","00","012","1202","0005","718","530","188","54","772","1326","0","58.22","39.97"
"63","000","00","012","1202","0006","703","525","178","62","765","1263","0","60.57","41.57"
"63","000","00","012","1203","0000","2590","1974","616","174","2764","4640","0","59.57","42.54"
"63","000","00","012","1203","0007","892","670","222","59","951","1580","0","60.19","42.41"
"63","000","00","012","1203","0008","883","672","211","45","928","1577","0","58.85","42.61"
"63","000","00","012","1203","0009","815","632","183","70","885","1483","0","59.68","42.62"
"63","000","00","012","1204","0000","3201","2458","743","205","3406","6090","0","55.93","40.36"
"63","000","00","012","1204","0010","771","605","166","42","813","1461","0","55.65","41.41"
"63","000","00","012","1204","0011","769","571","198","71","840","1466","0","57.3","38.95"
"63","000","00","012","1204","0012","894","689","205","63","957","1620","0","59.07","42.53"
"63","000","00","012","1204","0013","767","593","174","29","796","1543","0","51.59","38.43"
"63","000","00","012","1205","0000","3296","2579","717","235","3531","6230","0","56.68","41.4"
"63","000","00","012","1205","0014","746","561","185","69","815","1513","0","53.87","37.08"
"63","000","00","012","1205","0015","818","645","173","48","866","1534","0","56.45","42.05"
"63","000","00","012","1205","0016","907","722","185","75","982","1650","0","59.52","43.76"
"63","000","00","012","1205","0017","825","651","174","43","868","1533","0","56.62","42.47"
"63","000","00","012","1206","0000","3525","2624","901","246","3771","6528","0","57.77","40.2"
"63","000","00","012","1206","0018","884","670","214","53","937","1702","0","55.05","39.37"
"63","000","00","012","1206","0019","917","678","239","55","972","1721","0","56.48","39.4"
"63","000","00","012","1206","0020","896","644","252","64","960","1575","0","60.95","40.89"
"63","000","00","012","1206","0021","828","632","196","74","902","1530","0","58.95","41.31"
"63","000","00","012","1207","0000","3485","2666","819","248","3733","6810","0","54.82","39.15"
"63","000","00","012","1207","0022","935","725","210","67","1002","1728","0","57.99","41.96"
"63","000","00","012","1207","0023","904","697","207","73","977","1702","0","57.4","40.95"
"63","000","00","012","1207","0024","884","652","232","72","956","1696","0","56.37","38.44"
"63","000","00","012","1207","0025","762","592","170","36","798","1684","0","47.39","35.15"
"63","000","00","012","1208","0000","3676","2814","862","233","3909","6642","0","58.85","42.37"
"63","000","00","012","1208","0026","955","750","205","73","1028","1717","0","59.87","43.68"
"63","000","00","012","1208","0027","874","664","210","45","919","1605","0","57.26","41.37"
"63","000","00","012","1208","0028","931","717","214","53","984","1723","0","57.11","41.61"
"63","000","00","012","1208","0029","916","683","233","62","978","1597","0","61.24","42.77"
"63","000","00","012","1209","0000","4212","3197","1015","220","4432","7993","0","55.45","40.0"
"63","000","00","012","1209","0030","912","677","235","50","962","1700","0","56.59","39.82"
"63","000","00","012","1209","0031","770","578","192","43","813","1544","0","52.66","37.44"
"63","000","00","012","1209","0032","812","618","194","58","870","1635","0","53.21","37.8"
"63","000","00","012","1209","0033","820","639","181","37","857","1495","0","57.32","42.74"
"63","000","00","012","1209","0034","898","685","213","32","930","1619","0","57.44","42.31"
"63","000","00","012","1210","0000","3393","2544","849","182","3575","6869","0","52.05","37.04"
"63","000","00","012","1210","0035","907","657","250","49","956","1683","0","56.8","39.04"
"63","000","00","012","1210","0036","805","618","187","65","870","1662","0","52.35","37.18"
"63","000","00","012","1210","0037","855","654","201","42","897","1850","0","48.49","35.35"
"63","000","00","012","1210","0038","826","615","211","26","852","1674","0","50.9","36.74"
"63","000","00","012","1211","0000","2344","1835","509","138","2482","4183","0","59.34","43.87"
"63","000","00","012","1211","0039","861","681","180","55","916","1511","0","60.62","45.07"
"63","000","00","012","1211","0040","730","551","179","26","756","1393","0","54.27","39.55"
"63","000","00","012","1211","0041","753","603","150","57","810","1279","0","63.33","47.15"
"63","000","00","012","1212","0000","2240","1768","472","152","2392","3837","0","62.34","46.08"
"63","000","00","012","1212","0042","585","471","114","36","621","1122","0","55.35","41.98"
"63","000","00","012","1212","0043","803","646","157","56","859","1238","0","69.39","52.18"
"63","000","00","012","1212","0044","852","651","201","60","912","1477","0","61.75","44.08"
"63","000","00","012","1213","0000","3294","2580","714","245","3539","5857","0","60.42","44.05"
"63","000","00","012","1213","0045","840","650","190","72","912","1495","0","61.0","43.48"
"63","000","00","012","1213","0046","872","672","200","45","917","1469","0","62.42","45.75"
"63","000","00","012","1213","0047","801","640","161","59","860","1462","0","58.82","43.78"
"63","000","00","012","1213","0048","781","618","163","69","850","1431","0","59.4","43.19"
"63","000","00","012","1214","0000","2307","1804","503","143","2450","4391","0","55.8","41.08"
"63","000","00","012","1214","0049","692","583","109","46","738","1486","0","49.66","39.23"
"63","000","00","012","1214","0050","821","615","206","60","881","1449","0","60.8","42.44"
"63","000","00","012","1214","0051","794","606","188","37","831","1456","0","57.07","41.62"
"63","000","00","012","1215","0000","2137","1635","502","136","2273","4005","0","56.75","40.82"
"63","000","00","012","1215","0052","693","527","166","34","727","1311","0","55.45","40.2"
"63","000","00","012","1215","0053","718","564","154","64","782","1356","0","57.67","41.59"
"63","000","00","012","1215","0054","726","544","182","38","764","1338","0","57.1","40.66"
"63","000","00","012","1216","0000","2384","1870","514","110","2494","4644","0","53.7","40.27"
"63","000","00","012","1216","0055","819","636","183","31","850","1525","0","55.74","41.7"
"63","000","00","012","1216","0056","821","635","186","47","868","1620","0","53.58","39.2"
"63","000","00","012","1216","0057","744","599","145","32","776","1499","0","51.77","39.96"
"63","000","00","012","1217","0000","4099","3163","936","317","4416","7724","0","57.17","40.95"
"63","000","00","012","1217","0058","838","678","160","36","874","1497","0","58.38","45.29"
"63","000","00","012","1217","0059","854","652","202","60","914","1624","0","56.28","40.15"
"63","000","00","012","1217","0060","754","590","164","85","839","1536","0","54.62","38.41"
"63","000","00","012","1217","0061","818","624","194","82","900","1469","0","61.27","42.48"
"63","000","00","012","1217","0062","835","619","216","54","889","1598","0","55.63","38.74"
"63","000","00","012","1218","0000","2543","1930","613","206","2749","4923","0","55.84","39.2"
"63","000","00","012","1218","0063","872","665","207","37","909","1690","0","53.79","39.35"
"63","000","00","012","1218","0064","808","613","195","98","906","1599","0","56.66","38.34"
"63","000","00","012","1218","0065","863","652","211","71","934","1634","0","57.16","39.9"
"63","000","00","012","1219","0000","824","610","214","55","879","1660","0","52.95","36.75"
"63","000","00","012","1219","0066","824","610","214","55","879","1660","0","52.95","36.75"
"63","000","00","012","1220","0000","4804","3617","1187","322","5126","9045","0","56.67","39.99"
"63","000","00","012","1220","0067","927","710","217","64","991","1900","0","52.16","37.37"
"63","000","00","012","1220","0068","965","728","237","61","1026","1797","0","57.1","40.51"
"63","000","00","012","1220","0069","979","719","260","77","1056","1832","0","57.64","39.25"
"63","000","00","012","1220","0070","983","751","232","63","1046","1784","0","58.63","42.1"
"63","000","00","012","1220","0071","950","709","241","57","1007","1732","0","58.14","40.94"
"63","000","00","012","1221","0000","3853","2967","886","367","4220","8470","0","49.82","35.03"
"63","000","00","012","1221","0072","495","393","102","60","555","2035","0","27.27","19.31"
"63","000","00","012","1221","0073","788","607","181","76","864","1504","0","57.45","40.36"
"63","000","00","012","1221","0074","920","720","200","79","999","1683","0","59.36","42.78"
"63","000","00","012","1221","0075","819","613","206","83","902","1635","0","55.17","37.49"
"63","000","00","012","1221","0076","831","634","197","69","900","1613","0","55.8","39.31"
"63","000","00","012","1222","0000","3815","2920","895","290","4105","7542","0","54.43","38.72"
"63","000","00","012","1222","0077","733","589","144","37","770","1483","0","51.92","39.72"
"63","000","00","012","1222","0078","795","588","207","46","841","1500","0","56.07","39.2"
"63","000","00","012","1222","0079","797","614","183","70","867","1483","0","58.46","41.4"
"63","000","00","012","1222","0080","811","601","210","62","873","1544","0","56.54","38.92"
"63","000","00","012","1222","0081","679","528","151","75","754","1532","0","49.22","34.46"
"63","000","00","012","1223","0000","2697","1973","724","179","2876","5554","0","51.78","35.52"
"63","000","00","012","1223","0082","958","726","232","68","1026","1819","0","56.4","39.91"
"63","000","00","012","1223","0083","882","624","258","80","962","1863","0","51.64","33.49"
"63","000","00","012","1223","0084","857","623","234","31","888","1872","0","47.44","33.28"
"63","000","00","012","1224","0000","2607","1973","634","158","2765","5164","0","53.54","38.21"
"63","000","00","012","1224","0085","819","617","202","59","878","1627","0","53.96","37.92"
"63","000","00","012","1224","0086","839","647","192","38","877","1696","0","51.71","38.15"
"63","000","00","012","1224","0087","949","709","240","61","1010","1841","0","54.86","38.51"
"63","000","00","012","1225","0000","3116","2387","729","215","3331","5954","0","55.95","40.09"
"63","000","00","012","1225","0088","690","536","154","62","752","1324","0","56.8","40.48"
"63","000","00","012","1225","0089","740","591","149","45","785","1504","0","52.19","39.3"
"63","000","00","012","1225","0090","789","611","178","57","846","1511","0","55.99","40.44"
"63","000","00","012","1225","0091","897","649","248","51","948","1615","0","58.7","40.19"
"63","000","00","012","1226","0000","1310","1008","302","75","1385","2762","0","50.14","36.5"
"63","000","00","012","1226","0092","624","492","132","38","662","1270","0","52.13","38.74"
"63","000","00","012","1226","0093","686","516","170","37","723","1492","0","48.46","34.58"
"63","000","00","012","1227","0000","2926","2228","698","146","3072","5832","0","52.67","38.2"
"63","000","00","012","1227","0094","706","514","192","49","755","1429","0","52.83","35.97"
"63","000","00","012","1227","0095","788","621","167","23","811","1567","0","51.75","39.63"
"63","000","00","012","1227","0096","729","555","174","49","778","1388","0","56.05","39.99"
"63","000","00","012","1227","0097","703","538","165","25","728","1448","0","50.28","37.15"
"63","000","00","012","1228","0000","1990","1537","453","154","2144","3829","0","55.99","40.14"
"63","000","00","012","1228","0098","669","498","171","55","724","1356","0","53.39","36.73"
"63","000","00","012","1228","0099","686","542","144","47","733","1308","0","56.04","41.44"
"63","000","00","012","1228","0100","635","497","138","52","687","1165","0","58.97","42.66"
"63","000","00","012","1229","0000","3167","2468","699","228","3395","5889","0","57.65","41.91"
"63","000","00","012","1229","0101","768","611","157","67","835","1429","0","58.43","42.76"
"63","000","00","012","1229","0102","749","601","148","36","785","1472","0","53.33","40.83"
"63","000","00","012","1229","0103","871","670","201","64","935","1508","0","62.0","44.43"
"63","000","00","012","1229","0104","779","586","193","61","840","1480","0","56.76","39.59"
"63","000","00","012","1230","0000","2248","1739","509","187","2435","4365","0","55.78","39.84"
"63","000","00","012","1230","0105","569","425","144","47","616","1142","0","53.94","37.22"
"63","000","00","012","1230","0106","774","615","159","47","821","1554","0","52.83","39.58"
"63","000","00","012","1230","0107","905","699","206","93","998","1669","0","59.8","41.88"
"63","000","00","012","1231","0000","2713","2146","567","240","2953","5333","0","55.37","40.24"
"63","000","00","012","1231","0108","975","768","207","75","1050","1823","0","57.6","42.13"
"63","000","00","012","1231","0109","850","682","168","101","951","1739","0","54.69","39.22"
"63","000","00","012","1231","0110","888","696","192","64","952","1771","0","53.75","39.3"
"63","000","00","012","1232","0000","1485","1157","328","92","1577","2937","0","53.69","39.39"
"63","000","00","012","1232","0111","725","572","153","50","775","1468","0","52.79","38.96"
"63","000","00","012","1232","0112","760","585","175","42","802","1469","0","54.59","39.82"
"63","000","00","012","1233","0000","2138","1854","284","140","2278","3617","0","62.98","51.26"
"63","000","00","012","1233","0113","668","568","100","43","711","1094","0","64.99","51.92"
"63","000","00","012","1233","0114","659","544","115","42","701","1101","0","63.67","49.41"
"63","000","00","012","1233","0115","811","742","69","55","866","1422","0","60.9","52.18"
"63","000","00","012","1234","0000","2120","1691","429","205","2325","3912","0","59.43","43.23"
"63","000","00","012","1234","0116","719","600","119","57","776","1390","0","55.83","43.17"
"63","000","00","012","1234","0117","712","555","157","67","779","1307","0","59.6","42.46"
"63","000","00","012","1234","0118","689","536","153","81","770","1215","0","63.37","44.12"
"63","000","00","012","1235","0000","2428","1949","479","141","2569","4886","0","52.58","39.89"
"63","000","00","012","1235","0119","803","637","166","42","845","1642","0","51.46","38.79"
"63","000","00","012","1235","0120","795","659","136","34","829","1623","0","51.08","40.6"
"63","000","00","012","1235","0121","830","653","177","65","895","1621","0","55.21","40.28"
"63","000","00","012","1236","0000","2812","2144","668","164","2976","5397","0","55.14","39.73"
"63","000","00","012","1236","0122","716","551","165","21","737","1367","0","53.91","40.31"
"63","000","00","012","1236","0123","660","477","183","57","717","1309","0","54.77","36.44"
"63","000","00","012","1236","0124","739","571","168","32","771","1356","0","56.86","42.11"
"63","000","00","012","1236","0125","697","545","152","54","751","1365","0","55.02","39.93"
"63","000","00","012","1237","0000","3309","2501","808","211","3520","6487","0","54.26","38.55"
"63","000","00","012","1237","0126","810","601","209","47","857","1613","0","53.13","37.26"
"63","000","00","012","1237","0127","723","553","170","39","762","1590","0","47.92","34.78"
"63","000","00","012","1237","0128","903","687","216","67","970","1662","0","58.36","41.34"
"63","000","00","012","1237","0129","873","660","213","58","931","1622","0","57.4","40.69"
"63","000","00","012","1238","0000","5036","3930","1106","342","5378","10006","0","53.75","39.28"
"63","000","00","012","1238","0130","934","670","264","43","977","1820","0","53.68","36.81"
"63","000","00","012","1238","0131","871","667","204","67","938","1615","0","58.08","41.3"
"63","000","00","012","1238","0132","682","532","150","70","752","1612","0","46.65","33.0"
"63","000","00","012","1238","0133","835","745","90","78","913","1652","0","55.27","45.1"
"63","000","00","012","1238","0134","879","684","195","33","912","1666","0","54.74","41.06"
"63","000","00","012","1238","0135","835","632","203","51","886","1641","0","53.99","38.51"
"63","000","00","012","1239","0000","988","746","242","115","1103","2170","0","50.83","34.38"
"63","000","00","012","1239","0136","279","215","64","40","319","528","0","60.42","40.72"
"63","000","00","012","1239","0137","709","531","178","75","784","1642","0","47.75","32.34"
"63","000","00","012","1240","0000","785","627","158","66","851","1519","0","56.02","41.28"
"63","000","00","012","1240","0138","434","347","87","35","469","829","0","56.57","41.86"
"63","000","00","012","1240","0139","351","280","71","31","382","690","0","55.36","40.58"
"63","000","00","012","1241","0000","532","416","116","52","584","1067","0","54.73","38.99"
"63","000","00","012","1241","0140","532","416","116","52","584","1067","0","54.73","38.99"
"63","000","00","012","1242","0000","456","366","90","51","507","892","0","56.84","41.03"
"63","000","00","012","1242","0141","456","366","90","51","507","892","0","56.84","41.03"
"65","000","00","000","0000","0000","1719581","1346167","373414","127273","1846854","3375513","3992291","54.71","39.88"
"65","000","00","001","0000","0000","238604","183642","54962","19309","257913","463411","554357","55.66","39.63"
"65","000","00","001","0101","0000","697","514","183","72","769","1388","0","55.4","37.03"
"65","000","00","001","0101","0894","697","514","183","72","769","1388","0","55.4","37.03"
"65","000","00","001","0102","0000","712","517","195","49","761","1294","0","58.81","39.95"
"65","000","00","001","0102","0895","712","517","195","49","761","1294","0","58.81","39.95"
"65","000","00","001","0103","0000","379","291","88","18","397","667","0","59.52","43.63"
"65","000","00","001","0103","0896","379","291","88","18","397","667","0","59.52","43.63"
"65","000","00","001","0104","0000","433","321","112","41","474","898","0","52.78","35.75"
"65","000","00","001","0104","0897","433","321","112","41","474","898","0","52.78","35.75"
"65","000","00","001","0105","0000","890","708","182","74","964","1568","0","61.48","45.15"
"65","000","00","001","0105","0898","470","363","107","34","504","829","0","60.8","43.79"
"65","000","00","001","0105","0899","420","345","75","40","460","739","0","62.25","46.68"
"65","000","00","001","0106","0000","2252","1744","508","200","2452","4718","0","51.97","36.96"
"65","000","00","001","0106","0900","574","431","143","55","629","1035","0","60.77","41.64"
"65","000","00","001","0106","0901","728","570","158","34","762","1713","0","44.48","33.27"
"65","000","00","001","0106","0902","309","246","63","18","327","658","0","49.7","37.39"
"65","000","00","001","0106","0903","641","497","144","93","734","1312","0","55.95","37.88"
"65","000","00","001","0107","0000","1374","1031","343","129","1503","2885","0","52.1","35.74"
"65","000","00","001","0107","0904","699","535","164","64","763","1492","0","51.14","35.86"
"65","000","00","001","0107","0905","675","496","179","65","740","1393","0","53.12","35.61"
"65","000","00","001","0108","0000","2757","2116","641","201","2958","8490","0","34.84","24.92"
"65","000","00","001","0108","0906","818","602","216","61","879","4742","0","18.54","12.7"
"65","000","00","001","0108","0907","717","565","152","36","753","1439","0","52.33","39.26"
"65","000","00","001","0108","0908","644","494","150","71","715","1187","0","60.24","41.62"
"65","000","00","001","0108","0909","578","455","123","33","611","1122","0","54.46","40.55"
"65","000","00","001","0109","0000","2036","1562","474","162","2198","3787","0","58.04","41.25"
"65","000","00","001","0109","0910","724","567","157","59","783","1363","0","57.45","41.6"
"65","000","00","001","0109","0911","596","454","142","52","648","1093","0","59.29","41.54"
"65","000","00","001","0109","0912","716","541","175","51","767","1331","0","57.63","40.65"
"65","000","00","001","0110","0000","1896","1465","431","172","2068","3777","0","54.75","38.79"
"65","000","00","001","0110","0915","610","469","141","80","690","1268","0","54.42","36.99"
"65","000","00","001","0110","0916","608","463","145","40","648","1313","0","49.35","35.26"
"65","000","00","001","0110","0917","678","533","145","52","730","1196","0","61.04","44.57"
"65","000","00","001","0111","0000","2715","2125","590","190","2905","4565","0","63.64","46.55"
"65","000","00","001","0111","0918","725","563","162","49","774","1137","0","68.07","49.52"
"65","000","00","001","0111","0919","748","568","180","57","805","1269","0","63.44","44.76"
"65","000","00","001","0111","0920","640","506","134","27","667","1117","0","59.71","45.3"
"65","000","00","001","0111","0921","602","488","114","57","659","1042","0","63.24","46.83"
"65","000","00","001","0112","0000","1326","1025","301","156","1482","2473","0","59.93","41.45"
"65","000","00","001","0112","0922","682","520","162","77","759","1257","0","60.38","41.37"
"65","000","00","001","0112","0923","644","505","139","79","723","1216","0","59.46","41.53"
"65","000","00","001","0113","0000","1377","1077","300","124","1501","2416","0","62.13","44.58"
"65","000","00","001","0113","0924","597","473","124","60","657","1126","0","58.35","42.01"
"65","000","00","001","0113","0925","780","604","176","64","844","1290","0","65.43","46.82"
"65","000","00","001","0114","0000","1978","1635","343","119","2097","3372","0","62.19","48.49"
"65","000","00","001","0114","0928","826","700","126","44","870","1329","0","65.46","52.67"
"65","000","00","001","0114","0929","573","479","94","34","607","996","0","60.94","48.09"
"65","000","00","001","0114","0930","579","456","123","41","620","1047","0","59.22","43.55"
"65","000","00","001","0115","0000","1393","1087","306","117","1510","2524","0","59.83","43.07"
"65","000","00","001","0115","0931","703","547","156","62","765","1272","0","60.14","43.0"
"65","000","00","001","0115","0932","690","540","150","55","745","1252","0","59.5","43.13"
"65","000","00","001","0116","0000","1796","1395","401","177","1973","3509","0","56.23","39.75"
"65","000","00","001","0116","0936","523","412","111","59","582","1093","0","53.25","37.69"
"65","000","00","001","0116","0937","583","447","136","74","657","1148","0","57.23","38.94"
"65","000","00","001","0116","0938","690","536","154","44","734","1268","0","57.89","42.27"
"65","000","00","001","0117","0000","2284","1764","520","248","2532","4250","0","59.58","41.51"
"65","000","00","001","0117","0939","647","494","153","71","718","1230","0","58.37","40.16"
"65","000","00","001","0117","0940","523","408","115","53","576","1012","0","56.92","40.32"
"65","000","00","001","0117","0941","439","343","96","47","486","811","0","59.93","42.29"
"65","000","00","001","0117","0942","675","519","156","77","752","1197","0","62.82","43.36"
"65","000","00","001","0118","0000","1216","945","271","86","1302","2364","0","55.08","39.97"
"65","000","00","001","0118","0943","580","459","121","29","609","1142","0","53.33","40.19"
"65","000","00","001","0118","0944","636","486","150","57","693","1222","0","56.71","39.77"
"65","000","00","001","0119","0000","1735","1298","437","154","1889","3208","0","58.88","40.46"
"65","000","00","001","0119","0947","557","388","169","30","587","1011","0","58.06","38.38"
"65","000","00","001","0119","0948","603","460","143","64","667","1157","0","57.65","39.76"
"65","000","00","001","0119","0949","575","450","125","60","635","1040","0","61.06","43.27"
"65","000","00","001","0120","0000","1971","1539","432","110","2081","3621","0","57.47","42.5"
"65","000","00","001","0120","0950","666","530","136","42","708","1173","0","60.36","45.18"
"65","000","00","001","0120","0951","616","476","140","28","644","1193","0","53.98","39.9"
"65","000","00","001","0120","0952","689","533","156","40","729","1255","0","58.09","42.47"
"65","000","00","001","0121","0000","1764","1333","431","108","1872","3298","0","56.76","40.42"
"65","000","00","001","0121","0953","692","513","179","60","752","1306","0","57.58","39.28"
"65","000","00","001","0121","0954","564","441","123","15","579","1050","0","55.14","42.0"
"65","000","00","001","0121","0955","508","379","129","33","541","942","0","57.43","40.23"
"65","000","00","001","0122","0000","2056","1594","462","149","2205","3677","0","59.97","43.35"
"65","000","00","001","0122","0956","653","492","161","58","711","1133","0","62.75","43.42"
"65","000","00","001","0122","0957","675","527","148","52","727","1251","0","58.11","42.13"
"65","000","00","001","0122","0958","728","575","153","39","767","1293","0","59.32","44.47"
"65","000","00","001","0123","0000","1769","1339","430","197","1966","3492","0","56.3","38.34"
"65","000","00","001","0123","0959","585","433","152","67","652","1208","0","53.97","35.84"
"65","000","00","001","0123","0960","635","484","151","75","710","1223","0","58.05","39.57"
"65","000","00","001","0123","0961","549","422","127","55","604","1061","0","56.93","39.77"
"65","000","00","001","0124","0000","2135","1781","354","113","2248","3596","0","62.51","49.53"
"65","000","00","001","0124","0964","679","563","116","30","709","1120","0","63.3","50.27"
"65","000","00","001","0124","0965","647","523","124","40","687","1091","0","62.97","47.94"
"65","000","00","001","0124","0966","809","695","114","43","852","1385","0","61.52","50.18"
"65","000","00","001","0125","0000","1320","1033","287","123","1443","2269","0","63.6","45.53"
"65","000","00","001","0125","0969","698","559","139","59","757","1191","0","63.56","46.94"
"65","000","00","001","0125","0970","622","474","148","64","686","1078","0","63.64","43.97"
"65","000","00","001","0126","0000","1428","1089","339","146","1574","2673","0","58.89","40.74"
"65","000","00","001","0126","0971","718","540","178","78","796","1351","0","58.92","39.97"
"65","000","00","001","0126","0972","710","549","161","68","778","1322","0","58.85","41.53"
"65","000","00","001","0127","0000","1082","801","281","137","1219","1897","0","64.26","42.22"
"65","000","00","001","0127","0973","467","351","116","61","528","868","0","60.83","40.44"
"65","000","00","001","0127","0974","615","450","165","76","691","1029","0","67.15","43.73"
"65","000","00","001","0128","0000","3316","2568","748","248","3564","6157","0","57.89","41.71"
"65","000","00","001","0128","0975","895","691","204","40","935","1602","0","58.36","43.13"
"65","000","00","001","0128","0976","750","568","182","69","819","1362","0","60.13","41.7"
"65","000","00","001","0128","0977","871","663","208","91","962","1698","0","56.65","39.05"
"65","000","00","001","0128","0978","800","646","154","48","848","1495","0","56.72","43.21"
"65","000","00","001","0129","0000","2104","1586","518","221","2325","4360","0","53.33","36.38"
"65","000","00","001","0129","0979","760","531","229","85","845","1522","0","55.52","34.89"
"65","000","00","001","0129","0980","682","544","138","72","754","1279","0","58.95","42.53"
"65","000","00","001","0129","0981","662","511","151","64","726","1559","0","46.57","32.78"
"65","000","00","001","0130","0000","2276","1706","570","234","2510","4788","0","52.42","35.63"
"65","000","00","001","0130","0982","725","538","187","104","829","1537","0","53.94","35.0"
"65","000","00","001","0130","0983","695","520","175","92","787","1531","0","51.4","33.96"
"65","000","00","001","0130","0984","856","648","208","38","894","1720","0","51.98","37.67"
"65","000","00","001","0131","0000","2695","2082","613","204","2899","5277","0","54.94","39.45"
"65","000","00","001","0131","0985","556","431","125","43","599","1165","0","51.42","37.0"
"65","000","00","001","0131","0986","996","793","203","64","1060","1857","0","57.08","42.7"
"65","000","00","001","0131","0987","560","427","133","71","631","1078","0","58.53","39.61"
"65","000","00","001","0131","0988","583","431","152","26","609","1177","0","51.74","36.62"
"65","000","00","001","0132","0000","1726","1337","389","172","1898","3253","0","58.35","41.1"
"65","000","00","001","0132","0989","956","734","222","62","1018","1798","0","56.62","40.82"
"65","000","00","001","0132","0990","770","603","167","110","880","1455","0","60.48","41.44"
"65","000","00","001","0133","0000","2192","1677","515","144","2336","4295","0","54.39","39.05"
"65","000","00","001","0133","0993","877","692","185","44","921","1600","0","57.56","43.25"
"65","000","00","001","0133","0994","669","509","160","40","709","1409","0","50.32","36.12"
"65","000","00","001","0133","0995","646","476","170","60","706","1286","0","54.9","37.01"
"65","000","00","001","0134","0000","1120","824","296","178","1298","2547","0","50.96","32.35"
"65","000","00","001","0134","0996","544","394","150","124","668","1359","0","49.15","28.99"
"65","000","00","001","0134","0997","576","430","146","54","630","1188","0","53.03","36.2"
"65","000","00","001","0135","0000","3420","2632","788","290","3710","6884","0","53.89","38.23"
"65","000","00","001","0135","0998","777","600","177","59","836","1627","0","51.38","36.88"
"65","000","00","001","0135","0999","715","552","163","37","752","1633","0","46.05","33.8"
"65","000","00","001","0135","1000","985","761","224","107","1092","1814","0","60.2","41.95"
"65","000","00","001","0135","1001","943","719","224","87","1030","1810","0","56.91","39.72"
"65","000","00","001","0136","0000","1691","1292","399","183","1874","3315","0","56.53","38.97"
"65","000","00","001","0136","1005","556","419","137","79","635","1130","0","56.19","37.08"
"65","000","00","001","0136","1006","588","452","136","72","660","1056","0","62.5","42.8"
"65","000","00","001","0136","1007","547","421","126","32","579","1129","0","51.28","37.29"
"65","000","00","001","0137","0000","3447","2691","756","257","3704","6233","0","59.43","43.17"
"65","000","00","001","0137","1008","886","671","215","88","974","1713","0","56.86","39.17"
"65","000","00","001","0137","1009","867","665","202","76","943","1622","0","58.14","41.0"
"65","000","00","001","0137","1010","827","659","168","64","891","1427","0","62.44","46.18"
"65","000","00","001","0137","1011","867","696","171","29","896","1471","0","60.91","47.31"
"65","000","00","001","0138","0000","1381","1023","358","172","1553","2637","0","58.89","38.79"
"65","000","00","001","0138","1015","408","306","102","63","471","828","0","56.88","36.96"
"65","000","00","001","0138","1016","446","315","131","67","513","820","0","62.56","38.41"
"65","000","00","001","0138","1017","527","402","125","42","569","989","0","57.53","40.65"
"65","000","00","001","0139","0000","2217","1652","565","208","2425","4257","0","56.96","38.81"
"65","000","00","001","0139","1018","532","386","146","68","600","1023","0","58.65","37.73"
"65","000","00","001","0139","1019","526","391","135","35","561","1044","0","53.74","37.45"
"65","000","00","001","0139","1020","501","381","120","70","571","968","0","58.99","39.36"
"65","000","00","001","0139","1021","658","494","164","35","693","1222","0","56.71","40.43"
"65","000","00","001","0140","0000","1487","1139","348","118","1605","2970","0","54.04","38.35"
"65","000","00","001","0140","1022","703","548","155","48","751","1385","0","54.22","39.57"
"65","000","00","001","0140","1023","784","591","193","70","854","1585","0","53.88","37.29"
"65","000","00","001","0141","0000","1915","1424","491","195","2110","3646","0","57.87","39.06"
"65","000","00","001","0141","1024","913","688","225","91","1004","1840","0","54.57","37.39"
"65","000","00","001","0141","1025","1002","736","266","104","1106","1806","0","61.24","40.75"
"65","000","00","001","0142","0000","2308","1782","526","265","2573","4482","0","57.41","39.76"
"65","000","00","001","0142","1026","772","581","191","86","858","1506","0","56.97","38.58"
"65","000","00","001","0142","1027","745","578","167","96","841","1476","0","56.98","39.16"
"65","000","00","001","0142","1028","791","623","168","83","874","1500","0","58.27","41.53"
"65","000","00","001","0143","0000","1645","1247","398","122","1767","3108","0","56.85","40.12"
"65","000","00","001","0143","1031","801","607","194","41","842","1601","0","52.59","37.91"
"65","000","00","001","0143","1032","844","640","204","81","925","1507","0","61.38","42.47"
"65","000","00","001","0144","0000","4877","3771","1106","286","5163","8859","0","58.28","42.57"
"65","000","00","001","0144","1035","998","783","215","89","1087","1822","0","59.66","42.97"
"65","000","00","001","0144","1036","908","677","231","91","999","1605","0","62.24","42.18"
"65","000","00","001","0144","1037","876","669","207","20","896","1549","0","57.84","43.19"
"65","000","00","001","0144","1038","1102","859","243","53","1155","1948","0","59.29","44.1"
"65","000","00","001","0144","1039","993","783","210","33","1026","1935","0","53.02","40.47"
"65","000","00","001","0145","0000","1071","808","263","99","1170","2192","0","53.38","36.86"
"65","000","00","001","0145","1040","527","401","126","47","574","1097","0","52.32","36.55"
"65","000","00","001","0145","1041","544","407","137","52","596","1095","0","54.43","37.17"
"65","000","00","001","0146","0000","1910","1447","463","130","2040","3603","0","56.62","40.16"
"65","000","00","001","0146","1044","607","460","147","58","665","1187","0","56.02","38.75"
"65","000","00","001","0146","1045","637","475","162","31","668","1154","0","57.89","41.16"
"65","000","00","001","0146","1046","666","512","154","41","707","1262","0","56.02","40.57"
"65","000","00","001","0147","0000","1336","1019","317","188","1524","2681","0","56.84","38.01"
"65","000","00","001","0147","1047","629","487","142","90","719","1271","0","56.57","38.32"
"65","000","00","001","0147","1048","707","532","175","98","805","1410","0","57.09","37.73"
"65","000","00","001","0148","0000","2689","2060","629","326","3015","5365","0","56.2","38.4"
"65","000","00","001","0148","1049","819","643","176","90","909","1745","0","52.09","36.85"
"65","000","00","001","0148","1050","926","678","248","135","1061","1867","0","56.83","36.31"
"65","000","00","001","0148","1051","944","739","205","101","1045","1753","0","59.61","42.16"
"65","000","00","001","0149","0000","656","503","153","68","724","1204","0","60.13","41.78"
"65","000","00","001","0149","1052","656","503","153","68","724","1204","0","60.13","41.78"
"65","000","00","001","0150","0000","2847","2118","729","241","3088","5455","0","56.61","38.83"
"65","000","00","001","0150","1053","793","593","200","71","864","1614","0","53.53","36.74"
"65","000","00","001","0150","1054","686","516","170","54","740","1237","0","59.82","41.71"
"65","000","00","001","0150","1055","727","541","186","76","803","1361","0","59.0","39.75"
"65","000","00","001","0150","1056","641","468","173","40","681","1243","0","54.79","37.65"
"65","000","00","001","0151","0000","2064","1560","504","180","2244","3979","0","56.4","39.21"
"65","000","00","001","0151","1057","721","544","177","34","755","1515","0","49.83","35.91"
"65","000","00","001","0151","1058","825","621","204","82","907","1515","0","59.87","40.99"
"65","000","00","001","0151","1059","518","395","123","64","582","949","0","61.33","41.62"
"65","000","00","001","0152","0000","1802","1320","482","162","1964","3768","0","52.12","35.03"
"65","000","00","001","0152","1060","828","633","195","73","901","1629","0","55.31","38.86"
"65","000","00","001","0152","1061","631","407","224","51","682","1238","0","55.09","32.88"
"65","000","00","001","0152","1062","343","280","63","38","381","901","0","42.29","31.08"
"65","000","00","001","0153","0000","1513","1159","354","169","1682","2956","0","56.9","39.21"
"65","000","00","001","0153","1063","772","613","159","84","856","1475","0","58.03","41.56"
"65","000","00","001","0153","1064","741","546","195","85","826","1481","0","55.77","36.87"
"65","000","00","001","0154","0000","2927","2255","672","247","3174","5602","0","56.66","40.25"
"65","000","00","001","0154","1065","846","657","189","76","922","1800","0","51.22","36.5"
"65","000","00","001","0154","1066","886","664","222","71","957","1630","0","58.71","40.74"
"65","000","00","001","0154","1067","718","566","152","56","774","1298","0","59.63","43.61"
"65","000","00","001","0154","1068","477","368","109","44","521","874","0","59.61","42.11"
"65","000","00","001","0155","0000","1397","1026","371","136","1533","2581","0","59.4","39.75"
"65","000","00","001","0155","1071","771","551","220","86","857","1451","0","59.06","37.97"
"65","000","00","001","0155","1072","626","475","151","50","676","1130","0","59.82","42.04"
"65","000","00","001","0156","0000","1612","1212","400","143","1755","2971","0","59.07","40.79"
"65","000","00","001","0156","1073","793","611","182","54","847","1440","0","58.82","42.43"
"65","000","00","001","0156","1074","819","601","218","89","908","1531","0","59.31","39.26"
"65","000","00","001","0157","0000","3549","2781","768","240","3789","6492","0","58.36","42.84"
"65","000","00","001","0157","1077","632","508","124","37","669","1174","0","56.98","43.27"
"65","000","00","001","0157","1078","637","485","152","58","695","1228","0","56.6","39.5"
"65","000","00","001","0157","1079","627","462","165","42","669","1187","0","56.36","38.92"
"65","000","00","001","0157","1080","475","362","113","61","536","870","0","61.61","41.61"
"65","000","00","001","0157","1081","1178","964","214","42","1220","2033","0","60.01","47.42"
"65","000","00","001","0158","0000","1287","933","354","102","1389","2493","0","55.72","37.42"
"65","000","00","001","0158","1082","717","522","195","53","770","1418","0","54.3","36.81"
"65","000","00","001","0158","1083","570","411","159","49","619","1075","0","57.58","38.23"
"65","000","00","001","0159","0000","2282","1731","551","201","2483","4561","0","54.44","37.95"
"65","000","00","001","0159","1086","958","740","218","90","1048","1893","0","55.36","39.09"
"65","000","00","001","0159","1087","659","479","180","64","723","1302","0","55.53","36.79"
"65","000","00","001","0159","1088","665","512","153","47","712","1366","0","52.12","37.48"
"65","000","00","001","0160","0000","1356","1037","319","133","1489","2518","0","59.13","41.18"
"65","000","00","001","0160","1089","736","569","167","90","826","1318","0","62.67","43.17"
"65","000","00","001","0160","1090","620","468","152","43","663","1200","0","55.25","39.0"
"65","000","00","001","0161","0000","1993","1479","514","166","2159","3774","0","57.21","39.19"
"65","000","00","001","0161","1091","1082","800","282","53","1135","2028","0","55.97","39.45"
"65","000","00","001","0161","1092","911","679","232","113","1024","1746","0","58.65","38.89"
"65","000","00","001","0162","0000","1595","1196","399","145","1740","2981","0","58.37","40.12"
"65","000","00","001","0162","1095","714","541","173","66","780","1418","0","55.01","38.15"
"65","000","00","001","0162","1096","881","655","226","79","960","1563","0","61.42","41.91"
"65","000","00","001","0163","0000","1752","1335","417","154","1906","3487","0","54.66","38.29"
"65","000","00","001","0163","1097","880","664","216","103","983","1780","0","55.22","37.3"
"65","000","00","001","0163","1098","872","671","201","51","923","1707","0","54.07","39.31"
"65","000","00","001","0164","0000","1426","1098","328","124","1550","3051","0","50.8","35.99"
"65","000","00","001","0164","1099","303","250","53","12","315","906","0","34.77","27.59"
"65","000","00","001","0164","1100","522","391","131","66","588","1030","0","57.09","37.96"
"65","000","00","001","0164","1101","601","457","144","46","647","1115","0","58.03","40.99"
"65","000","00","001","0165","0000","3723","2902","821","228","3951","7165","0","55.14","40.5"
"65","000","00","001","0165","1102","921","737","184","33","954","1836","0","51.96","40.14"
"65","000","00","001","0165","1103","942","736","206","99","1041","1881","0","55.34","39.13"
"65","000","00","001","0165","1104","870","661","209","50","920","1688","0","54.5","39.16"
"65","000","00","001","0165","1105","990","768","222","46","1036","1760","0","58.86","43.64"
"65","000","00","001","0166","0000","1841","1398","443","144","1985","3186","0","62.3","43.88"
"65","000","00","001","0166","1106","604","459","145","50","654","1044","0","62.64","43.97"
"65","000","00","001","0166","1107","601","441","160","45","646","1043","0","61.94","42.28"
"65","000","00","001","0166","1108","636","498","138","49","685","1099","0","62.33","45.31"
"65","000","00","001","0167","0000","1280","955","325","102","1382","2391","0","57.8","39.94"
"65","000","00","001","0167","1109","671","490","181","54","725","1260","0","57.54","38.89"
"65","000","00","001","0167","1110","609","465","144","48","657","1131","0","58.09","41.11"
"65","000","00","001","0168","0000","2149","1618","531","182","2331","3947","0","59.06","40.99"
"65","000","00","001","0168","1111","658","494","164","60","718","1225","0","58.61","40.33"
"65","000","00","001","0168","1112","844","661","183","56","900","1455","0","61.86","45.43"
"65","000","00","001","0168","1113","647","463","184","66","713","1267","0","56.27","36.54"
"65","000","00","001","0169","0000","2115","1664","451","162","2277","3832","0","59.42","43.42"
"65","000","00","001","0169","1116","609","479","130","21","630","1111","0","56.71","43.11"
"65","000","00","001","0169","1117","713","554","159","74","787","1177","0","66.86","47.07"
"65","000","00","001","0169","1118","793","631","162","67","860","1544","0","55.7","40.87"
"65","000","00","001","0170","0000","2153","1663","490","105","2258","4087","0","55.25","40.69"
"65","000","00","001","0170","1121","786","596","190","29","815","1504","0","54.19","39.63"
"65","000","00","001","0170","1122","698","541","157","45","743","1373","0","54.12","39.4"
"65","000","00","001","0170","1123","669","526","143","31","700","1210","0","57.85","43.47"
"65","000","00","001","0171","0000","1714","1342","372","164","1878","3360","0","55.89","39.94"
"65","000","00","001","0171","1124","874","684","190","86","960","1809","0","53.07","37.81"
"65","000","00","001","0171","1125","840","658","182","78","918","1551","0","59.19","42.42"
"65","000","00","001","0172","0000","2126","1690","436","109","2235","3795","0","58.89","44.53"
"65","000","00","001","0172","1126","771","614","157","37","808","1408","0","57.39","43.61"
"65","000","00","001","0172","1127","714","577","137","28","742","1285","0","57.74","44.9"
"65","000","00","001","0172","1128","641","499","142","44","685","1102","0","62.16","45.28"
"65","000","00","001","0173","0000","1528","1190","338","137","1665","3091","0","53.87","38.5"
"65","000","00","001","0173","1129","675","520","155","32","707","1399","0","50.54","37.17"
"65","000","00","001","0173","1130","853","670","183","105","958","1692","0","56.62","39.6"
"65","000","00","001","0174","0000","2383","1880","503","135","2518","4478","0","56.23","41.98"
"65","000","00","001","0174","1133","670","522","148","34","704","1246","0","56.5","41.89"
"65","000","00","001","0174","1134","786","602","184","36","822","1471","0","55.88","40.92"
"65","000","00","001","0174","1135","927","756","171","65","992","1761","0","56.33","42.93"
"65","000","00","001","0175","0000","1529","1143","386","138","1667","3027","0","55.07","37.76"
"65","000","00","001","0175","1136","788","588","200","78","866","1499","0","57.77","39.23"
"65","000","00","001","0175","1137","741","555","186","60","801","1528","0","52.42","36.32"
"65","000","00","001","0176","0000","1640","1245","395","123","1763","3086","0","57.13","40.34"
"65","000","00","001","0176","1138","812","618","194","65","877","1536","0","57.1","40.23"
"65","000","00","001","0176","1139","828","627","201","58","886","1550","0","57.16","40.45"
"65","000","00","001","0177","0000","1818","1381","437","148","1966","3350","0","58.69","41.22"
"65","000","00","001","0177","1140","1101","820","281","94","1195","2050","0","58.29","40.0"
"65","000","00","001","0177","1141","717","561","156","54","771","1300","0","59.31","43.15"
"65","000","00","001","0178","0000","3013","2305","708","149","3162","5917","0","53.44","38.96"
"65","000","00","001","0178","1142","826","634","192","54","880","1537","0","57.25","41.25"
"65","000","00","001","0178","1143","631","476","155","25","656","1341","0","48.92","35.5"
"65","000","00","001","0178","1144","870","669","201","29","899","1606","0","55.98","41.66"
"65","000","00","001","0178","1145","686","526","160","41","727","1433","0","50.73","36.71"
"65","000","00","001","0179","0000","2086","1637","449","159","2245","4105","0","54.69","39.88"
"65","000","00","001","0179","1146","790","617","173","43","833","1685","0","49.44","36.62"
"65","000","00","001","0179","1147","700","534","166","65","765","1248","0","61.3","42.79"
"65","000","00","001","0179","1148","596","486","110","51","647","1172","0","55.2","41.47"
"65","000","00","001","0180","0000","3820","2983","837","248","4068","7527","0","54.05","39.63"
"65","000","00","001","0180","1149","714","545","169","31","745","1640","0","45.43","33.23"
"65","000","00","001","0180","1150","716","573","143","45","761","1428","0","53.29","40.13"
"65","000","00","001","0180","1151","801","616","185","74","875","1527","0","57.3","40.34"
"65","000","00","001","0180","1152","751","582","169","39","790","1350","0","58.52","43.11"
"65","000","00","001","0180","1153","838","667","171","59","897","1582","0","56.7","42.16"
"65","000","00","001","0181","0000","1617","1300","317","105","1722","2823","0","61.0","46.05"
"65","000","00","001","0181","1154","553","435","118","52","605","919","0","65.83","47.33"
"65","000","00","001","0181","1155","495","400","95","21","516","930","0","55.48","43.01"
"65","000","00","001","0181","1156","569","465","104","32","601","974","0","61.7","47.74"
"65","000","00","001","0182","0000","1708","1396","312","106","1814","3170","0","57.22","44.04"
"65","000","00","001","0182","1157","953","800","153","52","1005","1732","0","58.03","46.19"
"65","000","00","001","0182","1158","755","596","159","54","809","1438","0","56.26","41.45"
"65","000","00","001","0183","0000","1682","1273","409","159","1841","3541","0","51.99","35.95"
"65","000","00","001","0183","1159","863","644","219","101","964","1777","0","54.25","36.24"
"65","000","00","001","0183","1160","819","629","190","58","877","1764","0","49.72","35.66"
"65","000","00","001","0184","0000","1898","1463","435","173","2071","3712","0","55.79","39.41"
"65","000","00","001","0184","1164","897","683","214","111","1008","1870","0","53.9","36.52"
"65","000","00","001","0184","1165","1001","780","221","62","1063","1842","0","57.71","42.35"
"65","000","00","001","0185","0000","1195","950","245","113","1308","2322","0","56.33","40.91"
"65","000","00","001","0185","1166","571","465","106","62","633","1094","0","57.86","42.5"
"65","000","00","001","0185","1167","624","485","139","51","675","1228","0","54.97","39.5"
"65","000","00","001","0186","0000","3177","2453","724","216","3393","6224","0","54.51","39.41"
"65","000","00","001","0186","1170","790","581","209","54","844","1622","0","52.03","35.82"
"65","000","00","001","0186","1171","661","523","138","68","729","1205","0","60.5","43.4"
"65","000","00","001","0186","1172","857","657","200","47","904","1787","0","50.59","36.77"
"65","000","00","001","0186","1173","869","692","177","47","916","1610","0","56.89","42.98"
"65","000","00","001","0187","0000","3446","2669","777","203","3649","6600","0","55.29","40.44"
"65","000","00","001","0187","1174","1229","943","286","51","1280","2216","0","57.76","42.55"
"65","000","00","001","0187","1175","1214","943","271","61","1275","2294","0","55.58","41.11"
"65","000","00","001","0187","1176","1003","783","220","91","1094","2090","0","52.34","37.46"
"65","000","00","001","0188","0000","1861","1419","442","125","1986","3742","0","53.07","37.92"
"65","000","00","001","0188","1177","629","511","118","36","665","1356","0","49.04","37.68"
"65","000","00","001","0188","1178","608","486","122","35","643","1067","0","60.26","45.55"
"65","000","00","001","0188","1179","624","422","202","54","678","1319","0","51.4","31.99"
"65","000","00","001","0189","0000","1642","1250","392","159","1801","3368","0","53.47","37.11"
"65","000","00","001","0189","1180","622","480","142","56","678","1316","0","51.52","36.47"
"65","000","00","001","0189","1181","577","431","146","71","648","1195","0","54.23","36.07"
"65","000","00","001","0189","1182","443","339","104","32","475","857","0","55.43","39.56"
"65","000","00","001","0190","0000","2408","1851","557","243","2651","4724","0","56.12","39.18"
"65","000","00","001","0190","1183","685","516","169","80","765","1417","0","53.99","36.41"
"65","000","00","001","0190","1184","818","608","210","82","900","1560","0","57.69","38.97"
"65","000","00","001","0190","1185","905","727","178","81","986","1747","0","56.44","41.61"
"65","000","00","001","0191","0000","2097","1559","538","111","2208","3735","0","59.12","41.74"
"65","000","00","001","0191","1186","708","514","194","52","760","1176","0","64.63","43.71"
"65","000","00","001","0191","1187","611","455","156","30","641","1101","0","58.22","41.33"
"65","000","00","001","0191","1188","778","590","188","29","807","1458","0","55.35","40.47"
"65","000","00","001","0192","0000","3024","2413","611","249","3273","5591","0","58.54","43.16"
"65","000","00","001","0192","1192","591","487","104","32","623","1120","0","55.63","43.48"
"65","000","00","001","0192","1193","568","443","125","85","653","1022","0","63.89","43.35"
"65","000","00","001","0192","1194","569","439","130","69","638","1049","0","60.82","41.85"
"65","000","00","001","0192","1195","555","440","115","28","583","1007","0","57.89","43.69"
"65","000","00","001","0192","1196","741","604","137","35","776","1393","0","55.71","43.36"
"65","000","00","001","0193","0000","439","328","111","59","498","974","0","51.13","33.68"
"65","000","00","001","0193","1197","170","122","48","30","200","474","0","42.19","25.74"
"65","000","00","001","0193","1198","269","206","63","29","298","500","0","59.6","41.2"
"65","000","00","001","0194","0000","1827","1400","427","142","1969","3502","0","56.23","39.98"
"65","000","00","001","0194","1199","600","457","143","43","643","1177","0","54.63","38.83"
"65","000","00","001","0194","1200","593","463","130","36","629","1186","0","53.04","39.04"
"65","000","00","001","0194","1201","634","480","154","63","697","1139","0","61.19","42.14"
"65","000","00","001","0195","0000","2019","1566","453","108","2127","5201","0","40.9","30.11"
"65","000","00","001","0195","1202","892","687","205","71","963","1750","0","55.03","39.26"
"65","000","00","001","0195","1203","1127","879","248","37","1164","3451","0","33.73","25.47"
"65","000","00","001","0196","0000","2273","1739","534","185","2458","4730","0","51.97","36.77"
"65","000","00","001","0196","1204","779","600","179","78","857","1620","0","52.9","37.04"
"65","000","00","001","0196","1205","409","323","86","24","433","903","0","47.95","35.77"
"65","000","00","001","0196","1206","665","499","166","55","720","1232","0","58.44","40.5"
"65","000","00","001","0196","1207","420","317","103","28","448","975","0","45.95","32.51"
"65","000","00","001","0197","0000","1280","1015","265","73","1353","2515","0","53.8","40.36"
"65","000","00","001","0197","1208","612","478","134","33","645","1224","0","52.7","39.05"
"65","000","00","001","0197","1209","668","537","131","40","708","1291","0","54.84","41.6"
"65","000","00","001","0198","0000","4055","3163","892","243","4298","8555","0","50.24","36.97"
"65","000","00","001","0198","1210","833","632","201","44","877","1828","0","47.98","34.57"
"65","000","00","001","0198","1211","795","630","165","57","852","1725","0","49.39","36.52"
"65","000","00","001","0198","1212","496","387","109","25","521","1085","0","48.02","35.67"
"65","000","00","001","0198","1213","1141","891","250","80","1221","2357","0","51.8","37.8"
"65","000","00","001","0198","1214","790","623","167","37","827","1560","0","53.01","39.94"
"65","000","00","001","0199","0000","2459","1929","530","151","2610","5152","0","50.66","37.44"
"65","000","00","001","0199","1218","867","669","198","56","923","1763","0","52.35","37.95"
"65","000","00","001","0199","1219","803","635","168","34","837","1744","0","47.99","36.41"
"65","000","00","001","0199","1220","789","625","164","61","850","1645","0","51.67","37.99"
"65","000","00","001","01A0","0000","1677","1296","381","124","1801","3118","0","57.76","41.57"
"65","000","00","001","01A0","1228","804","615","189","79","883","1566","0","56.39","39.27"
"65","000","00","001","01A0","1229","873","681","192","45","918","1552","0","59.15","43.88"
"65","000","00","001","01A1","0000","1242","973","269","124","1366","2270","0","60.18","42.86"
"65","000","00","001","01A1","0913","587","455","132","54","641","1026","0","62.48","44.35"
"65","000","00","001","01A1","0914","655","518","137","70","725","1244","0","58.28","41.64"
"65","000","00","001","01A2","0000","2139","1638","501","218","2357","3821","0","61.69","42.87"
"65","000","00","001","01A2","0933","663","502","161","68","731","1238","0","59.05","40.55"
"65","000","00","001","01A2","0934","805","637","168","78","883","1389","0","63.57","45.86"
"65","000","00","001","01A2","0935","671","499","172","72","743","1194","0","62.23","41.79"
"65","000","00","001","01A3","0000","1495","1173","322","113","1608","2740","0","58.69","42.81"
"65","000","00","001","01A3","0962","807","643","164","46","853","1515","0","56.3","42.44"
"65","000","00","001","01A3","0963","688","530","158","67","755","1225","0","61.63","43.27"
"65","000","00","001","01A4","0000","1531","1120","411","164","1695","2949","0","57.48","37.98"
"65","000","00","001","01A4","0991","696","519","177","68","764","1245","0","61.37","41.69"
"65","000","00","001","01A4","0992","835","601","234","96","931","1704","0","54.64","35.27"
"65","000","00","001","01A5","0000","1555","1277","278","75","1630","3134","0","52.01","40.75"
"65","000","00","001","01A5","1012","483","425","58","25","508","1076","0","47.21","39.5"
"65","000","00","001","01A5","1013","440","343","97","16","456","979","0","46.58","35.04"
"65","000","00","001","01A5","1014","632","509","123","34","666","1079","0","61.72","47.17"
"65","000","00","001","01A6","0000","1338","981","357","112","1450","2493","0","58.16","39.35"
"65","000","00","001","01A6","1033","743","543","200","78","821","1315","0","62.43","41.29"
"65","000","00","001","01A6","1034","595","438","157","34","629","1178","0","53.4","37.18"
"65","000","00","001","01A7","0000","1112","856","256","40","1152","2026","0","56.86","42.25"
"65","000","00","001","01A7","1069","498","384","114","20","518","992","0","52.22","38.71"
"65","000","00","001","01A7","1070","614","472","142","20","634","1034","0","61.32","45.65"
"65","000","00","001","01A8","0000","1433","1125","308","93","1526","2697","0","56.58","41.71"
"65","000","00","001","01A8","1084","746","595","151","46","792","1515","0","52.28","39.27"
"65","000","00","001","01A8","1085","687","530","157","47","734","1182","0","62.1","44.84"
"65","000","00","001","01A9","0000","1073","780","293","101","1174","1966","0","59.72","39.67"
"65","000","00","001","01A9","1114","523","369","154","61","584","972","0","60.08","37.96"
"65","000","00","001","01A9","1115","550","411","139","40","590","994","0","59.36","41.35"
"65","000","00","001","01B0","0000","1851","1417","434","151","2002","3337","0","59.99","42.46"
"65","000","00","001","01B0","1131","925","711","214","38","963","1625","0","59.26","43.75"
"65","000","00","001","01B0","1132","926","706","220","113","1039","1712","0","60.69","41.24"
"65","000","00","001","01B1","0000","927","653","274","90","1017","1860","0","54.68","35.11"
"65","000","00","001","01B1","1168","493","348","145","49","542","998","0","54.31","34.87"
"65","000","00","001","01B1","1169","434","305","129","41","475","862","0","55.1","35.38"
"65","000","00","001","01B2","0000","1832","1390","442","113","1945","3778","0","51.48","36.79"
"65","000","00","001","01B2","1230","921","706","215","41","962","1885","0","51.03","37.45"
"65","000","00","001","01B2","1231","911","684","227","72","983","1893","0","51.93","36.13"
"65","000","00","001","01B3","0000","2482","1997","485","146","2628","5613","0","46.82","35.58"
"65","000","00","001","01B3","1215","913","757","156","32","945","2201","0","42.94","34.39"
"65","000","00","001","01B3","1216","794","619","175","63","857","1626","0","52.71","38.07"
"65","000","00","001","01B3","1217","775","621","154","51","826","1786","0","46.25","34.77"
"65","000","00","001","01B4","0000","1123","866","257","40","1163","2314","0","50.26","37.42"
"65","000","00","001","01B4","0926","583","455","128","13","596","1215","0","49.05","37.45"
"65","000","00","001","01B4","0927","540","411","129","27","567","1099","0","51.59","37.4"
"65","000","00","001","01B5","0000","1033","826","207","120","1153","1793","0","64.31","46.07"
"65","000","00","001","01B5","0945","462","361","101","44","506","796","0","63.57","45.35"
"65","000","00","001","01B5","0946","571","465","106","76","647","997","0","64.89","46.64"
"65","000","00","001","01B6","0000","1348","1014","334","163","1511","2487","0","60.76","40.77"
"65","000","00","001","01B6","0967","723","535","188","70","793","1283","0","61.81","41.7"
"65","000","00","001","01B6","0968","625","479","146","93","718","1204","0","59.63","39.78"
"65","000","00","001","01B7","0000","1603","1234","369","186","1789","3024","0","59.16","40.81"
"65","000","00","001","01B7","1002","575","444","131","83","658","1133","0","58.08","39.19"
"65","000","00","001","01B7","1003","431","331","100","42","473","841","0","56.24","39.36"
"65","000","00","001","01B7","1004","597","459","138","61","658","1050","0","62.67","43.71"
"65","000","00","001","01B8","0000","1153","878","275","144","1297","2059","0","62.99","42.64"
"65","000","00","001","01B8","1029","629","489","140","65","694","1096","0","63.32","44.62"
"65","000","00","001","01B8","1030","524","389","135","79","603","963","0","62.62","40.39"
"65","000","00","001","01B9","0000","1691","1273","418","199","1890","3428","0","55.13","37.14"
"65","000","00","001","01B9","1042","826","606","220","99","925","1678","0","55.13","36.11"
"65","000","00","001","01B9","1043","865","667","198","100","965","1750","0","55.14","38.11"
"65","000","00","001","01C0","0000","1505","1123","382","113","1618","2942","0","55.0","38.17"
"65","000","00","001","01C0","1075","785","589","196","69","854","1349","0","63.31","43.66"
"65","000","00","001","01C0","1076","720","534","186","44","764","1593","0","47.96","33.52"
"65","000","00","001","01C1","0000","1697","1321","376","100","1797","3428","0","52.42","38.54"
"65","000","00","001","01C1","1093","937","745","192","33","970","1954","0","49.64","38.13"
"65","000","00","001","01C1","1094","760","576","184","67","827","1474","0","56.11","39.08"
"65","000","00","001","01C2","0000","1054","824","230","133","1187","2061","0","57.59","39.98"
"65","000","00","001","01C2","1119","515","408","107","80","595","1021","0","58.28","39.96"
"65","000","00","001","01C2","1120","539","416","123","53","592","1040","0","56.92","40.0"
"65","000","00","001","01C3","0000","1931","1486","445","133","2064","3645","0","56.63","40.77"
"65","000","00","001","01C3","1161","661","507","154","26","687","1289","0","53.3","39.33"
"65","000","00","001","01C3","1162","631","501","130","40","671","1182","0","56.77","42.39"
"65","000","00","001","01C3","1163","639","478","161","67","706","1174","0","60.14","40.72"
"65","000","00","001","01C4","0000","6007","4802","1205","352","6359","12065","0","52.71","39.8"
"65","000","00","001","01C4","1221","864","716","148","37","901","1861","0","48.41","38.47"
"65","000","00","001","01C4","1222","747","571","176","30","777","1596","0","48.68","35.78"
"65","000","00","001","01C4","1223","950","723","227","65","1015","1871","0","54.25","38.64"
"65","000","00","001","01C4","1224","998","807","191","65","1063","1938","0","54.85","41.64"
"65","000","00","001","01C4","1225","961","762","199","51","1012","1827","0","55.39","41.71"
"65","000","00","001","01C4","1226","672","545","127","37","709","1359","0","52.17","40.1"
"65","000","00","001","01C4","1227","815","678","137","67","882","1613","0","54.68","42.03"
"65","000","00","001","01C5","0000","1536","1129","407","151","1687","3241","0","52.05","34.83"
"65","000","00","001","01C5","1189","743","564","179","52","795","1630","0","48.77","34.6"
"65","000","00","001","01C5","1190","793","565","228","99","892","1611","0","55.37","35.07"
"65","000","00","001","01C6","0000","559","419","140","32","591","1139","0","51.89","36.79"
"65","000","00","001","01C6","1191","559","419","140","32","591","1139","0","51.89","36.79"
"65","000","00","002","0000","0000","167528","128111","39417","16104","183632","329846","386077","55.67","38.84"
"65","000","00","002","0201","0000","2470","1909","561","209","2679","4753","0","56.36","40.16"
"65","000","00","002","0201","0659","736","577","159","71","807","1509","0","53.48","38.24"
"65","000","00","002","0201","0660","853","655","198","67","920","1591","0","57.83","41.17"
"65","000","00","002","0201","0661","881","677","204","71","952","1653","0","57.59","40.96"
"65","000","00","002","0202","0000","783","621","162","49","832","1459","0","57.03","42.56"
"65","000","00","002","0202","0665","783","621","162","49","832","1459","0","57.03","42.56"
"65","000","00","002","0203","0000","1131","852","279","124","1255","2090","0","60.05","40.77"
"65","000","00","002","0203","0666","552","417","135","62","614","1024","0","59.96","40.72"
"65","000","00","002","0203","0667","579","435","144","62","641","1066","0","60.13","40.81"
"65","000","00","002","0204","0000","502","395","107","64","566","856","0","66.12","46.14"
"65","000","00","002","0204","0668","502","395","107","64","566","856","0","66.12","46.14"
"65","000","00","002","0205","0000","1719","1277","442","127","1846","3533","0","52.25","36.14"
"65","000","00","002","0205","0671","911","670","241","70","981","1887","0","51.99","35.51"
"65","000","00","002","0205","0672","808","607","201","57","865","1646","0","52.55","36.88"
"65","000","00","002","0206","0000","193","154","39","17","210","358","0","58.66","43.02"
"65","000","00","002","0206","0673","193","154","39","17","210","358","0","58.66","43.02"
"65","000","00","002","0207","0000","2915","2213","702","205","3120","5443","0","57.32","40.66"
"65","000","00","002","0207","0674","577","458","119","44","621","1039","0","59.77","44.08"
"65","000","00","002","0207","0675","614","444","170","42","656","1114","0","58.89","39.86"
"65","000","00","002","0207","0676","877","662","215","57","934","1588","0","58.82","41.69"
"65","000","00","002","0207","0677","847","649","198","62","909","1702","0","53.41","38.13"
"65","000","00","002","0208","0000","2623","1974","649","201","2824","4778","0","59.1","41.31"
"65","000","00","002","0208","0678","730","539","191","63","793","1288","0","61.57","41.85"
"65","000","00","002","0208","0679","922","673","249","65","987","1629","0","60.59","41.31"
"65","000","00","002","0208","0680","971","762","209","73","1044","1861","0","56.1","40.95"
"65","000","00","002","0209","0000","1629","1252","377","149","1778","3108","0","57.21","40.28"
"65","000","00","002","0209","0683","829","651","178","78","907","1595","0","56.87","40.82"
"65","000","00","002","0209","0684","800","601","199","71","871","1513","0","57.57","39.72"
"65","000","00","002","0210","0000","3076","2301","775","193","3269","8503","0","38.45","27.06"
"65","000","00","002","0210","0685","770","554","216","53","823","4433","0","18.57","12.5"
"65","000","00","002","0210","0686","696","529","167","49","745","1283","0","58.07","41.23"
"65","000","00","002","0210","0687","814","621","193","57","871","1430","0","60.91","43.43"
"65","000","00","002","0210","0688","796","597","199","34","830","1357","0","61.16","43.99"
"65","000","00","002","0211","0000","986","758","228","99","1085","1846","0","58.78","41.06"
"65","000","00","002","0211","0689","524","403","121","46","570","963","0","59.19","41.85"
"65","000","00","002","0211","0690","462","355","107","53","515","883","0","58.32","40.2"
"65","000","00","002","0212","0000","1616","1248","368","193","1809","3110","0","58.17","40.13"
"65","000","00","002","0212","0691","752","584","168","102","854","1494","0","57.16","39.09"
"65","000","00","002","0212","0692","864","664","200","91","955","1616","0","59.1","41.09"
"65","000","00","002","0213","0000","2147","1599","548","221","2368","3998","0","59.23","39.99"
"65","000","00","002","0213","0693","687","532","155","76","763","1329","0","57.41","40.03"
"65","000","00","002","0213","0694","747","553","194","58","805","1289","0","62.45","42.9"
"65","000","00","002","0213","0695","713","514","199","87","800","1380","0","57.97","37.25"
"65","000","00","002","0214","0000","3091","2416","675","262","3353","5679","0","59.04","42.54"
"65","000","00","002","0214","0696","889","713","176","54","943","1668","0","56.53","42.75"
"65","000","00","002","0214","0697","698","536","162","78","776","1226","0","63.3","43.72"
"65","000","00","002","0214","0698","765","585","180","69","834","1421","0","58.69","41.17"
"65","000","00","002","0214","0699","739","582","157","61","800","1364","0","58.65","42.67"
"65","000","00","002","0215","0000","2092","1558","534","174","2266","3736","0","60.65","41.7"
"65","000","00","002","0215","0700","687","521","166","46","733","1232","0","59.5","42.29"
"65","000","00","002","0215","0701","718","547","171","60","778","1248","0","62.34","43.83"
"65","000","00","002","0215","0702","687","490","197","68","755","1256","0","60.11","39.01"
"65","000","00","002","0216","0000","1787","1341","446","137","1924","3175","0","60.6","42.24"
"65","000","00","002","0216","0703","857","635","222","75","932","1506","0","61.89","42.16"
"65","000","00","002","0216","0704","930","706","224","62","992","1669","0","59.44","42.3"
"65","000","00","002","0217","0000","2959","2263","696","445","3404","5489","0","62.01","41.23"
"65","000","00","002","0217","0705","669","519","150","97","766","1308","0","58.56","39.68"
"65","000","00","002","0217","0706","775","616","159","53","828","1263","0","65.56","48.77"
"65","000","00","002","0217","0707","755","572","183","183","938","1471","0","63.77","38.89"
"65","000","00","002","0217","0708","760","556","204","112","872","1447","0","60.26","38.42"
"65","000","00","002","0218","0000","2621","2006","615","241","2862","5520","0","51.85","36.34"
"65","000","00","002","0218","0709","761","572","189","71","832","1693","0","49.14","33.79"
"65","000","00","002","0218","0710","1009","779","230","73","1082","2015","0","53.7","38.66"
"65","000","00","002","0218","0711","851","655","196","97","948","1812","0","52.32","36.15"
"65","000","00","002","0219","0000","1471","1127","344","118","1589","2948","0","53.9","38.23"
"65","000","00","002","0219","0712","704","533","171","53","757","1509","0","50.17","35.32"
"65","000","00","002","0219","0713","767","594","173","65","832","1439","0","57.82","41.28"
"65","000","00","002","0220","0000","3374","2601","773","239","3613","6530","0","55.33","39.83"
"65","000","00","002","0220","0714","752","578","174","67","819","1437","0","56.99","40.22"
"65","000","00","002","0220","0715","858","642","216","62","920","1697","0","54.21","37.83"
"65","000","00","002","0220","0716","865","693","172","50","915","1793","0","51.03","38.65"
"65","000","00","002","0220","0717","899","688","211","60","959","1603","0","59.83","42.92"
"65","000","00","002","0221","0000","1212","941","271","86","1298","2292","0","56.63","41.06"
"65","000","00","002","0221","0718","593","455","138","41","634","1166","0","54.37","39.02"
"65","000","00","002","0221","0719","619","486","133","45","664","1126","0","58.97","43.16"
"65","000","00","002","0222","0000","585","451","134","63","648","1291","0","50.19","34.93"
"65","000","00","002","0222","0720","585","451","134","63","648","1291","0","50.19","34.93"
"65","000","00","002","0223","0000","797","595","202","100","897","1597","0","56.17","37.26"
"65","000","00","002","0223","0721","797","595","202","100","897","1597","0","56.17","37.26"
"65","000","00","002","0224","0000","1116","844","272","134","1250","1992","0","62.75","42.37"
"65","000","00","002","0224","0722","590","459","131","72","662","1081","0","61.24","42.46"
"65","000","00","002","0224","0723","526","385","141","62","588","911","0","64.54","42.26"
"65","000","00","002","0225","0000","783","609","174","56","839","1719","0","48.81","35.43"
"65","000","00","002","0225","0724","783","609","174","56","839","1719","0","48.81","35.43"
"65","000","00","002","0226","0000","641","482","159","83","724","1289","0","56.17","37.39"
"65","000","00","002","0226","0725","641","482","159","83","724","1289","0","56.17","37.39"
"65","000","00","002","0227","0000","706","519","187","97","803","1318","0","60.93","39.38"
"65","000","00","002","0227","0726","706","519","187","97","803","1318","0","60.93","39.38"
"65","000","00","002","0228","0000","864","641","223","80","944","1822","0","51.81","35.18"
"65","000","00","002","0228","0727","864","641","223","80","944","1822","0","51.81","35.18"
"65","000","00","002","0229","0000","590","424","166","100","690","1185","0","58.23","35.78"
"65","000","00","002","0229","0728","590","424","166","100","690","1185","0","58.23","35.78"
"65","000","00","002","0230","0000","635","502","133","87","722","1369","0","52.74","36.67"
"65","000","00","002","0230","0729","635","502","133","87","722","1369","0","52.74","36.67"
"65","000","00","002","0231","0000","822","636","186","69","891","1507","0","59.12","42.2"
"65","000","00","002","0231","0730","822","636","186","69","891","1507","0","59.12","42.2"
"65","000","00","002","0232","0000","931","716","215","84","1015","1876","0","54.1","38.17"
"65","000","00","002","0232","0731","489","374","115","63","552","926","0","59.61","40.39"
"65","000","00","002","0232","0732","442","342","100","21","463","950","0","48.74","36.0"
"65","000","00","002","0233","0000","812","612","200","79","891","1678","0","53.1","36.47"
"65","000","00","002","0233","0733","812","612","200","79","891","1678","0","53.1","36.47"
"65","000","00","002","0234","0000","559","435","124","79","638","1117","0","57.12","38.94"
"65","000","00","002","0234","0734","559","435","124","79","638","1117","0","57.12","38.94"
"65","000","00","002","0235","0000","633","490","143","63","696","1318","0","52.81","37.18"
"65","000","00","002","0235","0735","633","490","143","63","696","1318","0","52.81","37.18"
"65","000","00","002","0236","0000","707","537","170","46","753","1388","0","54.25","38.69"
"65","000","00","002","0236","0736","707","537","170","46","753","1388","0","54.25","38.69"
"65","000","00","002","0237","0000","521","395","126","77","598","1026","0","58.28","38.5"
"65","000","00","002","0237","0737","521","395","126","77","598","1026","0","58.28","38.5"
"65","000","00","002","0238","0000","1160","885","275","84","1244","2063","0","60.3","42.9"
"65","000","00","002","0238","0738","622","473","149","49","671","1096","0","61.22","43.16"
"65","000","00","002","0238","0739","538","412","126","35","573","967","0","59.26","42.61"
"65","000","00","002","0239","0000","1755","1337","418","160","1915","3534","0","54.19","37.83"
"65","000","00","002","0239","0740","907","668","239","75","982","1871","0","52.49","35.7"
"65","000","00","002","0239","0741","848","669","179","85","933","1663","0","56.1","40.23"
"65","000","00","002","0240","0000","603","474","129","32","635","1208","0","52.57","39.24"
"65","000","00","002","0240","0742","603","474","129","32","635","1208","0","52.57","39.24"
"65","000","00","002","0241","0000","1199","887","312","90","1289","2476","0","52.06","35.82"
"65","000","00","002","0241","0743","663","480","183","57","720","1398","0","51.5","34.33"
"65","000","00","002","0241","0744","536","407","129","33","569","1078","0","52.78","37.76"
"65","000","00","002","0242","0000","1202","903","299","151","1353","2495","0","54.23","36.19"
"65","000","00","002","0242","0745","520","397","123","66","586","1102","0","53.18","36.03"
"65","000","00","002","0242","0746","682","506","176","85","767","1393","0","55.06","36.32"
"65","000","00","002","0243","0000","1388","1080","308","140","1528","2485","0","61.49","43.46"
"65","000","00","002","0243","0747","669","526","143","74","743","1251","0","59.39","42.05"
"65","000","00","002","0243","0748","719","554","165","66","785","1234","0","63.61","44.89"
"65","000","00","002","0244","0000","1704","1287","417","162","1866","3251","0","57.4","39.59"
"65","000","00","002","0244","0749","877","655","222","82","959","1661","0","57.74","39.43"
"65","000","00","002","0244","0750","827","632","195","80","907","1590","0","57.04","39.75"
"65","000","00","002","0245","0000","2068","1528","540","209","2277","3773","0","60.35","40.5"
"65","000","00","002","0245","0751","625","463","162","76","701","1182","0","59.31","39.17"
"65","000","00","002","0245","0752","741","541","200","77","818","1369","0","59.75","39.52"
"65","000","00","002","0245","0753","702","524","178","56","758","1222","0","62.03","42.88"
"65","000","00","002","0246","0000","636","464","172","104","740","1304","0","56.75","35.58"
"65","000","00","002","0246","0754","636","464","172","104","740","1304","0","56.75","35.58"
"65","000","00","002","0247","0000","514","395","119","52","566","1054","0","53.7","37.48"
"65","000","00","002","0247","0755","514","395","119","52","566","1054","0","53.7","37.48"
"65","000","00","002","0248","0000","835","605","230","80","915","1635","0","55.96","37.0"
"65","000","00","002","0248","0756","835","605","230","80","915","1635","0","55.96","37.0"
"65","000","00","002","0249","0000","855","667","188","79","934","1779","0","52.5","37.49"
"65","000","00","002","0249","0757","855","667","188","79","934","1779","0","52.5","37.49"
"65","000","00","002","0250","0000","848","666","182","86","934","1633","0","57.2","40.78"
"65","000","00","002","0250","0758","848","666","182","86","934","1633","0","57.2","40.78"
"65","000","00","002","0251","0000","1170","902","268","102","1272","2128","0","59.77","42.39"
"65","000","00","002","0251","0759","585","452","133","54","639","1107","0","57.72","40.83"
"65","000","00","002","0251","0760","585","450","135","48","633","1021","0","62.0","44.07"
"65","000","00","002","0252","0000","754","560","194","101","855","1649","0","51.85","33.96"
"65","000","00","002","0252","0761","754","560","194","101","855","1649","0","51.85","33.96"
"65","000","00","002","0253","0000","457","348","109","39","496","874","0","56.75","39.82"
"65","000","00","002","0253","0762","457","348","109","39","496","874","0","56.75","39.82"
"65","000","00","002","0254","0000","711","538","173","112","823","1402","0","58.7","38.37"
"65","000","00","002","0254","0763","711","538","173","112","823","1402","0","58.7","38.37"
"65","000","00","002","0255","0000","772","574","198","93","865","1713","0","50.5","33.51"
"65","000","00","002","0255","0764","772","574","198","93","865","1713","0","50.5","33.51"
"65","000","00","002","0256","0000","991","739","252","113","1104","2011","0","54.9","36.75"
"65","000","00","002","0256","0765","435","330","105","54","489","973","0","50.26","33.92"
"65","000","00","002","0256","0766","556","409","147","59","615","1038","0","59.25","39.4"
"65","000","00","002","0257","0000","845","650","195","96","941","1833","0","51.34","35.46"
"65","000","00","002","0257","0767","845","650","195","96","941","1833","0","51.34","35.46"
"65","000","00","002","0258","0000","413","311","102","45","458","817","0","56.06","38.07"
"65","000","00","002","0258","0768","413","311","102","45","458","817","0","56.06","38.07"
"65","000","00","002","0259","0000","747","567","180","80","827","1387","0","59.63","40.88"
"65","000","00","002","0259","0769","747","567","180","80","827","1387","0","59.63","40.88"
"65","000","00","002","0260","0000","437","346","91","32","469","784","0","59.82","44.13"
"65","000","00","002","0260","0770","437","346","91","32","469","784","0","59.82","44.13"
"65","000","00","002","0261","0000","1160","890","270","93","1253","2259","0","55.47","39.4"
"65","000","00","002","0261","0771","529","398","131","31","560","1096","0","51.09","36.31"
"65","000","00","002","0261","0772","631","492","139","62","693","1163","0","59.59","42.3"
"65","000","00","002","0262","0000","917","724","193","62","979","1868","0","52.41","38.76"
"65","000","00","002","0262","0773","917","724","193","62","979","1868","0","52.41","38.76"
"65","000","00","002","0263","0000","989","754","235","125","1114","2051","0","54.31","36.76"
"65","000","00","002","0263","0774","544","411","133","71","615","1117","0","55.06","36.79"
"65","000","00","002","0263","0775","445","343","102","54","499","934","0","53.43","36.72"
"65","000","00","002","0264","0000","665","492","173","76","741","1412","0","52.48","34.84"
"65","000","00","002","0264","0776","665","492","173","76","741","1412","0","52.48","34.84"
"65","000","00","002","0265","0000","620","500","120","50","670","1062","0","63.09","47.08"
"65","000","00","002","0265","0777","620","500","120","50","670","1062","0","63.09","47.08"
"65","000","00","002","0266","0000","987","782","205","164","1151","1827","0","63.0","42.8"
"65","000","00","002","0266","0778","436","354","82","76","512","891","0","57.46","39.73"
"65","000","00","002","0266","0779","551","428","123","88","639","936","0","68.27","45.73"
"65","000","00","002","0267","0000","1012","746","266","94","1106","2150","0","51.44","34.7"
"65","000","00","002","0267","0780","526","392","134","72","598","1085","0","55.12","36.13"
"65","000","00","002","0267","0781","486","354","132","22","508","1065","0","47.7","33.24"
"65","000","00","002","0268","0000","1564","1182","382","124","1688","2948","0","57.26","40.09"
"65","000","00","002","0268","0782","739","555","184","66","805","1398","0","57.58","39.7"
"65","000","00","002","0268","0783","825","627","198","58","883","1550","0","56.97","40.45"
"65","000","00","002","0269","0000","807","608","199","98","905","1674","0","54.06","36.32"
"65","000","00","002","0269","0784","807","608","199","98","905","1674","0","54.06","36.32"
"65","000","00","002","0270","0000","638","496","142","73","711","1215","0","58.52","40.82"
"65","000","00","002","0270","0785","638","496","142","73","711","1215","0","58.52","40.82"
"65","000","00","002","0271","0000","809","589","220","75","884","1606","0","55.04","36.67"
"65","000","00","002","0271","0786","809","589","220","75","884","1606","0","55.04","36.67"
"65","000","00","002","0272","0000","1244","991","253","144","1388","2420","0","57.36","40.95"
"65","000","00","002","0272","0787","604","493","111","56","660","1182","0","55.84","41.71"
"65","000","00","002","0272","0788","640","498","142","88","728","1238","0","58.8","40.23"
"65","000","00","002","0273","0000","1495","1140","355","122","1617","2750","0","58.8","41.45"
"65","000","00","002","0273","0789","735","560","175","63","798","1342","0","59.46","41.73"
"65","000","00","002","0273","0790","760","580","180","59","819","1408","0","58.17","41.19"
"65","000","00","002","0274","0000","884","696","188","103","987","1770","0","55.76","39.32"
"65","000","00","002","0274","0791","884","696","188","103","987","1770","0","55.76","39.32"
"65","000","00","002","0275","0000","972","733","239","85","1057","1915","0","55.2","38.28"
"65","000","00","002","0275","0792","488","367","121","61","549","940","0","58.4","39.04"
"65","000","00","002","0275","0793","484","366","118","24","508","975","0","52.1","37.54"
"65","000","00","002","0276","0000","2143","1653","490","187","2330","4183","0","55.7","39.52"
"65","000","00","002","0276","0794","747","577","170","54","801","1507","0","53.15","38.29"
"65","000","00","002","0276","0795","737","553","184","76","813","1419","0","57.29","38.97"
"65","000","00","002","0276","0796","659","523","136","57","716","1257","0","56.96","41.61"
"65","000","00","002","0277","0000","1695","1274","421","178","1873","3364","0","55.68","37.87"
"65","000","00","002","0277","0797","831","601","230","90","921","1619","0","56.89","37.12"
"65","000","00","002","0277","0798","864","673","191","88","952","1745","0","54.56","38.57"
"65","000","00","002","0278","0000","2515","1903","612","222","2737","4898","0","55.88","38.85"
"65","000","00","002","0278","0799","786","579","207","72","858","1519","0","56.48","38.12"
"65","000","00","002","0278","0800","807","621","186","82","889","1682","0","52.85","36.92"
"65","000","00","002","0278","0801","922","703","219","68","990","1697","0","58.34","41.43"
"65","000","00","002","0279","0000","954","752","202","134","1088","1997","0","54.48","37.66"
"65","000","00","002","0279","0802","500","405","95","78","578","1073","0","53.87","37.74"
"65","000","00","002","0279","0803","454","347","107","56","510","924","0","55.19","37.55"
"65","000","00","002","0280","0000","701","541","160","56","757","1613","0","46.93","33.54"
"65","000","00","002","0280","0804","701","541","160","56","757","1613","0","46.93","33.54"
"65","000","00","002","0281","0000","1069","827","242","128","1197","2152","0","55.62","38.43"
"65","000","00","002","0281","0805","495","398","97","58","553","1034","0","53.48","38.49"
"65","000","00","002","0281","0806","574","429","145","70","644","1118","0","57.6","38.37"
"65","000","00","002","0282","0000","1780","1324","456","236","2016","3595","0","56.08","36.83"
"65","000","00","002","0282","0807","629","463","166","82","711","1269","0","56.03","36.49"
"65","000","00","002","0282","0808","481","351","130","69","550","990","0","55.56","35.45"
"65","000","00","002","0282","0809","670","510","160","85","755","1336","0","56.51","38.17"
"65","000","00","002","0283","0000","1702","1260","442","145","1847","3182","0","58.05","39.6"
"65","000","00","002","0283","0810","833","649","184","63","896","1601","0","55.97","40.54"
"65","000","00","002","0283","0811","869","611","258","82","951","1581","0","60.15","38.65"
"65","000","00","002","0284","0000","1413","1053","360","121","1534","2571","0","59.67","40.96"
"65","000","00","002","0284","0812","716","554","162","65","781","1345","0","58.07","41.19"
"65","000","00","002","0284","0813","697","499","198","56","753","1226","0","61.42","40.7"
"65","000","00","002","0285","0000","1363","1097","266","160","1523","2790","0","54.59","39.32"
"65","000","00","002","0285","0814","774","628","146","93","867","1650","0","52.55","38.06"
"65","000","00","002","0285","0815","589","469","120","67","656","1140","0","57.54","41.14"
"65","000","00","002","0286","0000","1666","1303","363","125","1791","3338","0","53.65","39.04"
"65","000","00","002","0286","0816","802","633","169","41","843","1639","0","51.43","38.62"
"65","000","00","002","0286","0817","864","670","194","84","948","1699","0","55.8","39.43"
"65","000","00","002","0287","0000","2176","1667","509","224","2400","4355","0","55.11","38.28"
"65","000","00","002","0287","0820","750","590","160","93","843","1540","0","54.74","38.31"
"65","000","00","002","0287","0821","660","518","142","61","721","1276","0","56.5","40.6"
"65","000","00","002","0287","0822","766","559","207","70","836","1539","0","54.32","36.32"
"65","000","00","002","0288","0000","1481","1145","336","150","1631","2898","0","56.28","39.51"
"65","000","00","002","0288","0828","713","551","162","83","796","1407","0","56.57","39.16"
"65","000","00","002","0288","0829","768","594","174","67","835","1491","0","56.0","39.84"
"65","000","00","002","0289","0000","2421","1797","624","244","2665","4718","0","56.49","38.09"
"65","000","00","002","0289","0837","738","528","210","81","819","1398","0","58.58","37.77"
"65","000","00","002","0289","0838","829","623","206","92","921","1706","0","53.99","36.52"
"65","000","00","002","0289","0839","854","646","208","71","925","1614","0","57.31","40.02"
"65","000","00","002","0290","0000","2407","1817","590","224","2631","4723","0","55.71","38.47"
"65","000","00","002","0290","0840","826","620","206","68","894","1591","0","56.19","38.97"
"65","000","00","002","0290","0841","807","617","190","64","871","1627","0","53.53","37.92"
"65","000","00","002","0290","0842","774","580","194","92","866","1505","0","57.54","38.54"
"65","000","00","002","0291","0000","1768","1483","285","115","1883","3577","0","52.64","41.46"
"65","000","00","002","0291","0832","950","743","207","65","1015","1938","0","52.37","38.34"
"65","000","00","002","0291","0833","818","740","78","50","868","1639","0","52.96","45.15"
"65","000","00","002","0292","0000","1247","923","324","94","1341","2290","0","58.56","40.31"
"65","000","00","002","0292","0823","651","496","155","52","703","1170","0","60.09","42.39"
"65","000","00","002","0292","0824","596","427","169","42","638","1120","0","56.96","38.13"
"65","000","00","002","0293","0000","3608","2753","855","258","3866","7372","0","52.44","37.34"
"65","000","00","002","0293","0846","982","744","238","78","1060","1800","0","58.89","41.33"
"65","000","00","002","0293","0847","785","602","183","53","838","1703","0","49.21","35.35"
"65","000","00","002","0293","0848","927","728","199","57","984","1975","0","49.82","36.86"
"65","000","00","002","0293","0849","914","679","235","70","984","1894","0","51.95","35.85"
"65","000","00","002","0294","0000","2128","1614","514","166","2294","3957","0","57.97","40.79"
"65","000","00","002","0294","0850","766","585","181","58","824","1405","0","58.65","41.64"
"65","000","00","002","0294","0851","697","529","168","46","743","1293","0","57.46","40.91"
"65","000","00","002","0294","0852","665","500","165","62","727","1259","0","57.74","39.71"
"65","000","00","002","0295","0000","1989","1535","454","230","2219","3711","0","59.8","41.36"
"65","000","00","002","0295","0853","626","477","149","82","708","1144","0","61.89","41.7"
"65","000","00","002","0295","0854","687","525","162","80","767","1254","0","61.16","41.87"
"65","000","00","002","0295","0855","676","533","143","68","744","1313","0","56.66","40.59"
"65","000","00","002","0296","0000","1688","1284","404","161","1849","3369","0","54.88","38.11"
"65","000","00","002","0296","0856","784","587","197","85","869","1594","0","54.52","36.83"
"65","000","00","002","0296","0857","904","697","207","76","980","1775","0","55.21","39.27"
"65","000","00","002","0297","0000","1466","1121","345","203","1669","2831","0","58.95","39.6"
"65","000","00","002","0297","0858","747","569","178","101","848","1516","0","55.94","37.53"
"65","000","00","002","0297","0859","719","552","167","102","821","1315","0","62.43","41.98"
"65","000","00","002","0298","0000","995","771","224","131","1126","2003","0","56.22","38.49"
"65","000","00","002","0298","0860","452","338","114","67","519","843","0","61.57","40.09"
"65","000","00","002","0298","0861","543","433","110","64","607","1160","0","52.33","37.33"
"65","000","00","002","0299","0000","1163","889","274","124","1287","2106","0","61.11","42.21"
"65","000","00","002","0299","0862","556","435","121","60","616","1052","0","58.56","41.35"
"65","000","00","002","0299","0863","607","454","153","64","671","1054","0","63.66","43.07"
"65","000","00","002","02A0","0000","983","723","260","105","1088","1933","0","56.29","37.4"
"65","000","00","002","02A0","0864","527","389","138","62","589","997","0","59.08","39.02"
"65","000","00","002","02A0","0865","456","334","122","43","499","936","0","53.31","35.68"
"65","000","00","002","02A1","0000","1539","1160","379","181","1720","3154","0","54.53","36.78"
"65","000","00","002","02A1","0866","810","619","191","99","909","1658","0","54.83","37.33"
"65","000","00","002","02A1","0867","729","541","188","82","811","1496","0","54.21","36.16"
"65","000","00","002","02A2","0000","1240","967","273","124","1364","2216","0","61.55","43.64"
"65","000","00","002","02A2","0868","598","466","132","62","660","1064","0","62.03","43.8"
"65","000","00","002","02A2","0869","642","501","141","62","704","1152","0","61.11","43.49"
"65","000","00","002","02A3","0000","2020","1584","436","164","2184","4173","0","52.34","37.96"
"65","000","00","002","02A3","0870","735","583","152","48","783","1532","0","51.11","38.05"
"65","000","00","002","02A3","0871","597","476","121","39","636","1338","0","47.53","35.58"
"65","000","00","002","02A3","0872","688","525","163","77","765","1303","0","58.71","40.29"
"65","000","00","002","02A4","0000","2125","1635","490","153","2278","4610","0","49.41","35.47"
"65","000","00","002","02A4","0880","624","470","154","31","655","1381","0","47.43","34.03"
"65","000","00","002","02A4","0881","759","600","159","74","833","1681","0","49.55","35.69"
"65","000","00","002","02A4","0882","742","565","177","48","790","1548","0","51.03","36.5"
"65","000","00","002","02A5","0000","2693","2026","667","262","2955","5569","0","53.06","36.38"
"65","000","00","002","02A5","0875","833","637","196","115","948","1821","0","52.06","34.98"
"65","000","00","002","02A5","0876","897","699","198","69","966","1906","0","50.68","36.67"
"65","000","00","002","02A5","0877","963","690","273","78","1041","1842","0","56.51","37.46"
"65","000","00","002","02A6","0000","1485","1182","303","170","1655","2860","0","57.87","41.33"
"65","000","00","002","02A6","0873","733","588","145","86","819","1369","0","59.82","42.95"
"65","000","00","002","02A6","0874","752","594","158","84","836","1491","0","56.07","39.84"
"65","000","00","002","02A7","0000","987","761","226","108","1095","1841","0","59.48","41.34"
"65","000","00","002","02A7","0878","426","336","90","46","472","878","0","53.76","38.27"
"65","000","00","002","02A7","0879","561","425","136","62","623","963","0","64.69","44.13"
"65","000","00","002","02A8","0000","3481","2709","772","234","3715","6784","0","54.76","39.93"
"65","000","00","002","02A8","0883","818","613","205","76","894","1542","0","57.98","39.75"
"65","000","00","002","02A8","0884","797","611","186","73","870","1557","0","55.88","39.24"
"65","000","00","002","02A8","0885","851","685","166","46","897","1661","0","54.0","41.24"
"65","000","00","002","02A8","0886","1015","800","215","39","1054","2024","0","52.08","39.53"
"65","000","00","002","02A9","0000","855","633","222","90","945","1585","0","59.62","39.94"
"65","000","00","002","02A9","0669","397","296","101","42","439","764","0","57.46","38.74"
"65","000","00","002","02A9","0670","458","337","121","48","506","821","0","61.63","41.05"
"65","000","00","002","02B0","0000","2204","1675","529","262","2466","4172","0","59.11","40.15"
"65","000","00","002","02B0","0662","746","552","194","79","825","1392","0","59.27","39.66"
"65","000","00","002","02B0","0663","783","618","165","97","880","1451","0","60.65","42.59"
"65","000","00","002","02B0","0664","675","505","170","86","761","1329","0","57.26","38.0"
"65","000","00","002","02B1","0000","1785","1366","419","109","1894","3540","0","53.5","38.59"
"65","000","00","002","02B1","0681","838","634","204","53","891","1727","0","51.59","36.71"
"65","000","00","002","02B1","0682","947","732","215","56","1003","1813","0","55.32","40.38"
"65","000","00","002","02B2","0000","1374","1052","322","165","1539","2603","0","59.12","40.41"
"65","000","00","002","02B2","0830","749","574","175","76","825","1381","0","59.74","41.56"
"65","000","00","002","02B2","0831","625","478","147","89","714","1222","0","58.43","39.12"
"65","000","00","002","02B3","0000","2587","1950","637","247","2834","5130","0","55.24","38.01"
"65","000","00","002","02B3","0825","915","715","200","94","1009","1789","0","56.4","39.97"
"65","000","00","002","02B3","0826","737","539","198","71","808","1520","0","53.16","35.46"
"65","000","00","002","02B3","0827","935","696","239","82","1017","1821","0","55.85","38.22"
"65","000","00","002","02B4","0000","2241","1761","480","169","2410","4507","0","53.47","39.07"
"65","000","00","002","02B4","0843","704","554","150","50","754","1331","0","56.65","41.62"
"65","000","00","002","02B4","0844","756","603","153","54","810","1678","0","48.27","35.94"
"65","000","00","002","02B4","0845","781","604","177","65","846","1498","0","56.48","40.32"
"65","000","00","002","02B5","0000","2509","1988","521","244","2753","5076","0","54.24","39.16"
"65","000","00","002","02B5","0834","816","665","151","89","905","1614","0","56.07","41.2"
"65","000","00","002","02B5","0835","865","677","188","76","941","1709","0","55.06","39.61"
"65","000","00","002","02B5","0836","828","646","182","79","907","1753","0","51.74","36.85"
"65","000","00","002","02B6","0000","1702","1311","391","162","1864","3039","0","61.34","43.14"
"65","000","00","002","02B6","0818","902","700","202","92","994","1501","0","66.22","46.64"
"65","000","00","002","02B6","0819","800","611","189","70","870","1538","0","56.57","39.73"
"65","000","00","002","02B7","0000","1541","1234","307","188","1729","3294","0","52.49","37.46"
"65","000","00","002","02B7","0887","725","618","107","66","791","1588","0","49.81","38.92"
"65","000","00","002","02B7","0888","816","616","200","122","938","1706","0","54.98","36.11"
"65","000","00","002","02B8","0000","1901","1470","431","183","2084","3705","0","56.25","39.68"
"65","000","00","002","02B8","0889","726","549","177","57","783","1341","0","58.39","40.94"
"65","000","00","002","02B8","0890","488","381","107","49","537","1025","0","52.39","37.17"
"65","000","00","002","02B8","0891","687","540","147","77","764","1339","0","57.06","40.33"
"65","000","00","002","02B9","0000","1812","1408","404","188","2000","3551","0","56.32","39.65"
"65","000","00","002","02B9","0892","850","636","214","108","958","1725","0","55.54","36.87"
"65","000","00","002","02B9","0893","962","772","190","80","1042","1826","0","57.06","42.28"
"65","000","00","003","0000","0000","183546","146208","37338","12119","195665","355978","412545","54.97","41.07"
"65","000","00","003","0301","0000","2585","2016","569","164","2749","5249","0","52.37","38.41"
"65","000","00","003","0301","1232","775","585","190","69","844","1630","0","51.78","35.89"
"65","000","00","003","0301","1233","936","741","195","54","990","1775","0","55.77","41.75"
"65","000","00","003","0301","1234","874","690","184","41","915","1844","0","49.62","37.42"
"65","000","00","003","0302","0000","4262","3423","839","304","4566","8034","0","56.83","42.61"
"65","000","00","003","0302","1282","878","673","205","79","957","1788","0","53.52","37.64"
"65","000","00","003","0302","1283","937","745","192","62","999","1793","0","55.72","41.55"
"65","000","00","003","0302","1284","722","578","144","65","787","1352","0","58.21","42.75"
"65","000","00","003","0302","1285","964","806","158","56","1020","1813","0","56.26","44.46"
"65","000","00","003","0302","1286","761","621","140","42","803","1288","0","62.34","48.21"
"65","000","00","003","0303","0000","1945","1515","430","100","2045","3829","0","53.41","39.57"
"65","000","00","003","0303","1287","619","481","138","41","660","1186","0","55.65","40.56"
"65","000","00","003","0303","1288","610","462","148","10","620","1237","0","50.12","37.35"
"65","000","00","003","0303","1289","716","572","144","49","765","1406","0","54.41","40.68"
"65","000","00","003","0304","0000","2055","1619","436","175","2230","3774","0","59.09","42.9"
"65","000","00","003","0304","1290","735","595","140","73","808","1442","0","56.03","41.26"
"65","000","00","003","0304","1291","580","455","125","56","636","1040","0","61.15","43.75"
"65","000","00","003","0304","1292","740","569","171","46","786","1292","0","60.84","44.04"
"65","000","00","003","0305","0000","1820","1430","390","175","1995","3600","0","55.42","39.72"
"65","000","00","003","0305","1293","919","702","217","64","983","1811","0","54.28","38.76"
"65","000","00","003","0305","1294","901","728","173","111","1012","1789","0","56.57","40.69"
"65","000","00","003","0306","0000","1836","1518","318","120","1956","3177","0","61.57","47.78"
"65","000","00","003","0306","1295","530","446","84","35","565","859","0","65.77","51.92"
"65","000","00","003","0306","1296","594","516","78","32","626","972","0","64.4","53.09"
"65","000","00","003","0306","1297","712","556","156","53","765","1346","0","56.84","41.31"
"65","000","00","003","0307","0000","1269","1017","252","65","1334","2157","0","61.85","47.15"
"65","000","00","003","0307","1235","616","484","132","28","644","1019","0","63.2","47.5"
"65","000","00","003","0307","1236","653","533","120","37","690","1138","0","60.63","46.84"
"65","000","00","003","0308","0000","2945","2378","567","173","3118","5702","0","54.68","41.7"
"65","000","00","003","0308","1237","910","739","171","44","954","1878","0","50.8","39.35"
"65","000","00","003","0308","1238","1079","888","191","53","1132","1980","0","57.17","44.85"
"65","000","00","003","0308","1239","956","751","205","76","1032","1844","0","55.97","40.73"
"65","000","00","003","0309","0000","2799","2215","584","138","2937","5344","0","54.96","41.45"
"65","000","00","003","0309","1240","1107","893","214","44","1151","2085","0","55.2","42.83"
"65","000","00","003","0309","1241","781","616","165","52","833","1498","0","55.61","41.12"
"65","000","00","003","0309","1242","911","706","205","42","953","1761","0","54.12","40.09"
"65","000","00","003","0310","0000","1725","1368","357","124","1849","3294","0","56.13","41.53"
"65","000","00","003","0310","1248","876","669","207","70","946","1712","0","55.26","39.08"
"65","000","00","003","0310","1249","849","699","150","54","903","1582","0","57.08","44.18"
"65","000","00","003","0311","0000","1761","1397","364","106","1867","3235","0","57.71","43.18"
"65","000","00","003","0311","1250","892","708","184","59","951","1742","0","54.59","40.64"
"65","000","00","003","0311","1251","869","689","180","47","916","1493","0","61.35","46.15"
"65","000","00","003","0312","0000","2097","1658","439","160","2257","3990","0","56.57","41.55"
"65","000","00","003","0312","1252","650","515","135","52","702","1352","0","51.92","38.09"
"65","000","00","003","0312","1253","690","554","136","47","737","1244","0","59.24","44.53"
"65","000","00","003","0312","1254","757","589","168","61","818","1394","0","58.68","42.25"
"65","000","00","003","0313","0000","1684","1301","383","118","1802","3747","0","48.09","34.72"
"65","000","00","003","0313","1255","814","634","180","26","840","1917","0","43.82","33.07"
"65","000","00","003","0313","1256","870","667","203","92","962","1830","0","52.57","36.45"
"65","000","00","003","0314","0000","1944","1502","442","149","2093","3892","0","53.78","38.59"
"65","000","00","003","0314","1257","604","465","139","57","661","1124","0","58.81","41.37"
"65","000","00","003","0314","1258","651","509","142","40","691","1412","0","48.94","36.05"
"65","000","00","003","0314","1259","689","528","161","52","741","1356","0","54.65","38.94"
"65","000","00","003","0315","0000","2040","1583","457","189","2229","3940","0","56.57","40.18"
"65","000","00","003","0315","1260","696","537","159","48","744","1425","0","52.21","37.68"
"65","000","00","003","0315","1261","682","534","148","75","757","1259","0","60.13","42.41"
"65","000","00","003","0315","1262","662","512","150","66","728","1256","0","57.96","40.76"
"65","000","00","003","0316","0000","2278","1797","481","165","2443","4502","0","54.26","39.92"
"65","000","00","003","0316","1263","750","589","161","41","791","1423","0","55.59","41.39"
"65","000","00","003","0316","1264","655","537","118","57","712","1221","0","58.31","43.98"
"65","000","00","003","0316","1265","873","671","202","67","940","1858","0","50.59","36.11"
"65","000","00","003","0317","0000","2569","2028","541","143","2712","4958","0","54.7","40.9"
"65","000","00","003","0317","1266","881","708","173","51","932","1804","0","51.66","39.25"
"65","000","00","003","0317","1267","900","691","209","44","944","1669","0","56.56","41.4"
"65","000","00","003","0317","1268","788","629","159","48","836","1485","0","56.3","42.36"
"65","000","00","003","0318","0000","1872","1472","400","170","2042","3351","0","60.94","43.93"
"65","000","00","003","0318","1269","552","428","124","53","605","1005","0","60.2","42.59"
"65","000","00","003","0318","1270","681","524","157","67","748","1175","0","63.66","44.6"
"65","000","00","003","0318","1271","639","520","119","50","689","1171","0","58.84","44.41"
"65","000","00","003","0319","0000","2153","1702","451","114","2267","4413","0","51.37","38.57"
"65","000","00","003","0319","1272","827","655","172","30","857","1746","0","49.08","37.51"
"65","000","00","003","0319","1273","738","575","163","41","779","1555","0","50.1","36.98"
"65","000","00","003","0319","1274","588","472","116","43","631","1112","0","56.74","42.45"
"65","000","00","003","0320","0000","1672","1325","347","92","1764","3286","0","53.68","40.32"
"65","000","00","003","0320","1434","746","591","155","51","797","1462","0","54.51","40.42"
"65","000","00","003","0320","1435","926","734","192","41","967","1824","0","53.02","40.24"
"65","000","00","003","0321","0000","1503","1174","329","112","1615","2823","0","57.21","41.59"
"65","000","00","003","0321","1436","709","544","165","69","778","1389","0","56.01","39.16"
"65","000","00","003","0321","1437","794","630","164","43","837","1434","0","58.37","43.93"
"65","000","00","003","0322","0000","2719","2214","505","133","2852","5350","0","53.31","41.38"
"65","000","00","003","0322","1440","911","751","160","45","956","1858","0","51.45","40.42"
"65","000","00","003","0322","1441","905","740","165","23","928","1801","0","51.53","41.09"
"65","000","00","003","0322","1442","903","723","180","65","968","1691","0","57.24","42.76"
"65","000","00","003","0323","0000","2285","1859","426","112","2397","3948","0","60.71","47.09"
"65","000","00","003","0323","1443","756","595","161","50","806","1363","0","59.13","43.65"
"65","000","00","003","0323","1444","722","599","123","30","752","1220","0","61.64","49.1"
"65","000","00","003","0323","1445","807","665","142","32","839","1365","0","61.47","48.72"
"65","000","00","003","0324","0000","1684","1354","330","122","1806","3205","0","56.35","42.25"
"65","000","00","003","0324","1446","630","515","115","33","663","1178","0","56.28","43.72"
"65","000","00","003","0324","1447","468","375","93","36","504","830","0","60.72","45.18"
"65","000","00","003","0324","1448","586","464","122","53","639","1197","0","53.38","38.76"
"65","000","00","003","0325","0000","3702","2964","738","150","3852","7168","0","53.74","41.35"
"65","000","00","003","0325","1275","1007","816","191","44","1051","1780","0","59.04","45.84"
"65","000","00","003","0325","1276","988","803","185","46","1034","1918","0","53.91","41.87"
"65","000","00","003","0325","1277","737","577","160","30","767","1689","0","45.41","34.16"
"65","000","00","003","0325","1278","970","768","202","30","1000","1781","0","56.15","43.12"
"65","000","00","003","0326","0000","2485","1950","535","152","2637","4567","0","57.74","42.7"
"65","000","00","003","0326","1279","745","583","162","49","794","1419","0","55.95","41.09"
"65","000","00","003","0326","1280","684","542","142","39","723","1344","0","53.79","40.33"
"65","000","00","003","0326","1281","1056","825","231","64","1120","1804","0","62.08","45.73"
"65","000","00","003","0327","0000","2289","1826","463","162","2451","4082","0","60.04","44.73"
"65","000","00","003","0327","1449","742","573","169","54","796","1369","0","58.14","41.86"
"65","000","00","003","0327","1450","744","599","145","51","795","1336","0","59.51","44.84"
"65","000","00","003","0327","1451","803","654","149","57","860","1377","0","62.45","47.49"
"65","000","00","003","0328","0000","1737","1386","351","115","1852","3188","0","58.09","43.48"
"65","000","00","003","0328","1452","815","637","178","67","882","1499","0","58.84","42.49"
"65","000","00","003","0328","1453","922","749","173","48","970","1689","0","57.43","44.35"
"65","000","00","003","0329","0000","2243","1735","508","174","2417","4314","0","56.03","40.22"
"65","000","00","003","0329","1456","832","647","185","67","899","1545","0","58.19","41.88"
"65","000","00","003","0329","1457","674","512","162","65","739","1326","0","55.73","38.61"
"65","000","00","003","0329","1458","737","576","161","42","779","1443","0","53.98","39.92"
"65","000","00","003","0330","0000","3129","2539","590","139","3268","5694","0","57.39","44.59"
"65","000","00","003","0330","1459","906","749","157","32","938","1712","0","54.79","43.75"
"65","000","00","003","0330","1460","985","803","182","58","1043","1916","0","54.44","41.91"
"65","000","00","003","0330","1461","505","402","103","36","541","863","0","62.69","46.58"
"65","000","00","003","0330","1462","733","585","148","13","746","1203","0","62.01","48.63"
"65","000","00","003","0331","0000","2242","1826","416","112","2354","4490","0","52.43","40.67"
"65","000","00","003","0331","1463","779","645","134","17","796","1483","0","53.67","43.49"
"65","000","00","003","0331","1464","806","666","140","31","837","1575","0","53.14","42.29"
"65","000","00","003","0331","1465","657","515","142","64","721","1432","0","50.35","35.96"
"65","000","00","003","0332","0000","2215","1795","420","153","2368","4073","0","58.14","44.07"
"65","000","00","003","0332","1466","748","614","134","59","807","1441","0","56.0","42.61"
"65","000","00","003","0332","1467","700","551","149","55","755","1269","0","59.5","43.42"
"65","000","00","003","0332","1468","767","630","137","39","806","1363","0","59.13","46.22"
"65","000","00","003","0333","0000","1569","1274","295","96","1665","2973","0","56.0","42.85"
"65","000","00","003","0333","1474","779","631","148","44","823","1526","0","53.93","41.35"
"65","000","00","003","0333","1475","790","643","147","52","842","1447","0","58.19","44.44"
"65","000","00","003","0334","0000","1517","1209","308","109","1626","2757","0","58.98","43.85"
"65","000","00","003","0334","1305","694","542","152","45","739","1319","0","56.03","41.09"
"65","000","00","003","0334","1306","823","667","156","64","887","1438","0","61.68","46.38"
"65","000","00","003","0335","0000","3161","2603","558","168","3329","6396","0","52.05","40.7"
"65","000","00","003","0335","1307","875","721","154","34","909","1808","0","50.28","39.88"
"65","000","00","003","0335","1308","586","498","88","23","609","1191","0","51.13","41.81"
"65","000","00","003","0335","1309","839","669","170","65","904","1632","0","55.39","40.99"
"65","000","00","003","0335","1310","861","715","146","46","907","1765","0","51.39","40.51"
"65","000","00","003","0336","0000","2215","1858","357","111","2326","3909","0","59.5","47.53"
"65","000","00","003","0336","1311","667","573","94","33","700","1168","0","59.93","49.06"
"65","000","00","003","0336","1312","613","503","110","24","637","1176","0","54.17","42.77"
"65","000","00","003","0336","1313","935","782","153","54","989","1565","0","63.19","49.97"
"65","000","00","003","0337","0000","2272","1882","390","120","2392","4512","0","53.01","41.71"
"65","000","00","003","0337","1314","759","620","139","48","807","1578","0","51.14","39.29"
"65","000","00","003","0337","1315","1025","859","166","38","1063","2029","0","52.39","42.34"
"65","000","00","003","0337","1316","488","403","85","34","522","905","0","57.68","44.53"
"65","000","00","003","0338","0000","2078","1640","438","202","2280","4293","0","53.11","38.2"
"65","000","00","003","0338","1317","403","327","76","41","444","839","0","52.92","38.97"
"65","000","00","003","0338","1318","406","318","88","32","438","762","0","57.48","41.73"
"65","000","00","003","0338","1319","634","485","149","69","703","1420","0","49.51","34.15"
"65","000","00","003","0338","1320","635","510","125","60","695","1272","0","54.64","40.09"
"65","000","00","003","0339","0000","1886","1533","353","128","2014","3755","0","53.64","40.83"
"65","000","00","003","0339","1321","985","784","201","76","1061","1976","0","53.69","39.68"
"65","000","00","003","0339","1322","901","749","152","52","953","1779","0","53.57","42.1"
"65","000","00","003","0340","0000","1413","1161","252","104","1517","2870","0","52.86","40.45"
"65","000","00","003","0340","1325","647","542","105","48","695","1369","0","50.77","39.59"
"65","000","00","003","0340","1326","766","619","147","56","822","1501","0","54.76","41.24"
"65","000","00","003","0341","0000","178","134","44","20","198","321","0","61.68","41.74"
"65","000","00","003","0341","1329","178","134","44","20","198","321","0","61.68","41.74"
"65","000","00","003","0342","0000","2124","1695","429","185","2309","4556","0","50.68","37.2"
"65","000","00","003","0342","1330","552","414","138","62","614","1474","0","41.66","28.09"
"65","000","00","003","0342","1331","765","630","135","71","836","1461","0","57.22","43.12"
"65","000","00","003","0342","1332","807","651","156","52","859","1621","0","52.99","40.16"
"65","000","00","003","0343","0000","1165","882","283","103","1268","2102","0","60.32","41.96"
"65","000","00","003","0343","1333","753","559","194","68","821","1327","0","61.87","42.13"
"65","000","00","003","0343","1334","412","323","89","35","447","775","0","57.68","41.68"
"65","000","00","003","0344","0000","1966","1538","428","101","2067","6749","0","30.63","22.79"
"65","000","00","003","0344","1337","714","558","156","38","752","4411","0","17.05","12.65"
"65","000","00","003","0344","1338","644","504","140","21","665","1212","0","54.87","41.58"
"65","000","00","003","0344","1339","608","476","132","42","650","1126","0","57.73","42.27"
"65","000","00","003","0345","0000","2098","1680","418","120","2218","4522","0","49.05","37.15"
"65","000","00","003","0345","1346","701","574","127","42","743","1627","0","45.67","35.28"
"65","000","00","003","0345","1347","718","567","151","45","763","1503","0","50.77","37.72"
"65","000","00","003","0345","1348","679","539","140","33","712","1392","0","51.15","38.72"
"65","000","00","003","0346","0000","2072","1658","414","131","2203","3898","0","56.52","42.53"
"65","000","00","003","0346","1349","597","495","102","39","636","1067","0","59.61","46.39"
"65","000","00","003","0346","1350","805","626","179","57","862","1623","0","53.11","38.57"
"65","000","00","003","0346","1351","670","537","133","35","705","1208","0","58.36","44.45"
"65","000","00","003","0347","0000","2269","1856","413","149","2418","4870","0","49.65","38.11"
"65","000","00","003","0347","1352","845","672","173","48","893","1991","0","44.85","33.75"
"65","000","00","003","0347","1353","844","714","130","58","902","1932","0","46.69","36.96"
"65","000","00","003","0347","1354","580","470","110","43","623","947","0","65.79","49.63"
"65","000","00","003","0348","0000","1611","1269","342","138","1749","3234","0","54.08","39.24"
"65","000","00","003","0348","1355","887","692","195","76","963","1660","0","58.01","41.69"
"65","000","00","003","0348","1356","724","577","147","62","786","1574","0","49.94","36.66"
"65","000","00","003","0349","0000","2439","1916","523","229","2668","5146","0","51.85","37.23"
"65","000","00","003","0349","1357","1013","802","211","66","1079","2136","0","50.51","37.55"
"65","000","00","003","0349","1358","701","522","179","80","781","1462","0","53.42","35.7"
"65","000","00","003","0349","1359","725","592","133","83","808","1548","0","52.2","38.24"
"65","000","00","003","0350","0000","2426","1954","472","190","2616","4228","0","61.87","46.22"
"65","000","00","003","0350","1360","434","355","79","23","457","692","0","66.04","51.3"
"65","000","00","003","0350","1361","707","592","115","63","770","1221","0","63.06","48.48"
"65","000","00","003","0350","1362","730","557","173","56","786","1331","0","59.05","41.85"
"65","000","00","003","0350","1363","555","450","105","48","603","984","0","61.28","45.73"
"65","000","00","003","0351","0000","1517","1200","317","103","1620","3150","0","51.43","38.1"
"65","000","00","003","0351","1364","885","693","192","59","944","1871","0","50.45","37.04"
"65","000","00","003","0351","1365","632","507","125","44","676","1279","0","52.85","39.64"
"65","000","00","003","0352","0000","2616","2081","535","151","2767","4826","0","57.34","43.12"
"65","000","00","003","0352","1366","873","684","189","55","928","1629","0","56.97","41.99"
"65","000","00","003","0352","1367","804","649","155","37","841","1482","0","56.75","43.79"
"65","000","00","003","0352","1368","939","748","191","59","998","1715","0","58.19","43.62"
"65","000","00","003","0353","0000","1022","805","217","66","1088","1952","0","55.74","41.24"
"65","000","00","003","0353","1369","1022","805","217","66","1088","1952","0","55.74","41.24"
"65","000","00","003","0354","0000","366","299","67","38","404","686","0","58.89","43.59"
"65","000","00","003","0354","1370","366","299","67","38","404","686","0","58.89","43.59"
"65","000","00","003","0355","0000","3973","3160","813","165","4138","7264","0","56.97","43.5"
"65","000","00","003","0355","1371","722","532","190","33","755","1577","0","47.88","33.73"
"65","000","00","003","0355","1372","638","522","116","10","648","1158","0","55.96","45.08"
"65","000","00","003","0355","1373","716","584","132","24","740","1195","0","61.92","48.87"
"65","000","00","003","0355","1374","643","513","130","32","675","1054","0","64.04","48.67"
"65","000","00","003","0355","1375","361","285","76","30","391","612","0","63.89","46.57"
"65","000","00","003","0355","1376","893","724","169","36","929","1668","0","55.7","43.41"
"65","000","00","003","0356","0000","1365","1054","311","118","1483","2240","0","66.21","47.05"
"65","000","00","003","0356","1377","621","478","143","64","685","1071","0","63.96","44.63"
"65","000","00","003","0356","1378","744","576","168","54","798","1169","0","68.26","49.27"
"65","000","00","003","0357","0000","2687","2160","527","159","2846","5558","0","51.21","38.86"
"65","000","00","003","0357","1379","689","542","147","49","738","1370","0","53.87","39.56"
"65","000","00","003","0357","1380","874","687","187","76","950","1574","0","60.36","43.65"
"65","000","00","003","0357","1381","1124","931","193","34","1158","2614","0","44.3","35.62"
"65","000","00","003","0358","0000","1365","1058","307","109","1474","2518","0","58.54","42.02"
"65","000","00","003","0358","1382","819","627","192","44","863","1477","0","58.43","42.45"
"65","000","00","003","0358","1383","546","431","115","65","611","1041","0","58.69","41.4"
"65","000","00","003","0359","0000","2368","1844","524","183","2551","4723","0","54.01","39.04"
"65","000","00","003","0359","1384","710","582","128","51","761","1538","0","49.48","37.84"
"65","000","00","003","0359","1385","796","605","191","55","851","1599","0","53.22","37.84"
"65","000","00","003","0359","1386","862","657","205","77","939","1586","0","59.21","41.42"
"65","000","00","003","0360","0000","1994","1532","462","178","2172","3580","0","60.67","42.79"
"65","000","00","003","0360","1387","947","725","222","90","1037","1726","0","60.08","42.0"
"65","000","00","003","0360","1388","1047","807","240","88","1135","1854","0","61.22","43.53"
"65","000","00","003","0361","0000","2467","1974","493","184","2651","4390","0","60.39","44.97"
"65","000","00","003","0361","1389","834","662","172","60","894","1472","0","60.73","44.97"
"65","000","00","003","0361","1390","797","635","162","69","866","1430","0","60.56","44.41"
"65","000","00","003","0361","1391","836","677","159","55","891","1488","0","59.88","45.5"
"65","000","00","003","0362","0000","2120","1658","462","167","2287","4066","0","56.25","40.78"
"65","000","00","003","0362","1392","650","497","153","29","679","1251","0","54.28","39.73"
"65","000","00","003","0362","1393","820","667","153","44","864","1487","0","58.1","44.86"
"65","000","00","003","0362","1394","650","494","156","94","744","1328","0","56.02","37.2"
"65","000","00","003","0363","0000","1273","1044","229","79","1352","2136","0","63.3","48.88"
"65","000","00","003","0363","1395","649","539","110","47","696","1128","0","61.7","47.78"
"65","000","00","003","0363","1396","624","505","119","32","656","1008","0","65.08","50.1"
"65","000","00","003","0364","0000","2089","1649","440","120","2209","4005","0","55.16","41.17"
"65","000","00","003","0364","1397","974","760","214","38","1012","1786","0","56.66","42.55"
"65","000","00","003","0364","1398","1115","889","226","82","1197","2219","0","53.94","40.06"
"65","000","00","003","0365","0000","1373","1072","301","66","1439","2817","0","51.08","38.05"
"65","000","00","003","0365","1399","629","480","149","37","666","1322","0","50.38","36.31"
"65","000","00","003","0365","1400","744","592","152","29","773","1495","0","51.71","39.6"
"65","000","00","003","0366","0000","2305","1795","510","170","2475","4456","0","55.54","40.28"
"65","000","00","003","0366","1401","706","531","175","49","755","1414","0","53.39","37.55"
"65","000","00","003","0366","1402","897","705","192","71","968","1681","0","57.58","41.94"
"65","000","00","003","0366","1403","702","559","143","50","752","1361","0","55.25","41.07"
"65","000","00","003","0367","0000","2153","1646","507","130","2283","4089","0","55.83","40.25"
"65","000","00","003","0367","1404","735","561","174","67","802","1442","0","55.62","38.9"
"65","000","00","003","0367","1405","683","519","164","27","710","1383","0","51.34","37.53"
"65","000","00","003","0367","1406","735","566","169","36","771","1264","0","61.0","44.78"
"65","000","00","003","0368","0000","1859","1441","418","163","2022","3761","0","53.76","38.31"
"65","000","00","003","0368","1407","962","740","222","116","1078","1810","0","59.56","40.88"
"65","000","00","003","0368","1408","897","701","196","47","944","1951","0","48.39","35.93"
"65","000","00","003","0369","0000","1782","1534","248","138","1920","3527","0","54.44","43.49"
"65","000","00","003","0369","1409","721","597","124","47","768","1582","0","48.55","37.74"
"65","000","00","003","0369","1410","1061","937","124","91","1152","1945","0","59.23","48.17"
"65","000","00","003","0370","0000","2129","1777","352","110","2239","3950","0","56.68","44.99"
"65","000","00","003","0370","1411","749","609","140","53","802","1390","0","57.7","43.81"
"65","000","00","003","0370","1412","631","496","135","18","649","1161","0","55.9","42.72"
"65","000","00","003","0370","1413","749","672","77","39","788","1399","0","56.33","48.03"
"65","000","00","003","0371","0000","1832","1443","389","126","1958","3453","0","56.7","41.79"
"65","000","00","003","0371","1414","549","432","117","27","576","1070","0","53.83","40.37"
"65","000","00","003","0371","1415","592","461","131","25","617","1169","0","52.78","39.44"
"65","000","00","003","0371","1416","691","550","141","74","765","1214","0","63.01","45.3"
"65","000","00","003","0372","0000","1933","1604","329","95","2028","3371","0","60.16","47.58"
"65","000","00","003","0372","1471","608","515","93","35","643","1150","0","55.91","44.78"
"65","000","00","003","0372","1472","704","572","132","23","727","1154","0","63.0","49.57"
"65","000","00","003","0372","1473","621","517","104","37","658","1067","0","61.67","48.45"
"65","000","00","003","0373","0000","2883","2255","628","124","3007","5742","0","52.37","39.27"
"65","000","00","003","0373","1245","935","738","197","34","969","1789","0","54.16","41.25"
"65","000","00","003","0373","1246","1044","834","210","45","1089","2000","0","54.45","41.7"
"65","000","00","003","0373","1247","904","683","221","45","949","1953","0","48.59","34.97"
"65","000","00","003","0374","0000","917","756","161","52","969","1712","0","56.6","44.16"
"65","000","00","003","0374","1433","917","756","161","52","969","1712","0","56.6","44.16"
"65","000","00","003","0375","0000","1998","1607","391","138","2136","3955","0","54.01","40.63"
"65","000","00","003","0375","1438","973","808","165","63","1036","1953","0","53.05","41.37"
"65","000","00","003","0375","1439","1025","799","226","75","1100","2002","0","54.95","39.91"
"65","000","00","003","0376","0000","1378","1063","315","98","1476","2402","0","61.45","44.25"
"65","000","00","003","0376","1454","744","574","170","56","800","1323","0","60.47","43.39"
"65","000","00","003","0376","1455","634","489","145","42","676","1079","0","62.65","45.32"
"65","000","00","003","0377","0000","1162","939","223","65","1227","2260","0","54.29","41.55"
"65","000","00","003","0377","1469","590","506","84","34","624","1089","0","57.3","46.46"
"65","000","00","003","0377","1470","572","433","139","31","603","1171","0","51.49","36.98"
"65","000","00","003","0378","0000","1322","1083","239","89","1411","2828","0","49.89","38.3"
"65","000","00","003","0378","1323","647","524","123","58","705","1454","0","48.49","36.04"
"65","000","00","003","0378","1324","675","559","116","31","706","1374","0","51.38","40.68"
"65","000","00","003","0379","0000","1130","896","234","121","1251","1970","0","63.5","45.48"
"65","000","00","003","0379","1327","539","424","115","59","598","920","0","65.0","46.09"
"65","000","00","003","0379","1328","591","472","119","62","653","1050","0","62.19","44.95"
"65","000","00","003","0380","0000","1827","1461","366","111","1938","3817","0","50.77","38.28"
"65","000","00","003","0380","1335","918","734","184","42","960","1916","0","50.1","38.31"
"65","000","00","003","0380","1336","909","727","182","69","978","1901","0","51.45","38.24"
"65","000","00","003","0381","0000","3140","2527","613","177","3317","5946","0","55.79","42.5"
"65","000","00","003","0381","1340","747","601","146","26","773","1507","0","51.29","39.88"
"65","000","00","003","0381","1341","793","640","153","28","821","1519","0","54.05","42.13"
"65","000","00","003","0381","1342","792","638","154","49","841","1467","0","57.33","43.49"
"65","000","00","003","0381","1343","808","648","160","74","882","1453","0","60.7","44.6"
"65","000","00","003","0382","0000","1448","1161","287","104","1552","2666","0","58.21","43.55"
"65","000","00","003","0382","1344","773","605","168","50","823","1364","0","60.34","44.35"
"65","000","00","003","0382","1345","675","556","119","54","729","1302","0","55.99","42.7"
"65","000","00","003","0383","0000","1308","1038","270","88","1396","2421","0","57.66","42.87"
"65","000","00","003","0383","1298","563","433","130","37","600","1034","0","58.03","41.88"
"65","000","00","003","0383","1299","745","605","140","51","796","1387","0","57.39","43.62"
"65","000","00","003","0384","0000","1816","1425","391","162","1978","3737","0","52.93","38.13"
"65","000","00","003","0384","1300","1072","854","218","100","1172","2067","0","56.7","41.32"
"65","000","00","003","0384","1301","744","571","173","62","806","1670","0","48.26","34.19"
"65","000","00","003","0385","0000","2082","1663","419","150","2232","3771","0","59.19","44.1"
"65","000","00","003","0385","1417","754","614","140","68","822","1398","0","58.8","43.92"
"65","000","00","003","0385","1418","570","450","120","33","603","1049","0","57.48","42.9"
"65","000","00","003","0385","1419","758","599","159","49","807","1324","0","60.95","45.24"
"65","000","00","003","0386","0000","1609","1264","345","82","1691","3474","0","48.68","36.38"
"65","000","00","003","0386","1420","776","608","168","36","812","1765","0","46.01","34.45"
"65","000","00","003","0386","1421","833","656","177","46","879","1709","0","51.43","38.39"
"65","000","00","003","0387","0000","1349","1044","305","117","1466","2504","0","58.55","41.69"
"65","000","00","003","0387","1422","635","494","141","61","696","1186","0","58.68","41.65"
"65","000","00","003","0387","1423","714","550","164","56","770","1318","0","58.42","41.73"
"65","000","00","003","0388","0000","1456","1140","316","95","1551","3067","0","50.57","37.17"
"65","000","00","003","0388","1424","776","598","178","41","817","1430","0","57.13","41.82"
"65","000","00","003","0388","1425","680","542","138","54","734","1637","0","44.84","33.11"
"65","000","00","003","0389","0000","2044","1603","441","161","2205","3894","0","56.63","41.17"
"65","000","00","003","0389","1426","651","511","140","58","709","1283","0","55.26","39.83"
"65","000","00","003","0389","1427","691","531","160","48","739","1310","0","56.41","40.53"
"65","000","00","003","0389","1428","702","561","141","55","757","1301","0","58.19","43.12"
"65","000","00","003","0390","0000","1643","1280","363","104","1747","3065","0","57.0","41.76"
"65","000","00","003","0390","1429","903","699","204","63","966","1681","0","57.47","41.58"
"65","000","00","003","0390","1430","740","581","159","41","781","1384","0","56.43","41.98"
"65","000","00","003","0391","0000","1407","1098","309","62","1469","2966","0","49.53","37.02"
"65","000","00","003","0391","1431","627","493","134","59","686","1187","0","57.79","41.53"
"65","000","00","003","0391","1432","780","605","175","3","783","1779","0","44.01","34.01"
"65","000","00","003","0392","0000","1661","1330","331","132","1793","3199","0","56.05","41.58"
"65","000","00","003","0392","1302","601","484","117","57","658","1166","0","56.43","41.51"
"65","000","00","003","0392","1303","535","437","98","40","575","963","0","59.71","45.38"
"65","000","00","003","0392","1304","525","409","116","35","560","1070","0","52.34","38.22"
"65","000","00","003","0393","0000","1375","1117","258","85","1460","2597","0","56.22","43.01"
"65","000","00","003","0393","1243","635","512","123","38","673","1254","0","53.67","40.83"
"65","000","00","003","0393","1244","740","605","135","47","787","1343","0","58.6","45.05"
"65","000","00","004","0000","0000","103642","83228","20414","6419","110061","187798","221123","58.61","44.32"
"65","000","00","004","0401","0000","1514","1205","309","104","1618","3012","0","53.72","40.01"
"65","000","00","004","0401","1486","762","600","162","60","822","1568","0","52.42","38.27"
"65","000","00","004","0401","1487","752","605","147","44","796","1444","0","55.12","41.9"
"65","000","00","004","0402","0000","1390","1153","237","73","1463","2535","0","57.71","45.48"
"65","000","00","004","0402","1601","698","581","117","29","727","1189","0","61.14","48.86"
"65","000","00","004","0402","1602","692","572","120","44","736","1346","0","54.68","42.5"
"65","000","00","004","0403","0000","1601","1287","314","81","1682","4440","0","37.88","28.99"
"65","000","00","004","0403","1495","816","678","138","49","865","1598","0","54.13","42.43"
"65","000","00","004","0403","1496","785","609","176","32","817","2842","0","28.75","21.43"
"65","000","00","004","0404","0000","1619","1259","360","94","1713","2710","0","63.21","46.46"
"65","000","00","004","0404","1497","740","564","176","47","787","1261","0","62.41","44.73"
"65","000","00","004","0404","1498","879","695","184","47","926","1449","0","63.91","47.96"
"65","000","00","004","0405","0000","1402","1124","278","93","1495","2418","0","61.83","46.48"
"65","000","00","004","0405","1599","667","528","139","46","713","1155","0","61.73","45.71"
"65","000","00","004","0405","1600","735","596","139","47","782","1263","0","61.92","47.19"
"65","000","00","004","0406","0000","1674","1326","348","63","1737","3034","0","57.25","43.7"
"65","000","00","004","0406","1505","850","680","170","27","877","1566","0","56.0","43.42"
"65","000","00","004","0406","1506","824","646","178","36","860","1468","0","58.58","44.01"
"65","000","00","004","0407","0000","1479","1186","293","78","1557","2486","0","62.63","47.71"
"65","000","00","004","0407","1507","808","653","155","44","852","1305","0","65.29","50.04"
"65","000","00","004","0407","1508","671","533","138","34","705","1181","0","59.7","45.13"
"65","000","00","004","0408","0000","1361","1110","251","116","1477","2537","0","58.22","43.75"
"65","000","00","004","0408","1543","656","541","115","57","713","1234","0","57.78","43.84"
"65","000","00","004","0408","1544","705","569","136","59","764","1303","0","58.63","43.67"
"65","000","00","004","0409","0000","381","324","57","29","410","893","0","45.91","36.28"
"65","000","00","004","0409","1597","381","324","57","29","410","893","0","45.91","36.28"
"65","000","00","004","0410","0000","392","340","52","44","436","743","0","58.68","45.76"
"65","000","00","004","0410","1598","392","340","52","44","436","743","0","58.68","45.76"
"65","000","00","004","0411","0000","2216","1754","462","169","2385","4189","0","56.93","41.87"
"65","000","00","004","0411","1514","789","630","159","67","856","1488","0","57.53","42.34"
"65","000","00","004","0411","1515","730","582","148","64","794","1288","0","61.65","45.19"
"65","000","00","004","0411","1516","697","542","155","38","735","1413","0","52.02","38.36"
"65","000","00","004","0412","0000","1773","1378","395","155","1928","3289","0","58.62","41.9"
"65","000","00","004","0412","1527","935","735","200","89","1024","1798","0","56.95","40.88"
"65","000","00","004","0412","1528","838","643","195","66","904","1491","0","60.63","43.13"
"65","000","00","004","0413","0000","3569","2841","728","210","3779","6230","0","60.66","45.6"
"65","000","00","004","0413","1582","853","662","191","62","915","1598","0","57.26","41.43"
"65","000","00","004","0413","1583","926","743","183","49","975","1609","0","60.6","46.18"
"65","000","00","004","0413","1584","809","629","180","43","852","1375","0","61.96","45.75"
"65","000","00","004","0413","1585","981","807","174","56","1037","1648","0","62.92","48.97"
"65","000","00","004","0414","0000","2396","1884","512","141","2537","4535","0","55.94","41.54"
"65","000","00","004","0414","1579","847","671","176","54","901","1586","0","56.81","42.31"
"65","000","00","004","0414","1580","679","534","145","22","701","1313","0","53.39","40.67"
"65","000","00","004","0414","1581","870","679","191","65","935","1636","0","57.15","41.5"
"65","000","00","004","0415","0000","2143","1658","485","114","2257","3628","0","62.21","45.7"
"65","000","00","004","0415","1558","705","555","150","32","737","1209","0","60.96","45.91"
"65","000","00","004","0415","1559","673","519","154","31","704","1132","0","62.19","45.85"
"65","000","00","004","0415","1560","765","584","181","51","816","1287","0","63.4","45.38"
"65","000","00","004","0416","0000","2382","1956","426","124","2506","4081","0","61.41","47.93"
"65","000","00","004","0416","1520","703","584","119","39","742","1100","0","67.45","53.09"
"65","000","00","004","0416","1521","910","732","178","51","961","1545","0","62.2","47.38"
"65","000","00","004","0416","1522","769","640","129","34","803","1436","0","55.92","44.57"
"65","000","00","004","0417","0000","2169","1743","426","150","2319","3877","0","59.81","44.96"
"65","000","00","004","0417","1517","713","572","141","59","772","1329","0","58.09","43.04"
"65","000","00","004","0417","1518","841","687","154","42","883","1436","0","61.49","47.84"
"65","000","00","004","0417","1519","615","484","131","49","664","1112","0","59.71","43.53"
"65","000","00","004","0418","0000","1468","1167","301","117","1585","2704","0","58.62","43.16"
"65","000","00","004","0418","1489","676","544","132","55","731","1188","0","61.53","45.79"
"65","000","00","004","0418","1490","792","623","169","62","854","1516","0","56.33","41.09"
"65","000","00","004","0419","0000","576","451","125","48","624","1140","0","54.74","39.56"
"65","000","00","004","0419","1488","576","451","125","48","624","1140","0","54.74","39.56"
"65","000","00","004","0420","0000","2034","1630","404","142","2176","3493","0","62.3","46.66"
"65","000","00","004","0420","1523","1020","843","177","62","1082","1731","0","62.51","48.7"
"65","000","00","004","0420","1524","1014","787","227","80","1094","1762","0","62.09","44.67"
"65","000","00","004","0421","0000","1309","1032","277","57","1366","2617","0","52.2","39.43"
"65","000","00","004","0421","1525","700","552","148","44","744","1320","0","56.36","41.82"
"65","000","00","004","0421","1526","609","480","129","13","622","1297","0","47.96","37.01"
"65","000","00","004","0422","0000","966","766","200","51","1017","1783","0","57.04","42.96"
"65","000","00","004","0422","1606","458","369","89","18","476","879","0","54.15","41.98"
"65","000","00","004","0422","1607","508","397","111","33","541","904","0","59.85","43.92"
"65","000","00","004","0423","0000","1753","1369","384","103","1856","3314","0","56.0","41.31"
"65","000","00","004","0423","1480","920","718","202","43","963","1733","0","55.57","41.43"
"65","000","00","004","0423","1481","833","651","182","60","893","1581","0","56.48","41.18"
"65","000","00","004","0424","0000","1994","1634","360","114","2108","3452","0","61.07","47.33"
"65","000","00","004","0424","1568","1063","878","185","46","1109","1876","0","59.12","46.8"
"65","000","00","004","0424","1569","931","756","175","68","999","1576","0","63.39","47.97"
"65","000","00","004","0425","0000","1921","1541","380","82","2003","3469","0","57.74","44.42"
"65","000","00","004","0425","1570","946","749","197","51","997","1661","0","60.02","45.09"
"65","000","00","004","0425","1571","975","792","183","31","1006","1808","0","55.64","43.81"
"65","000","00","004","0426","0000","2069","1630","439","170","2239","3547","0","63.12","45.95"
"65","000","00","004","0426","1563","705","557","148","54","759","1222","0","62.11","45.58"
"65","000","00","004","0426","1564","654","516","138","59","713","1157","0","61.62","44.6"
"65","000","00","004","0426","1565","710","557","153","57","767","1168","0","65.67","47.69"
"65","000","00","004","0427","0000","1442","1120","322","104","1546","2655","0","58.23","42.18"
"65","000","00","004","0427","1566","694","535","159","56","750","1283","0","58.46","41.7"
"65","000","00","004","0427","1567","748","585","163","48","796","1372","0","58.02","42.64"
"65","000","00","004","0428","0000","1631","1317","314","88","1719","2979","0","57.7","44.21"
"65","000","00","004","0428","1610","829","671","158","34","863","1551","0","55.64","43.26"
"65","000","00","004","0428","1611","802","646","156","54","856","1428","0","59.94","45.24"
"65","000","00","004","0429","0000","1304","1045","259","98","1402","2239","0","62.62","46.67"
"65","000","00","004","0429","1608","722","587","135","48","770","1221","0","63.06","48.08"
"65","000","00","004","0429","1609","582","458","124","50","632","1018","0","62.08","44.99"
"65","000","00","004","0430","0000","2211","1787","424","89","2300","3932","0","58.49","45.45"
"65","000","00","004","0430","1551","692","558","134","28","720","1210","0","59.5","46.12"
"65","000","00","004","0430","1552","892","717","175","34","926","1630","0","56.81","43.99"
"65","000","00","004","0430","1553","627","512","115","27","654","1092","0","59.89","46.89"
"65","000","00","004","0431","0000","2429","1958","471","135","2564","4196","0","61.11","46.66"
"65","000","00","004","0431","1547","587","470","117","31","618","991","0","62.36","47.43"
"65","000","00","004","0431","1548","594","479","115","40","634","1016","0","62.4","47.15"
"65","000","00","004","0431","1549","654","532","122","38","692","1146","0","60.38","46.42"
"65","000","00","004","0431","1550","594","477","117","26","620","1043","0","59.44","45.73"
"65","000","00","004","0432","0000","1357","1169","188","84","1441","2334","0","61.74","50.09"
"65","000","00","004","0432","1556","598","475","123","46","644","1049","0","61.39","45.28"
"65","000","00","004","0432","1557","759","694","65","38","797","1285","0","62.02","54.01"
"65","000","00","004","0433","0000","2282","1811","471","146","2428","4225","0","57.47","42.86"
"65","000","00","004","0433","1576","652","537","115","29","681","1177","0","57.86","45.62"
"65","000","00","004","0433","1577","852","682","170","71","923","1557","0","59.28","43.8"
"65","000","00","004","0433","1578","778","592","186","46","824","1491","0","55.26","39.7"
"65","000","00","004","0434","0000","1775","1417","358","118","1893","3434","0","55.13","41.26"
"65","000","00","004","0434","1536","895","695","200","57","952","1713","0","55.58","40.57"
"65","000","00","004","0434","1537","880","722","158","61","941","1721","0","54.68","41.95"
"65","000","00","004","0435","0000","2436","1997","439","159","2595","4177","0","62.13","47.81"
"65","000","00","004","0435","1540","797","652","145","53","850","1348","0","63.06","48.37"
"65","000","00","004","0435","1541","883","733","150","48","931","1461","0","63.72","50.17"
"65","000","00","004","0435","1542","756","612","144","58","814","1368","0","59.5","44.74"
"65","000","00","004","0436","0000","842","656","186","79","921","1554","0","59.27","42.21"
"65","000","00","004","0436","1476","842","656","186","79","921","1554","0","59.27","42.21"
"65","000","00","004","0437","0000","1200","988","212","102","1302","2107","0","61.79","46.89"
"65","000","00","004","0437","1478","500","417","83","42","542","854","0","63.47","48.83"
"65","000","00","004","0437","1479","700","571","129","60","760","1253","0","60.65","45.57"
"65","000","00","004","0438","0000","2565","2059","506","154","2719","4561","0","59.61","45.14"
"65","000","00","004","0438","1499","836","654","182","48","884","1511","0","58.5","43.28"
"65","000","00","004","0438","1500","868","716","152","59","927","1470","0","63.06","48.71"
"65","000","00","004","0438","1501","861","689","172","47","908","1580","0","57.47","43.61"
"65","000","00","004","0439","0000","2231","1823","408","107","2338","3789","0","61.7","48.11"
"65","000","00","004","0439","1502","855","693","162","45","900","1438","0","62.59","48.19"
"65","000","00","004","0439","1503","774","636","138","32","806","1305","0","61.76","48.74"
"65","000","00","004","0439","1504","602","494","108","30","632","1046","0","60.42","47.23"
"65","000","00","004","0440","0000","1609","1298","311","95","1704","2938","0","58.0","44.18"
"65","000","00","004","0440","1545","792","657","135","23","815","1516","0","53.76","43.34"
"65","000","00","004","0440","1546","817","641","176","72","889","1422","0","62.52","45.08"
"65","000","00","004","0441","0000","377","313","64","49","426","768","0","55.47","40.76"
"65","000","00","004","0441","1596","377","313","64","49","426","768","0","55.47","40.76"
"65","000","00","004","0442","0000","489","402","87","38","527","853","0","61.78","47.13"
"65","000","00","004","0442","1595","489","402","87","38","527","853","0","61.78","47.13"
"65","000","00","004","0443","0000","1003","802","201","47","1050","1898","0","55.32","42.26"
"65","000","00","004","0443","1572","1003","802","201","47","1050","1898","0","55.32","42.26"
"65","000","00","004","0444","0000","2415","1919","496","174","2589","4271","0","60.62","44.93"
"65","000","00","004","0444","1573","874","680","194","53","927","1508","0","61.47","45.09"
"65","000","00","004","0444","1574","759","616","143","69","828","1341","0","61.74","45.94"
"65","000","00","004","0444","1575","782","623","159","52","834","1422","0","58.65","43.81"
"65","000","00","004","0445","0000","1156","924","232","96","1252","2011","0","62.26","45.95"
"65","000","00","004","0445","1612","594","468","126","56","650","1044","0","62.26","44.83"
"65","000","00","004","0445","1613","562","456","106","40","602","967","0","62.25","47.16"
"65","000","00","004","0446","0000","1914","1510","404","145","2059","3545","0","58.08","42.6"
"65","000","00","004","0446","1593","1022","813","209","81","1103","1938","0","56.91","41.95"
"65","000","00","004","0446","1594","892","697","195","64","956","1607","0","59.49","43.37"
"65","000","00","004","0447","0000","2462","1958","504","166","2628","4361","0","60.26","44.9"
"65","000","00","004","0447","1511","893","735","158","79","972","1649","0","58.94","44.57"
"65","000","00","004","0447","1512","717","547","170","37","754","1206","0","62.52","45.36"
"65","000","00","004","0447","1513","852","676","176","50","902","1506","0","59.89","44.89"
"65","000","00","004","0448","0000","1538","1284","254","80","1618","2823","0","57.31","45.48"
"65","000","00","004","0448","1509","880","780","100","55","935","1720","0","54.36","45.35"
"65","000","00","004","0448","1510","658","504","154","25","683","1103","0","61.92","45.69"
"65","000","00","004","0449","0000","1906","1508","398","149","2055","3465","0","59.31","43.52"
"65","000","00","004","0449","1533","575","465","110","28","603","1115","0","54.08","41.7"
"65","000","00","004","0449","1534","665","528","137","63","728","1133","0","64.25","46.6"
"65","000","00","004","0449","1535","666","515","151","58","724","1217","0","59.49","42.32"
"65","000","00","004","0450","0000","1310","1059","251","75","1385","2331","0","59.42","45.43"
"65","000","00","004","0450","1529","696","582","114","23","719","1223","0","58.79","47.59"
"65","000","00","004","0450","1530","614","477","137","52","666","1108","0","60.11","43.05"
"65","000","00","004","0451","0000","1691","1364","327","110","1801","3104","0","58.02","43.94"
"65","000","00","004","0451","1484","916","715","201","63","979","1650","0","59.33","43.33"
"65","000","00","004","0451","1485","775","649","126","47","822","1454","0","56.53","44.64"
"65","000","00","004","0452","0000","571","473","98","22","593","1065","0","55.68","44.41"
"65","000","00","004","0452","1477","571","473","98","22","593","1065","0","55.68","44.41"
"65","000","00","004","0453","0000","1125","1003","122","67","1192","2025","0","58.86","49.53"
"65","000","00","004","0453","1493","610","502","108","39","649","1084","0","59.87","46.31"
"65","000","00","004","0453","1494","515","501","14","28","543","941","0","57.7","53.24"
"65","000","00","004","0454","0000","1476","1212","264","104","1580","2835","0","55.73","42.75"
"65","000","00","004","0454","1491","718","594","124","62","780","1397","0","55.83","42.52"
"65","000","00","004","0454","1492","758","618","140","42","800","1438","0","55.63","42.98"
"65","000","00","004","0455","0000","1703","1409","294","80","1783","3298","0","54.06","42.72"
"65","000","00","004","0455","1482","896","725","171","56","952","1735","0","54.87","41.79"
"65","000","00","004","0455","1483","807","684","123","24","831","1563","0","53.17","43.76"
"65","000","00","004","0456","0000","1999","1600","399","98","2097","3653","0","57.4","43.8"
"65","000","00","004","0456","1554","1047","836","211","58","1105","1872","0","59.03","44.66"
"65","000","00","004","0456","1555","952","764","188","40","992","1781","0","55.7","42.9"
"65","000","00","004","0457","0000","1322","1050","272","64","1386","2411","0","57.49","43.55"
"65","000","00","004","0457","1603","727","580","147","46","773","1368","0","56.51","42.4"
"65","000","00","004","0457","1604","595","470","125","18","613","1043","0","58.77","45.06"
"65","000","00","004","0458","0000","977","754","223","44","1021","1709","0","59.74","44.12"
"65","000","00","004","0458","1605","977","754","223","44","1021","1709","0","59.74","44.12"
"65","000","00","004","0459","0000","1428","1140","288","99","1527","2584","0","59.09","44.12"
"65","000","00","004","0459","1538","684","540","144","65","749","1327","0","56.44","40.69"
"65","000","00","004","0459","1539","744","600","144","34","778","1257","0","61.89","47.73"
"65","000","00","004","0460","0000","1518","1174","344","115","1633","2673","0","61.09","43.92"
"65","000","00","004","0460","1531","799","612","187","61","860","1408","0","61.08","43.47"
"65","000","00","004","0460","1532","719","562","157","54","773","1265","0","61.11","44.43"
"65","000","00","004","0461","0000","1274","1029","245","92","1366","2166","0","63.07","47.51"
"65","000","00","004","0461","1561","625","510","115","45","670","1068","0","62.73","47.75"
"65","000","00","004","0461","1562","649","519","130","47","696","1098","0","63.39","47.27"
"65","000","00","004","0462","0000","5123","4148","975","225","5348","8673","0","61.66","47.83"
"65","000","00","004","0462","1586","609","485","124","39","648","1077","0","60.17","45.03"
"65","000","00","004","0462","1587","668","520","148","35","703","1157","0","60.76","44.94"
"65","000","00","004","0462","1588","815","635","180","38","853","1339","0","63.7","47.42"
"65","000","00","004","0462","1589","776","638","138","18","794","1306","0","60.8","48.85"
"65","000","00","004","0462","1590","761","630","131","25","786","1236","0","63.59","50.97"
"65","000","00","004","0462","1591","677","555","122","24","701","1133","0","61.87","48.98"
"65","000","00","004","0462","1592","817","685","132","46","863","1425","0","60.56","48.07"
"65","000","00","005","0000","0000","181249","140045","41204","13774","195023","344981","417405","56.53","40.59"
"65","000","00","005","0501","0000","2672","1986","686","241","2913","4792","0","60.79","41.44"
"65","000","00","005","0501","0302","601","428","173","59","660","1123","0","58.77","38.11"
"65","000","00","005","0501","0303","695","508","187","67","762","1278","0","59.62","39.75"
"65","000","00","005","0501","0304","679","534","145","59","738","1163","0","63.46","45.92"
"65","000","00","005","0501","0305","697","516","181","56","753","1228","0","61.32","42.02"
"65","000","00","005","0502","0000","3709","2850","859","209","3918","7166","0","54.67","39.77"
"65","000","00","005","0502","0328","654","501","153","30","684","1382","0","49.49","36.25"
"65","000","00","005","0502","0329","776","599","177","54","830","1475","0","56.27","40.61"
"65","000","00","005","0502","0330","800","626","174","26","826","1462","0","56.5","42.82"
"65","000","00","005","0502","0331","750","585","165","38","788","1426","0","55.26","41.02"
"65","000","00","005","0502","0332","729","539","190","61","790","1421","0","55.59","37.93"
"65","000","00","005","0503","0000","659","509","150","96","755","1341","0","56.3","37.96"
"65","000","00","005","0503","0449","659","509","150","96","755","1341","0","56.3","37.96"
"65","000","00","005","0504","0000","2176","1609","567","173","2349","3923","0","59.88","41.01"
"65","000","00","005","0504","0306","651","474","177","59","710","1211","0","58.63","39.14"
"65","000","00","005","0504","0307","641","458","183","57","698","1176","0","59.35","38.95"
"65","000","00","005","0504","0308","884","677","207","57","941","1536","0","61.26","44.08"
"65","000","00","005","0505","0000","2051","1612","439","116","2167","3872","0","55.97","41.63"
"65","000","00","005","0505","0333","807","636","171","49","856","1536","0","55.73","41.41"
"65","000","00","005","0505","0334","871","684","187","50","921","1587","0","58.03","43.1"
"65","000","00","005","0505","0335","373","292","81","17","390","749","0","52.07","38.99"
"65","000","00","005","0506","0000","1817","1389","428","171","1988","3313","0","60.01","41.93"
"65","000","00","005","0506","0446","606","472","134","51","657","1107","0","59.35","42.64"
"65","000","00","005","0506","0447","603","471","132","57","660","1063","0","62.09","44.31"
"65","000","00","005","0506","0448","608","446","162","63","671","1143","0","58.71","39.02"
"65","000","00","005","0507","0000","2250","1766","484","189","2439","4240","0","57.52","41.65"
"65","000","00","005","0507","0312","689","545","144","81","770","1353","0","56.91","40.28"
"65","000","00","005","0507","0313","799","605","194","72","871","1409","0","61.82","42.94"
"65","000","00","005","0507","0314","762","616","146","36","798","1478","0","53.99","41.68"
"65","000","00","005","0508","0000","2024","1515","509","235","2259","3930","0","57.48","38.55"
"65","000","00","005","0508","0383","711","517","194","72","783","1342","0","58.35","38.52"
"65","000","00","005","0508","0384","670","494","176","91","761","1341","0","56.75","36.84"
"65","000","00","005","0508","0385","643","504","139","72","715","1247","0","57.34","40.42"
"65","000","00","005","0509","0000","3286","2525","761","215","3501","6296","0","55.61","40.1"
"65","000","00","005","0509","0501","785","610","175","44","829","1539","0","53.87","39.64"
"65","000","00","005","0509","0502","842","631","211","37","879","1586","0","55.42","39.79"
"65","000","00","005","0509","0503","856","657","199","77","933","1631","0","57.2","40.28"
"65","000","00","005","0509","0504","803","627","176","57","860","1540","0","55.84","40.71"
"65","000","00","005","0510","0000","1079","786","293","107","1186","1892","0","62.68","41.54"
"65","000","00","005","0510","0315","516","380","136","59","575","921","0","62.43","41.26"
"65","000","00","005","0510","0316","563","406","157","48","611","971","0","62.92","41.81"
"65","000","00","005","0511","0000","2742","2106","636","226","2968","5088","0","58.33","41.39"
"65","000","00","005","0511","0379","679","496","183","53","732","1167","0","62.72","42.5"
"65","000","00","005","0511","0380","645","505","140","68","713","1299","0","54.89","38.88"
"65","000","00","005","0511","0381","646","499","147","52","698","1207","0","57.83","41.34"
"65","000","00","005","0511","0382","772","606","166","53","825","1415","0","58.3","42.83"
"65","000","00","005","0512","0000","1373","1036","337","120","1493","2771","0","53.88","37.39"
"65","000","00","005","0512","0518","671","515","156","51","722","1371","0","52.66","37.56"
"65","000","00","005","0512","0519","702","521","181","69","771","1400","0","55.07","37.21"
"65","000","00","005","0513","0000","1632","1275","357","118","1750","3070","0","57.0","41.53"
"65","000","00","005","0513","0319","375","280","95","35","410","697","0","58.82","40.17"
"65","000","00","005","0513","0320","662","543","119","40","702","1235","0","56.84","43.97"
"65","000","00","005","0513","0321","595","452","143","43","638","1138","0","56.06","39.72"
"65","000","00","005","0514","0000","2217","1706","511","204","2421","4068","0","59.51","41.94"
"65","000","00","005","0514","0390","724","560","164","52","776","1346","0","57.65","41.6"
"65","000","00","005","0514","0391","734","560","174","84","818","1372","0","59.62","40.82"
"65","000","00","005","0514","0392","759","586","173","68","827","1350","0","61.26","43.41"
"65","000","00","005","0515","0000","5054","3939","1115","290","5344","9838","0","54.32","40.04"
"65","000","00","005","0515","0547","633","503","130","41","674","1126","0","59.86","44.67"
"65","000","00","005","0515","0548","677","522","155","43","720","1240","0","58.06","42.1"
"65","000","00","005","0515","0549","782","620","162","47","829","1460","0","56.78","42.47"
"65","000","00","005","0515","0550","562","421","141","39","601","1072","0","56.06","39.27"
"65","000","00","005","0515","0551","535","414","121","46","581","1127","0","51.55","36.73"
"65","000","00","005","0515","0552","741","592","149","32","773","1332","0","58.03","44.44"
"65","000","00","005","0515","0553","666","513","153","18","684","1341","0","51.01","38.26"
"65","000","00","005","0515","0554","458","354","104","24","482","1140","0","42.28","31.05"
"65","000","00","005","0516","0000","1301","980","321","93","1394","4462","0","31.24","21.96"
"65","000","00","005","0516","0322","525","405","120","28","553","1063","0","52.02","38.1"
"65","000","00","005","0516","0323","776","575","201","65","841","3399","0","24.74","16.92"
"65","000","00","005","0517","0000","2012","1522","490","257","2269","3947","0","57.49","38.56"
"65","000","00","005","0517","0393","643","472","171","82","725","1307","0","55.47","36.11"
"65","000","00","005","0517","0394","684","529","155","92","776","1353","0","57.35","39.1"
"65","000","00","005","0517","0395","685","521","164","83","768","1287","0","59.67","40.48"
"65","000","00","005","0518","0000","2733","2075","658","204","2937","5155","0","56.97","40.25"
"65","000","00","005","0518","0452","703","548","155","44","747","1309","0","57.07","41.86"
"65","000","00","005","0518","0453","689","510","179","45","734","1216","0","60.36","41.94"
"65","000","00","005","0518","0454","641","503","138","43","684","1278","0","53.52","39.36"
"65","000","00","005","0518","0455","700","514","186","72","772","1352","0","57.1","38.02"
"65","000","00","005","0519","0000","857","676","181","78","935","1575","0","59.37","42.92"
"65","000","00","005","0519","0324","857","676","181","78","935","1575","0","59.37","42.92"
"65","000","00","005","0520","0000","975","743","232","124","1099","1907","0","57.63","38.96"
"65","000","00","005","0520","0413","504","384","120","56","560","955","0","58.64","40.21"
"65","000","00","005","0520","0414","471","359","112","68","539","952","0","56.62","37.71"
"65","000","00","005","0521","0000","2960","2288","672","288","3248","6100","0","53.25","37.51"
"65","000","00","005","0521","0485","744","575","169","81","825","1505","0","54.82","38.21"
"65","000","00","005","0521","0486","741","551","190","82","823","1527","0","53.9","36.08"
"65","000","00","005","0521","0487","723","556","167","58","781","1482","0","52.7","37.52"
"65","000","00","005","0521","0488","752","606","146","67","819","1586","0","51.64","38.21"
"65","000","00","005","0522","0000","931","702","229","76","1007","1615","0","62.35","43.47"
"65","000","00","005","0522","0325","931","702","229","76","1007","1615","0","62.35","43.47"
"65","000","00","005","0523","0000","3039","2292","747","231","3270","5541","0","59.01","41.36"
"65","000","00","005","0523","0415","747","573","174","39","786","1412","0","55.67","40.58"
"65","000","00","005","0523","0416","758","550","208","64","822","1415","0","58.09","38.87"
"65","000","00","005","0523","0417","789","598","191","65","854","1421","0","60.1","42.08"
"65","000","00","005","0523","0418","745","571","174","63","808","1293","0","62.49","44.16"
"65","000","00","005","0524","0000","1133","870","263","99","1232","2161","0","57.01","40.26"
"65","000","00","005","0524","0491","566","431","135","45","611","1090","0","56.06","39.54"
"65","000","00","005","0524","0492","567","439","128","54","621","1071","0","57.98","40.99"
"65","000","00","005","0525","0000","2391","1846","545","220","2611","4748","0","54.99","38.88"
"65","000","00","005","0525","0371","805","617","188","85","890","1571","0","56.65","39.27"
"65","000","00","005","0525","0372","788","623","165","73","861","1594","0","54.02","39.08"
"65","000","00","005","0525","0373","798","606","192","62","860","1583","0","54.33","38.28"
"65","000","00","005","0526","0000","1216","998","218","77","1293","2027","0","63.79","49.24"
"65","000","00","005","0526","0386","620","521","99","30","650","984","0","66.06","52.95"
"65","000","00","005","0526","0387","596","477","119","47","643","1043","0","61.65","45.73"
"65","000","00","005","0527","0000","2494","1887","607","186","2680","4704","0","56.97","40.11"
"65","000","00","005","0527","0508","596","473","123","36","632","1181","0","53.51","40.05"
"65","000","00","005","0527","0509","613","443","170","59","672","1135","0","59.21","39.03"
"65","000","00","005","0527","0510","615","453","162","56","671","1173","0","57.2","38.62"
"65","000","00","005","0527","0511","670","518","152","35","705","1215","0","58.02","42.63"
"65","000","00","005","0528","0000","1182","912","270","161","1343","2406","0","55.82","37.91"
"65","000","00","005","0528","0362","563","439","124","62","625","1170","0","53.42","37.52"
"65","000","00","005","0528","0363","619","473","146","99","718","1236","0","58.09","38.27"
"65","000","00","005","0529","0000","1352","1033","319","88","1440","2320","0","62.07","44.53"
"65","000","00","005","0529","0388","711","532","179","43","754","1135","0","66.43","46.87"
"65","000","00","005","0529","0389","641","501","140","45","686","1185","0","57.89","42.28"
"65","000","00","005","0530","0000","2458","1916","542","236","2694","4728","0","56.98","40.52"
"65","000","00","005","0530","0353","800","624","176","92","892","1558","0","57.25","40.05"
"65","000","00","005","0530","0354","793","617","176","72","865","1567","0","55.2","39.37"
"65","000","00","005","0530","0355","865","675","190","72","937","1603","0","58.45","42.11"
"65","000","00","005","0531","0000","2533","1967","566","223","2756","4477","0","61.56","43.94"
"65","000","00","005","0531","0443","833","650","183","72","905","1535","0","58.96","42.35"
"65","000","00","005","0531","0444","872","665","207","69","941","1492","0","63.07","44.57"
"65","000","00","005","0531","0445","828","652","176","82","910","1450","0","62.76","44.97"
"65","000","00","005","0532","0000","2840","2263","577","188","3028","5219","0","58.02","43.36"
"65","000","00","005","0532","0523","668","528","140","63","731","1318","0","55.46","40.06"
"65","000","00","005","0532","0524","770","593","177","61","831","1411","0","58.89","42.03"
"65","000","00","005","0532","0525","695","548","147","28","723","1262","0","57.29","43.42"
"65","000","00","005","0532","0526","707","594","113","36","743","1228","0","60.5","48.37"
"65","000","00","005","0533","0000","2109","1616","493","198","2307","4251","0","54.27","38.01"
"65","000","00","005","0533","0344","619","469","150","61","680","1351","0","50.33","34.72"
"65","000","00","005","0533","0345","728","571","157","67","795","1403","0","56.66","40.7"
"65","000","00","005","0533","0346","762","576","186","70","832","1497","0","55.58","38.48"
"65","000","00","005","0534","0000","1532","1160","372","135","1667","3285","0","50.75","35.31"
"65","000","00","005","0534","0438","717","552","165","62","779","1633","0","47.7","33.8"
"65","000","00","005","0534","0439","815","608","207","73","888","1652","0","53.75","36.8"
"65","000","00","005","0535","0000","1246","948","298","128","1374","2670","0","51.46","35.51"
"65","000","00","005","0535","0529","640","488","152","64","704","1326","0","53.09","36.8"
"65","000","00","005","0535","0530","606","460","146","64","670","1344","0","49.85","34.23"
"65","000","00","005","0536","0000","1546","1166","380","145","1691","3126","0","54.09","37.3"
"65","000","00","005","0536","0326","784","590","194","67","851","1612","0","52.79","36.6"
"65","000","00","005","0536","0327","762","576","186","78","840","1514","0","55.48","38.04"
"65","000","00","005","0537","0000","1969","1509","460","132","2101","3484","0","60.3","43.31"
"65","000","00","005","0537","0400","641","499","142","65","706","1148","0","61.5","43.47"
"65","000","00","005","0537","0401","655","495","160","12","667","1201","0","55.54","41.22"
"65","000","00","005","0537","0402","673","515","158","55","728","1135","0","64.14","45.37"
"65","000","00","005","0538","0000","3158","2514","644","231","3389","6209","0","54.58","40.49"
"65","000","00","005","0538","0542","629","509","120","41","670","1245","0","53.82","40.88"
"65","000","00","005","0538","0543","589","466","123","48","637","1212","0","52.56","38.45"
"65","000","00","005","0538","0544","628","493","135","55","683","1253","0","54.51","39.35"
"65","000","00","005","0538","0545","619","479","140","56","675","1272","0","53.07","37.66"
"65","000","00","005","0538","0546","693","567","126","31","724","1227","0","59.01","46.21"
"65","000","00","005","0539","0000","2081","1622","459","157","2238","3713","0","60.27","43.68"
"65","000","00","005","0539","0374","704","563","141","54","758","1245","0","60.88","45.22"
"65","000","00","005","0539","0375","629","467","162","52","681","1203","0","56.61","38.82"
"65","000","00","005","0539","0376","748","592","156","51","799","1265","0","63.16","46.8"
"65","000","00","005","0540","0000","1106","833","273","77","1183","1990","0","59.45","41.86"
"65","000","00","005","0540","0458","438","335","103","25","463","881","0","52.55","38.02"
"65","000","00","005","0540","0459","668","498","170","52","720","1109","0","64.92","44.91"
"65","000","00","005","0541","0000","2031","1626","405","129","2160","3833","0","56.35","42.42"
"65","000","00","005","0541","0537","691","559","132","23","714","1301","0","54.88","42.97"
"65","000","00","005","0541","0538","666","529","137","57","723","1262","0","57.29","41.92"
"65","000","00","005","0541","0539","674","538","136","49","723","1270","0","56.93","42.36"
"65","000","00","005","0542","0000","1158","915","243","88","1246","2442","0","51.02","37.47"
"65","000","00","005","0542","0369","582","452","130","51","633","1225","0","51.67","36.9"
"65","000","00","005","0542","0370","576","463","113","37","613","1217","0","50.37","38.04"
"65","000","00","005","0543","0000","3840","3045","795","246","4086","7475","0","54.66","40.74"
"65","000","00","005","0543","0460","664","515","149","53","717","1291","0","55.54","39.89"
"65","000","00","005","0543","0461","659","515","144","25","684","1293","0","52.9","39.83"
"65","000","00","005","0543","0462","720","535","185","66","786","1336","0","58.83","40.04"
"65","000","00","005","0543","0463","697","562","135","48","745","1384","0","53.83","40.61"
"65","000","00","005","0543","0464","587","498","89","22","609","1231","0","49.47","40.45"
"65","000","00","005","0543","0465","513","420","93","32","545","940","0","57.98","44.68"
"65","000","00","005","0544","0000","2175","1736","439","151","2326","4010","0","58.0","43.29"
"65","000","00","005","0544","0531","720","590","130","47","767","1355","0","56.61","43.54"
"65","000","00","005","0544","0532","694","546","148","66","760","1306","0","58.19","41.81"
"65","000","00","005","0544","0533","761","600","161","38","799","1349","0","59.23","44.48"
"65","000","00","005","0545","0000","2332","1774","558","224","2556","4756","0","53.74","37.3"
"65","000","00","005","0545","0366","864","661","203","50","914","1586","0","57.63","41.68"
"65","000","00","005","0545","0367","765","584","181","64","829","1597","0","51.91","36.57"
"65","000","00","005","0545","0368","703","529","174","110","813","1573","0","51.68","33.63"
"65","000","00","005","0546","0000","2050","1552","498","233","2283","4025","0","56.72","38.56"
"65","000","00","005","0546","0466","669","502","167","96","765","1369","0","55.88","36.67"
"65","000","00","005","0546","0467","715","557","158","65","780","1384","0","56.36","40.25"
"65","000","00","005","0546","0468","666","493","173","72","738","1272","0","58.02","38.76"
"65","000","00","005","0547","0000","1983","1538","445","168","2151","3876","0","55.5","39.68"
"65","000","00","005","0547","0347","695","538","157","79","774","1272","0","60.85","42.3"
"65","000","00","005","0547","0348","581","460","121","39","620","1269","0","48.86","36.25"
"65","000","00","005","0547","0349","707","540","167","50","757","1335","0","56.7","40.45"
"65","000","00","005","0548","0000","4862","3911","951","278","5140","9217","0","55.77","42.43"
"65","000","00","005","0548","0471","798","629","169","24","822","1528","0","53.8","41.16"
"65","000","00","005","0548","0472","639","529","110","40","679","1244","0","54.58","42.52"
"65","000","00","005","0548","0473","674","543","131","51","725","1356","0","53.47","40.04"
"65","000","00","005","0548","0474","581","484","97","29","610","1164","0","52.41","41.58"
"65","000","00","005","0548","0475","775","636","139","65","840","1423","0","59.03","44.69"
"65","000","00","005","0548","0476","739","578","161","35","774","1250","0","61.92","46.24"
"65","000","00","005","0548","0477","656","512","144","34","690","1252","0","55.11","40.89"
"65","000","00","005","0549","0000","1120","852","268","119","1239","2200","0","56.32","38.73"
"65","000","00","005","0549","0364","529","415","114","66","595","1071","0","55.56","38.75"
"65","000","00","005","0549","0365","591","437","154","53","644","1129","0","57.04","38.71"
"65","000","00","005","0550","0000","4232","2837","1395","246","4478","7788","0","57.5","36.43"
"65","000","00","005","0550","0480","900","215","685","53","953","1646","0","57.9","13.06"
"65","000","00","005","0550","0481","804","638","166","64","868","1551","0","55.96","41.13"
"65","000","00","005","0550","0482","851","664","187","53","904","1526","0","59.24","43.51"
"65","000","00","005","0550","0483","820","634","186","30","850","1518","0","55.99","41.77"
"65","000","00","005","0550","0484","857","686","171","46","903","1547","0","58.37","44.34"
"65","000","00","005","0551","0000","1389","1059","330","114","1503","2542","0","59.13","41.66"
"65","000","00","005","0551","0377","684","527","157","66","750","1255","0","59.76","41.99"
"65","000","00","005","0551","0378","705","532","173","48","753","1287","0","58.51","41.34"
"65","000","00","005","0552","0000","2091","1588","503","153","2244","4004","0","56.04","39.66"
"65","000","00","005","0552","0435","825","623","202","68","893","1584","0","56.38","39.33"
"65","000","00","005","0552","0436","833","654","179","34","867","1602","0","54.12","40.82"
"65","000","00","005","0552","0437","433","311","122","51","484","818","0","59.17","38.02"
"65","000","00","005","0553","0000","4873","3821","1052","268","5141","9369","0","54.87","40.78"
"65","000","00","005","0553","0429","796","618","178","37","833","1641","0","50.76","37.66"
"65","000","00","005","0553","0430","805","608","197","37","842","1633","0","51.56","37.23"
"65","000","00","005","0553","0431","830","653","177","24","854","1531","0","55.78","42.65"
"65","000","00","005","0553","0432","842","675","167","62","904","1517","0","59.59","44.5"
"65","000","00","005","0553","0433","769","595","174","55","824","1487","0","55.41","40.01"
"65","000","00","005","0553","0434","831","672","159","53","884","1560","0","56.67","43.08"
"65","000","00","005","0554","0000","3869","3049","820","289","4158","7331","0","56.72","41.59"
"65","000","00","005","0554","0419","722","565","157","22","744","1475","0","50.44","38.31"
"65","000","00","005","0554","0420","744","587","157","74","818","1429","0","57.24","41.08"
"65","000","00","005","0554","0421","781","623","158","62","843","1481","0","56.92","42.07"
"65","000","00","005","0554","0422","798","634","164","90","888","1472","0","60.33","43.07"
"65","000","00","005","0554","0423","824","640","184","41","865","1474","0","58.68","43.42"
"65","000","00","005","0555","0000","1915","1427","488","186","2101","4163","0","50.47","34.28"
"65","000","00","005","0555","0505","650","469","181","48","698","1388","0","50.29","33.79"
"65","000","00","005","0555","0506","638","479","159","74","712","1388","0","51.3","34.51"
"65","000","00","005","0555","0507","627","479","148","64","691","1387","0","49.82","34.53"
"65","000","00","005","0556","0000","1249","966","283","129","1378","2241","0","61.49","43.11"
"65","000","00","005","0556","0499","623","488","135","61","684","1130","0","60.53","43.19"
"65","000","00","005","0556","0500","626","478","148","68","694","1111","0","62.47","43.02"
"65","000","00","005","0557","0000","1584","1238","346","126","1710","3276","0","52.2","37.79"
"65","000","00","005","0557","0396","655","523","132","36","691","1567","0","44.1","33.38"
"65","000","00","005","0557","0397","929","715","214","90","1019","1709","0","59.63","41.84"
"65","000","00","005","0558","0000","1493","1185","308","107","1600","3244","0","49.32","36.53"
"65","000","00","005","0558","0398","752","614","138","37","789","1616","0","48.82","38.0"
"65","000","00","005","0558","0399","741","571","170","70","811","1628","0","49.82","35.07"
"65","000","00","005","0559","0000","2207","1702","505","170","2377","4258","0","55.82","39.97"
"65","000","00","005","0559","0440","755","575","180","70","825","1498","0","55.07","38.38"
"65","000","00","005","0559","0441","692","533","159","51","743","1379","0","53.88","38.65"
"65","000","00","005","0559","0442","760","594","166","49","809","1381","0","58.58","43.01"
"65","000","00","005","0560","0000","2584","1974","610","219","2803","4394","0","63.79","44.92"
"65","000","00","005","0560","0309","867","691","176","66","933","1486","0","62.79","46.5"
"65","000","00","005","0560","0310","908","695","213","73","981","1513","0","64.84","45.94"
"65","000","00","005","0560","0311","809","588","221","80","889","1395","0","63.73","42.15"
"65","000","00","005","0561","0000","1707","1314","393","221","1928","3322","0","58.04","39.55"
"65","000","00","005","0561","0360","913","710","203","117","1030","1696","0","60.73","41.86"
"65","000","00","005","0561","0361","794","604","190","104","898","1626","0","55.23","37.15"
"65","000","00","005","0562","0000","3091","2383","708","198","3289","5442","0","60.44","43.79"
"65","000","00","005","0562","0409","792","606","186","74","866","1389","0","62.35","43.63"
"65","000","00","005","0562","0410","693","531","162","36","729","1272","0","57.31","41.75"
"65","000","00","005","0562","0411","828","668","160","50","878","1409","0","62.31","47.41"
"65","000","00","005","0562","0412","778","578","200","38","816","1372","0","59.48","42.13"
"65","000","00","005","0563","0000","1705","1299","406","100","1805","3243","0","55.66","40.06"
"65","000","00","005","0563","0358","819","616","203","49","868","1698","0","51.12","36.28"
"65","000","00","005","0563","0359","886","683","203","51","937","1545","0","60.65","44.21"
"65","000","00","005","0564","0000","3165","2499","666","138","3303","5852","0","56.44","42.7"
"65","000","00","005","0564","0340","816","661","155","31","847","1493","0","56.73","44.27"
"65","000","00","005","0564","0341","822","621","201","53","875","1507","0","58.06","41.21"
"65","000","00","005","0564","0342","777","623","154","23","800","1456","0","54.95","42.79"
"65","000","00","005","0564","0343","750","594","156","31","781","1396","0","55.95","42.55"
"65","000","00","005","0565","0000","1667","1313","354","120","1787","3050","0","58.59","43.05"
"65","000","00","005","0565","0317","892","718","174","70","962","1534","0","62.71","46.81"
"65","000","00","005","0565","0318","775","595","180","50","825","1516","0","54.42","39.25"
"65","000","00","005","0566","0000","1768","1396","372","135","1903","3301","0","57.65","42.29"
"65","000","00","005","0566","0497","906","705","201","65","971","1689","0","57.49","41.74"
"65","000","00","005","0566","0498","862","691","171","70","932","1612","0","57.82","42.87"
"65","000","00","005","0567","0000","1176","907","269","114","1290","2105","0","61.28","43.09"
"65","000","00","005","0567","0489","551","416","135","68","619","1065","0","58.12","39.06"
"65","000","00","005","0567","0490","625","491","134","46","671","1040","0","64.52","47.21"
"65","000","00","005","0568","0000","1183","901","282","107","1290","2340","0","55.13","38.5"
"65","000","00","005","0568","0456","621","464","157","57","678","1298","0","52.23","35.75"
"65","000","00","005","0568","0457","562","437","125","50","612","1042","0","58.73","41.94"
"65","000","00","005","0569","0000","1534","1210","324","96","1630","2712","0","60.1","44.62"
"65","000","00","005","0569","0495","793","636","157","56","849","1362","0","62.33","46.7"
"65","000","00","005","0569","0496","741","574","167","40","781","1350","0","57.85","42.52"
"65","000","00","005","0570","0000","3141","2415","726","186","3327","5880","0","56.58","41.07"
"65","000","00","005","0570","0512","818","632","186","48","866","1488","0","58.2","42.47"
"65","000","00","005","0570","0513","769","594","175","61","830","1444","0","57.48","41.14"
"65","000","00","005","0570","0514","781","604","177","48","829","1499","0","55.3","40.29"
"65","000","00","005","0570","0515","773","585","188","29","802","1449","0","55.35","40.37"
"65","000","00","005","0571","0000","2185","1712","473","157","2342","4371","0","53.58","39.17"
"65","000","00","005","0571","0520","739","587","152","71","810","1457","0","55.59","40.29"
"65","000","00","005","0571","0521","733","564","169","16","749","1502","0","49.87","37.55"
"65","000","00","005","0571","0522","713","561","152","70","783","1412","0","55.45","39.73"
"65","000","00","005","0572","0000","2829","2241","588","193","3022","5129","0","58.92","43.69"
"65","000","00","005","0572","0336","720","579","141","46","766","1276","0","60.03","45.38"
"65","000","00","005","0572","0337","671","517","154","37","708","1303","0","54.34","39.68"
"65","000","00","005","0572","0338","712","560","152","59","771","1259","0","61.24","44.48"
"65","000","00","005","0572","0339","726","585","141","51","777","1291","0","60.19","45.31"
"65","000","00","005","0573","0000","1702","1289","413","99","1801","3209","0","56.12","40.17"
"65","000","00","005","0573","0356","812","630","182","40","852","1538","0","55.4","40.96"
"65","000","00","005","0573","0357","890","659","231","59","949","1671","0","56.79","39.44"
"65","000","00","005","0574","0000","2266","1817","449","131","2397","3841","0","62.41","47.31"
"65","000","00","005","0574","0350","758","596","162","35","793","1300","0","61.0","45.85"
"65","000","00","005","0574","0351","736","606","130","44","780","1286","0","60.65","47.12"
"65","000","00","005","0574","0352","772","615","157","52","824","1255","0","65.66","49.0"
"65","000","00","005","0575","0000","4056","3204","852","182","4238","7288","0","58.15","43.96"
"65","000","00","005","0575","0424","816","633","183","26","842","1462","0","57.59","43.3"
"65","000","00","005","0575","0425","841","649","192","42","883","1484","0","59.5","43.73"
"65","000","00","005","0575","0426","786","629","157","51","837","1461","0","57.29","43.05"
"65","000","00","005","0575","0427","800","639","161","34","834","1444","0","57.76","44.25"
"65","000","00","005","0575","0428","813","654","159","29","842","1437","0","58.59","45.51"
"65","000","00","005","0576","0000","5242","4123","1119","296","5538","9313","0","59.47","44.27"
"65","000","00","005","0576","0403","866","646","220","56","922","1495","0","61.67","43.21"
"65","000","00","005","0576","0404","841","643","198","67","908","1486","0","61.1","43.27"
"65","000","00","005","0576","0405","872","700","172","49","921","1483","0","62.1","47.2"
"65","000","00","005","0576","0406","810","660","150","51","861","1553","0","55.44","42.5"
"65","000","00","005","0576","0407","967","764","203","37","1004","1625","0","61.78","47.02"
"65","000","00","005","0576","0408","886","710","176","36","922","1671","0","55.18","42.49"
"65","000","00","005","0577","0000","1186","905","281","97","1283","2159","0","59.43","41.92"
"65","000","00","005","0577","0450","580","455","125","45","625","1063","0","58.8","42.8"
"65","000","00","005","0577","0451","606","450","156","52","658","1096","0","60.04","41.06"
"65","000","00","005","0578","0000","1600","1250","350","70","1670","3402","0","49.09","36.74"
"65","000","00","005","0578","0493","818","625","193","33","851","1704","0","49.94","36.68"
"65","000","00","005","0578","0494","782","625","157","37","819","1698","0","48.23","36.81"
"65","000","00","005","0579","0000","1051","803","248","66","1117","1981","0","56.39","40.54"
"65","000","00","005","0579","0478","527","414","113","27","554","1022","0","54.21","40.51"
"65","000","00","005","0579","0479","524","389","135","39","563","959","0","58.71","40.56"
"65","000","00","005","0580","0000","1162","915","247","75","1237","2131","0","58.05","42.94"
"65","000","00","005","0580","0469","595","483","112","42","637","1073","0","59.37","45.01"
"65","000","00","005","0580","0470","567","432","135","33","600","1058","0","56.71","40.83"
"65","000","00","005","0581","0000","1670","1291","379","156","1826","3288","0","55.54","39.26"
"65","000","00","005","0581","0516","846","666","180","77","923","1640","0","56.28","40.61"
"65","000","00","005","0581","0517","824","625","199","79","903","1648","0","54.79","37.92"
"65","000","00","005","0582","0000","1902","1521","381","148","2050","3509","0","58.42","43.35"
"65","000","00","005","0582","0527","944","754","190","78","1022","1748","0","58.47","43.14"
"65","000","00","005","0582","0528","958","767","191","70","1028","1761","0","58.38","43.55"
"65","000","00","005","0583","0000","2064","1676","388","160","2224","3784","0","58.77","44.29"
"65","000","00","005","0583","0534","666","539","127","42","708","1265","0","55.97","42.61"
"65","000","00","005","0583","0535","705","562","143","64","769","1282","0","59.98","43.84"
"65","000","00","005","0583","0536","693","575","118","54","747","1237","0","60.39","46.48"
"65","000","00","005","0584","0000","1265","919","346","144","1409","2465","0","57.16","37.28"
"65","000","00","005","0584","0540","650","479","171","72","722","1245","0","57.99","38.47"
"65","000","00","005","0584","0541","615","440","175","72","687","1220","0","56.31","36.07"
"65","000","00","006","0000","0000","140023","113797","26226","8228","148251","264053","302055","56.14","43.1"
"65","000","00","006","0601","0000","1629","1401","228","134","1763","3019","0","58.4","46.41"
"65","000","00","006","0601","2049","851","696","155","68","919","1552","0","59.21","44.85"
"65","000","00","006","0601","2050","778","705","73","66","844","1467","0","57.53","48.06"
"65","000","00","006","0602","0000","2008","1646","362","133","2141","3593","0","59.59","45.81"
"65","000","00","006","0602","2051","758","622","136","39","797","1371","0","58.13","45.37"
"65","000","00","006","0602","2052","557","459","98","41","598","991","0","60.34","46.32"
"65","000","00","006","0602","2053","693","565","128","53","746","1231","0","60.6","45.9"
"65","000","00","006","0603","0000","1875","1482","393","100","1975","3408","0","57.95","43.49"
"65","000","00","006","0603","2054","941","755","186","56","997","1701","0","58.61","44.39"
"65","000","00","006","0603","2055","934","727","207","44","978","1707","0","57.29","42.59"
"65","000","00","006","0604","0000","1914","1554","360","73","1987","3639","0","54.6","42.7"
"65","000","00","006","0604","2056","965","798","167","34","999","1773","0","56.35","45.01"
"65","000","00","006","0604","2057","949","756","193","39","988","1866","0","52.95","40.51"
"65","000","00","006","0605","0000","2866","2338","528","144","3010","4958","0","60.71","47.16"
"65","000","00","006","0605","2058","990","813","177","40","1030","1735","0","59.37","46.86"
"65","000","00","006","0605","2059","988","781","207","50","1038","1632","0","63.6","47.86"
"65","000","00","006","0605","2060","888","744","144","54","942","1591","0","59.21","46.76"
"65","000","00","006","0606","0000","2725","2193","532","152","2877","4790","0","60.06","45.78"
"65","000","00","006","0606","2063","679","537","142","57","736","1260","0","58.41","42.62"
"65","000","00","006","0606","2064","1121","916","205","46","1167","1948","0","59.91","47.02"
"65","000","00","006","0606","2065","925","740","185","49","974","1582","0","61.57","46.78"
"65","000","00","006","0607","0000","2712","2241","471","144","2856","5031","0","56.77","44.54"
"65","000","00","006","0607","2070","935","778","157","35","970","1735","0","55.91","44.84"
"65","000","00","006","0607","2071","909","760","149","54","963","1716","0","56.12","44.29"
"65","000","00","006","0607","2072","868","703","165","55","923","1580","0","58.42","44.49"
"65","000","00","006","0608","0000","3311","2598","713","212","3523","5947","0","59.24","43.69"
"65","000","00","006","0608","2073","799","633","166","45","844","1358","0","62.15","46.61"
"65","000","00","006","0608","2074","914","703","211","88","1002","1610","0","62.24","43.66"
"65","000","00","006","0608","2075","730","556","174","43","773","1383","0","55.89","40.2"
"65","000","00","006","0608","2076","868","706","162","36","904","1596","0","56.64","44.24"
"65","000","00","006","0609","0000","1260","1076","184","57","1317","2520","0","52.26","42.7"
"65","000","00","006","0609","2077","686","573","113","38","724","1360","0","53.24","42.13"
"65","000","00","006","0609","2078","574","503","71","19","593","1160","0","51.12","43.36"
"65","000","00","006","0610","0000","1499","1293","206","61","1560","2470","0","63.16","52.35"
"65","000","00","006","0610","2079","731","639","92","35","766","1236","0","61.97","51.7"
"65","000","00","006","0610","2080","768","654","114","26","794","1234","0","64.34","53.0"
"65","000","00","006","0611","0000","1522","1255","267","104","1626","2820","0","57.66","44.5"
"65","000","00","006","0611","2081","858","684","174","59","917","1579","0","58.07","43.32"
"65","000","00","006","0611","2082","664","571","93","45","709","1241","0","57.13","46.01"
"65","000","00","006","0612","0000","729","578","151","60","789","1578","0","50.0","36.63"
"65","000","00","006","0612","2085","729","578","151","60","789","1578","0","50.0","36.63"
"65","000","00","006","0613","0000","1434","1125","309","124","1558","2917","0","53.41","38.57"
"65","000","00","006","0613","2086","746","584","162","48","794","1442","0","55.06","40.5"
"65","000","00","006","0613","2087","688","541","147","76","764","1475","0","51.8","36.68"
"65","000","00","006","0614","0000","4150","3334","816","250","4400","7921","0","55.55","42.09"
"65","000","00","006","0614","2088","876","698","178","48","924","1580","0","58.48","44.18"
"65","000","00","006","0614","2089","794","636","158","38","832","1585","0","52.49","40.13"
"65","000","00","006","0614","2090","828","664","164","60","888","1586","0","55.99","41.87"
"65","000","00","006","0614","2091","1003","803","200","70","1073","1931","0","55.57","41.58"
"65","000","00","006","0614","2092","649","533","116","34","683","1239","0","55.13","43.02"
"65","000","00","006","0615","0000","2353","1920","433","162","2515","4617","0","54.47","41.59"
"65","000","00","006","0615","2097","950","773","177","40","990","1885","0","52.52","41.01"
"65","000","00","006","0615","2098","677","556","121","56","733","1345","0","54.5","41.34"
"65","000","00","006","0615","2099","726","591","135","66","792","1387","0","57.1","42.61"
"65","000","00","006","0616","0000","5420","4367","1053","347","5767","10556","0","54.63","41.37"
"65","000","00","006","0616","2105","916","735","181","71","987","1835","0","53.79","40.05"
"65","000","00","006","0616","2106","1006","805","201","78","1084","2009","0","53.96","40.07"
"65","000","00","006","0616","2107","760","594","166","52","812","1450","0","56.0","40.97"
"65","000","00","006","0616","2108","912","763","149","46","958","1726","0","55.5","44.21"
"65","000","00","006","0616","2109","911","727","184","60","971","1797","0","54.03","40.46"
"65","000","00","006","0616","2110","915","743","172","40","955","1739","0","54.92","42.73"
"65","000","00","006","0617","0000","2712","2174","538","136","2848","5599","0","50.87","38.83"
"65","000","00","006","0617","2114","796","638","158","39","835","1662","0","50.24","38.39"
"65","000","00","006","0617","2115","1119","908","211","60","1179","2067","0","57.04","43.93"
"65","000","00","006","0617","2116","797","628","169","37","834","1870","0","44.6","33.58"
"65","000","00","006","0618","0000","2672","2116","556","165","2837","5222","0","54.33","40.52"
"65","000","00","006","0618","2123","502","377","125","39","541","1079","0","50.14","34.94"
"65","000","00","006","0618","2124","552","445","107","33","585","1140","0","51.32","39.04"
"65","000","00","006","0618","2125","940","757","183","59","999","1825","0","54.74","41.48"
"65","000","00","006","0618","2126","678","537","141","34","712","1178","0","60.44","45.59"
"65","000","00","006","0619","0000","2398","1880","518","176","2574","5277","0","48.78","35.63"
"65","000","00","006","0619","2133","887","691","196","75","962","1992","0","48.29","34.69"
"65","000","00","006","0619","2134","770","605","165","47","817","1668","0","48.98","36.27"
"65","000","00","006","0619","2135","741","584","157","54","795","1617","0","49.17","36.12"
"65","000","00","006","0620","0000","2795","2358","437","188","2983","5428","0","54.96","43.44"
"65","000","00","006","0620","2136","998","808","190","81","1079","2013","0","53.6","40.14"
"65","000","00","006","0620","2137","929","849","80","57","986","1791","0","55.05","47.4"
"65","000","00","006","0620","2138","868","701","167","50","918","1624","0","56.53","43.17"
"65","000","00","006","0621","0000","407","303","104","30","437","939","0","46.54","32.27"
"65","000","00","006","0621","2142","407","303","104","30","437","939","0","46.54","32.27"
"65","000","00","006","0622","0000","2568","2088","480","120","2688","4725","0","56.89","44.19"
"65","000","00","006","0622","2148","1025","844","181","51","1076","1860","0","57.85","45.38"
"65","000","00","006","0622","2149","839","672","167","38","877","1743","0","50.32","38.55"
"65","000","00","006","0622","2150","704","572","132","31","735","1122","0","65.51","50.98"
"65","000","00","006","0623","0000","2372","1988","384","110","2482","4575","0","54.25","43.45"
"65","000","00","006","0623","2151","779","649","130","32","811","1468","0","55.25","44.21"
"65","000","00","006","0623","2152","916","803","113","43","959","1763","0","54.4","45.55"
"65","000","00","006","0623","2153","677","536","141","35","712","1344","0","52.98","39.88"
"65","000","00","006","0624","0000","358","298","60","48","406","753","0","53.92","39.58"
"65","000","00","006","0624","2154","358","298","60","48","406","753","0","53.92","39.58"
"65","000","00","006","0625","0000","1379","1044","335","81","1460","2839","0","51.43","36.77"
"65","000","00","006","0625","2155","285","215","70","9","294","602","0","48.84","35.71"
"65","000","00","006","0625","2156","1094","829","265","72","1166","2237","0","52.12","37.06"
"65","000","00","006","0626","0000","1046","804","242","78","1124","2239","0","50.2","35.91"
"65","000","00","006","0626","2157","554","420","134","32","586","1096","0","53.47","38.32"
"65","000","00","006","0626","2158","492","384","108","46","538","1143","0","47.07","33.6"
"65","000","00","006","0627","0000","748","566","182","77","825","1569","0","52.58","36.07"
"65","000","00","006","0627","2159","748","566","182","77","825","1569","0","52.58","36.07"
"65","000","00","006","0628","0000","625","475","150","65","690","1284","0","53.74","36.99"
"65","000","00","006","0628","2160","625","475","150","65","690","1284","0","53.74","36.99"
"65","000","00","006","0629","0000","519","367","152","48","567","1189","0","47.69","30.87"
"65","000","00","006","0629","2161","124","93","31","10","134","439","0","30.52","21.18"
"65","000","00","006","0629","2162","395","274","121","38","433","750","0","57.73","36.53"
"65","000","00","006","0630","0000","2440","1959","481","162","2602","4840","0","53.76","40.48"
"65","000","00","006","0630","2145","898","702","196","59","957","1838","0","52.07","38.19"
"65","000","00","006","0630","2146","761","626","135","54","815","1453","0","56.09","43.08"
"65","000","00","006","0630","2147","781","631","150","49","830","1549","0","53.58","40.74"
"65","000","00","006","0631","0000","817","668","149","59","876","1603","0","54.65","41.67"
"65","000","00","006","0631","1987","817","668","149","59","876","1603","0","54.65","41.67"
"65","000","00","006","0632","0000","1032","829","203","48","1080","1921","0","56.22","43.15"
"65","000","00","006","0632","1988","1032","829","203","48","1080","1921","0","56.22","43.15"
"65","000","00","006","0633","0000","1225","959","266","74","1299","2317","0","56.06","41.39"
"65","000","00","006","0633","1989","559","446","113","23","582","1082","0","53.79","41.22"
"65","000","00","006","0633","1990","666","513","153","51","717","1235","0","58.06","41.54"
"65","000","00","006","0634","0000","878","733","145","35","913","1568","0","58.23","46.75"
"65","000","00","006","0634","1991","878","733","145","35","913","1568","0","58.23","46.75"
"65","000","00","006","0635","0000","423","319","104","32","455","771","0","59.01","41.37"
"65","000","00","006","0635","1992","423","319","104","32","455","771","0","59.01","41.37"
"65","000","00","006","0636","0000","1204","929","275","93","1297","2264","0","57.29","41.03"
"65","000","00","006","0636","1993","653","490","163","43","696","1256","0","55.41","39.01"
"65","000","00","006","0636","1994","551","439","112","50","601","1008","0","59.62","43.55"
"65","000","00","006","0637","0000","2648","2153","495","151","2799","4701","0","59.54","45.8"
"65","000","00","006","0637","1995","838","704","134","48","886","1515","0","58.48","46.47"
"65","000","00","006","0637","1996","961","787","174","53","1014","1637","0","61.94","48.08"
"65","000","00","006","0637","1997","849","662","187","50","899","1549","0","58.04","42.74"
"65","000","00","006","0638","0000","2916","2376","540","218","3134","5335","0","58.74","44.54"
"65","000","00","006","0638","1998","1186","987","199","66","1252","2011","0","62.26","49.08"
"65","000","00","006","0638","1999","811","642","169","88","899","1554","0","57.85","41.31"
"65","000","00","006","0638","2000","919","747","172","64","983","1770","0","55.54","42.2"
"65","000","00","006","0639","0000","1333","1075","258","90","1423","2442","0","58.27","44.02"
"65","000","00","006","0639","2001","735","603","132","47","782","1316","0","59.42","45.82"
"65","000","00","006","0639","2002","598","472","126","43","641","1126","0","56.93","41.92"
"65","000","00","006","0640","0000","4326","3498","828","253","4579","7834","0","58.45","44.65"
"65","000","00","006","0640","2003","735","581","154","58","793","1460","0","54.32","39.79"
"65","000","00","006","0640","2004","877","693","184","58","935","1584","0","59.03","43.75"
"65","000","00","006","0640","2005","780","625","155","48","828","1449","0","57.14","43.13"
"65","000","00","006","0640","2006","898","747","151","53","951","1520","0","62.57","49.14"
"65","000","00","006","0640","2007","1036","852","184","36","1072","1821","0","58.87","46.79"
"65","000","00","006","0641","0000","3701","2940","761","181","3882","6728","0","57.7","43.7"
"65","000","00","006","0641","2008","1043","827","216","51","1094","1956","0","55.93","42.28"
"65","000","00","006","0641","2009","921","730","191","58","979","1665","0","58.8","43.84"
"65","000","00","006","0641","2010","915","740","175","49","964","1588","0","60.71","46.6"
"65","000","00","006","0641","2011","822","643","179","23","845","1519","0","55.63","42.33"
"65","000","00","006","0642","0000","2217","1789","428","141","2358","5969","0","39.5","29.97"
"65","000","00","006","0642","2014","635","508","127","55","690","1106","0","62.39","45.93"
"65","000","00","006","0642","2015","388","306","82","20","408","2700","0","15.11","11.33"
"65","000","00","006","0642","2016","561","458","103","26","587","995","0","58.99","46.03"
"65","000","00","006","0642","2017","633","517","116","40","673","1168","0","57.62","44.26"
"65","000","00","006","0643","0000","1359","1098","261","104","1463","2208","0","66.26","49.73"
"65","000","00","006","0643","2018","702","588","114","58","760","1123","0","67.68","52.36"
"65","000","00","006","0643","2019","657","510","147","46","703","1085","0","64.79","47.0"
"65","000","00","006","0644","0000","3181","2618","563","195","3376","5645","0","59.81","46.38"
"65","000","00","006","0644","2020","830","665","165","52","882","1412","0","62.46","47.1"
"65","000","00","006","0644","2021","924","770","154","61","985","1659","0","59.37","46.41"
"65","000","00","006","0644","2022","713","597","116","53","766","1198","0","63.94","49.83"
"65","000","00","006","0644","2023","714","586","128","29","743","1376","0","54.0","42.59"
"65","000","00","006","0645","0000","2056","1668","388","106","2162","3926","0","55.07","42.49"
"65","000","00","006","0645","2024","676","548","128","34","710","1300","0","54.62","42.15"
"65","000","00","006","0645","2025","681","555","126","44","725","1238","0","58.56","44.83"
"65","000","00","006","0645","2026","699","565","134","28","727","1388","0","52.38","40.71"
"65","000","00","006","0646","0000","1094","877","217","73","1167","1841","0","63.39","47.64"
"65","000","00","006","0646","2027","545","440","105","41","586","933","0","62.81","47.16"
"65","000","00","006","0646","2028","549","437","112","32","581","908","0","63.99","48.13"
"65","000","00","006","0647","0000","1982","1656","326","153","2135","3508","0","60.86","47.21"
"65","000","00","006","0647","2031","547","449","98","53","600","971","0","61.79","46.24"
"65","000","00","006","0647","2032","650","552","98","48","698","1145","0","60.96","48.21"
"65","000","00","006","0647","2033","785","655","130","52","837","1392","0","60.13","47.05"
"65","000","00","006","0648","0000","1641","1322","319","107","1748","2892","0","60.44","45.71"
"65","000","00","006","0648","2034","862","706","156","52","914","1452","0","62.95","48.62"
"65","000","00","006","0648","2035","779","616","163","55","834","1440","0","57.92","42.78"
"65","000","00","006","0649","0000","1940","1591","349","144","2084","3611","0","57.71","44.06"
"65","000","00","006","0649","2036","934","754","180","88","1022","1786","0","57.22","42.22"
"65","000","00","006","0649","2037","1006","837","169","56","1062","1825","0","58.19","45.86"
"65","000","00","006","0650","0000","1831","1496","335","78","1909","3227","0","59.16","46.36"
"65","000","00","006","0650","2038","853","710","143","28","881","1477","0","59.65","48.07"
"65","000","00","006","0650","2039","978","786","192","50","1028","1750","0","58.74","44.91"
"65","000","00","006","0651","0000","2008","1692","316","134","2142","3771","0","56.8","44.87"
"65","000","00","006","0651","2040","957","795","162","68","1025","1792","0","57.2","44.36"
"65","000","00","006","0651","2041","1051","897","154","66","1117","1979","0","56.44","45.33"
"65","000","00","006","0652","0000","2389","1983","406","95","2484","4133","0","60.1","47.98"
"65","000","00","006","0652","2042","476","393","83","24","500","826","0","60.53","47.58"
"65","000","00","006","0652","2043","1099","923","176","43","1142","1924","0","59.36","47.97"
"65","000","00","006","0652","2044","814","667","147","28","842","1383","0","60.88","48.23"
"65","000","00","006","0653","0000","390","310","80","38","428","830","0","51.57","37.35"
"65","000","00","006","0653","2045","390","310","80","38","428","830","0","51.57","37.35"
"65","000","00","006","0654","0000","3062","2482","580","113","3175","5197","0","61.09","47.76"
"65","000","00","006","0654","2046","1024","842","182","37","1061","1759","0","60.32","47.87"
"65","000","00","006","0654","2047","1167","923","244","53","1220","1957","0","62.34","47.16"
"65","000","00","006","0654","2048","871","717","154","23","894","1481","0","60.36","48.41"
"65","000","00","006","0655","0000","1856","1502","354","59","1915","3135","0","61.08","47.91"
"65","000","00","006","0655","2119","998","801","197","33","1031","1712","0","60.22","46.79"
"65","000","00","006","0655","2120","858","701","157","26","884","1423","0","62.12","49.26"
"65","000","00","006","0656","0000","3397","2748","649","203","3600","6684","0","53.86","41.11"
"65","000","00","006","0656","2093","988","798","190","60","1048","1892","0","55.39","42.18"
"65","000","00","006","0656","2094","742","595","147","50","792","1529","0","51.8","38.91"
"65","000","00","006","0656","2095","739","621","118","49","788","1358","0","58.03","45.73"
"65","000","00","006","0656","2096","928","734","194","44","972","1905","0","51.02","38.53"
"65","000","00","006","0657","0000","2406","2031","375","117","2523","4334","0","58.21","46.86"
"65","000","00","006","0657","2139","680","576","104","33","713","1178","0","60.53","48.9"
"65","000","00","006","0657","2140","720","617","103","27","747","1277","0","58.5","48.32"
"65","000","00","006","0657","2141","1006","838","168","57","1063","1879","0","56.57","44.6"
"65","000","00","006","0658","0000","3489","2932","557","184","3673","6377","0","57.6","45.98"
"65","000","00","006","0658","2066","704","560","144","58","762","1315","0","57.95","42.59"
"65","000","00","006","0658","2067","800","742","58","46","846","1562","0","54.16","47.5"
"65","000","00","006","0658","2068","1138","953","185","28","1166","1982","0","58.83","48.08"
"65","000","00","006","0658","2069","847","677","170","52","899","1518","0","59.22","44.6"
"65","000","00","006","0659","0000","1974","1600","374","131","2105","3435","0","61.28","46.58"
"65","000","00","006","0659","2121","938","757","181","71","1009","1666","0","60.56","45.44"
"65","000","00","006","0659","2122","1036","843","193","60","1096","1769","0","61.96","47.65"
"65","000","00","006","0660","0000","4651","3884","767","201","4852","9469","0","51.24","41.02"
"65","000","00","006","0660","2127","755","623","132","38","793","1463","0","54.2","42.58"
"65","000","00","006","0660","2128","624","514","110","33","657","1152","0","57.03","44.62"
"65","000","00","006","0660","2129","890","749","141","29","919","2008","0","45.77","37.3"
"65","000","00","006","0660","2130","933","800","133","40","973","2120","0","45.9","37.74"
"65","000","00","006","0660","2131","657","556","101","18","675","1153","0","58.54","48.22"
"65","000","00","006","0660","2132","792","642","150","43","835","1573","0","53.08","40.81"
"65","000","00","006","0661","0000","1576","1282","294","112","1688","2829","0","59.67","45.32"
"65","000","00","006","0661","2029","844","681","163","67","911","1582","0","57.59","43.05"
"65","000","00","006","0661","2030","732","601","131","45","777","1247","0","62.31","48.2"
"65","000","00","006","0662","0000","1467","1230","237","99","1566","3006","0","52.1","40.92"
"65","000","00","006","0662","2061","745","626","119","70","815","1495","0","54.52","41.87"
"65","000","00","006","0662","2062","722","604","118","29","751","1511","0","49.7","39.97"
"65","000","00","006","0663","0000","1273","1029","244","77","1350","2489","0","54.24","41.34"
"65","000","00","006","0663","2083","675","537","138","29","704","1275","0","55.22","42.12"
"65","000","00","006","0663","2084","598","492","106","48","646","1214","0","53.21","40.53"
"65","000","00","006","0664","0000","2548","2131","417","81","2629","4809","0","54.67","44.31"
"65","000","00","006","0664","2111","809","682","127","36","845","1523","0","55.48","44.78"
"65","000","00","006","0664","2112","849","724","125","26","875","1642","0","53.29","44.09"
"65","000","00","006","0664","2113","890","725","165","19","909","1644","0","55.29","44.1"
"65","000","00","006","0665","0000","1377","1094","283","62","1439","2280","0","63.11","47.98"
"65","000","00","006","0665","2012","709","561","148","39","748","1185","0","63.12","47.34"
"65","000","00","006","0665","2013","668","533","135","23","691","1095","0","63.11","48.68"
"65","000","00","006","0666","0000","1965","1628","337","141","2106","3797","0","55.46","42.88"
"65","000","00","006","0666","2100","1014","849","165","65","1079","1960","0","55.05","43.32"
"65","000","00","006","0666","2101","951","779","172","76","1027","1837","0","55.91","42.41"
"65","000","00","006","0667","0000","2759","2211","548","138","2897","4983","0","58.14","44.37"
"65","000","00","006","0667","2102","898","705","193","48","946","1662","0","56.92","42.42"
"65","000","00","006","0667","2103","940","771","169","55","995","1617","0","61.53","47.68"
"65","000","00","006","0667","2104","921","735","186","35","956","1704","0","56.1","43.13"
"65","000","00","006","0668","0000","1836","1543","293","97","1933","3528","0","54.79","43.74"
"65","000","00","006","0668","2117","1001","843","158","59","1060","1982","0","53.48","42.53"
"65","000","00","006","0668","2118","835","700","135","38","873","1546","0","56.47","45.28"
"65","000","00","006","0669","0000","1350","1070","280","70","1420","2394","0","59.31","44.7"
"65","000","00","006","0669","2143","509","397","112","38","547","960","0","56.98","41.35"
"65","000","00","006","0669","2144","841","673","168","32","873","1434","0","60.88","46.93"
"65","000","00","007","0000","0000","77873","60667","17206","5482","83355","152102","183780","54.8","39.89"
"65","000","00","007","0701","0000","1658","1281","377","151","1809","3613","0","50.07","35.46"
"65","000","00","007","0701","1620","813","625","188","86","899","1897","0","47.39","32.95"
"65","000","00","007","0701","1621","845","656","189","65","910","1716","0","53.03","38.23"
"65","000","00","007","0702","0000","1857","1423","434","148","2005","3470","0","57.78","41.01"
"65","000","00","007","0702","1617","612","474","138","59","671","1211","0","55.41","39.14"
"65","000","00","007","0702","1618","614","471","143","41","655","1125","0","58.22","41.87"
"65","000","00","007","0702","1619","631","478","153","48","679","1134","0","59.88","42.15"
"65","000","00","007","0703","0000","2017","1521","496","157","2174","4252","0","51.13","35.77"
"65","000","00","007","0703","1614","681","506","175","60","741","1408","0","52.63","35.94"
"65","000","00","007","0703","1615","647","481","166","32","679","1310","0","51.83","36.72"
"65","000","00","007","0703","1616","689","534","155","65","754","1534","0","49.15","34.81"
"65","000","00","007","0704","0000","1632","1249","383","117","1749","3296","0","53.06","37.89"
"65","000","00","007","0704","1643","590","449","141","61","651","1116","0","58.33","40.23"
"65","000","00","007","0704","1644","529","398","131","36","565","1077","0","52.46","36.95"
"65","000","00","007","0704","1645","513","402","111","20","533","1103","0","48.32","36.45"
"65","000","00","007","0705","0000","2850","2200","650","166","3016","5619","0","53.68","39.15"
"65","000","00","007","0705","1639","742","558","184","28","770","1483","0","51.92","37.63"
"65","000","00","007","0705","1640","758","595","163","37","795","1524","0","52.17","39.04"
"65","000","00","007","0705","1641","758","592","166","37","795","1431","0","55.56","41.37"
"65","000","00","007","0705","1642","592","455","137","64","656","1181","0","55.55","38.53"
"65","000","00","007","0706","0000","1895","1433","462","170","2065","4297","0","48.06","33.35"
"65","000","00","007","0706","1633","631","472","159","77","708","1927","0","36.74","24.49"
"65","000","00","007","0706","1634","482","360","122","38","520","914","0","56.89","39.39"
"65","000","00","007","0706","1635","782","601","181","55","837","1456","0","57.49","41.28"
"65","000","00","007","0707","0000","2143","1638","505","140","2283","4468","0","51.1","36.66"
"65","000","00","007","0707","1624","746","567","179","52","798","1542","0","51.75","36.77"
"65","000","00","007","0707","1625","743","564","179","62","805","1470","0","54.76","38.37"
"65","000","00","007","0707","1626","654","507","147","26","680","1456","0","46.7","34.82"
"65","000","00","007","0708","0000","1720","1315","405","123","1843","3218","0","57.27","40.86"
"65","000","00","007","0708","1652","469","369","100","27","496","870","0","57.01","42.41"
"65","000","00","007","0708","1653","751","553","198","66","817","1338","0","61.06","41.33"
"65","000","00","007","0708","1654","500","393","107","30","530","1010","0","52.48","38.91"
"65","000","00","007","0709","0000","2446","1871","575","196","2642","4558","0","57.96","41.05"
"65","000","00","007","0709","1657","795","649","146","87","882","1405","0","62.78","46.19"
"65","000","00","007","0709","1658","832","607","225","56","888","1587","0","55.95","38.25"
"65","000","00","007","0709","1659","819","615","204","53","872","1566","0","55.68","39.27"
"65","000","00","007","0710","0000","2078","1606","472","147","2225","3749","0","59.35","42.84"
"65","000","00","007","0710","1667","713","547","166","62","775","1268","0","61.12","43.14"
"65","000","00","007","0710","1668","700","536","164","35","735","1281","0","57.38","41.84"
"65","000","00","007","0710","1669","665","523","142","50","715","1200","0","59.58","43.58"
"65","000","00","007","0711","0000","1566","1270","296","110","1676","2979","0","56.26","42.63"
"65","000","00","007","0711","1663","907","731","176","46","953","1701","0","56.03","42.97"
"65","000","00","007","0711","1664","659","539","120","64","723","1278","0","56.57","42.18"
"65","000","00","007","0712","0000","739","562","177","29","768","1491","0","51.51","37.69"
"65","000","00","007","0712","1670","739","562","177","29","768","1491","0","51.51","37.69"
"65","000","00","007","0713","0000","528","416","112","26","554","1066","0","51.97","39.02"
"65","000","00","007","0713","1671","528","416","112","26","554","1066","0","51.97","39.02"
"65","000","00","007","0714","0000","1642","1346","296","72","1714","3132","0","54.73","42.98"
"65","000","00","007","0714","1686","829","696","133","44","873","1566","0","55.75","44.44"
"65","000","00","007","0714","1687","813","650","163","28","841","1566","0","53.7","41.51"
"65","000","00","007","0715","0000","1798","1395","403","126","1924","3427","0","56.14","40.71"
"65","000","00","007","0715","1676","646","501","145","42","688","1144","0","60.14","43.79"
"65","000","00","007","0715","1677","529","426","103","31","560","1059","0","52.88","40.23"
"65","000","00","007","0715","1678","623","468","155","53","676","1224","0","55.23","38.24"
"65","000","00","007","0716","0000","2216","1721","495","181","2397","4452","0","53.84","38.66"
"65","000","00","007","0716","1683","757","584","173","73","830","1514","0","54.82","38.57"
"65","000","00","007","0716","1684","725","576","149","57","782","1546","0","50.58","37.26"
"65","000","00","007","0716","1685","734","561","173","51","785","1392","0","56.39","40.3"
"65","000","00","007","0717","0000","2229","1701","528","182","2411","4572","0","52.73","37.2"
"65","000","00","007","0717","1673","810","639","171","65","875","1616","0","54.15","39.54"
"65","000","00","007","0717","1674","682","533","149","60","742","1589","0","46.7","33.54"
"65","000","00","007","0717","1675","737","529","208","57","794","1367","0","58.08","38.7"
"65","000","00","007","0718","0000","1463","1067","396","132","1595","2883","0","55.32","37.01"
"65","000","00","007","0718","1699","789","586","203","64","853","1606","0","53.11","36.49"
"65","000","00","007","0718","1700","674","481","193","68","742","1277","0","58.1","37.67"
"65","000","00","007","0719","0000","2651","2087","564","215","2866","5231","0","54.79","39.9"
"65","000","00","007","0719","1695","634","505","129","65","699","1247","0","56.05","40.5"
"65","000","00","007","0719","1696","683","569","114","70","753","1390","0","54.17","40.94"
"65","000","00","007","0719","1697","702","545","157","39","741","1293","0","57.31","42.15"
"65","000","00","007","0719","1698","632","468","164","41","673","1301","0","51.73","35.97"
"65","000","00","007","0720","0000","2349","1799","550","167","2516","4264","0","59.01","42.19"
"65","000","00","007","0720","1692","926","713","213","78","1004","1661","0","60.45","42.93"
"65","000","00","007","0720","1693","843","629","214","53","896","1585","0","56.53","39.68"
"65","000","00","007","0720","1694","580","457","123","36","616","1018","0","60.51","44.89"
"65","000","00","007","0721","0000","687","536","151","34","721","1683","0","42.84","31.85"
"65","000","00","007","0721","1708","687","536","151","34","721","1683","0","42.84","31.85"
"65","000","00","007","0722","0000","660","522","138","51","711","1565","0","45.43","33.35"
"65","000","00","007","0722","1722","660","522","138","51","711","1565","0","45.43","33.35"
"65","000","00","007","0723","0000","869","644","225","107","976","1638","0","59.58","39.32"
"65","000","00","007","0723","1714","869","644","225","107","976","1638","0","59.58","39.32"
"65","000","00","007","0724","0000","6207","4977","1230","392","6599","11772","0","56.06","42.28"
"65","000","00","007","0724","1715","798","617","181","55","853","1592","0","53.58","38.76"
"65","000","00","007","0724","1716","829","683","146","55","884","1521","0","58.12","44.9"
"65","000","00","007","0724","1717","971","765","206","57","1028","1707","0","60.22","44.82"
"65","000","00","007","0724","1718","956","762","194","64","1020","1741","0","58.59","43.77"
"65","000","00","007","0724","1719","876","715","161","32","908","1655","0","54.86","43.2"
"65","000","00","007","0724","1720","856","678","178","60","916","1775","0","51.61","38.2"
"65","000","00","007","0724","1721","921","757","164","69","990","1781","0","55.59","42.5"
"65","000","00","007","0725","0000","1002","757","245","57","1059","1966","0","53.87","38.5"
"65","000","00","007","0725","1723","464","347","117","40","504","936","0","53.85","37.07"
"65","000","00","007","0725","1724","538","410","128","17","555","1030","0","53.88","39.81"
"65","000","00","007","0726","0000","4256","3543","713","201","4457","7662","0","58.17","46.24"
"65","000","00","007","0726","1709","786","623","163","49","835","1452","0","57.51","42.91"
"65","000","00","007","0726","1710","884","724","160","36","920","1592","0","57.79","45.48"
"65","000","00","007","0726","1711","883","731","152","48","931","1619","0","57.5","45.15"
"65","000","00","007","0726","1712","972","878","94","42","1014","1642","0","61.75","53.47"
"65","000","00","007","0726","1713","731","587","144","26","757","1357","0","55.78","43.26"
"65","000","00","007","0727","0000","498","397","101","6","504","877","0","57.47","45.27"
"65","000","00","007","0727","1672","498","397","101","6","504","877","0","57.47","45.27"
"65","000","00","007","0728","0000","1924","1506","418","162","2086","3846","0","54.24","39.16"
"65","000","00","007","0728","1646","715","576","139","60","775","1385","0","55.96","41.59"
"65","000","00","007","0728","1647","611","470","141","52","663","1266","0","52.37","37.12"
"65","000","00","007","0728","1648","598","460","138","50","648","1195","0","54.23","38.49"
"65","000","00","007","0729","0000","1647","1295","352","114","1761","3245","0","54.27","39.91"
"65","000","00","007","0729","1660","497","406","91","12","509","997","0","51.05","40.72"
"65","000","00","007","0729","1661","622","478","144","51","673","1187","0","56.7","40.27"
"65","000","00","007","0729","1662","528","411","117","51","579","1061","0","54.57","38.74"
"65","000","00","007","0730","0000","1811","1381","430","130","1941","3196","0","60.73","43.21"
"65","000","00","007","0730","1655","900","708","192","74","974","1658","0","58.75","42.7"
"65","000","00","007","0730","1656","911","673","238","56","967","1538","0","62.87","43.76"
"65","000","00","007","0731","0000","1854","1409","445","88","1942","3571","0","54.38","39.46"
"65","000","00","007","0731","1627","586","458","128","28","614","1124","0","54.63","40.75"
"65","000","00","007","0731","1628","627","481","146","30","657","1235","0","53.2","38.95"
"65","000","00","007","0731","1629","641","470","171","30","671","1212","0","55.36","38.78"
"65","000","00","007","0732","0000","1863","1407","456","160","2023","3764","0","53.75","37.38"
"65","000","00","007","0732","1630","580","465","115","45","625","1223","0","51.1","38.02"
"65","000","00","007","0732","1631","656","468","188","80","736","1335","0","55.13","35.06"
"65","000","00","007","0732","1632","627","474","153","35","662","1206","0","54.89","39.3"
"65","000","00","007","0733","0000","2402","1832","570","178","2580","5192","0","49.69","35.29"
"65","000","00","007","0733","1679","539","412","127","40","579","1141","0","50.74","36.11"
"65","000","00","007","0733","1680","568","456","112","25","593","1396","0","42.48","32.66"
"65","000","00","007","0733","1681","595","447","148","39","634","1157","0","54.8","38.63"
"65","000","00","007","0733","1682","700","517","183","74","774","1498","0","51.67","34.51"
"65","000","00","007","0734","0000","2332","1860","472","171","2503","4454","0","56.2","41.76"
"65","000","00","007","0734","1636","690","545","145","48","738","1409","0","52.38","38.68"
"65","000","00","007","0734","1637","834","621","213","64","898","1500","0","59.87","41.4"
"65","000","00","007","0734","1638","808","694","114","59","867","1545","0","56.12","44.92"
"65","000","00","007","0735","0000","2602","2058","544","175","2777","4995","0","55.6","41.2"
"65","000","00","007","0735","1701","634","483","151","69","703","1219","0","57.67","39.62"
"65","000","00","007","0735","1702","698","562","136","36","734","1454","0","50.48","38.65"
"65","000","00","007","0735","1703","662","528","134","38","700","1314","0","53.27","40.18"
"65","000","00","007","0735","1704","608","485","123","32","640","1008","0","63.49","48.12"
"65","000","00","007","0736","0000","2284","1784","500","179","2463","4615","0","53.37","38.66"
"65","000","00","007","0736","1705","774","635","139","72","846","1574","0","53.75","40.34"
"65","000","00","007","0736","1706","734","576","158","33","767","1364","0","56.23","42.23"
"65","000","00","007","0736","1707","776","573","203","74","850","1677","0","50.69","34.17"
"65","000","00","007","0737","0000","1520","1179","341","119","1639","2739","0","59.84","43.04"
"65","000","00","007","0737","1665","796","620","176","66","862","1433","0","60.15","43.27"
"65","000","00","007","0737","1666","724","559","165","53","777","1306","0","59.49","42.8"
"65","000","00","007","0738","0000","1546","1220","326","88","1634","2998","0","54.5","40.69"
"65","000","00","007","0738","1688","773","608","165","50","823","1517","0","54.25","40.08"
"65","000","00","007","0738","1689","773","612","161","38","811","1481","0","54.76","41.32"
"65","000","00","007","0739","0000","1224","956","268","64","1288","2424","0","53.14","39.44"
"65","000","00","007","0739","1690","644","491","153","38","682","1261","0","54.08","38.94"
"65","000","00","007","0739","1691","580","465","115","26","606","1163","0","52.11","39.98"
"65","000","00","007","0740","0000","1301","1014","287","99","1400","2517","0","55.62","40.29"
"65","000","00","007","0740","1649","625","487","138","52","677","1254","0","53.99","38.84"
"65","000","00","007","0740","1650","676","527","149","47","723","1263","0","57.24","41.73"
"65","000","00","007","0741","0000","837","659","178","75","912","1473","0","61.91","44.74"
"65","000","00","007","0741","1651","837","659","178","75","912","1473","0","61.91","44.74"
"65","000","00","007","0742","0000","1070","830","240","77","1147","1873","0","61.24","44.31"
"65","000","00","007","0742","1622","416","321","95","42","458","736","0","62.23","43.61"
"65","000","00","007","0742","1623","654","509","145","35","689","1137","0","60.6","44.77"
"65","000","00","008","0000","0000","35091","27167","7924","2344","37435","71645","86223","52.25","37.92"
"65","000","00","008","0801","0000","535","405","130","44","579","965","0","60.0","41.97"
"65","000","00","008","0801","1726","535","405","130","44","579","965","0","60.0","41.97"
"65","000","00","008","0802","0000","1026","796","230","45","1071","2019","0","53.05","39.43"
"65","000","00","008","0802","1729","560","435","125","32","592","1057","0","56.01","41.15"
"65","000","00","008","0802","1730","466","361","105","13","479","962","0","49.79","37.53"
"65","000","00","008","0803","0000","2570","1901","669","169","2739","5052","0","54.22","37.63"
"65","000","00","008","0803","1732","981","656","325","75","1056","1742","0","60.62","37.66"
"65","000","00","008","0803","1733","802","621","181","58","860","1634","0","52.63","38.0"
"65","000","00","008","0803","1734","787","624","163","36","823","1676","0","49.11","37.23"
"65","000","00","008","0804","0000","1795","1412","383","151","1946","3728","0","52.2","37.88"
"65","000","00","008","0804","1727","967","766","201","94","1061","1931","0","54.95","39.67"
"65","000","00","008","0804","1728","828","646","182","57","885","1797","0","49.25","35.95"
"65","000","00","008","0805","0000","546","421","125","34","580","934","0","62.1","45.07"
"65","000","00","008","0805","1731","546","421","125","34","580","934","0","62.1","45.07"
"65","000","00","008","0806","0000","278","198","80","16","294","515","0","57.09","38.45"
"65","000","00","008","0806","1725","278","198","80","16","294","515","0","57.09","38.45"
"65","000","00","008","0807","0000","779","602","177","65","844","1440","0","58.61","41.81"
"65","000","00","008","0807","1750","779","602","177","65","844","1440","0","58.61","41.81"
"65","000","00","008","0808","0000","3841","2970","871","270","4111","7315","0","56.2","40.6"
"65","000","00","008","0808","1751","912","691","221","79","991","1809","0","54.78","38.2"
"65","000","00","008","0808","1752","923","717","206","63","986","1758","0","56.09","40.78"
"65","000","00","008","0808","1753","804","637","167","58","862","1589","0","54.25","40.09"
"65","000","00","008","0808","1754","594","458","136","36","630","1067","0","59.04","42.92"
"65","000","00","008","0808","1755","608","467","141","34","642","1092","0","58.79","42.77"
"65","000","00","008","0809","0000","1513","1155","358","117","1630","3208","0","50.81","36.0"
"65","000","00","008","0809","1747","462","358","104","38","500","942","0","53.08","38.0"
"65","000","00","008","0809","1748","644","477","167","60","704","1317","0","53.45","36.22"
"65","000","00","008","0809","1749","407","320","87","19","426","949","0","44.89","33.72"
"65","000","00","008","0810","0000","3069","2440","629","199","3268","6702","0","48.76","36.41"
"65","000","00","008","0810","1743","829","672","157","42","871","1737","0","50.14","38.69"
"65","000","00","008","0810","1744","773","633","140","64","837","1669","0","50.15","37.93"
"65","000","00","008","0810","1745","777","610","167","45","822","1842","0","44.63","33.12"
"65","000","00","008","0810","1746","690","525","165","48","738","1454","0","50.76","36.11"
"65","000","00","008","0811","0000","3289","2572","717","193","3482","7102","0","49.03","36.22"
"65","000","00","008","0811","1739","860","680","180","53","913","1782","0","51.23","38.16"
"65","000","00","008","0811","1740","743","615","128","48","791","1496","0","52.87","41.11"
"65","000","00","008","0811","1741","947","708","239","41","988","2071","0","47.71","34.19"
"65","000","00","008","0811","1742","739","569","170","51","790","1753","0","45.07","32.46"
"65","000","00","008","0812","0000","358","260","98","23","381","850","0","44.82","30.59"
"65","000","00","008","0812","1738","358","260","98","23","381","850","0","44.82","30.59"
"65","000","00","008","0813","0000","96","77","19","3","99","227","0","43.61","33.92"
"65","000","00","008","0813","1774","96","77","19","3","99","227","0","43.61","33.92"
"65","000","00","008","0814","0000","2239","1732","507","140","2379","4604","0","51.67","37.62"
"65","000","00","008","0814","1768","655","528","127","22","677","1479","0","45.77","35.7"
"65","000","00","008","0814","1769","835","618","217","57","892","1736","0","51.38","35.6"
"65","000","00","008","0814","1770","749","586","163","61","810","1389","0","58.32","42.19"
"65","000","00","008","0815","0000","1890","1499","391","122","2012","4064","0","49.51","36.88"
"65","000","00","008","0815","1762","460","386","74","22","482","1026","0","46.98","37.62"
"65","000","00","008","0815","1763","803","635","168","38","841","1721","0","48.87","36.9"
"65","000","00","008","0815","1764","627","478","149","62","689","1317","0","52.32","36.29"
"65","000","00","008","0816","0000","1843","1314","529","152","1995","3526","0","56.58","37.27"
"65","000","00","008","0816","1765","578","442","136","48","626","1046","0","59.85","42.26"
"65","000","00","008","0816","1766","643","487","156","44","687","1144","0","60.05","42.57"
"65","000","00","008","0816","1767","622","385","237","60","682","1336","0","51.05","28.82"
"65","000","00","008","0817","0000","2296","1859","437","134","2430","4249","0","57.19","43.75"
"65","000","00","008","0817","1756","912","746","166","40","952","1730","0","55.03","43.12"
"65","000","00","008","0817","1757","662","546","116","51","713","1281","0","55.66","42.62"
"65","000","00","008","0817","1758","722","567","155","43","765","1238","0","61.79","45.8"
"65","000","00","008","0818","0000","2348","1832","516","158","2506","5137","0","48.78","35.66"
"65","000","00","008","0818","1771","956","758","198","78","1034","1956","0","52.86","38.75"
"65","000","00","008","0818","1772","694","513","181","45","739","1371","0","53.9","37.42"
"65","000","00","008","0818","1773","698","561","137","35","733","1810","0","40.5","30.99"
"65","000","00","008","0819","0000","1891","1505","386","152","2043","4022","0","50.8","37.42"
"65","000","00","008","0819","1759","792","630","162","77","869","1568","0","55.42","40.18"
"65","000","00","008","0819","1760","634","508","126","50","684","1271","0","53.82","39.97"
"65","000","00","008","0819","1761","465","367","98","25","490","1183","0","41.42","31.02"
"65","000","00","008","0820","0000","2889","2217","672","157","3046","5986","0","50.89","37.04"
"65","000","00","008","0820","1735","1041","792","249","87","1128","2052","0","54.97","38.6"
"65","000","00","008","0820","1736","865","667","198","35","900","1977","0","45.52","33.74"
"65","000","00","008","0820","1737","983","758","225","35","1018","1957","0","52.02","38.73"
"65","000","00","009","0000","0000","45838","35739","10099","3190","49028","94291","115712","52.0","37.9"
"65","000","00","009","0901","0000","166","130","36","22","188","274","0","68.61","47.45"
"65","000","00","009","0901","1917","166","130","36","22","188","274","0","68.61","47.45"
"65","000","00","009","0902","0000","281","227","54","41","322","583","0","55.23","38.94"
"65","000","00","009","0902","1918","281","227","54","41","322","583","0","55.23","38.94"
"65","000","00","009","0903","0000","1581","1180","401","86","1667","3479","0","47.92","33.92"
"65","000","00","009","0903","1919","733","542","191","30","763","1765","0","43.23","30.71"
"65","000","00","009","0903","1920","848","638","210","56","904","1714","0","52.74","37.22"
"65","000","00","009","0904","0000","1357","1102","255","68","1425","2684","0","53.09","41.06"
"65","000","00","009","0904","1921","653","523","130","27","680","1355","0","50.18","38.6"
"65","000","00","009","0904","1922","704","579","125","41","745","1329","0","56.06","43.57"
"65","000","00","009","0905","0000","515","398","117","39","554","1059","0","52.31","37.58"
"65","000","00","009","0905","1923","515","398","117","39","554","1059","0","52.31","37.58"
"65","000","00","009","0906","0000","3335","2552","783","273","3608","6529","0","55.26","39.09"
"65","000","00","009","0906","1924","720","547","173","60","780","1364","0","57.18","40.1"
"65","000","00","009","0906","1925","590","441","149","56","646","1098","0","58.83","40.16"
"65","000","00","009","0906","1926","652","507","145","58","710","1296","0","54.78","39.12"
"65","000","00","009","0906","1927","611","459","152","52","663","1240","0","53.47","37.02"
"65","000","00","009","0906","1928","762","598","164","47","809","1531","0","52.84","39.06"
"65","000","00","009","0907","0000","2427","1906","521","174","2601","5025","0","51.76","37.93"
"65","000","00","009","0907","1952","770","609","161","53","823","1634","0","50.37","37.27"
"65","000","00","009","0907","1953","859","661","198","54","913","1716","0","53.21","38.52"
"65","000","00","009","0907","1954","798","636","162","67","865","1675","0","51.64","37.97"
"65","000","00","009","0908","0000","4036","3243","793","286","4322","8724","0","49.54","37.17"
"65","000","00","009","0908","1929","661","540","121","35","696","1444","0","48.2","37.4"
"65","000","00","009","0908","1930","654","511","143","72","726","1347","0","53.9","37.94"
"65","000","00","009","0908","1931","727","598","129","52","779","1455","0","53.54","41.1"
"65","000","00","009","0908","1932","671","534","137","39","710","1556","0","45.63","34.32"
"65","000","00","009","0908","1933","554","441","113","38","592","1390","0","42.59","31.73"
"65","000","00","009","0908","1934","769","619","150","50","819","1532","0","53.46","40.4"
"65","000","00","009","0909","0000","3989","3153","836","212","4201","8053","0","52.17","39.15"
"65","000","00","009","0909","1935","609","489","120","61","670","1377","0","48.66","35.51"
"65","000","00","009","0909","1936","839","659","180","54","893","1731","0","51.59","38.07"
"65","000","00","009","0909","1937","816","621","195","33","849","1705","0","49.79","36.42"
"65","000","00","009","0909","1938","832","677","155","35","867","1590","0","54.53","42.58"
"65","000","00","009","0909","1939","893","707","186","29","922","1650","0","55.88","42.85"
"65","000","00","009","0910","0000","1701","1364","337","163","1864","3638","0","51.24","37.49"
"65","000","00","009","0910","1966","573","449","124","57","630","1389","0","45.36","32.33"
"65","000","00","009","0910","1967","599","473","126","67","666","1315","0","50.65","35.97"
"65","000","00","009","0910","1968","529","442","87","39","568","934","0","60.81","47.32"
"65","000","00","009","0911","0000","974","748","226","75","1049","2199","0","47.7","34.02"
"65","000","00","009","0911","1969","557","437","120","35","592","1270","0","46.61","34.41"
"65","000","00","009","0911","1970","417","311","106","40","457","929","0","49.19","33.48"
"65","000","00","009","0912","0000","484","376","108","17","501","1035","0","48.41","36.33"
"65","000","00","009","0912","1971","484","376","108","17","501","1035","0","48.41","36.33"
"65","000","00","009","0913","0000","209","170","39","17","226","502","0","45.02","33.86"
"65","000","00","009","0913","1972","209","170","39","17","226","502","0","45.02","33.86"
"65","000","00","009","0914","0000","353","274","79","54","407","836","0","48.68","32.78"
"65","000","00","009","0914","1973","353","274","79","54","407","836","0","48.68","32.78"
"65","000","00","009","0915","0000","272","208","64","54","326","669","0","48.73","31.09"
"65","000","00","009","0915","1974","272","208","64","54","326","669","0","48.73","31.09"
"65","000","00","009","0916","0000","366","292","74","64","430","733","0","58.66","39.84"
"65","000","00","009","0916","1975","366","292","74","64","430","733","0","58.66","39.84"
"65","000","00","009","0917","0000","1022","774","248","83","1105","2138","0","51.68","36.2"
"65","000","00","009","0917","1979","397","313","84","48","445","771","0","57.72","40.6"
"65","000","00","009","0917","1980","625","461","164","35","660","1367","0","48.28","33.72"
"65","000","00","009","0918","0000","613","490","123","48","661","1394","0","47.42","35.15"
"65","000","00","009","0918","1978","613","490","123","48","661","1394","0","47.42","35.15"
"65","000","00","009","0919","0000","1265","1006","259","93","1358","2761","0","49.19","36.44"
"65","000","00","009","0919","1981","576","453","123","69","645","1241","0","51.97","36.5"
"65","000","00","009","0919","1982","689","553","136","24","713","1520","0","46.91","36.38"
"65","000","00","009","0920","0000","503","388","115","53","556","873","0","63.69","44.44"
"65","000","00","009","0920","1983","503","388","115","53","556","873","0","63.69","44.44"
"65","000","00","009","0921","0000","500","392","108","67","567","1322","0","42.89","29.65"
"65","000","00","009","0921","1986","500","392","108","67","567","1322","0","42.89","29.65"
"65","000","00","009","0922","0000","801","618","183","83","884","1865","0","47.4","33.14"
"65","000","00","009","0922","1984","326","240","86","48","374","768","0","48.7","31.25"
"65","000","00","009","0922","1985","475","378","97","35","510","1097","0","46.49","34.46"
"65","000","00","009","0923","0000","2746","2167","579","175","2921","5947","0","49.12","36.44"
"65","000","00","009","0923","1959","667","526","141","60","727","1363","0","53.34","38.59"
"65","000","00","009","0923","1960","799","650","149","40","839","1624","0","51.66","40.02"
"65","000","00","009","0923","1961","699","537","162","49","748","1352","0","55.33","39.72"
"65","000","00","009","0923","1962","581","454","127","26","607","1608","0","37.75","28.23"
"65","000","00","009","0924","0000","3069","2465","604","236","3305","6635","0","49.81","37.15"
"65","000","00","009","0924","1955","663","534","129","57","720","1649","0","43.66","32.38"
"65","000","00","009","0924","1956","716","567","149","70","786","1489","0","52.79","38.08"
"65","000","00","009","0924","1957","814","648","166","49","863","1771","0","48.73","36.59"
"65","000","00","009","0924","1958","876","716","160","60","936","1726","0","54.23","41.48"
"65","000","00","009","0925","0000","2160","1673","487","200","2360","4629","0","50.98","36.14"
"65","000","00","009","0925","1963","722","561","161","55","777","1458","0","53.29","38.48"
"65","000","00","009","0925","1964","737","587","150","42","779","1641","0","47.47","35.77"
"65","000","00","009","0925","1965","701","525","176","103","804","1530","0","52.55","34.31"
"65","000","00","009","0926","0000","1669","1317","352","108","1777","3198","0","55.57","41.18"
"65","000","00","009","0926","1976","879","702","177","58","937","1560","0","60.06","45.0"
"65","000","00","009","0926","1977","790","615","175","50","840","1638","0","51.28","37.55"
"65","000","00","009","0927","0000","6552","4787","1765","274","6826","12019","0","56.79","39.83"
"65","000","00","009","0927","1944","831","664","167","21","852","1579","0","53.96","42.05"
"65","000","00","009","0927","1945","732","589","143","29","761","1435","0","53.03","41.05"
"65","000","00","009","0927","1946","926","764","162","33","959","1659","0","57.81","46.05"
"65","000","00","009","0927","1947","871","712","159","45","916","1512","0","60.58","47.09"
"65","000","00","009","0927","1948","792","632","160","52","844","1463","0","57.69","43.2"
"65","000","00","009","0927","1949","812","663","149","23","835","1465","0","57.0","45.26"
"65","000","00","009","0927","1950","810","124","686","28","838","1463","0","57.28","8.48"
"65","000","00","009","0927","1951","778","639","139","43","821","1443","0","56.9","44.28"
"65","000","00","009","0928","0000","2892","2339","553","125","3017","5488","0","54.97","42.62"
"65","000","00","009","0928","1940","751","602","149","35","786","1441","0","54.55","41.78"
"65","000","00","009","0928","1941","788","657","131","25","813","1404","0","57.91","46.79"
"65","000","00","009","0928","1942","736","602","134","34","770","1295","0","59.46","46.49"
"65","000","00","009","0928","1943","617","478","139","31","648","1348","0","48.07","35.46"
"65","000","00","010","0000","0000","72399","56960","15439","4367","76766","147272","172677","52.13","38.68"
"65","000","00","010","1001","0000","260","191","69","27","287","544","0","52.76","35.11"
"65","000","00","010","1001","0029","260","191","69","27","287","544","0","52.76","35.11"
"65","000","00","010","1002","0000","526","416","110","53","579","1044","0","55.46","39.85"
"65","000","00","010","1002","0030","526","416","110","53","579","1044","0","55.46","39.85"
"65","000","00","010","1003","0000","685","553","132","38","723","1462","0","49.45","37.82"
"65","000","00","010","1003","0031","685","553","132","38","723","1462","0","49.45","37.82"
"65","000","00","010","1004","0000","734","554","180","62","796","1525","0","52.2","36.33"
"65","000","00","010","1004","0032","734","554","180","62","796","1525","0","52.2","36.33"
"65","000","00","010","1005","0000","426","338","88","41","467","986","0","47.36","34.28"
"65","000","00","010","1005","0033","426","338","88","41","467","986","0","47.36","34.28"
"65","000","00","010","1006","0000","1172","918","254","110","1282","2516","0","50.95","36.49"
"65","000","00","010","1006","0035","588","454","134","69","657","1173","0","56.01","38.7"
"65","000","00","010","1006","0036","584","464","120","41","625","1343","0","46.54","34.55"
"65","000","00","010","1007","0000","411","306","105","32","443","806","0","54.96","37.97"
"65","000","00","010","1007","0034","411","306","105","32","443","806","0","54.96","37.97"
"65","000","00","010","1008","0000","5459","4317","1142","237","5696","12236","0","46.55","35.28"
"65","000","00","010","1008","0065","934","770","164","44","978","1837","0","53.24","41.92"
"65","000","00","010","1008","0066","627","506","121","25","652","1924","0","33.89","26.3"
"65","000","00","010","1008","0067","1120","898","222","35","1155","2340","0","49.36","38.38"
"65","000","00","010","1008","0068","746","609","137","47","793","1704","0","46.54","35.74"
"65","000","00","010","1008","0069","680","528","152","39","719","1363","0","52.75","38.74"
"65","000","00","010","1008","0070","1352","1006","346","47","1399","3068","0","45.6","32.79"
"65","000","00","010","1009","0000","709","583","126","31","740","1528","0","48.43","38.15"
"65","000","00","010","1009","0071","709","583","126","31","740","1528","0","48.43","38.15"
"65","000","00","010","1010","0000","3093","2452","641","176","3269","6351","0","51.47","38.61"
"65","000","00","010","1010","0079","708","562","146","72","780","1373","0","56.81","40.93"
"65","000","00","010","1010","0080","881","724","157","33","914","1732","0","52.77","41.8"
"65","000","00","010","1010","0081","712","541","171","48","760","1519","0","50.03","35.62"
"65","000","00","010","1010","0082","792","625","167","23","815","1727","0","47.19","36.19"
"65","000","00","010","1011","0000","2490","1966","524","193","2683","5041","0","53.22","39.0"
"65","000","00","010","1011","0072","746","573","173","59","805","1600","0","50.31","35.81"
"65","000","00","010","1011","0073","979","782","197","66","1045","1874","0","55.76","41.73"
"65","000","00","010","1011","0074","765","611","154","68","833","1567","0","53.16","38.99"
"65","000","00","010","1012","0000","4326","3474","852","220","4546","8417","0","54.01","41.27"
"65","000","00","010","1012","0093","906","756","150","58","964","1804","0","53.44","41.91"
"65","000","00","010","1012","0094","652","514","138","47","699","1322","0","52.87","38.88"
"65","000","00","010","1012","0095","997","818","179","32","1029","2019","0","50.97","40.52"
"65","000","00","010","1012","0096","928","752","176","47","975","1696","0","57.49","44.34"
"65","000","00","010","1012","0097","843","634","209","36","879","1576","0","55.77","40.23"
"65","000","00","010","1013","0000","832","610","222","72","904","2027","0","44.6","30.09"
"65","000","00","010","1013","0037","453","350","103","34","487","1153","0","42.24","30.36"
"65","000","00","010","1013","0038","379","260","119","38","417","874","0","47.71","29.75"
"65","000","00","010","1014","0000","507","377","130","79","586","1063","0","55.13","35.47"
"65","000","00","010","1014","0039","507","377","130","79","586","1063","0","55.13","35.47"
"65","000","00","010","1015","0000","578","449","129","39","617","1309","0","47.14","34.3"
"65","000","00","010","1015","0040","578","449","129","39","617","1309","0","47.14","34.3"
"65","000","00","010","1016","0000","646","490","156","47","693","1290","0","53.72","37.98"
"65","000","00","010","1016","0041","646","490","156","47","693","1290","0","53.72","37.98"
"65","000","00","010","1017","0000","3263","2562","701","171","3434","6129","0","56.03","41.8"
"65","000","00","010","1017","0042","909","720","189","39","948","1675","0","56.6","42.99"
"65","000","00","010","1017","0043","831","641","190","48","879","1589","0","55.32","40.34"
"65","000","00","010","1017","0044","905","720","185","43","948","1624","0","58.37","44.33"
"65","000","00","010","1017","0045","618","481","137","41","659","1241","0","53.1","38.76"
"65","000","00","010","1018","0000","2834","2280","554","175","3009","5578","0","53.94","40.87"
"65","000","00","010","1018","0046","663","503","160","47","710","1317","0","53.91","38.19"
"65","000","00","010","1018","0047","556","510","46","36","592","1225","0","48.33","41.63"
"65","000","00","010","1018","0048","732","585","147","39","771","1426","0","54.07","41.02"
"65","000","00","010","1018","0049","883","682","201","53","936","1610","0","58.14","42.36"
"65","000","00","010","1019","0000","3214","2519","695","241","3455","6426","0","53.77","39.2"
"65","000","00","010","1019","0052","864","663","201","51","915","1822","0","50.22","36.39"
"65","000","00","010","1019","0053","657","507","150","77","734","1232","0","59.58","41.15"
"65","000","00","010","1019","0054","839","655","184","63","902","1588","0","56.8","41.25"
"65","000","00","010","1019","0055","854","694","160","50","904","1784","0","50.67","38.9"
"65","000","00","010","1020","0000","2580","1970","610","178","2758","5205","0","52.99","37.85"
"65","000","00","010","1020","0056","847","619","228","80","927","1762","0","52.61","35.13"
"65","000","00","010","1020","0057","772","620","152","45","817","1546","0","52.85","40.1"
"65","000","00","010","1020","0058","961","731","230","53","1014","1897","0","53.45","38.53"
"65","000","00","010","1021","0000","4581","3643","938","205","4786","9332","0","51.29","39.04"
"65","000","00","010","1021","0059","754","606","148","44","798","1489","0","53.59","40.7"
"65","000","00","010","1021","0060","808","636","172","51","859","1679","0","51.16","37.88"
"65","000","00","010","1021","0061","802","617","185","41","843","1693","0","49.79","36.44"
"65","000","00","010","1021","0062","773","616","157","21","794","1674","0","47.43","36.8"
"65","000","00","010","1021","0063","699","543","156","27","726","1330","0","54.59","40.83"
"65","000","00","010","1021","0064","745","625","120","21","766","1467","0","52.22","42.6"
"65","000","00","010","1022","0000","2884","2332","552","162","3046","5459","0","55.8","42.72"
"65","000","00","010","1022","0098","955","760","195","48","1003","1781","0","56.32","42.67"
"65","000","00","010","1022","0099","917","686","231","54","971","1665","0","58.32","41.2"
"65","000","00","010","1022","0100","1012","886","126","60","1072","2013","0","53.25","44.01"
"65","000","00","010","1023","0000","1842","1446","396","91","1933","3659","0","52.83","39.52"
"65","000","00","010","1023","0106","562","430","132","24","586","1289","0","45.46","33.36"
"65","000","00","010","1023","0107","738","580","158","45","783","1319","0","59.36","43.97"
"65","000","00","010","1023","0108","542","436","106","22","564","1051","0","53.66","41.48"
"65","000","00","010","1024","0000","677","542","135","39","716","1348","0","53.12","40.21"
"65","000","00","010","1024","0109","677","542","135","39","716","1348","0","53.12","40.21"
"65","000","00","010","1025","0000","529","411","118","35","564","1106","0","50.99","37.16"
"65","000","00","010","1025","0110","529","411","118","35","564","1106","0","50.99","37.16"
"65","000","00","010","1026","0000","390","295","95","31","421","717","0","58.72","41.14"
"65","000","00","010","1026","0111","390","295","95","31","421","717","0","58.72","41.14"
"65","000","00","010","1027","0000","687","518","169","28","715","1385","0","51.62","37.4"
"65","000","00","010","1027","0112","687","518","169","28","715","1385","0","51.62","37.4"
"65","000","00","010","1028","0000","472","351","121","32","504","841","0","59.93","41.74"
"65","000","00","010","1028","0113","472","351","121","32","504","841","0","59.93","41.74"
"65","000","00","010","1029","0000","347","277","70","31","378","665","0","56.84","41.65"
"65","000","00","010","1029","0114","347","277","70","31","378","665","0","56.84","41.65"
"65","000","00","010","1030","0000","230","181","49","20","250","419","0","59.67","43.2"
"65","000","00","010","1030","0115","230","181","49","20","250","419","0","59.67","43.2"
"65","000","00","010","1031","0000","850","667","183","32","882","1599","0","55.16","41.71"
"65","000","00","010","1031","0116","850","667","183","32","882","1599","0","55.16","41.71"
"65","000","00","010","1032","0000","2459","1921","538","169","2628","4930","0","53.31","38.97"
"65","000","00","010","1032","0117","820","638","182","57","877","1670","0","52.51","38.2"
"65","000","00","010","1032","0118","897","703","194","58","955","1683","0","56.74","41.77"
"65","000","00","010","1032","0119","742","580","162","54","796","1577","0","50.48","36.78"
"65","000","00","010","1033","0000","1745","1392","353","93","1838","3832","0","47.96","36.33"
"65","000","00","010","1033","0120","762","604","158","52","814","1618","0","50.31","37.33"
"65","000","00","010","1033","0121","983","788","195","41","1024","2214","0","46.25","35.59"
"65","000","00","010","1034","0000","1894","1512","382","148","2042","3750","0","54.45","40.32"
"65","000","00","010","1034","0083","671","530","141","35","706","1297","0","54.43","40.86"
"65","000","00","010","1034","0084","510","415","95","61","571","1066","0","53.56","38.93"
"65","000","00","010","1034","0085","713","567","146","52","765","1387","0","55.16","40.88"
"65","000","00","010","1035","0000","3694","2903","791","220","3914","7408","0","52.83","39.19"
"65","000","00","010","1035","0086","983","761","222","54","1037","1909","0","54.32","39.86"
"65","000","00","010","1035","0087","885","704","181","62","947","1770","0","53.5","39.77"
"65","000","00","010","1035","0088","956","762","194","70","1026","2049","0","50.07","37.19"
"65","000","00","010","1035","0089","870","676","194","34","904","1680","0","53.81","40.24"
"65","000","00","010","1036","0000","2227","1724","503","161","2388","4250","0","56.19","40.56"
"65","000","00","010","1036","0090","778","575","203","65","843","1433","0","58.83","40.13"
"65","000","00","010","1036","0091","685","544","141","42","727","1365","0","53.26","39.85"
"65","000","00","010","1036","0092","764","605","159","54","818","1452","0","56.34","41.67"
"65","000","00","010","1037","0000","2047","1647","400","89","2136","4020","0","53.13","40.97"
"65","000","00","010","1037","0077","1025","819","206","48","1073","1992","0","53.87","41.11"
"65","000","00","010","1037","0078","1022","828","194","41","1063","2028","0","52.42","40.83"
"65","000","00","010","1038","0000","1259","965","294","69","1328","2456","0","54.07","39.29"
"65","000","00","010","1038","0075","659","496","163","39","698","1245","0","56.06","39.84"
"65","000","00","010","1038","0076","600","469","131","30","630","1211","0","52.02","38.73"
"65","000","00","010","1039","0000","1872","1469","403","89","1961","3906","0","50.2","37.61"
"65","000","00","010","1039","0050","1027","808","219","40","1067","1982","0","53.83","40.77"
"65","000","00","010","1039","0051","845","661","184","49","894","1924","0","46.47","34.36"
"65","000","00","010","1040","0000","1825","1386","439","108","1933","3612","0","53.52","38.37"
"65","000","00","010","1040","0101","560","423","137","33","593","1108","0","53.52","38.18"
"65","000","00","010","1040","0102","659","507","152","53","712","1305","0","54.56","38.85"
"65","000","00","010","1040","0103","606","456","150","22","628","1199","0","52.38","38.03"
"65","000","00","010","1041","0000","1961","1460","501","130","2091","4142","0","50.48","35.25"
"65","000","00","010","1041","0104","997","795","202","63","1060","2017","0","52.55","39.41"
"65","000","00","010","1041","0105","964","665","299","67","1031","2125","0","48.52","31.29"
"65","000","00","010","1042","0000","3182","2593","589","163","3345","6953","0","48.11","37.29"
"65","000","00","010","1042","0122","889","698","191","64","953","1832","0","52.02","38.1"
"65","000","00","010","1042","0123","1040","818","222","66","1106","2123","0","52.1","38.53"
"65","000","00","010","1042","0124","1253","1077","176","33","1286","2998","0","42.9","35.92"
"65","000","00","011","0000","0000","85612","67547","18065","5665","91277","173831","200217","52.51","38.86"
"65","000","00","011","1101","0000","662","521","141","43","705","1262","0","55.86","41.28"
"65","000","00","011","1101","2337","662","521","141","43","705","1262","0","55.86","41.28"
"65","000","00","011","1102","0000","482","379","103","59","541","917","0","59.0","41.33"
"65","000","00","011","1102","2338","482","379","103","59","541","917","0","59.0","41.33"
"65","000","00","011","1103","0000","2115","1667","448","129","2244","4156","0","53.99","40.11"
"65","000","00","011","1103","2339","1005","780","225","61","1066","1929","0","55.26","40.44"
"65","000","00","011","1103","2340","1110","887","223","68","1178","2227","0","52.9","39.83"
"65","000","00","011","1104","0000","153","113","40","20","173","322","0","53.73","35.09"
"65","000","00","011","1104","2343","153","113","40","20","173","322","0","53.73","35.09"
"65","000","00","011","1105","0000","1234","962","272","91","1325","2564","0","51.68","37.52"
"65","000","00","011","1105","2373","611","469","142","53","664","1244","0","53.38","37.7"
"65","000","00","011","1105","2374","623","493","130","38","661","1320","0","50.08","37.35"
"65","000","00","011","1106","0000","1703","1231","472","122","1825","4797","0","38.04","25.66"
"65","000","00","011","1106","2350","332","246","86","24","356","1809","0","19.68","13.6"
"65","000","00","011","1106","2351","698","440","258","33","731","1601","0","45.66","27.48"
"65","000","00","011","1106","2352","673","545","128","65","738","1387","0","53.21","39.29"
"65","000","00","011","1107","0000","2359","1832","527","135","2494","4840","0","51.53","37.85"
"65","000","00","011","1107","2344","781","612","169","9","790","1460","0","54.11","41.92"
"65","000","00","011","1107","2345","807","609","198","68","875","1719","0","50.9","35.43"
"65","000","00","011","1107","2346","771","611","160","58","829","1661","0","49.91","36.79"
"65","000","00","011","1108","0000","3233","2536","697","144","3377","6144","0","54.96","41.28"
"65","000","00","011","1108","2355","1063","843","220","47","1110","2072","0","53.57","40.69"
"65","000","00","011","1108","2356","1170","902","268","57","1227","2120","0","57.88","42.55"
"65","000","00","011","1108","2357","1000","791","209","40","1040","1952","0","53.28","40.52"
"65","000","00","011","1109","0000","1859","1436","423","165","2024","3964","0","51.06","36.23"
"65","000","00","011","1109","2365","654","517","137","64","718","1363","0","52.68","37.93"
"65","000","00","011","1109","2366","645","496","149","50","695","1368","0","50.8","36.26"
"65","000","00","011","1109","2367","560","423","137","51","611","1233","0","49.55","34.31"
"65","000","00","011","1110","0000","674","532","142","62","736","1481","0","49.7","35.92"
"65","000","00","011","1110","2378","674","532","142","62","736","1481","0","49.7","35.92"
"65","000","00","011","1111","0000","708","554","154","61","769","1497","0","51.37","37.01"
"65","000","00","011","1111","2379","708","554","154","61","769","1497","0","51.37","37.01"
"65","000","00","011","1112","0000","1872","1504","368","97","1969","3940","0","49.97","38.17"
"65","000","00","011","1112","2381","901","713","188","55","956","1913","0","49.97","37.27"
"65","000","00","011","1112","2382","971","791","180","42","1013","2027","0","49.98","39.02"
"65","000","00","011","1113","0000","992","775","217","60","1052","2127","0","49.46","36.44"
"65","000","00","011","1113","2385","992","775","217","60","1052","2127","0","49.46","36.44"
"65","000","00","011","1114","0000","2455","1910","545","188","2643","5447","0","48.52","35.07"
"65","000","00","011","1114","2386","722","577","145","50","772","1642","0","47.02","35.14"
"65","000","00","011","1114","2387","915","699","216","80","995","1912","0","52.04","36.56"
"65","000","00","011","1114","2388","818","634","184","58","876","1893","0","46.28","33.49"
"65","000","00","011","1115","0000","2094","1684","410","185","2279","4554","0","50.04","36.98"
"65","000","00","011","1115","2389","653","516","137","60","713","1466","0","48.64","35.2"
"65","000","00","011","1115","2390","702","566","136","82","784","1538","0","50.98","36.8"
"65","000","00","011","1115","2391","739","602","137","43","782","1550","0","50.45","38.84"
"65","000","00","011","1116","0000","682","523","159","52","734","1456","0","50.41","35.92"
"65","000","00","011","1116","2392","682","523","159","52","734","1456","0","50.41","35.92"
"65","000","00","011","1117","0000","522","405","117","49","571","947","0","60.3","42.77"
"65","000","00","011","1117","2393","522","405","117","49","571","947","0","60.3","42.77"
"65","000","00","011","1118","0000","829","646","183","28","857","1988","0","43.11","32.49"
"65","000","00","011","1118","2400","829","646","183","28","857","1988","0","43.11","32.49"
"65","000","00","011","1119","0000","1795","1377","418","188","1983","4055","0","48.9","33.96"
"65","000","00","011","1119","2395","928","719","209","99","1027","2043","0","50.27","35.19"
"65","000","00","011","1119","2396","867","658","209","89","956","2012","0","47.51","32.7"
"65","000","00","011","1120","0000","2757","2177","580","232","2989","5100","0","58.61","42.69"
"65","000","00","011","1120","2431","705","551","154","61","766","1335","0","57.38","41.27"
"65","000","00","011","1120","2432","751","608","143","55","806","1324","0","60.88","45.92"
"65","000","00","011","1120","2433","710","562","148","70","780","1286","0","60.65","43.7"
"65","000","00","011","1120","2434","591","456","135","46","637","1155","0","55.15","39.48"
"65","000","00","011","1121","0000","1713","1322","391","94","1807","3847","0","46.97","34.36"
"65","000","00","011","1121","2363","818","645","173","49","867","1941","0","44.67","33.23"
"65","000","00","011","1121","2364","895","677","218","45","940","1906","0","49.32","35.52"
"65","000","00","011","1122","0000","2130","1652","478","196","2326","4215","0","55.18","39.19"
"65","000","00","011","1122","2438","1104","858","246","114","1218","2184","0","55.77","39.29"
"65","000","00","011","1122","2439","1026","794","232","82","1108","2031","0","54.55","39.09"
"65","000","00","011","1123","0000","283","231","52","20","303","556","0","54.5","41.55"
"65","000","00","011","1123","2380","283","231","52","20","303","556","0","54.5","41.55"
"65","000","00","011","1124","0000","1747","1360","387","124","1871","3336","0","56.09","40.77"
"65","000","00","011","1124","2440","909","716","193","69","978","1759","0","55.6","40.7"
"65","000","00","011","1124","2441","838","644","194","55","893","1577","0","56.63","40.84"
"65","000","00","011","1125","0000","1437","1141","296","55","1492","2765","0","53.96","41.27"
"65","000","00","011","1125","2442","690","560","130","19","709","1364","0","51.98","41.06"
"65","000","00","011","1125","2443","747","581","166","36","783","1401","0","55.89","41.47"
"65","000","00","011","1126","0000","3211","2527","684","228","3439","6938","0","49.57","36.42"
"65","000","00","011","1126","2411","837","661","176","55","892","1765","0","50.54","37.45"
"65","000","00","011","1126","2412","757","596","161","33","790","1815","0","43.53","32.84"
"65","000","00","011","1126","2413","822","633","189","62","884","1778","0","49.72","35.6"
"65","000","00","011","1126","2414","795","637","158","78","873","1580","0","55.25","40.32"
"65","000","00","011","1127","0000","2601","2116","485","125","2726","5304","0","51.4","39.89"
"65","000","00","011","1127","2422","937","728","209","49","986","2035","0","48.45","35.77"
"65","000","00","011","1127","2423","909","744","165","56","965","1895","0","50.92","39.26"
"65","000","00","011","1127","2424","755","644","111","20","775","1374","0","56.4","46.87"
"65","000","00","011","1128","0000","779","615","164","77","856","1595","0","53.67","38.56"
"65","000","00","011","1128","2336","779","615","164","77","856","1595","0","53.67","38.56"
"65","000","00","011","1129","0000","3131","2497","634","182","3313","6514","0","50.86","38.33"
"65","000","00","011","1129","2405","747","597","150","27","774","1511","0","51.22","39.51"
"65","000","00","011","1129","2406","765","607","158","35","800","1691","0","47.31","35.9"
"65","000","00","011","1129","2407","829","660","169","44","873","1636","0","53.36","40.34"
"65","000","00","011","1129","2408","790","633","157","76","866","1676","0","51.67","37.77"
"65","000","00","011","1130","0000","3529","2821","708","266","3795","7292","0","52.04","38.69"
"65","000","00","011","1130","2401","1029","819","210","59","1088","2198","0","49.5","37.26"
"65","000","00","011","1130","2402","806","638","168","64","870","1712","0","50.82","37.27"
"65","000","00","011","1130","2403","939","751","188","66","1005","1806","0","55.65","41.58"
"65","000","00","011","1130","2404","755","613","142","77","832","1576","0","52.79","38.9"
"65","000","00","011","1131","0000","2427","1905","522","169","2596","4725","0","54.94","40.32"
"65","000","00","011","1131","2358","809","632","177","67","876","1654","0","52.96","38.21"
"65","000","00","011","1131","2359","696","556","140","62","758","1444","0","52.49","38.5"
"65","000","00","011","1131","2360","922","717","205","40","962","1627","0","59.13","44.07"
"65","000","00","011","1132","0000","1865","1477","388","123","1988","3817","0","52.08","38.7"
"65","000","00","011","1132","2361","829","654","175","75","904","1751","0","51.63","37.35"
"65","000","00","011","1132","2362","1036","823","213","48","1084","2066","0","52.47","39.84"
"65","000","00","011","1133","0000","2166","1734","432","144","2310","4604","0","50.17","37.66"
"65","000","00","011","1133","2397","637","506","131","35","672","1471","0","45.68","34.4"
"65","000","00","011","1133","2398","762","623","139","52","814","1603","0","50.78","38.86"
"65","000","00","011","1133","2399","767","605","162","57","824","1530","0","53.86","39.54"
"65","000","00","011","1134","0000","1411","1100","311","97","1508","2941","0","51.28","37.4"
"65","000","00","011","1134","2415","758","586","172","50","808","1516","0","53.3","38.65"
"65","000","00","011","1134","2416","653","514","139","47","700","1425","0","49.12","36.07"
"65","000","00","011","1135","0000","1444","1136","308","89","1533","2824","0","54.28","40.23"
"65","000","00","011","1135","2417","721","575","146","36","757","1388","0","54.54","41.43"
"65","000","00","011","1135","2418","723","561","162","53","776","1436","0","54.04","39.07"
"65","000","00","011","1136","0000","2232","1796","436","100","2332","4624","0","50.43","38.84"
"65","000","00","011","1136","2419","802","645","157","36","838","1591","0","52.67","40.54"
"65","000","00","011","1136","2420","767","619","148","46","813","1639","0","49.6","37.77"
"65","000","00","011","1136","2421","663","532","131","18","681","1394","0","48.85","38.16"
"65","000","00","011","1137","0000","1853","1466","387","106","1959","3176","0","61.68","46.16"
"65","000","00","011","1137","2435","985","767","218","50","1035","1682","0","61.53","45.6"
"65","000","00","011","1137","2436","868","699","169","56","924","1494","0","61.85","46.79"
"65","000","00","011","1138","0000","631","460","171","66","697","1166","0","59.78","39.45"
"65","000","00","011","1138","2437","631","460","171","66","697","1166","0","59.78","39.45"
"65","000","00","011","1139","0000","1992","1583","409","110","2102","3753","0","56.01","42.18"
"65","000","00","011","1139","2444","635","479","156","58","693","1173","0","59.08","40.84"
"65","000","00","011","1139","2445","555","469","86","23","578","993","0","58.21","47.23"
"65","000","00","011","1139","2446","802","635","167","29","831","1587","0","52.36","40.01"
"65","000","00","011","1140","0000","1185","968","217","67","1252","2429","0","51.54","39.85"
"65","000","00","011","1140","2409","617","501","116","37","654","1264","0","51.74","39.64"
"65","000","00","011","1140","2410","568","467","101","30","598","1165","0","51.33","40.09"
"65","000","00","011","1141","0000","1304","994","310","101","1405","2510","0","55.98","39.6"
"65","000","00","011","1141","2341","586","429","157","60","646","1143","0","56.52","37.53"
"65","000","00","011","1141","2342","718","565","153","41","759","1367","0","55.52","41.33"
"65","000","00","011","1142","0000","2146","1705","441","81","2227","4378","0","50.87","38.94"
"65","000","00","011","1142","2368","738","597","141","23","761","1554","0","48.97","38.42"
"65","000","00","011","1142","2369","807","617","190","31","838","1700","0","49.29","36.29"
"65","000","00","011","1142","2370","601","491","110","27","628","1124","0","55.87","43.68"
"65","000","00","011","1143","0000","3057","2416","641","165","3222","5763","0","55.91","41.92"
"65","000","00","011","1143","2427","806","640","166","43","849","1548","0","54.84","41.34"
"65","000","00","011","1143","2428","741","582","159","31","772","1350","0","57.19","43.11"
"65","000","00","011","1143","2429","782","608","174","32","814","1499","0","54.3","40.56"
"65","000","00","011","1143","2430","728","586","142","59","787","1366","0","57.61","42.9"
"65","000","00","011","1144","0000","483","348","135","26","509","923","0","55.15","37.7"
"65","000","00","011","1144","2394","483","348","135","26","509","923","0","55.15","37.7"
"65","000","00","011","1145","0000","2574","2073","501","167","2741","4938","0","55.51","41.98"
"65","000","00","011","1145","2347","835","667","168","67","902","1590","0","56.73","41.95"
"65","000","00","011","1145","2348","819","664","155","52","871","1599","0","54.47","41.53"
"65","000","00","011","1145","2349","920","742","178","48","968","1749","0","55.35","42.42"
"65","000","00","011","1146","0000","1998","1583","415","155","2153","3853","0","55.88","41.08"
"65","000","00","011","1146","2353","915","707","208","83","998","1779","0","56.1","39.74"
"65","000","00","011","1146","2354","1083","876","207","72","1155","2074","0","55.69","42.24"
"65","000","00","011","1147","0000","2413","1934","479","151","2564","4541","0","56.46","42.59"
"65","000","00","011","1147","2375","785","611","174","45","830","1473","0","56.35","41.48"
"65","000","00","011","1147","2376","923","732","191","69","992","1802","0","55.05","40.62"
"65","000","00","011","1147","2377","705","591","114","37","742","1266","0","58.61","46.68"
"65","000","00","011","1148","0000","2037","1658","379","138","2175","3950","0","55.06","41.97"
"65","000","00","011","1148","2371","1004","806","198","80","1084","1900","0","57.05","42.42"
"65","000","00","011","1148","2372","1033","852","181","58","1091","2050","0","53.22","41.56"
"65","000","00","011","1149","0000","1398","1162","236","56","1454","2373","0","61.27","48.97"
"65","000","00","011","1149","2425","597","490","107","29","626","1061","0","59.0","46.18"
"65","000","00","011","1149","2426","801","672","129","27","828","1312","0","63.11","51.22"
"65","000","00","011","1150","0000","1255","1003","252","77","1332","2623","0","50.78","38.24"
"65","000","00","011","1150","2383","910","750","160","33","943","1927","0","48.94","38.92"
"65","000","00","011","1150","2384","345","253","92","44","389","696","0","55.89","36.35"
"65","000","00","012","0000","0000","15488","12211","3277","1236","16724","35036","40022","47.73","34.85"
"65","000","00","012","1201","0000","386","306","80","34","420","725","0","57.93","42.21"
"65","000","00","012","1201","2220","386","306","80","34","420","725","0","57.93","42.21"
"65","000","00","012","1202","0000","945","771","174","76","1021","1899","0","53.77","40.6"
"65","000","00","012","1202","2221","547","445","102","53","600","1074","0","55.87","41.43"
"65","000","00","012","1202","2222","398","326","72","23","421","825","0","51.03","39.52"
"65","000","00","012","1203","0000","627","490","137","37","664","1242","0","53.46","39.45"
"65","000","00","012","1203","2223","627","490","137","37","664","1242","0","53.46","39.45"
"65","000","00","012","1204","0000","753","593","160","79","832","1632","0","50.98","36.34"
"65","000","00","012","1204","2225","423","331","92","43","466","872","0","53.44","37.96"
"65","000","00","012","1204","2226","330","262","68","36","366","760","0","48.16","34.47"
"65","000","00","012","1205","0000","584","458","126","34","618","1330","0","46.47","34.44"
"65","000","00","012","1205","2227","584","458","126","34","618","1330","0","46.47","34.44"
"65","000","00","012","1206","0000","300","241","59","26","326","598","0","54.52","40.3"
"65","000","00","012","1206","2224","300","241","59","26","326","598","0","54.52","40.3"
"65","000","00","012","1207","0000","1653","1291","362","142","1795","3609","0","49.74","35.77"
"65","000","00","012","1207","2228","715","554","161","60","775","1683","0","46.05","32.92"
"65","000","00","012","1207","2229","478","378","100","40","518","980","0","52.86","38.57"
"65","000","00","012","1207","2230","460","359","101","42","502","946","0","53.07","37.95"
"65","000","00","012","1208","0000","506","383","123","52","558","1089","0","51.24","35.17"
"65","000","00","012","1208","2235","506","383","123","52","558","1089","0","51.24","35.17"
"65","000","00","012","1209","0000","681","530","151","51","732","1623","0","45.1","32.66"
"65","000","00","012","1209","2233","395","324","71","22","417","978","0","42.64","33.13"
"65","000","00","012","1209","2234","286","206","80","29","315","645","0","48.84","31.94"
"65","000","00","012","1210","0000","542","445","97","52","594","1291","0","46.01","34.47"
"65","000","00","012","1210","2245","323","269","54","40","363","673","0","53.94","39.97"
"65","000","00","012","1210","2246","219","176","43","12","231","618","0","37.38","28.48"
"65","000","00","012","1211","0000","836","647","189","77","913","1701","0","53.67","38.04"
"65","000","00","012","1211","2240","411","325","86","38","449","817","0","54.96","39.78"
"65","000","00","012","1211","2241","425","322","103","39","464","884","0","52.49","36.43"
"65","000","00","012","1212","0000","1302","1053","249","90","1392","2985","0","46.63","35.28"
"65","000","00","012","1212","2242","566","456","110","52","618","1333","0","46.36","34.21"
"65","000","00","012","1212","2243","227","189","38","5","232","607","0","38.22","31.14"
"65","000","00","012","1212","2244","509","408","101","33","542","1045","0","51.87","39.04"
"65","000","00","012","1213","0000","890","716","174","66","956","1923","0","49.71","37.23"
"65","000","00","012","1213","2247","464","377","87","27","491","1063","0","46.19","35.47"
"65","000","00","012","1213","2248","426","339","87","39","465","860","0","54.07","39.42"
"65","000","00","012","1214","0000","204","160","44","27","231","461","0","50.11","34.71"
"65","000","00","012","1214","2237","204","160","44","27","231","461","0","50.11","34.71"
"65","000","00","012","1215","0000","121","95","26","16","137","274","0","50.0","34.67"
"65","000","00","012","1215","2238","121","95","26","16","137","274","0","50.0","34.67"
"65","000","00","012","1216","0000","110","88","22","11","121","286","0","42.31","30.77"
"65","000","00","012","1216","2236","110","88","22","11","121","286","0","42.31","30.77"
"65","000","00","012","1217","0000","82","64","18","11","93","155","0","60.0","41.29"
"65","000","00","012","1217","2239","82","64","18","11","93","155","0","60.0","41.29"
"65","000","00","012","1218","0000","128","101","27","3","131","432","0","30.32","23.38"
"65","000","00","012","1218","2249","128","101","27","3","131","432","0","30.32","23.38"
"65","000","00","012","1219","0000","159","121","38","9","168","445","0","37.75","27.19"
"65","000","00","012","1219","2250","159","121","38","9","168","445","0","37.75","27.19"
"65","000","00","012","1220","0000","126","110","16","7","133","318","0","41.82","34.59"
"65","000","00","012","1220","2251","126","110","16","7","133","318","0","41.82","34.59"
"65","000","00","012","1221","0000","68","59","9","9","77","159","0","48.43","37.11"
"65","000","00","012","1221","2252","68","59","9","9","77","159","0","48.43","37.11"
"65","000","00","012","1222","0000","128","95","33","17","145","337","0","43.03","28.19"
"65","000","00","012","1222","2253","128","95","33","17","145","337","0","43.03","28.19"
"65","000","00","012","1223","0000","172","131","41","19","191","369","0","51.76","35.5"
"65","000","00","012","1223","2256","172","131","41","19","191","369","0","51.76","35.5"
"65","000","00","012","1224","0000","92","69","23","6","98","180","0","54.44","38.33"
"65","000","00","012","1224","2254","92","69","23","6","98","180","0","54.44","38.33"
"65","000","00","012","1225","0000","68","57","11","13","81","187","0","43.32","30.48"
"65","000","00","012","1225","2255","68","57","11","13","81","187","0","43.32","30.48"
"65","000","00","012","1226","0000","171","121","50","15","186","335","0","55.52","36.12"
"65","000","00","012","1226","2257","171","121","50","15","186","335","0","55.52","36.12"
"65","000","00","012","1227","0000","110","83","27","5","115","297","0","38.72","27.95"
"65","000","00","012","1227","2259","110","83","27","5","115","297","0","38.72","27.95"
"65","000","00","012","1228","0000","183","151","32","16","199","470","0","42.34","32.13"
"65","000","00","012","1228","2258","183","151","32","16","199","470","0","42.34","32.13"
"65","000","00","012","1229","0000","419","317","102","29","448","1241","0","36.1","25.54"
"65","000","00","012","1229","2262","419","317","102","29","448","1241","0","36.1","25.54"
"65","000","00","012","1230","0000","921","678","243","112","1033","1946","0","53.08","34.84"
"65","000","00","012","1230","2263","476","343","133","58","534","998","0","53.51","34.37"
"65","000","00","012","1230","2264","445","335","110","54","499","948","0","52.64","35.34"
"65","000","00","012","1231","0000","485","382","103","27","512","1308","0","39.14","29.2"
"65","000","00","012","1231","2265","485","382","103","27","512","1308","0","39.14","29.2"
"65","000","00","012","1232","0000","160","138","22","4","164","267","0","61.42","51.69"
"65","000","00","012","1232","2260","160","138","22","4","164","267","0","61.42","51.69"
"65","000","00","012","1233","0000","211","165","46","9","220","876","0","25.11","18.84"
"65","000","00","012","1233","2261","211","165","46","9","220","876","0","25.11","18.84"
"65","000","00","012","1234","0000","1365","1102","263","55","1420","3046","0","46.62","36.18"
"65","000","00","012","1234","2231","579","470","109","21","600","1375","0","43.64","34.18"
"65","000","00","012","1234","2232","786","632","154","34","820","1671","0","49.07","37.82"
"65","000","00","013","0000","0000","101064","78924","22140","7807","108871","200783","236964","54.22","39.31"
"65","000","00","013","1301","0000","1638","1326","312","163","1801","4869","0","36.99","27.23"
"65","000","00","013","1301","1799","476","380","96","46","522","2518","0","20.73","15.09"
"65","000","00","013","1301","1800","585","465","120","47","632","1218","0","51.89","38.18"
"65","000","00","013","1301","1801","577","481","96","70","647","1133","0","57.11","42.45"
"65","000","00","013","1302","0000","946","728","218","95","1041","1825","0","57.04","39.89"
"65","000","00","013","1302","1802","457","349","108","37","494","894","0","55.26","39.04"
"65","000","00","013","1302","1803","489","379","110","58","547","931","0","58.75","40.71"
"65","000","00","013","1303","0000","2810","2238","572","201","3011","5283","0","56.99","42.36"
"65","000","00","013","1303","1808","731","586","145","54","785","1378","0","56.97","42.53"
"65","000","00","013","1303","1809","763","598","165","62","825","1421","0","58.06","42.08"
"65","000","00","013","1303","1810","678","554","124","45","723","1340","0","53.96","41.34"
"65","000","00","013","1303","1811","638","500","138","40","678","1144","0","59.27","43.71"
"65","000","00","013","1304","0000","2427","1899","528","171","2598","4954","0","52.44","38.33"
"65","000","00","013","1304","1795","657","505","152","39","696","1292","0","53.87","39.09"
"65","000","00","013","1304","1796","608","483","125","31","639","1324","0","48.26","36.48"
"65","000","00","013","1304","1797","565","436","129","47","612","1155","0","52.99","37.75"
"65","000","00","013","1304","1798","597","475","122","54","651","1183","0","55.03","40.15"
"65","000","00","013","1305","0000","1100","943","157","52","1152","1820","0","63.3","51.81"
"65","000","00","013","1305","1804","1100","943","157","52","1152","1820","0","63.3","51.81"
"65","000","00","013","1306","0000","2138","1658","480","224","2362","4161","0","56.77","39.85"
"65","000","00","013","1306","1820","700","532","168","79","779","1356","0","57.45","39.23"
"65","000","00","013","1306","1821","773","606","167","65","838","1496","0","56.02","40.51"
"65","000","00","013","1306","1822","665","520","145","80","745","1309","0","56.91","39.72"
"65","000","00","013","1307","0000","2725","2084","641","257","2982","5067","0","58.85","41.13"
"65","000","00","013","1307","1816","643","502","141","61","704","1230","0","57.24","40.81"
"65","000","00","013","1307","1817","684","509","175","79","763","1342","0","56.86","37.93"
"65","000","00","013","1307","1818","692","540","152","52","744","1268","0","58.68","42.59"
"65","000","00","013","1307","1819","706","533","173","65","771","1227","0","62.84","43.44"
"65","000","00","013","1308","0000","1985","1580","405","176","2161","3900","0","55.41","40.51"
"65","000","00","013","1308","1827","594","456","138","71","665","1182","0","56.26","38.58"
"65","000","00","013","1308","1828","785","635","150","49","834","1558","0","53.53","40.76"
"65","000","00","013","1308","1829","606","489","117","56","662","1160","0","57.07","42.16"
"65","000","00","013","1309","0000","1547","1214","333","107","1654","2965","0","55.78","40.94"
"65","000","00","013","1309","1858","722","555","167","52","774","1445","0","53.56","38.41"
"65","000","00","013","1309","1859","825","659","166","55","880","1520","0","57.89","43.36"
"65","000","00","013","1310","0000","3939","3068","871","314","4253","7503","0","56.68","40.89"
"65","000","00","013","1310","1840","784","594","190","82","866","1576","0","54.95","37.69"
"65","000","00","013","1310","1841","769","620","149","63","832","1458","0","57.06","42.52"
"65","000","00","013","1310","1842","794","608","186","76","870","1517","0","57.35","40.08"
"65","000","00","013","1310","1843","799","630","169","45","844","1489","0","56.68","42.31"
"65","000","00","013","1310","1844","793","616","177","48","841","1463","0","57.48","42.11"
"65","000","00","013","1311","0000","1395","1057","338","164","1559","2821","0","55.26","37.47"
"65","000","00","013","1311","1830","690","525","165","72","762","1357","0","56.15","38.69"
"65","000","00","013","1311","1831","705","532","173","92","797","1464","0","54.44","36.34"
"65","000","00","013","1312","0000","3599","2776","823","274","3873","7204","0","53.76","38.53"
"65","000","00","013","1312","1875","716","543","173","69","785","1402","0","55.99","38.73"
"65","000","00","013","1312","1876","704","546","158","52","756","1379","0","54.82","39.59"
"65","000","00","013","1312","1877","710","552","158","47","757","1471","0","51.46","37.53"
"65","000","00","013","1312","1878","697","550","147","50","747","1410","0","52.98","39.01"
"65","000","00","013","1312","1879","772","585","187","56","828","1542","0","53.7","37.94"
"65","000","00","013","1313","0000","2572","1985","587","212","2784","5586","0","49.84","35.54"
"65","000","00","013","1313","1864","603","439","164","52","655","1337","0","48.99","32.83"
"65","000","00","013","1313","1865","540","423","117","50","590","1325","0","44.53","31.92"
"65","000","00","013","1313","1866","667","511","156","42","709","1390","0","51.01","36.76"
"65","000","00","013","1313","1867","762","612","150","68","830","1534","0","54.11","39.9"
"65","000","00","013","1314","0000","2067","1623","444","135","2202","3850","0","57.19","42.16"
"65","000","00","013","1314","1880","630","480","150","53","683","1238","0","55.17","38.77"
"65","000","00","013","1314","1881","635","502","133","42","677","1301","0","52.04","38.59"
"65","000","00","013","1314","1882","802","641","161","40","842","1311","0","64.23","48.89"
"65","000","00","013","1315","0000","715","550","165","73","788","1484","0","53.1","37.06"
"65","000","00","013","1315","1868","715","550","165","73","788","1484","0","53.1","37.06"
"65","000","00","013","1316","0000","3106","2466","640","262","3368","6156","0","54.71","40.06"
"65","000","00","013","1316","1869","722","569","153","76","798","1532","0","52.09","37.14"
"65","000","00","013","1316","1870","770","610","160","75","845","1507","0","56.07","40.48"
"65","000","00","013","1316","1871","809","648","161","57","866","1550","0","55.87","41.81"
"65","000","00","013","1316","1872","805","639","166","54","859","1567","0","54.82","40.78"
"65","000","00","013","1317","0000","3197","2528","669","265","3462","6530","0","53.02","38.71"
"65","000","00","013","1317","1892","652","504","148","53","705","1312","0","53.73","38.41"
"65","000","00","013","1317","1893","617","493","124","59","676","1301","0","51.96","37.89"
"65","000","00","013","1317","1894","609","474","135","57","666","1254","0","53.11","37.8"
"65","000","00","013","1317","1895","584","462","122","37","621","1215","0","51.11","38.02"
"65","000","00","013","1317","1896","735","595","140","59","794","1448","0","54.83","41.09"
"65","000","00","013","1318","0000","3135","2483","652","243","3378","6194","0","54.54","40.09"
"65","000","00","013","1318","1906","763","621","142","51","814","1550","0","52.52","40.06"
"65","000","00","013","1318","1907","835","656","179","75","910","1606","0","56.66","40.85"
"65","000","00","013","1318","1908","774","597","177","53","827","1509","0","54.8","39.56"
"65","000","00","013","1318","1909","763","609","154","64","827","1529","0","54.09","39.83"
"65","000","00","013","1319","0000","1787","1294","493","114","1901","4283","0","44.38","30.21"
"65","000","00","013","1319","1886","249","79","170","40","289","1335","0","21.65","5.92"
"65","000","00","013","1319","1887","760","606","154","43","803","1459","0","55.04","41.54"
"65","000","00","013","1319","1888","778","609","169","31","809","1489","0","54.33","40.9"
"65","000","00","013","1320","0000","2200","1694","506","191","2391","4330","0","55.22","39.12"
"65","000","00","013","1320","1792","628","488","140","65","693","1206","0","57.46","40.46"
"65","000","00","013","1320","1793","683","521","162","46","729","1255","0","58.09","41.51"
"65","000","00","013","1320","1794","889","685","204","80","969","1869","0","51.85","36.65"
"65","000","00","013","1321","0000","3652","2861","791","244","3896","7156","0","54.44","39.98"
"65","000","00","013","1321","1787","703","548","155","59","762","1424","0","53.51","38.48"
"65","000","00","013","1321","1788","726","563","163","59","785","1455","0","53.95","38.69"
"65","000","00","013","1321","1789","694","525","169","42","736","1419","0","51.87","37.0"
"65","000","00","013","1321","1790","774","629","145","38","812","1357","0","59.84","46.35"
"65","000","00","013","1321","1791","755","596","159","46","801","1501","0","53.36","39.71"
"65","000","00","013","1322","0000","1987","1547","440","170","2157","4013","0","53.75","38.55"
"65","000","00","013","1322","1784","644","505","139","57","701","1378","0","50.87","36.65"
"65","000","00","013","1322","1785","619","488","131","48","667","1256","0","53.11","38.85"
"65","000","00","013","1322","1786","724","554","170","65","789","1379","0","57.22","40.17"
"65","000","00","013","1323","0000","2172","1719","453","177","2349","4405","0","53.33","39.02"
"65","000","00","013","1323","1781","763","597","166","57","820","1499","0","54.7","39.83"
"65","000","00","013","1323","1782","726","610","116","43","769","1495","0","51.44","40.8"
"65","000","00","013","1323","1783","683","512","171","77","760","1411","0","53.86","36.29"
"65","000","00","013","1324","0000","2221","1687","534","194","2415","4638","0","52.07","36.37"
"65","000","00","013","1324","1778","729","548","181","76","805","1474","0","54.61","37.18"
"65","000","00","013","1324","1779","689","525","164","62","751","1489","0","50.44","35.26"
"65","000","00","013","1324","1780","803","614","189","56","859","1675","0","51.28","36.66"
"65","000","00","013","1325","0000","1389","1117","272","65","1454","2448","0","59.4","45.63"
"65","000","00","013","1325","1776","704","580","124","37","741","1242","0","59.66","46.7"
"65","000","00","013","1325","1777","685","537","148","28","713","1206","0","59.12","44.53"
"65","000","00","013","1326","0000","734","569","165","69","803","1505","0","53.36","37.81"
"65","000","00","013","1326","1775","734","569","165","69","803","1505","0","53.36","37.81"
"65","000","00","013","1327","0000","2355","1835","520","190","2545","4640","0","54.85","39.55"
"65","000","00","013","1327","1847","838","640","198","61","899","1598","0","56.26","40.05"
"65","000","00","013","1327","1848","724","557","167","81","805","1500","0","53.67","37.13"
"65","000","00","013","1327","1849","793","638","155","48","841","1542","0","54.54","41.37"
"65","000","00","013","1328","0000","2490","1944","546","147","2637","5032","0","52.4","38.63"
"65","000","00","013","1328","1835","846","674","172","57","903","1639","0","55.09","41.12"
"65","000","00","013","1328","1836","924","705","219","55","979","1728","0","56.66","40.8"
"65","000","00","013","1328","1837","720","565","155","35","755","1665","0","45.35","33.93"
"65","000","00","013","1329","0000","1610","1269","341","97","1707","3140","0","54.36","40.41"
"65","000","00","013","1329","1850","895","698","197","63","958","1619","0","59.17","43.11"
"65","000","00","013","1329","1851","715","571","144","34","749","1521","0","49.24","37.54"
"65","000","00","013","1330","0000","2076","1635","441","185","2261","3975","0","56.88","41.13"
"65","000","00","013","1330","1900","747","556","191","64","811","1366","0","59.37","40.7"
"65","000","00","013","1330","1901","681","550","131","50","731","1292","0","56.58","42.57"
"65","000","00","013","1330","1902","648","529","119","71","719","1317","0","54.59","40.17"
"65","000","00","013","1331","0000","2197","1702","495","212","2409","4421","0","54.49","38.5"
"65","000","00","013","1331","1910","680","540","140","85","765","1458","0","52.47","37.04"
"65","000","00","013","1331","1911","764","577","187","77","841","1468","0","57.29","39.31"
"65","000","00","013","1331","1912","753","585","168","50","803","1495","0","53.71","39.13"
"65","000","00","013","1332","0000","1363","1070","293","82","1445","2605","0","55.47","41.07"
"65","000","00","013","1332","1862","637","513","124","37","674","1262","0","53.41","40.65"
"65","000","00","013","1332","1863","726","557","169","45","771","1343","0","57.41","41.47"
"65","000","00","013","1333","0000","2661","2100","561","204","2865","4947","0","57.91","42.45"
"65","000","00","013","1333","1812","667","513","154","57","724","1268","0","57.1","40.46"
"65","000","00","013","1333","1813","627","496","131","65","692","1196","0","57.86","41.47"
"65","000","00","013","1333","1814","730","571","159","48","778","1308","0","59.48","43.65"
"65","000","00","013","1333","1815","637","520","117","34","671","1175","0","57.11","44.26"
"65","000","00","013","1334","0000","1819","1367","452","194","2013","3896","0","51.67","35.09"
"65","000","00","013","1334","1897","644","497","147","67","711","1321","0","53.82","37.62"
"65","000","00","013","1334","1898","530","393","137","73","603","1150","0","52.43","34.17"
"65","000","00","013","1334","1899","645","477","168","54","699","1425","0","49.05","33.47"
"65","000","00","013","1335","0000","2073","1571","502","208","2281","4116","0","55.42","38.17"
"65","000","00","013","1335","1832","616","468","148","78","694","1335","0","51.99","35.06"
"65","000","00","013","1335","1833","646","501","145","79","725","1346","0","53.86","37.22"
"65","000","00","013","1335","1834","811","602","209","51","862","1435","0","60.07","41.95"
"65","000","00","013","1336","0000","2538","1950","588","233","2771","4896","0","56.6","39.83"
"65","000","00","013","1336","1823","628","459","169","64","692","1175","0","58.89","39.06"
"65","000","00","013","1336","1824","619","460","159","75","694","1237","0","56.1","37.19"
"65","000","00","013","1336","1825","661","529","132","59","720","1256","0","57.32","42.12"
"65","000","00","013","1336","1826","630","502","128","35","665","1228","0","54.15","40.88"
"65","000","00","013","1337","0000","1958","1538","420","141","2099","3975","0","52.81","38.69"
"65","000","00","013","1337","1805","659","541","118","29","688","1320","0","52.12","40.98"
"65","000","00","013","1337","1806","607","452","155","48","655","1241","0","52.78","36.42"
"65","000","00","013","1337","1807","692","545","147","64","756","1414","0","53.47","38.54"
"65","000","00","013","1338","0000","2239","1756","483","166","2405","4680","0","51.39","37.52"
"65","000","00","013","1338","1883","704","557","147","32","736","1511","0","48.71","36.86"
"65","000","00","013","1338","1884","749","577","172","67","816","1531","0","53.3","37.69"
"65","000","00","013","1338","1885","786","622","164","67","853","1638","0","52.08","37.97"
"65","000","00","013","1339","0000","1579","1235","344","130","1709","2900","0","58.93","42.59"
"65","000","00","013","1339","1838","724","565","159","82","806","1333","0","60.47","42.39"
"65","000","00","013","1339","1839","855","670","185","48","903","1567","0","57.63","42.76"
"65","000","00","013","1340","0000","2922","2323","599","247","3169","5663","0","55.96","41.02"
"65","000","00","013","1340","1913","675","505","170","65","740","1303","0","56.79","38.76"
"65","000","00","013","1340","1914","711","569","142","57","768","1365","0","56.26","41.68"
"65","000","00","013","1340","1915","737","580","157","83","820","1476","0","55.56","39.3"
"65","000","00","013","1340","1916","799","669","130","42","841","1519","0","55.37","44.04"
"65","000","00","013","1341","0000","1336","1056","280","65","1401","2846","0","49.23","37.1"
"65","000","00","013","1341","1860","641","511","130","33","674","1484","0","45.42","34.43"
"65","000","00","013","1341","1861","695","545","150","32","727","1362","0","53.38","40.01"
"65","000","00","013","1342","0000","2332","1686","646","120","2452","4173","0","58.76","40.4"
"65","000","00","013","1342","1855","757","597","160","21","778","1423","0","54.67","41.95"
"65","000","00","013","1342","1856","768","565","203","43","811","1321","0","61.39","42.77"
"65","000","00","013","1342","1857","807","524","283","56","863","1429","0","60.39","36.67"
"65","000","00","013","1343","0000","2671","2076","595","137","2808","5120","0","54.84","40.55"
"65","000","00","013","1343","1852","864","674","190","41","905","1691","0","53.52","39.86"
"65","000","00","013","1343","1853","828","656","172","52","880","1657","0","53.11","39.59"
"65","000","00","013","1343","1854","979","746","233","44","1023","1772","0","57.73","42.1"
"65","000","00","013","1344","0000","1578","1260","318","74","1652","3048","0","54.2","41.34"
"65","000","00","013","1344","1845","822","661","161","26","848","1584","0","53.54","41.73"
"65","000","00","013","1344","1846","756","599","157","48","804","1464","0","54.92","40.92"
"65","000","00","013","1345","0000","1388","1097","291","88","1476","2660","0","55.49","41.24"
"65","000","00","013","1345","1873","753","584","169","30","783","1367","0","57.28","42.72"
"65","000","00","013","1345","1874","635","513","122","58","693","1293","0","53.6","39.68"
"65","000","00","013","1346","0000","2780","2252","528","136","2916","5364","0","54.36","41.98"
"65","000","00","013","1346","1889","912","730","182","12","924","1774","0","52.09","41.15"
"65","000","00","013","1346","1890","923","758","165","54","977","1792","0","54.52","42.3"
"65","000","00","013","1346","1891","945","764","181","70","1015","1798","0","56.45","42.49"
"65","000","00","013","1347","0000","1916","1508","408","139","2055","3736","0","55.01","40.36"
"65","000","00","013","1347","1903","691","544","147","62","753","1324","0","56.87","41.09"
"65","000","00","013","1347","1904","588","468","120","3","591","1189","0","49.71","39.36"
"65","000","00","013","1347","1905","637","496","141","74","711","1223","0","58.14","40.56"
"65","000","00","014","0000","0000","82181","62988","19193","6888","89069","167457","201173","53.19","37.61"
"65","000","00","014","1401","0000","5721","4412","1309","302","6023","10484","0","57.45","42.08"
"65","000","00","014","1401","0581","997","760","237","57","1054","1791","0","58.85","42.43"
"65","000","00","014","1401","0582","983","707","276","55","1038","1714","0","60.56","41.25"
"65","000","00","014","1401","0583","968","781","187","41","1009","1780","0","56.69","43.88"
"65","000","00","014","1401","0584","914","694","220","50","964","1713","0","56.28","40.51"
"65","000","00","014","1401","0585","939","723","216","49","988","1720","0","57.44","42.03"
"65","000","00","014","1401","0586","920","747","173","50","970","1766","0","54.93","42.3"
"65","000","00","014","1402","0000","2545","1996","549","221","2766","4958","0","55.79","40.26"
"65","000","00","014","1402","0573","860","668","192","87","947","1652","0","57.32","40.44"
"65","000","00","014","1402","0574","815","624","191","90","905","1650","0","54.85","37.82"
"65","000","00","014","1402","0575","870","704","166","44","914","1656","0","55.19","42.51"
"65","000","00","014","1403","0000","1550","1083","467","102","1652","3576","0","46.2","30.29"
"65","000","00","014","1403","0561","646","513","133","44","690","1779","0","38.79","28.84"
"65","000","00","014","1403","0562","904","570","334","58","962","1797","0","53.53","31.72"
"65","000","00","014","1404","0000","2403","1830","573","261","2664","4665","0","57.11","39.23"
"65","000","00","014","1404","0555","821","620","201","96","917","1600","0","57.31","38.75"
"65","000","00","014","1404","0556","792","593","199","67","859","1549","0","55.46","38.28"
"65","000","00","014","1404","0557","790","617","173","98","888","1516","0","58.58","40.7"
"65","000","00","014","1405","0000","1622","1235","387","187","1809","3361","0","53.82","36.75"
"65","000","00","014","1405","0655","783","589","194","84","867","1673","0","51.82","35.21"
"65","000","00","014","1405","0656","839","646","193","103","942","1688","0","55.81","38.27"
"65","000","00","014","1406","0000","4263","3297","966","354","4617","9051","0","51.01","36.43"
"65","000","00","014","1406","0640","912","698","214","83","995","1851","0","53.75","37.71"
"65","000","00","014","1406","0641","813","619","194","63","876","1791","0","48.91","34.56"
"65","000","00","014","1406","0642","845","664","181","72","917","1853","0","49.49","35.83"
"65","000","00","014","1406","0643","809","628","181","52","861","1758","0","48.98","35.72"
"65","000","00","014","1406","0644","884","688","196","84","968","1798","0","53.84","38.26"
"65","000","00","014","1407","0000","2590","1973","617","218","2808","5589","0","50.24","35.3"
"65","000","00","014","1407","0604","896","675","221","72","968","1806","0","53.6","37.38"
"65","000","00","014","1407","0605","914","703","211","79","993","1910","0","51.99","36.81"
"65","000","00","014","1407","0606","780","595","185","67","847","1873","0","45.22","31.77"
"65","000","00","014","1408","0000","2471","1875","596","188","2659","4826","0","55.1","38.85"
"65","000","00","014","1408","0616","809","626","183","70","879","1634","0","53.79","38.31"
"65","000","00","014","1408","0617","800","609","191","69","869","1573","0","55.24","38.72"
"65","000","00","014","1408","0618","862","640","222","49","911","1619","0","56.27","39.53"
"65","000","00","014","1409","0000","2780","2138","642","227","3007","5491","0","54.76","38.94"
"65","000","00","014","1409","0619","935","728","207","95","1030","1878","0","54.85","38.76"
"65","000","00","014","1409","0620","877","677","200","90","967","1797","0","53.81","37.67"
"65","000","00","014","1409","0621","968","733","235","42","1010","1816","0","55.62","40.36"
"65","000","00","014","1410","0000","1539","1116","423","141","1680","2836","0","59.24","39.35"
"65","000","00","014","1410","0622","711","525","186","84","795","1344","0","59.15","39.06"
"65","000","00","014","1410","0623","828","591","237","57","885","1492","0","59.32","39.61"
"65","000","00","014","1411","0000","1461","1091","370","124","1585","2963","0","53.49","36.82"
"65","000","00","014","1411","0636","827","635","192","64","891","1602","0","55.62","39.64"
"65","000","00","014","1411","0637","634","456","178","60","694","1361","0","50.99","33.5"
"65","000","00","014","1412","0000","1193","877","316","145","1338","2287","0","58.5","38.35"
"65","000","00","014","1412","0634","570","412","158","69","639","1111","0","57.52","37.08"
"65","000","00","014","1412","0635","623","465","158","76","699","1176","0","59.44","39.54"
"65","000","00","014","1413","0000","938","723","215","113","1051","1959","0","53.65","36.91"
"65","000","00","014","1413","0624","938","723","215","113","1051","1959","0","53.65","36.91"
"65","000","00","014","1414","0000","1363","1025","338","150","1513","2980","0","50.77","34.4"
"65","000","00","014","1414","0630","672","498","174","64","736","1332","0","55.26","37.39"
"65","000","00","014","1414","0631","691","527","164","86","777","1648","0","47.15","31.98"
"65","000","00","014","1415","0000","2661","2061","600","188","2849","5122","0","55.62","40.24"
"65","000","00","014","1415","0587","814","630","184","69","883","1623","0","54.41","38.82"
"65","000","00","014","1415","0588","897","688","209","51","948","1740","0","54.48","39.54"
"65","000","00","014","1415","0589","950","743","207","68","1018","1759","0","57.87","42.24"
"65","000","00","014","1416","0000","2912","2244","668","253","3165","5489","0","57.66","40.88"
"65","000","00","014","1416","0590","943","722","221","81","1024","1775","0","57.69","40.68"
"65","000","00","014","1416","0591","1013","790","223","76","1089","1909","0","57.05","41.38"
"65","000","00","014","1416","0592","956","732","224","96","1052","1805","0","58.28","40.55"
"65","000","00","014","1417","0000","2924","2284","640","204","3128","5952","0","52.55","38.37"
"65","000","00","014","1417","0597","697","554","143","58","755","1434","0","52.65","38.63"
"65","000","00","014","1417","0598","723","541","182","71","794","1450","0","54.76","37.31"
"65","000","00","014","1417","0599","733","572","161","26","759","1543","0","49.19","37.07"
"65","000","00","014","1417","0600","771","617","154","49","820","1525","0","53.77","40.46"
"65","000","00","014","1418","0000","1586","1200","386","123","1709","3545","0","48.21","33.85"
"65","000","00","014","1418","0607","785","596","189","57","842","1785","0","47.17","33.39"
"65","000","00","014","1418","0608","801","604","197","66","867","1760","0","49.26","34.32"
"65","000","00","014","1419","0000","2437","1934","503","190","2627","5146","0","51.05","37.58"
"65","000","00","014","1419","0609","948","766","182","73","1021","1841","0","55.46","41.61"
"65","000","00","014","1419","0610","836","662","174","40","876","1855","0","47.22","35.69"
"65","000","00","014","1419","0611","653","506","147","77","730","1450","0","50.34","34.9"
"65","000","00","014","1420","0000","1444","1113","331","172","1616","3126","0","51.7","35.6"
"65","000","00","014","1420","0612","753","569","184","76","829","1585","0","52.3","35.9"
"65","000","00","014","1420","0613","691","544","147","96","787","1541","0","51.07","35.3"
"65","000","00","014","1421","0000","3839","2984","855","306","4145","8323","0","49.8","35.85"
"65","000","00","014","1421","0645","838","646","192","59","897","1645","0","54.53","39.27"
"65","000","00","014","1421","0646","735","573","162","57","792","1612","0","49.13","35.55"
"65","000","00","014","1421","0647","776","599","177","82","858","1784","0","48.09","33.58"
"65","000","00","014","1421","0648","725","562","163","63","788","1701","0","46.33","33.04"
"65","000","00","014","1421","0649","765","604","161","45","810","1581","0","51.23","38.2"
"65","000","00","014","1422","0000","2449","1865","584","202","2651","4648","0","57.04","40.12"
"65","000","00","014","1422","0650","784","584","200","60","844","1534","0","55.02","38.07"
"65","000","00","014","1422","0651","852","641","211","69","921","1620","0","56.85","39.57"
"65","000","00","014","1422","0652","813","640","173","73","886","1494","0","59.3","42.84"
"65","000","00","014","1423","0000","1452","1138","314","123","1575","2881","0","54.67","39.5"
"65","000","00","014","1423","0579","653","529","124","69","722","1367","0","52.82","38.7"
"65","000","00","014","1423","0580","799","609","190","54","853","1514","0","56.34","40.22"
"65","000","00","014","1424","0000","2331","1810","521","186","2517","4810","0","52.33","37.63"
"65","000","00","014","1424","0566","759","590","169","54","813","1524","0","53.35","38.71"
"65","000","00","014","1424","0567","757","585","172","70","827","1612","0","51.3","36.29"
"65","000","00","014","1424","0568","815","635","180","62","877","1674","0","52.39","37.93"
"65","000","00","014","1425","0000","1468","1123","345","105","1573","2938","0","53.54","38.22"
"65","000","00","014","1425","0571","722","514","208","49","771","1473","0","52.34","34.89"
"65","000","00","014","1425","0572","746","609","137","56","802","1465","0","54.74","41.57"
"65","000","00","014","1426","0000","1323","1039","284","73","1396","2726","0","51.21","38.11"
"65","000","00","014","1426","0632","661","520","141","29","690","1355","0","50.92","38.38"
"65","000","00","014","1426","0633","662","519","143","44","706","1371","0","51.5","37.86"
"65","000","00","014","1427","0000","2456","1857","599","254","2710","4838","0","56.01","38.38"
"65","000","00","014","1427","0625","785","576","209","97","882","1611","0","54.75","35.75"
"65","000","00","014","1427","0626","817","609","208","85","902","1574","0","57.31","38.69"
"65","000","00","014","1427","0627","854","672","182","72","926","1653","0","56.02","40.65"
"65","000","00","014","1428","0000","1882","1427","455","140","2022","4897","0","41.29","29.14"
"65","000","00","014","1428","0628","989","764","225","64","1053","3085","0","34.13","24.76"
"65","000","00","014","1428","0629","893","663","230","76","969","1812","0","53.48","36.59"
"65","000","00","014","1429","0000","2144","1687","457","219","2363","4270","0","55.34","39.51"
"65","000","00","014","1429","0558","692","533","159","82","774","1404","0","55.13","37.96"
"65","000","00","014","1429","0559","663","507","156","88","751","1381","0","54.38","36.71"
"65","000","00","014","1429","0560","789","647","142","49","838","1485","0","56.43","43.57"
"65","000","00","014","1430","0000","1237","927","310","125","1362","2725","0","49.98","34.02"
"65","000","00","014","1430","0657","532","392","140","52","584","1249","0","46.76","31.39"
"65","000","00","014","1430","0658","705","535","170","73","778","1476","0","52.71","36.25"
"65","000","00","014","1431","0000","2246","1672","574","183","2429","4569","0","53.16","36.59"
"65","000","00","014","1431","0576","762","568","194","58","820","1571","0","52.2","36.16"
"65","000","00","014","1431","0577","740","527","213","79","819","1523","0","53.78","34.6"
"65","000","00","014","1431","0578","744","577","167","46","790","1475","0","53.56","39.12"
"65","000","00","014","1432","0000","1222","958","264","134","1356","2455","0","55.23","39.02"
"65","000","00","014","1432","0638","761","602","159","67","828","1530","0","54.12","39.35"
"65","000","00","014","1432","0639","461","356","105","67","528","925","0","57.08","38.49"
"65","000","00","014","1433","0000","1123","844","279","106","1229","2168","0","56.69","38.93"
"65","000","00","014","1433","0653","604","470","134","53","657","1183","0","55.54","39.73"
"65","000","00","014","1433","0654","519","374","145","53","572","985","0","58.07","37.97"
"65","000","00","014","1434","0000","1443","1128","315","131","1574","2867","0","54.9","39.34"
"65","000","00","014","1434","0614","790","630","160","68","858","1626","0","52.77","38.75"
"65","000","00","014","1434","0615","653","498","155","63","716","1241","0","57.7","40.13"
"65","000","00","014","1435","0000","2257","1747","510","189","2446","4566","0","53.57","38.26"
"65","000","00","014","1435","0563","723","559","164","69","792","1364","0","58.06","40.98"
"65","000","00","014","1435","0564","838","649","189","73","911","1635","0","55.72","39.69"
"65","000","00","014","1435","0565","696","539","157","47","743","1567","0","47.42","34.4"
"65","000","00","014","1436","0000","1613","1232","381","109","1722","3652","0","47.15","33.73"
"65","000","00","014","1436","0569","838","644","194","62","900","1838","0","48.97","35.04"
"65","000","00","014","1436","0570","775","588","187","47","822","1814","0","45.31","32.41"
"65","000","00","014","1437","0000","3318","2520","798","237","3555","6697","0","53.08","37.63"
"65","000","00","014","1437","0593","819","629","190","49","868","1642","0","52.86","38.31"
"65","000","00","014","1437","0594","856","651","205","59","915","1713","0","53.42","38.0"
"65","000","00","014","1437","0595","833","619","214","64","897","1746","0","51.37","35.45"
"65","000","00","014","1437","0596","810","621","189","65","875","1596","0","54.82","38.91"
"65","000","00","014","1438","0000","1975","1523","452","203","2178","4021","0","54.17","37.88"
"65","000","00","014","1438","0601","653","513","140","79","732","1419","0","51.59","36.15"
"65","000","00","014","1438","0602","684","518","166","56","740","1298","0","57.01","39.91"
"65","000","00","014","1438","0603","638","492","146","68","706","1304","0","54.14","37.73"
"65","000","00","015","0000","0000","35250","27379","7871","2856","38106","72443","86156","52.6","37.79"
"65","000","00","015","1501","0000","2076","1538","538","220","2296","4225","0","54.34","36.4"
"65","000","00","015","1501","0207","696","512","184","95","791","1456","0","54.33","35.16"
"65","000","00","015","1501","0208","712","540","172","71","783","1482","0","52.83","36.44"
"65","000","00","015","1501","0209","668","486","182","54","722","1287","0","56.1","37.76"
"65","000","00","015","1502","0000","514","345","169","39","553","1106","0","50.0","31.19"
"65","000","00","015","1502","0210","514","345","169","39","553","1106","0","50.0","31.19"
"65","000","00","015","1503","0000","1712","1325","387","137","1849","3437","0","53.8","38.55"
"65","000","00","015","1503","0212","857","657","200","54","911","1833","0","49.7","35.84"
"65","000","00","015","1503","0213","604","481","123","51","655","1141","0","57.41","42.16"
"65","000","00","015","1503","0214","251","187","64","32","283","463","0","61.12","40.39"
"65","000","00","015","1504","0000","559","405","154","77","636","1283","0","49.57","31.57"
"65","000","00","015","1504","0211","559","405","154","77","636","1283","0","49.57","31.57"
"65","000","00","015","1505","0000","2417","1870","547","199","2616","5271","0","49.63","35.48"
"65","000","00","015","1505","0219","855","656","199","109","964","1832","0","52.62","35.81"
"65","000","00","015","1505","0220","753","593","160","42","795","1542","0","51.56","38.46"
"65","000","00","015","1505","0221","809","621","188","48","857","1897","0","45.18","32.74"
"65","000","00","015","1506","0000","2472","1930","542","264","2736","5478","0","49.95","35.23"
"65","000","00","015","1506","0222","856","669","187","101","957","1964","0","48.73","34.06"
"65","000","00","015","1506","0223","804","618","186","81","885","1779","0","49.75","34.74"
"65","000","00","015","1506","0224","812","643","169","82","894","1735","0","51.53","37.06"
"65","000","00","015","1507","0000","554","410","144","41","595","1281","0","46.45","32.01"
"65","000","00","015","1507","0229","554","410","144","41","595","1281","0","46.45","32.01"
"65","000","00","015","1508","0000","1862","1437","425","173","2035","3910","0","52.05","36.75"
"65","000","00","015","1508","0236","481","376","105","35","516","1333","0","38.71","28.21"
"65","000","00","015","1508","0237","697","537","160","60","757","1263","0","59.94","42.52"
"65","000","00","015","1508","0238","684","524","160","78","762","1314","0","57.99","39.88"
"65","000","00","015","1509","0000","1419","1098","321","122","1541","3126","0","49.3","35.12"
"65","000","00","015","1509","0230","760","578","182","83","843","1566","0","53.83","36.91"
"65","000","00","015","1509","0231","659","520","139","39","698","1560","0","44.74","33.33"
"65","000","00","015","1510","0000","2291","1776","515","148","2439","4643","0","52.53","38.25"
"65","000","00","015","1510","0239","713","564","149","41","754","1513","0","49.83","37.28"
"65","000","00","015","1510","0240","780","604","176","34","814","1517","0","53.66","39.82"
"65","000","00","015","1510","0241","798","608","190","73","871","1613","0","54.0","37.69"
"65","000","00","015","1511","0000","1102","958","144","73","1175","2281","0","51.51","42.0"
"65","000","00","015","1511","0253","544","465","79","30","574","1127","0","50.93","41.26"
"65","000","00","015","1511","0254","558","493","65","43","601","1154","0","52.08","42.72"
"65","000","00","015","1512","0000","1538","1287","251","109","1647","2709","0","60.8","47.51"
"65","000","00","015","1512","0251","798","661","137","53","851","1397","0","60.92","47.32"
"65","000","00","015","1512","0252","740","626","114","56","796","1312","0","60.67","47.71"
"65","000","00","015","1513","0000","2071","1672","399","141","2212","3916","0","56.49","42.7"
"65","000","00","015","1513","0248","710","566","144","31","741","1441","0","51.42","39.28"
"65","000","00","015","1513","0249","700","572","128","51","751","1305","0","57.55","43.83"
"65","000","00","015","1513","0250","661","534","127","59","720","1170","0","61.54","45.64"
"65","000","00","015","1514","0000","1397","1055","342","169","1566","2819","0","55.55","37.42"
"65","000","00","015","1514","0217","756","554","202","87","843","1534","0","54.95","36.11"
"65","000","00","015","1514","0218","641","501","140","82","723","1285","0","56.26","38.99"
"65","000","00","015","1515","0000","1711","1345","366","93","1804","3401","0","53.04","39.55"
"65","000","00","015","1515","0232","813","643","170","42","855","1622","0","52.71","39.64"
"65","000","00","015","1515","0233","898","702","196","51","949","1779","0","53.34","39.46"
"65","000","00","015","1516","0000","1693","1246","447","94","1787","3446","0","51.86","36.16"
"65","000","00","015","1516","0215","888","687","201","55","943","1786","0","52.8","38.47"
"65","000","00","015","1516","0216","805","559","246","39","844","1660","0","50.84","33.67"
"65","000","00","015","1517","0000","1498","1185","313","126","1624","3054","0","53.18","38.8"
"65","000","00","015","1517","0234","692","543","149","75","767","1487","0","51.58","36.52"
"65","000","00","015","1517","0235","806","642","164","51","857","1567","0","54.69","40.97"
"65","000","00","015","1518","0000","3528","2756","772","263","3791","7389","0","51.31","37.3"
"65","000","00","015","1518","0225","1072","832","240","52","1124","2299","0","48.89","36.19"
"65","000","00","015","1518","0226","784","623","161","60","844","1755","0","48.09","35.5"
"65","000","00","015","1518","0227","837","657","180","69","906","1674","0","54.12","39.25"
"65","000","00","015","1518","0228","835","644","191","82","917","1661","0","55.21","38.77"
"65","000","00","015","1519","0000","3351","2599","752","245","3596","6815","0","52.77","38.14"
"65","000","00","015","1519","0242","799","625","174","70","869","1616","0","53.77","38.68"
"65","000","00","015","1519","0243","792","601","191","73","865","1616","0","53.53","37.19"
"65","000","00","015","1519","0244","842","647","195","76","918","1689","0","54.35","38.31"
"65","000","00","015","1519","0245","918","726","192","26","944","1894","0","49.84","38.33"
"65","000","00","015","1520","0000","1485","1142","343","123","1608","2853","0","56.36","40.03"
"65","000","00","015","1520","0246","696","530","166","66","762","1210","0","62.98","43.8"
"65","000","00","015","1520","0247","789","612","177","57","846","1643","0","51.49","37.25"
"65","000","00","016","0000","0000","32967","26020","6947","2173","35140","64252","78683","54.69","40.5"
"65","000","00","016","1601","0000","402","312","90","39","441","829","0","53.2","37.64"
"65","000","00","016","1601","0255","293","221","72","34","327","643","0","50.86","34.37"
"65","000","00","016","1601","0256","109","91","18","5","114","186","0","61.29","48.92"
"65","000","00","016","1602","0000","1509","1201","308","107","1616","3051","0","52.97","39.36"
"65","000","00","016","1602","0257","683","535","148","45","728","1457","0","49.97","36.72"
"65","000","00","016","1602","0258","826","666","160","62","888","1594","0","55.71","41.78"
"65","000","00","016","1603","0000","2856","2289","567","205","3061","5921","0","51.7","38.66"
"65","000","00","016","1603","0259","748","632","116","53","801","1598","0","50.13","39.55"
"65","000","00","016","1603","0260","704","569","135","46","750","1503","0","49.9","37.86"
"65","000","00","016","1603","0261","693","552","141","55","748","1436","0","52.09","38.44"
"65","000","00","016","1603","0262","711","536","175","51","762","1384","0","55.06","38.73"
"65","000","00","016","1604","0000","1266","971","295","76","1342","2526","0","53.13","38.44"
"65","000","00","016","1604","0263","636","490","146","51","687","1231","0","55.81","39.81"
"65","000","00","016","1604","0264","630","481","149","25","655","1295","0","50.58","37.14"
"65","000","00","016","1605","0000","2005","1553","452","121","2126","3901","0","54.5","39.81"
"65","000","00","016","1605","0267","640","485","155","33","673","1253","0","53.71","38.71"
"65","000","00","016","1605","0268","623","491","132","41","664","1294","0","51.31","37.94"
"65","000","00","016","1605","0269","742","577","165","47","789","1354","0","58.27","42.61"
"65","000","00","016","1606","0000","1848","1469","379","89","1937","3605","0","53.73","40.75"
"65","000","00","016","1606","0270","641","521","120","36","677","1259","0","53.77","41.38"
"65","000","00","016","1606","0271","670","516","154","27","697","1252","0","55.67","41.21"
"65","000","00","016","1606","0272","537","432","105","26","563","1094","0","51.46","39.49"
"65","000","00","016","1607","0000","2095","1670","425","167","2262","4048","0","55.88","41.25"
"65","000","00","016","1607","0280","680","546","134","54","734","1201","0","61.12","45.46"
"65","000","00","016","1607","0281","602","468","134","55","657","1182","0","55.58","39.59"
"65","000","00","016","1607","0282","813","656","157","58","871","1665","0","52.31","39.4"
"65","000","00","016","1608","0000","1732","1359","373","131","1863","3306","0","56.35","41.11"
"65","000","00","016","1608","0287","555","452","103","36","591","1152","0","51.3","39.24"
"65","000","00","016","1608","0288","577","430","147","48","625","1114","0","56.1","38.6"
"65","000","00","016","1608","0289","600","477","123","47","647","1040","0","62.21","45.87"
"65","000","00","016","1609","0000","1807","1407","400","117","1924","3517","0","54.71","40.01"
"65","000","00","016","1609","0294","639","497","142","41","680","1211","0","56.15","41.04"
"65","000","00","016","1609","0295","631","486","145","35","666","1237","0","53.84","39.29"
"65","000","00","016","1609","0296","537","424","113","41","578","1069","0","54.07","39.66"
"65","000","00","016","1610","0000","2294","1790","504","105","2399","4348","0","55.17","41.17"
"65","000","00","016","1610","0299","696","546","150","30","726","1420","0","51.13","38.45"
"65","000","00","016","1610","0300","721","559","162","33","754","1337","0","56.39","41.81"
"65","000","00","016","1610","0301","877","685","192","42","919","1591","0","57.76","43.05"
"65","000","00","016","1611","0000","1659","1356","303","139","1798","3224","0","55.77","42.06"
"65","000","00","016","1611","0273","833","626","207","57","890","1590","0","55.97","39.37"
"65","000","00","016","1611","0274","826","730","96","82","908","1634","0","55.57","44.68"
"65","000","00","016","1612","0000","3617","2813","804","268","3885","7245","0","53.62","38.83"
"65","000","00","016","1612","0283","938","719","219","71","1009","1855","0","54.39","38.76"
"65","000","00","016","1612","0284","934","710","224","93","1027","1866","0","55.04","38.05"
"65","000","00","016","1612","0285","974","771","203","56","1030","1935","0","53.23","39.84"
"65","000","00","016","1612","0286","771","613","158","48","819","1589","0","51.54","38.58"
"65","000","00","016","1613","0000","1097","847","250","66","1163","1978","0","58.8","42.82"
"65","000","00","016","1613","0290","556","448","108","41","597","1003","0","59.52","44.67"
"65","000","00","016","1613","0291","541","399","142","25","566","975","0","58.05","40.92"
"65","000","00","016","1614","0000","1475","1138","337","67","1542","2920","0","52.81","38.97"
"65","000","00","016","1614","0292","741","558","183","44","785","1440","0","54.51","38.75"
"65","000","00","016","1614","0293","734","580","154","23","757","1480","0","51.15","39.19"
"65","000","00","016","1615","0000","1805","1437","368","103","1908","3331","0","57.28","43.14"
"65","000","00","016","1615","0297","929","761","168","63","992","1680","0","59.05","45.3"
"65","000","00","016","1615","0298","876","676","200","40","916","1651","0","55.48","40.94"
"65","000","00","016","1616","0000","1698","1373","325","136","1834","3173","0","57.8","43.27"
"65","000","00","016","1616","0265","828","657","171","69","897","1563","0","57.39","42.03"
"65","000","00","016","1616","0266","870","716","154","67","937","1610","0","58.2","44.47"
"65","000","00","016","1617","0000","3802","3035","767","237","4039","7329","0","55.11","41.41"
"65","000","00","016","1617","0275","684","521","163","45","729","1536","0","47.46","33.92"
"65","000","00","016","1617","0276","827","650","177","58","885","1534","0","57.69","42.37"
"65","000","00","016","1617","0277","885","724","161","62","947","1545","0","61.29","46.86"
"65","000","00","016","1617","0278","738","608","130","44","782","1399","0","55.9","43.46"
"65","000","00","016","1617","0279","668","532","136","28","696","1315","0","52.93","40.46"
"65","000","00","017","0000","0000","45476","36042","9434","2656","48132","86203","108950","55.84","41.81"
"65","000","00","017","1701","0000","1802","1358","444","181","1983","3657","0","54.22","37.13"
"65","000","00","017","1701","0145","603","455","148","73","676","1268","0","53.31","35.88"
"65","000","00","017","1701","0146","557","413","144","50","607","1171","0","51.84","35.27"
"65","000","00","017","1701","0147","642","490","152","58","700","1218","0","57.47","40.23"
"65","000","00","017","1702","0000","2321","1818","503","178","2499","4861","0","51.41","37.4"
"65","000","00","017","1702","0148","862","672","190","54","916","1788","0","51.23","37.58"
"65","000","00","017","1702","0149","767","602","165","61","828","1625","0","50.95","37.05"
"65","000","00","017","1702","0150","692","544","148","63","755","1448","0","52.14","37.57"
"65","000","00","017","1703","0000","4243","3397","846","315","4558","8259","0","55.19","41.13"
"65","000","00","017","1703","0151","601","454","147","83","684","1328","0","51.51","34.19"
"65","000","00","017","1703","0152","635","505","130","70","705","1523","0","46.29","33.16"
"65","000","00","017","1703","0153","633","519","114","50","683","1245","0","54.86","41.69"
"65","000","00","017","1703","0154","782","647","135","43","825","1329","0","62.08","48.68"
"65","000","00","017","1703","0155","822","657","165","34","856","1465","0","58.43","44.85"
"65","000","00","017","1703","0156","770","615","155","35","805","1369","0","58.8","44.92"
"65","000","00","017","1704","0000","2091","1568","523","141","2232","3818","0","58.46","41.07"
"65","000","00","017","1704","0157","734","560","174","52","786","1346","0","58.4","41.6"
"65","000","00","017","1704","0158","588","440","148","61","649","1181","0","54.95","37.26"
"65","000","00","017","1704","0159","769","568","201","28","797","1291","0","61.74","44.0"
"65","000","00","017","1705","0000","1921","1488","433","128","2049","3654","0","56.08","40.72"
"65","000","00","017","1705","0160","629","479","150","45","674","1213","0","55.56","39.49"
"65","000","00","017","1705","0161","693","561","132","39","732","1256","0","58.28","44.67"
"65","000","00","017","1705","0162","599","448","151","44","643","1185","0","54.26","37.81"
"65","000","00","017","1706","0000","696","549","147","41","737","1361","0","54.15","40.34"
"65","000","00","017","1706","0163","696","549","147","41","737","1361","0","54.15","40.34"
"65","000","00","017","1707","0000","9219","7538","1681","373","9592","17256","0","55.59","43.68"
"65","000","00","017","1707","0164","875","765","110","22","897","1756","0","51.08","43.56"
"65","000","00","017","1707","0165","828","670","158","32","860","1676","0","51.31","39.98"
"65","000","00","017","1707","0166","849","689","160","22","871","1540","0","56.56","44.74"
"65","000","00","017","1707","0167","810","681","129","41","851","1569","0","54.24","43.4"
"65","000","00","017","1707","0168","804","658","146","32","836","1514","0","55.22","43.46"
"65","000","00","017","1707","0169","670","561","109","24","694","1193","0","58.17","47.02"
"65","000","00","017","1707","0170","882","711","171","30","912","1610","0","56.65","44.16"
"65","000","00","017","1707","0171","745","609","136","30","775","1338","0","57.92","45.52"
"65","000","00","017","1707","0172","617","488","129","37","654","1141","0","57.32","42.77"
"65","000","00","017","1707","0173","700","560","140","38","738","1307","0","56.47","42.85"
"65","000","00","017","1707","0174","733","584","149","28","761","1327","0","57.35","44.01"
"65","000","00","017","1707","0175","706","562","144","37","743","1285","0","57.82","43.74"
"65","000","00","017","1708","0000","8406","6813","1593","363","8769","15777","0","55.58","43.18"
"65","000","00","017","1708","0176","790","608","182","45","835","1481","0","56.38","41.05"
"65","000","00","017","1708","0177","829","660","169","29","858","1510","0","56.82","43.71"
"65","000","00","017","1708","0178","907","720","187","47","954","1785","0","53.45","40.34"
"65","000","00","017","1708","0179","937","747","190","34","971","1792","0","54.19","41.69"
"65","000","00","017","1708","0180","827","678","149","29","856","1517","0","56.43","44.69"
"65","000","00","017","1708","0181","867","715","152","32","899","1564","0","57.48","45.72"
"65","000","00","017","1708","0182","851","721","130","44","895","1560","0","57.37","46.22"
"65","000","00","017","1708","0183","807","640","167","33","840","1544","0","54.4","41.45"
"65","000","00","017","1708","0184","819","676","143","39","858","1593","0","53.86","42.44"
"65","000","00","017","1708","0185","772","648","124","31","803","1431","0","56.11","45.28"
"65","000","00","017","1709","0000","2866","2210","656","177","3043","5291","0","57.51","41.77"
"65","000","00","017","1709","0195","764","606","158","48","812","1380","0","58.84","43.91"
"65","000","00","017","1709","0196","712","543","169","55","767","1367","0","56.11","39.72"
"65","000","00","017","1709","0197","730","532","198","35","765","1350","0","56.67","39.41"
"65","000","00","017","1709","0198","660","529","131","39","699","1194","0","58.54","44.3"
"65","000","00","017","1710","0000","457","338","119","44","501","1026","0","48.83","32.94"
"65","000","00","017","1710","0202","457","338","119","44","501","1026","0","48.83","32.94"
"65","000","00","017","1711","0000","623","459","164","49","672","1210","0","55.54","37.93"
"65","000","00","017","1711","0203","623","459","164","49","672","1210","0","55.54","37.93"
"65","000","00","017","1712","0000","459","349","110","54","513","912","0","56.25","38.27"
"65","000","00","017","1712","0204","459","349","110","54","513","912","0","56.25","38.27"
"65","000","00","017","1713","0000","444","316","128","36","480","824","0","58.25","38.35"
"65","000","00","017","1713","0205","444","316","128","36","480","824","0","58.25","38.35"
"65","000","00","017","1714","0000","743","576","167","88","831","1411","0","58.89","40.82"
"65","000","00","017","1714","0206","743","576","167","88","831","1411","0","58.89","40.82"
"65","000","00","017","1715","0000","3165","2496","669","175","3340","5852","0","57.07","42.65"
"65","000","00","017","1715","0186","794","628","166","40","834","1571","0","53.09","39.97"
"65","000","00","017","1715","0187","786","631","155","37","823","1439","0","57.19","43.85"
"65","000","00","017","1715","0188","794","614","180","49","843","1451","0","58.1","42.32"
"65","000","00","017","1715","0189","791","623","168","49","840","1391","0","60.39","44.79"
"65","000","00","017","1716","0000","4067","3247","820","182","4249","7417","0","57.29","43.78"
"65","000","00","017","1716","0190","782","627","155","30","812","1461","0","55.58","42.92"
"65","000","00","017","1716","0191","881","705","176","32","913","1691","0","53.99","41.69"
"65","000","00","017","1716","0192","799","602","197","50","849","1524","0","55.71","39.5"
"65","000","00","017","1716","0193","805","659","146","33","838","1343","0","62.4","49.07"
"65","000","00","017","1716","0194","800","654","146","37","837","1398","0","59.87","46.78"
"65","000","00","017","1717","0000","1953","1522","431","131","2084","3617","0","57.62","42.08"
"65","000","00","017","1717","0199","679","513","166","58","737","1344","0","54.84","38.17"
"65","000","00","017","1717","0200","620","492","128","33","653","1154","0","56.59","42.63"
"65","000","00","017","1717","0201","654","517","137","40","694","1119","0","62.02","46.2"
"65","000","00","018","0000","0000","10394","8193","2201","716","11110","20624","23617","53.87","39.73"
"65","000","00","018","1801","0000","1427","1137","290","97","1524","3004","0","50.73","37.85"
"65","000","00","018","1801","2169","634","506","128","29","663","1496","0","44.32","33.82"
"65","000","00","018","1801","2170","793","631","162","68","861","1508","0","57.1","41.84"
"65","000","00","018","1802","0000","1171","898","273","82","1253","2281","0","54.93","39.37"
"65","000","00","018","1802","2163","555","435","120","30","585","1142","0","51.23","38.09"
"65","000","00","018","1802","2164","616","463","153","52","668","1139","0","58.65","40.65"
"65","000","00","018","1803","0000","1279","1022","257","71","1350","2710","0","49.82","37.71"
"65","000","00","018","1803","2167","644","509","135","33","677","1330","0","50.9","38.27"
"65","000","00","018","1803","2168","635","513","122","38","673","1380","0","48.77","37.17"
"65","000","00","018","1804","0000","1002","806","196","44","1046","1946","0","53.75","41.42"
"65","000","00","018","1804","2174","358","288","70","23","381","782","0","48.72","36.83"
"65","000","00","018","1804","2175","644","518","126","21","665","1164","0","57.13","44.5"
"65","000","00","018","1805","0000","306","244","62","33","339","556","0","60.97","43.88"
"65","000","00","018","1805","2178","306","244","62","33","339","556","0","60.97","43.88"
"65","000","00","018","1806","0000","2877","2252","625","187","3064","5579","0","54.92","40.37"
"65","000","00","018","1806","2171","864","679","185","59","923","1624","0","56.83","41.81"
"65","000","00","018","1806","2172","1100","872","228","63","1163","2165","0","53.72","40.28"
"65","000","00","018","1806","2173","913","701","212","65","978","1790","0","54.64","39.16"
"65","000","00","018","1807","0000","1169","915","254","110","1279","2465","0","51.89","37.12"
"65","000","00","018","1807","2165","513","385","128","60","573","1065","0","53.8","36.15"
"65","000","00","018","1807","2166","656","530","126","50","706","1400","0","50.43","37.86"
"65","000","00","018","1808","0000","1163","919","244","92","1255","2083","0","60.25","44.12"
"65","000","00","018","1808","2176","735","579","156","65","800","1344","0","59.52","43.08"
"65","000","00","018","1808","2177","428","340","88","27","455","739","0","61.57","46.01"
"65","000","00","019","0000","0000","3077","2358","719","309","3386","6861","7727","49.35","34.37"
"65","000","00","019","1901","0000","218","158","60","23","241","391","0","61.64","40.41"
"65","000","00","019","1901","2179","218","158","60","23","241","391","0","61.64","40.41"
"65","000","00","019","1902","0000","357","272","85","41","398","789","0","50.44","34.47"
"65","000","00","019","1902","2180","357","272","85","41","398","789","0","50.44","34.47"
"65","000","00","019","1903","0000","261","205","56","48","309","683","0","45.24","30.01"
"65","000","00","019","1903","2185","261","205","56","48","309","683","0","45.24","30.01"
"65","000","00","019","1904","0000","251","191","60","25","276","662","0","41.69","28.85"
"65","000","00","019","1904","2181","251","191","60","25","276","662","0","41.69","28.85"
"65","000","00","019","1905","0000","142","107","35","12","154","310","0","49.68","34.52"
"65","000","00","019","1905","2182","142","107","35","12","154","310","0","49.68","34.52"
"65","000","00","019","1906","0000","168","131","37","18","186","373","0","49.87","35.12"
"65","000","00","019","1906","2183","135","106","29","13","148","280","0","52.86","37.86"
"65","000","00","019","1906","2184","33","25","8","5","38","93","0","40.86","26.88"
"65","000","00","019","1907","0000","280","203","77","35","315","591","0","53.3","34.35"
"65","000","00","019","1907","2188","280","203","77","35","315","591","0","53.3","34.35"
"65","000","00","019","1908","0000","249","191","58","7","256","726","0","35.26","26.31"
"65","000","00","019","1908","2187","249","191","58","7","256","726","0","35.26","26.31"
"65","000","00","019","1909","0000","167","128","39","22","189","282","0","67.02","45.39"
"65","000","00","019","1909","2189","167","128","39","22","189","282","0","67.02","45.39"
"65","000","00","019","1910","0000","191","158","33","11","202","323","0","62.54","48.92"
"65","000","00","019","1910","2186","191","158","33","11","202","323","0","62.54","48.92"
"65","000","00","019","1911","0000","299","237","62","12","311","788","0","39.47","30.08"
"65","000","00","019","1911","2190","299","237","62","12","311","788","0","39.47","30.08"
"65","000","00","019","1912","0000","494","377","117","55","549","943","0","58.22","39.98"
"65","000","00","019","1912","2191","494","377","117","55","549","943","0","58.22","39.98"
"65","000","00","020","0000","0000","2610","2075","535","311","2921","5891","6570","49.58","35.22"
"65","000","00","020","2001","0000","422","330","92","60","482","843","0","57.18","39.15"
"65","000","00","020","2001","2196","287","222","65","43","330","595","0","55.46","37.31"
"65","000","00","020","2001","2197","135","108","27","17","152","248","0","61.29","43.55"
"65","000","00","020","2002","0000","590","482","108","43","633","1248","0","50.72","38.62"
"65","000","00","020","2002","2192","590","482","108","43","633","1248","0","50.72","38.62"
"65","000","00","020","2003","0000","554","434","120","96","650","1141","0","56.97","38.04"
"65","000","00","020","2003","2194","554","434","120","96","650","1141","0","56.97","38.04"
"65","000","00","020","2004","0000","149","116","33","9","158","417","0","37.89","27.82"
"65","000","00","020","2004","2195","149","116","33","9","158","417","0","37.89","27.82"
"65","000","00","020","2005","0000","344","280","64","24","368","816","0","45.1","34.31"
"65","000","00","020","2005","2198","154","120","34","8","162","338","0","47.93","35.5"
"65","000","00","020","2005","2199","190","160","30","16","206","478","0","43.1","33.47"
"65","000","00","020","2006","0000","250","200","50","41","291","612","0","47.55","32.68"
"65","000","00","020","2006","2193","250","200","50","41","291","612","0","47.55","32.68"
"65","000","00","020","2007","0000","301","233","68","38","339","814","0","41.65","28.62"
"65","000","00","020","2007","2200","135","101","34","12","147","390","0","37.69","25.9"
"65","000","00","020","2007","2201","166","132","34","26","192","424","0","45.28","31.13"
"65","000","00","021","0000","0000","8926","6999","1927","704","9630","20119","23010","47.87","34.79"
"65","000","00","021","2101","0000","138","109","29","10","148","312","0","47.44","34.94"
"65","000","00","021","2101","0011","138","109","29","10","148","312","0","47.44","34.94"
"65","000","00","021","2102","0000","2242","1806","436","154","2396","4806","0","49.85","37.58"
"65","000","00","021","2102","0012","636","525","111","37","673","1421","0","47.36","36.95"
"65","000","00","021","2102","0013","743","587","156","58","801","1557","0","51.45","37.7"
"65","000","00","021","2102","0014","863","694","169","59","922","1828","0","50.44","37.96"
"65","000","00","021","2103","0000","496","383","113","44","540","1060","0","50.94","36.13"
"65","000","00","021","2103","0015","496","383","113","44","540","1060","0","50.94","36.13"
"65","000","00","021","2104","0000","321","252","69","35","356","819","0","43.47","30.77"
"65","000","00","021","2104","0016","321","252","69","35","356","819","0","43.47","30.77"
"65","000","00","021","2105","0000","2583","2022","561","215","2798","6140","0","45.57","32.93"
"65","000","00","021","2105","0017","679","535","144","37","716","1701","0","42.09","31.45"
"65","000","00","021","2105","0018","761","596","165","76","837","1740","0","48.1","34.25"
"65","000","00","021","2105","0019","621","480","141","49","670","1451","0","46.18","33.08"
"65","000","00","021","2105","0020","522","411","111","53","575","1248","0","46.07","32.93"
"65","000","00","021","2106","0000","303","232","71","13","316","629","0","50.24","36.88"
"65","000","00","021","2106","0021","303","232","71","13","316","629","0","50.24","36.88"
"65","000","00","021","2107","0000","212","177","35","21","233","504","0","46.23","35.12"
"65","000","00","021","2107","0022","212","177","35","21","233","504","0","46.23","35.12"
"65","000","00","021","2108","0000","291","225","66","17","308","698","0","44.13","32.23"
"65","000","00","021","2108","0023","291","225","66","17","308","698","0","44.13","32.23"
"65","000","00","021","2109","0000","902","726","176","51","953","2069","0","46.06","35.09"
"65","000","00","021","2109","0024","902","726","176","51","953","2069","0","46.06","35.09"
"65","000","00","021","2110","0000","380","297","83","34","414","784","0","52.81","37.88"
"65","000","00","021","2110","0025","380","297","83","34","414","784","0","52.81","37.88"
"65","000","00","021","2111","0000","240","170","70","23","263","522","0","50.38","32.57"
"65","000","00","021","2111","0026","240","170","70","23","263","522","0","50.38","32.57"
"65","000","00","021","2112","0000","258","192","66","47","305","587","0","51.96","32.71"
"65","000","00","021","2112","0027","258","192","66","47","305","587","0","51.96","32.71"
"65","000","00","021","2113","0000","560","408","152","40","600","1189","0","50.46","34.31"
"65","000","00","021","2113","0028","560","408","152","40","600","1189","0","50.46","34.31"
"65","000","00","022","0000","0000","4917","3899","1018","509","5426","10528","12158","51.54","37.03"
"65","000","00","022","2201","0000","528","402","126","51","579","1121","0","51.65","35.86"
"65","000","00","022","2201","0001","528","402","126","51","579","1121","0","51.65","35.86"
"65","000","00","022","2202","0000","601","471","130","70","671","1389","0","48.31","33.91"
"65","000","00","022","2202","0002","601","471","130","70","671","1389","0","48.31","33.91"
"65","000","00","022","2203","0000","993","803","190","116","1109","2177","0","50.94","36.89"
"65","000","00","022","2203","0003","436","353","83","55","491","933","0","52.63","37.83"
"65","000","00","022","2203","0004","557","450","107","61","618","1244","0","49.68","36.17"
"65","000","00","022","2204","0000","428","342","86","56","484","883","0","54.81","38.73"
"65","000","00","022","2204","0005","428","342","86","56","484","883","0","54.81","38.73"
"65","000","00","022","2205","0000","767","612","155","56","823","1564","0","52.62","39.13"
"65","000","00","022","2205","0006","767","612","155","56","823","1564","0","52.62","39.13"
"65","000","00","022","2206","0000","731","574","157","64","795","1500","0","53.0","38.27"
"65","000","00","022","2206","0007","731","574","157","64","795","1500","0","53.0","38.27"
"65","000","00","022","2207","0000","137","115","22","14","151","328","0","46.04","35.06"
"65","000","00","022","2207","0008","137","115","22","14","151","328","0","46.04","35.06"
"65","000","00","022","2208","0000","359","289","70","44","403","651","0","61.9","44.39"
"65","000","00","022","2208","0009","359","289","70","44","403","651","0","61.9","44.39"
"65","000","00","022","2209","0000","373","291","82","38","411","915","0","44.92","31.8"
"65","000","00","022","2209","0010","373","291","82","38","411","915","0","44.92","31.8"
"65","000","00","023","0000","0000","16177","12684","3493","1263","17440","32970","38861","52.9","38.47"
"65","000","00","023","2301","0000","3151","2471","680","236","3387","6595","0","51.36","37.47"
"65","000","00","023","2301","0125","680","530","150","63","743","1498","0","49.6","35.38"
"65","000","00","023","2301","0126","853","683","170","38","891","1939","0","45.95","35.22"
"65","000","00","023","2301","0127","738","564","174","70","808","1516","0","53.3","37.2"
"65","000","00","023","2301","0128","880","694","186","65","945","1642","0","57.55","42.27"
"65","000","00","023","2302","0000","1496","1186","310","135","1631","3203","0","50.92","37.03"
"65","000","00","023","2302","0129","853","667","186","87","940","1927","0","48.78","34.61"
"65","000","00","023","2302","0130","643","519","124","48","691","1276","0","54.15","40.67"
"65","000","00","023","2303","0000","1463","1161","302","108","1571","2752","0","57.09","42.19"
"65","000","00","023","2303","0131","741","585","156","44","785","1349","0","58.19","43.37"
"65","000","00","023","2303","0132","722","576","146","64","786","1403","0","56.02","41.05"
"65","000","00","023","2304","0000","1746","1363","383","122","1868","3497","0","53.42","38.98"
"65","000","00","023","2304","0133","828","638","190","59","887","1644","0","53.95","38.81"
"65","000","00","023","2304","0134","918","725","193","63","981","1853","0","52.94","39.13"
"65","000","00","023","2305","0000","957","763","194","88","1045","1793","0","58.28","42.55"
"65","000","00","023","2305","0135","957","763","194","88","1045","1793","0","58.28","42.55"
"65","000","00","023","2306","0000","3212","2491","721","225","3437","6457","0","53.23","38.58"
"65","000","00","023","2306","0136","835","638","197","49","884","1644","0","53.77","38.81"
"65","000","00","023","2306","0137","900","716","184","64","964","1846","0","52.22","38.79"
"65","000","00","023","2306","0138","659","511","148","58","717","1346","0","53.27","37.96"
"65","000","00","023","2306","0139","818","626","192","54","872","1621","0","53.79","38.62"
"65","000","00","023","2307","0000","1784","1406","378","157","1941","4077","0","47.61","34.49"
"65","000","00","023","2307","0140","873","693","180","68","941","2110","0","44.6","32.84"
"65","000","00","023","2307","0141","911","713","198","89","1000","1967","0","50.84","36.25"
"65","000","00","023","2308","0000","848","664","184","49","897","1626","0","55.17","40.84"
"65","000","00","023","2308","0142","848","664","184","49","897","1626","0","55.17","40.84"
"65","000","00","023","2309","0000","770","601","169","61","831","1514","0","54.89","39.7"
"65","000","00","023","2309","0143","770","601","169","61","831","1514","0","54.89","39.7"
"65","000","00","023","2310","0000","750","578","172","82","832","1456","0","57.14","39.7"
"65","000","00","023","2310","0144","750","578","172","82","832","1456","0","57.14","39.7"
"65","000","00","024","0000","0000","1840","1428","412","190","2030","4321","4687","46.98","33.05"
"65","000","00","024","2401","0000","178","133","45","9","187","384","0","48.7","34.64"
"65","000","00","024","2401","2208","178","133","45","9","187","384","0","48.7","34.64"
"65","000","00","024","2402","0000","93","77","16","3","96","232","0","41.38","33.19"
"65","000","00","024","2402","2209","93","77","16","3","96","232","0","41.38","33.19"
"65","000","00","024","2403","0000","127","96","31","13","140","249","0","56.22","38.55"
"65","000","00","024","2403","2210","127","96","31","13","140","249","0","56.22","38.55"
"65","000","00","024","2404","0000","223","171","52","30","253","458","0","55.24","37.34"
"65","000","00","024","2404","2211","223","171","52","30","253","458","0","55.24","37.34"
"65","000","00","024","2405","0000","113","83","30","16","129","232","0","55.6","35.78"
"65","000","00","024","2405","2212","113","83","30","16","129","232","0","55.6","35.78"
"65","000","00","024","2406","0000","243","193","50","16","259","635","0","40.79","30.39"
"65","000","00","024","2406","2213","243","193","50","16","259","635","0","40.79","30.39"
"65","000","00","024","2407","0000","212","165","47","25","237","427","0","55.5","38.64"
"65","000","00","024","2407","2214","212","165","47","25","237","427","0","55.5","38.64"
"65","000","00","024","2408","0000","69","53","16","4","73","147","0","49.66","36.05"
"65","000","00","024","2408","2216","69","53","16","4","73","147","0","49.66","36.05"
"65","000","00","024","2409","0000","122","98","24","13","135","365","0","36.99","26.85"
"65","000","00","024","2409","2217","122","98","24","13","135","365","0","36.99","26.85"
"65","000","00","024","2410","0000","93","71","22","16","109","177","0","61.58","40.11"
"65","000","00","024","2410","2219","93","71","22","16","109","177","0","61.58","40.11"
"65","000","00","024","2411","0000","305","241","64","37","342","862","0","39.68","27.96"
"65","000","00","024","2411","2215","305","241","64","37","342","862","0","39.68","27.96"
"65","000","00","024","2412","0000","62","47","15","8","70","153","0","45.75","30.72"
"65","000","00","024","2412","2218","62","47","15","8","70","153","0","45.75","30.72"
"65","000","00","025","0000","0000","3476","2739","737","373","3849","7999","8872","48.12","34.24"
"65","000","00","025","2501","0000","192","162","30","22","214","455","0","47.03","35.6"
"65","000","00","025","2501","2266","192","162","30","22","214","455","0","47.03","35.6"
"65","000","00","025","2502","0000","176","148","28","23","199","391","0","50.9","37.85"
"65","000","00","025","2502","2278","56","48","8","9","65","120","0","54.17","40.0"
"65","000","00","025","2502","2279","120","100","20","14","134","271","0","49.45","36.9"
"65","000","00","025","2503","0000","388","317","71","36","424","782","0","54.22","40.54"
"65","000","00","025","2503","2267","136","113","23","12","148","286","0","51.75","39.51"
"65","000","00","025","2503","2268","252","204","48","24","276","496","0","55.65","41.13"
"65","000","00","025","2504","0000","352","277","75","53","405","733","0","55.25","37.79"
"65","000","00","025","2504","2280","187","147","40","25","212","362","0","58.56","40.61"
"65","000","00","025","2504","2281","165","130","35","28","193","371","0","52.02","35.04"
"65","000","00","025","2505","0000","149","121","28","11","160","383","0","41.78","31.59"
"65","000","00","025","2505","2269","149","121","28","11","160","383","0","41.78","31.59"
"65","000","00","025","2506","0000","578","448","130","75","653","1539","0","42.43","29.11"
"65","000","00","025","2506","2270","337","255","82","40","377","887","0","42.5","28.75"
"65","000","00","025","2506","2271","241","193","48","35","276","652","0","42.33","29.6"
"65","000","00","025","2507","0000","154","124","30","13","167","333","0","50.15","37.24"
"65","000","00","025","2507","2272","154","124","30","13","167","333","0","50.15","37.24"
"65","000","00","025","2508","0000","413","317","96","38","451","924","0","48.81","34.31"
"65","000","00","025","2508","2273","289","227","62","27","316","642","0","49.22","35.36"
"65","000","00","025","2508","2274","124","90","34","11","135","282","0","47.87","31.91"
"65","000","00","025","2509","0000","247","182","65","21","268","621","0","43.16","29.31"
"65","000","00","025","2509","2275","247","182","65","21","268","621","0","43.16","29.31"
"65","000","00","025","2510","0000","156","128","28","10","166","422","0","39.34","30.33"
"65","000","00","025","2510","2276","156","128","28","10","166","422","0","39.34","30.33"
"65","000","00","025","2511","0000","114","82","32","20","134","369","0","36.31","22.22"
"65","000","00","025","2511","2277","114","82","32","20","134","369","0","36.31","22.22"
"65","000","00","025","2512","0000","557","433","124","51","608","1047","0","58.07","41.36"
"65","000","00","025","2512","2282","557","433","124","51","608","1047","0","58.07","41.36"
"65","000","00","026","0000","0000","4384","3309","1075","423","4807","11279","12364","42.62","29.34"
"65","000","00","026","2601","0000","392","310","82","43","435","876","0","49.66","35.39"
"65","000","00","026","2601","2283","392","310","82","43","435","876","0","49.66","35.39"
"65","000","00","026","2602","0000","183","147","36","15","198","516","0","38.37","28.49"
"65","000","00","026","2602","2285","183","147","36","15","198","516","0","38.37","28.49"
"65","000","00","026","2603","0000","260","193","67","38","298","686","0","43.44","28.13"
"65","000","00","026","2603","2286","129","100","29","20","149","373","0","39.95","26.81"
"65","000","00","026","2603","2287","131","93","38","18","149","313","0","47.6","29.71"
"65","000","00","026","2604","0000","195","147","48","22","217","433","0","50.12","33.95"
"65","000","00","026","2604","2284","195","147","48","22","217","433","0","50.12","33.95"
"65","000","00","026","2605","0000","231","173","58","31","262","676","0","38.76","25.59"
"65","000","00","026","2605","2292","231","173","58","31","262","676","0","38.76","25.59"
"65","000","00","026","2606","0000","687","517","170","47","734","1673","0","43.87","30.9"
"65","000","00","026","2606","2290","308","240","68","14","322","812","0","39.66","29.56"
"65","000","00","026","2606","2291","379","277","102","33","412","861","0","47.85","32.17"
"65","000","00","026","2607","0000","692","524","168","52","744","1731","0","42.98","30.27"
"65","000","00","026","2607","2295","269","219","50","11","280","769","0","36.41","28.48"
"65","000","00","026","2607","2296","423","305","118","41","464","962","0","48.23","31.7"
"65","000","00","026","2608","0000","696","512","184","78","774","2046","0","37.83","25.02"
"65","000","00","026","2608","2293","358","265","93","29","387","1091","0","35.47","24.29"
"65","000","00","026","2608","2294","338","247","91","49","387","955","0","40.52","25.86"
"65","000","00","026","2609","0000","402","298","104","43","445","900","0","49.44","33.11"
"65","000","00","026","2609","2288","223","179","44","11","234","485","0","48.25","36.91"
"65","000","00","026","2609","2289","179","119","60","32","211","415","0","50.84","28.67"
"65","000","00","026","2610","0000","328","253","75","14","342","739","0","46.28","34.24"
"65","000","00","026","2610","2297","182","143","39","12","194","390","0","49.74","36.67"
"65","000","00","026","2610","2298","146","110","36","2","148","349","0","42.41","31.52"
"65","000","00","026","2611","0000","318","235","83","40","358","1003","0","35.69","23.43"
"65","000","00","026","2611","2299","170","125","45","27","197","508","0","38.78","24.61"
"65","000","00","026","2611","2300","148","110","38","13","161","495","0","32.53","22.22"
"65","000","00","027","0000","0000","8713","6853","1860","843","9556","18978","21821","50.35","36.11"
"65","000","00","027","2701","0000","233","194","39","29","262","481","0","54.47","40.33"
"65","000","00","027","2701","2301","233","194","39","29","262","481","0","54.47","40.33"
"65","000","00","027","2702","0000","348","267","81","31","379","715","0","53.01","37.34"
"65","000","00","027","2702","2302","348","267","81","31","379","715","0","53.01","37.34"
"65","000","00","027","2703","0000","189","147","42","25","214","481","0","44.49","30.56"
"65","000","00","027","2703","2303","189","147","42","25","214","481","0","44.49","30.56"
"65","000","00","027","2704","0000","739","601","138","87","826","1792","0","46.09","33.54"
"65","000","00","027","2704","2304","739","601","138","87","826","1792","0","46.09","33.54"
"65","000","00","027","2705","0000","1848","1444","404","127","1975","3791","0","52.1","38.09"
"65","000","00","027","2705","2305","837","627","210","72","909","1781","0","51.04","35.2"
"65","000","00","027","2705","2306","1011","817","194","55","1066","2010","0","53.03","40.65"
"65","000","00","027","2706","0000","820","645","175","64","884","1716","0","51.52","37.59"
"65","000","00","027","2706","2310","400","318","82","35","435","828","0","52.54","38.41"
"65","000","00","027","2706","2311","420","327","93","29","449","888","0","50.56","36.82"
"65","000","00","027","2707","0000","538","405","133","69","607","1211","0","50.12","33.44"
"65","000","00","027","2707","2312","538","405","133","69","607","1211","0","50.12","33.44"
"65","000","00","027","2708","0000","223","173","50","16","239","416","0","57.45","41.59"
"65","000","00","027","2708","2313","223","173","50","16","239","416","0","57.45","41.59"
"65","000","00","027","2709","0000","355","277","78","43","398","682","0","58.36","40.62"
"65","000","00","027","2709","2314","355","277","78","43","398","682","0","58.36","40.62"
"65","000","00","027","2710","0000","300","238","62","48","348","644","0","54.04","36.96"
"65","000","00","027","2710","2315","300","238","62","48","348","644","0","54.04","36.96"
"65","000","00","027","2711","0000","367","289","78","42","409","830","0","49.28","34.82"
"65","000","00","027","2711","2316","367","289","78","42","409","830","0","49.28","34.82"
"65","000","00","027","2712","0000","229","159","70","30","259","469","0","55.22","33.9"
"65","000","00","027","2712","2318","229","159","70","30","259","469","0","55.22","33.9"
"65","000","00","027","2713","0000","88","65","23","11","99","188","0","52.66","34.57"
"65","000","00","027","2713","2317","88","65","23","11","99","188","0","52.66","34.57"
"65","000","00","027","2714","0000","185","143","42","28","213","582","0","36.6","24.57"
"65","000","00","027","2714","2319","185","143","42","28","213","582","0","36.6","24.57"
"65","000","00","027","2715","0000","2251","1806","445","193","2444","4980","0","49.08","36.27"
"65","000","00","027","2715","2307","708","563","145","55","763","1572","0","48.54","35.81"
"65","000","00","027","2715","2308","836","673","163","71","907","1777","0","51.04","37.87"
"65","000","00","027","2715","2309","707","570","137","67","774","1631","0","47.46","34.95"
"65","000","00","028","0000","0000","8694","6883","1811","854","9548","19297","22102","49.48","35.67"
"65","000","00","028","2801","0000","2091","1666","425","156","2247","4309","0","52.15","38.66"
"65","000","00","028","2801","2320","649","528","121","46","695","1286","0","54.04","41.06"
"65","000","00","028","2801","2321","795","618","177","64","859","1576","0","54.51","39.21"
"65","000","00","028","2801","2322","647","520","127","46","693","1447","0","47.89","35.94"
"65","000","00","028","2802","0000","1052","845","207","112","1164","2532","0","45.97","33.37"
"65","000","00","028","2802","2325","420","342","78","55","475","1215","0","39.09","28.15"
"65","000","00","028","2802","2326","632","503","129","57","689","1317","0","52.32","38.19"
"65","000","00","028","2803","0000","1310","1053","257","148","1458","3226","0","45.2","32.64"
"65","000","00","028","2803","2327","650","528","122","69","719","1676","0","42.9","31.5"
"65","000","00","028","2803","2328","660","525","135","79","739","1550","0","47.68","33.87"
"65","000","00","028","2804","0000","1416","1119","297","126","1542","2705","0","57.01","41.37"
"65","000","00","028","2804","2329","533","422","111","51","584","945","0","61.8","44.66"
"65","000","00","028","2804","2330","883","697","186","75","958","1760","0","54.43","39.6"
"65","000","00","028","2805","0000","268","221","47","20","288","570","0","50.53","38.77"
"65","000","00","028","2805","2331","268","221","47","20","288","570","0","50.53","38.77"
"65","000","00","028","2806","0000","417","307","110","27","444","952","0","46.64","32.25"
"65","000","00","028","2806","2332","417","307","110","27","444","952","0","46.64","32.25"
"65","000","00","028","2807","0000","343","263","80","52","395","674","0","58.61","39.02"
"65","000","00","028","2807","2333","343","263","80","52","395","674","0","58.61","39.02"
"65","000","00","028","2808","0000","185","151","34","23","208","405","0","51.36","37.28"
"65","000","00","028","2808","2334","185","151","34","23","208","405","0","51.36","37.28"
"65","000","00","028","2809","0000","491","378","113","56","547","1089","0","50.23","34.71"
"65","000","00","028","2809","2335","491","378","113","56","547","1089","0","50.23","34.71"
"65","000","00","028","2810","0000","1121","880","241","134","1255","2835","0","44.27","31.04"
"65","000","00","028","2810","2323","595","474","121","74","669","1466","0","45.63","32.33"
"65","000","00","028","2810","2324","526","406","120","60","586","1369","0","42.8","29.66"
"65","000","00","029","0000","0000","2542","2072","470","161","2703","5264","6383","51.35","39.36"
"65","000","00","029","2901","0000","1081","881","200","46","1127","2367","0","47.61","37.22"
"65","000","00","029","2901","2203","560","452","108","21","581","1198","0","48.5","37.73"
"65","000","00","029","2901","2204","521","429","92","25","546","1169","0","46.71","36.7"
"65","000","00","029","2902","0000","869","701","168","57","926","1568","0","59.06","44.71"
"65","000","00","029","2902","2202","869","701","168","57","926","1568","0","59.06","44.71"
"65","000","00","029","2903","0000","251","211","40","22","273","615","0","44.39","34.31"
"65","000","00","029","2903","2207","251","211","40","22","273","615","0","44.39","34.31"
"65","000","00","029","2904","0000","229","189","40","34","263","486","0","54.12","38.89"
"65","000","00","029","2904","2206","229","189","40","34","263","486","0","54.12","38.89"
"65","000","00","029","2905","0000","112","90","22","2","114","228","0","50.0","39.47"
"65","000","00","029","2905","2205","112","90","22","2","114","228","0","50.0","39.47"
"68","000","00","000","0000","0000","870861","697528","173333","48893","919754","1801823","2215615","51.05","38.71"
"68","000","00","001","0000","0000","171837","135663","36174","9359","181196","359790","446246","50.36","37.71"
"68","000","00","001","0101","0000","346","269","77","15","361","690","0","52.32","38.99"
"68","000","00","001","0101","0032","346","269","77","15","361","690","0","52.32","38.99"
"68","000","00","001","0102","0000","723","548","175","54","777","1353","0","57.43","40.5"
"68","000","00","001","0102","0034","723","548","175","54","777","1353","0","57.43","40.5"
"68","000","00","001","0103","0000","680","497","183","46","726","1582","0","45.89","31.42"
"68","000","00","001","0103","0043","680","497","183","46","726","1582","0","45.89","31.42"
"68","000","00","001","0104","0000","3105","2420","685","158","3263","6636","0","49.17","36.47"
"68","000","00","001","0104","0001","753","578","175","51","804","1593","0","50.47","36.28"
"68","000","00","001","0104","0002","818","621","197","33","851","1934","0","44.0","32.11"
"68","000","00","001","0104","0003","861","688","173","53","914","1661","0","55.03","41.42"
"68","000","00","001","0104","0004","673","533","140","21","694","1448","0","47.93","36.81"
"68","000","00","001","0105","0000","1488","1175","313","58","1546","3483","0","44.39","33.74"
"68","000","00","001","0105","0190","817","660","157","33","850","1790","0","47.49","36.87"
"68","000","00","001","0105","0191","671","515","156","25","696","1693","0","41.11","30.42"
"68","000","00","001","0106","0000","4107","3318","789","170","4277","9063","0","47.19","36.61"
"68","000","00","001","0106","0204","855","690","165","41","896","1796","0","49.89","38.42"
"68","000","00","001","0106","0205","907","750","157","29","936","1878","0","49.84","39.94"
"68","000","00","001","0106","0206","805","629","176","40","845","1729","0","48.87","36.38"
"68","000","00","001","0106","0207","792","641","151","26","818","1843","0","44.38","34.78"
"68","000","00","001","0106","0208","748","608","140","34","782","1817","0","43.04","33.46"
"68","000","00","001","0107","0000","540","389","151","44","584","1028","0","56.81","37.84"
"68","000","00","001","0107","0044","540","389","151","44","584","1028","0","56.81","37.84"
"68","000","00","001","0108","0000","681","516","165","59","740","1452","0","50.96","35.54"
"68","000","00","001","0108","0036","681","516","165","59","740","1452","0","50.96","35.54"
"68","000","00","001","0109","0000","812","606","206","58","870","1681","0","51.75","36.05"
"68","000","00","001","0109","0037","812","606","206","58","870","1681","0","51.75","36.05"
"68","000","00","001","0110","0000","2438","1913","525","131","2569","5078","0","50.59","37.67"
"68","000","00","001","0110","0187","778","587","191","48","826","1764","0","46.83","33.28"
"68","000","00","001","0110","0188","969","772","197","62","1031","1899","0","54.29","40.65"
"68","000","00","001","0110","0189","691","554","137","21","712","1415","0","50.32","39.15"
"68","000","00","001","0111","0000","2193","1693","500","171","2364","4509","0","52.43","37.55"
"68","000","00","001","0111","0113","618","481","137","62","680","1308","0","51.99","36.77"
"68","000","00","001","0111","0114","749","592","157","55","804","1583","0","50.79","37.4"
"68","000","00","001","0111","0115","826","620","206","54","880","1618","0","54.39","38.32"
"68","000","00","001","0112","0000","2046","1580","466","133","2179","4668","0","46.68","33.85"
"68","000","00","001","0112","0131","754","572","182","58","812","1689","0","48.08","33.87"
"68","000","00","001","0112","0132","625","479","146","33","658","1542","0","42.67","31.06"
"68","000","00","001","0112","0133","667","529","138","42","709","1437","0","49.34","36.81"
"68","000","00","001","0113","0000","1432","1099","333","75","1507","2928","0","51.47","37.53"
"68","000","00","001","0113","0193","628","483","145","31","659","1434","0","45.96","33.68"
"68","000","00","001","0113","0194","804","616","188","44","848","1494","0","56.76","41.23"
"68","000","00","001","0114","0000","872","684","188","55","927","1916","0","48.38","35.7"
"68","000","00","001","0114","0192","872","684","188","55","927","1916","0","48.38","35.7"
"68","000","00","001","0115","0000","516","387","129","35","551","979","0","56.28","39.53"
"68","000","00","001","0115","0209","516","387","129","35","551","979","0","56.28","39.53"
"68","000","00","001","0116","0000","1597","1240","357","101","1698","3565","0","47.63","34.78"
"68","000","00","001","0116","0134","784","617","167","38","822","1679","0","48.96","36.75"
"68","000","00","001","0116","0135","813","623","190","63","876","1886","0","46.45","33.03"
"68","000","00","001","0117","0000","1235","983","252","75","1310","2210","0","59.28","44.48"
"68","000","00","001","0117","0105","653","525","128","37","690","1149","0","60.05","45.69"
"68","000","00","001","0117","0106","582","458","124","38","620","1061","0","58.44","43.17"
"68","000","00","001","0118","0000","1445","1160","285","88","1533","3058","0","50.13","37.93"
"68","000","00","001","0118","0127","911","749","162","45","956","1995","0","47.92","37.54"
"68","000","00","001","0118","0128","534","411","123","43","577","1063","0","54.28","38.66"
"68","000","00","001","0119","0000","717","580","137","45","762","1587","0","48.02","36.55"
"68","000","00","001","0119","0041","717","580","137","45","762","1587","0","48.02","36.55"
"68","000","00","001","0120","0000","719","535","184","72","791","1375","0","57.53","38.91"
"68","000","00","001","0120","0028","719","535","184","72","791","1375","0","57.53","38.91"
"68","000","00","001","0121","0000","479","368","111","36","515","852","0","60.45","43.19"
"68","000","00","001","0121","0033","479","368","111","36","515","852","0","60.45","43.19"
"68","000","00","001","0122","0000","4505","3594","911","229","4734","9234","0","51.27","38.92"
"68","000","00","001","0122","0155","864","699","165","45","909","1807","0","50.3","38.68"
"68","000","00","001","0122","0156","902","727","175","44","946","1857","0","50.94","39.15"
"68","000","00","001","0122","0157","832","658","174","59","891","1589","0","56.07","41.41"
"68","000","00","001","0122","0158","996","772","224","44","1040","2088","0","49.81","36.97"
"68","000","00","001","0122","0159","911","738","173","37","948","1893","0","50.08","38.99"
"68","000","00","001","0123","0000","3324","2554","770","120","3444","6570","0","52.42","38.87"
"68","000","00","001","0123","0050","753","515","238","38","791","1489","0","53.12","34.59"
"68","000","00","001","0123","0051","982","756","226","27","1009","1821","0","55.41","41.52"
"68","000","00","001","0123","0052","705","568","137","24","729","1563","0","46.64","36.34"
"68","000","00","001","0123","0053","884","715","169","31","915","1697","0","53.92","42.13"
"68","000","00","001","0124","0000","2857","2258","599","174","3031","6075","0","49.89","37.17"
"68","000","00","001","0124","0151","681","531","150","50","731","1569","0","46.59","33.84"
"68","000","00","001","0124","0152","707","558","149","36","743","1505","0","49.37","37.08"
"68","000","00","001","0124","0153","707","547","160","48","755","1496","0","50.47","36.56"
"68","000","00","001","0124","0154","762","622","140","40","802","1505","0","53.29","41.33"
"68","000","00","001","0125","0000","747","551","196","59","806","1451","0","55.55","37.97"
"68","000","00","001","0125","0042","747","551","196","59","806","1451","0","55.55","37.97"
"68","000","00","001","0126","0000","2769","2109","660","198","2967","5866","0","50.58","35.95"
"68","000","00","001","0126","0045","880","719","161","86","966","1934","0","49.95","37.18"
"68","000","00","001","0126","0046","505","301","204","46","551","1016","0","54.23","29.63"
"68","000","00","001","0126","0047","547","425","122","33","580","1079","0","53.75","39.39"
"68","000","00","001","0126","0048","837","664","173","33","870","1837","0","47.36","36.15"
"68","000","00","001","0127","0000","698","525","173","58","756","1390","0","54.39","37.77"
"68","000","00","001","0127","0049","698","525","173","58","756","1390","0","54.39","37.77"
"68","000","00","001","0128","0000","2411","1812","599","187","2598","4944","0","52.55","36.65"
"68","000","00","001","0128","0081","761","554","207","67","828","1449","0","57.14","38.23"
"68","000","00","001","0128","0082","799","610","189","73","872","1803","0","48.36","33.83"
"68","000","00","001","0128","0083","851","648","203","47","898","1692","0","53.07","38.3"
"68","000","00","001","0129","0000","2303","1778","525","115","2418","4421","0","54.69","40.22"
"68","000","00","001","0129","0060","632","505","127","33","665","1115","0","59.64","45.29"
"68","000","00","001","0129","0061","820","594","226","39","859","1562","0","54.99","38.03"
"68","000","00","001","0129","0062","851","679","172","43","894","1744","0","51.26","38.93"
"68","000","00","001","0130","0000","2598","2035","563","131","2729","5152","0","52.97","39.5"
"68","000","00","001","0130","0057","897","720","177","42","939","1766","0","53.17","40.77"
"68","000","00","001","0130","0058","785","606","179","48","833","1555","0","53.57","38.97"
"68","000","00","001","0130","0059","916","709","207","41","957","1831","0","52.27","38.72"
"68","000","00","001","0131","0000","598","479","119","32","630","1698","0","37.1","28.21"
"68","000","00","001","0131","0035","598","479","119","32","630","1698","0","37.1","28.21"
"68","000","00","001","0132","0000","3050","2406","644","183","3233","5981","0","54.05","40.23"
"68","000","00","001","0132","0013","733","550","183","41","774","1482","0","52.23","37.11"
"68","000","00","001","0132","0014","719","567","152","58","777","1423","0","54.6","39.85"
"68","000","00","001","0132","0015","782","615","167","51","833","1509","0","55.2","40.76"
"68","000","00","001","0132","0016","816","674","142","33","849","1567","0","54.18","43.01"
"68","000","00","001","0133","0000","2909","2273","636","172","3081","5805","0","53.07","39.16"
"68","000","00","001","0133","0020","732","536","196","49","781","1399","0","55.83","38.31"
"68","000","00","001","0133","0021","815","637","178","45","860","1540","0","55.84","41.36"
"68","000","00","001","0133","0022","762","627","135","39","801","1638","0","48.9","38.28"
"68","000","00","001","0133","0023","600","473","127","39","639","1228","0","52.04","38.52"
"68","000","00","001","0134","0000","2408","1817","591","163","2571","4781","0","53.78","38.0"
"68","000","00","001","0134","0038","793","590","203","61","854","1669","0","51.17","35.35"
"68","000","00","001","0134","0039","810","616","194","54","864","1530","0","56.47","40.26"
"68","000","00","001","0134","0040","805","611","194","48","853","1582","0","53.92","38.62"
"68","000","00","001","0135","0000","1572","1258","314","121","1693","3529","0","47.97","35.65"
"68","000","00","001","0135","0086","544","417","127","42","586","1173","0","49.96","35.55"
"68","000","00","001","0135","0087","532","449","83","22","554","1162","0","47.68","38.64"
"68","000","00","001","0135","0088","496","392","104","57","553","1194","0","46.31","32.83"
"68","000","00","001","0136","0000","2617","2094","523","127","2744","5705","0","48.1","36.7"
"68","000","00","001","0136","0092","831","663","168","67","898","1780","0","50.45","37.25"
"68","000","00","001","0136","0093","837","668","169","34","871","1904","0","45.75","35.08"
"68","000","00","001","0136","0094","949","763","186","26","975","2021","0","48.24","37.75"
"68","000","00","001","0137","0000","1829","1397","432","79","1908","3870","0","49.3","36.1"
"68","000","00","001","0137","0185","924","718","206","37","961","1925","0","49.92","37.3"
"68","000","00","001","0137","0186","905","679","226","42","947","1945","0","48.69","34.91"
"68","000","00","001","0138","0000","2175","1645","530","143","2318","4271","0","54.27","38.52"
"68","000","00","001","0138","0195","665","510","155","54","719","1311","0","54.84","38.9"
"68","000","00","001","0138","0196","729","542","187","42","771","1476","0","52.24","36.72"
"68","000","00","001","0138","0197","781","593","188","47","828","1484","0","55.8","39.96"
"68","000","00","001","0139","0000","1003","788","215","66","1069","1970","0","54.26","40.0"
"68","000","00","001","0139","0202","529","405","124","40","569","1015","0","56.06","39.9"
"68","000","00","001","0139","0203","474","383","91","26","500","955","0","52.36","40.1"
"68","000","00","001","0140","0000","2581","1976","605","168","2749","5333","0","51.55","37.05"
"68","000","00","001","0140","0029","888","666","222","50","938","1743","0","53.82","38.21"
"68","000","00","001","0140","0030","844","644","200","65","909","1862","0","48.82","34.59"
"68","000","00","001","0140","0031","849","666","183","53","902","1728","0","52.2","38.54"
"68","000","00","001","0141","0000","2989","2356","633","196","3185","6230","0","51.12","37.82"
"68","000","00","001","0141","0024","770","621","149","57","827","1649","0","50.15","37.66"
"68","000","00","001","0141","0025","796","617","179","37","833","1601","0","52.03","38.54"
"68","000","00","001","0141","0026","678","529","149","67","745","1477","0","50.44","35.82"
"68","000","00","001","0141","0027","745","589","156","35","780","1503","0","51.9","39.19"
"68","000","00","001","0142","0000","2355","1806","549","172","2527","5170","0","48.88","34.93"
"68","000","00","001","0142","0010","714","555","159","50","764","1590","0","48.05","34.91"
"68","000","00","001","0142","0011","769","586","183","62","831","1637","0","50.76","35.8"
"68","000","00","001","0142","0012","872","665","207","60","932","1943","0","47.97","34.23"
"68","000","00","001","0143","0000","2361","1832","529","160","2521","5024","0","50.18","36.46"
"68","000","00","001","0143","0007","827","636","191","53","880","1800","0","48.89","35.33"
"68","000","00","001","0143","0008","825","650","175","46","871","1598","0","54.51","40.68"
"68","000","00","001","0143","0009","709","546","163","61","770","1626","0","47.36","33.58"
"68","000","00","001","0144","0000","2081","1656","425","117","2198","4160","0","52.84","39.81"
"68","000","00","001","0144","0017","663","536","127","45","708","1305","0","54.25","41.07"
"68","000","00","001","0144","0018","643","513","130","36","679","1416","0","47.95","36.23"
"68","000","00","001","0144","0019","775","607","168","36","811","1439","0","56.36","42.18"
"68","000","00","001","0145","0000","2262","1875","387","96","2358","4197","0","56.18","44.67"
"68","000","00","001","0145","0173","823","718","105","23","846","1432","0","59.08","50.14"
"68","000","00","001","0145","0174","774","637","137","47","821","1421","0","57.78","44.83"
"68","000","00","001","0145","0175","665","520","145","26","691","1344","0","51.41","38.69"
"68","000","00","001","0146","0000","2383","1866","517","129","2512","5384","0","46.66","34.66"
"68","000","00","001","0146","0182","745","587","158","32","777","1860","0","41.77","31.56"
"68","000","00","001","0146","0183","809","639","170","58","867","1726","0","50.23","37.02"
"68","000","00","001","0146","0184","829","640","189","39","868","1798","0","48.28","35.6"
"68","000","00","001","0147","0000","2815","2267","548","162","2977","6097","0","48.83","37.18"
"68","000","00","001","0147","0198","728","585","143","44","772","1514","0","50.99","38.64"
"68","000","00","001","0147","0199","694","568","126","60","754","1446","0","52.14","39.28"
"68","000","00","001","0147","0200","709","562","147","19","728","1573","0","46.28","35.73"
"68","000","00","001","0147","0201","684","552","132","39","723","1564","0","46.23","35.29"
"68","000","00","001","0148","0000","3167","2464","703","220","3387","6901","0","49.08","35.7"
"68","000","00","001","0148","0139","857","677","180","70","927","1846","0","50.22","36.67"
"68","000","00","001","0148","0140","726","568","158","46","772","1644","0","46.96","34.55"
"68","000","00","001","0148","0141","747","584","163","57","804","1674","0","48.03","34.89"
"68","000","00","001","0148","0142","837","635","202","47","884","1737","0","50.89","36.56"
"68","000","00","001","0149","0000","2723","2175","548","122","2845","5873","0","48.44","37.03"
"68","000","00","001","0149","0107","813","651","162","34","847","1831","0","46.26","35.55"
"68","000","00","001","0149","0108","1024","819","205","58","1082","2168","0","49.91","37.78"
"68","000","00","001","0149","0109","886","705","181","30","916","1874","0","48.88","37.62"
"68","000","00","001","0150","0000","4013","3174","839","198","4211","8384","0","50.23","37.86"
"68","000","00","001","0150","0116","967","740","227","66","1033","2127","0","48.57","34.79"
"68","000","00","001","0150","0117","936","746","190","22","958","2033","0","47.12","36.69"
"68","000","00","001","0150","0118","1021","819","202","36","1057","2098","0","50.38","39.04"
"68","000","00","001","0150","0119","1089","869","220","74","1163","2126","0","54.7","40.87"
"68","000","00","001","0151","0000","4152","3234","918","165","4317","8396","0","51.42","38.52"
"68","000","00","001","0151","0146","881","636","245","27","908","1774","0","51.18","35.85"
"68","000","00","001","0151","0147","835","687","148","35","870","1666","0","52.22","41.24"
"68","000","00","001","0151","0148","768","608","160","26","794","1528","0","51.96","39.79"
"68","000","00","001","0151","0149","842","644","198","43","885","1709","0","51.78","37.68"
"68","000","00","001","0151","0150","826","659","167","34","860","1719","0","50.03","38.34"
"68","000","00","001","0152","0000","1411","1091","320","74","1485","2598","0","57.16","41.99"
"68","000","00","001","0152","0079","738","549","189","49","787","1404","0","56.05","39.1"
"68","000","00","001","0152","0080","673","542","131","25","698","1194","0","58.46","45.39"
"68","000","00","001","0153","0000","1820","1394","426","112","1932","3728","0","51.82","37.39"
"68","000","00","001","0153","0084","939","723","216","50","989","1913","0","51.7","37.79"
"68","000","00","001","0153","0085","881","671","210","62","943","1815","0","51.96","36.97"
"68","000","00","001","0154","0000","1803","1418","385","109","1912","3914","0","48.85","36.23"
"68","000","00","001","0154","0074","881","676","205","60","941","1949","0","48.28","34.68"
"68","000","00","001","0154","0075","922","742","180","49","971","1965","0","49.41","37.76"
"68","000","00","001","0155","0000","3016","2429","587","169","3185","6512","0","48.91","37.3"
"68","000","00","001","0155","0076","1021","834","187","63","1084","2414","0","44.9","34.55"
"68","000","00","001","0155","0077","932","751","181","58","990","1942","0","50.98","38.67"
"68","000","00","001","0155","0078","1063","844","219","48","1111","2156","0","51.53","39.15"
"68","000","00","001","0156","0000","2319","1908","411","107","2426","4845","0","50.07","39.38"
"68","000","00","001","0156","0095","750","613","137","41","791","1545","0","51.2","39.68"
"68","000","00","001","0156","0096","752","624","128","31","783","1617","0","48.42","38.59"
"68","000","00","001","0156","0097","817","671","146","35","852","1683","0","50.62","39.87"
"68","000","00","001","0157","0000","2653","2144","509","109","2762","5884","0","46.94","36.44"
"68","000","00","001","0157","0176","859","686","173","41","900","1942","0","46.34","35.32"
"68","000","00","001","0157","0177","957","776","181","43","1000","2001","0","49.98","38.78"
"68","000","00","001","0157","0178","837","682","155","25","862","1941","0","44.41","35.14"
"68","000","00","001","0158","0000","3595","2874","721","200","3795","8196","0","46.3","35.07"
"68","000","00","001","0158","0213","1007","807","200","62","1069","2164","0","49.4","37.29"
"68","000","00","001","0158","0214","921","705","216","48","969","2020","0","47.97","34.9"
"68","000","00","001","0158","0215","807","661","146","46","853","1924","0","44.33","34.36"
"68","000","00","001","0158","0216","860","701","159","44","904","2088","0","43.3","33.57"
"68","000","00","001","0159","0000","3368","2723","645","126","3494","9237","0","37.83","29.48"
"68","000","00","001","0159","0101","879","707","172","37","916","1873","0","48.91","37.75"
"68","000","00","001","0159","0102","725","594","131","38","763","3687","0","20.69","16.11"
"68","000","00","001","0159","0103","894","710","184","7","901","1850","0","48.7","38.38"
"68","000","00","001","0159","0104","870","712","158","44","914","1827","0","50.03","38.97"
"68","000","00","001","0160","0000","2493","1998","495","123","2616","5084","0","51.46","39.3"
"68","000","00","001","0160","0089","855","662","193","49","904","1695","0","53.33","39.06"
"68","000","00","001","0160","0090","857","687","170","40","897","1797","0","49.92","38.23"
"68","000","00","001","0160","0091","781","649","132","34","815","1592","0","51.19","40.77"
"68","000","00","001","0161","0000","3525","2822","703","170","3695","7274","0","50.8","38.8"
"68","000","00","001","0161","0123","817","640","177","41","858","1691","0","50.74","37.85"
"68","000","00","001","0161","0124","925","761","164","36","961","1900","0","50.58","40.05"
"68","000","00","001","0161","0125","873","709","164","60","933","1761","0","52.98","40.26"
"68","000","00","001","0161","0126","910","712","198","33","943","1922","0","49.06","37.04"
"68","000","00","001","0162","0000","2646","2047","599","173","2819","5712","0","49.35","35.84"
"68","000","00","001","0162","0063","808","614","194","49","857","1838","0","46.63","33.41"
"68","000","00","001","0162","0064","953","726","227","71","1024","1889","0","54.21","38.43"
"68","000","00","001","0162","0065","885","707","178","53","938","1985","0","47.25","35.62"
"68","000","00","001","0163","0000","2396","2007","389","118","2514","4811","0","52.26","41.72"
"68","000","00","001","0163","0136","826","661","165","65","891","1657","0","53.77","39.89"
"68","000","00","001","0163","0137","674","528","146","15","689","1349","0","51.07","39.14"
"68","000","00","001","0163","0138","896","818","78","38","934","1805","0","51.75","45.32"
"68","000","00","001","0164","0000","2369","1905","464","94","2463","4605","0","53.49","41.37"
"68","000","00","001","0164","0054","900","718","182","38","938","1740","0","53.91","41.26"
"68","000","00","001","0164","0055","806","639","167","42","848","1626","0","52.15","39.3"
"68","000","00","001","0164","0056","663","548","115","14","677","1239","0","54.64","44.23"
"68","000","00","001","0165","0000","2545","2049","496","126","2671","4555","0","58.64","44.98"
"68","000","00","001","0165","0066","834","663","171","41","875","1524","0","57.41","43.5"
"68","000","00","001","0165","0067","825","681","144","47","872","1425","0","61.19","47.79"
"68","000","00","001","0165","0068","886","705","181","38","924","1606","0","57.53","43.9"
"68","000","00","001","0166","0000","2183","1768","415","65","2248","4066","0","55.29","43.48"
"68","000","00","001","0166","0069","1104","892","212","32","1136","2056","0","55.25","43.39"
"68","000","00","001","0166","0070","1079","876","203","33","1112","2010","0","55.32","43.58"
"68","000","00","001","0167","0000","2278","1783","495","129","2407","4702","0","51.19","37.92"
"68","000","00","001","0167","0143","780","594","186","54","834","1566","0","53.26","37.93"
"68","000","00","001","0167","0144","786","623","163","41","827","1517","0","54.52","41.07"
"68","000","00","001","0167","0145","712","566","146","34","746","1619","0","46.08","34.96"
"68","000","00","001","0168","0000","2897","2282","615","96","2993","5893","0","50.79","38.72"
"68","000","00","001","0168","0168","1177","930","247","45","1222","2204","0","55.44","42.2"
"68","000","00","001","0168","0169","899","682","217","31","930","2033","0","45.75","33.55"
"68","000","00","001","0168","0170","821","670","151","20","841","1656","0","50.79","40.46"
"68","000","00","001","0169","0000","2217","1766","451","100","2317","4541","0","51.02","38.89"
"68","000","00","001","0169","0110","674","531","143","24","698","1524","0","45.8","34.84"
"68","000","00","001","0169","0111","781","625","156","32","813","1528","0","53.21","40.9"
"68","000","00","001","0169","0112","762","610","152","44","806","1489","0","54.13","40.97"
"68","000","00","001","0170","0000","2741","2199","542","120","2861","5371","0","53.27","40.94"
"68","000","00","001","0170","0071","1056","870","186","53","1109","2245","0","49.4","38.75"
"68","000","00","001","0170","0072","804","628","176","37","841","1590","0","52.89","39.5"
"68","000","00","001","0170","0073","881","701","180","30","911","1536","0","59.31","45.64"
"68","000","00","001","0171","0000","2727","2198","529","115","2842","5717","0","49.71","38.45"
"68","000","00","001","0171","0098","949","765","184","51","1000","1834","0","54.53","41.71"
"68","000","00","001","0171","0099","918","730","188","38","956","2055","0","46.52","35.52"
"68","000","00","001","0171","0100","860","703","157","26","886","1828","0","48.47","38.46"
"68","000","00","001","0172","0000","2798","2353","445","131","2929","5843","0","50.13","40.27"
"68","000","00","001","0172","0120","904","734","170","43","947","1917","0","49.4","38.29"
"68","000","00","001","0172","0121","923","744","179","47","970","1997","0","48.57","37.26"
"68","000","00","001","0172","0122","971","875","96","41","1012","1929","0","52.46","45.36"
"68","000","00","001","0173","0000","1585","1272","313","70","1655","3158","0","52.41","40.28"
"68","000","00","001","0173","0129","682","556","126","48","730","1412","0","51.7","39.38"
"68","000","00","001","0173","0130","903","716","187","22","925","1746","0","52.98","41.01"
"68","000","00","001","0174","0000","3605","2904","701","211","3816","7902","0","48.29","36.75"
"68","000","00","001","0174","0164","961","790","171","49","1010","2103","0","48.03","37.57"
"68","000","00","001","0174","0165","900","721","179","58","958","1943","0","49.31","37.11"
"68","000","00","001","0174","0166","922","722","200","52","974","1927","0","50.54","37.47"
"68","000","00","001","0174","0167","822","671","151","52","874","1929","0","45.31","34.78"
"68","000","00","001","0175","0000","2671","2111","560","146","2817","5729","0","49.17","36.85"
"68","000","00","001","0175","0160","555","437","118","37","592","1303","0","45.43","33.54"
"68","000","00","001","0175","0161","716","547","169","38","754","1416","0","53.25","38.63"
"68","000","00","001","0175","0162","629","499","130","33","662","1351","0","49.0","36.94"
"68","000","00","001","0175","0163","771","628","143","38","809","1659","0","48.76","37.85"
"68","000","00","001","0176","0000","1614","1265","349","108","1722","3450","0","49.91","36.67"
"68","000","00","001","0176","0171","786","609","177","60","846","1712","0","49.42","35.57"
"68","000","00","001","0176","0172","828","656","172","48","876","1738","0","50.4","37.74"
"68","000","00","001","0177","0000","1700","1340","360","115","1815","3856","0","47.07","34.75"
"68","000","00","001","0177","0005","908","722","186","39","947","1974","0","47.97","36.58"
"68","000","00","001","0177","0006","792","618","174","76","868","1882","0","46.12","32.84"
"68","000","00","001","0178","0000","2378","1907","471","127","2505","4835","0","51.81","39.44"
"68","000","00","001","0178","0179","851","671","180","50","901","1702","0","52.94","39.42"
"68","000","00","001","0178","0180","779","624","155","42","821","1589","0","51.67","39.27"
"68","000","00","001","0178","0181","748","612","136","35","783","1544","0","50.71","39.64"
"68","000","00","001","0179","0000","2058","1692","366","75","2133","4217","0","50.58","40.12"
"68","000","00","001","0179","0210","689","552","137","30","719","1363","0","52.75","40.5"
"68","000","00","001","0179","0211","744","626","118","13","757","1546","0","48.97","40.49"
"68","000","00","001","0179","0212","625","514","111","32","657","1308","0","50.23","39.3"
"68","000","00","002","0000","0000","166034","134509","31525","8758","174792","334402","411135","52.27","40.22"
"68","000","00","002","0201","0000","1345","1143","202","80","1425","2916","0","48.87","39.2"
"68","000","00","002","0201","0617","616","540","76","17","633","1329","0","47.63","40.63"
"68","000","00","002","0201","0618","729","603","126","63","792","1587","0","49.91","38.0"
"68","000","00","002","0202","0000","2723","2383","340","106","2829","5418","0","52.21","43.98"
"68","000","00","002","0202","0614","987","817","170","36","1023","1818","0","56.27","44.94"
"68","000","00","002","0202","0615","928","875","53","39","967","1991","0","48.57","43.95"
"68","000","00","002","0202","0616","808","691","117","31","839","1609","0","52.14","42.95"
"68","000","00","002","0203","0000","1557","1283","274","78","1635","3033","0","53.91","42.3"
"68","000","00","002","0203","0654","807","652","155","46","853","1588","0","53.72","41.06"
"68","000","00","002","0203","0655","750","631","119","32","782","1445","0","54.12","43.67"
"68","000","00","002","0204","0000","468","367","101","33","501","943","0","53.13","38.92"
"68","000","00","002","0204","0763","468","367","101","33","501","943","0","53.13","38.92"
"68","000","00","002","0205","0000","1042","861","181","74","1116","2152","0","51.86","40.01"
"68","000","00","002","0205","0689","488","405","83","25","513","1087","0","47.19","37.26"
"68","000","00","002","0205","0690","554","456","98","49","603","1065","0","56.62","42.82"
"68","000","00","002","0206","0000","2070","1684","386","152","2222","4283","0","51.88","39.32"
"68","000","00","002","0206","0691","917","745","172","76","993","1844","0","53.85","40.4"
"68","000","00","002","0206","0692","531","442","89","45","576","1220","0","47.21","36.23"
"68","000","00","002","0206","0693","622","497","125","31","653","1219","0","53.57","40.77"
"68","000","00","002","0207","0000","2499","2020","479","120","2619","5415","0","48.37","37.3"
"68","000","00","002","0207","0771","970","780","190","51","1021","2156","0","47.36","36.18"
"68","000","00","002","0207","0772","643","514","129","29","672","1479","0","45.44","34.75"
"68","000","00","002","0207","0773","886","726","160","40","926","1780","0","52.02","40.79"
"68","000","00","002","0208","0000","2431","2062","369","154","2585","5136","0","50.33","40.15"
"68","000","00","002","0208","0679","785","663","122","34","819","1659","0","49.37","39.96"
"68","000","00","002","0208","0680","884","753","131","81","965","1874","0","51.49","40.18"
"68","000","00","002","0208","0681","762","646","116","39","801","1603","0","49.97","40.3"
"68","000","00","002","0209","0000","1726","1426","300","130","1856","3474","0","53.43","41.05"
"68","000","00","002","0209","0675","795","639","156","68","863","1659","0","52.02","38.52"
"68","000","00","002","0209","0676","931","787","144","62","993","1815","0","54.71","43.36"
"68","000","00","002","0210","0000","1892","1601","291","86","1978","3758","0","52.63","42.6"
"68","000","00","002","0210","0662","749","628","121","32","781","1489","0","52.45","42.18"
"68","000","00","002","0210","0663","434","367","67","24","458","827","0","55.38","44.38"
"68","000","00","002","0210","0664","709","606","103","30","739","1442","0","51.25","42.02"
"68","000","00","002","0211","0000","2225","1803","422","132","2357","4303","0","54.78","41.9"
"68","000","00","002","0211","0602","710","580","130","47","757","1281","0","59.09","45.28"
"68","000","00","002","0211","0603","797","638","159","31","828","1462","0","56.63","43.64"
"68","000","00","002","0211","0604","718","585","133","54","772","1560","0","49.49","37.5"
"68","000","00","002","0212","0000","2629","2129","500","119","2748","5378","0","51.1","39.59"
"68","000","00","002","0212","0619","962","800","162","32","994","1955","0","50.84","40.92"
"68","000","00","002","0212","0620","845","657","188","38","883","1711","0","51.61","38.4"
"68","000","00","002","0212","0621","822","672","150","49","871","1712","0","50.88","39.25"
"68","000","00","002","0213","0000","1733","1385","348","79","1812","3009","0","60.22","46.03"
"68","000","00","002","0213","0652","911","745","166","43","954","1625","0","58.71","45.85"
"68","000","00","002","0213","0653","822","640","182","36","858","1384","0","61.99","46.24"
"68","000","00","002","0214","0000","1049","830","219","78","1127","2061","0","54.68","40.27"
"68","000","00","002","0214","0754","428","329","99","35","463","852","0","54.34","38.62"
"68","000","00","002","0214","0755","621","501","120","43","664","1209","0","54.92","41.44"
"68","000","00","002","0215","0000","1972","1607","365","85","2057","3498","0","58.81","45.94"
"68","000","00","002","0215","0721","794","672","122","34","828","1384","0","59.83","48.55"
"68","000","00","002","0215","0722","608","475","133","19","627","1122","0","55.88","42.34"
"68","000","00","002","0215","0723","570","460","110","32","602","992","0","60.69","46.37"
"68","000","00","002","0216","0000","2075","1769","306","99","2174","4141","0","52.5","42.72"
"68","000","00","002","0216","0627","637","607","30","33","670","1201","0","55.79","50.54"
"68","000","00","002","0216","0628","675","537","138","34","709","1353","0","52.4","39.69"
"68","000","00","002","0216","0629","763","625","138","32","795","1587","0","50.09","39.38"
"68","000","00","002","0217","0000","1746","1411","335","82","1828","5573","0","32.8","25.32"
"68","000","00","002","0217","0642","677","546","131","30","707","3474","0","20.35","15.72"
"68","000","00","002","0217","0643","1069","865","204","52","1121","2099","0","53.41","41.21"
"68","000","00","002","0218","0000","1609","1296","313","70","1679","3540","0","47.43","36.61"
"68","000","00","002","0218","0648","926","734","192","46","972","1900","0","51.16","38.63"
"68","000","00","002","0218","0649","683","562","121","24","707","1640","0","43.11","34.27"
"68","000","00","002","0219","0000","2374","1945","429","107","2481","4845","0","51.21","40.14"
"68","000","00","002","0219","0667","773","637","136","40","813","1764","0","46.09","36.11"
"68","000","00","002","0219","0668","798","659","139","25","823","1488","0","55.31","44.29"
"68","000","00","002","0219","0669","803","649","154","42","845","1593","0","53.04","40.74"
"68","000","00","002","0220","0000","1509","1250","259","37","1546","3362","0","45.98","37.18"
"68","000","00","002","0220","0665","828","681","147","16","844","1842","0","45.82","36.97"
"68","000","00","002","0220","0666","681","569","112","21","702","1520","0","46.18","37.43"
"68","000","00","002","0221","0000","1673","1335","338","106","1779","3334","0","53.36","40.04"
"68","000","00","002","0221","0732","922","726","196","57","979","1951","0","50.18","37.21"
"68","000","00","002","0221","0733","751","609","142","49","800","1383","0","57.85","44.03"
"68","000","00","002","0222","0000","2323","1814","509","125","2448","4872","0","50.25","37.23"
"68","000","00","002","0222","0787","517","393","124","45","562","1097","0","51.23","35.82"
"68","000","00","002","0222","0788","902","714","188","31","933","1917","0","48.67","37.25"
"68","000","00","002","0222","0789","904","707","197","49","953","1858","0","51.29","38.05"
"68","000","00","002","0223","0000","1264","1027","237","56","1320","2506","0","52.67","40.98"
"68","000","00","002","0223","0673","586","467","119","30","616","1249","0","49.32","37.39"
"68","000","00","002","0223","0674","678","560","118","26","704","1257","0","56.01","44.55"
"68","000","00","002","0224","0000","1944","1507","437","129","2073","3776","0","54.9","39.91"
"68","000","00","002","0224","0768","513","423","90","48","561","1028","0","54.57","41.15"
"68","000","00","002","0224","0769","633","484","149","39","672","1157","0","58.08","41.83"
"68","000","00","002","0224","0770","798","600","198","42","840","1591","0","52.8","37.71"
"68","000","00","002","0225","0000","1763","1421","342","89","1852","3667","0","50.5","38.75"
"68","000","00","002","0225","0724","878","698","180","42","920","1820","0","50.55","38.35"
"68","000","00","002","0225","0725","885","723","162","47","932","1847","0","50.46","39.14"
"68","000","00","002","0226","0000","1850","1503","347","126","1976","3712","0","53.23","40.49"
"68","000","00","002","0226","0696","865","673","192","73","938","1733","0","54.13","38.83"
"68","000","00","002","0226","0697","985","830","155","53","1038","1979","0","52.45","41.94"
"68","000","00","002","0227","0000","3398","2716","682","138","3536","6638","0","53.27","40.92"
"68","000","00","002","0227","0716","861","663","198","36","897","1798","0","49.89","36.87"
"68","000","00","002","0227","0717","988","812","176","51","1039","1822","0","57.03","44.57"
"68","000","00","002","0227","0718","824","661","163","20","844","1613","0","52.32","40.98"
"68","000","00","002","0227","0719","725","580","145","31","756","1405","0","53.81","41.28"
"68","000","00","002","0228","0000","412","325","87","30","442","731","0","60.47","44.46"
"68","000","00","002","0228","0764","412","325","87","30","442","731","0","60.47","44.46"
"68","000","00","002","0229","0000","2420","1953","467","176","2596","4672","0","55.57","41.8"
"68","000","00","002","0229","0608","820","664","156","68","888","1627","0","54.58","40.81"
"68","000","00","002","0229","0609","821","650","171","38","859","1519","0","56.55","42.79"
"68","000","00","002","0229","0610","779","639","140","70","849","1526","0","55.64","41.87"
"68","000","00","002","0230","0000","1383","1144","239","96","1479","2836","0","52.15","40.34"
"68","000","00","002","0230","0658","736","607","129","54","790","1546","0","51.1","39.26"
"68","000","00","002","0230","0659","647","537","110","42","689","1290","0","53.41","41.63"
"68","000","00","002","0231","0000","1827","1464","363","133","1960","3544","0","55.3","41.31"
"68","000","00","002","0231","0737","925","731","194","66","991","1703","0","58.19","42.92"
"68","000","00","002","0231","0738","902","733","169","67","969","1841","0","52.63","39.82"
"68","000","00","002","0232","0000","1730","1401","329","71","1801","3507","0","51.35","39.95"
"68","000","00","002","0232","0752","945","779","166","47","992","1987","0","49.92","39.2"
"68","000","00","002","0232","0753","785","622","163","24","809","1520","0","53.22","40.92"
"68","000","00","002","0233","0000","4162","3474","688","177","4339","8947","0","48.5","38.83"
"68","000","00","002","0233","0701","891","733","158","43","934","1943","0","48.07","37.73"
"68","000","00","002","0233","0702","695","579","116","19","714","1363","0","52.38","42.48"
"68","000","00","002","0233","0703","931","769","162","57","988","2172","0","45.49","35.41"
"68","000","00","002","0233","0704","839","730","109","40","879","1798","0","48.89","40.6"
"68","000","00","002","0233","0705","806","663","143","18","824","1671","0","49.31","39.68"
"68","000","00","002","0234","0000","4168","3407","761","256","4424","8663","0","51.07","39.33"
"68","000","00","002","0234","0709","765","651","114","45","810","1923","0","42.12","33.85"
"68","000","00","002","0234","0710","832","678","154","64","896","1572","0","57.0","43.13"
"68","000","00","002","0234","0711","971","795","176","41","1012","1850","0","54.7","42.97"
"68","000","00","002","0234","0712","761","635","126","56","817","1583","0","51.61","40.11"
"68","000","00","002","0234","0713","839","648","191","50","889","1735","0","51.24","37.35"
"68","000","00","002","0235","0000","1005","800","205","55","1060","1957","0","54.16","40.88"
"68","000","00","002","0235","0758","1005","800","205","55","1060","1957","0","54.16","40.88"
"68","000","00","002","0236","0000","3674","2956","718","187","3861","7473","0","51.67","39.56"
"68","000","00","002","0236","0741","868","716","152","30","898","1636","0","54.89","43.77"
"68","000","00","002","0236","0742","847","692","155","23","870","1528","0","56.94","45.29"
"68","000","00","002","0236","0743","1021","810","211","82","1103","2289","0","48.19","35.39"
"68","000","00","002","0236","0744","938","738","200","52","990","2020","0","49.01","36.53"
"68","000","00","002","0237","0000","2348","1904","444","97","2445","4365","0","56.01","43.62"
"68","000","00","002","0237","0636","690","553","137","18","708","1368","0","51.75","40.42"
"68","000","00","002","0237","0637","814","664","150","45","859","1424","0","60.32","46.63"
"68","000","00","002","0237","0638","844","687","157","34","878","1573","0","55.82","43.67"
"68","000","00","002","0238","0000","912","708","204","62","974","1730","0","56.3","40.92"
"68","000","00","002","0238","0720","912","708","204","62","974","1730","0","56.3","40.92"
"68","000","00","002","0239","0000","2519","2147","372","186","2705","4878","0","55.45","44.01"
"68","000","00","002","0239","0611","807","688","119","66","873","1618","0","53.96","42.52"
"68","000","00","002","0239","0612","853","720","133","50","903","1554","0","58.11","46.33"
"68","000","00","002","0239","0613","859","739","120","70","929","1706","0","54.45","43.32"
"68","000","00","002","0240","0000","506","388","118","40","546","1011","0","54.01","38.38"
"68","000","00","002","0240","0766","506","388","118","40","546","1011","0","54.01","38.38"
"68","000","00","002","0241","0000","1441","1175","266","92","1533","3045","0","50.34","38.59"
"68","000","00","002","0241","0756","722","581","141","72","794","1481","0","53.61","39.23"
"68","000","00","002","0241","0757","719","594","125","20","739","1564","0","47.25","37.98"
"68","000","00","002","0242","0000","2269","1850","419","138","2407","4841","0","49.72","38.22"
"68","000","00","002","0242","0591","690","605","85","45","735","1401","0","52.46","43.18"
"68","000","00","002","0242","0592","854","666","188","46","900","1798","0","50.06","37.04"
"68","000","00","002","0242","0593","725","579","146","47","772","1642","0","47.02","35.26"
"68","000","00","002","0243","0000","2741","2201","540","185","2926","6378","0","45.88","34.51"
"68","000","00","002","0243","0798","959","797","162","86","1045","2068","0","50.53","38.54"
"68","000","00","002","0243","0799","849","674","175","44","893","2152","0","41.5","31.32"
"68","000","00","002","0243","0800","933","730","203","55","988","2158","0","45.78","33.83"
"68","000","00","002","0244","0000","2998","2359","639","155","3153","6013","0","52.44","39.23"
"68","000","00","002","0244","0779","717","550","167","40","757","1426","0","53.09","38.57"
"68","000","00","002","0244","0780","741","578","163","28","769","1618","0","47.53","35.72"
"68","000","00","002","0244","0781","732","571","161","52","784","1441","0","54.41","39.63"
"68","000","00","002","0244","0782","808","660","148","35","843","1528","0","55.17","43.19"
"68","000","00","002","0245","0000","787","617","170","44","831","1532","0","54.24","40.27"
"68","000","00","002","0245","0767","787","617","170","44","831","1532","0","54.24","40.27"
"68","000","00","002","0246","0000","1598","1232","366","121","1719","3344","0","51.41","36.84"
"68","000","00","002","0246","0785","751","570","181","58","809","1534","0","52.74","37.16"
"68","000","00","002","0246","0786","847","662","185","63","910","1810","0","50.28","36.57"
"68","000","00","002","0247","0000","2674","2068","606","196","2870","5162","0","55.6","40.06"
"68","000","00","002","0247","0793","1027","785","242","87","1114","2037","0","54.69","38.54"
"68","000","00","002","0247","0794","653","519","134","43","696","1158","0","60.1","44.82"
"68","000","00","002","0247","0795","994","764","230","66","1060","1967","0","53.89","38.84"
"68","000","00","002","0248","0000","1444","1160","284","62","1506","3148","0","47.84","36.85"
"68","000","00","002","0248","0777","714","573","141","32","746","1609","0","46.36","35.61"
"68","000","00","002","0248","0778","730","587","143","30","760","1539","0","49.38","38.14"
"68","000","00","002","0249","0000","1688","1322","366","141","1829","3686","0","49.62","35.87"
"68","000","00","002","0249","0796","852","682","170","72","924","1830","0","50.49","37.27"
"68","000","00","002","0249","0797","836","640","196","69","905","1856","0","48.76","34.48"
"68","000","00","002","0250","0000","453","365","88","33","486","851","0","57.11","42.89"
"68","000","00","002","0250","0765","453","365","88","33","486","851","0","57.11","42.89"
"68","000","00","002","0251","0000","2407","1870","537","99","2506","4643","0","53.97","40.28"
"68","000","00","002","0251","0790","810","649","161","32","842","1576","0","53.43","41.18"
"68","000","00","002","0251","0791","794","611","183","30","824","1478","0","55.75","41.34"
"68","000","00","002","0251","0792","803","610","193","37","840","1589","0","52.86","38.39"
"68","000","00","002","0252","0000","2303","1894","409","110","2413","4812","0","50.15","39.36"
"68","000","00","002","0252","0729","682","550","132","44","726","1234","0","58.83","44.57"
"68","000","00","002","0252","0730","903","762","141","50","953","2023","0","47.11","37.67"
"68","000","00","002","0252","0731","718","582","136","16","734","1555","0","47.2","37.43"
"68","000","00","002","0253","0000","1442","1148","294","60","1502","2587","0","58.06","44.38"
"68","000","00","002","0253","0634","649","523","126","21","670","1177","0","56.92","44.44"
"68","000","00","002","0253","0635","793","625","168","39","832","1410","0","59.01","44.33"
"68","000","00","002","0254","0000","1494","1192","302","95","1589","2767","0","57.43","43.08"
"68","000","00","002","0254","0761","589","460","129","39","628","1066","0","58.91","43.15"
"68","000","00","002","0254","0762","905","732","173","56","961","1701","0","56.5","43.03"
"68","000","00","002","0255","0000","2622","2105","517","126","2748","5434","0","50.57","38.74"
"68","000","00","002","0255","0774","835","680","155","55","890","1651","0","53.91","41.19"
"68","000","00","002","0255","0775","951","744","207","38","989","1870","0","52.89","39.79"
"68","000","00","002","0255","0776","836","681","155","33","869","1913","0","45.43","35.6"
"68","000","00","002","0256","0000","2802","2325","477","127","2929","5294","0","55.33","43.92"
"68","000","00","002","0256","0706","931","764","167","40","971","1969","0","49.31","38.8"
"68","000","00","002","0256","0707","938","777","161","47","985","1563","0","63.02","49.71"
"68","000","00","002","0256","0708","933","784","149","40","973","1762","0","55.22","44.49"
"68","000","00","002","0257","0000","2370","1913","457","87","2457","4543","0","54.08","42.11"
"68","000","00","002","0257","0698","822","661","161","22","844","1621","0","52.07","40.78"
"68","000","00","002","0257","0699","739","577","162","36","775","1391","0","55.72","41.48"
"68","000","00","002","0257","0700","809","675","134","29","838","1531","0","54.74","44.09"
"68","000","00","002","0258","0000","1503","1186","317","117","1620","2854","0","56.76","41.56"
"68","000","00","002","0258","0694","645","513","132","48","693","1260","0","55.0","40.71"
"68","000","00","002","0258","0695","858","673","185","69","927","1594","0","58.16","42.22"
"68","000","00","002","0259","0000","1270","1048","222","57","1327","2557","0","51.9","40.99"
"68","000","00","002","0259","0714","635","520","115","36","671","1292","0","51.93","40.25"
"68","000","00","002","0259","0715","635","528","107","21","656","1265","0","51.86","41.74"
"68","000","00","002","0260","0000","1671","1342","329","82","1753","3331","0","52.63","40.29"
"68","000","00","002","0260","0630","956","786","170","50","1006","1883","0","53.43","41.74"
"68","000","00","002","0260","0631","715","556","159","32","747","1448","0","51.59","38.4"
"68","000","00","002","0261","0000","1842","1509","333","92","1934","3726","0","51.91","40.5"
"68","000","00","002","0261","0632","921","765","156","33","954","1810","0","52.71","42.27"
"68","000","00","002","0261","0633","921","744","177","59","980","1916","0","51.15","38.83"
"68","000","00","002","0262","0000","2474","1993","481","116","2590","4657","0","55.62","42.8"
"68","000","00","002","0262","0594","839","666","173","44","883","1670","0","52.87","39.88"
"68","000","00","002","0262","0595","770","606","164","21","791","1456","0","54.33","41.62"
"68","000","00","002","0262","0596","865","721","144","51","916","1531","0","59.83","47.09"
"68","000","00","002","0263","0000","1751","1467","284","75","1826","3576","0","51.06","41.02"
"68","000","00","002","0263","0597","891","738","153","41","932","1623","0","57.42","45.47"
"68","000","00","002","0263","0598","860","729","131","34","894","1953","0","45.78","37.33"
"68","000","00","002","0264","0000","1832","1436","396","125","1957","3628","0","53.94","39.58"
"68","000","00","002","0264","0783","831","640","191","52","883","1683","0","52.47","38.03"
"68","000","00","002","0264","0784","1001","796","205","73","1074","1945","0","55.22","40.93"
"68","000","00","002","0265","0000","2300","1879","421","87","2387","4082","0","58.48","46.03"
"68","000","00","002","0265","0605","892","722","170","33","925","1602","0","57.74","45.07"
"68","000","00","002","0265","0606","616","502","114","29","645","1006","0","64.12","49.9"
"68","000","00","002","0265","0607","792","655","137","25","817","1474","0","55.43","44.44"
"68","000","00","002","0266","0000","2208","1748","460","97","2305","4296","0","53.65","40.69"
"68","000","00","002","0266","0639","614","491","123","28","642","1152","0","55.73","42.62"
"68","000","00","002","0266","0640","623","484","139","10","633","1178","0","53.74","41.09"
"68","000","00","002","0266","0641","971","773","198","59","1030","1966","0","52.39","39.32"
"68","000","00","002","0267","0000","1248","1050","198","76","1324","2125","0","62.31","49.41"
"68","000","00","002","0267","0650","568","469","99","27","595","994","0","59.86","47.18"
"68","000","00","002","0267","0651","680","581","99","49","729","1131","0","64.46","51.37"
"68","000","00","002","0268","0000","2381","1980","401","84","2465","4658","0","52.92","42.51"
"68","000","00","002","0268","0670","773","641","132","30","803","1505","0","53.36","42.59"
"68","000","00","002","0268","0671","817","673","144","28","845","1661","0","50.87","40.52"
"68","000","00","002","0268","0672","791","666","125","26","817","1492","0","54.76","44.64"
"68","000","00","002","0269","0000","1408","823","585","88","1496","2575","0","58.1","31.96"
"68","000","00","002","0269","0644","602","183","419","37","639","1178","0","54.24","15.53"
"68","000","00","002","0269","0645","806","640","166","51","857","1397","0","61.35","45.81"
"68","000","00","002","0270","0000","1827","1477","350","110","1937","3756","0","51.57","39.32"
"68","000","00","002","0270","0646","863","681","182","58","921","1669","0","55.18","40.8"
"68","000","00","002","0270","0647","964","796","168","52","1016","2087","0","48.68","38.14"
"68","000","00","002","0271","0000","1636","1342","294","121","1757","3596","0","48.86","37.32"
"68","000","00","002","0271","0660","957","798","159","83","1040","2145","0","48.48","37.2"
"68","000","00","002","0271","0661","679","544","135","38","717","1451","0","49.41","37.49"
"68","000","00","002","0272","0000","2307","1889","418","97","2404","4686","0","51.3","40.31"
"68","000","00","002","0272","0622","791","657","134","43","834","1448","0","57.6","45.37"
"68","000","00","002","0272","0623","778","631","147","40","818","1605","0","50.97","39.31"
"68","000","00","002","0272","0624","738","601","137","14","752","1633","0","46.05","36.8"
"68","000","00","002","0273","0000","2786","2274","512","123","2909","5990","0","48.56","37.96"
"68","000","00","002","0273","0745","1001","826","175","50","1051","2027","0","51.85","40.75"
"68","000","00","002","0273","0746","804","650","154","27","831","1883","0","44.13","34.52"
"68","000","00","002","0273","0747","981","798","183","46","1027","2080","0","49.38","38.37"
"68","000","00","002","0274","0000","3025","2410","615","135","3160","5466","0","57.81","44.09"
"68","000","00","002","0274","0748","311","242","69","15","326","646","0","50.46","37.46"
"68","000","00","002","0274","0749","1058","847","211","55","1113","1780","0","62.53","47.58"
"68","000","00","002","0274","0750","750","622","128","23","773","1372","0","56.34","45.34"
"68","000","00","002","0274","0751","906","699","207","42","948","1668","0","56.83","41.91"
"68","000","00","002","0275","0000","1569","1315","254","76","1645","3555","0","46.27","36.99"
"68","000","00","002","0275","0656","750","618","132","43","793","1743","0","45.5","35.46"
"68","000","00","002","0275","0657","819","697","122","33","852","1812","0","47.02","38.47"
"68","000","00","002","0276","0000","1847","1530","317","83","1930","3484","0","55.4","43.92"
"68","000","00","002","0276","0625","963","805","158","53","1016","1795","0","56.6","44.85"
"68","000","00","002","0276","0626","884","725","159","30","914","1689","0","54.11","42.92"
"68","000","00","002","0277","0000","1718","1448","270","82","1800","3448","0","52.2","42.0"
"68","000","00","002","0277","0685","915","773","142","51","966","1739","0","55.55","44.45"
"68","000","00","002","0277","0686","803","675","128","31","834","1709","0","48.8","39.5"
"68","000","00","002","0278","0000","1714","1425","289","79","1793","3319","0","54.02","42.93"
"68","000","00","002","0278","0687","876","701","175","36","912","1655","0","55.11","42.36"
"68","000","00","002","0278","0688","838","724","114","43","881","1664","0","52.94","43.51"
"68","000","00","002","0279","0000","2342","1868","474","123","2465","4416","0","55.82","42.3"
"68","000","00","002","0279","0734","657","524","133","48","705","1164","0","60.57","45.02"
"68","000","00","002","0279","0735","784","643","141","27","811","1482","0","54.72","43.39"
"68","000","00","002","0279","0736","901","701","200","48","949","1770","0","53.62","39.6"
"68","000","00","002","0280","0000","1315","1006","309","92","1407","2405","0","58.5","41.83"
"68","000","00","002","0280","0759","682","519","163","57","739","1223","0","60.43","42.44"
"68","000","00","002","0280","0760","633","487","146","35","668","1182","0","56.51","41.2"
"68","000","00","002","0281","0000","1601","1302","299","60","1661","3243","0","51.22","40.15"
"68","000","00","002","0281","0677","816","673","143","39","855","1702","0","50.24","39.54"
"68","000","00","002","0281","0678","785","629","156","21","806","1541","0","52.3","40.82"
"68","000","00","002","0282","0000","2256","1886","370","98","2354","4712","0","49.96","40.03"
"68","000","00","002","0282","0599","634","520","114","23","657","1155","0","56.88","45.02"
"68","000","00","002","0282","0600","804","669","135","42","846","1800","0","47.0","37.17"
"68","000","00","002","0282","0601","818","697","121","33","851","1757","0","48.43","39.67"
"68","000","00","002","0283","0000","2513","2009","504","92","2605","5423","0","48.04","37.05"
"68","000","00","002","0283","0682","839","676","163","39","878","1735","0","50.61","38.96"
"68","000","00","002","0283","0683","881","723","158","19","900","1815","0","49.59","39.83"
"68","000","00","002","0283","0684","793","610","183","34","827","1873","0","44.15","32.57"
"68","000","00","002","0284","0000","2105","1702","403","102","2207","3731","0","59.15","45.62"
"68","000","00","002","0284","0726","709","584","125","53","762","1302","0","58.53","44.85"
"68","000","00","002","0284","0727","652","531","121","33","685","1203","0","56.94","44.14"
"68","000","00","002","0284","0728","744","587","157","16","760","1226","0","61.99","47.88"
"68","000","00","002","0285","0000","2097","1720","377","82","2179","3970","0","54.89","43.32"
"68","000","00","002","0285","0739","1021","830","191","40","1061","1941","0","54.66","42.76"
"68","000","00","002","0285","0740","1076","890","186","42","1118","2029","0","55.1","43.86"
"68","000","00","003","0000","0000","37901","30058","7843","2974","40875","78285","94862","52.21","38.4"
"68","000","00","003","0301","0000","763","555","208","62","825","1477","0","55.86","37.58"
"68","000","00","003","0301","0522","763","555","208","62","825","1477","0","55.86","37.58"
"68","000","00","003","0302","0000","500","382","118","43","543","1006","0","53.98","37.97"
"68","000","00","003","0302","0523","500","382","118","43","543","1006","0","53.98","37.97"
"68","000","00","003","0303","0000","2179","1723","456","110","2289","4752","0","48.17","36.26"
"68","000","00","003","0303","0527","700","549","151","50","750","1585","0","47.32","34.64"
"68","000","00","003","0303","0528","792","616","176","43","835","1612","0","51.8","38.21"
"68","000","00","003","0303","0529","687","558","129","17","704","1555","0","45.27","35.88"
"68","000","00","003","0304","0000","2774","2156","618","238","3012","5544","0","54.33","38.89"
"68","000","00","003","0304","0530","712","539","173","62","774","1282","0","60.37","42.04"
"68","000","00","003","0304","0531","673","543","130","59","732","1392","0","52.59","39.01"
"68","000","00","003","0304","0532","664","501","163","54","718","1422","0","50.49","35.23"
"68","000","00","003","0304","0533","725","573","152","63","788","1448","0","54.42","39.57"
"68","000","00","003","0305","0000","718","551","167","56","774","1269","0","60.99","43.42"
"68","000","00","003","0305","0534","718","551","167","56","774","1269","0","60.99","43.42"
"68","000","00","003","0306","0000","523","379","144","68","591","977","0","60.49","38.79"
"68","000","00","003","0306","0535","523","379","144","68","591","977","0","60.49","38.79"
"68","000","00","003","0307","0000","1442","1149","293","126","1568","3036","0","51.65","37.85"
"68","000","00","003","0307","0539","484","376","108","38","522","1056","0","49.43","35.61"
"68","000","00","003","0307","0540","598","494","104","52","650","1263","0","51.46","39.11"
"68","000","00","003","0307","0541","360","279","81","36","396","717","0","55.23","38.91"
"68","000","00","003","0308","0000","999","758","241","66","1065","2275","0","46.81","33.32"
"68","000","00","003","0308","0542","506","367","139","20","526","1299","0","40.49","28.25"
"68","000","00","003","0308","0543","493","391","102","46","539","976","0","55.23","40.06"
"68","000","00","003","0309","0000","459","351","108","45","504","938","0","53.73","37.42"
"68","000","00","003","0309","0544","459","351","108","45","504","938","0","53.73","37.42"
"68","000","00","003","0310","0000","373","287","86","33","406","832","0","48.8","34.5"
"68","000","00","003","0310","0545","373","287","86","33","406","832","0","48.8","34.5"
"68","000","00","003","0311","0000","716","535","181","37","753","1359","0","55.41","39.37"
"68","000","00","003","0311","0536","716","535","181","37","753","1359","0","55.41","39.37"
"68","000","00","003","0312","0000","943","704","239","99","1042","1795","0","58.05","39.22"
"68","000","00","003","0312","0537","626","465","161","64","690","1135","0","60.79","40.97"
"68","000","00","003","0312","0538","317","239","78","35","352","660","0","53.33","36.21"
"68","000","00","003","0313","0000","1207","897","310","98","1305","2713","0","48.1","33.06"
"68","000","00","003","0313","0548","619","442","177","40","659","1410","0","46.74","31.35"
"68","000","00","003","0313","0549","588","455","133","58","646","1303","0","49.58","34.92"
"68","000","00","003","0314","0000","659","506","153","59","718","1560","0","46.03","32.44"
"68","000","00","003","0314","0546","362","289","73","24","386","866","0","44.57","33.37"
"68","000","00","003","0314","0547","297","217","80","35","332","694","0","47.84","31.27"
"68","000","00","003","0315","0000","1265","1067","198","105","1370","2852","0","48.04","37.41"
"68","000","00","003","0315","0557","689","572","117","55","744","1446","0","51.45","39.56"
"68","000","00","003","0315","0558","576","495","81","50","626","1406","0","44.52","35.21"
"68","000","00","003","0316","0000","1315","1120","195","68","1383","2542","0","54.41","44.06"
"68","000","00","003","0316","0555","635","564","71","43","678","1173","0","57.8","48.08"
"68","000","00","003","0316","0556","680","556","124","25","705","1369","0","51.5","40.61"
"68","000","00","003","0317","0000","1872","1510","362","114","1986","3603","0","55.12","41.91"
"68","000","00","003","0317","0550","554","452","102","35","589","1125","0","52.36","40.18"
"68","000","00","003","0317","0551","600","495","105","36","636","1170","0","54.36","42.31"
"68","000","00","003","0317","0552","718","563","155","43","761","1308","0","58.18","43.04"
"68","000","00","003","0318","0000","2427","2053","374","155","2582","5012","0","51.52","40.96"
"68","000","00","003","0318","0562","801","649","152","23","824","1684","0","48.93","38.54"
"68","000","00","003","0318","0563","923","844","79","58","981","1959","0","50.08","43.08"
"68","000","00","003","0318","0564","703","560","143","74","777","1369","0","56.76","40.91"
"68","000","00","003","0319","0000","1351","1086","265","91","1442","3088","0","46.7","35.17"
"68","000","00","003","0319","0565","728","592","136","66","794","1431","0","55.49","41.37"
"68","000","00","003","0319","0566","623","494","129","25","648","1657","0","39.11","29.81"
"68","000","00","003","0320","0000","676","528","148","29","705","1514","0","46.57","34.87"
"68","000","00","003","0320","0575","676","528","148","29","705","1514","0","46.57","34.87"
"68","000","00","003","0321","0000","2115","1620","495","257","2372","4947","0","47.95","32.75"
"68","000","00","003","0321","0570","696","545","151","88","784","1511","0","51.89","36.07"
"68","000","00","003","0321","0571","712","534","178","85","797","1719","0","46.36","31.06"
"68","000","00","003","0321","0572","707","541","166","84","791","1717","0","46.07","31.51"
"68","000","00","003","0322","0000","1838","1465","373","131","1969","3732","0","52.76","39.26"
"68","000","00","003","0322","0578","452","357","95","19","471","831","0","56.68","42.96"
"68","000","00","003","0322","0579","730","584","146","47","777","1407","0","55.22","41.51"
"68","000","00","003","0322","0580","656","524","132","65","721","1494","0","48.26","35.07"
"68","000","00","003","0323","0000","1187","969","218","135","1322","2395","0","55.2","40.46"
"68","000","00","003","0323","0573","582","458","124","68","650","1207","0","53.85","37.95"
"68","000","00","003","0323","0574","605","511","94","67","672","1188","0","56.57","43.01"
"68","000","00","003","0324","0000","1485","1220","265","111","1596","2789","0","57.22","43.74"
"68","000","00","003","0324","0576","790","646","144","66","856","1529","0","55.98","42.25"
"68","000","00","003","0324","0577","695","574","121","45","740","1260","0","58.73","45.56"
"68","000","00","003","0325","0000","2206","1719","487","206","2412","4508","0","53.5","38.13"
"68","000","00","003","0325","0524","739","569","170","77","816","1553","0","52.54","36.64"
"68","000","00","003","0325","0525","794","614","180","71","865","1597","0","54.16","38.45"
"68","000","00","003","0325","0526","673","536","137","58","731","1358","0","53.83","39.47"
"68","000","00","003","0326","0000","1831","1463","368","124","1955","3875","0","50.45","37.75"
"68","000","00","003","0326","0567","567","441","126","30","597","1387","0","43.04","31.8"
"68","000","00","003","0326","0568","525","423","102","42","567","1085","0","52.26","38.99"
"68","000","00","003","0326","0569","739","599","140","52","791","1403","0","56.38","42.69"
"68","000","00","003","0327","0000","2430","1952","478","192","2622","4648","0","56.41","42.0"
"68","000","00","003","0327","0559","830","687","143","29","859","1592","0","53.96","43.15"
"68","000","00","003","0327","0560","780","612","168","71","851","1497","0","56.85","40.88"
"68","000","00","003","0327","0561","820","653","167","92","912","1559","0","58.5","41.89"
"68","000","00","003","0328","0000","1648","1353","295","116","1764","3247","0","54.33","41.67"
"68","000","00","003","0328","0553","564","433","131","55","619","1094","0","56.58","39.58"
"68","000","00","003","0328","0554","1084","920","164","61","1145","2153","0","53.18","42.73"
"68","000","00","004","0000","0000","66211","54109","12102","3373","69584","137917","169991","50.45","39.23"
"68","000","00","004","0401","0000","1825","1474","351","82","1907","3705","0","51.47","39.78"
"68","000","00","004","0401","0960","952","770","182","49","1001","1943","0","51.52","39.63"
"68","000","00","004","0401","0961","873","704","169","33","906","1762","0","51.42","39.95"
"68","000","00","004","0402","0000","547","442","105","26","573","1083","0","52.91","40.81"
"68","000","00","004","0402","0962","547","442","105","26","573","1083","0","52.91","40.81"
"68","000","00","004","0403","0000","1404","1143","261","106","1510","2633","0","57.35","43.41"
"68","000","00","004","0403","0964","672","535","137","57","729","1274","0","57.22","41.99"
"68","000","00","004","0403","0965","732","608","124","49","781","1359","0","57.47","44.74"
"68","000","00","004","0404","0000","2826","2302","524","126","2952","6964","0","42.39","33.06"
"68","000","00","004","0404","0966","805","648","157","56","861","2444","0","35.23","26.51"
"68","000","00","004","0404","0967","975","806","169","29","1004","2298","0","43.69","35.07"
"68","000","00","004","0404","0968","1046","848","198","41","1087","2222","0","48.92","38.16"
"68","000","00","004","0405","0000","1571","1276","295","140","1711","3237","0","52.86","39.42"
"68","000","00","004","0405","0969","787","638","149","59","846","1610","0","52.55","39.63"
"68","000","00","004","0405","0970","784","638","146","81","865","1627","0","53.17","39.21"
"68","000","00","004","0406","0000","1187","961","226","70","1257","2776","0","45.28","34.62"
"68","000","00","004","0406","0973","740","595","145","47","787","1776","0","44.31","33.5"
"68","000","00","004","0406","0974","447","366","81","23","470","1000","0","47.0","36.6"
"68","000","00","004","0407","0000","2189","1781","408","129","2318","4112","0","56.37","43.31"
"68","000","00","004","0407","1003","763","623","140","30","793","1448","0","54.77","43.02"
"68","000","00","004","0407","1004","720","578","142","44","764","1351","0","56.55","42.78"
"68","000","00","004","0407","1005","706","580","126","55","761","1313","0","57.96","44.17"
"68","000","00","004","0408","0000","1322","1078","244","48","1370","2602","0","52.65","41.43"
"68","000","00","004","0408","0989","596","487","109","29","625","1194","0","52.35","40.79"
"68","000","00","004","0408","0990","726","591","135","19","745","1408","0","52.91","41.97"
"68","000","00","004","0409","0000","997","809","188","53","1050","2027","0","51.8","39.91"
"68","000","00","004","0409","0963","997","809","188","53","1050","2027","0","51.8","39.91"
"68","000","00","004","0410","0000","1736","1539","197","74","1810","3300","0","54.85","46.64"
"68","000","00","004","0410","0956","850","802","48","25","875","1713","0","51.08","46.82"
"68","000","00","004","0410","0957","886","737","149","49","935","1587","0","58.92","46.44"
"68","000","00","004","0411","0000","745","601","144","55","800","1434","0","55.79","41.91"
"68","000","00","004","0411","0929","745","601","144","55","800","1434","0","55.79","41.91"
"68","000","00","004","0412","0000","627","523","104","24","651","1137","0","57.26","46.0"
"68","000","00","004","0412","0932","627","523","104","24","651","1137","0","57.26","46.0"
"68","000","00","004","0413","0000","2476","1976","500","157","2633","5314","0","49.55","37.18"
"68","000","00","004","0413","0936","766","598","168","48","814","1449","0","56.18","41.27"
"68","000","00","004","0413","0937","812","653","159","53","865","1877","0","46.08","34.79"
"68","000","00","004","0413","0938","898","725","173","56","954","1988","0","47.99","36.47"
"68","000","00","004","0414","0000","2023","1655","368","67","2090","4219","0","49.54","39.23"
"68","000","00","004","0414","0933","1063","884","179","36","1099","2211","0","49.71","39.98"
"68","000","00","004","0414","0934","960","771","189","31","991","2008","0","49.35","38.4"
"68","000","00","004","0415","0000","1803","1475","328","63","1866","3730","0","50.03","39.54"
"68","000","00","004","0415","0942","890","733","157","32","922","1848","0","49.89","39.66"
"68","000","00","004","0415","0943","913","742","171","31","944","1882","0","50.16","39.43"
"68","000","00","004","0416","0000","1643","1367","276","64","1707","3657","0","46.68","37.38"
"68","000","00","004","0416","0991","735","608","127","32","767","1737","0","44.16","35.0"
"68","000","00","004","0416","0992","908","759","149","32","940","1920","0","48.96","39.53"
"68","000","00","004","0417","0000","1642","1344","298","83","1725","3378","0","51.07","39.79"
"68","000","00","004","0417","0997","820","671","149","55","875","1692","0","51.71","39.66"
"68","000","00","004","0417","0998","822","673","149","28","850","1686","0","50.42","39.92"
"68","000","00","004","0418","0000","2167","1782","385","126","2293","3923","0","58.45","45.42"
"68","000","00","004","0418","0926","657","526","131","50","707","1269","0","55.71","41.45"
"68","000","00","004","0418","0927","724","599","125","42","766","1246","0","61.48","48.07"
"68","000","00","004","0418","0928","786","657","129","34","820","1408","0","58.24","46.66"
"68","000","00","004","0419","0000","1478","1216","262","88","1566","3172","0","49.37","38.34"
"68","000","00","004","0419","0930","723","601","122","45","768","1515","0","50.69","39.67"
"68","000","00","004","0419","0931","755","615","140","43","798","1657","0","48.16","37.12"
"68","000","00","004","0420","0000","854","706","148","66","920","1861","0","49.44","37.94"
"68","000","00","004","0420","0977","854","706","148","66","920","1861","0","49.44","37.94"
"68","000","00","004","0421","0000","1753","1442","311","115","1868","3841","0","48.63","37.54"
"68","000","00","004","0421","0975","977","811","166","73","1050","2290","0","45.85","35.41"
"68","000","00","004","0421","0976","776","631","145","42","818","1551","0","52.74","40.68"
"68","000","00","004","0422","0000","1323","947","376","98","1421","2685","0","52.92","35.27"
"68","000","00","004","0422","0980","742","601","141","57","799","1498","0","53.34","40.12"
"68","000","00","004","0422","0981","581","346","235","41","622","1187","0","52.4","29.15"
"68","000","00","004","0423","0000","1746","1372","374","63","1809","3752","0","48.21","36.57"
"68","000","00","004","0423","1006","842","650","192","33","875","1689","0","51.81","38.48"
"68","000","00","004","0423","1007","904","722","182","30","934","2063","0","45.27","35.0"
"68","000","00","004","0424","0000","1367","1123","244","96","1463","2694","0","54.31","41.69"
"68","000","00","004","0424","0982","653","522","131","55","708","1270","0","55.75","41.1"
"68","000","00","004","0424","0983","714","601","113","41","755","1424","0","53.02","42.21"
"68","000","00","004","0425","0000","2368","1944","424","140","2508","5412","0","46.34","35.92"
"68","000","00","004","0425","0986","755","592","163","60","815","1783","0","45.71","33.2"
"68","000","00","004","0425","0987","788","680","108","21","809","1709","0","47.34","39.79"
"68","000","00","004","0425","0988","825","672","153","59","884","1920","0","46.04","35.0"
"68","000","00","004","0426","0000","1591","1321","270","55","1646","3007","0","54.74","43.93"
"68","000","00","004","0426","0958","751","622","129","24","775","1416","0","54.73","43.93"
"68","000","00","004","0426","0959","840","699","141","31","871","1591","0","54.75","43.93"
"68","000","00","004","0427","0000","2971","2536","435","118","3089","6381","0","48.41","39.74"
"68","000","00","004","0427","0950","949","744","205","41","990","2101","0","47.12","35.41"
"68","000","00","004","0427","0951","1024","940","84","47","1071","2054","0","52.14","45.76"
"68","000","00","004","0427","0952","998","852","146","30","1028","2226","0","46.18","38.27"
"68","000","00","004","0428","0000","1789","1440","349","72","1861","3687","0","50.47","39.06"
"68","000","00","004","0428","0946","665","554","111","16","681","1562","0","43.6","35.47"
"68","000","00","004","0428","0947","1124","886","238","56","1180","2125","0","55.53","41.69"
"68","000","00","004","0429","0000","1560","1263","297","55","1615","3248","0","49.72","38.89"
"68","000","00","004","0429","0953","729","602","127","13","742","1405","0","52.81","42.85"
"68","000","00","004","0429","0954","831","661","170","42","873","1843","0","47.37","35.87"
"68","000","00","004","0430","0000","1673","1353","320","126","1799","3347","0","53.75","40.42"
"68","000","00","004","0430","0971","813","653","160","51","864","1589","0","54.37","41.1"
"68","000","00","004","0430","0972","860","700","160","75","935","1758","0","53.19","39.82"
"68","000","00","004","0431","0000","1695","1362","333","84","1779","3883","0","45.82","35.08"
"68","000","00","004","0431","0995","893","715","178","52","945","2020","0","46.78","35.4"
"68","000","00","004","0431","0996","802","647","155","32","834","1863","0","44.77","34.73"
"68","000","00","004","0432","0000","1737","1411","326","120","1857","3492","0","53.18","40.41"
"68","000","00","004","0432","1001","877","711","166","51","928","1603","0","57.89","44.35"
"68","000","00","004","0432","1002","860","700","160","69","929","1889","0","49.18","37.06"
"68","000","00","004","0433","0000","1660","1354","306","70","1730","3183","0","54.35","42.54"
"68","000","00","004","0433","0999","834","659","175","53","887","1626","0","54.55","40.53"
"68","000","00","004","0433","1000","826","695","131","17","843","1557","0","54.14","44.64"
"68","000","00","004","0434","0000","2734","2293","441","84","2818","5546","0","50.81","41.35"
"68","000","00","004","0434","0939","959","791","168","28","987","1931","0","51.11","40.96"
"68","000","00","004","0434","0940","918","760","158","31","949","1938","0","48.97","39.22"
"68","000","00","004","0434","0941","857","742","115","25","882","1677","0","52.59","44.25"
"68","000","00","004","0435","0000","983","793","190","36","1019","1911","0","53.32","41.5"
"68","000","00","004","0435","0935","983","793","190","36","1019","1911","0","53.32","41.5"
"68","000","00","004","0436","0000","1482","1227","255","58","1540","3479","0","44.27","35.27"
"68","000","00","004","0436","0944","582","479","103","21","603","1541","0","39.13","31.08"
"68","000","00","004","0436","0945","900","748","152","37","937","1938","0","48.35","38.6"
"68","000","00","004","0437","0000","1402","1100","302","82","1484","2725","0","54.46","40.37"
"68","000","00","004","0437","0993","623","483","140","32","655","1234","0","53.08","39.14"
"68","000","00","004","0437","0994","779","617","162","50","829","1491","0","55.6","41.38"
"68","000","00","004","0438","0000","1318","1070","248","81","1399","2926","0","47.81","36.57"
"68","000","00","004","0438","0978","499","394","105","38","537","1141","0","47.06","34.53"
"68","000","00","004","0438","0979","819","676","143","43","862","1785","0","48.29","37.87"
"68","000","00","004","0439","0000","982","796","186","53","1035","2324","0","44.54","34.25"
"68","000","00","004","0439","0955","982","796","186","53","1035","2324","0","44.54","34.25"
"68","000","00","004","0440","0000","1707","1392","315","70","1777","3323","0","53.48","41.89"
"68","000","00","004","0440","0948","847","692","155","41","888","1516","0","58.58","45.65"
"68","000","00","004","0440","0949","860","700","160","29","889","1807","0","49.2","38.74"
"68","000","00","004","0441","0000","1308","1120","188","50","1358","2807","0","48.38","39.9"
"68","000","00","004","0441","0984","647","620","27","23","670","1273","0","52.63","48.7"
"68","000","00","004","0441","0985","661","500","161","27","688","1534","0","44.85","32.59"
"68","000","00","005","0000","0000","61105","48141","12964","3805","64910","129252","164057","50.22","37.25"
"68","000","00","005","0501","0000","1311","955","356","160","1471","2896","0","50.79","32.98"
"68","000","00","005","0501","0396","626","462","164","75","701","1358","0","51.62","34.02"
"68","000","00","005","0501","0397","685","493","192","85","770","1538","0","50.07","32.05"
"68","000","00","005","0502","0000","1683","1334","349","123","1806","3791","0","47.64","35.19"
"68","000","00","005","0502","0398","815","646","169","62","877","2118","0","41.41","30.5"
"68","000","00","005","0502","0399","868","688","180","61","929","1673","0","55.53","41.12"
"68","000","00","005","0503","0000","2104","1681","423","113","2217","4816","0","46.03","34.9"
"68","000","00","005","0503","0404","622","491","131","24","646","1446","0","44.67","33.96"
"68","000","00","005","0503","0405","699","548","151","54","753","1623","0","46.4","33.76"
"68","000","00","005","0503","0406","783","642","141","35","818","1747","0","46.82","36.75"
"68","000","00","005","0504","0000","2023","1689","334","119","2142","4687","0","45.7","36.04"
"68","000","00","005","0504","0411","1032","799","233","59","1091","2189","0","49.84","36.5"
"68","000","00","005","0504","0412","991","890","101","60","1051","2498","0","42.07","35.63"
"68","000","00","005","0506","0000","1668","1267","401","163","1831","4088","0","44.79","30.99"
"68","000","00","005","0506","0414","759","576","183","86","845","1991","0","42.44","28.93"
"68","000","00","005","0506","0415","909","691","218","77","986","2097","0","47.02","32.95"
"68","000","00","005","0507","0000","1646","1268","378","94","1740","3567","0","48.78","35.55"
"68","000","00","005","0507","0430","892","692","200","69","961","1864","0","51.56","37.12"
"68","000","00","005","0507","0431","754","576","178","25","779","1703","0","45.74","33.82"
"68","000","00","005","0508","0000","1869","1447","422","101","1970","3815","0","51.64","37.93"
"68","000","00","005","0508","0432","878","682","196","33","911","1893","0","48.12","36.03"
"68","000","00","005","0508","0433","991","765","226","68","1059","1922","0","55.1","39.8"
"68","000","00","005","0509","0000","1150","908","242","70","1220","2380","0","51.26","38.15"
"68","000","00","005","0509","0440","665","542","123","48","713","1181","0","60.37","45.89"
"68","000","00","005","0509","0441","485","366","119","22","507","1199","0","42.29","30.53"
"68","000","00","005","0510","0000","1166","895","271","153","1319","2521","0","52.32","35.5"
"68","000","00","005","0510","0459","506","394","112","55","561","1318","0","42.56","29.89"
"68","000","00","005","0510","0460","660","501","159","98","758","1203","0","63.01","41.65"
"68","000","00","005","0511","0000","769","600","169","30","799","1771","0","45.12","33.88"
"68","000","00","005","0511","0461","769","600","169","30","799","1771","0","45.12","33.88"
"68","000","00","005","0512","0000","1560","1160","400","188","1748","3595","0","48.62","32.27"
"68","000","00","005","0512","0462","769","567","202","90","859","1832","0","46.89","30.95"
"68","000","00","005","0512","0463","791","593","198","98","889","1763","0","50.43","33.64"
"68","000","00","005","0513","0000","573","421","152","21","594","1497","0","39.68","28.12"
"68","000","00","005","0513","0464","573","421","152","21","594","1497","0","39.68","28.12"
"68","000","00","005","0514","0000","871","666","205","118","989","1671","0","59.19","39.86"
"68","000","00","005","0514","0465","871","666","205","118","989","1671","0","59.19","39.86"
"68","000","00","005","0515","0000","1215","924","291","187","1402","2488","0","56.35","37.14"
"68","000","00","005","0515","0466","461","363","98","72","533","929","0","57.37","39.07"
"68","000","00","005","0515","0467","754","561","193","115","869","1559","0","55.74","35.98"
"68","000","00","005","0516","0000","1538","1226","312","122","1660","2938","0","56.5","41.73"
"68","000","00","005","0516","0468","713","585","128","34","747","1497","0","49.9","39.08"
"68","000","00","005","0516","0469","825","641","184","88","913","1441","0","63.36","44.48"
"68","000","00","005","0517","0000","1482","1176","306","51","1533","3161","0","48.5","37.2"
"68","000","00","005","0517","0428","687","523","164","20","707","1668","0","42.39","31.35"
"68","000","00","005","0517","0429","795","653","142","31","826","1493","0","55.32","43.74"
"68","000","00","005","0518","0000","2497","1995","502","120","2617","5039","0","51.93","39.59"
"68","000","00","005","0518","0416","817","649","168","30","847","1558","0","54.36","41.66"
"68","000","00","005","0518","0417","947","748","199","51","998","1891","0","52.78","39.56"
"68","000","00","005","0518","0418","733","598","135","39","772","1590","0","48.55","37.61"
"68","000","00","005","0519","0000","1199","937","262","61","1260","2588","0","48.69","36.21"
"68","000","00","005","0519","0438","586","440","146","27","613","1232","0","49.76","35.71"
"68","000","00","005","0519","0439","613","497","116","34","647","1356","0","47.71","36.65"
"68","000","00","005","0520","0000","1497","1167","330","109","1606","3150","0","50.98","37.05"
"68","000","00","005","0520","0436","814","646","168","41","855","1688","0","50.65","38.27"
"68","000","00","005","0520","0437","683","521","162","68","751","1462","0","51.37","35.64"
"68","000","00","005","0521","0000","659","499","160","28","687","1322","0","51.97","37.75"
"68","000","00","005","0521","0413","659","499","160","28","687","1322","0","51.97","37.75"
"68","000","00","005","0522","0000","1664","1310","354","111","1775","3425","0","51.82","38.25"
"68","000","00","005","0522","0407","952","744","208","69","1021","1988","0","51.36","37.42"
"68","000","00","005","0522","0408","712","566","146","42","754","1437","0","52.47","39.39"
"68","000","00","005","0523","0000","1429","1150","279","114","1543","2979","0","51.8","38.6"
"68","000","00","005","0523","0409","785","609","176","68","853","1532","0","55.68","39.75"
"68","000","00","005","0523","0410","644","541","103","46","690","1447","0","47.68","37.39"
"68","000","00","005","0524","0000","1591","1260","331","110","1701","3172","0","53.63","39.72"
"68","000","00","005","0524","0457","798","609","189","56","854","1483","0","57.59","41.07"
"68","000","00","005","0524","0458","793","651","142","54","847","1689","0","50.15","38.54"
"68","000","00","005","0525","0000","2079","1652","427","86","2165","4595","0","47.12","35.95"
"68","000","00","005","0525","0453","1250","992","258","52","1302","2727","0","47.74","36.38"
"68","000","00","005","0525","0454","829","660","169","34","863","1868","0","46.2","35.33"
"68","000","00","005","0526","0000","2037","1608","429","77","2114","4233","0","49.94","37.99"
"68","000","00","005","0526","0446","986","782","204","40","1026","2055","0","49.93","38.05"
"68","000","00","005","0526","0447","1051","826","225","37","1088","2178","0","49.95","37.92"
"68","000","00","005","0527","0000","1683","1359","324","77","1760","3551","0","49.56","38.27"
"68","000","00","005","0527","0425","795","642","153","41","836","1731","0","48.3","37.09"
"68","000","00","005","0527","0426","888","717","171","36","924","1820","0","50.77","39.4"
"68","000","00","005","0528","0000","2228","1743","485","95","2323","4926","0","47.16","35.38"
"68","000","00","005","0528","0419","1027","798","229","46","1073","2404","0","44.63","33.19"
"68","000","00","005","0528","0420","1201","945","256","49","1250","2522","0","49.56","37.47"
"68","000","00","005","0529","0000","1633","1309","324","85","1718","3348","0","51.31","39.1"
"68","000","00","005","0529","0421","808","648","160","34","842","1633","0","51.56","39.68"
"68","000","00","005","0529","0422","825","661","164","51","876","1715","0","51.08","38.54"
"68","000","00","005","0530","0000","803","656","147","72","875","1633","0","53.58","40.17"
"68","000","00","005","0530","0427","803","656","147","72","875","1633","0","53.58","40.17"
"68","000","00","005","0531","0000","2799","2234","565","130","2929","5379","0","54.45","41.53"
"68","000","00","005","0531","0449","870","699","171","43","913","1667","0","54.77","41.93"
"68","000","00","005","0531","0450","913","729","184","34","947","1745","0","54.27","41.78"
"68","000","00","005","0531","0451","1016","806","210","53","1069","1967","0","54.35","40.98"
"68","000","00","005","0532","0000","1840","1485","355","69","1909","3511","0","54.37","42.3"
"68","000","00","005","0532","0448","883","719","164","34","917","1709","0","53.66","42.07"
"68","000","00","005","0532","0452","957","766","191","35","992","1802","0","55.05","42.51"
"68","000","00","005","0533","0000","1558","1274","284","72","1630","3133","0","52.03","40.66"
"68","000","00","005","0533","0442","886","729","157","34","920","1710","0","53.8","42.63"
"68","000","00","005","0533","0443","672","545","127","38","710","1423","0","49.89","38.3"
"68","000","00","005","0534","0000","1601","1269","332","87","1688","3161","0","53.4","40.15"
"68","000","00","005","0534","0444","775","601","174","38","813","1522","0","53.42","39.49"
"68","000","00","005","0534","0445","826","668","158","49","875","1639","0","53.39","40.76"
"68","000","00","005","0535","0000","1399","1109","290","71","1470","2731","0","53.83","40.61"
"68","000","00","005","0535","0434","704","561","143","32","736","1393","0","52.84","40.27"
"68","000","00","005","0535","0435","695","548","147","39","734","1338","0","54.86","40.96"
"68","000","00","005","0536","0000","2092","1687","405","83","2175","4604","0","47.24","36.64"
"68","000","00","005","0536","0402","1081","882","199","59","1140","2250","0","50.67","39.2"
"68","000","00","005","0536","0403","1011","805","206","24","1035","2354","0","43.97","34.2"
"68","000","00","005","0537","0000","1607","1247","360","77","1684","3199","0","52.64","38.98"
"68","000","00","005","0537","0400","748","578","170","30","778","1500","0","51.87","38.53"
"68","000","00","005","0537","0401","859","669","190","47","906","1699","0","53.33","39.38"
"68","000","00","005","0538","0000","1533","1184","349","83","1616","3153","0","51.25","37.55"
"68","000","00","005","0538","0455","732","573","159","42","774","1537","0","50.36","37.28"
"68","000","00","005","0538","0456","801","611","190","41","842","1616","0","52.1","37.81"
"68","000","00","005","0539","0000","1877","1495","382","81","1958","4244","0","46.14","35.23"
"68","000","00","005","0539","0423","944","738","206","34","978","2215","0","44.15","33.32"
"68","000","00","005","0539","0424","933","757","176","47","980","2029","0","48.3","37.31"
"68","000","00","005","0540","0000","1172","895","277","94","1266","2494","0","50.76","35.89"
"68","000","00","005","0540","0470","688","535","153","49","737","1465","0","50.31","36.52"
"68","000","00","005","0540","0471","484","360","124","45","529","1029","0","51.41","34.99"
"68","000","00","006","0000","0000","34049","26894","7155","2005","36054","73900","90407","48.79","36.39"
"68","000","00","006","0601","0000","2821","2181","640","169","2990","6145","0","48.66","35.49"
"68","000","00","006","0601","0472","654","507","147","50","704","1538","0","45.77","32.96"
"68","000","00","006","0601","0473","598","464","134","29","627","1616","0","38.8","28.71"
"68","000","00","006","0601","0474","772","584","188","49","821","1437","0","57.13","40.64"
"68","000","00","006","0601","0475","797","626","171","41","838","1554","0","53.93","40.28"
"68","000","00","006","0602","0000","2992","2380","612","204","3196","6471","0","49.39","36.78"
"68","000","00","006","0602","0476","602","470","132","37","639","1237","0","51.66","38.0"
"68","000","00","006","0602","0477","629","511","118","65","694","1347","0","51.52","37.94"
"68","000","00","006","0602","0478","582","456","126","27","609","1261","0","48.3","36.16"
"68","000","00","006","0602","0479","593","479","114","43","636","1256","0","50.64","38.14"
"68","000","00","006","0602","0480","586","464","122","32","618","1370","0","45.11","33.87"
"68","000","00","006","0603","0000","1963","1528","435","112","2075","4617","0","44.94","33.1"
"68","000","00","006","0603","0481","700","541","159","44","744","1610","0","46.21","33.6"
"68","000","00","006","0603","0482","662","511","151","48","710","1419","0","50.04","36.01"
"68","000","00","006","0603","0483","601","476","125","20","621","1588","0","39.11","29.97"
"68","000","00","006","0604","0000","768","608","160","38","806","1612","0","50.0","37.72"
"68","000","00","006","0604","0484","768","608","160","38","806","1612","0","50.0","37.72"
"68","000","00","006","0605","0000","4908","3887","1021","263","5171","10011","0","51.65","38.83"
"68","000","00","006","0605","0485","669","521","148","42","711","1440","0","49.38","36.18"
"68","000","00","006","0605","0486","613","480","133","33","646","1326","0","48.72","36.2"
"68","000","00","006","0605","0487","769","628","141","51","820","1455","0","56.36","43.16"
"68","000","00","006","0605","0488","776","607","169","61","837","1562","0","53.59","38.86"
"68","000","00","006","0605","0489","683","543","140","30","713","1284","0","55.53","42.29"
"68","000","00","006","0605","0490","663","522","141","23","686","1454","0","47.18","35.9"
"68","000","00","006","0605","0491","735","586","149","23","758","1490","0","50.87","39.33"
"68","000","00","006","0606","0000","2154","1670","484","197","2351","4861","0","48.36","34.36"
"68","000","00","006","0606","0492","665","511","154","46","711","1617","0","43.97","31.6"
"68","000","00","006","0606","0493","710","553","157","90","800","1594","0","50.19","34.69"
"68","000","00","006","0606","0494","779","606","173","61","840","1650","0","50.91","36.73"
"68","000","00","006","0607","0000","2711","2133","578","134","2845","5896","0","48.25","36.18"
"68","000","00","006","0607","0495","644","502","142","20","664","1467","0","45.26","34.22"
"68","000","00","006","0607","0496","706","546","160","35","741","1494","0","49.6","36.55"
"68","000","00","006","0607","0497","716","574","142","57","773","1538","0","50.26","37.32"
"68","000","00","006","0607","0498","645","511","134","22","667","1397","0","47.75","36.58"
"68","000","00","006","0608","0000","735","586","149","16","751","1637","0","45.88","35.8"
"68","000","00","006","0608","0499","735","586","149","16","751","1637","0","45.88","35.8"
"68","000","00","006","0610","0000","1391","1107","284","101","1492","2866","0","52.06","38.63"
"68","000","00","006","0610","0500","647","519","128","55","702","1452","0","48.35","35.74"
"68","000","00","006","0610","0501","744","588","156","46","790","1414","0","55.87","41.58"
"68","000","00","006","0611","0000","2900","2252","648","149","3049","6871","0","44.37","32.78"
"68","000","00","006","0611","0502","762","583","179","44","806","1670","0","48.26","34.91"
"68","000","00","006","0611","0503","726","573","153","17","743","1701","0","43.68","33.69"
"68","000","00","006","0611","0504","694","528","166","40","734","1813","0","40.49","29.12"
"68","000","00","006","0611","0505","718","568","150","48","766","1687","0","45.41","33.67"
"68","000","00","006","0612","0000","1631","1400","231","59","1690","3206","0","52.71","43.67"
"68","000","00","006","0612","0506","805","749","56","11","816","1650","0","49.45","45.39"
"68","000","00","006","0612","0507","826","651","175","48","874","1556","0","56.17","41.84"
"68","000","00","006","0613","0000","777","620","157","38","815","1844","0","44.2","33.62"
"68","000","00","006","0613","0508","777","620","157","38","815","1844","0","44.2","33.62"
"68","000","00","006","0614","0000","1310","1012","298","128","1438","2750","0","52.29","36.8"
"68","000","00","006","0614","0509","591","475","116","62","653","1336","0","48.88","35.55"
"68","000","00","006","0614","0510","719","537","182","66","785","1414","0","55.52","37.98"
"68","000","00","006","0615","0000","1377","1086","291","97","1474","2465","0","59.8","44.06"
"68","000","00","006","0615","0511","687","541","146","48","735","1238","0","59.37","43.7"
"68","000","00","006","0615","0512","690","545","145","49","739","1227","0","60.23","44.42"
"68","000","00","006","0616","0000","1033","857","176","47","1080","2548","0","42.39","33.63"
"68","000","00","006","0616","0513","562","424","138","20","582","1199","0","48.54","35.36"
"68","000","00","006","0616","0514","471","433","38","27","498","1349","0","36.92","32.1"
"68","000","00","006","0617","0000","1037","821","216","60","1097","2200","0","49.86","37.32"
"68","000","00","006","0617","0515","523","414","109","29","552","1120","0","49.29","36.96"
"68","000","00","006","0617","0516","514","407","107","31","545","1080","0","50.46","37.69"
"68","000","00","006","0618","0000","1298","998","300","69","1367","2686","0","50.89","37.16"
"68","000","00","006","0618","0517","622","491","131","36","658","1341","0","49.07","36.61"
"68","000","00","006","0618","0518","676","507","169","33","709","1345","0","52.71","37.7"
"68","000","00","006","0619","0000","2243","1768","475","124","2367","5214","0","45.4","33.91"
"68","000","00","006","0619","0519","682","548","134","43","725","1565","0","46.33","35.02"
"68","000","00","006","0619","0520","634","483","151","23","657","1519","0","43.25","31.8"
"68","000","00","006","0619","0521","927","737","190","58","985","2130","0","46.24","34.6"
"68","000","00","007","0000","0000","60705","47936","12769","3366","64071","131702","160182","48.65","36.4"
"68","000","00","007","0701","0000","1855","1435","420","90","1945","3735","0","52.07","38.42"
"68","000","00","007","0701","0270","703","530","173","20","723","1455","0","49.69","36.43"
"68","000","00","007","0701","0271","1152","905","247","70","1222","2280","0","53.6","39.69"
"68","000","00","007","0702","0000","3199","2505","694","239","3438","6706","0","51.27","37.35"
"68","000","00","007","0702","0231","1049","816","233","62","1111","2178","0","51.01","37.47"
"68","000","00","007","0702","0232","802","617","185","91","893","1672","0","53.41","36.9"
"68","000","00","007","0702","0233","645","532","113","39","684","1376","0","49.71","38.66"
"68","000","00","007","0702","0234","703","540","163","47","750","1480","0","50.68","36.49"
"68","000","00","007","0703","0000","1979","1500","479","145","2124","4353","0","48.79","34.46"
"68","000","00","007","0703","0261","405","316","89","22","427","841","0","50.77","37.57"
"68","000","00","007","0703","0262","982","736","246","64","1046","2284","0","45.8","32.22"
"68","000","00","007","0703","0263","592","448","144","59","651","1228","0","53.01","36.48"
"68","000","00","007","0704","0000","2797","2229","568","168","2965","5735","0","51.7","38.87"
"68","000","00","007","0704","0235","654","521","133","35","689","1258","0","54.77","41.41"
"68","000","00","007","0704","0236","709","588","121","28","737","1464","0","50.34","40.16"
"68","000","00","007","0704","0237","852","663","189","84","936","1844","0","50.76","35.95"
"68","000","00","007","0704","0238","582","457","125","21","603","1169","0","51.58","39.09"
"68","000","00","007","0705","0000","1513","1199","314","90","1603","3253","0","49.28","36.86"
"68","000","00","007","0705","0245","863","692","171","42","905","1788","0","50.62","38.7"
"68","000","00","007","0705","0246","650","507","143","48","698","1465","0","47.65","34.61"
"68","000","00","007","0706","0000","2408","1905","503","101","2509","5386","0","46.58","35.37"
"68","000","00","007","0706","0239","711","561","150","23","734","1921","0","38.21","29.2"
"68","000","00","007","0706","0240","765","603","162","26","791","1694","0","46.69","35.6"
"68","000","00","007","0706","0241","932","741","191","52","984","1771","0","55.56","41.84"
"68","000","00","007","0707","0000","1845","1614","231","111","1956","3629","0","53.9","44.48"
"68","000","00","007","0707","0220","890","793","97","55","945","1744","0","54.19","45.47"
"68","000","00","007","0707","0221","955","821","134","56","1011","1885","0","53.63","43.55"
"68","000","00","007","0708","0000","2475","2059","416","111","2586","5033","0","51.38","40.91"
"68","000","00","007","0708","0217","465","404","61","17","482","874","0","55.15","46.22"
"68","000","00","007","0708","0218","1005","845","160","66","1071","2014","0","53.18","41.96"
"68","000","00","007","0708","0219","1005","810","195","28","1033","2145","0","48.16","37.76"
"68","000","00","007","0709","0000","582","453","129","34","616","1156","0","53.29","39.19"
"68","000","00","007","0709","0276","582","453","129","34","616","1156","0","53.29","39.19"
"68","000","00","007","0710","0000","1659","1258","401","73","1732","3553","0","48.75","35.41"
"68","000","00","007","0710","0272","802","606","196","35","837","1668","0","50.18","36.33"
"68","000","00","007","0710","0273","857","652","205","38","895","1885","0","47.48","34.59"
"68","000","00","007","0711","0000","886","661","225","92","978","1840","0","53.15","35.92"
"68","000","00","007","0711","0289","886","661","225","92","978","1840","0","53.15","35.92"
"68","000","00","007","0712","0000","852","680","172","47","899","1917","0","46.9","35.47"
"68","000","00","007","0712","0267","852","680","172","47","899","1917","0","46.9","35.47"
"68","000","00","007","0713","0000","2104","1635","469","136","2240","4707","0","47.59","34.74"
"68","000","00","007","0713","0222","701","562","139","54","755","1546","0","48.84","36.35"
"68","000","00","007","0713","0223","769","595","174","55","824","1684","0","48.93","35.33"
"68","000","00","007","0713","0224","634","478","156","27","661","1477","0","44.75","32.36"
"68","000","00","007","0714","0000","2038","1644","394","174","2212","4832","0","45.78","34.02"
"68","000","00","007","0714","0242","731","570","161","51","782","1665","0","46.97","34.23"
"68","000","00","007","0714","0243","584","514","70","56","640","1439","0","44.48","35.72"
"68","000","00","007","0714","0244","723","560","163","67","790","1728","0","45.72","32.41"
"68","000","00","007","0715","0000","2740","2128","612","196","2936","5448","0","53.89","39.06"
"68","000","00","007","0715","0227","779","625","154","57","836","1525","0","54.82","40.98"
"68","000","00","007","0715","0228","560","430","130","45","605","1041","0","58.12","41.31"
"68","000","00","007","0715","0229","644","484","160","40","684","1404","0","48.72","34.47"
"68","000","00","007","0715","0230","757","589","168","54","811","1478","0","54.87","39.85"
"68","000","00","007","0716","0000","1862","1449","413","154","2016","3952","0","51.01","36.66"
"68","000","00","007","0716","0256","477","356","121","60","537","1005","0","53.43","35.42"
"68","000","00","007","0716","0257","727","592","135","33","760","1449","0","52.45","40.86"
"68","000","00","007","0716","0258","658","501","157","61","719","1498","0","48.0","33.44"
"68","000","00","007","0717","0000","812","589","223","72","884","1752","0","50.46","33.62"
"68","000","00","007","0717","0250","812","589","223","72","884","1752","0","50.46","33.62"
"68","000","00","007","0718","0000","1084","855","229","72","1156","2439","0","47.4","35.06"
"68","000","00","007","0718","0265","596","482","114","28","624","1378","0","45.28","34.98"
"68","000","00","007","0718","0266","488","373","115","44","532","1061","0","50.14","35.16"
"68","000","00","007","0719","0000","1659","1323","336","81","1740","4057","0","42.89","32.61"
"68","000","00","007","0719","0277","828","674","154","52","880","2114","0","41.63","31.88"
"68","000","00","007","0719","0278","831","649","182","29","860","1943","0","44.26","33.4"
"68","000","00","007","0720","0000","2766","2146","620","157","2923","6056","0","48.27","35.44"
"68","000","00","007","0720","0286","1046","822","224","59","1105","2187","0","50.53","37.59"
"68","000","00","007","0720","0287","894","718","176","58","952","1959","0","48.6","36.65"
"68","000","00","007","0720","0288","826","606","220","40","866","1910","0","45.34","31.73"
"68","000","00","007","0721","0000","1080","855","225","48","1128","2266","0","49.78","37.73"
"68","000","00","007","0721","0290","1080","855","225","48","1128","2266","0","49.78","37.73"
"68","000","00","007","0722","0000","1991","1585","406","99","2090","5170","0","40.43","30.66"
"68","000","00","007","0722","0247","641","517","124","46","687","1659","0","41.41","31.16"
"68","000","00","007","0722","0248","701","551","150","34","735","1693","0","43.41","32.55"
"68","000","00","007","0722","0249","649","517","132","19","668","1818","0","36.74","28.44"
"68","000","00","007","0723","0000","836","681","155","43","879","1979","0","44.42","34.41"
"68","000","00","007","0723","0264","836","681","155","43","879","1979","0","44.42","34.41"
"68","000","00","007","0724","0000","1545","1213","332","62","1607","3317","0","48.45","36.57"
"68","000","00","007","0724","0251","847","653","194","33","880","1818","0","48.4","35.92"
"68","000","00","007","0724","0252","698","560","138","29","727","1499","0","48.5","37.36"
"68","000","00","007","0725","0000","2709","2088","621","139","2848","5847","0","48.71","35.71"
"68","000","00","007","0725","0253","900","704","196","56","956","1916","0","49.9","36.74"
"68","000","00","007","0725","0254","858","659","199","41","899","1804","0","49.83","36.53"
"68","000","00","007","0725","0255","951","725","226","42","993","2127","0","46.69","34.09"
"68","000","00","007","0726","0000","1552","1222","330","64","1616","3920","0","41.22","31.17"
"68","000","00","007","0726","0259","915","704","211","46","961","2149","0","44.72","32.76"
"68","000","00","007","0726","0260","637","518","119","18","655","1771","0","36.98","29.25"
"68","000","00","007","0727","0000","2399","1897","502","132","2531","5139","0","49.25","36.91"
"68","000","00","007","0727","0279","792","615","177","43","835","1800","0","46.39","34.17"
"68","000","00","007","0727","0280","913","714","199","52","965","2020","0","47.77","35.35"
"68","000","00","007","0727","0281","694","568","126","37","731","1319","0","55.42","43.06"
"68","000","00","007","0728","0000","4022","3161","861","153","4175","8591","0","48.6","36.79"
"68","000","00","007","0728","0282","1123","876","247","46","1169","2229","0","52.45","39.3"
"68","000","00","007","0728","0283","913","690","223","21","934","1992","0","46.89","34.64"
"68","000","00","007","0728","0284","996","786","210","53","1049","2237","0","46.89","35.14"
"68","000","00","007","0728","0285","990","809","181","33","1023","2133","0","47.96","37.93"
"68","000","00","007","0729","0000","1771","1301","470","72","1843","3553","0","51.87","36.62"
"68","000","00","007","0729","0274","868","666","202","35","903","1849","0","48.84","36.02"
"68","000","00","007","0729","0275","903","635","268","37","940","1704","0","55.16","37.27"
"68","000","00","007","0730","0000","1074","882","192","70","1144","2956","0","38.7","29.84"
"68","000","00","007","0730","0225","797","669","128","56","853","1528","0","55.82","43.78"
"68","000","00","007","0730","0226","277","213","64","14","291","1428","0","20.38","14.92"
"68","000","00","007","0731","0000","2993","2463","530","91","3084","6452","0","47.8","38.17"
"68","000","00","007","0731","0291","1029","867","162","28","1057","2387","0","44.28","36.32"
"68","000","00","007","0731","0292","763","613","150","22","785","1692","0","46.39","36.23"
"68","000","00","007","0731","0293","444","355","89","16","460","904","0","50.88","39.27"
"68","000","00","007","0731","0294","757","628","129","25","782","1469","0","53.23","42.75"
"68","000","00","007","0732","0000","1618","1321","297","50","1668","2973","0","56.1","44.43"
"68","000","00","007","0732","0268","872","708","164","30","902","1540","0","58.57","45.97"
"68","000","00","007","0732","0269","746","613","133","20","766","1433","0","53.45","42.78"
"68","000","00","008","0000","0000","77782","62058","15724","4842","82624","165065","201493","50.06","37.6"
"68","000","00","008","0801","0000","2711","2180","531","176","2887","7162","0","40.31","30.44"
"68","000","00","008","0801","0295","756","610","146","90","846","1761","0","48.04","34.64"
"68","000","00","008","0801","0296","703","561","142","17","720","1804","0","39.91","31.1"
"68","000","00","008","0801","0297","480","378","102","32","512","1813","0","28.24","20.85"
"68","000","00","008","0801","0298","772","631","141","37","809","1784","0","45.35","35.37"
"68","000","00","008","0802","0000","3516","2914","602","175","3691","8278","0","44.59","35.2"
"68","000","00","008","0802","0299","919","794","125","47","966","2257","0","42.8","35.18"
"68","000","00","008","0802","0300","712","596","116","29","741","1857","0","39.9","32.09"
"68","000","00","008","0802","0301","952","784","168","44","996","2261","0","44.05","34.67"
"68","000","00","008","0802","0302","933","740","193","55","988","1903","0","51.92","38.89"
"68","000","00","008","0803","0000","1601","1309","292","84","1685","3620","0","46.55","36.16"
"68","000","00","008","0803","0303","911","750","161","66","977","1955","0","49.97","38.36"
"68","000","00","008","0803","0304","690","559","131","18","708","1665","0","42.52","33.57"
"68","000","00","008","0804","0000","1540","1265","275","104","1644","3216","0","51.12","39.33"
"68","000","00","008","0804","0310","831","670","161","73","904","1630","0","55.46","41.1"
"68","000","00","008","0804","0311","709","595","114","31","740","1586","0","46.66","37.52"
"68","000","00","008","0805","0000","1597","1282","315","152","1749","3559","0","49.14","36.02"
"68","000","00","008","0805","0312","794","625","169","61","855","1649","0","51.85","37.9"
"68","000","00","008","0805","0313","803","657","146","91","894","1910","0","46.81","34.4"
"68","000","00","008","0806","0000","1632","1328","304","112","1744","3252","0","53.63","40.84"
"68","000","00","008","0806","0314","818","641","177","72","890","1612","0","55.21","39.76"
"68","000","00","008","0806","0315","814","687","127","40","854","1640","0","52.07","41.89"
"68","000","00","008","0807","0000","1584","1275","309","113","1697","3273","0","51.85","38.96"
"68","000","00","008","0807","0318","818","640","178","47","865","1711","0","50.56","37.41"
"68","000","00","008","0807","0319","766","635","131","66","832","1562","0","53.27","40.65"
"68","000","00","008","0808","0000","2201","1771","430","135","2336","4415","0","52.91","40.11"
"68","000","00","008","0808","0320","824","682","142","59","883","1735","0","50.89","39.31"
"68","000","00","008","0808","0321","806","650","156","38","844","1658","0","50.9","39.2"
"68","000","00","008","0808","0322","571","439","132","38","609","1022","0","59.59","42.95"
"68","000","00","008","0809","0000","1501","1209","292","81","1582","3414","0","46.34","35.41"
"68","000","00","008","0809","0323","723","581","142","47","770","1673","0","46.03","34.73"
"68","000","00","008","0809","0324","778","628","150","34","812","1741","0","46.64","36.07"
"68","000","00","008","0810","0000","1021","798","223","62","1083","2110","0","51.33","37.82"
"68","000","00","008","0810","0325","1021","798","223","62","1083","2110","0","51.33","37.82"
"68","000","00","008","0811","0000","1360","1097","263","85","1445","2519","0","57.36","43.55"
"68","000","00","008","0811","0331","729","578","151","35","764","1341","0","56.97","43.1"
"68","000","00","008","0811","0332","631","519","112","50","681","1178","0","57.81","44.06"
"68","000","00","008","0812","0000","1478","1266","212","126","1604","3871","0","41.44","32.7"
"68","000","00","008","0812","0335","794","733","61","49","843","1943","0","43.39","37.73"
"68","000","00","008","0812","0336","684","533","151","77","761","1928","0","39.47","27.65"
"68","000","00","008","0813","0000","1455","1118","337","74","1529","3147","0","48.59","35.53"
"68","000","00","008","0813","0339","867","665","202","35","902","1947","0","46.33","34.16"
"68","000","00","008","0813","0340","588","453","135","39","627","1200","0","52.25","37.75"
"68","000","00","008","0814","0000","1680","1306","374","133","1813","3883","0","46.69","33.63"
"68","000","00","008","0814","0341","823","641","182","71","894","1895","0","47.18","33.83"
"68","000","00","008","0814","0342","857","665","192","62","919","1988","0","46.23","33.45"
"68","000","00","008","0815","0000","1751","1389","362","126","1877","3410","0","55.04","40.73"
"68","000","00","008","0815","0348","650","503","147","63","713","1317","0","54.14","38.19"
"68","000","00","008","0815","0349","1101","886","215","63","1164","2093","0","55.61","42.33"
"68","000","00","008","0816","0000","1719","1386","333","87","1806","3545","0","50.94","39.1"
"68","000","00","008","0816","0351","853","676","177","54","907","1782","0","50.9","37.93"
"68","000","00","008","0816","0352","866","710","156","33","899","1763","0","50.99","40.27"
"68","000","00","008","0817","0000","3272","2684","588","178","3450","6933","0","49.76","38.71"
"68","000","00","008","0817","0359","963","774","189","62","1025","1998","0","51.3","38.74"
"68","000","00","008","0817","0360","477","386","91","30","507","916","0","55.35","42.14"
"68","000","00","008","0817","0361","881","720","161","47","928","1943","0","47.76","37.06"
"68","000","00","008","0817","0362","951","804","147","39","990","2076","0","47.69","38.73"
"68","000","00","008","0818","0000","776","626","150","63","839","1505","0","55.75","41.59"
"68","000","00","008","0818","0371","776","626","150","63","839","1505","0","55.75","41.59"
"68","000","00","008","0819","0000","1605","1272","333","136","1741","3303","0","52.71","38.51"
"68","000","00","008","0819","0373","810","605","205","67","877","1618","0","54.2","37.39"
"68","000","00","008","0819","0374","795","667","128","69","864","1685","0","51.28","39.58"
"68","000","00","008","0820","0000","1669","1372","297","108","1777","3716","0","47.82","36.92"
"68","000","00","008","0820","0375","788","648","140","52","840","1835","0","45.78","35.31"
"68","000","00","008","0820","0376","881","724","157","56","937","1881","0","49.81","38.49"
"68","000","00","008","0821","0000","787","619","168","47","834","1766","0","47.23","35.05"
"68","000","00","008","0821","0377","787","619","168","47","834","1766","0","47.23","35.05"
"68","000","00","008","0822","0000","2885","2320","565","151","3036","5083","0","59.73","45.64"
"68","000","00","008","0822","0385","915","723","192","52","967","1685","0","57.39","42.91"
"68","000","00","008","0822","0386","894","695","199","50","944","1748","0","54.0","39.76"
"68","000","00","008","0822","0387","1076","902","174","49","1125","1650","0","68.18","54.67"
"68","000","00","008","0823","0000","1941","1543","398","132","2073","3923","0","52.84","39.33"
"68","000","00","008","0823","0390","947","744","203","68","1015","1841","0","55.13","40.41"
"68","000","00","008","0823","0391","994","799","195","64","1058","2082","0","50.82","38.38"
"68","000","00","008","0824","0000","1548","1214","334","88","1636","3578","0","45.72","33.93"
"68","000","00","008","0824","0365","702","550","152","67","769","1474","0","52.17","37.31"
"68","000","00","008","0824","0366","162","136","26","13","175","718","0","24.37","18.94"
"68","000","00","008","0824","0367","684","528","156","8","692","1386","0","49.93","38.1"
"68","000","00","008","0825","0000","1290","1063","227","65","1355","2483","0","54.57","42.81"
"68","000","00","008","0825","0355","607","500","107","36","643","1170","0","54.96","42.74"
"68","000","00","008","0825","0356","683","563","120","29","712","1313","0","54.23","42.88"
"68","000","00","008","0826","0000","1798","1356","442","78","1876","4169","0","45.0","32.53"
"68","000","00","008","0826","0344","901","697","204","13","914","2061","0","44.35","33.82"
"68","000","00","008","0826","0345","897","659","238","65","962","2108","0","45.64","31.26"
"68","000","00","008","0827","0000","1949","1628","321","102","2051","4015","0","51.08","40.55"
"68","000","00","008","0827","0378","854","692","162","68","922","1817","0","50.74","38.08"
"68","000","00","008","0827","0379","1095","936","159","34","1129","2198","0","51.36","42.58"
"68","000","00","008","0828","0000","2179","1749","430","123","2302","4185","0","55.01","41.79"
"68","000","00","008","0828","0307","826","662","164","62","888","1583","0","56.1","41.82"
"68","000","00","008","0828","0308","654","534","120","30","684","1246","0","54.9","42.86"
"68","000","00","008","0828","0309","699","553","146","31","730","1356","0","53.83","40.78"
"68","000","00","008","0829","0000","1399","1098","301","118","1517","2854","0","53.15","38.47"
"68","000","00","008","0829","0363","666","528","138","64","730","1363","0","53.56","38.74"
"68","000","00","008","0829","0364","733","570","163","54","787","1491","0","52.78","38.23"
"68","000","00","008","0830","0000","1992","1629","363","102","2094","3951","0","53.0","41.23"
"68","000","00","008","0830","0382","642","525","117","31","673","1257","0","53.54","41.77"
"68","000","00","008","0830","0383","608","488","120","48","656","1267","0","51.78","38.52"
"68","000","00","008","0830","0384","742","616","126","23","765","1427","0","53.61","43.17"
"68","000","00","008","0831","0000","1540","1220","320","109","1649","3085","0","53.45","39.55"
"68","000","00","008","0831","0388","730","563","167","56","786","1478","0","53.18","38.09"
"68","000","00","008","0831","0389","810","657","153","53","863","1607","0","53.7","40.88"
"68","000","00","008","0832","0000","982","760","222","60","1042","2006","0","51.94","37.89"
"68","000","00","008","0832","0343","982","760","222","60","1042","2006","0","51.94","37.89"
"68","000","00","008","0833","0000","1624","1299","325","86","1710","3543","0","48.26","36.66"
"68","000","00","008","0833","0346","837","673","164","54","891","1862","0","47.85","36.14"
"68","000","00","008","0833","0347","787","626","161","32","819","1681","0","48.72","37.24"
"68","000","00","008","0834","0000","795","596","199","56","851","1499","0","56.77","39.76"
"68","000","00","008","0834","0350","795","596","199","56","851","1499","0","56.77","39.76"
"68","000","00","008","0835","0000","637","488","149","64","701","1436","0","48.82","33.98"
"68","000","00","008","0835","0372","637","488","149","64","701","1436","0","48.82","33.98"
"68","000","00","008","0836","0000","1096","900","196","53","1149","2209","0","52.01","40.74"
"68","000","00","008","0836","0393","1096","900","196","53","1149","2209","0","52.01","40.74"
"68","000","00","008","0837","0000","851","696","155","49","900","1959","0","45.94","35.53"
"68","000","00","008","0837","0392","851","696","155","49","900","1959","0","45.94","35.53"
"68","000","00","008","0838","0000","2004","1589","415","89","2093","4531","0","46.19","35.07"
"68","000","00","008","0838","0328","774","617","157","19","793","1848","0","42.91","33.39"
"68","000","00","008","0838","0329","677","534","143","43","720","1334","0","53.97","40.03"
"68","000","00","008","0838","0330","553","438","115","27","580","1349","0","42.99","32.47"
"68","000","00","008","0839","0000","1345","1031","314","78","1423","3075","0","46.28","33.53"
"68","000","00","008","0839","0337","596","449","147","27","623","1403","0","44.4","32.0"
"68","000","00","008","0839","0338","749","582","167","51","800","1672","0","47.85","34.81"
"68","000","00","008","0840","0000","1379","1082","297","87","1466","2694","0","54.42","40.16"
"68","000","00","008","0840","0305","733","564","169","50","783","1431","0","54.72","39.41"
"68","000","00","008","0840","0306","646","518","128","37","683","1263","0","54.08","41.01"
"68","000","00","008","0841","0000","1315","1045","270","91","1406","2537","0","55.42","41.19"
"68","000","00","008","0841","0353","615","493","122","53","668","1226","0","54.49","40.21"
"68","000","00","008","0841","0354","700","552","148","38","738","1311","0","56.29","42.11"
"68","000","00","008","0842","0000","1907","1520","387","82","1989","3821","0","52.05","39.78"
"68","000","00","008","0842","0380","857","691","166","49","906","1732","0","52.31","39.9"
"68","000","00","008","0842","0381","1050","829","221","33","1083","2089","0","51.84","39.68"
"68","000","00","008","0843","0000","1862","1512","350","109","1971","3864","0","51.01","39.13"
"68","000","00","008","0843","0394","923","777","146","50","973","1864","0","52.2","41.68"
"68","000","00","008","0843","0395","939","735","204","59","998","2000","0","49.9","36.75"
"68","000","00","008","0844","0000","1385","1096","289","89","1474","2716","0","54.27","40.35"
"68","000","00","008","0844","0316","629","481","148","38","667","1303","0","51.19","36.91"
"68","000","00","008","0844","0317","756","615","141","51","807","1413","0","57.11","43.52"
"68","000","00","008","0845","0000","952","780","172","53","1005","2155","0","46.64","36.19"
"68","000","00","008","0845","0326","584","501","83","23","607","1145","0","53.01","43.76"
"68","000","00","008","0845","0327","368","279","89","30","398","1010","0","39.41","27.62"
"68","000","00","008","0846","0000","2005","1291","714","189","2194","4294","0","51.09","30.07"
"68","000","00","008","0846","0368","704","579","125","67","771","1487","0","51.85","38.94"
"68","000","00","008","0846","0369","742","628","114","68","810","1552","0","52.19","40.46"
"68","000","00","008","0846","0370","559","84","475","54","613","1255","0","48.84","6.69"
"68","000","00","008","0847","0000","1370","1041","329","108","1478","2836","0","52.12","36.71"
"68","000","00","008","0847","0333","702","544","158","37","739","1374","0","53.78","39.59"
"68","000","00","008","0847","0334","668","497","171","71","739","1462","0","50.55","33.99"
"68","000","00","008","0848","0000","1296","1046","250","74","1370","2667","0","51.37","39.22"
"68","000","00","008","0848","0357","624","507","117","25","649","1186","0","54.72","42.75"
"68","000","00","008","0848","0358","672","539","133","49","721","1481","0","48.68","36.39"
"68","000","00","009","0000","0000","51179","42077","9102","2699","53878","101574","122981","53.04","41.42"
"68","000","00","009","0901","0000","2160","1751","409","121","2281","4513","0","50.54","38.8"
"68","000","00","009","0901","1008","707","568","139","30","737","1482","0","49.73","38.33"
"68","000","00","009","0901","1009","726","590","136","46","772","1528","0","50.52","38.61"
"68","000","00","009","0901","1010","727","593","134","45","772","1503","0","51.36","39.45"
"68","000","00","009","0902","0000","2770","2271","499","187","2957","5661","0","52.23","40.12"
"68","000","00","009","0902","1013","880","708","172","69","949","2088","0","45.45","33.91"
"68","000","00","009","0902","1014","1027","841","186","73","1100","1987","0","55.36","42.33"
"68","000","00","009","0902","1015","863","722","141","45","908","1586","0","57.25","45.52"
"68","000","00","009","0903","0000","1776","1444","332","82","1858","4006","0","46.38","36.05"
"68","000","00","009","0903","1018","922","740","182","52","974","2081","0","46.8","35.56"
"68","000","00","009","0903","1019","854","704","150","30","884","1925","0","45.92","36.57"
"68","000","00","009","0904","0000","1482","1240","242","65","1547","3188","0","48.53","38.9"
"68","000","00","009","0904","1064","781","649","132","30","811","1649","0","49.18","39.36"
"68","000","00","009","0904","1065","701","591","110","35","736","1539","0","47.82","38.4"
"68","000","00","009","0906","0000","1770","1405","365","128","1898","3662","0","51.83","38.37"
"68","000","00","009","0906","1022","826","677","149","51","877","1790","0","48.99","37.82"
"68","000","00","009","0906","1023","944","728","216","77","1021","1872","0","54.54","38.89"
"68","000","00","009","0907","0000","2049","1684","365","119","2168","4152","0","52.22","40.56"
"68","000","00","009","0907","1026","697","580","117","38","735","1398","0","52.58","41.49"
"68","000","00","009","0907","1027","624","502","122","41","665","1345","0","49.44","37.32"
"68","000","00","009","0907","1028","728","602","126","40","768","1409","0","54.51","42.73"
"68","000","00","009","0908","0000","297","232","65","21","318","678","0","46.9","34.22"
"68","000","00","009","0908","1071","297","232","65","21","318","678","0","46.9","34.22"
"68","000","00","009","0909","0000","2172","1757","415","106","2278","4282","0","53.2","41.03"
"68","000","00","009","0909","1031","794","657","137","38","832","1597","0","52.1","41.14"
"68","000","00","009","0909","1032","713","570","143","24","737","1410","0","52.27","40.43"
"68","000","00","009","0909","1033","665","530","135","44","709","1275","0","55.61","41.57"
"68","000","00","009","0910","0000","2826","2436","390","136","2962","5372","0","55.14","45.35"
"68","000","00","009","0910","1037","962","788","174","47","1009","1786","0","56.49","44.12"
"68","000","00","009","0910","1038","902","739","163","52","954","1756","0","54.33","42.08"
"68","000","00","009","0910","1039","962","909","53","37","999","1830","0","54.59","49.67"
"68","000","00","009","0911","0000","1030","810","220","60","1090","1909","0","57.1","42.43"
"68","000","00","009","0911","1034","1030","810","220","60","1090","1909","0","57.1","42.43"
"68","000","00","009","0912","0000","2305","1855","450","113","2418","4369","0","55.34","42.46"
"68","000","00","009","0912","1066","837","676","161","46","883","1541","0","57.3","43.87"
"68","000","00","009","0912","1067","711","568","143","39","750","1375","0","54.55","41.31"
"68","000","00","009","0912","1068","757","611","146","28","785","1453","0","54.03","42.05"
"68","000","00","009","0913","0000","1644","1351","293","57","1701","3597","0","47.29","37.56"
"68","000","00","009","0913","1042","859","707","152","30","889","1805","0","49.25","39.17"
"68","000","00","009","0913","1043","785","644","141","27","812","1792","0","45.31","35.94"
"68","000","00","009","0914","0000","2031","1654","377","115","2146","4268","0","50.28","38.75"
"68","000","00","009","0914","1049","641","530","111","53","694","1297","0","53.51","40.86"
"68","000","00","009","0914","1050","659","546","113","19","678","1407","0","48.19","38.81"
"68","000","00","009","0914","1051","731","578","153","43","774","1564","0","49.49","36.96"
"68","000","00","009","0915","0000","1790","1467","323","103","1893","3485","0","54.32","42.09"
"68","000","00","009","0915","1054","871","699","172","47","918","1721","0","53.34","40.62"
"68","000","00","009","0915","1055","919","768","151","56","975","1764","0","55.27","43.54"
"68","000","00","009","0916","0000","1308","1073","235","57","1365","2373","0","57.52","45.22"
"68","000","00","009","0916","1069","568","451","117","42","610","1074","0","56.8","41.99"
"68","000","00","009","0916","1070","740","622","118","15","755","1299","0","58.12","47.88"
"68","000","00","009","0917","0000","753","609","144","51","804","1499","0","53.64","40.63"
"68","000","00","009","0917","1056","753","609","144","51","804","1499","0","53.64","40.63"
"68","000","00","009","0918","0000","957","798","159","41","998","2151","0","46.4","37.1"
"68","000","00","009","0918","1057","957","798","159","41","998","2151","0","46.4","37.1"
"68","000","00","009","0919","0000","1651","1387","264","59","1710","2980","0","57.38","46.54"
"68","000","00","009","0919","1058","818","697","121","28","846","1524","0","55.51","45.73"
"68","000","00","009","0919","1059","833","690","143","31","864","1456","0","59.34","47.39"
"68","000","00","009","0920","0000","1320","1076","244","106","1426","2784","0","51.22","38.65"
"68","000","00","009","0920","1011","747","607","140","47","794","1568","0","50.64","38.71"
"68","000","00","009","0920","1012","573","469","104","59","632","1216","0","51.97","38.57"
"68","000","00","009","0921","0000","1178","919","259","83","1261","2355","0","53.55","39.02"
"68","000","00","009","0921","1016","576","435","141","39","615","1221","0","50.37","35.63"
"68","000","00","009","0921","1017","602","484","118","44","646","1134","0","56.97","42.68"
"68","000","00","009","0922","0000","2203","1879","324","80","2283","4135","0","55.21","45.44"
"68","000","00","009","0922","1020","1091","934","157","32","1123","2095","0","53.6","44.58"
"68","000","00","009","0922","1021","1112","945","167","48","1160","2040","0","56.86","46.32"
"68","000","00","009","0923","0000","1815","1478","337","123","1938","3518","0","55.09","42.01"
"68","000","00","009","0923","1024","896","729","167","65","961","1726","0","55.68","42.24"
"68","000","00","009","0923","1025","919","749","170","58","977","1792","0","54.52","41.8"
"68","000","00","009","0924","0000","1494","1179","315","78","1572","3012","0","52.19","39.14"
"68","000","00","009","0924","1029","610","488","122","26","636","1362","0","46.7","35.83"
"68","000","00","009","0924","1030","884","691","193","52","936","1650","0","56.73","41.88"
"68","000","00","009","0925","0000","2077","1707","370","89","2166","4026","0","53.8","42.4"
"68","000","00","009","0925","1035","1056","868","188","34","1090","2024","0","53.85","42.89"
"68","000","00","009","0925","1036","1021","839","182","55","1076","2002","0","53.75","41.91"
"68","000","00","009","0926","0000","1769","1501","268","59","1828","3216","0","56.84","46.67"
"68","000","00","009","0926","1040","971","804","167","29","1000","1697","0","58.93","47.38"
"68","000","00","009","0926","1041","798","697","101","30","828","1519","0","54.51","45.89"
"68","000","00","009","0927","0000","814","672","142","65","879","1500","0","58.6","44.8"
"68","000","00","009","0927","1044","814","672","142","65","879","1500","0","58.6","44.8"
"68","000","00","009","0928","0000","1936","1565","371","112","2048","3980","0","51.46","39.32"
"68","000","00","009","0928","1046","604","484","120","46","650","1444","0","45.01","33.52"
"68","000","00","009","0928","1047","636","520","116","35","671","1321","0","50.79","39.36"
"68","000","00","009","0928","1048","696","561","135","31","727","1215","0","59.84","46.17"
"68","000","00","009","0929","0000","1104","901","203","105","1209","2340","0","51.67","38.5"
"68","000","00","009","0929","1052","638","516","122","63","701","1317","0","53.23","39.18"
"68","000","00","009","0929","1053","466","385","81","42","508","1023","0","49.66","37.63"
"68","000","00","009","0930","0000","2180","1885","295","62","2242","3746","0","59.85","50.32"
"68","000","00","009","0930","1060","1087","949","138","29","1116","1847","0","60.42","51.38"
"68","000","00","009","0930","1061","1093","936","157","33","1126","1899","0","59.29","49.29"
"68","000","00","009","0931","0000","1854","1543","311","87","1941","3390","0","57.26","45.52"
"68","000","00","009","0931","1062","892","746","146","37","929","1725","0","53.86","43.25"
"68","000","00","009","0931","1063","962","797","165","50","1012","1665","0","60.78","47.87"
"68","000","00","009","0932","0000","664","548","116","29","693","1427","0","48.56","38.4"
"68","000","00","009","0932","1045","664","548","116","29","693","1427","0","48.56","38.4"
"68","000","00","010","0000","0000","92074","74739","17335","4474","96548","183560","225897","52.6","40.72"
"68","000","00","010","1001","0000","2296","1856","440","112","2408","4781","0","50.37","38.82"
"68","000","00","010","1001","0864","785","667","118","21","806","1717","0","46.94","38.85"
"68","000","00","010","1001","0865","683","524","159","35","718","1319","0","54.44","39.73"
"68","000","00","010","1001","0866","828","665","163","56","884","1745","0","50.66","38.11"
"68","000","00","010","1002","0000","2277","1841","436","103","2380","4129","0","57.64","44.59"
"68","000","00","010","1002","0867","893","712","181","49","942","1721","0","54.74","41.37"
"68","000","00","010","1002","0868","636","521","115","23","659","1206","0","54.64","43.2"
"68","000","00","010","1002","0869","748","608","140","31","779","1202","0","64.81","50.58"
"68","000","00","010","1003","0000","2919","2307","612","87","3006","5256","0","57.19","43.89"
"68","000","00","010","1003","0850","641","510","131","25","666","1044","0","63.79","48.85"
"68","000","00","010","1003","0851","603","505","98","10","613","1124","0","54.54","44.93"
"68","000","00","010","1003","0852","892","648","244","24","916","1517","0","60.38","42.72"
"68","000","00","010","1003","0853","783","644","139","28","811","1571","0","51.62","40.99"
"68","000","00","010","1004","0000","2834","2277","557","182","3016","5442","0","55.42","41.84"
"68","000","00","010","1004","0840","668","530","138","48","716","1307","0","54.78","40.55"
"68","000","00","010","1004","0841","694","552","142","40","734","1337","0","54.9","41.29"
"68","000","00","010","1004","0842","595","491","104","39","634","980","0","64.69","50.1"
"68","000","00","010","1004","0843","877","704","173","55","932","1818","0","51.27","38.72"
"68","000","00","010","1005","0000","2519","2010","509","90","2609","5083","0","51.33","39.54"
"68","000","00","010","1005","0857","826","674","152","34","860","1555","0","55.31","43.34"
"68","000","00","010","1005","0858","931","741","190","32","963","2051","0","46.95","36.13"
"68","000","00","010","1005","0859","762","595","167","24","786","1477","0","53.22","40.28"
"68","000","00","010","1006","0000","1854","1493","361","75","1929","3895","0","49.53","38.33"
"68","000","00","010","1006","0835","972","772","200","44","1016","1901","0","53.45","40.61"
"68","000","00","010","1006","0836","882","721","161","31","913","1994","0","45.79","36.16"
"68","000","00","010","1007","0000","1954","1691","263","94","2048","3585","0","57.13","47.17"
"68","000","00","010","1007","0875","544","451","93","37","581","1010","0","57.52","44.65"
"68","000","00","010","1007","0876","671","532","139","31","702","1261","0","55.67","42.19"
"68","000","00","010","1007","0877","739","708","31","26","765","1314","0","58.22","53.88"
"68","000","00","010","1008","0000","2918","2353","565","124","3042","6426","0","47.34","36.62"
"68","000","00","010","1008","0883","626","498","128","24","650","2213","0","29.37","22.5"
"68","000","00","010","1008","0884","565","454","111","22","587","949","0","61.85","47.84"
"68","000","00","010","1008","0885","914","726","188","49","963","1621","0","59.41","44.79"
"68","000","00","010","1008","0886","813","675","138","29","842","1643","0","51.25","41.08"
"68","000","00","010","1009","0000","1367","1063","304","81","1448","2475","0","58.51","42.95"
"68","000","00","010","1009","0870","659","526","133","46","705","1208","0","58.36","43.54"
"68","000","00","010","1009","0871","708","537","171","35","743","1267","0","58.64","42.38"
"68","000","00","010","1010","0000","2133","1710","423","116","2249","3993","0","56.32","42.82"
"68","000","00","010","1010","0891","576","441","135","35","611","1039","0","58.81","42.44"
"68","000","00","010","1010","0892","729","583","146","47","776","1318","0","58.88","44.23"
"68","000","00","010","1010","0893","828","686","142","34","862","1636","0","52.69","41.93"
"68","000","00","010","1011","0000","1999","1751","248","87","2086","4038","0","51.66","43.36"
"68","000","00","010","1011","0896","662","542","120","40","702","1480","0","47.43","36.62"
"68","000","00","010","1011","0897","682","670","12","23","705","1330","0","53.01","50.38"
"68","000","00","010","1011","0898","655","539","116","24","679","1228","0","55.29","43.89"
"68","000","00","010","1012","0000","2162","1734","428","132","2294","4431","0","51.77","39.13"
"68","000","00","010","1012","0801","679","534","145","43","722","1487","0","48.55","35.91"
"68","000","00","010","1012","0802","711","587","124","49","760","1453","0","52.31","40.4"
"68","000","00","010","1012","0803","772","613","159","40","812","1491","0","54.46","41.11"
"68","000","00","010","1013","0000","2758","2268","490","126","2884","5762","0","50.05","39.36"
"68","000","00","010","1013","0806","850","693","157","34","884","1921","0","46.02","36.07"
"68","000","00","010","1013","0807","1009","850","159","57","1066","1974","0","54.0","43.06"
"68","000","00","010","1013","0808","899","725","174","35","934","1867","0","50.03","38.83"
"68","000","00","010","1014","0000","2323","1899","424","126","2449","4440","0","55.16","42.77"
"68","000","00","010","1014","0827","518","411","107","42","560","1048","0","53.44","39.22"
"68","000","00","010","1014","0828","660","544","116","44","704","1259","0","55.92","43.21"
"68","000","00","010","1014","0829","531","432","99","15","546","1061","0","51.46","40.72"
"68","000","00","010","1014","0830","614","512","102","25","639","1072","0","59.61","47.76"
"68","000","00","010","1015","0000","1099","897","202","51","1150","2326","0","49.44","38.56"
"68","000","00","010","1015","0820","506","424","82","18","524","1130","0","46.37","37.52"
"68","000","00","010","1015","0821","593","473","120","33","626","1196","0","52.34","39.55"
"68","000","00","010","1016","0000","2384","1975","409","85","2469","5300","0","46.58","37.26"
"68","000","00","010","1016","0824","771","670","101","31","802","1564","0","51.28","42.84"
"68","000","00","010","1016","0825","730","604","126","30","760","1824","0","41.67","33.11"
"68","000","00","010","1016","0826","883","701","182","24","907","1912","0","47.44","36.66"
"68","000","00","010","1017","0000","1401","1186","215","96","1497","2780","0","53.85","42.66"
"68","000","00","010","1017","0917","684","581","103","64","748","1385","0","54.01","41.95"
"68","000","00","010","1017","0918","717","605","112","32","749","1395","0","53.69","43.37"
"68","000","00","010","1018","0000","1602","1329","273","79","1681","3342","0","50.3","39.77"
"68","000","00","010","1018","0919","818","676","142","30","848","1711","0","49.56","39.51"
"68","000","00","010","1018","0920","784","653","131","49","833","1631","0","51.07","40.04"
"68","000","00","010","1019","0000","1302","1114","188","103","1405","2541","0","55.29","43.84"
"68","000","00","010","1019","0923","579","486","93","38","617","1127","0","54.75","43.12"
"68","000","00","010","1019","0924","723","628","95","65","788","1414","0","55.73","44.41"
"68","000","00","010","1020","0000","998","846","152","46","1044","1931","0","54.07","43.81"
"68","000","00","010","1020","0922","998","846","152","46","1044","1931","0","54.07","43.81"
"68","000","00","010","1021","0000","589","516","73","14","603","1110","0","54.32","46.49"
"68","000","00","010","1021","0921","589","516","73","14","603","1110","0","54.32","46.49"
"68","000","00","010","1022","0000","803","686","117","37","840","1609","0","52.21","42.64"
"68","000","00","010","1022","0925","803","686","117","37","840","1609","0","52.21","42.64"
"68","000","00","010","1023","0000","2142","1617","525","144","2286","4199","0","54.44","38.51"
"68","000","00","010","1023","0902","653","506","147","58","711","1243","0","57.2","40.71"
"68","000","00","010","1023","0903","794","568","226","45","839","1590","0","52.77","35.72"
"68","000","00","010","1023","0904","695","543","152","41","736","1366","0","53.88","39.75"
"68","000","00","010","1024","0000","2646","2127","519","146","2792","5390","0","51.8","39.46"
"68","000","00","010","1024","0913","485","385","100","31","516","1052","0","49.05","36.6"
"68","000","00","010","1024","0914","656","534","122","51","707","1154","0","61.27","46.27"
"68","000","00","010","1024","0915","774","633","141","22","796","1645","0","48.39","38.48"
"68","000","00","010","1024","0916","731","575","156","42","773","1539","0","50.23","37.36"
"68","000","00","010","1025","0000","1292","1065","227","78","1370","2811","0","48.74","37.89"
"68","000","00","010","1025","0908","652","543","109","56","708","1351","0","52.41","40.19"
"68","000","00","010","1025","0909","640","522","118","22","662","1460","0","45.34","35.75"
"68","000","00","010","1026","0000","2094","1744","350","83","2177","4327","0","50.31","40.31"
"68","000","00","010","1026","0910","889","743","146","38","927","1841","0","50.35","40.36"
"68","000","00","010","1026","0911","672","561","111","20","692","1475","0","46.92","38.03"
"68","000","00","010","1026","0912","533","440","93","25","558","1011","0","55.19","43.52"
"68","000","00","010","1027","0000","1465","1170","295","87","1552","3006","0","51.63","38.92"
"68","000","00","010","1027","0804","650","507","143","49","699","1346","0","51.93","37.67"
"68","000","00","010","1027","0805","815","663","152","38","853","1660","0","51.39","39.94"
"68","000","00","010","1028","0000","3154","2514","640","167","3321","6483","0","51.23","38.78"
"68","000","00","010","1028","0860","754","611","143","25","779","1501","0","51.9","40.71"
"68","000","00","010","1028","0861","720","570","150","58","778","1405","0","55.37","40.57"
"68","000","00","010","1028","0862","818","652","166","55","873","1656","0","52.72","39.37"
"68","000","00","010","1028","0863","862","681","181","29","891","1921","0","46.38","35.45"
"68","000","00","010","1029","0000","843","677","166","51","894","1788","0","50.0","37.86"
"68","000","00","010","1029","0831","843","677","166","51","894","1788","0","50.0","37.86"
"68","000","00","010","1030","0000","2196","1820","376","108","2304","4320","0","53.33","42.13"
"68","000","00","010","1030","0832","775","672","103","22","797","1510","0","52.78","44.5"
"68","000","00","010","1030","0833","702","565","137","38","740","1403","0","52.74","40.27"
"68","000","00","010","1030","0834","719","583","136","48","767","1407","0","54.51","41.44"
"68","000","00","010","1031","0000","2010","1596","414","113","2123","3761","0","56.45","42.44"
"68","000","00","010","1031","0844","749","579","170","54","803","1463","0","54.89","39.58"
"68","000","00","010","1031","0845","683","555","128","21","704","1213","0","58.04","45.75"
"68","000","00","010","1031","0846","578","462","116","38","616","1085","0","56.77","42.58"
"68","000","00","010","1032","0000","1656","1322","334","74","1730","3217","0","53.78","41.09"
"68","000","00","010","1032","0822","842","683","159","30","872","1685","0","51.75","40.53"
"68","000","00","010","1032","0823","814","639","175","44","858","1532","0","56.01","41.71"
"68","000","00","010","1033","0000","2890","2386","504","97","2987","6014","0","49.67","39.67"
"68","000","00","010","1033","0809","880","729","151","41","921","1786","0","51.57","40.82"
"68","000","00","010","1033","0810","664","548","116","22","686","1634","0","41.98","33.54"
"68","000","00","010","1033","0811","569","469","100","15","584","1080","0","54.07","43.43"
"68","000","00","010","1033","0812","777","640","137","19","796","1514","0","52.58","42.27"
"68","000","00","010","1034","0000","2085","1657","428","132","2217","4262","0","52.02","38.88"
"68","000","00","010","1034","0847","683","553","130","37","720","1458","0","49.38","37.93"
"68","000","00","010","1034","0848","731","574","157","47","778","1408","0","55.26","40.77"
"68","000","00","010","1034","0849","671","530","141","48","719","1396","0","51.5","37.97"
"68","000","00","010","1035","0000","1561","1261","300","66","1627","3094","0","52.59","40.76"
"68","000","00","010","1035","0889","740","593","147","42","782","1577","0","49.59","37.6"
"68","000","00","010","1035","0890","821","668","153","24","845","1517","0","55.7","44.03"
"68","000","00","010","1036","0000","2187","1642","545","85","2272","3806","0","59.7","43.14"
"68","000","00","010","1036","0899","771","602","169","35","806","1377","0","58.53","43.72"
"68","000","00","010","1036","0900","695","562","133","26","721","1198","0","60.18","46.91"
"68","000","00","010","1036","0901","721","478","243","24","745","1231","0","60.52","38.83"
"68","000","00","010","1037","0000","2523","2012","511","104","2627","5039","0","52.13","39.93"
"68","000","00","010","1037","0880","726","575","151","22","748","1399","0","53.47","41.1"
"68","000","00","010","1037","0881","937","747","190","48","985","1968","0","50.05","37.96"
"68","000","00","010","1037","0882","860","690","170","34","894","1672","0","53.47","41.27"
"68","000","00","010","1038","0000","1948","1611","337","100","2048","4201","0","48.75","38.35"
"68","000","00","010","1038","0905","674","567","107","41","715","1332","0","53.68","42.57"
"68","000","00","010","1038","0906","542","446","96","24","566","1201","0","47.13","37.14"
"68","000","00","010","1038","0907","732","598","134","35","767","1668","0","45.98","35.85"
"68","000","00","010","1039","0000","1493","1175","318","89","1582","2790","0","56.7","42.11"
"68","000","00","010","1039","0894","706","546","160","59","765","1316","0","58.13","41.49"
"68","000","00","010","1039","0895","787","629","158","30","817","1474","0","55.43","42.67"
"68","000","00","010","1040","0000","813","618","195","60","873","1561","0","55.93","39.59"
"68","000","00","010","1040","0878","387","309","78","34","421","722","0","58.31","42.8"
"68","000","00","010","1040","0879","426","309","117","26","452","839","0","53.87","36.83"
"68","000","00","010","1041","0000","2048","1689","359","87","2135","3703","0","57.66","45.61"
"68","000","00","010","1041","0872","588","499","89","20","608","1094","0","55.58","45.61"
"68","000","00","010","1041","0873","766","607","159","51","817","1394","0","58.61","43.54"
"68","000","00","010","1041","0874","694","583","111","16","710","1215","0","58.44","47.98"
"68","000","00","010","1042","0000","2703","2234","469","98","2801","4896","0","57.21","45.63"
"68","000","00","010","1042","0854","933","769","164","30","963","1752","0","54.97","43.89"
"68","000","00","010","1042","0855","826","712","114","29","855","1434","0","59.62","49.65"
"68","000","00","010","1042","0856","944","753","191","39","983","1710","0","57.49","44.04"
"68","000","00","010","1043","0000","2624","2163","461","115","2739","5358","0","51.12","40.37"
"68","000","00","010","1043","0837","858","676","182","42","900","1730","0","52.02","39.08"
"68","000","00","010","1043","0838","957","767","190","47","1004","1905","0","52.7","40.26"
"68","000","00","010","1043","0839","809","720","89","26","835","1723","0","48.46","41.79"
"68","000","00","010","1044","0000","1871","1502","369","83","1954","3596","0","54.34","41.77"
"68","000","00","010","1044","0887","960","766","194","48","1008","1844","0","54.66","41.54"
"68","000","00","010","1044","0888","911","736","175","35","946","1752","0","54.0","42.01"
"68","000","00","010","1045","0000","2187","1759","428","156","2343","4767","0","49.15","36.9"
"68","000","00","010","1045","0813","823","681","142","58","881","1918","0","45.93","35.51"
"68","000","00","010","1045","0814","595","455","140","63","658","1182","0","55.67","38.49"
"68","000","00","010","1045","0815","769","623","146","35","804","1667","0","48.23","37.37"
"68","000","00","010","1046","0000","3152","2576","576","105","3257","6496","0","50.14","39.66"
"68","000","00","010","1046","0816","732","585","147","32","764","1640","0","46.59","35.67"
"68","000","00","010","1046","0817","788","635","153","29","817","1603","0","50.97","39.61"
"68","000","00","010","1046","0818","836","691","145","11","847","1556","0","54.43","44.41"
"68","000","00","010","1046","0819","796","665","131","33","829","1697","0","48.85","39.19"
"68","000","00","011","0000","0000","21561","17090","4471","1267","22828","41461","49159","55.06","41.22"
"68","000","00","011","1101","0000","1564","1239","325","61","1625","2862","0","56.78","43.29"
"68","000","00","011","1101","1072","736","605","131","23","759","1306","0","58.12","46.32"
"68","000","00","011","1101","1073","828","634","194","38","866","1556","0","55.66","40.75"
"68","000","00","011","1102","0000","2221","1761","460","117","2338","3945","0","59.26","44.64"
"68","000","00","011","1102","1074","1059","849","210","53","1112","1849","0","60.14","45.92"
"68","000","00","011","1102","1075","1162","912","250","64","1226","2096","0","58.49","43.51"
"68","000","00","011","1103","0000","743","572","171","53","796","1517","0","52.47","37.71"
"68","000","00","011","1103","1076","743","572","171","53","796","1517","0","52.47","37.71"
"68","000","00","011","1104","0000","1966","1563","403","90","2056","3951","0","52.04","39.56"
"68","000","00","011","1104","1077","1140","911","229","55","1195","2095","0","57.04","43.48"
"68","000","00","011","1104","1078","826","652","174","35","861","1856","0","46.39","35.13"
"68","000","00","011","1105","0000","2167","1776","391","98","2265","4024","0","56.29","44.14"
"68","000","00","011","1105","1086","1039","859","180","37","1076","1992","0","54.02","43.12"
"68","000","00","011","1105","1087","1128","917","211","61","1189","2032","0","58.51","45.13"
"68","000","00","011","1106","0000","1389","1082","307","74","1463","2542","0","57.55","42.56"
"68","000","00","011","1106","1082","736","566","170","45","781","1271","0","61.45","44.53"
"68","000","00","011","1106","1083","653","516","137","29","682","1271","0","53.66","40.6"
"68","000","00","011","1107","0000","1211","929","282","97","1308","2319","0","56.4","40.06"
"68","000","00","011","1107","1084","657","489","168","46","703","1234","0","56.97","39.63"
"68","000","00","011","1107","1085","554","440","114","51","605","1085","0","55.76","40.55"
"68","000","00","011","1108","0000","641","517","124","37","678","1385","0","48.95","37.33"
"68","000","00","011","1108","1081","641","517","124","37","678","1385","0","48.95","37.33"
"68","000","00","011","1109","0000","672","546","126","25","697","1425","0","48.91","38.32"
"68","000","00","011","1109","1080","672","546","126","25","697","1425","0","48.91","38.32"
"68","000","00","011","1110","0000","1028","824","204","58","1086","1986","0","54.68","41.49"
"68","000","00","011","1110","1079","1028","824","204","58","1086","1986","0","54.68","41.49"
"68","000","00","011","1111","0000","388","315","73","17","405","741","0","54.66","42.51"
"68","000","00","011","1111","1098","388","315","73","17","405","741","0","54.66","42.51"
"68","000","00","011","1112","0000","809","618","191","74","883","1714","0","51.52","36.06"
"68","000","00","011","1112","1100","809","618","191","74","883","1714","0","51.52","36.06"
"68","000","00","011","1113","0000","526","402","124","56","582","943","0","61.72","42.63"
"68","000","00","011","1113","1099","526","402","124","56","582","943","0","61.72","42.63"
"68","000","00","011","1114","0000","678","559","119","18","696","1340","0","51.94","41.72"
"68","000","00","011","1114","1101","678","559","119","18","696","1340","0","51.94","41.72"
"68","000","00","011","1115","0000","451","344","107","32","483","995","0","48.54","34.57"
"68","000","00","011","1115","1097","451","344","107","32","483","995","0","48.54","34.57"
"68","000","00","011","1116","0000","1234","1009","225","93","1327","2265","0","58.59","44.55"
"68","000","00","011","1116","1095","488","398","90","19","507","896","0","56.58","44.42"
"68","000","00","011","1116","1096","746","611","135","74","820","1369","0","59.9","44.63"
"68","000","00","011","1117","0000","620","481","139","47","667","1050","0","63.52","45.81"
"68","000","00","011","1117","1094","620","481","139","47","667","1050","0","63.52","45.81"
"68","000","00","011","1118","0000","375","301","74","33","408","663","0","61.54","45.4"
"68","000","00","011","1118","1092","375","301","74","33","408","663","0","61.54","45.4"
"68","000","00","011","1119","0000","443","343","100","11","454","908","0","50.0","37.78"
"68","000","00","011","1119","1091","443","343","100","11","454","908","0","50.0","37.78"
"68","000","00","011","1120","0000","530","412","118","48","578","1088","0","53.13","37.87"
"68","000","00","011","1120","1093","530","412","118","48","578","1088","0","53.13","37.87"
"68","000","00","011","1121","0000","605","457","148","42","647","1106","0","58.5","41.32"
"68","000","00","011","1121","1090","605","457","148","42","647","1106","0","58.5","41.32"
"68","000","00","011","1122","0000","651","515","136","56","707","1291","0","54.76","39.89"
"68","000","00","011","1122","1088","651","515","136","56","707","1291","0","54.76","39.89"
"68","000","00","011","1123","0000","649","525","124","30","679","1401","0","48.47","37.47"
"68","000","00","011","1123","1089","649","525","124","30","679","1401","0","48.47","37.47"
"68","000","00","012","0000","0000","25840","20514","5326","1616","27456","55149","67208","49.79","37.2"
"68","000","00","012","1201","0000","1123","906","217","53","1176","2733","0","43.03","33.15"
"68","000","00","012","1201","1102","591","475","116","28","619","1371","0","45.15","34.65"
"68","000","00","012","1201","1103","532","431","101","25","557","1362","0","40.9","31.64"
"68","000","00","012","1202","0000","457","367","90","72","529","997","0","53.06","36.81"
"68","000","00","012","1202","1104","457","367","90","72","529","997","0","53.06","36.81"
"68","000","00","012","1203","0000","619","498","121","25","644","1407","0","45.77","35.39"
"68","000","00","012","1203","1105","619","498","121","25","644","1407","0","45.77","35.39"
"68","000","00","012","1204","0000","844","691","153","29","873","1692","0","51.6","40.84"
"68","000","00","012","1204","1106","844","691","153","29","873","1692","0","51.6","40.84"
"68","000","00","012","1205","0000","467","377","90","36","503","892","0","56.39","42.26"
"68","000","00","012","1205","1109","467","377","90","36","503","892","0","56.39","42.26"
"68","000","00","012","1206","0000","1009","830","179","40","1049","2070","0","50.68","40.1"
"68","000","00","012","1206","1107","620","512","108","22","642","1279","0","50.2","40.03"
"68","000","00","012","1206","1108","389","318","71","18","407","791","0","51.45","40.2"
"68","000","00","012","1207","0000","508","408","100","24","532","886","0","60.05","46.05"
"68","000","00","012","1207","1110","508","408","100","24","532","886","0","60.05","46.05"
"68","000","00","012","1208","0000","366","279","87","32","398","712","0","55.9","39.19"
"68","000","00","012","1208","1111","366","279","87","32","398","712","0","55.9","39.19"
"68","000","00","012","1209","0000","724","561","163","88","812","1609","0","50.47","34.87"
"68","000","00","012","1209","1112","724","561","163","88","812","1609","0","50.47","34.87"
"68","000","00","012","1210","0000","1216","961","255","64","1280","2625","0","48.76","36.61"
"68","000","00","012","1210","1113","658","510","148","47","705","1274","0","55.34","40.03"
"68","000","00","012","1210","1114","558","451","107","17","575","1351","0","42.56","33.38"
"68","000","00","012","1211","0000","1317","1053","264","116","1433","2504","0","57.23","42.05"
"68","000","00","012","1211","1115","674","547","127","54","728","1262","0","57.69","43.34"
"68","000","00","012","1211","1116","643","506","137","62","705","1242","0","56.76","40.74"
"68","000","00","012","1212","0000","1483","1157","326","104","1587","3074","0","51.63","37.64"
"68","000","00","012","1212","1117","708","551","157","64","772","1461","0","52.84","37.71"
"68","000","00","012","1212","1118","775","606","169","40","815","1613","0","50.53","37.57"
"68","000","00","012","1213","0000","755","574","181","41","796","1479","0","53.82","38.81"
"68","000","00","012","1213","1119","755","574","181","41","796","1479","0","53.82","38.81"
"68","000","00","012","1214","0000","2204","1707","497","126","2330","4760","0","48.95","35.86"
"68","000","00","012","1214","1120","693","535","158","48","741","1552","0","47.74","34.47"
"68","000","00","012","1214","1121","728","561","167","25","753","1517","0","49.64","36.98"
"68","000","00","012","1214","1122","783","611","172","53","836","1691","0","49.44","36.13"
"68","000","00","012","1215","0000","1885","1498","387","89","1974","3762","0","52.47","39.82"
"68","000","00","012","1215","1123","610","485","125","18","628","1157","0","54.28","41.92"
"68","000","00","012","1215","1124","696","539","157","46","742","1455","0","51.0","37.04"
"68","000","00","012","1215","1125","579","474","105","25","604","1150","0","52.52","41.22"
"68","000","00","012","1216","0000","1177","928","249","56","1233","2363","0","52.18","39.27"
"68","000","00","012","1216","1126","591","455","136","36","627","1112","0","56.38","40.92"
"68","000","00","012","1216","1127","586","473","113","20","606","1251","0","48.44","37.81"
"68","000","00","012","1217","0000","1405","1104","301","170","1575","2939","0","53.59","37.56"
"68","000","00","012","1217","1128","694","557","137","90","784","1446","0","54.22","38.52"
"68","000","00","012","1217","1129","711","547","164","80","791","1493","0","52.98","36.64"
"68","000","00","012","1218","0000","1278","1038","240","76","1354","2476","0","54.68","41.92"
"68","000","00","012","1218","1130","657","529","128","45","702","1339","0","52.43","39.51"
"68","000","00","012","1218","1131","621","509","112","31","652","1137","0","57.34","44.77"
"68","000","00","012","1219","0000","483","407","76","41","524","1043","0","50.24","39.02"
"68","000","00","012","1219","1132","483","407","76","41","524","1043","0","50.24","39.02"
"68","000","00","012","1220","0000","893","694","199","51","944","1968","0","47.97","35.26"
"68","000","00","012","1220","1133","430","344","86","31","461","993","0","46.42","34.64"
"68","000","00","012","1220","1134","463","350","113","20","483","975","0","49.54","35.9"
"68","000","00","012","1221","0000","817","650","167","49","866","2029","0","42.68","32.04"
"68","000","00","012","1221","1135","817","650","167","49","866","2029","0","42.68","32.04"
"68","000","00","012","1222","0000","1411","1136","275","88","1499","3802","0","39.43","29.88"
"68","000","00","012","1222","1139","762","628","134","51","813","1870","0","43.48","33.58"
"68","000","00","012","1222","1140","649","508","141","37","686","1932","0","35.51","26.29"
"68","000","00","012","1223","0000","752","582","170","23","775","1884","0","41.14","30.89"
"68","000","00","012","1223","1141","357","276","81","8","365","899","0","40.6","30.7"
"68","000","00","012","1223","1142","395","306","89","15","410","985","0","41.62","31.07"
"68","000","00","012","1224","0000","2647","2108","539","123","2770","5443","0","50.89","38.73"
"68","000","00","012","1224","1136","908","706","202","34","942","1765","0","53.37","40.0"
"68","000","00","012","1224","1137","872","688","184","46","918","1809","0","50.75","38.03"
"68","000","00","012","1224","1138","867","714","153","43","910","1869","0","48.69","38.2"
"68","000","00","013","0000","0000","4583","3740","843","355","4938","9766","11997","50.56","38.3"
"68","000","00","013","1301","0000","1001","796","205","98","1099","1991","0","55.2","39.98"
"68","000","00","013","1301","0581","1001","796","205","98","1099","1991","0","55.2","39.98"
"68","000","00","013","1302","0000","717","574","143","65","782","1392","0","56.18","41.24"
"68","000","00","013","1302","0582","717","574","143","65","782","1392","0","56.18","41.24"
"68","000","00","013","1303","0000","318","251","67","23","341","716","0","47.63","35.06"
"68","000","00","013","1303","0584","318","251","67","23","341","716","0","47.63","35.06"
"68","000","00","013","1304","0000","278","230","48","14","292","564","0","51.77","40.78"
"68","000","00","013","1304","0583","278","230","48","14","292","564","0","51.77","40.78"
"68","000","00","013","1305","0000","249","195","54","13","262","669","0","39.16","29.15"
"68","000","00","013","1305","0586","249","195","54","13","262","669","0","39.16","29.15"
"68","000","00","013","1306","0000","225","189","36","7","232","683","0","33.97","27.67"
"68","000","00","013","1306","0589","225","189","36","7","232","683","0","33.97","27.67"
"68","000","00","013","1307","0000","335","277","58","19","354","760","0","46.58","36.45"
"68","000","00","013","1307","0587","335","277","58","19","354","760","0","46.58","36.45"
"68","000","00","013","1308","0000","556","452","104","35","591","1224","0","48.28","36.93"
"68","000","00","013","1308","0590","556","452","104","35","591","1224","0","48.28","36.93"
"68","000","00","013","1309","0000","567","450","117","61","628","1016","0","61.81","44.29"
"68","000","00","013","1309","0585","567","450","117","61","628","1016","0","61.81","44.29"
"68","000","00","013","1310","0000","337","326","11","20","357","751","0","47.54","43.41"
"68","000","00","013","1310","0588","337","326","11","20","357","751","0","47.54","43.41"
"66","000","00","000","0000","0000","1247990","1013174","234816","71112","1319102","2295642","2799254","57.46","44.13"
"66","000","00","001","0000","0000","7673","6132","1541","468","8141","14696","18557","55.4","41.73"
"66","000","00","001","0101","0000","813","614","199","40","853","1531","0","55.72","40.1"
"66","000","00","001","0101","1071","813","614","199","40","853","1531","0","55.72","40.1"
"66","000","00","001","0102","0000","1111","858","253","71","1182","2046","0","57.77","41.94"
"66","000","00","001","0102","1075","640","495","145","47","687","1191","0","57.68","41.56"
"66","000","00","001","0102","1076","471","363","108","24","495","855","0","57.89","42.46"
"66","000","00","001","0103","0000","947","756","191","79","1026","1652","0","62.11","45.76"
"66","000","00","001","0103","1070","947","756","191","79","1026","1652","0","62.11","45.76"
"66","000","00","001","0104","0000","764","602","162","24","788","1431","0","55.07","42.07"
"66","000","00","001","0104","1072","764","602","162","24","788","1431","0","55.07","42.07"
"66","000","00","001","0105","0000","1081","880","201","81","1162","2042","0","56.9","43.1"
"66","000","00","001","0105","1073","577","469","108","36","613","1060","0","57.83","44.25"
"66","000","00","001","0105","1074","504","411","93","45","549","982","0","55.91","41.85"
"66","000","00","001","0106","0000","889","744","145","41","930","1840","0","50.54","40.43"
"66","000","00","001","0106","1077","503","410","93","28","531","1135","0","46.78","36.12"
"66","000","00","001","0106","1078","386","334","52","13","399","705","0","56.6","47.38"
"66","000","00","001","0107","0000","1218","969","249","105","1323","2313","0","57.2","41.89"
"66","000","00","001","0107","1079","569","459","110","31","600","1009","0","59.46","45.49"
"66","000","00","001","0107","1080","649","510","139","74","723","1304","0","55.44","39.11"
"66","000","00","001","0108","0000","850","709","141","27","877","1841","0","47.64","38.51"
"66","000","00","001","0108","1081","850","709","141","27","877","1841","0","47.64","38.51"
"66","000","00","002","0000","0000","35389","28395","6994","2147","37536","64291","76070","58.38","44.17"
"66","000","00","002","0201","0000","1451","1160","291","69","1520","2999","0","50.68","38.68"
"66","000","00","002","0201","1148","419","330","89","19","438","1138","0","38.49","29.0"
"66","000","00","002","0201","1149","541","432","109","21","562","984","0","57.11","43.9"
"66","000","00","002","0201","1150","491","398","93","29","520","877","0","59.29","45.38"
"66","000","00","002","0202","0000","1810","1386","424","129","1939","3129","0","61.97","44.3"
"66","000","00","002","0202","1151","642","485","157","41","683","1070","0","63.83","45.33"
"66","000","00","002","0202","1152","634","490","144","45","679","1106","0","61.39","44.3"
"66","000","00","002","0202","1153","534","411","123","43","577","953","0","60.55","43.13"
"66","000","00","002","0203","0000","1971","1550","421","95","2066","3636","0","56.82","42.63"
"66","000","00","002","0203","1154","678","547","131","18","696","1195","0","58.24","45.77"
"66","000","00","002","0203","1155","672","549","123","33","705","1251","0","56.35","43.88"
"66","000","00","002","0203","1156","621","454","167","44","665","1190","0","55.88","38.15"
"66","000","00","002","0204","0000","1568","1199","369","100","1668","2837","0","58.79","42.26"
"66","000","00","002","0204","1157","739","574","165","49","788","1394","0","56.53","41.18"
"66","000","00","002","0204","1158","829","625","204","51","880","1443","0","60.98","43.31"
"66","000","00","002","0205","0000","1159","991","168","83","1242","1966","0","63.17","50.41"
"66","000","00","002","0205","1161","696","594","102","62","758","1211","0","62.59","49.05"
"66","000","00","002","0205","1162","463","397","66","21","484","755","0","64.11","52.58"
"66","000","00","002","0206","0000","1074","850","224","83","1157","1902","0","60.83","44.69"
"66","000","00","002","0206","1159","399","313","86","36","435","762","0","57.09","41.08"
"66","000","00","002","0206","1160","675","537","138","47","722","1140","0","63.33","47.11"
"66","000","00","002","0207","0000","1286","1001","285","86","1372","2491","0","55.08","40.18"
"66","000","00","002","0207","1163","780","609","171","57","837","1491","0","56.14","40.85"
"66","000","00","002","0207","1164","506","392","114","29","535","1000","0","53.5","39.2"
"66","000","00","002","0208","0000","1219","957","262","78","1297","2215","0","58.56","43.21"
"66","000","00","002","0208","1165","634","492","142","43","677","1114","0","60.77","44.17"
"66","000","00","002","0208","1166","585","465","120","35","620","1101","0","56.31","42.23"
"66","000","00","002","0209","0000","3730","2958","772","238","3968","6563","0","60.46","45.07"
"66","000","00","002","0209","1167","699","556","143","57","756","1169","0","64.67","47.56"
"66","000","00","002","0209","1168","739","606","133","66","805","1283","0","62.74","47.23"
"66","000","00","002","0209","1169","706","560","146","32","738","1168","0","63.18","47.95"
"66","000","00","002","0209","1170","713","548","165","32","745","1386","0","53.75","39.54"
"66","000","00","002","0209","1171","873","688","185","51","924","1557","0","59.34","44.19"
"66","000","00","002","0210","0000","2637","2097","540","142","2779","4658","0","59.66","45.02"
"66","000","00","002","0210","1172","756","577","179","60","816","1380","0","59.13","41.81"
"66","000","00","002","0210","1173","926","754","172","43","969","1674","0","57.89","45.04"
"66","000","00","002","0210","1174","955","766","189","39","994","1604","0","61.97","47.76"
"66","000","00","002","0211","0000","2172","1801","371","121","2293","3743","0","61.26","48.12"
"66","000","00","002","0211","1179","719","612","107","30","749","1252","0","59.82","48.88"
"66","000","00","002","0211","1180","755","605","150","38","793","1250","0","63.44","48.4"
"66","000","00","002","0211","1181","698","584","114","53","751","1241","0","60.52","47.06"
"66","000","00","002","0212","0000","1350","1083","267","89","1439","2606","0","55.22","41.56"
"66","000","00","002","0212","1182","659","510","149","47","706","1318","0","53.57","38.69"
"66","000","00","002","0212","1183","691","573","118","42","733","1288","0","56.91","44.49"
"66","000","00","002","0213","0000","2293","1902","391","172","2465","4096","0","60.18","46.44"
"66","000","00","002","0213","1184","817","673","144","78","895","1442","0","62.07","46.67"
"66","000","00","002","0213","1185","667","533","134","45","712","1202","0","59.23","44.34"
"66","000","00","002","0213","1186","809","696","113","49","858","1452","0","59.09","47.93"
"66","000","00","002","0214","0000","839","707","132","42","881","1693","0","52.04","41.76"
"66","000","00","002","0214","1190","839","707","132","42","881","1693","0","52.04","41.76"
"66","000","00","002","0215","0000","2211","1845","366","106","2317","4083","0","56.75","45.19"
"66","000","00","002","0215","1187","807","657","150","29","836","1480","0","56.49","44.39"
"66","000","00","002","0215","1188","947","832","115","38","985","1736","0","56.74","47.93"
"66","000","00","002","0215","1189","457","356","101","39","496","867","0","57.21","41.06"
"66","000","00","002","0216","0000","4849","3884","965","308","5157","8717","0","59.16","44.56"
"66","000","00","002","0216","1191","873","710","163","67","940","1538","0","61.12","46.16"
"66","000","00","002","0216","1192","916","701","215","83","999","1593","0","62.71","44.01"
"66","000","00","002","0216","1193","789","651","138","24","813","1481","0","54.9","43.96"
"66","000","00","002","0216","1194","820","671","149","42","862","1414","0","60.96","47.45"
"66","000","00","002","0216","1195","683","550","133","28","711","1297","0","54.82","42.41"
"66","000","00","002","0216","1196","768","601","167","64","832","1394","0","59.68","43.11"
"66","000","00","002","0217","0000","3770","3024","746","206","3976","6957","0","57.15","43.47"
"66","000","00","002","0217","1175","1036","814","222","54","1090","1815","0","60.06","44.85"
"66","000","00","002","0217","1176","895","713","182","46","941","1700","0","55.35","41.94"
"66","000","00","002","0217","1177","857","698","159","55","912","1592","0","57.29","43.84"
"66","000","00","002","0217","1178","982","799","183","51","1033","1850","0","55.84","43.19"
"66","000","00","003","0000","0000","60043","48518","11525","3309","63352","103643","125726","61.13","46.81"
"66","000","00","003","0301","0000","2076","1624","452","150","2226","3607","0","61.71","45.02"
"66","000","00","003","0301","1201","670","528","142","45","715","1130","0","63.27","46.73"
"66","000","00","003","0301","1202","736","568","168","47","783","1239","0","63.2","45.84"
"66","000","00","003","0301","1203","670","528","142","58","728","1238","0","58.8","42.65"
"66","000","00","003","0302","0000","2198","1758","440","159","2357","3862","0","61.03","45.52"
"66","000","00","003","0302","1204","731","557","174","56","787","1272","0","61.87","43.79"
"66","000","00","003","0302","1205","725","559","166","40","765","1273","0","60.09","43.91"
"66","000","00","003","0302","1206","742","642","100","63","805","1317","0","61.12","48.75"
"66","000","00","003","0303","0000","2126","1685","441","132","2258","3476","0","64.96","48.48"
"66","000","00","003","0303","1207","748","598","150","40","788","1160","0","67.93","51.55"
"66","000","00","003","0303","1208","730","567","163","55","785","1205","0","65.15","47.05"
"66","000","00","003","0303","1209","648","520","128","37","685","1111","0","61.66","46.8"
"66","000","00","003","0304","0000","1685","1319","366","92","1777","2826","0","62.88","46.67"
"66","000","00","003","0304","1210","880","687","193","44","924","1407","0","65.67","48.83"
"66","000","00","003","0304","1211","805","632","173","48","853","1419","0","60.11","44.54"
"66","000","00","003","0305","0000","1444","1149","295","93","1537","2572","0","59.76","44.67"
"66","000","00","003","0305","1212","675","529","146","62","737","1157","0","63.7","45.72"
"66","000","00","003","0305","1213","769","620","149","31","800","1415","0","56.54","43.82"
"66","000","00","003","0306","0000","1617","1294","323","102","1719","2743","0","62.67","47.17"
"66","000","00","003","0306","1214","800","634","166","46","846","1289","0","65.63","49.19"
"66","000","00","003","0306","1215","817","660","157","56","873","1454","0","60.04","45.39"
"66","000","00","003","0307","0000","2414","1986","428","134","2548","4315","0","59.05","46.03"
"66","000","00","003","0307","1216","809","692","117","55","864","1491","0","57.95","46.41"
"66","000","00","003","0307","1217","797","659","138","30","827","1394","0","59.33","47.27"
"66","000","00","003","0307","1218","808","635","173","49","857","1430","0","59.93","44.41"
"66","000","00","003","0308","0000","2289","1816","473","178","2467","3836","0","64.31","47.34"
"66","000","00","003","0308","1219","771","616","155","66","837","1342","0","62.37","45.9"
"66","000","00","003","0308","1220","802","622","180","82","884","1304","0","67.79","47.7"
"66","000","00","003","0308","1221","716","578","138","30","746","1190","0","62.69","48.57"
"66","000","00","003","0309","0000","3089","2522","567","200","3289","5320","0","61.82","47.41"
"66","000","00","003","0309","1222","700","587","113","56","756","1273","0","59.39","46.11"
"66","000","00","003","0309","1223","844","690","154","62","906","1387","0","65.32","49.75"
"66","000","00","003","0309","1224","777","621","156","35","812","1356","0","59.88","45.8"
"66","000","00","003","0309","1225","768","624","144","47","815","1304","0","62.5","47.85"
"66","000","00","003","0310","0000","2148","1718","430","123","2271","3842","0","59.11","44.72"
"66","000","00","003","0310","1230","745","595","150","53","798","1308","0","61.01","45.49"
"66","000","00","003","0310","1231","699","574","125","34","733","1250","0","58.64","45.92"
"66","000","00","003","0310","1232","704","549","155","36","740","1284","0","57.63","42.76"
"66","000","00","003","0311","0000","4529","3710","819","211","4740","7672","0","61.78","48.36"
"66","000","00","003","0311","1240","992","817","175","47","1039","1643","0","63.24","49.73"
"66","000","00","003","0311","1241","857","677","180","32","889","1423","0","62.47","47.58"
"66","000","00","003","0311","1242","877","722","155","41","918","1542","0","59.53","46.82"
"66","000","00","003","0311","1243","878","739","139","27","905","1533","0","59.03","48.21"
"66","000","00","003","0311","1244","925","755","170","64","989","1531","0","64.6","49.31"
"66","000","00","003","0312","0000","6108","4990","1118","286","6394","10764","0","59.4","46.36"
"66","000","00","003","0312","1248","940","748","192","43","983","1799","0","54.64","41.58"
"66","000","00","003","0312","1249","1036","862","174","48","1084","1708","0","63.47","50.47"
"66","000","00","003","0312","1250","937","766","171","45","982","1700","0","57.76","45.06"
"66","000","00","003","0312","1251","1044","853","191","42","1086","1751","0","62.02","48.72"
"66","000","00","003","0312","1252","1199","980","219","55","1254","2109","0","59.46","46.47"
"66","000","00","003","0312","1253","952","781","171","53","1005","1697","0","59.22","46.02"
"66","000","00","003","0313","0000","4904","4026","878","213","5117","7918","0","64.62","50.85"
"66","000","00","003","0313","1258","753","622","131","39","792","1274","0","62.17","48.82"
"66","000","00","003","0313","1259","885","718","167","33","918","1390","0","66.04","51.65"
"66","000","00","003","0313","1260","819","664","155","30","849","1295","0","65.56","51.27"
"66","000","00","003","0313","1261","759","624","135","46","805","1312","0","61.36","47.56"
"66","000","00","003","0313","1262","871","717","154","30","901","1417","0","63.59","50.6"
"66","000","00","003","0313","1263","817","681","136","35","852","1230","0","69.27","55.37"
"66","000","00","003","0314","0000","2349","1912","437","161","2510","4174","0","60.13","45.81"
"66","000","00","003","0314","1264","726","583","143","55","781","1308","0","59.71","44.57"
"66","000","00","003","0314","1265","805","634","171","70","875","1467","0","59.65","43.22"
"66","000","00","003","0314","1266","818","695","123","36","854","1399","0","61.04","49.68"
"66","000","00","003","0315","0000","1150","901","249","79","1229","1938","0","63.42","46.49"
"66","000","00","003","0315","1197","534","425","109","39","573","937","0","61.15","45.36"
"66","000","00","003","0315","1198","616","476","140","40","656","1001","0","65.53","47.55"
"66","000","00","003","0316","0000","1532","1215","317","110","1642","2451","0","66.99","49.57"
"66","000","00","003","0316","1199","762","610","152","61","823","1249","0","65.89","48.84"
"66","000","00","003","0316","1200","770","605","165","49","819","1202","0","68.14","50.33"
"66","000","00","003","0317","0000","3226","2568","658","142","3368","5388","0","62.51","47.66"
"66","000","00","003","0317","1226","767","614","153","24","791","1256","0","62.98","48.89"
"66","000","00","003","0317","1227","838","659","179","25","863","1364","0","63.27","48.31"
"66","000","00","003","0317","1228","775","591","184","71","846","1361","0","62.16","43.42"
"66","000","00","003","0317","1229","846","704","142","22","868","1407","0","61.69","50.04"
"66","000","00","003","0318","0000","2108","1655","453","127","2235","3501","0","63.84","47.27"
"66","000","00","003","0318","1233","702","547","155","51","753","1175","0","64.09","46.55"
"66","000","00","003","0318","1234","738","576","162","31","769","1158","0","66.41","49.74"
"66","000","00","003","0318","1235","668","532","136","45","713","1168","0","61.04","45.55"
"66","000","00","003","0319","0000","3724","3064","660","143","3867","7241","0","53.4","42.31"
"66","000","00","003","0319","1236","991","830","161","45","1036","1626","0","63.71","51.05"
"66","000","00","003","0319","1237","848","664","184","32","880","2115","0","41.61","31.39"
"66","000","00","003","0319","1238","967","808","159","38","1005","1805","0","55.68","44.76"
"66","000","00","003","0319","1239","918","762","156","28","946","1695","0","55.81","44.96"
"66","000","00","003","0320","0000","2430","1971","459","119","2549","4415","0","57.73","44.64"
"66","000","00","003","0320","1245","709","570","139","30","739","1392","0","53.09","40.95"
"66","000","00","003","0320","1246","871","716","155","46","917","1592","0","57.6","44.97"
"66","000","00","003","0320","1247","850","685","165","43","893","1431","0","62.4","47.87"
"66","000","00","003","0321","0000","3859","3169","690","204","4063","6474","0","62.76","48.95"
"66","000","00","003","0321","1254","815","674","141","46","861","1456","0","59.13","46.29"
"66","000","00","003","0321","1255","1096","888","208","51","1147","1726","0","66.45","51.45"
"66","000","00","003","0321","1256","1029","858","171","53","1082","1723","0","62.8","49.8"
"66","000","00","003","0321","1257","919","749","170","54","973","1569","0","62.01","47.74"
"66","000","00","003","0322","0000","3038","2466","572","151","3189","5308","0","60.08","46.46"
"66","000","00","003","0322","1267","683","537","146","50","733","1207","0","60.73","44.49"
"66","000","00","003","0322","1268","737","613","124","34","771","1317","0","58.54","46.55"
"66","000","00","003","0322","1269","878","687","191","37","915","1563","0","58.54","43.95"
"66","000","00","003","0322","1270","740","629","111","30","770","1221","0","63.06","51.52"
"66","000","00","004","0000","0000","52551","41855","10696","2576","55127","95040","115551","58.0","44.04"
"66","000","00","004","0401","0000","1091","847","244","56","1147","1798","0","63.79","47.11"
"66","000","00","004","0401","1085","597","466","131","38","635","1020","0","62.25","45.69"
"66","000","00","004","0401","1086","494","381","113","18","512","778","0","65.81","48.97"
"66","000","00","004","0402","0000","803","636","167","45","848","1416","0","59.89","44.92"
"66","000","00","004","0402","1084","803","636","167","45","848","1416","0","59.89","44.92"
"66","000","00","004","0403","0000","1008","810","198","47","1055","2261","0","46.66","35.82"
"66","000","00","004","0403","1082","484","397","87","28","512","1400","0","36.57","28.36"
"66","000","00","004","0403","1083","524","413","111","19","543","861","0","63.07","47.97"
"66","000","00","004","0404","0000","1408","1123","285","78","1486","2295","0","64.75","48.93"
"66","000","00","004","0404","1090","766","617","149","37","803","1251","0","64.19","49.32"
"66","000","00","004","0404","1091","642","506","136","41","683","1044","0","65.42","48.47"
"66","000","00","004","0405","0000","759","614","145","43","802","1465","0","54.74","41.91"
"66","000","00","004","0405","1087","759","614","145","43","802","1465","0","54.74","41.91"
"66","000","00","004","0406","0000","1077","844","233","36","1113","1885","0","59.05","44.77"
"66","000","00","004","0406","1088","569","449","120","14","583","1017","0","57.33","44.15"
"66","000","00","004","0406","1089","508","395","113","22","530","868","0","61.06","45.51"
"66","000","00","004","0407","0000","2677","2146","531","130","2807","4791","0","58.59","44.79"
"66","000","00","004","0407","1092","830","663","167","24","854","1487","0","57.43","44.59"
"66","000","00","004","0407","1093","861","690","171","45","906","1573","0","57.6","43.87"
"66","000","00","004","0407","1094","986","793","193","61","1047","1731","0","60.49","45.81"
"66","000","00","004","0408","0000","2254","1812","442","86","2340","3948","0","59.27","45.9"
"66","000","00","004","0408","1095","702","559","143","19","721","1209","0","59.64","46.24"
"66","000","00","004","0408","1096","855","696","159","33","888","1564","0","56.78","44.5"
"66","000","00","004","0408","1097","697","557","140","34","731","1175","0","62.21","47.4"
"66","000","00","004","0409","0000","3017","2374","643","101","3118","5680","0","54.89","41.8"
"66","000","00","004","0409","1098","824","670","154","18","842","1505","0","55.95","44.52"
"66","000","00","004","0409","1099","821","640","181","27","848","1418","0","59.8","45.13"
"66","000","00","004","0409","1100","659","528","131","15","674","1497","0","45.02","35.27"
"66","000","00","004","0409","1101","713","536","177","41","754","1260","0","59.84","42.54"
"66","000","00","004","0410","0000","1232","950","282","90","1322","2330","0","56.74","40.77"
"66","000","00","004","0410","1116","598","473","125","60","658","1129","0","58.28","41.9"
"66","000","00","004","0410","1117","634","477","157","30","664","1201","0","55.29","39.72"
"66","000","00","004","0411","0000","1671","1345","326","97","1768","3196","0","55.32","42.08"
"66","000","00","004","0411","1114","904","732","172","57","961","1822","0","52.74","40.18"
"66","000","00","004","0411","1115","767","613","154","40","807","1374","0","58.73","44.61"
"66","000","00","004","0412","0000","1888","1491","397","127","2015","3502","0","57.54","42.58"
"66","000","00","004","0412","1118","865","683","182","61","926","1639","0","56.5","41.67"
"66","000","00","004","0412","1119","1023","808","215","66","1089","1863","0","58.45","43.37"
"66","000","00","004","0413","0000","1598","1236","362","81","1679","2846","0","59.0","43.43"
"66","000","00","004","0413","1102","805","608","197","46","851","1399","0","60.83","43.46"
"66","000","00","004","0413","1103","793","628","165","35","828","1447","0","57.22","43.4"
"66","000","00","004","0414","0000","3586","2882","704","187","3773","6488","0","58.15","44.42"
"66","000","00","004","0414","1104","929","726","203","53","982","1683","0","58.35","43.14"
"66","000","00","004","0414","1105","907","715","192","48","955","1585","0","60.25","45.11"
"66","000","00","004","0414","1106","895","748","147","35","930","1557","0","59.73","48.04"
"66","000","00","004","0414","1107","855","693","162","51","906","1663","0","54.48","41.67"
"66","000","00","004","0415","0000","3171","2533","638","177","3348","5656","0","59.19","44.78"
"66","000","00","004","0415","1122","707","558","149","55","762","1308","0","58.26","42.66"
"66","000","00","004","0415","1123","795","649","146","52","847","1433","0","59.11","45.29"
"66","000","00","004","0415","1124","786","611","175","30","816","1450","0","56.28","42.14"
"66","000","00","004","0415","1125","883","715","168","40","923","1465","0","63.0","48.81"
"66","000","00","004","0416","0000","3029","2390","639","136","3165","5663","0","55.89","42.2"
"66","000","00","004","0416","1140","650","514","136","26","676","1139","0","59.35","45.13"
"66","000","00","004","0416","1141","650","522","128","32","682","1105","0","61.72","47.24"
"66","000","00","004","0416","1142","821","649","172","43","864","1498","0","57.68","43.32"
"66","000","00","004","0416","1143","908","705","203","35","943","1921","0","49.09","36.7"
"66","000","00","004","0417","0000","3511","2830","681","156","3667","6075","0","60.36","46.58"
"66","000","00","004","0417","1133","927","768","159","40","967","1613","0","59.95","47.61"
"66","000","00","004","0417","1134","806","648","158","44","850","1454","0","58.46","44.57"
"66","000","00","004","0417","1135","921","731","190","36","957","1597","0","59.92","45.77"
"66","000","00","004","0417","1136","857","683","174","36","893","1411","0","63.29","48.41"
"66","000","00","004","0418","0000","2954","2315","639","125","3079","5581","0","55.17","41.48"
"66","000","00","004","0418","1108","1066","826","240","54","1120","1921","0","58.3","43.0"
"66","000","00","004","0418","1109","975","762","213","32","1007","1952","0","51.59","39.04"
"66","000","00","004","0418","1110","913","727","186","39","952","1708","0","55.74","42.56"
"66","000","00","004","0419","0000","3239","2546","693","165","3404","5667","0","60.07","44.93"
"66","000","00","004","0419","1144","730","569","161","50","780","1340","0","58.21","42.46"
"66","000","00","004","0419","1145","908","711","197","19","927","1536","0","60.35","46.29"
"66","000","00","004","0419","1146","739","563","176","66","805","1361","0","59.15","41.37"
"66","000","00","004","0419","1147","862","703","159","30","892","1430","0","62.38","49.16"
"66","000","00","004","0420","0000","1506","1174","332","80","1586","2794","0","56.76","42.02"
"66","000","00","004","0420","1128","818","627","191","40","858","1428","0","60.08","43.91"
"66","000","00","004","0420","1129","688","547","141","40","728","1366","0","53.29","40.04"
"66","000","00","004","0421","0000","1933","1433","500","112","2045","3600","0","56.81","39.81"
"66","000","00","004","0421","1126","939","704","235","60","999","1818","0","54.95","38.72"
"66","000","00","004","0421","1127","994","729","265","52","1046","1782","0","58.7","40.91"
"66","000","00","004","0422","0000","2674","2142","532","159","2833","4803","0","58.98","44.6"
"66","000","00","004","0422","1137","829","658","171","60","889","1493","0","59.54","44.07"
"66","000","00","004","0422","1138","930","769","161","48","978","1600","0","61.13","48.06"
"66","000","00","004","0422","1139","915","715","200","51","966","1710","0","56.49","41.81"
"66","000","00","004","0423","0000","2370","1953","417","98","2468","4187","0","58.94","46.64"
"66","000","00","004","0423","1130","810","654","156","37","847","1498","0","56.54","43.66"
"66","000","00","004","0423","1131","781","652","129","34","815","1350","0","60.37","48.3"
"66","000","00","004","0423","1132","779","647","132","27","806","1339","0","60.19","48.32"
"66","000","00","004","0424","0000","1656","1322","334","83","1739","2791","0","62.31","47.37"
"66","000","00","004","0424","1120","784","636","148","40","824","1287","0","64.02","49.42"
"66","000","00","004","0424","1121","872","686","186","43","915","1504","0","60.84","45.61"
"66","000","00","004","0425","0000","2439","2107","332","81","2520","4322","0","58.31","48.75"
"66","000","00","004","0425","1111","697","584","113","17","714","1131","0","63.13","51.64"
"66","000","00","004","0425","1112","991","923","68","42","1033","1916","0","53.91","48.17"
"66","000","00","004","0425","1113","751","600","151","22","773","1275","0","60.63","47.06"
"66","000","00","005","0000","0000","66222","53751","12471","3239","69461","124621","147528","55.74","43.13"
"66","000","00","005","0501","0000","1065","867","198","62","1127","2047","0","55.06","42.35"
"66","000","00","005","0501","0985","510","419","91","32","542","1051","0","51.57","39.87"
"66","000","00","005","0501","0986","555","448","107","30","585","996","0","58.73","44.98"
"66","000","00","005","0502","0000","1894","1566","328","97","1991","3365","0","59.17","46.54"
"66","000","00","005","0502","0987","843","724","119","20","863","1504","0","57.38","48.14"
"66","000","00","005","0502","0988","552","441","111","53","605","975","0","62.05","45.23"
"66","000","00","005","0502","0989","499","401","98","24","523","886","0","59.03","45.26"
"66","000","00","005","0503","0000","706","577","129","64","770","1404","0","54.84","41.1"
"66","000","00","005","0503","0992","706","577","129","64","770","1404","0","54.84","41.1"
"66","000","00","005","0504","0000","823","694","129","31","854","1532","0","55.74","45.3"
"66","000","00","005","0504","0997","391","325","66","13","404","773","0","52.26","42.04"
"66","000","00","005","0504","0998","432","369","63","18","450","759","0","59.29","48.62"
"66","000","00","005","0505","0000","936","770","166","37","973","1683","0","57.81","45.75"
"66","000","00","005","0505","0995","411","323","88","17","428","704","0","60.8","45.88"
"66","000","00","005","0505","0996","525","447","78","20","545","979","0","55.67","45.66"
"66","000","00","005","0506","0000","1420","1226","194","51","1471","2650","0","55.51","46.26"
"66","000","00","005","0506","0999","807","697","110","37","844","1438","0","58.69","48.47"
"66","000","00","005","0506","1000","613","529","84","14","627","1212","0","51.73","43.65"
"66","000","00","005","0507","0000","1790","1461","329","70","1860","3176","0","58.56","46.0"
"66","000","00","005","0507","1001","930","756","174","41","971","1731","0","56.09","43.67"
"66","000","00","005","0507","1002","860","705","155","29","889","1445","0","61.52","48.79"
"66","000","00","005","0508","0000","2722","2234","488","137","2859","5461","0","52.35","40.91"
"66","000","00","005","0508","1003","984","791","193","39","1023","1855","0","55.15","42.64"
"66","000","00","005","0508","1004","818","698","120","53","871","1728","0","50.41","40.39"
"66","000","00","005","0508","1005","920","745","175","45","965","1878","0","51.38","39.67"
"66","000","00","005","0509","0000","1655","1369","286","55","1710","3340","0","51.2","40.99"
"66","000","00","005","0509","1008","824","674","150","28","852","1761","0","48.38","38.27"
"66","000","00","005","0509","1009","831","695","136","27","858","1579","0","54.34","44.02"
"66","000","00","005","0510","0000","1401","1117","284","75","1476","2482","0","59.47","45.0"
"66","000","00","005","0510","1012","810","632","178","44","854","1476","0","57.86","42.82"
"66","000","00","005","0510","1013","591","485","106","31","622","1006","0","61.83","48.21"
"66","000","00","005","0511","0000","2247","1784","463","101","2348","4309","0","54.49","41.4"
"66","000","00","005","0511","1014","774","624","150","36","810","1403","0","57.73","44.48"
"66","000","00","005","0511","1015","700","549","151","23","723","1446","0","50.0","37.97"
"66","000","00","005","0511","1016","773","611","162","42","815","1460","0","55.82","41.85"
"66","000","00","005","0512","0000","1320","1077","243","41","1361","2260","0","60.22","47.65"
"66","000","00","005","0512","1017","666","546","120","21","687","1233","0","55.72","44.28"
"66","000","00","005","0512","1018","654","531","123","20","674","1027","0","65.63","51.7"
"66","000","00","005","0513","0000","3136","2497","639","125","3261","5590","0","58.34","44.67"
"66","000","00","005","0513","1019","669","538","131","22","691","1207","0","57.25","44.57"
"66","000","00","005","0513","1020","681","549","132","30","711","1167","0","60.93","47.04"
"66","000","00","005","0513","1021","619","493","126","23","642","1150","0","55.83","42.87"
"66","000","00","005","0513","1022","597","476","121","30","627","1061","0","59.1","44.86"
"66","000","00","005","0513","1023","570","441","129","20","590","1005","0","58.71","43.88"
"66","000","00","005","0514","0000","2262","1840","422","133","2395","4077","0","58.74","45.13"
"66","000","00","005","0514","1024","679","546","133","22","701","1250","0","56.08","43.68"
"66","000","00","005","0514","1025","804","645","159","51","855","1448","0","59.05","44.54"
"66","000","00","005","0514","1026","779","649","130","60","839","1379","0","60.84","47.06"
"66","000","00","005","0515","0000","2191","1808","383","101","2292","5070","0","45.21","35.66"
"66","000","00","005","0515","1029","526","423","103","20","546","2078","0","26.28","20.36"
"66","000","00","005","0515","1030","893","739","154","46","939","1562","0","60.12","47.31"
"66","000","00","005","0515","1031","772","646","126","35","807","1430","0","56.43","45.17"
"66","000","00","005","0516","0000","2356","1926","430","112","2468","4440","0","55.59","43.38"
"66","000","00","005","0516","1045","715","579","136","27","742","1461","0","50.79","39.63"
"66","000","00","005","0516","1046","773","639","134","56","829","1310","0","63.28","48.78"
"66","000","00","005","0516","1047","868","708","160","29","897","1669","0","53.74","42.42"
"66","000","00","005","0517","0000","1958","1584","374","88","2046","3614","0","56.61","43.83"
"66","000","00","005","0517","1048","1059","870","189","52","1111","1932","0","57.51","45.03"
"66","000","00","005","0517","1049","899","714","185","36","935","1682","0","55.59","42.45"
"66","000","00","005","0518","0000","2570","2023","547","143","2713","4932","0","55.01","41.02"
"66","000","00","005","0518","1050","955","736","219","43","998","1891","0","52.78","38.92"
"66","000","00","005","0518","1051","993","783","210","70","1063","1882","0","56.48","41.6"
"66","000","00","005","0518","1052","622","504","118","30","652","1159","0","56.26","43.49"
"66","000","00","005","0519","0000","1407","1150","257","121","1528","2613","0","58.48","44.01"
"66","000","00","005","0519","1068","732","604","128","67","799","1346","0","59.36","44.87"
"66","000","00","005","0519","1069","675","546","129","54","729","1267","0","57.54","43.09"
"66","000","00","005","0520","0000","2005","1652","353","115","2120","3752","0","56.5","44.03"
"66","000","00","005","0520","1010","1124","931","193","65","1189","2192","0","54.24","42.47"
"66","000","00","005","0520","1011","881","721","160","50","931","1560","0","59.68","46.22"
"66","000","00","005","0521","0000","3417","2699","718","192","3609","6457","0","55.89","41.8"
"66","000","00","005","0521","1053","813","643","170","50","863","1553","0","55.57","41.4"
"66","000","00","005","0521","1054","831","669","162","51","882","1607","0","54.88","41.63"
"66","000","00","005","0521","1055","948","732","216","39","987","1773","0","55.67","41.29"
"66","000","00","005","0521","1056","825","655","170","52","877","1524","0","57.55","42.98"
"66","000","00","005","0522","0000","2990","2425","565","160","3150","5282","0","59.64","45.91"
"66","000","00","005","0522","1057","943","747","196","58","1001","1613","0","62.06","46.31"
"66","000","00","005","0522","1058","1067","885","182","50","1117","1877","0","59.51","47.15"
"66","000","00","005","0522","1059","980","793","187","52","1032","1792","0","57.59","44.25"
"66","000","00","005","0523","0000","3277","2604","673","136","3413","6037","0","56.53","43.13"
"66","000","00","005","0523","1062","902","700","202","30","932","1556","0","59.9","44.99"
"66","000","00","005","0523","1063","799","628","171","28","827","1497","0","55.24","41.95"
"66","000","00","005","0523","1064","818","677","141","45","863","1550","0","55.68","43.68"
"66","000","00","005","0523","1065","758","599","159","33","791","1434","0","55.16","41.77"
"66","000","00","005","0524","0000","2019","1758","261","87","2106","3734","0","56.4","47.08"
"66","000","00","005","0524","1040","697","669","28","16","713","1243","0","57.36","53.82"
"66","000","00","005","0524","1041","615","543","72","22","637","1219","0","52.26","44.54"
"66","000","00","005","0524","1042","707","546","161","49","756","1272","0","59.43","42.92"
"66","000","00","005","0525","0000","2087","1720","367","82","2169","3777","0","57.43","45.54"
"66","000","00","005","0525","1034","755","629","126","33","788","1432","0","55.03","43.92"
"66","000","00","005","0525","1035","672","540","132","26","698","1157","0","60.33","46.67"
"66","000","00","005","0525","1036","660","551","109","23","683","1188","0","57.49","46.38"
"66","000","00","005","0526","0000","729","571","158","27","756","1437","0","52.61","39.74"
"66","000","00","005","0526","0983","729","571","158","27","756","1437","0","52.61","39.74"
"66","000","00","005","0527","0000","865","647","218","65","930","1708","0","54.45","37.88"
"66","000","00","005","0527","0984","865","647","218","65","930","1708","0","54.45","37.88"
"66","000","00","005","0528","0000","983","781","202","71","1054","2214","0","47.61","35.28"
"66","000","00","005","0528","0990","529","423","106","41","570","1276","0","44.67","33.15"
"66","000","00","005","0528","0991","454","358","96","30","484","938","0","51.6","38.17"
"66","000","00","005","0529","0000","987","767","220","64","1051","1865","0","56.35","41.13"
"66","000","00","005","0529","0993","539","430","109","20","559","996","0","56.12","43.17"
"66","000","00","005","0529","0994","448","337","111","44","492","869","0","56.62","38.78"
"66","000","00","005","0530","0000","1717","1485","232","117","1834","3348","0","54.78","44.35"
"66","000","00","005","0530","1006","874","695","179","63","937","1793","0","52.26","38.76"
"66","000","00","005","0530","1007","843","790","53","54","897","1555","0","57.68","50.8"
"66","000","00","005","0531","0000","1869","1502","367","99","1968","3519","0","55.92","42.68"
"66","000","00","005","0531","1027","899","707","192","59","958","1652","0","57.99","42.8"
"66","000","00","005","0531","1028","970","795","175","40","1010","1867","0","54.1","42.58"
"66","000","00","005","0532","0000","2313","1866","447","87","2400","4305","0","55.75","43.34"
"66","000","00","005","0532","1037","774","631","143","25","799","1419","0","56.31","44.47"
"66","000","00","005","0532","1038","846","686","160","26","872","1653","0","52.75","41.5"
"66","000","00","005","0532","1039","693","549","144","36","729","1233","0","59.12","44.53"
"66","000","00","005","0533","0000","1468","1191","277","79","1547","2689","0","57.53","44.29"
"66","000","00","005","0533","1060","778","626","152","45","823","1392","0","59.12","44.97"
"66","000","00","005","0533","1061","690","565","125","34","724","1297","0","55.82","43.56"
"66","000","00","005","0534","0000","1991","1603","388","81","2072","3659","0","56.63","43.81"
"66","000","00","005","0534","1066","988","795","193","48","1036","1793","0","57.78","44.34"
"66","000","00","005","0534","1067","1003","808","195","33","1036","1866","0","55.52","43.3"
"66","000","00","005","0535","0000","1703","1359","344","64","1767","3065","0","57.65","44.34"
"66","000","00","005","0535","1043","719","582","137","20","739","1285","0","57.51","45.29"
"66","000","00","005","0535","1044","984","777","207","44","1028","1780","0","57.75","43.65"
"66","000","00","005","0536","0000","1943","1551","392","69","2012","3728","0","53.97","41.6"
"66","000","00","005","0536","1032","1121","885","236","38","1159","2018","0","57.43","43.86"
"66","000","00","005","0536","1033","822","666","156","31","853","1710","0","49.88","38.95"
"66","000","00","006","0000","0000","101237","82825","18412","4948","106185","183814","228128","57.77","45.06"
"66","000","00","006","0601","0000","2673","2164","509","127","2800","4749","0","58.96","45.57"
"66","000","00","006","0601","0625","962","761","201","50","1012","1638","0","61.78","46.46"
"66","000","00","006","0601","0626","706","570","136","27","733","1335","0","54.91","42.7"
"66","000","00","006","0601","0627","1005","833","172","50","1055","1776","0","59.4","46.9"
"66","000","00","006","0602","0000","2856","2298","558","135","2991","5323","0","56.19","43.17"
"66","000","00","006","0602","0634","921","705","216","58","979","1749","0","55.97","40.31"
"66","000","00","006","0602","0635","1038","875","163","48","1086","1877","0","57.86","46.62"
"66","000","00","006","0602","0636","897","718","179","29","926","1697","0","54.57","42.31"
"66","000","00","006","0603","0000","2639","2123","516","132","2771","5447","0","50.87","38.98"
"66","000","00","006","0603","0637","858","700","158","44","902","1480","0","60.95","47.3"
"66","000","00","006","0603","0638","925","740","185","48","973","1483","0","65.61","49.9"
"66","000","00","006","0603","0639","856","683","173","40","896","2484","0","36.07","27.5"
"66","000","00","006","0604","0000","477","378","99","46","523","781","0","66.97","48.4"
"66","000","00","006","0604","0640","477","378","99","46","523","781","0","66.97","48.4"
"66","000","00","006","0605","0000","7333","6104","1229","268","7601","13148","0","57.81","46.43"
"66","000","00","006","0605","0641","832","678","154","57","889","1477","0","60.19","45.9"
"66","000","00","006","0605","0642","965","809","156","36","1001","1784","0","56.11","45.35"
"66","000","00","006","0605","0643","944","801","143","22","966","1686","0","57.3","47.51"
"66","000","00","006","0605","0644","931","760","171","31","962","1692","0","56.86","44.92"
"66","000","00","006","0605","0645","874","745","129","21","895","1659","0","53.95","44.91"
"66","000","00","006","0605","0646","917","780","137","32","949","1648","0","57.58","47.33"
"66","000","00","006","0605","0647","912","747","165","28","940","1536","0","61.2","48.63"
"66","000","00","006","0605","0648","958","784","174","41","999","1666","0","59.96","47.06"
"66","000","00","006","0606","0000","2621","2199","422","115","2736","4812","0","56.86","45.7"
"66","000","00","006","0606","0649","807","661","146","45","852","1428","0","59.66","46.29"
"66","000","00","006","0606","0650","950","797","153","37","987","1810","0","54.53","44.03"
"66","000","00","006","0606","0651","864","741","123","33","897","1574","0","56.99","47.08"
"66","000","00","006","0607","0000","2401","1945","456","116","2517","4314","0","58.34","45.09"
"66","000","00","006","0607","0658","947","758","189","30","977","1714","0","57.0","44.22"
"66","000","00","006","0607","0659","790","645","145","52","842","1424","0","59.13","45.29"
"66","000","00","006","0607","0660","664","542","122","34","698","1176","0","59.35","46.09"
"66","000","00","006","0608","0000","1632","1415","217","70","1702","2739","0","62.14","51.66"
"66","000","00","006","0608","0665","801","704","97","51","852","1355","0","62.88","51.96"
"66","000","00","006","0608","0666","831","711","120","19","850","1384","0","61.42","51.37"
"66","000","00","006","0609","0000","2583","2126","457","158","2741","5068","0","54.08","41.95"
"66","000","00","006","0609","0679","890","734","156","74","964","1699","0","56.74","43.2"
"66","000","00","006","0609","0680","842","680","162","43","885","1715","0","51.6","39.65"
"66","000","00","006","0609","0681","851","712","139","41","892","1654","0","53.93","43.05"
"66","000","00","006","0610","0000","1781","1427","354","95","1876","3175","0","59.09","44.94"
"66","000","00","006","0610","0667","920","746","174","46","966","1613","0","59.89","46.25"
"66","000","00","006","0610","0668","861","681","180","49","910","1562","0","58.26","43.6"
"66","000","00","006","0611","0000","2284","1842","442","116","2400","3774","0","63.59","48.81"
"66","000","00","006","0611","0695","719","575","144","24","743","1221","0","60.85","47.09"
"66","000","00","006","0611","0696","806","656","150","43","849","1252","0","67.81","52.4"
"66","000","00","006","0611","0697","759","611","148","49","808","1301","0","62.11","46.96"
"66","000","00","006","0612","0000","1267","1112","155","74","1341","2162","0","62.03","51.43"
"66","000","00","006","0612","0698","635","564","71","31","666","1049","0","63.49","53.77"
"66","000","00","006","0612","0699","632","548","84","43","675","1113","0","60.65","49.24"
"66","000","00","006","0613","0000","1665","1382","283","90","1755","3197","0","54.9","43.23"
"66","000","00","006","0613","0700","799","680","119","48","847","1557","0","54.4","43.67"
"66","000","00","006","0613","0701","866","702","164","42","908","1640","0","55.37","42.8"
"66","000","00","006","0614","0000","2611","2131","480","193","2804","4807","0","58.33","44.33"
"66","000","00","006","0614","0702","867","690","177","66","933","1402","0","66.55","49.22"
"66","000","00","006","0614","0703","837","686","151","69","906","1717","0","52.77","39.95"
"66","000","00","006","0614","0704","907","755","152","58","965","1688","0","57.17","44.73"
"66","000","00","006","0615","0000","2575","2109","466","145","2720","4904","0","55.46","43.01"
"66","000","00","006","0615","0705","660","525","135","59","719","1168","0","61.56","44.95"
"66","000","00","006","0615","0706","898","750","148","44","942","1729","0","54.48","43.38"
"66","000","00","006","0615","0707","1017","834","183","42","1059","2007","0","52.77","41.55"
"66","000","00","006","0616","0000","1242","1004","238","91","1333","2364","0","56.39","42.47"
"66","000","00","006","0616","0708","723","587","136","74","797","1296","0","61.5","45.29"
"66","000","00","006","0616","0709","519","417","102","17","536","1068","0","50.19","39.04"
"66","000","00","006","0617","0000","1767","1476","291","104","1871","3343","0","55.97","44.15"
"66","000","00","006","0617","0710","846","715","131","61","907","1707","0","53.13","41.89"
"66","000","00","006","0617","0711","921","761","160","43","964","1636","0","58.92","46.52"
"66","000","00","006","0618","0000","6441","5319","1122","277","6718","12239","0","54.89","43.46"
"66","000","00","006","0618","0712","806","662","144","39","845","1761","0","47.98","37.59"
"66","000","00","006","0618","0713","725","590","135","40","765","1314","0","58.22","44.9"
"66","000","00","006","0618","0714","750","615","135","36","786","1233","0","63.75","49.88"
"66","000","00","006","0618","0715","803","655","148","48","851","1549","0","54.94","42.29"
"66","000","00","006","0618","0716","848","726","122","29","877","1639","0","53.51","44.3"
"66","000","00","006","0618","0717","768","632","136","45","813","1486","0","54.71","42.53"
"66","000","00","006","0618","0718","971","803","168","18","989","1806","0","54.76","44.46"
"66","000","00","006","0618","0719","770","636","134","22","792","1451","0","54.58","43.83"
"66","000","00","006","0619","0000","1536","1270","266","72","1608","2655","0","60.56","47.83"
"66","000","00","006","0619","0720","736","626","110","30","766","1302","0","58.83","48.08"
"66","000","00","006","0619","0721","800","644","156","42","842","1353","0","62.23","47.6"
"66","000","00","006","0620","0000","2565","2062","503","146","2711","4520","0","59.98","45.62"
"66","000","00","006","0620","0741","627","506","121","44","671","1206","0","55.64","41.96"
"66","000","00","006","0620","0742","636","489","147","45","681","1086","0","62.71","45.03"
"66","000","00","006","0620","0743","652","533","119","29","681","1088","0","62.59","48.99"
"66","000","00","006","0620","0744","650","534","116","28","678","1140","0","59.47","46.84"
"66","000","00","006","0621","0000","3405","2746","659","133","3538","6178","0","57.27","44.45"
"66","000","00","006","0621","0682","862","702","160","23","885","1636","0","54.1","42.91"
"66","000","00","006","0621","0683","699","550","149","22","721","1298","0","55.55","42.37"
"66","000","00","006","0621","0684","798","636","162","41","839","1391","0","60.32","45.72"
"66","000","00","006","0621","0685","1046","858","188","47","1093","1853","0","58.99","46.3"
"66","000","00","006","0622","0000","1949","1610","339","99","2048","3629","0","56.43","44.36"
"66","000","00","006","0622","0686","951","787","164","56","1007","1820","0","55.33","43.24"
"66","000","00","006","0622","0687","998","823","175","43","1041","1809","0","57.55","45.49"
"66","000","00","006","0623","0000","3727","3019","708","191","3918","6663","0","58.8","45.31"
"66","000","00","006","0623","0691","941","750","191","42","983","1674","0","58.72","44.8"
"66","000","00","006","0623","0692","954","761","193","54","1008","1610","0","62.61","47.27"
"66","000","00","006","0623","0693","940","771","169","42","982","1695","0","57.94","45.49"
"66","000","00","006","0623","0694","892","737","155","53","945","1684","0","56.12","43.76"
"66","000","00","006","0624","0000","2564","2134","430","121","2685","4890","0","54.91","43.64"
"66","000","00","006","0624","0631","867","730","137","25","892","1710","0","52.16","42.69"
"66","000","00","006","0624","0632","808","632","176","46","854","1595","0","53.54","39.62"
"66","000","00","006","0624","0633","889","772","117","50","939","1585","0","59.24","48.71"
"66","000","00","006","0625","0000","2442","1988","454","86","2528","4205","0","60.12","47.28"
"66","000","00","006","0625","0672","885","718","167","47","932","1494","0","62.38","48.06"
"66","000","00","006","0625","0673","753","623","130","17","770","1325","0","58.11","47.02"
"66","000","00","006","0625","0674","804","647","157","22","826","1386","0","59.6","46.68"
"66","000","00","006","0626","0000","2392","1900","492","90","2482","4271","0","58.11","44.49"
"66","000","00","006","0626","0628","757","601","156","17","774","1351","0","57.29","44.49"
"66","000","00","006","0626","0629","778","603","175","41","819","1338","0","61.21","45.07"
"66","000","00","006","0626","0630","857","696","161","32","889","1582","0","56.19","43.99"
"66","000","00","006","0627","0000","2712","2207","505","128","2840","4987","0","56.95","44.26"
"66","000","00","006","0627","0652","913","746","167","22","935","1650","0","56.67","45.21"
"66","000","00","006","0627","0653","912","750","162","59","971","1681","0","57.76","44.62"
"66","000","00","006","0627","0654","887","711","176","47","934","1656","0","56.4","42.93"
"66","000","00","006","0628","0000","2464","2046","418","134","2598","4145","0","62.68","49.36"
"66","000","00","006","0628","0655","710","591","119","51","761","1243","0","61.22","47.55"
"66","000","00","006","0628","0656","882","721","161","54","936","1471","0","63.63","49.01"
"66","000","00","006","0628","0657","872","734","138","29","901","1431","0","62.96","51.29"
"66","000","00","006","0629","0000","3138","2610","528","171","3309","5327","0","62.12","49.0"
"66","000","00","006","0629","0661","823","672","151","60","883","1456","0","60.65","46.15"
"66","000","00","006","0629","0662","888","745","143","45","933","1451","0","64.3","51.34"
"66","000","00","006","0629","0663","674","574","100","24","698","1063","0","65.66","54.0"
"66","000","00","006","0629","0664","753","619","134","42","795","1357","0","58.59","45.62"
"66","000","00","006","0630","0000","2045","1578","467","149","2194","3585","0","61.2","44.02"
"66","000","00","006","0630","0669","735","563","172","59","794","1219","0","65.14","46.19"
"66","000","00","006","0630","0670","677","521","156","40","717","1235","0","58.06","42.19"
"66","000","00","006","0630","0671","633","494","139","50","683","1131","0","60.39","43.68"
"66","000","00","006","0631","0000","3863","3115","748","214","4077","7145","0","57.06","43.6"
"66","000","00","006","0631","0675","1010","792","218","63","1073","1816","0","59.09","43.61"
"66","000","00","006","0631","0676","892","738","154","42","934","1734","0","53.86","42.56"
"66","000","00","006","0631","0677","1013","825","188","53","1066","1777","0","59.99","46.43"
"66","000","00","006","0631","0678","948","760","188","56","1004","1818","0","55.23","41.8"
"66","000","00","006","0632","0000","2476","2007","469","148","2624","4359","0","60.2","46.04"
"66","000","00","006","0632","0688","798","659","139","44","842","1352","0","62.28","48.74"
"66","000","00","006","0632","0689","821","663","158","58","879","1521","0","57.79","43.59"
"66","000","00","006","0632","0690","857","685","172","46","903","1486","0","60.77","46.1"
"66","000","00","006","0633","0000","2463","1990","473","141","2604","4285","0","60.77","46.44"
"66","000","00","006","0633","0733","862","676","186","45","907","1526","0","59.44","44.3"
"66","000","00","006","0633","0734","805","668","137","59","864","1425","0","60.63","46.88"
"66","000","00","006","0633","0735","796","646","150","37","833","1334","0","62.44","48.43"
"66","000","00","006","0634","0000","1784","1448","336","53","1837","3215","0","57.14","45.04"
"66","000","00","006","0634","0736","964","780","184","26","990","1649","0","60.04","47.3"
"66","000","00","006","0634","0737","820","668","152","27","847","1566","0","54.09","42.66"
"66","000","00","006","0635","0000","2736","2235","501","102","2838","4699","0","60.4","47.56"
"66","000","00","006","0635","0738","955","794","161","38","993","1629","0","60.96","48.74"
"66","000","00","006","0635","0739","926","722","204","32","958","1628","0","58.85","44.35"
"66","000","00","006","0635","0740","855","719","136","32","887","1442","0","61.51","49.86"
"66","000","00","006","0636","0000","1530","1264","266","80","1610","3043","0","52.91","41.54"
"66","000","00","006","0636","0731","732","612","120","42","774","1541","0","50.23","39.71"
"66","000","00","006","0636","0732","798","652","146","38","836","1502","0","55.66","43.41"
"66","000","00","006","0637","0000","1565","1275","290","52","1617","2917","0","55.43","43.71"
"66","000","00","006","0637","0729","785","649","136","27","812","1402","0","57.92","46.29"
"66","000","00","006","0637","0730","780","626","154","25","805","1515","0","53.14","41.32"
"66","000","00","006","0638","0000","4005","3236","769","151","4156","7133","0","58.26","45.37"
"66","000","00","006","0638","0725","999","809","190","46","1045","1847","0","56.58","43.8"
"66","000","00","006","0638","0726","982","795","187","27","1009","1738","0","58.06","45.74"
"66","000","00","006","0638","0727","962","791","171","43","1005","1640","0","61.28","48.23"
"66","000","00","006","0638","0728","1062","841","221","35","1097","1908","0","57.49","44.08"
"66","000","00","006","0639","0000","3028","2531","497","135","3163","5617","0","56.31","45.06"
"66","000","00","006","0639","0722","1204","1001","203","51","1255","2162","0","58.05","46.3"
"66","000","00","006","0639","0723","811","668","143","54","865","1520","0","56.91","43.95"
"66","000","00","006","0639","0724","1013","862","151","30","1043","1935","0","53.9","44.55"
"66","000","00","007","0000","0000","77556","63052","14504","3946","81502","135448","170160","60.17","46.55"
"66","000","00","007","0701","0000","4869","3954","915","242","5111","8349","0","61.22","47.36"
"66","000","00","007","0701","0745","751","586","165","56","807","1321","0","61.09","44.36"
"66","000","00","007","0701","0746","790","620","170","55","845","1346","0","62.78","46.06"
"66","000","00","007","0701","0747","811","634","177","47","858","1428","0","60.08","44.4"
"66","000","00","007","0701","0748","799","663","136","37","836","1442","0","57.98","45.98"
"66","000","00","007","0701","0749","884","746","138","22","906","1408","0","64.35","52.98"
"66","000","00","007","0701","0750","834","705","129","25","859","1404","0","61.18","50.21"
"66","000","00","007","0702","0000","6462","5237","1225","316","6778","10909","0","62.13","48.01"
"66","000","00","007","0702","0751","810","676","134","51","861","1354","0","63.59","49.93"
"66","000","00","007","0702","0752","790","620","170","46","836","1332","0","62.76","46.55"
"66","000","00","007","0702","0753","890","725","165","36","926","1463","0","63.29","49.56"
"66","000","00","007","0702","0754","810","654","156","46","856","1413","0","60.58","46.28"
"66","000","00","007","0702","0755","735","606","129","39","774","1218","0","63.55","49.75"
"66","000","00","007","0702","0756","738","598","140","25","763","1308","0","58.33","45.72"
"66","000","00","007","0702","0757","919","745","174","42","961","1527","0","62.93","48.79"
"66","000","00","007","0702","0758","770","613","157","31","801","1294","0","61.9","47.37"
"66","000","00","007","0703","0000","3196","2576","620","212","3408","5848","0","58.28","44.05"
"66","000","00","007","0703","0759","771","616","155","44","815","1516","0","53.76","40.63"
"66","000","00","007","0703","0760","868","711","157","78","946","1529","0","61.87","46.5"
"66","000","00","007","0703","0761","798","630","168","60","858","1397","0","61.42","45.1"
"66","000","00","007","0703","0762","759","619","140","30","789","1406","0","56.12","44.03"
"66","000","00","007","0704","0000","2219","1794","425","151","2370","4409","0","53.75","40.69"
"66","000","00","007","0704","0763","776","627","149","49","825","1497","0","55.11","41.88"
"66","000","00","007","0704","0764","748","606","142","69","817","1424","0","57.37","42.56"
"66","000","00","007","0704","0765","695","561","134","33","728","1488","0","48.92","37.7"
"66","000","00","007","0705","0000","3133","2564","569","164","3297","6387","0","51.62","40.14"
"66","000","00","007","0705","0768","581","444","137","55","636","1190","0","53.45","37.31"
"66","000","00","007","0705","0769","635","527","108","29","664","1174","0","56.56","44.89"
"66","000","00","007","0705","0770","701","586","115","23","724","1224","0","59.15","47.88"
"66","000","00","007","0705","0771","664","550","114","36","700","1466","0","47.75","37.52"
"66","000","00","007","0705","0772","552","457","95","21","573","1333","0","42.99","34.28"
"66","000","00","007","0706","0000","469","379","90","51","520","814","0","63.88","46.56"
"66","000","00","007","0706","0773","469","379","90","51","520","814","0","63.88","46.56"
"66","000","00","007","0707","0000","5270","4372","898","284","5554","9662","0","57.48","45.25"
"66","000","00","007","0707","0774","730","586","144","55","785","1436","0","54.67","40.81"
"66","000","00","007","0707","0775","855","692","163","52","907","1515","0","59.87","45.68"
"66","000","00","007","0707","0776","767","649","118","37","804","1545","0","52.04","42.01"
"66","000","00","007","0707","0777","779","646","133","35","814","1383","0","58.86","46.71"
"66","000","00","007","0707","0778","820","697","123","37","857","1433","0","59.8","48.64"
"66","000","00","007","0707","0779","591","468","123","34","625","1134","0","55.11","41.27"
"66","000","00","007","0707","0780","728","634","94","34","762","1216","0","62.66","52.14"
"66","000","00","007","0708","0000","779","629","150","38","817","1397","0","58.48","45.03"
"66","000","00","007","0708","0785","779","629","150","38","817","1397","0","58.48","45.03"
"66","000","00","007","0709","0000","2693","2182","511","138","2831","4800","0","58.98","45.46"
"66","000","00","007","0709","0786","860","672","188","62","922","1607","0","57.37","41.82"
"66","000","00","007","0709","0787","908","750","158","34","942","1582","0","59.54","47.41"
"66","000","00","007","0709","0788","925","760","165","42","967","1611","0","60.02","47.18"
"66","000","00","007","0710","0000","3963","3237","726","155","4118","6621","0","62.2","48.89"
"66","000","00","007","0710","0789","806","622","184","36","842","1322","0","63.69","47.05"
"66","000","00","007","0710","0790","827","684","143","32","859","1321","0","65.03","51.78"
"66","000","00","007","0710","0791","770","650","120","41","811","1360","0","59.63","47.79"
"66","000","00","007","0710","0792","801","665","136","13","814","1361","0","59.81","48.86"
"66","000","00","007","0710","0793","759","616","143","33","792","1257","0","63.01","49.01"
"66","000","00","007","0711","0000","3084","2492","592","165","3249","5151","0","63.08","48.38"
"66","000","00","007","0711","0809","710","585","125","41","751","1171","0","64.13","49.96"
"66","000","00","007","0711","0810","749","587","162","57","806","1349","0","59.75","43.51"
"66","000","00","007","0711","0811","840","685","155","34","874","1368","0","63.89","50.07"
"66","000","00","007","0711","0812","785","635","150","33","818","1263","0","64.77","50.28"
"66","000","00","007","0712","0000","3586","2843","743","164","3750","6052","0","61.96","46.98"
"66","000","00","007","0712","0822","1003","831","172","31","1034","1544","0","66.97","53.82"
"66","000","00","007","0712","0823","930","715","215","43","973","1482","0","65.65","48.25"
"66","000","00","007","0712","0824","871","689","182","57","928","1488","0","62.37","46.3"
"66","000","00","007","0712","0825","782","608","174","33","815","1538","0","52.99","39.53"
"66","000","00","007","0713","0000","2626","2116","510","124","2750","4239","0","64.87","49.92"
"66","000","00","007","0713","0805","659","524","135","28","687","981","0","70.03","53.41"
"66","000","00","007","0713","0806","660","530","130","44","704","1097","0","64.18","48.31"
"66","000","00","007","0713","0807","624","510","114","25","649","991","0","65.49","51.46"
"66","000","00","007","0713","0808","683","552","131","27","710","1170","0","60.68","47.18"
"66","000","00","007","0714","0000","847","658","189","89","936","1421","0","65.87","46.31"
"66","000","00","007","0714","0766","371","293","78","37","408","608","0","67.11","48.19"
"66","000","00","007","0714","0767","476","365","111","52","528","813","0","64.94","44.9"
"66","000","00","007","0715","0000","2838","2283","555","128","2966","4733","0","62.67","48.24"
"66","000","00","007","0715","0836","747","618","129","26","773","1278","0","60.49","48.36"
"66","000","00","007","0715","0837","720","582","138","34","754","1144","0","65.91","50.87"
"66","000","00","007","0715","0838","661","508","153","37","698","1140","0","61.23","44.56"
"66","000","00","007","0715","0839","710","575","135","31","741","1171","0","63.28","49.1"
"66","000","00","007","0716","0000","2130","1732","398","135","2265","3673","0","61.67","47.15"
"66","000","00","007","0716","0829","737","607","130","46","783","1217","0","64.34","49.88"
"66","000","00","007","0716","0830","747","604","143","55","802","1347","0","59.54","44.84"
"66","000","00","007","0716","0831","646","521","125","34","680","1109","0","61.32","46.98"
"66","000","00","007","0717","0000","2925","2376","549","156","3081","5144","0","59.9","46.19"
"66","000","00","007","0717","0832","846","703","143","51","897","1546","0","58.02","45.47"
"66","000","00","007","0717","0833","865","689","176","40","905","1408","0","64.28","48.93"
"66","000","00","007","0717","0834","568","466","102","18","586","1057","0","55.44","44.09"
"66","000","00","007","0717","0835","646","518","128","47","693","1133","0","61.17","45.72"
"66","000","00","007","0718","0000","2675","2179","496","166","2841","5184","0","54.8","42.03"
"66","000","00","007","0718","0826","988","803","185","69","1057","1674","0","63.14","47.97"
"66","000","00","007","0718","0827","821","655","166","42","863","1996","0","43.24","32.82"
"66","000","00","007","0718","0828","866","721","145","55","921","1514","0","60.83","47.62"
"66","000","00","007","0719","0000","2133","1732","401","118","2251","3517","0","64.0","49.25"
"66","000","00","007","0719","0843","692","542","150","40","732","1139","0","64.27","47.59"
"66","000","00","007","0719","0844","740","607","133","40","780","1216","0","64.14","49.92"
"66","000","00","007","0719","0845","701","583","118","38","739","1162","0","63.6","50.17"
"66","000","00","007","0720","0000","2404","1939","465","118","2522","4276","0","58.98","45.35"
"66","000","00","007","0720","0840","801","645","156","37","838","1303","0","64.31","49.5"
"66","000","00","007","0720","0841","733","588","145","40","773","1402","0","55.14","41.94"
"66","000","00","007","0720","0842","870","706","164","41","911","1571","0","57.99","44.94"
"66","000","00","007","0721","0000","3579","2880","699","155","3734","6405","0","58.3","44.96"
"66","000","00","007","0721","0813","929","746","183","39","968","1547","0","62.57","48.22"
"66","000","00","007","0721","0814","947","772","175","42","989","1649","0","59.98","46.82"
"66","000","00","007","0721","0815","885","720","165","33","918","1629","0","56.35","44.2"
"66","000","00","007","0721","0816","818","642","176","41","859","1580","0","54.37","40.63"
"66","000","00","007","0722","0000","4191","3401","790","156","4347","7096","0","61.26","47.93"
"66","000","00","007","0722","0817","921","752","169","26","947","1444","0","65.58","52.08"
"66","000","00","007","0722","0818","802","659","143","23","825","1413","0","58.39","46.64"
"66","000","00","007","0722","0819","776","649","127","29","805","1377","0","58.46","47.13"
"66","000","00","007","0722","0820","888","682","206","45","933","1527","0","61.1","44.66"
"66","000","00","007","0722","0821","804","659","145","33","837","1335","0","62.7","49.36"
"66","000","00","007","0723","0000","2809","2268","541","167","2976","5132","0","57.99","44.19"
"66","000","00","007","0723","0781","671","542","129","64","735","1271","0","57.83","42.64"
"66","000","00","007","0723","0782","637","521","116","28","665","1203","0","55.28","43.31"
"66","000","00","007","0723","0783","719","577","142","23","742","1268","0","58.52","45.5"
"66","000","00","007","0723","0784","782","628","154","52","834","1390","0","60.0","45.18"
"66","000","00","007","0724","0000","4810","4020","790","208","5018","7974","0","62.93","50.41"
"66","000","00","007","0724","0799","669","555","114","39","708","1102","0","64.25","50.36"
"66","000","00","007","0724","0800","1019","850","169","32","1051","1630","0","64.48","52.15"
"66","000","00","007","0724","0801","801","677","124","32","833","1333","0","62.49","50.79"
"66","000","00","007","0724","0802","795","651","144","29","824","1292","0","63.78","50.39"
"66","000","00","007","0724","0803","746","617","129","37","783","1272","0","61.56","48.51"
"66","000","00","007","0724","0804","780","670","110","39","819","1345","0","60.89","49.81"
"66","000","00","007","0725","0000","3866","3209","657","146","4012","6255","0","64.14","51.3"
"66","000","00","007","0725","0794","756","623","133","26","782","1207","0","64.79","51.62"
"66","000","00","007","0725","0795","793","667","126","23","816","1282","0","63.65","52.03"
"66","000","00","007","0725","0796","791","654","137","27","818","1248","0","65.54","52.4"
"66","000","00","007","0725","0797","815","675","140","37","852","1304","0","65.34","51.76"
"66","000","00","007","0725","0798","711","590","121","33","744","1214","0","61.29","48.6"
"66","000","00","008","0000","0000","123256","100833","22423","6126","129382","227720","278096","56.82","44.28"
"66","000","00","008","0801","0000","1627","1339","288","103","1730","3258","0","53.1","41.1"
"66","000","00","008","0801","0850","549","458","91","25","574","1107","0","51.85","41.37"
"66","000","00","008","0801","0851","1078","881","197","78","1156","2151","0","53.74","40.96"
"66","000","00","008","0802","0000","1836","1503","333","121","1957","3376","0","57.97","44.52"
"66","000","00","008","0802","0846","966","788","178","60","1026","1670","0","61.44","47.19"
"66","000","00","008","0802","0847","870","715","155","61","931","1706","0","54.57","41.91"
"66","000","00","008","0803","0000","3816","3170","646","111","3927","7049","0","55.71","44.97"
"66","000","00","008","0803","0852","928","780","148","25","953","1612","0","59.12","48.39"
"66","000","00","008","0803","0853","935","774","161","44","979","1743","0","56.17","44.41"
"66","000","00","008","0803","0854","1061","863","198","42","1103","2099","0","52.55","41.11"
"66","000","00","008","0803","0855","892","753","139","0","892","1595","0","55.92","47.21"
"66","000","00","008","0804","0000","2966","2400","566","130","3096","5567","0","55.61","43.11"
"66","000","00","008","0804","0924","858","679","179","31","889","1640","0","54.21","41.4"
"66","000","00","008","0804","0925","1080","885","195","55","1135","2052","0","55.31","43.13"
"66","000","00","008","0804","0926","1028","836","192","44","1072","1875","0","57.17","44.59"
"66","000","00","008","0805","0000","2812","2307","505","122","2934","5056","0","58.03","45.63"
"66","000","00","008","0805","0943","963","785","178","37","1000","1661","0","60.2","47.26"
"66","000","00","008","0805","0944","928","762","166","46","974","1667","0","58.43","45.71"
"66","000","00","008","0805","0945","921","760","161","39","960","1728","0","55.56","43.98"
"66","000","00","008","0806","0000","2267","1867","400","123","2390","4533","0","52.72","41.19"
"66","000","00","008","0806","0860","803","640","163","46","849","1563","0","54.32","40.95"
"66","000","00","008","0806","0861","780","640","140","60","840","1559","0","53.88","41.05"
"66","000","00","008","0806","0862","684","587","97","17","701","1411","0","49.68","41.6"
"66","000","00","008","0807","0000","3268","2698","570","140","3408","5930","0","57.47","45.5"
"66","000","00","008","0807","0894","829","702","127","43","872","1445","0","60.35","48.58"
"66","000","00","008","0807","0895","942","769","173","39","981","1842","0","53.26","41.75"
"66","000","00","008","0807","0896","689","572","117","28","717","1187","0","60.4","48.19"
"66","000","00","008","0807","0897","808","655","153","30","838","1456","0","57.55","44.99"
"66","000","00","008","0808","0000","7402","6029","1373","346","7748","12981","0","59.69","46.44"
"66","000","00","008","0808","0863","1004","829","175","34","1038","1761","0","58.94","47.08"
"66","000","00","008","0808","0864","805","646","159","50","855","1361","0","62.82","47.47"
"66","000","00","008","0808","0865","996","802","194","60","1056","1852","0","57.02","43.3"
"66","000","00","008","0808","0866","1068","888","180","39","1107","1928","0","57.42","46.06"
"66","000","00","008","0808","0867","928","749","179","29","957","1492","0","64.14","50.2"
"66","000","00","008","0808","0868","1042","860","182","56","1098","1998","0","54.95","43.04"
"66","000","00","008","0808","0869","787","622","165","38","825","1272","0","64.86","48.9"
"66","000","00","008","0808","0870","772","633","139","40","812","1317","0","61.66","48.06"
"66","000","00","008","0809","0000","6269","5178","1091","363","6632","11817","0","56.12","43.82"
"66","000","00","008","0809","0871","655","515","140","64","719","1327","0","54.18","38.81"
"66","000","00","008","0809","0872","650","519","131","26","676","1280","0","52.81","40.55"
"66","000","00","008","0809","0873","926","762","164","54","980","1865","0","52.55","40.86"
"66","000","00","008","0809","0874","732","613","119","51","783","1230","0","63.66","49.84"
"66","000","00","008","0809","0875","684","571","113","43","727","1356","0","53.61","42.11"
"66","000","00","008","0809","0876","938","791","147","53","991","1732","0","57.22","45.67"
"66","000","00","008","0809","0877","907","760","147","37","944","1586","0","59.52","47.92"
"66","000","00","008","0809","0878","777","647","130","35","812","1441","0","56.35","44.9"
"66","000","00","008","0810","0000","5187","4273","914","276","5463","9996","0","54.65","42.75"
"66","000","00","008","0810","0879","1058","865","193","54","1112","2045","0","54.38","42.3"
"66","000","00","008","0810","0880","939","741","198","68","1007","1914","0","52.61","38.71"
"66","000","00","008","0810","0881","1029","859","170","58","1087","1918","0","56.67","44.79"
"66","000","00","008","0810","0882","1051","906","145","33","1084","2079","0","52.14","43.58"
"66","000","00","008","0810","0883","1110","902","208","63","1173","2040","0","57.5","44.22"
"66","000","00","008","0811","0000","895","675","220","28","923","2037","0","45.31","33.14"
"66","000","00","008","0811","0890","895","675","220","28","923","2037","0","45.31","33.14"
"66","000","00","008","0812","0000","543","450","93","37","580","985","0","58.88","45.69"
"66","000","00","008","0812","0889","543","450","93","37","580","985","0","58.88","45.69"
"66","000","00","008","0813","0000","4869","4056","813","190","5059","9749","0","51.89","41.6"
"66","000","00","008","0813","0884","957","812","145","52","1009","2027","0","49.78","40.06"
"66","000","00","008","0813","0885","744","614","130","45","789","1402","0","56.28","43.79"
"66","000","00","008","0813","0886","1018","842","176","45","1063","1826","0","58.21","46.11"
"66","000","00","008","0813","0887","1060","902","158","26","1086","2162","0","50.23","41.72"
"66","000","00","008","0813","0888","1090","886","204","22","1112","2332","0","47.68","37.99"
"66","000","00","008","0814","0000","1184","988","196","72","1256","2094","0","59.98","47.18"
"66","000","00","008","0814","0891","590","489","101","42","632","1032","0","61.24","47.38"
"66","000","00","008","0814","0892","594","499","95","30","624","1062","0","58.76","46.99"
"66","000","00","008","0815","0000","472","381","91","49","521","909","0","57.32","41.91"
"66","000","00","008","0815","0893","472","381","91","49","521","909","0","57.32","41.91"
"66","000","00","008","0816","0000","4560","3674","886","259","4819","8139","0","59.21","45.14"
"66","000","00","008","0816","0915","831","661","170","55","886","1458","0","60.77","45.34"
"66","000","00","008","0816","0916","896","741","155","50","946","1571","0","60.22","47.17"
"66","000","00","008","0816","0917","875","691","184","62","937","1579","0","59.34","43.76"
"66","000","00","008","0816","0918","1036","828","208","50","1086","1849","0","58.73","44.78"
"66","000","00","008","0816","0919","922","753","169","42","964","1682","0","57.31","44.77"
"66","000","00","008","0817","0000","4301","3528","773","161","4462","8903","0","50.12","39.63"
"66","000","00","008","0817","0949","1168","970","198","46","1214","2078","0","58.42","46.68"
"66","000","00","008","0817","0950","1116","910","206","45","1161","2059","0","56.39","44.2"
"66","000","00","008","0817","0951","1005","829","176","38","1043","1792","0","58.2","46.26"
"66","000","00","008","0817","0952","1012","819","193","32","1044","2974","0","35.1","27.54"
"66","000","00","008","0818","0000","4638","3613","1025","195","4833","7936","0","60.9","45.53"
"66","000","00","008","0818","0954","1253","835","418","51","1304","2099","0","62.12","39.78"
"66","000","00","008","0818","0955","1121","901","220","44","1165","1823","0","63.91","49.42"
"66","000","00","008","0818","0956","1166","973","193","69","1235","2022","0","61.08","48.12"
"66","000","00","008","0818","0957","1098","904","194","31","1129","1992","0","56.68","45.38"
"66","000","00","008","0819","0000","923","742","181","56","979","1585","0","61.77","46.81"
"66","000","00","008","0819","0958","923","742","181","56","979","1585","0","61.77","46.81"
"66","000","00","008","0820","0000","5605","4697","908","238","5843","9652","0","60.54","48.66"
"66","000","00","008","0820","0962","1007","858","149","42","1049","1755","0","59.77","48.89"
"66","000","00","008","0820","0963","969","810","159","37","1006","1497","0","67.2","54.11"
"66","000","00","008","0820","0964","934","772","162","52","986","1567","0","62.92","49.27"
"66","000","00","008","0820","0965","863","737","126","42","905","1624","0","55.73","45.38"
"66","000","00","008","0820","0966","942","773","169","43","985","1614","0","61.03","47.89"
"66","000","00","008","0820","0967","890","747","143","22","912","1595","0","57.18","46.83"
"66","000","00","008","0821","0000","2867","2340","527","142","3009","5219","0","57.65","44.84"
"66","000","00","008","0821","0959","915","737","178","46","961","1565","0","61.41","47.09"
"66","000","00","008","0821","0960","850","709","141","45","895","1780","0","50.28","39.83"
"66","000","00","008","0821","0961","1102","894","208","51","1153","1874","0","61.53","47.71"
"66","000","00","008","0822","0000","581","466","115","46","627","1072","0","58.49","43.47"
"66","000","00","008","0822","0953","581","466","115","46","627","1072","0","58.49","43.47"
"66","000","00","008","0823","0000","3715","3000","715","222","3937","6608","0","59.58","45.4"
"66","000","00","008","0823","0979","1007","805","202","54","1061","1785","0","59.44","45.1"
"66","000","00","008","0823","0980","924","751","173","55","979","1596","0","61.34","47.06"
"66","000","00","008","0823","0981","992","803","189","54","1046","1731","0","60.43","46.39"
"66","000","00","008","0823","0982","792","641","151","59","851","1496","0","56.89","42.85"
"66","000","00","008","0824","0000","2554","2104","450","158","2712","4576","0","59.27","45.98"
"66","000","00","008","0824","0971","718","591","127","42","760","1372","0","55.39","43.08"
"66","000","00","008","0824","0972","794","655","139","54","848","1415","0","59.93","46.29"
"66","000","00","008","0824","0973","1042","858","184","62","1104","1789","0","61.71","47.96"
"66","000","00","008","0825","0000","2113","1783","330","146","2259","4210","0","53.66","42.35"
"66","000","00","008","0825","0968","885","764","121","64","949","1782","0","53.25","42.87"
"66","000","00","008","0825","0969","663","550","113","24","687","1357","0","50.63","40.53"
"66","000","00","008","0825","0970","565","469","96","58","623","1071","0","58.17","43.79"
"66","000","00","008","0826","0000","2798","2225","573","161","2959","5209","0","56.81","42.71"
"66","000","00","008","0826","0930","1056","850","206","41","1097","1889","0","58.07","45.0"
"66","000","00","008","0826","0931","914","709","205","57","971","1728","0","56.19","41.03"
"66","000","00","008","0826","0932","828","666","162","63","891","1592","0","55.97","41.83"
"66","000","00","008","0827","0000","1621","1337","284","122","1743","3180","0","54.81","42.04"
"66","000","00","008","0827","0933","852","706","146","67","919","1656","0","55.5","42.63"
"66","000","00","008","0827","0934","769","631","138","55","824","1524","0","54.07","41.4"
"66","000","00","008","0828","0000","3228","2546","682","158","3386","6168","0","54.9","41.28"
"66","000","00","008","0828","0940","1009","796","213","58","1067","2033","0","52.48","39.15"
"66","000","00","008","0828","0941","1024","824","200","40","1064","1947","0","54.65","42.32"
"66","000","00","008","0828","0942","1195","926","269","60","1255","2188","0","57.36","42.32"
"66","000","00","008","0829","0000","2578","2053","525","144","2722","4803","0","56.67","42.74"
"66","000","00","008","0829","0908","929","742","187","44","973","1601","0","60.77","46.35"
"66","000","00","008","0829","0909","805","643","162","53","858","1527","0","56.19","42.11"
"66","000","00","008","0829","0910","844","668","176","47","891","1675","0","53.19","39.88"
"66","000","00","008","0830","0000","2789","2279","510","133","2922","5216","0","56.02","43.69"
"66","000","00","008","0830","0898","1007","809","198","65","1072","1866","0","57.45","43.35"
"66","000","00","008","0830","0899","850","702","148","47","897","1667","0","53.81","42.11"
"66","000","00","008","0830","0900","932","768","164","21","953","1683","0","56.63","45.63"
"66","000","00","008","0831","0000","2703","2233","470","126","2829","4895","0","57.79","45.62"
"66","000","00","008","0831","0976","831","689","142","47","878","1541","0","56.98","44.71"
"66","000","00","008","0831","0977","941","769","172","54","995","1669","0","59.62","46.08"
"66","000","00","008","0831","0978","931","775","156","25","956","1685","0","56.74","45.99"
"66","000","00","008","0832","0000","3487","2924","563","93","3580","6364","0","56.25","45.95"
"66","000","00","008","0832","0901","879","713","166","22","901","1642","0","54.87","43.42"
"66","000","00","008","0832","0902","825","681","144","17","842","1475","0","57.08","46.17"
"66","000","00","008","0832","0903","855","739","116","29","884","1644","0","53.77","44.95"
"66","000","00","008","0832","0904","928","791","137","25","953","1603","0","59.45","49.34"
"66","000","00","008","0833","0000","2995","2462","533","131","3126","5179","0","60.36","47.54"
"66","000","00","008","0833","0905","1099","899","200","58","1157","1949","0","59.36","46.13"
"66","000","00","008","0833","0906","1082","896","186","37","1119","1790","0","62.51","50.06"
"66","000","00","008","0833","0907","814","667","147","36","850","1440","0","59.03","46.32"
"66","000","00","008","0834","0000","1750","1381","369","116","1866","3159","0","59.07","43.72"
"66","000","00","008","0834","0848","815","646","169","69","884","1507","0","58.66","42.87"
"66","000","00","008","0834","0849","935","735","200","47","982","1652","0","59.44","44.49"
"66","000","00","008","0835","0000","2584","2145","439","113","2697","4735","0","56.96","45.3"
"66","000","00","008","0835","0935","839","664","175","42","881","1502","0","58.66","44.21"
"66","000","00","008","0835","0936","955","780","175","35","990","1772","0","55.87","44.02"
"66","000","00","008","0835","0937","790","701","89","36","826","1461","0","56.54","47.98"
"66","000","00","008","0836","0000","1933","1572","361","90","2023","3663","0","55.23","42.92"
"66","000","00","008","0836","0938","873","732","141","22","895","1769","0","50.59","41.38"
"66","000","00","008","0836","0939","1060","840","220","68","1128","1894","0","59.56","44.35"
"66","000","00","008","0837","0000","3275","2712","563","220","3495","6379","0","54.79","42.51"
"66","000","00","008","0837","0911","749","611","138","41","790","1579","0","50.03","38.7"
"66","000","00","008","0837","0912","809","681","128","75","884","1524","0","58.01","44.69"
"66","000","00","008","0837","0913","861","713","148","55","916","1677","0","54.62","42.52"
"66","000","00","008","0837","0914","856","707","149","49","905","1599","0","56.6","44.22"
"66","000","00","008","0838","0000","2702","2235","467","94","2796","4844","0","57.72","46.14"
"66","000","00","008","0838","0946","871","726","145","38","909","1688","0","53.85","43.01"
"66","000","00","008","0838","0947","828","686","142","24","852","1475","0","57.76","46.51"
"66","000","00","008","0838","0948","1003","823","180","32","1035","1681","0","61.57","48.96"
"66","000","00","008","0839","0000","3697","3001","696","153","3850","6576","0","58.55","45.64"
"66","000","00","008","0839","0920","936","788","148","31","967","1760","0","54.94","44.77"
"66","000","00","008","0839","0921","926","758","168","64","990","1699","0","58.27","44.61"
"66","000","00","008","0839","0922","954","780","174","48","1002","1626","0","61.62","47.97"
"66","000","00","008","0839","0923","881","675","206","10","891","1491","0","59.76","45.27"
"66","000","00","008","0840","0000","2441","1963","478","142","2583","4436","0","58.23","44.25"
"66","000","00","008","0840","0927","838","687","151","21","859","1559","0","55.1","44.07"
"66","000","00","008","0840","0928","814","659","155","69","883","1480","0","59.66","44.53"
"66","000","00","008","0840","0929","789","617","172","52","841","1397","0","60.2","44.17"
"66","000","00","008","0841","0000","3151","2624","527","171","3322","5762","0","57.65","45.54"
"66","000","00","008","0841","0856","959","791","168","55","1014","1923","0","52.73","41.13"
"66","000","00","008","0841","0857","859","713","146","54","913","1641","0","55.64","43.45"
"66","000","00","008","0841","0858","706","582","124","25","731","1157","0","63.18","50.3"
"66","000","00","008","0841","0859","627","538","89","37","664","1041","0","63.78","51.68"
"66","000","00","008","0842","0000","2254","1880","374","125","2379","3915","0","60.77","48.02"
"66","000","00","008","0842","0974","1121","933","188","72","1193","1907","0","62.56","48.93"
"66","000","00","008","0842","0975","1133","947","186","53","1186","2008","0","59.06","47.16"
"66","000","00","009","0000","0000","76988","61483","15505","4660","81648","136658","166867","59.75","44.99"
"66","000","00","009","0901","0000","1246","972","274","97","1343","2292","0","58.6","42.41"
"66","000","00","009","0901","0394","521","400","121","39","560","983","0","56.97","40.69"
"66","000","00","009","0901","0395","725","572","153","58","783","1309","0","59.82","43.7"
"66","000","00","009","0902","0000","571","457","114","37","608","945","0","64.34","48.36"
"66","000","00","009","0902","0397","571","457","114","37","608","945","0","64.34","48.36"
"66","000","00","009","0903","0000","494","359","135","57","551","850","0","64.82","42.24"
"66","000","00","009","0903","0398","494","359","135","57","551","850","0","64.82","42.24"
"66","000","00","009","0904","0000","641","485","156","57","698","1116","0","62.54","43.46"
"66","000","00","009","0904","0396","641","485","156","57","698","1116","0","62.54","43.46"
"66","000","00","009","0905","0000","455","367","88","34","489","760","0","64.34","48.29"
"66","000","00","009","0905","0399","455","367","88","34","489","760","0","64.34","48.29"
"66","000","00","009","0906","0000","508","401","107","37","545","759","0","71.81","52.83"
"66","000","00","009","0906","0419","508","401","107","37","545","759","0","71.81","52.83"
"66","000","00","009","0907","0000","386","283","103","37","423","642","0","65.89","44.08"
"66","000","00","009","0907","0420","386","283","103","37","423","642","0","65.89","44.08"
"66","000","00","009","0908","0000","884","696","188","30","914","1647","0","55.49","42.26"
"66","000","00","009","0908","0415","884","696","188","30","914","1647","0","55.49","42.26"
"66","000","00","009","0909","0000","2959","2387","572","160","3119","4979","0","62.64","47.94"
"66","000","00","009","0909","0421","868","702","166","28","896","1528","0","58.64","45.94"
"66","000","00","009","0909","0422","1079","871","208","62","1141","1788","0","63.81","48.71"
"66","000","00","009","0909","0423","1012","814","198","70","1082","1663","0","65.06","48.95"
"66","000","00","009","0910","0000","1308","1055","253","85","1393","2162","0","64.43","48.8"
"66","000","00","009","0910","0424","817","640","177","54","871","1260","0","69.13","50.79"
"66","000","00","009","0910","0425","491","415","76","31","522","902","0","57.87","46.01"
"66","000","00","009","0911","0000","857","661","196","53","910","1457","0","62.46","45.37"
"66","000","00","009","0911","0437","857","661","196","53","910","1457","0","62.46","45.37"
"66","000","00","009","0912","0000","695","545","150","35","730","1184","0","61.66","46.03"
"66","000","00","009","0912","0438","695","545","150","35","730","1184","0","61.66","46.03"
"66","000","00","009","0913","0000","1334","1080","254","98","1432","2507","0","57.12","43.08"
"66","000","00","009","0913","0403","590","462","128","72","662","1145","0","57.82","40.35"
"66","000","00","009","0913","0404","744","618","126","26","770","1362","0","56.53","45.37"
"66","000","00","009","0914","0000","1674","1364","310","101","1775","2919","0","60.81","46.73"
"66","000","00","009","0914","0405","794","661","133","41","835","1389","0","60.12","47.59"
"66","000","00","009","0914","0406","880","703","177","60","940","1530","0","61.44","45.95"
"66","000","00","009","0915","0000","2209","1752","457","197","2406","4043","0","59.51","43.33"
"66","000","00","009","0915","0407","807","646","161","76","883","1471","0","60.03","43.92"
"66","000","00","009","0915","0408","781","616","165","74","855","1410","0","60.64","43.69"
"66","000","00","009","0915","0409","621","490","131","47","668","1162","0","57.49","42.17"
"66","000","00","009","0916","0000","4955","4008","947","285","5240","8802","0","59.53","45.54"
"66","000","00","009","0916","0410","909","740","169","34","943","1656","0","56.94","44.69"
"66","000","00","009","0916","0411","993","799","194","51","1044","1838","0","56.8","43.47"
"66","000","00","009","0916","0412","888","717","171","56","944","1666","0","56.66","43.04"
"66","000","00","009","0916","0413","1018","825","193","80","1098","1821","0","60.3","45.3"
"66","000","00","009","0916","0414","1147","927","220","64","1211","1821","0","66.5","50.91"
"66","000","00","009","0917","0000","772","595","177","66","838","1256","0","66.72","47.37"
"66","000","00","009","0917","0416","772","595","177","66","838","1256","0","66.72","47.37"
"66","000","00","009","0918","0000","1947","1587","360","93","2040","3345","0","60.99","47.44"
"66","000","00","009","0918","0417","949","777","172","49","998","1552","0","64.3","50.06"
"66","000","00","009","0918","0418","998","810","188","44","1042","1793","0","58.11","45.18"
"66","000","00","009","0919","0000","5345","4389","956","331","5676","9838","0","57.69","44.61"
"66","000","00","009","0919","0428","1035","882","153","69","1104","1873","0","58.94","47.09"
"66","000","00","009","0919","0429","1006","850","156","54","1060","1867","0","56.78","45.53"
"66","000","00","009","0919","0430","989","791","198","71","1060","1823","0","58.15","43.39"
"66","000","00","009","0919","0431","966","792","174","63","1029","1962","0","52.45","40.37"
"66","000","00","009","0919","0432","1349","1074","275","74","1423","2313","0","61.52","46.43"
"66","000","00","009","0920","0000","3639","2300","1339","147","3786","6232","0","60.75","36.91"
"66","000","00","009","0920","0433","891","711","180","50","941","1510","0","62.32","47.09"
"66","000","00","009","0920","0434","1037","833","204","67","1104","1824","0","60.53","45.67"
"66","000","00","009","0920","0435","795","595","200","30","825","1363","0","60.53","43.65"
"66","000","00","009","0920","0436","916","161","755","0","916","1535","0","59.67","10.49"
"66","000","00","009","0921","0000","1627","1364","263","66","1693","2949","0","57.41","46.25"
"66","000","00","009","0921","0426","699","587","112","30","729","1357","0","53.72","43.26"
"66","000","00","009","0921","0427","928","777","151","36","964","1592","0","60.55","48.81"
"66","000","00","009","0922","0000","3223","2674","549","189","3412","6306","0","54.11","42.4"
"66","000","00","009","0922","0439","1051","885","166","63","1114","2299","0","48.46","38.49"
"66","000","00","009","0922","0440","1083","888","195","70","1153","1940","0","59.43","45.77"
"66","000","00","009","0922","0441","1089","901","188","56","1145","2067","0","55.39","43.59"
"66","000","00","009","0923","0000","5412","4352","1060","374","5786","10123","0","57.16","42.99"
"66","000","00","009","0923","0442","1074","891","183","80","1154","2038","0","56.62","43.72"
"66","000","00","009","0923","0443","993","778","215","53","1046","1835","0","57.0","42.4"
"66","000","00","009","0923","0444","1063","821","242","74","1137","1979","0","57.45","41.49"
"66","000","00","009","0923","0445","1060","882","178","67","1127","2014","0","55.96","43.79"
"66","000","00","009","0923","0446","1222","980","242","100","1322","2257","0","58.57","43.42"
"66","000","00","009","0924","0000","2692","2215","477","186","2878","4596","0","62.62","48.19"
"66","000","00","009","0924","0447","815","663","152","73","888","1406","0","63.16","47.16"
"66","000","00","009","0924","0448","808","649","159","44","852","1418","0","60.08","45.77"
"66","000","00","009","0924","0449","1069","903","166","69","1138","1772","0","64.22","50.96"
"66","000","00","009","0925","0000","6053","4929","1124","320","6373","10381","0","61.39","47.48"
"66","000","00","009","0925","0452","1015","809","206","69","1084","1758","0","61.66","46.02"
"66","000","00","009","0925","0453","929","741","188","56","985","1546","0","63.71","47.93"
"66","000","00","009","0925","0454","1074","914","160","50","1124","1815","0","61.93","50.36"
"66","000","00","009","0925","0455","1120","883","237","51","1171","1932","0","60.61","45.7"
"66","000","00","009","0925","0456","1074","872","202","58","1132","1770","0","63.95","49.27"
"66","000","00","009","0925","0457","841","710","131","36","877","1560","0","56.22","45.51"
"66","000","00","009","0926","0000","1571","1254","317","80","1651","2649","0","62.33","47.34"
"66","000","00","009","0926","0450","718","574","144","42","760","1202","0","63.23","47.75"
"66","000","00","009","0926","0451","853","680","173","38","891","1447","0","61.58","46.99"
"66","000","00","009","0927","0000","7226","5878","1348","487","7713","13032","0","59.19","45.1"
"66","000","00","009","0927","0458","1015","824","191","33","1048","1810","0","57.9","45.52"
"66","000","00","009","0927","0459","977","796","181","50","1027","1653","0","62.13","48.15"
"66","000","00","009","0927","0460","808","673","135","57","865","1444","0","59.9","46.61"
"66","000","00","009","0927","0461","775","639","136","51","826","1318","0","62.67","48.48"
"66","000","00","009","0927","0462","869","682","187","79","948","1566","0","60.54","43.55"
"66","000","00","009","0927","0463","954","788","166","67","1021","1748","0","58.41","45.08"
"66","000","00","009","0927","0464","894","732","162","76","970","1772","0","54.74","41.31"
"66","000","00","009","0927","0465","934","744","190","74","1008","1721","0","58.57","43.23"
"66","000","00","009","0928","0000","2823","2306","517","95","2918","5065","0","57.61","45.53"
"66","000","00","009","0928","0400","895","719","176","12","907","1617","0","56.09","44.47"
"66","000","00","009","0928","0401","848","704","144","46","894","1677","0","53.31","41.98"
"66","000","00","009","0928","0402","1080","883","197","37","1117","1771","0","63.07","49.86"
"66","000","00","009","0929","0000","905","720","185","48","953","1578","0","60.39","45.63"
"66","000","00","009","0929","0466","905","720","185","48","953","1578","0","60.39","45.63"
"66","000","00","009","0930","0000","2882","2281","601","164","3046","5227","0","58.27","43.64"
"66","000","00","009","0930","0467","1008","784","224","76","1084","1859","0","58.31","42.17"
"66","000","00","009","0930","0468","819","647","172","46","865","1479","0","58.49","43.75"
"66","000","00","009","0930","0469","1055","850","205","42","1097","1889","0","58.07","45.0"
"66","000","00","009","0931","0000","1759","1432","327","94","1853","3224","0","57.48","44.42"
"66","000","00","009","0931","0470","995","841","154","37","1032","1803","0","57.24","46.64"
"66","000","00","009","0931","0471","764","591","173","57","821","1421","0","57.78","41.59"
"66","000","00","009","0932","0000","1992","1581","411","129","2121","3359","0","63.14","47.07"
"66","000","00","009","0932","0472","938","710","228","63","1001","1585","0","63.15","44.79"
"66","000","00","009","0932","0473","1054","871","183","66","1120","1774","0","63.13","49.1"
"66","000","00","009","0933","0000","1191","969","222","70","1261","2132","0","59.15","45.45"
"66","000","00","009","0933","0474","1191","969","222","70","1261","2132","0","59.15","45.45"
"66","000","00","009","0934","0000","1522","1234","288","85","1607","2874","0","55.92","42.94"
"66","000","00","009","0934","0475","838","674","164","66","904","1515","0","59.67","44.49"
"66","000","00","009","0934","0476","684","560","124","19","703","1359","0","51.73","41.21"
"66","000","00","009","0935","0000","1207","945","262","99","1306","2082","0","62.73","45.39"
"66","000","00","009","0935","0477","541","437","104","54","595","948","0","62.76","46.1"
"66","000","00","009","0935","0478","666","508","158","45","711","1134","0","62.7","44.8"
"66","000","00","009","0936","0000","2024","1606","418","137","2161","3346","0","64.58","48.0"
"66","000","00","009","0936","0479","699","554","145","50","749","1114","0","67.24","49.73"
"66","000","00","009","0936","0480","594","464","130","44","638","1050","0","60.76","44.19"
"66","000","00","009","0936","0481","731","588","143","43","774","1182","0","65.48","49.75"
"66","000","00","010","0000","0000","23269","18958","4311","1783","25052","43181","50308","58.02","43.9"
"66","000","00","010","1001","0000","779","666","113","70","849","1357","0","62.56","49.08"
"66","000","00","010","1001","1540","779","666","113","70","849","1357","0","62.56","49.08"
"66","000","00","010","1002","0000","529","451","78","47","576","865","0","66.59","52.14"
"66","000","00","010","1002","1539","529","451","78","47","576","865","0","66.59","52.14"
"66","000","00","010","1003","0000","584","483","101","54","638","1031","0","61.88","46.85"
"66","000","00","010","1003","1538","584","483","101","54","638","1031","0","61.88","46.85"
"66","000","00","010","1004","0000","1118","956","162","62","1180","1850","0","63.78","51.68"
"66","000","00","010","1004","1536","552","470","82","27","579","984","0","58.84","47.76"
"66","000","00","010","1004","1537","566","486","80","35","601","866","0","69.4","56.12"
"66","000","00","010","1005","0000","1253","1002","251","127","1380","2196","0","62.84","45.63"
"66","000","00","010","1005","1534","662","525","137","77","739","1169","0","63.22","44.91"
"66","000","00","010","1005","1535","591","477","114","50","641","1027","0","62.41","46.45"
"66","000","00","010","1006","0000","563","454","109","27","590","977","0","60.39","46.47"
"66","000","00","010","1006","1532","563","454","109","27","590","977","0","60.39","46.47"
"66","000","00","010","1007","0000","727","616","111","34","761","1395","0","54.55","44.16"
"66","000","00","010","1007","1533","727","616","111","34","761","1395","0","54.55","44.16"
"66","000","00","010","1008","0000","2006","1622","384","101","2107","3486","0","60.44","46.53"
"66","000","00","010","1008","1529","658","537","121","18","676","1222","0","55.32","43.94"
"66","000","00","010","1008","1530","758","608","150","55","813","1228","0","66.21","49.51"
"66","000","00","010","1008","1531","590","477","113","28","618","1036","0","59.65","46.04"
"66","000","00","010","1009","0000","960","800","160","74","1034","1878","0","55.06","42.6"
"66","000","00","010","1009","1527","443","380","63","22","465","872","0","53.33","43.58"
"66","000","00","010","1009","1528","517","420","97","52","569","1006","0","56.56","41.75"
"66","000","00","010","1010","0000","2025","1671","354","152","2177","3662","0","59.45","45.63"
"66","000","00","010","1010","1523","773","638","135","52","825","1372","0","60.13","46.5"
"66","000","00","010","1010","1524","786","647","139","48","834","1412","0","59.07","45.82"
"66","000","00","010","1010","1525","466","386","80","52","518","878","0","59.0","43.96"
"66","000","00","010","1011","0000","683","541","142","70","753","1475","0","51.05","36.68"
"66","000","00","010","1011","1526","683","541","142","70","753","1475","0","51.05","36.68"
"66","000","00","010","1012","0000","2701","2183","518","190","2891","4908","0","58.9","44.48"
"66","000","00","010","1012","1519","650","513","137","49","699","1335","0","52.36","38.43"
"66","000","00","010","1012","1520","648","530","118","50","698","1092","0","63.92","48.53"
"66","000","00","010","1012","1521","623","494","129","46","669","1050","0","63.71","47.05"
"66","000","00","010","1012","1522","780","646","134","45","825","1431","0","57.65","45.14"
"66","000","00","010","1013","0000","818","653","165","105","923","1628","0","56.7","40.11"
"66","000","00","010","1013","1518","818","653","165","105","923","1628","0","56.7","40.11"
"66","000","00","010","1014","0000","596","473","123","61","657","991","0","66.3","47.73"
"66","000","00","010","1014","1516","596","473","123","61","657","991","0","66.3","47.73"
"66","000","00","010","1015","0000","412","322","90","23","435","863","0","50.41","37.31"
"66","000","00","010","1015","1517","412","322","90","23","435","863","0","50.41","37.31"
"66","000","00","010","1016","0000","937","753","184","107","1044","1866","0","55.95","40.35"
"66","000","00","010","1016","1514","520","410","110","44","564","1007","0","56.01","40.71"
"66","000","00","010","1016","1515","417","343","74","63","480","859","0","55.88","39.93"
"66","000","00","010","1017","0000","677","552","125","48","725","1299","0","55.81","42.49"
"66","000","00","010","1017","1513","677","552","125","48","725","1299","0","55.81","42.49"
"66","000","00","010","1018","0000","1123","924","199","81","1204","1957","0","61.52","47.22"
"66","000","00","010","1018","1544","542","448","94","33","575","950","0","60.53","47.16"
"66","000","00","010","1018","1545","581","476","105","48","629","1007","0","62.46","47.27"
"66","000","00","010","1019","0000","1144","956","188","74","1218","2050","0","59.41","46.63"
"66","000","00","010","1019","1541","424","360","64","24","448","736","0","60.87","48.91"
"66","000","00","010","1019","1542","720","596","124","50","770","1314","0","58.6","45.36"
"66","000","00","010","1020","0000","812","655","157","97","909","1677","0","54.2","39.06"
"66","000","00","010","1020","1543","812","655","157","97","909","1677","0","54.2","39.06"
"66","000","00","010","1021","0000","575","416","159","45","620","1214","0","51.07","34.27"
"66","000","00","010","1021","1546","575","416","159","45","620","1214","0","51.07","34.27"
"66","000","00","010","1022","0000","957","760","197","63","1020","1809","0","56.38","42.01"
"66","000","00","010","1022","1547","491","397","94","29","520","907","0","57.33","43.77"
"66","000","00","010","1022","1548","466","363","103","34","500","902","0","55.43","40.24"
"66","000","00","010","1023","0000","310","249","61","9","319","720","0","44.31","34.58"
"66","000","00","010","1023","1549","310","249","61","9","319","720","0","44.31","34.58"
"66","000","00","010","1024","0000","295","231","64","10","305","666","0","45.8","34.68"
"66","000","00","010","1024","1550","295","231","64","10","305","666","0","45.8","34.68"
"66","000","00","010","1025","0000","685","569","116","52","737","1361","0","54.15","41.81"
"66","000","00","010","1025","1551","685","569","116","52","737","1361","0","54.15","41.81"
"66","000","00","011","0000","0000","33680","27122","6558","2271","35951","63069","77697","57.0","43.0"
"66","000","00","011","1101","0000","736","584","152","70","806","1356","0","59.44","43.07"
"66","000","00","011","1101","0001","736","584","152","70","806","1356","0","59.44","43.07"
"66","000","00","011","1102","0000","609","494","115","50","659","1059","0","62.23","46.65"
"66","000","00","011","1102","0002","609","494","115","50","659","1059","0","62.23","46.65"
"66","000","00","011","1103","0000","907","675","232","50","957","1568","0","61.03","43.05"
"66","000","00","011","1103","0003","413","307","106","27","440","694","0","63.4","44.24"
"66","000","00","011","1103","0004","494","368","126","23","517","874","0","59.15","42.11"
"66","000","00","011","1104","0000","399","318","81","30","429","763","0","56.23","41.68"
"66","000","00","011","1104","0005","399","318","81","30","429","763","0","56.23","41.68"
"66","000","00","011","1105","0000","1211","960","251","71","1282","2105","0","60.9","45.61"
"66","000","00","011","1105","0006","512","424","88","35","547","856","0","63.9","49.53"
"66","000","00","011","1105","0007","699","536","163","36","735","1249","0","58.85","42.91"
"66","000","00","011","1106","0000","1122","915","207","67","1189","2111","0","56.32","43.34"
"66","000","00","011","1106","0008","464","382","82","32","496","922","0","53.8","41.43"
"66","000","00","011","1106","0009","658","533","125","35","693","1189","0","58.28","44.83"
"66","000","00","011","1107","0000","1935","1546","389","155","2090","3374","0","61.94","45.82"
"66","000","00","011","1107","0010","633","530","103","49","682","1065","0","64.04","49.77"
"66","000","00","011","1107","0011","731","580","151","73","804","1252","0","64.22","46.33"
"66","000","00","011","1107","0012","571","436","135","33","604","1057","0","57.14","41.25"
"66","000","00","011","1108","0000","1194","934","260","71","1265","2091","0","60.5","44.67"
"66","000","00","011","1108","0013","563","453","110","31","594","1031","0","57.61","43.94"
"66","000","00","011","1108","0014","631","481","150","40","671","1060","0","63.3","45.38"
"66","000","00","011","1109","0000","2311","1970","341","153","2464","4405","0","55.94","44.72"
"66","000","00","011","1109","0015","714","572","142","51","765","1311","0","58.35","43.63"
"66","000","00","011","1109","0016","774","648","126","44","818","1424","0","57.44","45.51"
"66","000","00","011","1109","0017","823","750","73","58","881","1670","0","52.75","44.91"
"66","000","00","011","1110","0000","432","362","70","44","476","812","0","58.62","44.58"
"66","000","00","011","1110","0018","432","362","70","44","476","812","0","58.62","44.58"
"66","000","00","011","1111","0000","486","399","87","21","507","863","0","58.75","46.23"
"66","000","00","011","1111","0019","486","399","87","21","507","863","0","58.75","46.23"
"66","000","00","011","1112","0000","1781","1455","326","78","1859","3186","0","58.35","45.67"
"66","000","00","011","1112","0020","906","735","171","42","948","1598","0","59.32","45.99"
"66","000","00","011","1112","0021","875","720","155","36","911","1588","0","57.37","45.34"
"66","000","00","011","1113","0000","639","503","136","52","691","1197","0","57.73","42.02"
"66","000","00","011","1113","0022","639","503","136","52","691","1197","0","57.73","42.02"
"66","000","00","011","1114","0000","539","425","114","76","615","1106","0","55.61","38.43"
"66","000","00","011","1114","0023","539","425","114","76","615","1106","0","55.61","38.43"
"66","000","00","011","1115","0000","1038","814","224","77","1115","1772","0","62.92","45.94"
"66","000","00","011","1115","0024","523","422","101","48","571","903","0","63.23","46.73"
"66","000","00","011","1115","0025","515","392","123","29","544","869","0","62.6","45.11"
"66","000","00","011","1116","0000","2937","2336","601","170","3107","5269","0","58.97","44.33"
"66","000","00","011","1116","0026","753","588","165","24","777","1350","0","57.56","43.56"
"66","000","00","011","1116","0027","622","498","124","65","687","1144","0","60.05","43.53"
"66","000","00","011","1116","0028","685","552","133","48","733","1208","0","60.68","45.7"
"66","000","00","011","1116","0029","877","698","179","33","910","1567","0","58.07","44.54"
"66","000","00","011","1117","0000","1192","970","222","68","1260","2013","0","62.59","48.19"
"66","000","00","011","1117","0030","758","628","130","30","788","1246","0","63.24","50.4"
"66","000","00","011","1117","0031","434","342","92","38","472","767","0","61.54","44.59"
"66","000","00","011","1118","0000","989","819","170","69","1058","1762","0","60.05","46.48"
"66","000","00","011","1118","0032","438","361","77","41","479","790","0","60.63","45.7"
"66","000","00","011","1118","0033","551","458","93","28","579","972","0","59.57","47.12"
"66","000","00","011","1119","0000","716","591","125","51","767","1388","0","55.26","42.58"
"66","000","00","011","1119","0034","716","591","125","51","767","1388","0","55.26","42.58"
"66","000","00","011","1120","0000","2393","1960","433","136","2529","4432","0","57.06","44.22"
"66","000","00","011","1120","0035","672","541","131","34","706","1331","0","53.04","40.65"
"66","000","00","011","1120","0036","683","552","131","40","723","1167","0","61.95","47.3"
"66","000","00","011","1120","0037","1038","867","171","62","1100","1934","0","56.88","44.83"
"66","000","00","011","1121","0000","613","489","124","46","659","1263","0","52.18","38.72"
"66","000","00","011","1121","0038","613","489","124","46","659","1263","0","52.18","38.72"
"66","000","00","011","1122","0000","2061","1660","401","104","2165","3973","0","54.49","41.78"
"66","000","00","011","1122","0039","779","621","158","50","829","1390","0","59.64","44.68"
"66","000","00","011","1122","0040","534","427","107","27","561","1186","0","47.3","36.0"
"66","000","00","011","1122","0041","748","612","136","27","775","1397","0","55.48","43.81"
"66","000","00","011","1123","0000","1189","976","213","81","1270","2571","0","49.4","37.96"
"66","000","00","011","1123","0042","482","408","74","15","497","1173","0","42.37","34.78"
"66","000","00","011","1123","0043","707","568","139","66","773","1398","0","55.29","40.63"
"66","000","00","011","1124","0000","2771","2177","594","176","2947","5453","0","54.04","39.92"
"66","000","00","011","1124","0044","587","443","144","53","640","1228","0","52.12","36.07"
"66","000","00","011","1124","0045","640","506","134","41","681","1258","0","54.13","40.22"
"66","000","00","011","1124","0046","751","613","138","35","786","1435","0","54.77","42.72"
"66","000","00","011","1124","0047","793","615","178","47","840","1532","0","54.83","40.14"
"66","000","00","011","1125","0000","742","599","143","56","798","1522","0","52.43","39.36"
"66","000","00","011","1125","0048","346","284","62","30","376","652","0","57.67","43.56"
"66","000","00","011","1125","0049","396","315","81","26","422","870","0","48.51","36.21"
"66","000","00","011","1126","0000","853","682","171","58","911","1675","0","54.39","40.72"
"66","000","00","011","1126","0050","432","333","99","28","460","891","0","51.63","37.37"
"66","000","00","011","1126","0051","421","349","72","30","451","784","0","57.53","44.52"
"66","000","00","011","1127","0000","670","534","136","75","745","1368","0","54.46","39.04"
"66","000","00","011","1127","0052","670","534","136","75","745","1368","0","54.46","39.04"
"66","000","00","011","1128","0000","553","437","116","48","601","1126","0","53.37","38.81"
"66","000","00","011","1128","0053","553","437","116","48","601","1126","0","53.37","38.81"
"66","000","00","011","1129","0000","662","538","124","68","730","1486","0","49.13","36.2"
"66","000","00","011","1129","0054","662","538","124","68","730","1486","0","49.13","36.2"
"66","000","00","012","0000","0000","39306","32206","7100","2489","41795","71528","86659","58.43","45.03"
"66","000","00","012","1201","0000","561","447","114","19","580","1076","0","53.9","41.54"
"66","000","00","012","1201","0091","561","447","114","19","580","1076","0","53.9","41.54"
"66","000","00","012","1202","0000","578","472","106","47","625","953","0","65.58","49.53"
"66","000","00","012","1202","0092","578","472","106","47","625","953","0","65.58","49.53"
"66","000","00","012","1203","0000","1231","979","252","75","1306","2057","0","63.49","47.59"
"66","000","00","012","1203","0093","535","418","117","38","573","914","0","62.69","45.73"
"66","000","00","012","1203","0094","696","561","135","37","733","1143","0","64.13","49.08"
"66","000","00","012","1204","0000","405","307","98","20","425","680","0","62.5","45.15"
"66","000","00","012","1204","0095","405","307","98","20","425","680","0","62.5","45.15"
"66","000","00","012","1205","0000","1063","861","202","70","1133","1797","0","63.05","47.91"
"66","000","00","012","1205","0096","520","425","95","38","558","904","0","61.73","47.01"
"66","000","00","012","1205","0097","543","436","107","32","575","893","0","64.39","48.82"
"66","000","00","012","1206","0000","884","712","172","34","918","1577","0","58.21","45.15"
"66","000","00","012","1206","0098","884","712","172","34","918","1577","0","58.21","45.15"
"66","000","00","012","1207","0000","383","316","67","26","409","690","0","59.28","45.8"
"66","000","00","012","1207","0099","383","316","67","26","409","690","0","59.28","45.8"
"66","000","00","012","1208","0000","234","181","53","13","247","403","0","61.29","44.91"
"66","000","00","012","1208","0100","234","181","53","13","247","403","0","61.29","44.91"
"66","000","00","012","1209","0000","1222","982","240","87","1309","2190","0","59.77","44.84"
"66","000","00","012","1209","0101","792","644","148","52","844","1413","0","59.73","45.58"
"66","000","00","012","1209","0102","430","338","92","35","465","777","0","59.85","43.5"
"66","000","00","012","1210","0000","5391","4476","915","213","5604","9237","0","60.67","48.46"
"66","000","00","012","1210","0103","764","613","151","27","791","1313","0","60.24","46.69"
"66","000","00","012","1210","0104","854","693","161","45","899","1439","0","62.47","48.16"
"66","000","00","012","1210","0105","656","533","123","23","679","1265","0","53.68","42.13"
"66","000","00","012","1210","0106","765","626","139","29","794","1277","0","62.18","49.02"
"66","000","00","012","1210","0107","733","628","105","37","770","1276","0","60.34","49.22"
"66","000","00","012","1210","0108","838","734","104","27","865","1376","0","62.86","53.34"
"66","000","00","012","1210","0109","781","649","132","25","806","1291","0","62.43","50.27"
"66","000","00","012","1211","0000","860","697","163","57","917","1510","0","60.73","46.16"
"66","000","00","012","1211","0110","860","697","163","57","917","1510","0","60.73","46.16"
"66","000","00","012","1212","0000","867","720","147","63","930","1524","0","61.02","47.24"
"66","000","00","012","1212","0111","867","720","147","63","930","1524","0","61.02","47.24"
"66","000","00","012","1213","0000","2355","1926","429","148","2503","4302","0","58.18","44.77"
"66","000","00","012","1213","0112","742","611","131","40","782","1474","0","53.05","41.45"
"66","000","00","012","1213","0113","818","679","139","42","860","1507","0","57.07","45.06"
"66","000","00","012","1213","0114","795","636","159","66","861","1321","0","65.18","48.15"
"66","000","00","012","1214","0000","1780","1447","333","71","1851","3293","0","56.21","43.94"
"66","000","00","012","1214","0115","584","474","110","19","603","1157","0","52.12","40.97"
"66","000","00","012","1214","0116","720","591","129","30","750","1255","0","59.76","47.09"
"66","000","00","012","1214","0117","476","382","94","22","498","881","0","56.53","43.36"
"66","000","00","012","1215","0000","1182","1013","169","66","1248","2034","0","61.36","49.8"
"66","000","00","012","1215","0118","623","532","91","44","667","1083","0","61.59","49.12"
"66","000","00","012","1215","0119","559","481","78","22","581","951","0","61.09","50.58"
"66","000","00","012","1216","0000","2611","2122","489","195","2806","5145","0","54.54","41.24"
"66","000","00","012","1216","0120","740","611","129","42","782","1424","0","54.92","42.91"
"66","000","00","012","1216","0121","620","488","132","55","675","1233","0","54.74","39.58"
"66","000","00","012","1216","0122","578","467","111","52","630","1288","0","48.91","36.26"
"66","000","00","012","1216","0123","673","556","117","46","719","1200","0","59.92","46.33"
"66","000","00","012","1217","0000","1611","1390","221","59","1670","2745","0","60.84","50.64"
"66","000","00","012","1217","0124","919","811","108","40","959","1609","0","59.6","50.4"
"66","000","00","012","1217","0125","692","579","113","19","711","1136","0","62.59","50.97"
"66","000","00","012","1218","0000","676","573","103","50","726","1302","0","55.76","44.01"
"66","000","00","012","1218","0126","676","573","103","50","726","1302","0","55.76","44.01"
"66","000","00","012","1219","0000","694","588","106","80","774","1373","0","56.37","42.83"
"66","000","00","012","1219","0127","694","588","106","80","774","1373","0","56.37","42.83"
"66","000","00","012","1220","0000","592","462","130","64","656","1257","0","52.19","36.75"
"66","000","00","012","1220","0128","592","462","130","64","656","1257","0","52.19","36.75"
"66","000","00","012","1221","0000","565","468","97","47","612","1184","0","51.69","39.53"
"66","000","00","012","1221","0129","565","468","97","47","612","1184","0","51.69","39.53"
"66","000","00","012","1222","0000","694","578","116","54","748","1322","0","56.58","43.72"
"66","000","00","012","1222","0130","694","578","116","54","748","1322","0","56.58","43.72"
"66","000","00","012","1223","0000","1090","865","225","75","1165","2120","0","54.95","40.8"
"66","000","00","012","1223","0131","584","474","110","38","622","1193","0","52.14","39.73"
"66","000","00","012","1223","0132","506","391","115","37","543","927","0","58.58","42.18"
"66","000","00","012","1224","0000","1285","1026","259","104","1389","2236","0","62.12","45.89"
"66","000","00","012","1224","0133","630","509","121","40","670","1073","0","62.44","47.44"
"66","000","00","012","1224","0134","655","517","138","64","719","1163","0","61.82","44.45"
"66","000","00","012","1225","0000","864","707","157","119","983","1757","0","55.95","40.24"
"66","000","00","012","1225","0135","414","355","59","63","477","855","0","55.79","41.52"
"66","000","00","012","1225","0136","450","352","98","56","506","902","0","56.1","39.02"
"66","000","00","012","1226","0000","1314","1053","261","78","1392","2481","0","56.11","42.44"
"66","000","00","012","1226","0137","761","622","139","52","813","1415","0","57.46","43.96"
"66","000","00","012","1226","0138","553","431","122","26","579","1066","0","54.32","40.43"
"66","000","00","012","1227","0000","3944","3211","733","222","4166","7264","0","57.35","44.2"
"66","000","00","012","1227","0139","740","605","135","52","792","1391","0","56.94","43.49"
"66","000","00","012","1227","0140","734","598","136","31","765","1449","0","52.8","41.27"
"66","000","00","012","1227","0141","779","628","151","50","829","1377","0","60.2","45.61"
"66","000","00","012","1227","0142","794","651","143","49","843","1423","0","59.24","45.75"
"66","000","00","012","1227","0143","897","729","168","40","937","1624","0","57.7","44.89"
"66","000","00","012","1228","0000","1468","1222","246","132","1600","2822","0","56.7","43.3"
"66","000","00","012","1228","0144","691","582","109","60","751","1358","0","55.3","42.86"
"66","000","00","012","1228","0145","777","640","137","72","849","1464","0","57.99","43.72"
"66","000","00","012","1229","0000","689","548","141","58","747","1211","0","61.68","45.25"
"66","000","00","012","1229","0146","689","548","141","58","747","1211","0","61.68","45.25"
"66","000","00","012","1230","0000","660","558","102","62","722","1162","0","62.13","48.02"
"66","000","00","012","1230","0148","660","558","102","62","722","1162","0","62.13","48.02"
"66","000","00","012","1231","0000","815","678","137","56","871","1368","0","63.67","49.56"
"66","000","00","012","1231","0149","815","678","137","56","871","1368","0","63.67","49.56"
"66","000","00","012","1232","0000","738","621","117","25","763","1456","0","52.4","42.65"
"66","000","00","012","1232","0147","738","621","117","25","763","1456","0","52.4","42.65"
"66","000","00","013","0000","0000","39659","32234","7425","2329","41988","74207","93720","56.58","43.44"
"66","000","00","013","1301","0000","701","593","108","38","739","1380","0","53.55","42.97"
"66","000","00","013","1301","0186","701","593","108","38","739","1380","0","53.55","42.97"
"66","000","00","013","1302","0000","1179","951","228","67","1246","2028","0","61.44","46.89"
"66","000","00","013","1302","0187","485","389","96","35","520","852","0","61.03","45.66"
"66","000","00","013","1302","0188","694","562","132","32","726","1176","0","61.73","47.79"
"66","000","00","013","1303","0000","578","441","137","67","645","958","0","67.33","46.03"
"66","000","00","013","1303","0189","578","441","137","67","645","958","0","67.33","46.03"
"66","000","00","013","1304","0000","319","249","70","17","336","488","0","68.85","51.02"
"66","000","00","013","1304","0190","319","249","70","17","336","488","0","68.85","51.02"
"66","000","00","013","1305","0000","1346","1062","284","80","1426","2462","0","57.92","43.14"
"66","000","00","013","1305","0191","658","510","148","32","690","1177","0","58.62","43.33"
"66","000","00","013","1305","0192","688","552","136","48","736","1285","0","57.28","42.96"
"66","000","00","013","1306","0000","2395","1925","470","130","2525","4336","0","58.23","44.4"
"66","000","00","013","1306","0195","764","613","151","26","790","1469","0","53.78","41.73"
"66","000","00","013","1306","0196","827","665","162","45","872","1423","0","61.28","46.73"
"66","000","00","013","1306","0197","804","647","157","59","863","1444","0","59.76","44.81"
"66","000","00","013","1307","0000","2760","2220","540","201","2961","5046","0","58.68","44.0"
"66","000","00","013","1307","0198","782","627","155","78","860","1469","0","58.54","42.68"
"66","000","00","013","1307","0199","1038","845","193","80","1118","1902","0","58.78","44.43"
"66","000","00","013","1307","0200","940","748","192","43","983","1675","0","58.69","44.66"
"66","000","00","013","1308","0000","3705","2834","871","232","3937","6728","0","58.52","42.12"
"66","000","00","013","1308","0201","587","474","113","48","635","1098","0","57.83","43.17"
"66","000","00","013","1308","0202","875","598","277","58","933","1539","0","60.62","38.86"
"66","000","00","013","1308","0203","754","601","153","32","786","1329","0","59.14","45.22"
"66","000","00","013","1308","0204","652","503","149","45","697","1255","0","55.54","40.08"
"66","000","00","013","1308","0205","837","658","179","49","886","1507","0","58.79","43.66"
"66","000","00","013","1309","0000","3883","3206","677","286","4169","7300","0","57.11","43.92"
"66","000","00","013","1309","0206","797","644","153","71","868","1463","0","59.33","44.02"
"66","000","00","013","1309","0207","655","542","113","52","707","1279","0","55.28","42.38"
"66","000","00","013","1309","0208","503","437","66","30","533","1024","0","52.05","42.68"
"66","000","00","013","1309","0209","687","575","112","67","754","1388","0","54.32","41.43"
"66","000","00","013","1309","0210","617","498","119","35","652","1074","0","60.71","46.37"
"66","000","00","013","1309","0211","624","510","114","31","655","1072","0","61.1","47.57"
"66","000","00","013","1310","0000","628","505","123","61","689","1107","0","62.24","45.62"
"66","000","00","013","1310","0212","628","505","123","61","689","1107","0","62.24","45.62"
"66","000","00","013","1311","0000","2381","1984","397","129","2510","4771","0","52.61","41.58"
"66","000","00","013","1311","0215","902","786","116","48","950","1633","0","58.18","48.13"
"66","000","00","013","1311","0216","758","614","144","47","805","1533","0","52.51","40.05"
"66","000","00","013","1311","0217","721","584","137","34","755","1605","0","47.04","36.39"
"66","000","00","013","1312","0000","1781","1467","314","104","1885","3629","0","51.94","40.42"
"66","000","00","013","1312","0213","941","784","157","47","988","1947","0","50.74","40.27"
"66","000","00","013","1312","0214","840","683","157","57","897","1682","0","53.33","40.61"
"66","000","00","013","1313","0000","841","712","129","26","867","1694","0","51.18","42.03"
"66","000","00","013","1313","0218","841","712","129","26","867","1694","0","51.18","42.03"
"66","000","00","013","1314","0000","2620","2135","485","114","2734","4944","0","55.3","43.18"
"66","000","00","013","1314","0219","831","672","159","43","874","1628","0","53.69","41.28"
"66","000","00","013","1314","0220","927","749","178","24","951","1665","0","57.12","44.98"
"66","000","00","013","1314","0221","862","714","148","47","909","1651","0","55.06","43.25"
"66","000","00","013","1315","0000","1892","1581","311","94","1986","3289","0","60.38","48.07"
"66","000","00","013","1315","0222","658","560","98","30","688","1108","0","62.09","50.54"
"66","000","00","013","1315","0223","664","548","116","36","700","1142","0","61.3","47.99"
"66","000","00","013","1315","0224","570","473","97","28","598","1039","0","57.56","45.52"
"66","000","00","013","1316","0000","2742","2248","494","150","2892","5270","0","54.88","42.66"
"66","000","00","013","1316","0225","943","774","169","70","1013","1840","0","55.05","42.07"
"66","000","00","013","1316","0226","1006","830","176","30","1036","1872","0","55.34","44.34"
"66","000","00","013","1316","0227","793","644","149","50","843","1558","0","54.11","41.34"
"66","000","00","013","1317","0000","2346","1937","409","117","2463","4314","0","57.09","44.9"
"66","000","00","013","1317","0232","858","683","175","47","905","1593","0","56.81","42.88"
"66","000","00","013","1317","0233","501","432","69","25","526","981","0","53.62","44.04"
"66","000","00","013","1317","0234","987","822","165","45","1032","1740","0","59.31","47.24"
"66","000","00","013","1318","0000","1292","1088","204","72","1364","2294","0","59.46","47.43"
"66","000","00","013","1318","0235","705","582","123","59","764","1247","0","61.27","46.67"
"66","000","00","013","1318","0236","587","506","81","13","600","1047","0","57.31","48.33"
"66","000","00","013","1319","0000","1139","923","216","73","1212","2144","0","56.53","43.05"
"66","000","00","013","1319","0237","608","488","120","58","666","1119","0","59.52","43.61"
"66","000","00","013","1319","0238","531","435","96","15","546","1025","0","53.27","42.44"
"66","000","00","013","1320","0000","1802","1422","380","124","1926","3364","0","57.25","42.27"
"66","000","00","013","1320","0193","871","687","184","67","938","1736","0","54.03","39.57"
"66","000","00","013","1320","0194","931","735","196","57","988","1628","0","60.69","45.15"
"66","000","00","013","1321","0000","3329","2751","578","147","3476","6661","0","52.18","41.3"
"66","000","00","013","1321","0228","855","722","133","43","898","1739","0","51.64","41.52"
"66","000","00","013","1321","0229","809","658","151","32","841","1672","0","50.3","39.35"
"66","000","00","013","1321","0230","880","728","152","28","908","1634","0","55.57","44.55"
"66","000","00","013","1321","0231","785","643","142","44","829","1616","0","51.3","39.79"
"66","000","00","014","0000","0000","25134","20303","4831","1659","26793","47040","58189","56.96","43.16"
"66","000","00","014","1401","0000","1658","1346","312","92","1750","3122","0","56.05","43.11"
"66","000","00","014","1401","0150","819","655","164","50","869","1541","0","56.39","42.5"
"66","000","00","014","1401","0151","839","691","148","42","881","1581","0","55.72","43.71"
"66","000","00","014","1402","0000","1100","878","222","66","1166","1959","0","59.52","44.82"
"66","000","00","014","1402","0152","598","471","127","39","637","1083","0","58.82","43.49"
"66","000","00","014","1402","0153","502","407","95","27","529","876","0","60.39","46.46"
"66","000","00","014","1403","0000","2058","1652","406","126","2184","3929","0","55.59","42.05"
"66","000","00","014","1403","0154","564","441","123","55","619","1043","0","59.35","42.28"
"66","000","00","014","1403","0155","742","585","157","38","780","1502","0","51.93","38.95"
"66","000","00","014","1403","0156","752","626","126","33","785","1384","0","56.72","45.23"
"66","000","00","014","1404","0000","334","262","72","24","358","517","0","69.25","50.68"
"66","000","00","014","1404","0157","334","262","72","24","358","517","0","69.25","50.68"
"66","000","00","014","1405","0000","696","575","121","50","746","1169","0","63.82","49.19"
"66","000","00","014","1405","0158","696","575","121","50","746","1169","0","63.82","49.19"
"66","000","00","014","1406","0000","493","371","122","31","524","863","0","60.72","42.99"
"66","000","00","014","1406","0159","493","371","122","31","524","863","0","60.72","42.99"
"66","000","00","014","1407","0000","3185","2487","698","205","3390","6128","0","55.32","40.58"
"66","000","00","014","1407","0160","603","502","101","38","641","1277","0","50.2","39.31"
"66","000","00","014","1407","0161","896","693","203","41","937","1742","0","53.79","39.78"
"66","000","00","014","1407","0162","740","556","184","52","792","1342","0","59.02","41.43"
"66","000","00","014","1407","0163","946","736","210","74","1020","1767","0","57.72","41.65"
"66","000","00","014","1408","0000","2459","2017","442","159","2618","4974","0","52.63","40.55"
"66","000","00","014","1408","0164","731","578","153","53","784","1542","0","50.84","37.48"
"66","000","00","014","1408","0165","849","707","142","48","897","1636","0","54.83","43.22"
"66","000","00","014","1408","0166","879","732","147","58","937","1796","0","52.17","40.76"
"66","000","00","014","1409","0000","2238","1845","393","212","2450","4364","0","56.14","42.28"
"66","000","00","014","1409","0167","724","594","130","73","797","1450","0","54.97","40.97"
"66","000","00","014","1409","0168","749","608","141","102","851","1548","0","54.97","39.28"
"66","000","00","014","1409","0169","765","643","122","37","802","1366","0","58.71","47.07"
"66","000","00","014","1410","0000","4097","3356","741","252","4349","7342","0","59.23","45.71"
"66","000","00","014","1410","0170","587","493","94","26","613","955","0","64.19","51.62"
"66","000","00","014","1410","0171","663","532","131","54","717","1305","0","54.94","40.77"
"66","000","00","014","1410","0172","704","581","123","29","733","1239","0","59.16","46.89"
"66","000","00","014","1410","0173","612","509","103","55","667","1079","0","61.82","47.17"
"66","000","00","014","1410","0174","656","545","111","24","680","1220","0","55.74","44.67"
"66","000","00","014","1410","0175","875","696","179","64","939","1544","0","60.82","45.08"
"66","000","00","014","1411","0000","3046","2470","576","193","3239","5607","0","57.77","44.05"
"66","000","00","014","1411","0176","835","672","163","46","881","1460","0","60.34","46.03"
"66","000","00","014","1411","0177","746","616","130","38","784","1292","0","60.68","47.68"
"66","000","00","014","1411","0178","677","559","118","62","739","1300","0","56.85","43.0"
"66","000","00","014","1411","0179","788","623","165","47","835","1555","0","53.7","40.06"
"66","000","00","014","1412","0000","1254","1005","249","89","1343","2308","0","58.19","43.54"
"66","000","00","014","1412","0180","532","417","115","39","571","1031","0","55.38","40.45"
"66","000","00","014","1412","0181","722","588","134","50","772","1277","0","60.45","46.05"
"66","000","00","014","1413","0000","1197","947","250","83","1280","2224","0","57.55","42.58"
"66","000","00","014","1413","0182","534","411","123","39","573","1037","0","55.26","39.63"
"66","000","00","014","1413","0183","663","536","127","44","707","1187","0","59.56","45.16"
"66","000","00","014","1414","0000","1319","1092","227","77","1396","2534","0","55.09","43.09"
"66","000","00","014","1414","0184","716","592","124","39","755","1399","0","53.97","42.32"
"66","000","00","014","1414","0185","603","500","103","38","641","1135","0","56.48","44.05"
"66","000","00","015","0000","0000","24418","20022","4396","1587","26005","44962","54682","57.84","44.53"
"66","000","00","015","1501","0000","1103","927","176","89","1192","1987","0","59.99","46.65"
"66","000","00","015","1501","0357","510","441","69","34","544","852","0","63.85","51.76"
"66","000","00","015","1501","0358","593","486","107","55","648","1135","0","57.09","42.82"
"66","000","00","015","1502","0000","541","428","113","37","578","1079","0","53.57","39.67"
"66","000","00","015","1502","0359","541","428","113","37","578","1079","0","53.57","39.67"
"66","000","00","015","1503","0000","1726","1451","275","116","1842","3130","0","58.85","46.36"
"66","000","00","015","1503","0360","872","731","141","46","918","1539","0","59.65","47.5"
"66","000","00","015","1503","0361","854","720","134","70","924","1591","0","58.08","45.25"
"66","000","00","015","1504","0000","2126","1723","403","168","2294","3701","0","61.98","46.55"
"66","000","00","015","1504","0364","782","624","158","72","854","1428","0","59.8","43.7"
"66","000","00","015","1504","0365","739","598","141","43","782","1178","0","66.38","50.76"
"66","000","00","015","1504","0366","605","501","104","53","658","1095","0","60.09","45.75"
"66","000","00","015","1505","0000","1127","925","202","63","1190","2126","0","55.97","43.51"
"66","000","00","015","1505","0367","509","419","90","23","532","963","0","55.24","43.51"
"66","000","00","015","1505","0368","618","506","112","40","658","1163","0","56.58","43.51"
"66","000","00","015","1506","0000","2688","2242","446","154","2842","4712","0","60.31","47.58"
"66","000","00","015","1506","0369","592","490","102","28","620","1018","0","60.9","48.13"
"66","000","00","015","1506","0370","514","439","75","38","552","854","0","64.64","51.41"
"66","000","00","015","1506","0371","767","630","137","47","814","1485","0","54.81","42.42"
"66","000","00","015","1506","0372","815","683","132","41","856","1355","0","63.17","50.41"
"66","000","00","015","1507","0000","1065","854","211","87","1152","1986","0","58.01","43.0"
"66","000","00","015","1507","0373","423","348","75","40","463","840","0","55.12","41.43"
"66","000","00","015","1507","0374","642","506","136","47","689","1146","0","60.12","44.15"
"66","000","00","015","1508","0000","1921","1588","333","144","2065","3342","0","61.79","47.52"
"66","000","00","015","1508","0375","962","802","160","58","1020","1669","0","61.11","48.05"
"66","000","00","015","1508","0376","959","786","173","86","1045","1673","0","62.46","46.98"
"66","000","00","015","1509","0000","1886","1526","360","106","1992","3454","0","57.67","44.18"
"66","000","00","015","1509","0377","828","676","152","37","865","1493","0","57.94","45.28"
"66","000","00","015","1509","0378","598","477","121","52","650","1052","0","61.79","45.34"
"66","000","00","015","1509","0379","460","373","87","17","477","909","0","52.48","41.03"
"66","000","00","015","1510","0000","1395","1141","254","105","1500","2433","0","61.65","46.9"
"66","000","00","015","1510","0380","607","499","108","63","670","1091","0","61.41","45.74"
"66","000","00","015","1510","0381","788","642","146","42","830","1342","0","61.85","47.84"
"66","000","00","015","1511","0000","1145","916","229","96","1241","2115","0","58.68","43.31"
"66","000","00","015","1511","0382","593","460","133","55","648","1138","0","56.94","40.42"
"66","000","00","015","1511","0383","552","456","96","41","593","977","0","60.7","46.67"
"66","000","00","015","1512","0000","721","581","140","27","748","1584","0","47.22","36.68"
"66","000","00","015","1512","0384","721","581","140","27","748","1584","0","47.22","36.68"
"66","000","00","015","1513","0000","1176","964","212","84","1260","2140","0","58.88","45.05"
"66","000","00","015","1513","0385","499","405","94","25","524","915","0","57.27","44.26"
"66","000","00","015","1513","0386","677","559","118","59","736","1225","0","60.08","45.63"
"66","000","00","015","1514","0000","1660","1372","288","57","1717","3152","0","54.47","43.53"
"66","000","00","015","1514","0387","813","680","133","37","850","1552","0","54.77","43.81"
"66","000","00","015","1514","0388","847","692","155","20","867","1600","0","54.19","43.25"
"66","000","00","015","1515","0000","668","533","135","47","715","1340","0","53.36","39.78"
"66","000","00","015","1515","0393","668","533","135","47","715","1340","0","53.36","39.78"
"66","000","00","015","1516","0000","1108","920","188","83","1191","2122","0","56.13","43.36"
"66","000","00","015","1516","0391","528","451","77","32","560","1055","0","53.08","42.75"
"66","000","00","015","1516","0392","580","469","111","51","631","1067","0","59.14","43.96"
"66","000","00","015","1517","0000","1004","810","194","57","1061","1885","0","56.29","42.97"
"66","000","00","015","1517","0389","502","416","86","33","535","942","0","56.79","44.16"
"66","000","00","015","1517","0390","502","394","108","24","526","943","0","55.78","41.78"
"66","000","00","015","1518","0000","1358","1121","237","67","1425","2674","0","53.29","41.92"
"66","000","00","015","1518","0362","664","549","115","45","709","1376","0","51.53","39.9"
"66","000","00","015","1518","0363","694","572","122","22","716","1298","0","55.16","44.07"
"66","000","00","016","0000","0000","29997","24223","5774","1950","31947","54565","65692","58.55","44.39"
"66","000","00","016","1601","0000","1821","1503","318","109","1930","3243","0","59.51","46.35"
"66","000","00","016","1601","0482","948","783","165","57","1005","1684","0","59.68","46.5"
"66","000","00","016","1601","0483","873","720","153","52","925","1559","0","59.33","46.18"
"66","000","00","016","1602","0000","1245","1001","244","79","1324","2139","0","61.9","46.8"
"66","000","00","016","1602","0484","591","463","128","24","615","1095","0","56.16","42.28"
"66","000","00","016","1602","0485","654","538","116","55","709","1044","0","67.91","51.53"
"66","000","00","016","1603","0000","1537","1228","309","142","1679","2604","0","64.48","47.16"
"66","000","00","016","1603","0486","788","626","162","65","853","1310","0","65.11","47.79"
"66","000","00","016","1603","0487","749","602","147","77","826","1294","0","63.83","46.52"
"66","000","00","016","1604","0000","1226","962","264","90","1316","2165","0","60.79","44.43"
"66","000","00","016","1604","0488","639","507","132","45","684","1143","0","59.84","44.36"
"66","000","00","016","1604","0489","587","455","132","45","632","1022","0","61.84","44.52"
"66","000","00","016","1605","0000","3889","3174","715","202","4091","7265","0","56.31","43.69"
"66","000","00","016","1605","0498","757","628","129","30","787","1452","0","54.2","43.25"
"66","000","00","016","1605","0499","897","736","161","65","962","1551","0","62.02","47.45"
"66","000","00","016","1605","0500","815","672","143","46","861","1567","0","54.95","42.88"
"66","000","00","016","1605","0501","795","634","161","42","837","1449","0","57.76","43.75"
"66","000","00","016","1605","0502","625","504","121","19","644","1246","0","51.69","40.45"
"66","000","00","016","1606","0000","3058","2473","585","184","3242","5267","0","61.55","46.95"
"66","000","00","016","1606","0503","808","654","154","46","854","1431","0","59.68","45.7"
"66","000","00","016","1606","0504","686","539","147","49","735","1163","0","63.2","46.35"
"66","000","00","016","1606","0505","848","691","157","53","901","1402","0","64.27","49.29"
"66","000","00","016","1606","0506","716","589","127","36","752","1271","0","59.17","46.34"
"66","000","00","016","1607","0000","1429","1162","267","100","1529","2510","0","60.92","46.29"
"66","000","00","016","1607","0507","683","546","137","43","726","1198","0","60.6","45.58"
"66","000","00","016","1607","0508","746","616","130","57","803","1312","0","61.2","46.95"
"66","000","00","016","1608","0000","1596","1275","321","69","1665","2885","0","57.71","44.19"
"66","000","00","016","1608","0512","896","722","174","42","938","1483","0","63.25","48.69"
"66","000","00","016","1608","0513","700","553","147","27","727","1402","0","51.85","39.44"
"66","000","00","016","1609","0000","2246","1927","319","144","2390","4329","0","55.21","44.51"
"66","000","00","016","1609","0509","838","685","153","64","902","1590","0","56.73","43.08"
"66","000","00","016","1609","0510","686","563","123","38","724","1324","0","54.68","42.52"
"66","000","00","016","1609","0511","722","679","43","42","764","1415","0","53.99","47.99"
"66","000","00","016","1610","0000","3895","3104","791","271","4166","7224","0","57.67","42.97"
"66","000","00","016","1610","0514","676","549","127","35","711","1275","0","55.76","43.06"
"66","000","00","016","1610","0515","633","490","143","74","707","1288","0","54.89","38.04"
"66","000","00","016","1610","0516","577","451","126","42","619","1080","0","57.31","41.76"
"66","000","00","016","1610","0517","694","568","126","27","721","1344","0","53.65","42.26"
"66","000","00","016","1610","0518","612","482","130","51","663","1061","0","62.49","45.43"
"66","000","00","016","1610","0519","703","564","139","42","745","1176","0","63.35","47.96"
"66","000","00","016","1611","0000","1528","1208","320","99","1627","2562","0","63.51","47.15"
"66","000","00","016","1611","0520","726","570","156","51","777","1244","0","62.46","45.82"
"66","000","00","016","1611","0521","802","638","164","48","850","1318","0","64.49","48.41"
"66","000","00","016","1612","0000","1555","1255","300","116","1671","2794","0","59.81","44.92"
"66","000","00","016","1612","0522","751","614","137","46","797","1471","0","54.18","41.74"
"66","000","00","016","1612","0523","804","641","163","70","874","1323","0","66.06","48.45"
"66","000","00","016","1613","0000","1134","939","195","70","1204","2354","0","51.15","39.89"
"66","000","00","016","1613","0490","650","524","126","43","693","1269","0","54.61","41.29"
"66","000","00","016","1613","0491","484","415","69","27","511","1085","0","47.1","38.25"
"66","000","00","016","1614","0000","2154","1707","447","162","2316","4090","0","56.63","41.74"
"66","000","00","016","1614","0494","727","558","169","41","768","1390","0","55.25","40.14"
"66","000","00","016","1614","0495","793","642","151","75","868","1372","0","63.27","46.79"
"66","000","00","016","1614","0496","634","507","127","46","680","1328","0","51.2","38.18"
"66","000","00","016","1615","0000","1148","888","260","86","1234","2096","0","58.87","42.37"
"66","000","00","016","1615","0492","533","410","123","61","594","942","0","63.06","43.52"
"66","000","00","016","1615","0493","615","478","137","25","640","1154","0","55.46","41.42"
"66","000","00","016","1616","0000","536","417","119","27","563","1038","0","54.24","40.17"
"66","000","00","016","1616","0497","536","417","119","27","563","1038","0","54.24","40.17"
"66","000","00","017","0000","0000","48422","39569","8853","2553","50975","89487","108777","56.96","44.22"
"66","000","00","017","1701","0000","5901","4810","1091","292","6193","10976","0","56.42","43.82"
"66","000","00","017","1701","0573","941","785","156","60","1001","1630","0","61.41","48.16"
"66","000","00","017","1701","0574","850","705","145","27","877","1532","0","57.25","46.02"
"66","000","00","017","1701","0575","830","672","158","36","866","1677","0","51.64","40.07"
"66","000","00","017","1701","0576","873","704","169","53","926","1744","0","53.1","40.37"
"66","000","00","017","1701","0577","976","766","210","57","1033","1795","0","57.55","42.67"
"66","000","00","017","1701","0578","648","536","112","26","674","1171","0","57.56","45.77"
"66","000","00","017","1701","0579","783","642","141","33","816","1427","0","57.18","44.99"
"66","000","00","017","1702","0000","747","586","161","39","786","1306","0","60.18","44.87"
"66","000","00","017","1702","0570","747","586","161","39","786","1306","0","60.18","44.87"
"66","000","00","017","1703","0000","1348","1087","261","87","1435","2287","0","62.75","47.53"
"66","000","00","017","1703","0571","646","520","126","41","687","1128","0","60.9","46.1"
"66","000","00","017","1703","0572","702","567","135","46","748","1159","0","64.54","48.92"
"66","000","00","017","1704","0000","5523","4533","990","288","5811","10187","0","57.04","44.5"
"66","000","00","017","1704","0580","922","754","168","65","987","1709","0","57.75","44.12"
"66","000","00","017","1704","0581","948","777","171","35","983","1723","0","57.05","45.1"
"66","000","00","017","1704","0582","943","783","160","43","986","1782","0","55.33","43.94"
"66","000","00","017","1704","0583","728","601","127","39","767","1407","0","54.51","42.71"
"66","000","00","017","1704","0584","965","786","179","39","1004","1771","0","56.69","44.38"
"66","000","00","017","1704","0585","1017","832","185","67","1084","1795","0","60.39","46.35"
"66","000","00","017","1705","0000","2872","2346","526","123","2995","5195","0","57.65","45.16"
"66","000","00","017","1705","0586","963","790","173","47","1010","1612","0","62.66","49.01"
"66","000","00","017","1705","0587","996","822","174","37","1033","1894","0","54.54","43.4"
"66","000","00","017","1705","0588","913","734","179","39","952","1689","0","56.36","43.46"
"66","000","00","017","1706","0000","5105","4267","838","270","5375","9343","0","57.53","45.67"
"66","000","00","017","1706","0599","950","811","139","42","992","1666","0","59.54","48.68"
"66","000","00","017","1706","0600","917","770","147","69","986","1750","0","56.34","44.0"
"66","000","00","017","1706","0601","763","637","126","46","809","1437","0","56.3","44.33"
"66","000","00","017","1706","0602","942","776","166","32","974","1735","0","56.14","44.73"
"66","000","00","017","1706","0603","851","695","156","57","908","1612","0","56.33","43.11"
"66","000","00","017","1706","0604","682","578","104","24","706","1143","0","61.77","50.57"
"66","000","00","017","1707","0000","6440","5316","1124","308","6748","11996","0","56.25","44.31"
"66","000","00","017","1707","0605","1088","899","189","34","1122","2096","0","53.53","42.89"
"66","000","00","017","1707","0606","876","693","183","60","936","1549","0","60.43","44.74"
"66","000","00","017","1707","0607","858","704","154","33","891","1573","0","56.64","44.76"
"66","000","00","017","1707","0608","818","687","131","29","847","1585","0","53.44","43.34"
"66","000","00","017","1707","0609","845","697","148","38","883","1572","0","56.17","44.34"
"66","000","00","017","1707","0610","983","827","156","46","1029","1738","0","59.21","47.58"
"66","000","00","017","1707","0611","972","809","163","68","1040","1883","0","55.23","42.96"
"66","000","00","017","1708","0000","1573","1269","304","69","1642","2753","0","59.64","46.1"
"66","000","00","017","1708","0612","774","614","160","26","800","1401","0","57.1","43.83"
"66","000","00","017","1708","0613","799","655","144","43","842","1352","0","62.28","48.45"
"66","000","00","017","1709","0000","3203","2598","605","153","3356","5805","0","57.81","44.75"
"66","000","00","017","1709","0614","1174","979","195","67","1241","2085","0","59.52","46.95"
"66","000","00","017","1709","0615","1172","957","215","69","1241","2047","0","60.63","46.75"
"66","000","00","017","1709","0616","857","662","195","17","874","1673","0","52.24","39.57"
"66","000","00","017","1710","0000","2463","1959","504","173","2636","4599","0","57.32","42.6"
"66","000","00","017","1710","0617","1040","850","190","77","1117","1874","0","59.61","45.36"
"66","000","00","017","1710","0618","588","454","134","47","635","1051","0","60.42","43.2"
"66","000","00","017","1710","0619","835","655","180","49","884","1674","0","52.81","39.13"
"66","000","00","017","1711","0000","2044","1662","382","119","2163","3834","0","56.42","43.35"
"66","000","00","017","1711","0620","1018","839","179","61","1079","1831","0","58.93","45.82"
"66","000","00","017","1711","0621","1026","823","203","58","1084","2003","0","54.12","41.09"
"66","000","00","017","1712","0000","826","674","152","36","862","1535","0","56.16","43.91"
"66","000","00","017","1712","0622","826","674","152","36","862","1535","0","56.16","43.91"
"66","000","00","017","1713","0000","2014","1626","388","154","2168","4147","0","52.28","39.21"
"66","000","00","017","1713","0623","1080","881","199","91","1171","2286","0","51.22","38.54"
"66","000","00","017","1713","0624","934","745","189","63","997","1861","0","53.57","40.03"
"66","000","00","017","1714","0000","2270","1827","443","145","2415","4347","0","55.56","42.03"
"66","000","00","017","1714","0589","749","604","145","47","796","1525","0","52.2","39.61"
"66","000","00","017","1714","0590","858","684","174","36","894","1622","0","55.12","42.17"
"66","000","00","017","1714","0591","663","539","124","62","725","1200","0","60.42","44.92"
"66","000","00","017","1715","0000","3556","2963","593","133","3689","6729","0","54.82","44.03"
"66","000","00","017","1715","0592","708","591","117","12","720","1355","0","53.14","43.62"
"66","000","00","017","1715","0593","936","782","154","29","965","1777","0","54.31","44.01"
"66","000","00","017","1715","0594","1052","873","179","27","1079","1923","0","56.11","45.4"
"66","000","00","017","1715","0595","860","717","143","65","925","1674","0","55.26","42.83"
"66","000","00","017","1716","0000","2537","2046","491","164","2701","4448","0","60.72","46.0"
"66","000","00","017","1716","0596","866","708","158","45","911","1451","0","62.78","48.79"
"66","000","00","017","1716","0597","816","646","170","59","875","1486","0","58.88","43.47"
"66","000","00","017","1716","0598","855","692","163","60","915","1511","0","60.56","45.8"
"66","000","00","018","0000","0000","41077","33608","7469","2236","43313","77189","95703","56.11","43.54"
"66","000","00","018","1801","0000","2535","2038","497","146","2681","4378","0","61.24","46.55"
"66","000","00","018","1801","0527","896","723","173","47","943","1537","0","61.35","47.04"
"66","000","00","018","1801","0528","852","667","185","49","901","1439","0","62.61","46.35"
"66","000","00","018","1801","0529","787","648","139","50","837","1402","0","59.7","46.22"
"66","000","00","018","1802","0000","5160","4185","975","292","5452","9096","0","59.94","46.01"
"66","000","00","018","1802","0553","934","768","166","48","982","1568","0","62.63","48.98"
"66","000","00","018","1802","0554","954","745","209","56","1010","1761","0","57.35","42.31"
"66","000","00","018","1802","0555","1005","808","197","59","1064","1752","0","60.73","46.12"
"66","000","00","018","1802","0556","722","587","135","37","759","1264","0","60.05","46.44"
"66","000","00","018","1802","0557","771","644","127","38","809","1302","0","62.14","49.46"
"66","000","00","018","1802","0558","774","633","141","54","828","1449","0","57.14","43.69"
"66","000","00","018","1803","0000","3306","2774","532","191","3497","6169","0","56.69","44.97"
"66","000","00","018","1803","0559","921","783","138","70","991","1621","0","61.14","48.3"
"66","000","00","018","1803","0560","851","705","146","75","926","1647","0","56.22","42.81"
"66","000","00","018","1803","0561","762","636","126","25","787","1441","0","54.61","44.14"
"66","000","00","018","1803","0562","772","650","122","21","793","1460","0","54.32","44.52"
"66","000","00","018","1804","0000","1945","1563","382","117","2062","3203","0","64.38","48.8"
"66","000","00","018","1804","0563","1127","893","234","65","1192","1832","0","65.07","48.74"
"66","000","00","018","1804","0564","818","670","148","52","870","1371","0","63.46","48.87"
"66","000","00","018","1805","0000","1788","1512","276","152","1940","3617","0","53.64","41.8"
"66","000","00","018","1805","0568","926","777","149","52","978","1733","0","56.43","44.84"
"66","000","00","018","1805","0569","862","735","127","100","962","1884","0","51.06","39.01"
"66","000","00","018","1806","0000","2258","1845","413","92","2350","4226","0","55.61","43.66"
"66","000","00","018","1806","0565","685","539","146","13","698","1418","0","49.22","38.01"
"66","000","00","018","1806","0566","828","694","134","32","860","1473","0","58.38","47.11"
"66","000","00","018","1806","0567","745","612","133","47","792","1335","0","59.33","45.84"
"66","000","00","018","1807","0000","2288","1742","546","144","2432","5183","0","46.92","33.61"
"66","000","00","018","1807","0533","449","264","185","46","495","1887","0","26.23","13.99"
"66","000","00","018","1807","0534","851","662","189","51","902","1480","0","60.95","44.73"
"66","000","00","018","1807","0535","988","816","172","47","1035","1816","0","56.99","44.93"
"66","000","00","018","1808","0000","2546","2098","448","143","2689","4728","0","56.87","44.37"
"66","000","00","018","1808","0542","865","725","140","63","928","1635","0","56.76","44.34"
"66","000","00","018","1808","0543","883","729","154","40","923","1565","0","58.98","46.58"
"66","000","00","018","1808","0544","798","644","154","40","838","1528","0","54.84","42.15"
"66","000","00","018","1809","0000","3058","2512","546","125","3183","6020","0","52.87","41.73"
"66","000","00","018","1809","0545","983","816","167","45","1028","1963","0","52.37","41.57"
"66","000","00","018","1809","0546","1024","835","189","36","1060","2073","0","51.13","40.28"
"66","000","00","018","1809","0547","1051","861","190","44","1095","1984","0","55.19","43.4"
"66","000","00","018","1810","0000","3098","2582","516","183","3281","5882","0","55.78","43.9"
"66","000","00","018","1810","0536","922","741","181","63","985","1898","0","51.9","39.04"
"66","000","00","018","1810","0537","1082","915","167","68","1150","2008","0","57.27","45.57"
"66","000","00","018","1810","0538","1094","926","168","52","1146","1976","0","58.0","46.86"
"66","000","00","018","1811","0000","2557","2103","454","91","2648","4464","0","59.32","47.11"
"66","000","00","018","1811","0539","936","786","150","41","977","1673","0","58.4","46.98"
"66","000","00","018","1811","0540","835","672","163","32","867","1409","0","61.53","47.69"
"66","000","00","018","1811","0541","786","645","141","18","804","1382","0","58.18","46.67"
"66","000","00","018","1812","0000","3049","2514","535","131","3180","5906","0","53.84","42.57"
"66","000","00","018","1812","0524","1094","919","175","68","1162","2027","0","57.33","45.34"
"66","000","00","018","1812","0525","965","777","188","27","992","1967","0","50.43","39.5"
"66","000","00","018","1812","0526","990","818","172","36","1026","1912","0","53.66","42.78"
"66","000","00","018","1813","0000","3181","2599","582","129","3310","5941","0","55.71","43.75"
"66","000","00","018","1813","0530","1064","862","202","31","1095","2013","0","54.4","42.82"
"66","000","00","018","1813","0531","1055","858","197","64","1119","1917","0","58.37","44.76"
"66","000","00","018","1813","0532","1062","879","183","34","1096","2011","0","54.5","43.71"
"66","000","00","018","1814","0000","2602","2123","479","172","2774","4776","0","58.08","44.45"
"66","000","00","018","1814","0548","886","743","143","52","938","1688","0","55.57","44.02"
"66","000","00","018","1814","0549","754","604","150","48","802","1387","0","57.82","43.55"
"66","000","00","018","1814","0550","962","776","186","72","1034","1701","0","60.79","45.62"
"66","000","00","018","1815","0000","1706","1418","288","128","1834","3600","0","50.94","39.39"
"66","000","00","018","1815","0551","882","728","154","89","971","1721","0","56.42","42.3"
"66","000","00","018","1815","0552","824","690","134","39","863","1879","0","45.93","36.72"
"66","000","00","019","0000","0000","10135","8246","1889","651","10786","20860","24605","51.71","39.53"
"66","000","00","019","1901","0000","1776","1427","349","81","1857","3259","0","56.98","43.79"
"66","000","00","019","1901","1562","532","420","112","22","554","1011","0","54.8","41.54"
"66","000","00","019","1901","1563","633","504","129","39","672","1195","0","56.23","42.18"
"66","000","00","019","1901","1564","611","503","108","20","631","1053","0","59.92","47.77"
"66","000","00","019","1902","0000","841","666","175","32","873","1880","0","46.44","35.43"
"66","000","00","019","1902","1565","388","304","84","15","403","961","0","41.94","31.63"
"66","000","00","019","1902","1566","453","362","91","17","470","919","0","51.14","39.39"
"66","000","00","019","1903","0000","784","642","142","55","839","1367","0","61.38","46.96"
"66","000","00","019","1903","1567","784","642","142","55","839","1367","0","61.38","46.96"
"66","000","00","019","1904","0000","504","402","102","22","526","1010","0","52.08","39.8"
"66","000","00","019","1904","1568","504","402","102","22","526","1010","0","52.08","39.8"
"66","000","00","019","1905","0000","516","415","101","42","558","1169","0","47.73","35.5"
"66","000","00","019","1905","1569","516","415","101","42","558","1169","0","47.73","35.5"
"66","000","00","019","1906","0000","968","777","191","61","1029","1883","0","54.65","41.26"
"66","000","00","019","1906","1570","514","393","121","48","562","989","0","56.83","39.74"
"66","000","00","019","1906","1571","454","384","70","13","467","894","0","52.24","42.95"
"66","000","00","019","1907","0000","1250","1019","231","60","1310","2936","0","44.62","34.71"
"66","000","00","019","1907","1572","463","387","76","16","479","1033","0","46.37","37.46"
"66","000","00","019","1907","1573","417","342","75","23","440","1058","0","41.59","32.33"
"66","000","00","019","1907","1574","370","290","80","21","391","845","0","46.27","34.32"
"66","000","00","019","1908","0000","365","296","69","24","389","576","0","67.53","51.39"
"66","000","00","019","1908","1575","365","296","69","24","389","576","0","67.53","51.39"
"66","000","00","019","1909","0000","1312","1063","249","113","1425","2900","0","49.14","36.66"
"66","000","00","019","1909","1576","567","458","109","59","626","1229","0","50.94","37.27"
"66","000","00","019","1909","1577","375","304","71","26","401","890","0","45.06","34.16"
"66","000","00","019","1909","1578","370","301","69","28","398","781","0","50.96","38.54"
"66","000","00","019","1910","0000","612","526","86","67","679","1244","0","54.58","42.28"
"66","000","00","019","1910","1579","612","526","86","67","679","1244","0","54.58","42.28"
"66","000","00","019","1911","0000","356","298","58","31","387","889","0","43.53","33.52"
"66","000","00","019","1911","1580","71","64","7","8","79","213","0","37.09","30.05"
"66","000","00","019","1911","1581","285","234","51","23","308","676","0","45.56","34.62"
"66","000","00","019","1912","0000","256","214","42","22","278","585","0","47.52","36.58"
"66","000","00","019","1912","1582","256","214","42","22","278","585","0","47.52","36.58"
"66","000","00","019","1913","0000","595","501","94","41","636","1162","0","54.73","43.12"
"66","000","00","019","1913","1583","488","414","74","38","526","938","0","56.08","44.14"
"66","000","00","019","1913","1584","107","87","20","3","110","224","0","49.11","38.84"
"66","000","00","020","0000","0000","7114","5735","1379","477","7591","12880","14968","58.94","44.53"
"66","000","00","020","2001","0000","688","548","140","42","730","1244","0","58.68","44.05"
"66","000","00","020","2001","1552","688","548","140","42","730","1244","0","58.68","44.05"
"66","000","00","020","2002","0000","825","665","160","5","830","1539","0","53.93","43.21"
"66","000","00","020","2002","1553","825","665","160","5","830","1539","0","53.93","43.21"
"66","000","00","020","2003","0000","670","517","153","40","710","1202","0","59.07","43.01"
"66","000","00","020","2003","1554","670","517","153","40","710","1202","0","59.07","43.01"
"66","000","00","020","2004","0000","633","519","114","64","697","1272","0","54.8","40.8"
"66","000","00","020","2004","1555","633","519","114","64","697","1272","0","54.8","40.8"
"66","000","00","020","2005","0000","361","298","63","30","391","652","0","59.97","45.71"
"66","000","00","020","2005","1556","361","298","63","30","391","652","0","59.97","45.71"
"66","000","00","020","2006","0000","886","717","169","71","957","1457","0","65.68","49.21"
"66","000","00","020","2006","1557","886","717","169","71","957","1457","0","65.68","49.21"
"66","000","00","020","2007","0000","974","785","189","62","1036","1836","0","56.43","42.76"
"66","000","00","020","2007","1558","974","785","189","62","1036","1836","0","56.43","42.76"
"66","000","00","020","2008","0000","532","431","101","48","580","1001","0","57.94","43.06"
"66","000","00","020","2008","1559","532","431","101","48","580","1001","0","57.94","43.06"
"66","000","00","020","2009","0000","835","681","154","62","897","1448","0","61.95","47.03"
"66","000","00","020","2009","1560","835","681","154","62","897","1448","0","61.95","47.03"
"66","000","00","020","2010","0000","710","574","136","53","763","1229","0","62.08","46.7"
"66","000","00","020","2010","1561","710","574","136","53","763","1229","0","62.08","46.7"
"66","000","00","021","0000","0000","14783","12116","2667","912","15695","27059","32202","58.0","44.78"
"66","000","00","021","2101","0000","565","446","119","37","602","1059","0","56.85","42.12"
"66","000","00","021","2101","0071","565","446","119","37","602","1059","0","56.85","42.12"
"66","000","00","021","2102","0000","1233","1017","216","68","1301","2163","0","60.15","47.02"
"66","000","00","021","2102","0072","565","462","103","23","588","1013","0","58.05","45.61"
"66","000","00","021","2102","0073","668","555","113","45","713","1150","0","62.0","48.26"
"66","000","00","021","2103","0000","990","804","186","80","1070","1902","0","56.26","42.27"
"66","000","00","021","2103","0081","990","804","186","80","1070","1902","0","56.26","42.27"
"66","000","00","021","2104","0000","2713","2274","439","135","2848","4635","0","61.45","49.06"
"66","000","00","021","2104","0074","1112","942","170","62","1174","1855","0","63.29","50.78"
"66","000","00","021","2104","0075","763","622","141","31","794","1327","0","59.83","46.87"
"66","000","00","021","2104","0076","838","710","128","42","880","1453","0","60.56","48.86"
"66","000","00","021","2105","0000","2048","1678","370","136","2184","3446","0","63.38","48.69"
"66","000","00","021","2105","0082","691","557","134","39","730","1138","0","64.15","48.95"
"66","000","00","021","2105","0083","613","506","107","65","678","1065","0","63.66","47.51"
"66","000","00","021","2105","0084","744","615","129","32","776","1243","0","62.43","49.48"
"66","000","00","021","2106","0000","3304","2689","615","183","3487","6297","0","55.38","42.7"
"66","000","00","021","2106","0077","858","715","143","67","925","1653","0","55.96","43.25"
"66","000","00","021","2106","0078","834","692","142","39","873","1615","0","54.06","42.85"
"66","000","00","021","2106","0079","745","593","152","31","776","1470","0","52.79","40.34"
"66","000","00","021","2106","0080","867","689","178","46","913","1559","0","58.56","44.19"
"66","000","00","021","2107","0000","737","605","132","41","778","1391","0","55.93","43.49"
"66","000","00","021","2107","0088","737","605","132","41","778","1391","0","55.93","43.49"
"66","000","00","021","2108","0000","730","599","131","52","782","1216","0","64.31","49.26"
"66","000","00","021","2108","0087","730","599","131","52","782","1216","0","64.31","49.26"
"66","000","00","021","2109","0000","1101","910","191","81","1182","2131","0","55.47","42.7"
"66","000","00","021","2109","0085","486","398","88","44","530","962","0","55.09","41.37"
"66","000","00","021","2109","0086","615","512","103","37","652","1169","0","55.77","43.8"
"66","000","00","021","2110","0000","837","652","185","69","906","1616","0","56.06","40.35"
"66","000","00","021","2110","0089","837","652","185","69","906","1616","0","56.06","40.35"
"66","000","00","021","2111","0000","525","442","83","30","555","1203","0","46.13","36.74"
"66","000","00","021","2111","0090","525","442","83","30","555","1203","0","46.13","36.74"
"66","000","00","022","0000","0000","8979","7288","1691","734","9713","16520","19250","58.8","44.12"
"66","000","00","022","2201","0000","519","446","73","53","572","1068","0","53.56","41.76"
"66","000","00","022","2201","0055","519","446","73","53","572","1068","0","53.56","41.76"
"66","000","00","022","2202","0000","555","453","102","58","613","1050","0","58.38","43.14"
"66","000","00","022","2202","0056","555","453","102","58","613","1050","0","58.38","43.14"
"66","000","00","022","2203","0000","1425","1131","294","109","1534","2643","0","58.04","42.79"
"66","000","00","022","2203","0057","690","547","143","60","750","1246","0","60.19","43.9"
"66","000","00","022","2203","0058","735","584","151","49","784","1397","0","56.12","41.8"
"66","000","00","022","2204","0000","869","712","157","71","940","1581","0","59.46","45.03"
"66","000","00","022","2204","0061","560","453","107","35","595","914","0","65.1","49.56"
"66","000","00","022","2204","0062","309","259","50","36","345","667","0","51.72","38.83"
"66","000","00","022","2205","0000","628","518","110","65","693","1170","0","59.23","44.27"
"66","000","00","022","2205","0060","628","518","110","65","693","1170","0","59.23","44.27"
"66","000","00","022","2206","0000","712","577","135","53","765","1227","0","62.35","47.03"
"66","000","00","022","2206","0059","712","577","135","53","765","1227","0","62.35","47.03"
"66","000","00","022","2207","0000","448","366","82","38","486","890","0","54.61","41.12"
"66","000","00","022","2207","0063","448","366","82","38","486","890","0","54.61","41.12"
"66","000","00","022","2208","0000","885","696","189","85","970","1744","0","55.62","39.91"
"66","000","00","022","2208","0064","669","525","144","60","729","1289","0","56.56","40.73"
"66","000","00","022","2208","0065","216","171","45","25","241","455","0","52.97","37.58"
"66","000","00","022","2209","0000","557","445","112","31","588","1028","0","57.2","43.29"
"66","000","00","022","2209","0066","557","445","112","31","588","1028","0","57.2","43.29"
"66","000","00","022","2210","0000","794","659","135","67","861","1446","0","59.54","45.57"
"66","000","00","022","2210","0067","794","659","135","67","861","1446","0","59.54","45.57"
"66","000","00","022","2211","0000","1022","841","181","75","1097","1750","0","62.69","48.06"
"66","000","00","022","2211","0068","422","350","72","26","448","688","0","65.12","50.87"
"66","000","00","022","2211","0069","600","491","109","49","649","1062","0","61.11","46.23"
"66","000","00","022","2212","0000","565","444","121","29","594","923","0","64.36","48.1"
"66","000","00","022","2212","0070","565","444","121","29","594","923","0","64.36","48.1"
"66","000","00","023","0000","0000","33822","27379","6443","2087","35909","61705","75275","58.19","44.37"
"66","000","00","023","2301","0000","4758","3845","913","288","5046","8455","0","59.68","45.48"
"66","000","00","023","2301","0317","853","674","179","54","907","1480","0","61.28","45.54"
"66","000","00","023","2301","0318","1056","860","196","68","1124","1841","0","61.05","46.71"
"66","000","00","023","2301","0319","941","753","188","58","999","1751","0","57.05","43.0"
"66","000","00","023","2301","0320","895","727","168","64","959","1547","0","61.99","46.99"
"66","000","00","023","2301","0321","1013","831","182","44","1057","1836","0","57.57","45.26"
"66","000","00","023","2302","0000","1422","1129","293","150","1572","2534","0","62.04","44.55"
"66","000","00","023","2302","0322","745","589","156","85","830","1239","0","66.99","47.54"
"66","000","00","023","2302","0323","677","540","137","65","742","1295","0","57.3","41.7"
"66","000","00","023","2303","0000","2510","2050","460","143","2653","4707","0","56.36","43.55"
"66","000","00","023","2303","0324","674","545","129","37","711","1263","0","56.29","43.15"
"66","000","00","023","2303","0325","876","721","155","30","906","1622","0","55.86","44.45"
"66","000","00","023","2303","0326","960","784","176","76","1036","1822","0","56.86","43.03"
"66","000","00","023","2304","0000","2677","2212","465","129","2806","4813","0","58.3","45.96"
"66","000","00","023","2304","0327","1056","881","175","52","1108","1966","0","56.36","44.81"
"66","000","00","023","2304","0328","902","746","156","47","949","1615","0","58.76","46.19"
"66","000","00","023","2304","0329","719","585","134","30","749","1232","0","60.8","47.48"
"66","000","00","023","2305","0000","1312","1105","207","61","1373","2512","0","54.66","43.99"
"66","000","00","023","2305","0330","727","613","114","26","753","1347","0","55.9","45.51"
"66","000","00","023","2305","0331","585","492","93","35","620","1165","0","53.22","42.23"
"66","000","00","023","2306","0000","7065","5669","1396","362","7427","12812","0","57.97","44.25"
"66","000","00","023","2306","0332","948","781","167","37","985","1664","0","59.19","46.94"
"66","000","00","023","2306","0333","722","585","137","52","774","1230","0","62.93","47.56"
"66","000","00","023","2306","0334","917","715","202","72","989","1574","0","62.83","45.43"
"66","000","00","023","2306","0335","880","685","195","39","919","1452","0","63.29","47.18"
"66","000","00","023","2306","0336","928","767","161","50","978","1879","0","52.05","40.82"
"66","000","00","023","2306","0337","860","689","171","37","897","1601","0","56.03","43.04"
"66","000","00","023","2306","0338","908","725","183","43","951","1546","0","61.51","46.9"
"66","000","00","023","2306","0339","902","722","180","32","934","1866","0","50.05","38.69"
"66","000","00","023","2307","0000","4121","3275","846","220","4341","7449","0","58.28","43.97"
"66","000","00","023","2307","0340","1085","849","236","67","1152","1938","0","59.44","43.81"
"66","000","00","023","2307","0341","987","792","195","55","1042","1759","0","59.24","45.03"
"66","000","00","023","2307","0342","1094","859","235","54","1148","2061","0","55.7","41.68"
"66","000","00","023","2307","0343","955","775","180","44","999","1691","0","59.08","45.83"
"66","000","00","023","2308","0000","1343","1032","311","64","1407","2260","0","62.26","45.66"
"66","000","00","023","2308","0344","642","484","158","37","679","1039","0","65.35","46.58"
"66","000","00","023","2308","0345","701","548","153","27","728","1221","0","59.62","44.88"
"66","000","00","023","2309","0000","826","752","74","73","899","1650","0","54.48","45.58"
"66","000","00","023","2309","0346","826","752","74","73","899","1650","0","54.48","45.58"
"66","000","00","023","2310","0000","1229","1002","227","82","1311","2157","0","60.78","46.45"
"66","000","00","023","2310","0347","549","436","113","33","582","937","0","62.11","46.53"
"66","000","00","023","2310","0348","680","566","114","49","729","1220","0","59.75","46.39"
"66","000","00","023","2311","0000","1046","844","202","104","1150","2139","0","53.76","39.46"
"66","000","00","023","2311","0349","1046","844","202","104","1150","2139","0","53.76","39.46"
"66","000","00","023","2312","0000","2412","1941","471","156","2568","4356","0","58.95","44.56"
"66","000","00","023","2312","0350","814","657","157","60","874","1371","0","63.75","47.92"
"66","000","00","023","2312","0351","711","581","130","44","755","1277","0","59.12","45.5"
"66","000","00","023","2312","0352","887","703","184","52","939","1708","0","54.98","41.16"
"66","000","00","023","2313","0000","1077","895","182","63","1140","2048","0","55.66","43.7"
"66","000","00","023","2313","0353","1077","895","182","63","1140","2048","0","55.66","43.7"
"66","000","00","023","2314","0000","833","667","166","79","912","1632","0","55.88","40.87"
"66","000","00","023","2314","0354","833","667","166","79","912","1632","0","55.88","40.87"
"66","000","00","023","2315","0000","751","607","144","54","805","1327","0","60.66","45.74"
"66","000","00","023","2315","0355","751","607","144","54","805","1327","0","60.66","45.74"
"66","000","00","023","2316","0000","440","354","86","59","499","854","0","58.43","41.45"
"66","000","00","023","2316","0356","440","354","86","59","499","854","0","58.43","41.45"
"66","000","00","024","0000","0000","25866","21090","4776","1563","27429","47457","57267","57.8","44.44"
"66","000","00","024","2401","0000","2333","1898","435","123","2456","4327","0","56.76","43.86"
"66","000","00","024","2401","0284","761","623","138","28","789","1415","0","55.76","44.03"
"66","000","00","024","2401","0285","701","563","138","45","746","1392","0","53.59","40.45"
"66","000","00","024","2401","0286","871","712","159","50","921","1520","0","60.59","46.84"
"66","000","00","024","2402","0000","534","421","113","49","583","862","0","67.63","48.84"
"66","000","00","024","2402","0287","534","421","113","49","583","862","0","67.63","48.84"
"66","000","00","024","2403","0000","2012","1622","390","128","2140","3558","0","60.15","45.59"
"66","000","00","024","2403","0288","729","589","140","48","777","1256","0","61.86","46.89"
"66","000","00","024","2403","0289","699","560","139","48","747","1292","0","57.82","43.34"
"66","000","00","024","2403","0290","584","473","111","32","616","1010","0","60.99","46.83"
"66","000","00","024","2404","0000","844","676","168","74","918","1485","0","61.82","45.52"
"66","000","00","024","2404","0291","844","676","168","74","918","1485","0","61.82","45.52"
"66","000","00","024","2405","0000","1393","1156","237","109","1502","2440","0","61.56","47.38"
"66","000","00","024","2405","0292","701","587","114","57","758","1190","0","63.7","49.33"
"66","000","00","024","2405","0293","692","569","123","52","744","1250","0","59.52","45.52"
"66","000","00","024","2406","0000","1434","1129","305","82","1516","2604","0","58.22","43.36"
"66","000","00","024","2406","0294","738","560","178","42","780","1310","0","59.54","42.75"
"66","000","00","024","2406","0295","696","569","127","40","736","1294","0","56.88","43.97"
"66","000","00","024","2407","0000","1731","1410","321","99","1830","3050","0","60.0","46.23"
"66","000","00","024","2407","0296","1032","838","194","50","1082","1734","0","62.4","48.33"
"66","000","00","024","2407","0297","699","572","127","49","748","1316","0","56.84","43.47"
"66","000","00","024","2408","0000","1252","1011","241","56","1308","2127","0","61.5","47.53"
"66","000","00","024","2408","0298","479","383","96","32","511","854","0","59.84","44.85"
"66","000","00","024","2408","0299","773","628","145","24","797","1273","0","62.61","49.33"
"66","000","00","024","2409","0000","514","431","83","17","531","851","0","62.4","50.65"
"66","000","00","024","2409","0300","514","431","83","17","531","851","0","62.4","50.65"
"66","000","00","024","2410","0000","873","746","127","35","908","1629","0","55.74","45.79"
"66","000","00","024","2410","0301","873","746","127","35","908","1629","0","55.74","45.79"
"66","000","00","024","2411","0000","876","735","141","95","971","1709","0","56.82","43.01"
"66","000","00","024","2411","0302","876","735","141","95","971","1709","0","56.82","43.01"
"66","000","00","024","2412","0000","474","402","72","36","510","953","0","53.52","42.18"
"66","000","00","024","2412","0303","474","402","72","36","510","953","0","53.52","42.18"
"66","000","00","024","2413","0000","774","620","154","38","812","1336","0","60.78","46.41"
"66","000","00","024","2413","0304","774","620","154","38","812","1336","0","60.78","46.41"
"66","000","00","024","2414","0000","3880","3149","731","210","4090","7282","0","56.17","43.24"
"66","000","00","024","2414","0305","1079","828","251","63","1142","2113","0","54.05","39.19"
"66","000","00","024","2414","0306","936","775","161","81","1017","1730","0","58.79","44.8"
"66","000","00","024","2414","0307","921","744","177","25","946","1692","0","55.91","43.97"
"66","000","00","024","2414","0308","944","802","142","41","985","1747","0","56.38","45.91"
"66","000","00","024","2415","0000","2631","2185","446","148","2779","5020","0","55.36","43.53"
"66","000","00","024","2415","0309","901","780","121","57","958","1672","0","57.3","46.65"
"66","000","00","024","2415","0310","842","678","164","40","882","1675","0","52.66","40.48"
"66","000","00","024","2415","0311","888","727","161","51","939","1673","0","56.13","43.45"
"66","000","00","024","2416","0000","2419","1937","482","153","2572","4732","0","54.35","40.93"
"66","000","00","024","2416","0312","913","740","173","39","952","1636","0","58.19","45.23"
"66","000","00","024","2416","0313","856","666","190","86","942","1753","0","53.74","37.99"
"66","000","00","024","2416","0314","650","531","119","28","678","1343","0","50.48","39.54"
"66","000","00","024","2417","0000","1892","1562","330","111","2003","3492","0","57.36","44.73"
"66","000","00","024","2417","0315","920","758","162","51","971","1822","0","53.29","41.6"
"66","000","00","024","2417","0316","972","804","168","60","1032","1670","0","61.8","48.14"
"66","000","00","025","0000","0000","33618","26747","6871","1884","35502","63584","77922","55.83","42.07"
"66","000","00","025","2501","0000","1672","1343","329","108","1780","3033","0","58.69","44.28"
"66","000","00","025","2501","0239","976","785","191","74","1050","1758","0","59.73","44.65"
"66","000","00","025","2501","0240","696","558","138","34","730","1275","0","57.25","43.76"
"66","000","00","025","2502","0000","1329","1067","262","87","1416","2782","0","50.9","38.35"
"66","000","00","025","2502","0241","641","512","129","27","668","1379","0","48.44","37.13"
"66","000","00","025","2502","0242","688","555","133","60","748","1403","0","53.31","39.56"
"66","000","00","025","2503","0000","1019","425","594","83","1102","1875","0","58.77","22.67"
"66","000","00","025","2503","0243","518","408","110","45","563","974","0","57.8","41.89"
"66","000","00","025","2503","0244","501","17","484","38","539","901","0","59.82","1.89"
"66","000","00","025","2504","0000","1840","1503","337","103","1943","3388","0","57.35","44.36"
"66","000","00","025","2504","0245","929","763","166","58","987","1779","0","55.48","42.89"
"66","000","00","025","2504","0246","911","740","171","45","956","1609","0","59.42","45.99"
"66","000","00","025","2505","0000","516","415","101","19","535","1038","0","51.54","39.98"
"66","000","00","025","2505","0247","516","415","101","19","535","1038","0","51.54","39.98"
"66","000","00","025","2506","0000","1282","1037","245","85","1367","2249","0","60.78","46.11"
"66","000","00","025","2506","0248","754","615","139","51","805","1328","0","60.62","46.31"
"66","000","00","025","2506","0249","528","422","106","34","562","921","0","61.02","45.82"
"66","000","00","025","2507","0000","2420","1936","484","135","2555","5028","0","50.82","38.5"
"66","000","00","025","2507","0250","797","637","160","47","844","1609","0","52.45","39.59"
"66","000","00","025","2507","0251","557","453","104","16","573","1227","0","46.7","36.92"
"66","000","00","025","2507","0252","669","548","121","55","724","1278","0","56.65","42.88"
"66","000","00","025","2507","0253","397","298","99","17","414","914","0","45.3","32.6"
"66","000","00","025","2508","0000","1347","1090","257","72","1419","2911","0","48.75","37.44"
"66","000","00","025","2508","0254","755","626","129","40","795","1678","0","47.38","37.31"
"66","000","00","025","2508","0255","592","464","128","32","624","1233","0","50.61","37.63"
"66","000","00","025","2509","0000","2582","2063","519","146","2728","4945","0","55.17","41.72"
"66","000","00","025","2509","0256","794","639","155","65","859","1520","0","56.51","42.04"
"66","000","00","025","2509","0257","942","778","164","27","969","1905","0","50.87","40.84"
"66","000","00","025","2509","0258","846","646","200","54","900","1520","0","59.21","42.5"
"66","000","00","025","2510","0000","2904","2342","562","153","3057","5692","0","53.71","41.15"
"66","000","00","025","2510","0259","685","561","124","63","748","1385","0","54.01","40.51"
"66","000","00","025","2510","0260","595","471","124","37","632","1212","0","52.15","38.86"
"66","000","00","025","2510","0261","790","639","151","21","811","1432","0","56.63","44.62"
"66","000","00","025","2510","0262","834","671","163","32","866","1663","0","52.07","40.35"
"66","000","00","025","2511","0000","3830","3083","747","170","4000","7249","0","55.18","42.53"
"66","000","00","025","2511","0263","716","579","137","34","750","1422","0","52.74","40.72"
"66","000","00","025","2511","0264","756","594","162","57","813","1616","0","50.31","36.76"
"66","000","00","025","2511","0265","802","670","132","45","847","1422","0","59.56","47.12"
"66","000","00","025","2511","0266","675","546","129","15","690","1165","0","59.23","46.87"
"66","000","00","025","2511","0267","881","694","187","19","900","1624","0","55.42","42.73"
"66","000","00","025","2512","0000","1405","1129","276","80","1485","2556","0","58.1","44.17"
"66","000","00","025","2512","0268","856","690","166","43","899","1613","0","55.73","42.78"
"66","000","00","025","2512","0269","549","439","110","37","586","943","0","62.14","46.55"
"66","000","00","025","2513","0000","3189","2561","628","208","3397","6091","0","55.77","42.05"
"66","000","00","025","2513","0270","782","638","144","69","851","1595","0","53.35","40.0"
"66","000","00","025","2513","0271","828","662","166","60","888","1508","0","58.89","43.9"
"66","000","00","025","2513","0272","746","592","154","38","784","1479","0","53.01","40.03"
"66","000","00","025","2513","0273","833","669","164","41","874","1509","0","57.92","44.33"
"66","000","00","025","2514","0000","887","714","173","55","942","1582","0","59.54","45.13"
"66","000","00","025","2514","0274","887","714","173","55","942","1582","0","59.54","45.13"
"66","000","00","025","2515","0000","2686","2163","523","156","2842","4692","0","60.57","46.1"
"66","000","00","025","2515","0280","628","512","116","34","662","1121","0","59.05","45.67"
"66","000","00","025","2515","0281","581","462","119","39","620","987","0","62.82","46.81"
"66","000","00","025","2515","0282","665","517","148","48","713","1206","0","59.12","42.87"
"66","000","00","025","2515","0283","812","672","140","35","847","1378","0","61.47","48.77"
"66","000","00","025","2516","0000","4710","3876","834","224","4934","8473","0","58.23","45.75"
"66","000","00","025","2516","0275","933","779","154","42","975","1725","0","56.52","45.16"
"66","000","00","025","2516","0276","884","760","124","31","915","1616","0","56.62","47.03"
"66","000","00","025","2516","0277","929","773","156","43","972","1657","0","58.66","46.65"
"66","000","00","025","2516","0278","981","802","179","54","1035","1774","0","58.34","45.21"
"66","000","00","025","2516","0279","983","762","221","54","1037","1701","0","60.96","44.8"
"66","000","00","026","0000","0000","31012","25277","5735","2276","33288","55225","65632","60.28","45.77"
"66","000","00","026","2601","0000","703","568","135","37","740","1205","0","61.41","47.14"
"66","000","00","026","2601","1470","703","568","135","37","740","1205","0","61.41","47.14"
"66","000","00","026","2602","0000","5136","4217","919","293","5429","9281","0","58.5","45.44"
"66","000","00","026","2602","1471","880","688","192","43","923","1620","0","56.98","42.47"
"66","000","00","026","2602","1472","904","761","143","50","954","1559","0","61.19","48.81"
"66","000","00","026","2602","1473","897","743","154","56","953","1660","0","57.41","44.76"
"66","000","00","026","2602","1474","940","779","161","45","985","1602","0","61.49","48.63"
"66","000","00","026","2602","1475","682","554","128","47","729","1325","0","55.02","41.81"
"66","000","00","026","2602","1476","833","692","141","52","885","1515","0","58.42","45.68"
"66","000","00","026","2603","0000","2501","1979","522","157","2658","4738","0","56.1","41.77"
"66","000","00","026","2603","1477","808","641","167","61","869","1561","0","55.67","41.06"
"66","000","00","026","2603","1478","857","686","171","52","909","1691","0","53.76","40.57"
"66","000","00","026","2603","1479","836","652","184","44","880","1486","0","59.22","43.88"
"66","000","00","026","2604","0000","1355","1116","239","116","1471","2333","0","63.05","47.84"
"66","000","00","026","2604","1480","561","446","115","51","612","975","0","62.77","45.74"
"66","000","00","026","2604","1481","794","670","124","65","859","1358","0","63.25","49.34"
"66","000","00","026","2605","0000","1227","998","229","91","1318","1996","0","66.03","50.0"
"66","000","00","026","2605","1482","723","589","134","33","756","1141","0","66.26","51.62"
"66","000","00","026","2605","1483","504","409","95","58","562","855","0","65.73","47.84"
"66","000","00","026","2606","0000","655","526","129","64","719","1202","0","59.82","43.76"
"66","000","00","026","2606","1484","655","526","129","64","719","1202","0","59.82","43.76"
"66","000","00","026","2607","0000","557","467","90","44","601","1078","0","55.75","43.32"
"66","000","00","026","2607","1485","557","467","90","44","601","1078","0","55.75","43.32"
"66","000","00","026","2608","0000","3316","2716","600","212","3528","5834","0","60.47","46.55"
"66","000","00","026","2608","1486","783","605","178","61","844","1456","0","57.97","41.55"
"66","000","00","026","2608","1487","915","759","156","47","962","1573","0","61.16","48.25"
"66","000","00","026","2608","1488","894","745","149","49","943","1591","0","59.27","46.83"
"66","000","00","026","2608","1489","724","607","117","55","779","1214","0","64.17","50.0"
"66","000","00","026","2609","0000","1703","1442","261","120","1823","2936","0","62.09","49.11"
"66","000","00","026","2609","1508","797","696","101","60","857","1363","0","62.88","51.06"
"66","000","00","026","2609","1509","906","746","160","60","966","1573","0","61.41","47.43"
"66","000","00","026","2610","0000","2099","1728","371","162","2261","3910","0","57.83","44.19"
"66","000","00","026","2610","1490","668","538","130","55","723","1267","0","57.06","42.46"
"66","000","00","026","2610","1491","704","607","97","56","760","1277","0","59.51","47.53"
"66","000","00","026","2610","1492","727","583","144","51","778","1366","0","56.95","42.68"
"66","000","00","026","2611","0000","1146","916","230","83","1229","1857","0","66.18","49.33"
"66","000","00","026","2611","1493","646","518","128","42","688","994","0","69.22","52.11"
"66","000","00","026","2611","1494","500","398","102","41","541","863","0","62.69","46.12"
"66","000","00","026","2612","0000","1314","1054","260","101","1415","2436","0","58.09","43.27"
"66","000","00","026","2612","1495","694","562","132","41","735","1274","0","57.69","44.11"
"66","000","00","026","2612","1496","620","492","128","60","680","1162","0","58.52","42.34"
"66","000","00","026","2613","0000","1450","1169","281","115","1565","2574","0","60.8","45.42"
"66","000","00","026","2613","1497","713","590","123","62","775","1252","0","61.9","47.12"
"66","000","00","026","2613","1498","737","579","158","53","790","1322","0","59.76","43.8"
"66","000","00","026","2614","0000","1405","1139","266","121","1526","2642","0","57.76","43.11"
"66","000","00","026","2614","1504","654","526","128","64","718","1314","0","54.64","40.03"
"66","000","00","026","2614","1505","751","613","138","57","808","1328","0","60.84","46.16"
"66","000","00","026","2615","0000","1165","946","219","106","1271","2077","0","61.19","45.55"
"66","000","00","026","2615","1506","538","437","101","54","592","989","0","59.86","44.19"
"66","000","00","026","2615","1507","627","509","118","52","679","1088","0","62.41","46.78"
"66","000","00","026","2616","0000","585","480","105","65","650","1117","0","58.19","42.97"
"66","000","00","026","2616","1510","585","480","105","65","650","1117","0","58.19","42.97"
"66","000","00","026","2617","0000","1423","1125","298","122","1545","2366","0","65.3","47.55"
"66","000","00","026","2617","1511","804","637","167","58","862","1342","0","64.23","47.47"
"66","000","00","026","2617","1512","619","488","131","64","683","1024","0","66.7","47.66"
"66","000","00","026","2618","0000","1316","1071","245","125","1441","2272","0","63.42","47.14"
"66","000","00","026","2618","1499","653","533","120","56","709","1116","0","63.53","47.76"
"66","000","00","026","2618","1500","663","538","125","69","732","1156","0","63.32","46.54"
"66","000","00","026","2619","0000","1275","1067","208","95","1370","2075","0","66.02","51.42"
"66","000","00","026","2619","1501","690","581","109","52","742","1147","0","64.69","50.65"
"66","000","00","026","2619","1502","585","486","99","43","628","928","0","67.67","52.37"
"66","000","00","026","2620","0000","681","553","128","47","728","1296","0","56.17","42.67"
"66","000","00","026","2620","1503","681","553","128","47","728","1296","0","56.17","42.67"
"66","000","00","027","0000","0000","80906","66181","14725","4802","85708","157926","191097","54.27","41.91"
"66","000","00","027","2701","0000","2745","2212","533","216","2961","5448","0","54.35","40.6"
"66","000","00","027","2701","1271","902","731","171","91","993","1821","0","54.53","40.14"
"66","000","00","027","2701","1272","804","663","141","35","839","1680","0","49.94","39.46"
"66","000","00","027","2701","1273","1039","818","221","90","1129","1947","0","57.99","42.01"
"66","000","00","027","2702","0000","3017","2437","580","204","3221","5757","0","55.95","42.33"
"66","000","00","027","2702","1274","1039","822","217","111","1150","1910","0","60.21","43.04"
"66","000","00","027","2702","1275","978","789","189","41","1019","1894","0","53.8","41.66"
"66","000","00","027","2702","1276","1000","826","174","52","1052","1953","0","53.87","42.29"
"66","000","00","027","2703","0000","2050","1679","371","110","2160","4067","0","53.11","41.28"
"66","000","00","027","2703","1281","1034","828","206","69","1103","2011","0","54.85","41.17"
"66","000","00","027","2703","1282","1016","851","165","41","1057","2056","0","51.41","41.39"
"66","000","00","027","2704","0000","1862","1474","388","123","1985","3317","0","59.84","44.44"
"66","000","00","027","2704","1287","1062","849","213","63","1125","1886","0","59.65","45.02"
"66","000","00","027","2704","1288","800","625","175","60","860","1431","0","60.1","43.68"
"66","000","00","027","2705","0000","1441","1178","263","108","1549","2924","0","52.98","40.29"
"66","000","00","027","2705","1297","674","555","119","67","741","1378","0","53.77","40.28"
"66","000","00","027","2705","1298","767","623","144","41","808","1546","0","52.26","40.3"
"66","000","00","027","2706","0000","2042","1672","370","155","2197","4083","0","53.81","40.95"
"66","000","00","027","2706","1291","1025","842","183","92","1117","2048","0","54.54","41.11"
"66","000","00","027","2706","1292","1017","830","187","63","1080","2035","0","53.07","40.79"
"66","000","00","027","2707","0000","3015","2444","571","169","3184","6114","0","52.08","39.97"
"66","000","00","027","2707","1316","875","731","144","36","911","1623","0","56.13","45.04"
"66","000","00","027","2707","1317","715","575","140","46","761","1548","0","49.16","37.14"
"66","000","00","027","2707","1318","736","579","157","55","791","1442","0","54.85","40.15"
"66","000","00","027","2707","1319","689","559","130","32","721","1501","0","48.03","37.24"
"66","000","00","027","2708","0000","1671","1365","306","103","1774","3605","0","49.21","37.86"
"66","000","00","027","2708","1312","926","747","179","71","997","1654","0","60.28","45.16"
"66","000","00","027","2708","1313","745","618","127","32","777","1951","0","39.83","31.68"
"66","000","00","027","2709","0000","1830","1530","300","131","1961","3281","0","59.77","46.63"
"66","000","00","027","2709","1301","881","758","123","74","955","1582","0","60.37","47.91"
"66","000","00","027","2709","1302","949","772","177","57","1006","1699","0","59.21","45.44"
"66","000","00","027","2710","0000","2515","2059","456","115","2630","5163","0","50.94","39.88"
"66","000","00","027","2710","1307","865","710","155","28","893","1776","0","50.28","39.98"
"66","000","00","027","2710","1308","892","723","169","40","932","1729","0","53.9","41.82"
"66","000","00","027","2710","1309","758","626","132","47","805","1658","0","48.55","37.76"
"66","000","00","027","2711","0000","3790","3153","637","193","3983","7262","0","54.85","43.42"
"66","000","00","027","2711","1325","1117","928","189","72","1189","2075","0","57.3","44.72"
"66","000","00","027","2711","1326","864","708","156","39","903","1723","0","52.41","41.09"
"66","000","00","027","2711","1327","1060","894","166","51","1111","2049","0","54.22","43.63"
"66","000","00","027","2711","1328","749","623","126","31","780","1415","0","55.12","44.03"
"66","000","00","027","2712","0000","3856","3174","682","222","4078","7197","0","56.66","44.1"
"66","000","00","027","2712","1335","918","747","171","54","972","1667","0","58.31","44.81"
"66","000","00","027","2712","1336","941","751","190","75","1016","1793","0","56.66","41.89"
"66","000","00","027","2712","1337","1033","889","144","34","1067","1903","0","56.07","46.72"
"66","000","00","027","2712","1338","964","787","177","59","1023","1834","0","55.78","42.91"
"66","000","00","027","2713","0000","2928","2424","504","126","3054","5993","0","50.96","40.45"
"66","000","00","027","2713","1346","916","756","160","47","963","1974","0","48.78","38.3"
"66","000","00","027","2713","1347","970","811","159","48","1018","1828","0","55.69","44.37"
"66","000","00","027","2713","1348","1042","857","185","31","1073","2191","0","48.97","39.11"
"66","000","00","027","2714","0000","892","716","176","79","971","1825","0","53.21","39.23"
"66","000","00","027","2714","1349","892","716","176","79","971","1825","0","53.21","39.23"
"66","000","00","027","2715","0000","622","518","104","66","688","1225","0","56.16","42.29"
"66","000","00","027","2715","1351","622","518","104","66","688","1225","0","56.16","42.29"
"66","000","00","027","2716","0000","1620","1303","317","120","1740","3179","0","54.73","40.99"
"66","000","00","027","2716","1352","879","725","154","58","937","1678","0","55.84","43.21"
"66","000","00","027","2716","1353","741","578","163","62","803","1501","0","53.5","38.51"
"66","000","00","027","2717","0000","1535","1243","292","96","1631","3094","0","52.71","40.17"
"66","000","00","027","2717","1357","640","501","139","29","669","1428","0","46.85","35.08"
"66","000","00","027","2717","1358","895","742","153","67","962","1666","0","57.74","44.54"
"66","000","00","027","2718","0000","2377","1911","466","142","2519","4710","0","53.48","40.57"
"66","000","00","027","2718","1361","634","514","120","34","668","1166","0","57.29","44.08"
"66","000","00","027","2718","1362","979","797","182","65","1044","1790","0","58.32","44.53"
"66","000","00","027","2718","1363","764","600","164","43","807","1754","0","46.01","34.21"
"66","000","00","027","2719","0000","409","338","71","36","445","699","0","63.66","48.35"
"66","000","00","027","2719","1356","409","338","71","36","445","699","0","63.66","48.35"
"66","000","00","027","2720","0000","3591","2928","663","196","3787","6563","0","57.7","44.61"
"66","000","00","027","2720","1277","990","778","212","72","1062","1846","0","57.53","42.15"
"66","000","00","027","2720","1278","838","693","145","39","877","1493","0","58.74","46.42"
"66","000","00","027","2720","1279","843","687","156","57","900","1605","0","56.07","42.8"
"66","000","00","027","2720","1280","920","770","150","28","948","1619","0","58.55","47.56"
"66","000","00","027","2721","0000","2027","1598","429","142","2169","4094","0","52.98","39.03"
"66","000","00","027","2721","1289","984","771","213","67","1051","1930","0","54.46","39.95"
"66","000","00","027","2721","1290","1043","827","216","75","1118","2164","0","51.66","38.22"
"66","000","00","027","2722","0000","1858","1607","251","157","2015","3870","0","52.07","41.52"
"66","000","00","027","2722","1293","845","685","160","90","935","1685","0","55.49","40.65"
"66","000","00","027","2722","1294","1013","922","91","67","1080","2185","0","49.43","42.2"
"66","000","00","027","2723","0000","1425","1162","263","69","1494","2773","0","53.88","41.9"
"66","000","00","027","2723","1295","598","495","103","23","621","1176","0","52.81","42.09"
"66","000","00","027","2723","1296","827","667","160","46","873","1597","0","54.66","41.77"
"66","000","00","027","2724","0000","1875","1538","337","131","2006","3691","0","54.35","41.67"
"66","000","00","027","2724","1283","961","788","173","62","1023","1876","0","54.53","42.0"
"66","000","00","027","2724","1284","914","750","164","69","983","1815","0","54.16","41.32"
"66","000","00","027","2725","0000","1281","990","291","84","1365","2285","0","59.74","43.33"
"66","000","00","027","2725","1285","672","516","156","41","713","1281","0","55.66","40.28"
"66","000","00","027","2725","1286","609","474","135","43","652","1004","0","64.94","47.21"
"66","000","00","027","2726","0000","1424","1147","277","130","1554","2943","0","52.8","38.97"
"66","000","00","027","2726","1299","883","695","188","77","960","1890","0","50.79","36.77"
"66","000","00","027","2726","1300","541","452","89","53","594","1053","0","56.41","42.92"
"66","000","00","027","2727","0000","2600","2200","400","77","2677","4703","0","56.92","46.78"
"66","000","00","027","2727","1339","784","668","116","26","810","1526","0","53.08","43.77"
"66","000","00","027","2727","1340","893","755","138","24","917","1483","0","61.83","50.91"
"66","000","00","027","2727","1341","923","777","146","27","950","1694","0","56.08","45.87"
"66","000","00","027","2728","0000","3682","3051","631","101","3783","6795","0","55.67","44.9"
"66","000","00","027","2728","1342","926","758","168","7","933","1952","0","47.8","38.83"
"66","000","00","027","2728","1343","1040","841","199","32","1072","1995","0","53.73","42.16"
"66","000","00","027","2728","1344","737","617","120","25","762","1311","0","58.12","47.06"
"66","000","00","027","2728","1345","979","835","144","37","1016","1537","0","66.1","54.33"
"66","000","00","027","2729","0000","2895","2339","556","144","3039","5574","0","54.52","41.96"
"66","000","00","027","2729","1329","944","765","179","41","985","1778","0","55.4","43.03"
"66","000","00","027","2729","1330","856","679","177","51","907","1706","0","53.17","39.8"
"66","000","00","027","2729","1331","1095","895","200","52","1147","2090","0","54.88","42.82"
"66","000","00","027","2730","0000","2459","2088","371","126","2585","5269","0","49.06","39.63"
"66","000","00","027","2730","1332","990","827","163","49","1039","2093","0","49.64","39.51"
"66","000","00","027","2730","1333","753","638","115","38","791","1688","0","46.86","37.8"
"66","000","00","027","2730","1334","716","623","93","39","755","1488","0","50.74","41.87"
"66","000","00","027","2731","0000","2882","2336","546","156","3038","6065","0","50.09","38.52"
"66","000","00","027","2731","1320","942","769","173","26","968","2025","0","47.8","37.98"
"66","000","00","027","2731","1321","951","772","179","58","1009","1885","0","53.53","40.95"
"66","000","00","027","2731","1322","989","795","194","72","1061","2155","0","49.23","36.89"
"66","000","00","027","2732","0000","1682","1375","307","118","1800","3796","0","47.42","36.22"
"66","000","00","027","2732","1323","826","666","160","43","869","1775","0","48.96","37.52"
"66","000","00","027","2732","1324","856","709","147","75","931","2021","0","46.07","35.08"
"66","000","00","027","2733","0000","1898","1628","270","113","2011","3762","0","53.46","43.27"
"66","000","00","027","2733","1310","1024","883","141","50","1074","2010","0","53.43","43.93"
"66","000","00","027","2733","1311","874","745","129","63","937","1752","0","53.48","42.52"
"66","000","00","027","2734","0000","2552","2049","503","122","2674","4401","0","60.76","46.56"
"66","000","00","027","2734","1314","1283","1036","247","81","1364","2170","0","62.86","47.74"
"66","000","00","027","2734","1315","1269","1013","256","41","1310","2231","0","58.72","45.41"
"66","000","00","027","2735","0000","1310","1064","246","83","1393","2556","0","54.5","41.63"
"66","000","00","027","2735","1303","768","629","139","50","818","1493","0","54.79","42.13"
"66","000","00","027","2735","1304","542","435","107","33","575","1063","0","54.09","40.92"
"66","000","00","027","2736","0000","1271","1083","188","78","1349","2201","0","61.29","49.2"
"66","000","00","027","2736","1305","649","550","99","42","691","1117","0","61.86","49.24"
"66","000","00","027","2736","1306","622","533","89","36","658","1084","0","60.7","49.17"
"66","000","00","027","2737","0000","739","592","147","18","757","1559","0","48.56","37.97"
"66","000","00","027","2737","1350","739","592","147","18","757","1559","0","48.56","37.97"
"66","000","00","027","2738","0000","1885","1512","373","146","2031","3576","0","56.8","42.28"
"66","000","00","027","2738","1354","856","672","184","73","929","1450","0","64.07","46.34"
"66","000","00","027","2738","1355","1029","840","189","73","1102","2126","0","51.83","39.51"
"66","000","00","027","2739","0000","1353","1064","289","97","1450","2507","0","57.84","42.44"
"66","000","00","027","2739","1359","646","494","152","45","691","1241","0","55.68","39.81"
"66","000","00","027","2739","1360","707","570","137","52","759","1266","0","59.95","45.02"
"66","000","00","028","0000","0000","90509","73521","16988","5141","95650","171769","211860","55.69","42.8"
"66","000","00","028","2801","0000","1885","1496","389","122","2007","3508","0","57.21","42.65"
"66","000","00","028","2801","1373","875","701","174","47","922","1697","0","54.33","41.31"
"66","000","00","028","2801","1374","1010","795","215","75","1085","1811","0","59.91","43.9"
"66","000","00","028","2802","0000","5158","4171","987","274","5432","9923","0","54.74","42.03"
"66","000","00","028","2802","1375","923","740","183","57","980","1830","0","53.55","40.44"
"66","000","00","028","2802","1376","898","725","173","67","965","2228","0","43.31","32.54"
"66","000","00","028","2802","1377","1065","885","180","75","1140","1997","0","57.09","44.32"
"66","000","00","028","2802","1378","1255","1044","211","42","1297","2033","0","63.8","51.35"
"66","000","00","028","2802","1379","1017","777","240","33","1050","1835","0","57.22","42.34"
"66","000","00","028","2803","0000","1724","1421","303","128","1852","3418","0","54.18","41.57"
"66","000","00","028","2803","1384","830","725","105","60","890","1621","0","54.9","44.73"
"66","000","00","028","2803","1385","894","696","198","68","962","1797","0","53.53","38.73"
"66","000","00","028","2804","0000","3646","2900","746","166","3812","7122","0","53.52","40.72"
"66","000","00","028","2804","1422","939","746","193","44","983","1875","0","52.43","39.79"
"66","000","00","028","2804","1423","904","725","179","50","954","1670","0","57.13","43.41"
"66","000","00","028","2804","1424","962","770","192","44","1006","1898","0","53.0","40.57"
"66","000","00","028","2804","1425","841","659","182","28","869","1679","0","51.76","39.25"
"66","000","00","028","2805","0000","3626","2912","714","253","3879","6924","0","56.02","42.06"
"66","000","00","028","2805","1386","621","503","118","24","645","1230","0","52.44","40.89"
"66","000","00","028","2805","1387","769","627","142","52","821","1488","0","55.17","42.14"
"66","000","00","028","2805","1388","732","568","164","62","794","1459","0","54.42","38.93"
"66","000","00","028","2805","1389","879","711","168","54","933","1647","0","56.65","43.17"
"66","000","00","028","2805","1390","625","503","122","61","686","1100","0","62.36","45.73"
"66","000","00","028","2806","0000","2124","1744","380","165","2289","3956","0","57.86","44.08"
"66","000","00","028","2806","1434","661","551","110","42","703","1103","0","63.74","49.95"
"66","000","00","028","2806","1435","742","612","130","51","793","1419","0","55.88","43.13"
"66","000","00","028","2806","1436","721","581","140","72","793","1434","0","55.3","40.52"
"66","000","00","028","2807","0000","2802","2249","553","111","2913","5587","0","52.14","40.25"
"66","000","00","028","2807","1437","850","698","152","34","884","1875","0","47.15","37.23"
"66","000","00","028","2807","1438","1005","774","231","49","1054","1862","0","56.61","41.57"
"66","000","00","028","2807","1439","947","777","170","28","975","1850","0","52.7","42.0"
"66","000","00","028","2808","0000","4208","3459","749","249","4457","8258","0","53.97","41.89"
"66","000","00","028","2808","1391","761","641","120","46","807","1410","0","57.23","45.46"
"66","000","00","028","2808","1392","896","734","162","61","957","1807","0","52.96","40.62"
"66","000","00","028","2808","1393","708","568","140","50","758","1331","0","56.95","42.67"
"66","000","00","028","2808","1394","920","739","181","49","969","1801","0","53.8","41.03"
"66","000","00","028","2808","1395","923","777","146","43","966","1909","0","50.6","40.7"
"66","000","00","028","2809","0000","1709","1389","320","108","1817","3355","0","54.16","41.4"
"66","000","00","028","2809","1399","878","717","161","62","940","1753","0","53.62","40.9"
"66","000","00","028","2809","1400","831","672","159","46","877","1602","0","54.74","41.95"
"66","000","00","028","2810","0000","2581","2063","518","175","2756","5278","0","52.22","39.09"
"66","000","00","028","2810","1451","894","725","169","40","934","1759","0","53.1","41.22"
"66","000","00","028","2810","1452","866","688","178","71","937","1783","0","52.55","38.59"
"66","000","00","028","2810","1453","821","650","171","64","885","1736","0","50.98","37.44"
"66","000","00","028","2811","0000","3845","3103","742","256","4101","7599","0","53.97","40.83"
"66","000","00","028","2811","1458","963","780","183","61","1024","1836","0","55.77","42.48"
"66","000","00","028","2811","1459","979","786","193","68","1047","1913","0","54.73","41.09"
"66","000","00","028","2811","1460","942","745","197","75","1017","1913","0","53.16","38.94"
"66","000","00","028","2811","1461","961","792","169","52","1013","1937","0","52.3","40.89"
"66","000","00","028","2812","0000","2293","1785","508","137","2430","4237","0","57.35","42.13"
"66","000","00","028","2812","1401","611","490","121","49","660","1144","0","57.69","42.83"
"66","000","00","028","2812","1402","911","692","219","51","962","1655","0","58.13","41.81"
"66","000","00","028","2812","1403","771","603","168","37","808","1438","0","56.19","41.93"
"66","000","00","028","2813","0000","545","439","106","46","591","1000","0","59.1","43.9"
"66","000","00","028","2813","1404","545","439","106","46","591","1000","0","59.1","43.9"
"66","000","00","028","2814","0000","4401","3653","748","241","4642","8369","0","55.47","43.65"
"66","000","00","028","2814","1405","895","748","147","68","963","1711","0","56.28","43.72"
"66","000","00","028","2814","1406","870","750","120","10","880","1698","0","51.83","44.17"
"66","000","00","028","2814","1407","1001","831","170","71","1072","1914","0","56.01","43.42"
"66","000","00","028","2814","1408","797","648","149","28","825","1465","0","56.31","44.23"
"66","000","00","028","2814","1409","838","676","162","64","902","1581","0","57.05","42.76"
"66","000","00","028","2815","0000","2041","1658","383","93","2134","4438","0","48.08","37.36"
"66","000","00","028","2815","1414","549","431","118","36","585","1204","0","48.59","35.8"
"66","000","00","028","2815","1415","817","662","155","31","848","1761","0","48.15","37.59"
"66","000","00","028","2815","1416","675","565","110","26","701","1473","0","47.59","38.36"
"66","000","00","028","2816","0000","4361","3535","826","322","4683","8428","0","55.56","41.94"
"66","000","00","028","2816","1417","897","738","159","50","947","1675","0","56.54","44.06"
"66","000","00","028","2816","1418","934","798","136","54","988","1755","0","56.3","45.47"
"66","000","00","028","2816","1419","762","596","166","77","839","1593","0","52.67","37.41"
"66","000","00","028","2816","1420","937","739","198","61","998","1799","0","55.48","41.08"
"66","000","00","028","2816","1421","831","664","167","80","911","1606","0","56.72","41.34"
"66","000","00","028","2817","0000","6162","5023","1139","279","6441","11504","0","55.99","43.66"
"66","000","00","028","2817","1462","784","642","142","35","819","1508","0","54.31","42.57"
"66","000","00","028","2817","1463","762","618","144","19","781","1340","0","58.28","46.12"
"66","000","00","028","2817","1464","918","760","158","47","965","1656","0","58.27","45.89"
"66","000","00","028","2817","1465","687","557","130","42","729","1290","0","56.51","43.18"
"66","000","00","028","2817","1466","889","737","152","35","924","1655","0","55.83","44.53"
"66","000","00","028","2817","1467","595","490","105","18","613","1260","0","48.65","38.89"
"66","000","00","028","2817","1468","708","579","129","36","744","1247","0","59.66","46.43"
"66","000","00","028","2817","1469","819","640","179","47","866","1548","0","55.94","41.34"
"66","000","00","028","2818","0000","5022","4041","981","349","5371","9578","0","56.08","42.19"
"66","000","00","028","2818","1445","825","637","188","75","900","1701","0","52.91","37.45"
"66","000","00","028","2818","1446","777","625","152","55","832","1549","0","53.71","40.35"
"66","000","00","028","2818","1447","879","724","155","58","937","1567","0","59.8","46.2"
"66","000","00","028","2818","1448","863","712","151","45","908","1614","0","56.26","44.11"
"66","000","00","028","2818","1449","966","777","189","78","1044","1811","0","57.65","42.9"
"66","000","00","028","2818","1450","712","566","146","38","750","1336","0","56.14","42.37"
"66","000","00","028","2819","0000","5079","4133","946","244","5323","10155","0","52.42","40.7"
"66","000","00","028","2819","1364","792","633","159","44","836","1614","0","51.8","39.22"
"66","000","00","028","2819","1365","772","638","134","28","800","1599","0","50.03","39.9"
"66","000","00","028","2819","1366","828","667","161","41","869","1715","0","50.67","38.89"
"66","000","00","028","2819","1367","691","559","132","23","714","1264","0","56.49","44.22"
"66","000","00","028","2819","1368","706","584","122","34","740","1416","0","52.26","41.24"
"66","000","00","028","2819","1369","617","515","102","25","642","1188","0","54.04","43.35"
"66","000","00","028","2819","1370","673","537","136","49","722","1359","0","53.13","39.51"
"66","000","00","028","2820","0000","1563","1274","289","103","1666","2860","0","58.25","44.55"
"66","000","00","028","2820","1371","778","634","144","60","838","1457","0","57.52","43.51"
"66","000","00","028","2820","1372","785","640","145","43","828","1403","0","59.02","45.62"
"66","000","00","028","2821","0000","3281","2710","571","122","3403","5775","0","58.93","46.93"
"66","000","00","028","2821","1380","696","569","127","23","719","1268","0","56.7","44.87"
"66","000","00","028","2821","1381","880","711","169","47","927","1645","0","56.35","43.22"
"66","000","00","028","2821","1382","879","724","155","22","901","1561","0","57.72","46.38"
"66","000","00","028","2821","1383","826","706","120","30","856","1301","0","65.8","54.27"
"66","000","00","028","2822","0000","2168","1768","400","148","2316","4102","0","56.46","43.1"
"66","000","00","028","2822","1426","697","559","138","54","751","1373","0","54.7","40.71"
"66","000","00","028","2822","1427","697","574","123","55","752","1299","0","57.89","44.19"
"66","000","00","028","2822","1428","774","635","139","39","813","1430","0","56.85","44.41"
"66","000","00","028","2823","0000","5614","4642","972","196","5810","9149","0","63.5","50.74"
"66","000","00","028","2823","1429","1094","885","209","43","1137","1805","0","62.99","49.03"
"66","000","00","028","2823","1430","1132","922","210","25","1157","1806","0","64.06","51.05"
"66","000","00","028","2823","1431","1145","965","180","45","1190","1826","0","65.17","52.85"
"66","000","00","028","2823","1432","1137","948","189","40","1177","1805","0","65.21","52.52"
"66","000","00","028","2823","1433","1106","922","184","43","1149","1907","0","60.25","48.35"
"66","000","00","028","2824","0000","4772","3884","888","267","5039","8472","0","59.48","45.85"
"66","000","00","028","2824","1440","872","693","179","63","935","1622","0","57.64","42.73"
"66","000","00","028","2824","1441","963","788","175","55","1018","1638","0","62.15","48.11"
"66","000","00","028","2824","1442","942","754","188","73","1015","1633","0","62.16","46.17"
"66","000","00","028","2824","1443","907","725","182","35","942","1662","0","56.68","43.62"
"66","000","00","028","2824","1444","1088","924","164","41","1129","1917","0","58.89","48.2"
"66","000","00","028","2825","0000","2652","2183","469","188","2840","5238","0","54.22","41.68"
"66","000","00","028","2825","1396","791","640","151","71","862","1699","0","50.74","37.67"
"66","000","00","028","2825","1397","884","728","156","57","941","1627","0","57.84","44.74"
"66","000","00","028","2825","1398","977","815","162","60","1037","1912","0","54.24","42.63"
"66","000","00","028","2826","0000","4083","3309","774","202","4285","7648","0","56.03","43.27"
"66","000","00","028","2826","1454","984","799","185","61","1045","1874","0","55.76","42.64"
"66","000","00","028","2826","1455","1031","833","198","38","1069","1889","0","56.59","44.1"
"66","000","00","028","2826","1456","986","797","189","55","1041","1947","0","53.47","40.93"
"66","000","00","028","2826","1457","1082","880","202","48","1130","1938","0","58.31","45.41"
"66","000","00","028","2827","0000","3164","2577","587","197","3361","5888","0","57.08","43.77"
"66","000","00","028","2827","1410","834","670","164","60","894","1509","0","59.24","44.4"
"66","000","00","028","2827","1411","786","664","122","34","820","1570","0","52.23","42.29"
"66","000","00","028","2827","1412","786","631","155","40","826","1425","0","57.96","44.28"
"66","000","00","028","2827","1413","758","612","146","63","821","1384","0","59.32","44.22"
"66","000","00","029","0000","0000","5369","4505","864","309","5678","9498","11066","59.78","47.43"
"66","000","00","029","2901","0000","1161","940","221","79","1240","1919","0","64.62","48.98"
"66","000","00","029","2901","1585","581","460","121","32","613","956","0","64.12","48.12"
"66","000","00","029","2901","1586","580","480","100","47","627","963","0","65.11","49.84"
"66","000","00","029","2902","0000","244","205","39","14","258","456","0","56.58","44.96"
"66","000","00","029","2902","1587","244","205","39","14","258","456","0","56.58","44.96"
"66","000","00","029","2903","0000","967","820","147","44","1011","1647","0","61.38","49.79"
"66","000","00","029","2903","1588","606","517","89","31","637","1011","0","63.01","51.14"
"66","000","00","029","2903","1589","361","303","58","13","374","636","0","58.81","47.64"
"66","000","00","029","2904","0000","296","250","46","13","309","451","0","68.51","55.43"
"66","000","00","029","2904","1595","296","250","46","13","309","451","0","68.51","55.43"
"66","000","00","029","2905","0000","688","608","80","38","726","1051","0","69.08","57.85"
"66","000","00","029","2905","1590","121","105","16","6","127","270","0","47.04","38.89"
"66","000","00","029","2905","1591","336","306","30","21","357","460","0","77.61","66.52"
"66","000","00","029","2905","1592","231","197","34","11","242","321","0","75.39","61.37"
"66","000","00","029","2906","0000","653","538","115","43","696","1119","0","62.2","48.08"
"66","000","00","029","2906","1593","471","388","83","25","496","783","0","63.35","49.55"
"66","000","00","029","2906","1594","182","150","32","18","200","336","0","59.52","44.64"
"66","000","00","029","2907","0000","952","798","154","59","1011","1985","0","50.93","40.2"
"66","000","00","029","2907","1596","178","144","34","13","191","366","0","52.19","39.34"
"66","000","00","029","2907","1597","325","282","43","8","333","771","0","43.19","36.58"
"66","000","00","029","2907","1598","292","250","42","26","318","574","0","55.4","43.55"
"66","000","00","029","2907","1599","157","122","35","12","169","274","0","61.68","44.53"
"66","000","00","029","2908","0000","408","346","62","19","427","870","0","49.08","39.77"
"66","000","00","029","2908","1600","84","69","15","2","86","157","0","54.78","43.95"
"66","000","00","029","2908","1601","324","277","47","17","341","713","0","47.83","38.85"
"67","000","00","000","0000","0000","739505","572230","167275","59206","798711","1594821","1883804","50.08","35.88"
"67","000","00","001","0000","0000","29577","23334","6243","1931","31508","64949","77651","48.51","35.93"
"67","000","00","001","0101","0000","2290","1803","487","165","2455","4741","0","51.78","38.03"
"67","000","00","001","0101","0116","731","584","147","55","786","1693","0","46.43","34.49"
"67","000","00","001","0101","0117","814","652","162","54","868","1561","0","55.61","41.77"
"67","000","00","001","0101","0118","745","567","178","56","801","1487","0","53.87","38.13"
"67","000","00","001","0102","0000","1078","856","222","62","1140","2299","0","49.59","37.23"
"67","000","00","001","0102","0119","582","464","118","31","613","1232","0","49.76","37.66"
"67","000","00","001","0102","0120","496","392","104","31","527","1067","0","49.39","36.74"
"67","000","00","001","0103","0000","1324","1058","266","60","1384","2885","0","47.97","36.67"
"67","000","00","001","0103","0121","585","452","133","37","622","1419","0","43.83","31.85"
"67","000","00","001","0103","0122","739","606","133","23","762","1466","0","51.98","41.34"
"67","000","00","001","0107","0000","1396","1079","317","70","1466","2940","0","49.86","36.7"
"67","000","00","001","0107","0126","464","368","96","33","497","888","0","55.97","41.44"
"67","000","00","001","0107","0127","527","398","129","14","541","1115","0","48.52","35.7"
"67","000","00","001","0107","0128","405","313","92","23","428","937","0","45.68","33.4"
"67","000","00","001","0108","0000","2036","1587","449","116","2152","4214","0","51.07","37.66"
"67","000","00","001","0108","0129","639","486","153","36","675","1387","0","48.67","35.04"
"67","000","00","001","0108","0130","710","562","148","43","753","1526","0","49.34","36.83"
"67","000","00","001","0108","0131","687","539","148","37","724","1301","0","55.65","41.43"
"67","000","00","001","0109","0000","635","487","148","47","682","1193","0","57.17","40.82"
"67","000","00","001","0109","0136","635","487","148","47","682","1193","0","57.17","40.82"
"67","000","00","001","0110","0000","495","401","94","13","508","1439","0","35.3","27.87"
"67","000","00","001","0110","0137","495","401","94","13","508","1439","0","35.3","27.87"
"67","000","00","001","0112","0000","931","736","195","49","980","2460","0","39.84","29.92"
"67","000","00","001","0112","0140","458","342","116","31","489","1233","0","39.66","27.74"
"67","000","00","001","0112","0141","473","394","79","18","491","1227","0","40.02","32.11"
"67","000","00","001","0113","0000","940","745","195","73","1013","1797","0","56.37","41.46"
"67","000","00","001","0113","0138","752","608","144","52","804","1438","0","55.91","42.28"
"67","000","00","001","0113","0139","188","137","51","21","209","359","0","58.22","38.16"
"67","000","00","001","0114","0000","1267","1007","260","56","1323","3250","0","40.71","30.98"
"67","000","00","001","0114","0142","534","443","91","29","563","1320","0","42.65","33.56"
"67","000","00","001","0114","0143","733","564","169","27","760","1930","0","39.38","29.22"
"67","000","00","001","0115","0000","1958","1556","402","157","2115","4419","0","47.86","35.21"
"67","000","00","001","0115","0150","763","603","160","64","827","1595","0","51.85","37.81"
"67","000","00","001","0115","0151","387","309","78","17","404","959","0","42.13","32.22"
"67","000","00","001","0115","0152","808","644","164","76","884","1865","0","47.4","34.53"
"67","000","00","001","0116","0000","696","552","144","85","781","1678","0","46.54","32.9"
"67","000","00","001","0116","0153","696","552","144","85","781","1678","0","46.54","32.9"
"67","000","00","001","0117","0000","561","450","111","53","614","1373","0","44.72","32.77"
"67","000","00","001","0117","0154","561","450","111","53","614","1373","0","44.72","32.77"
"67","000","00","001","0118","0000","582","435","147","26","608","1722","0","35.31","25.26"
"67","000","00","001","0118","0155","491","361","130","23","514","1431","0","35.92","25.23"
"67","000","00","001","0118","0156","91","74","17","3","94","291","0","32.3","25.43"
"67","000","00","001","0119","0000","800","620","180","38","838","1749","0","47.91","35.45"
"67","000","00","001","0119","0157","800","620","180","38","838","1749","0","47.91","35.45"
"67","000","00","001","0120","0000","1657","1331","326","141","1798","3683","0","48.82","36.14"
"67","000","00","001","0120","0158","773","616","157","48","821","1862","0","44.09","33.08"
"67","000","00","001","0120","0159","884","715","169","93","977","1821","0","53.65","39.26"
"67","000","00","001","0121","0000","788","616","172","59","847","1845","0","45.91","33.39"
"67","000","00","001","0121","0160","788","616","172","59","847","1845","0","45.91","33.39"
"67","000","00","001","0125","0000","730","546","184","98","828","1644","0","50.36","33.21"
"67","000","00","001","0125","0163","351","260","91","59","410","703","0","58.32","36.98"
"67","000","00","001","0125","0164","379","286","93","39","418","941","0","44.42","30.39"
"67","000","00","001","0126","0000","304","236","68","18","322","944","0","34.11","25.0"
"67","000","00","001","0126","0161","178","140","38","10","188","542","0","34.69","25.83"
"67","000","00","001","0126","0162","126","96","30","8","134","402","0","33.33","23.88"
"67","000","00","001","0127","0000","2279","1859","420","151","2430","4729","0","51.39","39.31"
"67","000","00","001","0127","0144","732","586","146","55","787","1501","0","52.43","39.04"
"67","000","00","001","0127","0145","672","555","117","42","714","1475","0","48.41","37.63"
"67","000","00","001","0127","0146","875","718","157","54","929","1753","0","52.99","40.96"
"67","000","00","001","0128","0000","2285","1841","444","111","2396","4922","0","48.68","37.4"
"67","000","00","001","0128","0147","804","646","158","40","844","1748","0","48.28","36.96"
"67","000","00","001","0128","0148","833","664","169","45","878","1741","0","50.43","38.14"
"67","000","00","001","0128","0149","648","531","117","26","674","1433","0","47.03","37.06"
"67","000","00","001","0129","0000","3255","2548","707","182","3437","6235","0","55.12","40.87"
"67","000","00","001","0129","0132","801","644","157","64","865","1538","0","56.24","41.87"
"67","000","00","001","0129","0133","809","657","152","42","851","1584","0","53.72","41.48"
"67","000","00","001","0129","0134","858","619","239","37","895","1583","0","56.54","39.1"
"67","000","00","001","0129","0135","787","628","159","39","826","1530","0","53.99","41.05"
"67","000","00","001","0130","0000","1290","985","305","101","1391","2788","0","49.89","35.33"
"67","000","00","001","0130","0123","521","393","128","45","566","932","0","60.73","42.17"
"67","000","00","001","0130","0124","451","339","112","29","480","1099","0","43.68","30.85"
"67","000","00","001","0130","0125","318","253","65","27","345","757","0","45.57","33.42"
"67","000","00","002","0000","0000","9312","7197","2115","884","10196","22121","25397","46.09","32.53"
"67","000","00","002","0201","0000","724","555","169","84","808","1517","0","53.26","36.59"
"67","000","00","002","0201","0085","486","375","111","65","551","1037","0","53.13","36.16"
"67","000","00","002","0201","0086","238","180","58","19","257","480","0","53.54","37.5"
"67","000","00","002","0208","0000","1608","1275","333","104","1712","3743","0","45.74","34.06"
"67","000","00","002","0208","0093","332","255","77","23","355","863","0","41.14","29.55"
"67","000","00","002","0208","0094","588","463","125","21","609","1373","0","44.36","33.72"
"67","000","00","002","0208","0095","688","557","131","60","748","1507","0","49.64","36.96"
"67","000","00","002","0210","0000","282","220","62","41","323","921","0","35.07","23.89"
"67","000","00","002","0210","0099","282","220","62","41","323","921","0","35.07","23.89"
"67","000","00","002","0211","0000","1639","1257","382","183","1822","3640","0","50.05","34.53"
"67","000","00","002","0211","0096","651","490","161","74","725","1374","0","52.77","35.66"
"67","000","00","002","0211","0097","514","402","112","48","562","1244","0","45.18","32.32"
"67","000","00","002","0211","0098","474","365","109","61","535","1022","0","52.35","35.71"
"67","000","00","002","0214","0000","659","519","140","57","716","1653","0","43.32","31.4"
"67","000","00","002","0214","0107","379","305","74","29","408","925","0","44.11","32.97"
"67","000","00","002","0214","0108","280","214","66","28","308","728","0","42.31","29.4"
"67","000","00","002","0226","0000","744","565","179","73","817","1454","0","56.19","38.86"
"67","000","00","002","0226","0087","347","270","77","30","377","636","0","59.28","42.45"
"67","000","00","002","0226","0088","137","93","44","9","146","321","0","45.48","28.97"
"67","000","00","002","0226","0089","260","202","58","34","294","497","0","59.15","40.64"
"67","000","00","002","0227","0000","788","623","165","61","849","1607","0","52.83","38.77"
"67","000","00","002","0227","0090","400","312","88","15","415","759","0","54.68","41.11"
"67","000","00","002","0227","0091","144","125","19","18","162","341","0","47.51","36.66"
"67","000","00","002","0227","0092","244","186","58","28","272","507","0","53.65","36.69"
"67","000","00","002","0228","0000","638","478","160","59","697","1539","0","45.29","31.06"
"67","000","00","002","0228","0102","320","240","80","14","334","761","0","43.89","31.54"
"67","000","00","002","0228","0103","126","97","29","11","137","285","0","48.07","34.04"
"67","000","00","002","0228","0104","192","141","51","34","226","493","0","45.84","28.6"
"67","000","00","002","0229","0000","630","455","175","44","674","1583","0","42.58","28.74"
"67","000","00","002","0229","0100","417","289","128","40","457","847","0","53.96","34.12"
"67","000","00","002","0229","0101","213","166","47","4","217","736","0","29.48","22.55"
"67","000","00","002","0230","0000","308","250","58","34","342","1013","0","33.76","24.68"
"67","000","00","002","0230","0105","195","158","37","23","218","621","0","35.1","25.44"
"67","000","00","002","0230","0106","113","92","21","11","124","392","0","31.63","23.47"
"67","000","00","002","0231","0000","386","284","102","43","429","1120","0","38.3","25.36"
"67","000","00","002","0231","0112","259","192","67","26","285","755","0","37.75","25.43"
"67","000","00","002","0231","0113","127","92","35","17","144","365","0","39.45","25.21"
"67","000","00","002","0232","0000","360","288","72","44","404","902","0","44.79","31.93"
"67","000","00","002","0232","0109","62","49","13","18","80","214","0","37.38","22.9"
"67","000","00","002","0232","0110","167","143","24","7","174","387","0","44.96","36.95"
"67","000","00","002","0232","0111","131","96","35","19","150","301","0","49.83","31.89"
"67","000","00","002","0233","0000","546","428","118","57","603","1429","0","42.2","29.95"
"67","000","00","002","0233","0114","360","280","80","30","390","935","0","41.71","29.95"
"67","000","00","002","0233","0115","186","148","38","27","213","494","0","43.12","29.96"
"67","000","00","003","0000","0000","9309","7115","2194","945","10254","24894","28152","41.19","28.58"
"67","000","00","003","0301","0000","784","613","171","104","888","1722","0","51.57","35.6"
"67","000","00","003","0301","0030","536","414","122","86","622","1176","0","52.89","35.2"
"67","000","00","003","0301","0031","248","199","49","18","266","546","0","48.72","36.45"
"67","000","00","003","0302","0000","1403","1071","332","110","1513","2921","0","51.8","36.67"
"67","000","00","003","0302","0032","426","321","105","34","460","859","0","53.55","37.37"
"67","000","00","003","0302","0033","475","371","104","38","513","946","0","54.23","39.22"
"67","000","00","003","0302","0034","502","379","123","38","540","1116","0","48.39","33.96"
"67","000","00","003","0303","0000","463","367","96","33","496","1397","0","35.5","26.27"
"67","000","00","003","0303","0035","463","367","96","33","496","1397","0","35.5","26.27"
"67","000","00","003","0304","0000","636","500","136","61","697","1627","0","42.84","30.73"
"67","000","00","003","0304","0036","259","202","57","17","276","756","0","36.51","26.72"
"67","000","00","003","0304","0037","377","298","79","44","421","871","0","48.34","34.21"
"67","000","00","003","0305","0000","401","304","97","38","439","897","0","48.94","33.89"
"67","000","00","003","0305","0038","401","304","97","38","439","897","0","48.94","33.89"
"67","000","00","003","0306","0000","441","339","102","50","491","1356","0","36.21","25.0"
"67","000","00","003","0306","0039","224","171","53","35","259","784","0","33.04","21.81"
"67","000","00","003","0306","0040","217","168","49","15","232","572","0","40.56","29.37"
"67","000","00","003","0307","0000","126","100","26","9","135","457","0","29.54","21.88"
"67","000","00","003","0307","0041","126","100","26","9","135","457","0","29.54","21.88"
"67","000","00","003","0308","0000","182","146","36","15","197","600","0","32.83","24.33"
"67","000","00","003","0308","0042","182","146","36","15","197","600","0","32.83","24.33"
"67","000","00","003","0309","0000","100","87","13","7","107","375","0","28.53","23.2"
"67","000","00","003","0309","0043","100","87","13","7","107","375","0","28.53","23.2"
"67","000","00","003","0310","0000","112","88","24","10","122","508","0","24.02","17.32"
"67","000","00","003","0310","0044","112","88","24","10","122","508","0","24.02","17.32"
"67","000","00","003","0311","0000","359","271","88","32","391","1305","0","29.96","20.77"
"67","000","00","003","0311","0047","224","167","57","14","238","799","0","29.79","20.9"
"67","000","00","003","0311","0048","135","104","31","18","153","506","0","30.24","20.55"
"67","000","00","003","0312","0000","260","189","71","26","286","1022","0","27.98","18.49"
"67","000","00","003","0312","0045","163","114","49","13","176","631","0","27.89","18.07"
"67","000","00","003","0312","0046","97","75","22","13","110","391","0","28.13","19.18"
"67","000","00","003","0314","0000","459","346","113","26","485","1443","0","33.61","23.98"
"67","000","00","003","0314","0051","224","171","53","11","235","744","0","31.59","22.98"
"67","000","00","003","0314","0052","235","175","60","15","250","699","0","35.77","25.04"
"67","000","00","003","0318","0000","332","253","79","47","379","884","0","42.87","28.62"
"67","000","00","003","0318","0055","332","253","79","47","379","884","0","42.87","28.62"
"67","000","00","003","0319","0000","184","151","33","9","193","740","0","26.08","20.41"
"67","000","00","003","0319","0056","184","151","33","9","193","740","0","26.08","20.41"
"67","000","00","003","0320","0000","490","377","113","54","544","1334","0","40.78","28.26"
"67","000","00","003","0320","0057","490","377","113","54","544","1334","0","40.78","28.26"
"67","000","00","003","0321","0000","295","219","76","57","352","723","0","48.69","30.29"
"67","000","00","003","0321","0058","295","219","76","57","352","723","0","48.69","30.29"
"67","000","00","003","0322","0000","309","226","83","64","373","682","0","54.69","33.14"
"67","000","00","003","0322","0059","309","226","83","64","373","682","0","54.69","33.14"
"67","000","00","003","0325","0000","785","594","191","60","845","2011","0","42.02","29.54"
"67","000","00","003","0325","0049","299","225","74","29","328","832","0","39.42","27.04"
"67","000","00","003","0325","0050","486","369","117","31","517","1179","0","43.85","31.3"
"67","000","00","003","0326","0000","605","454","151","67","672","1492","0","45.04","30.43"
"67","000","00","003","0326","0053","200","149","51","14","214","633","0","33.81","23.54"
"67","000","00","003","0326","0054","405","305","100","53","458","859","0","53.32","35.51"
"67","000","00","003","0327","0000","583","420","163","66","649","1398","0","46.42","30.04"
"67","000","00","003","0327","0060","391","278","113","47","438","855","0","51.23","32.51"
"67","000","00","003","0327","0061","192","142","50","19","211","543","0","38.86","26.15"
"67","000","00","004","0000","0000","8116","6416","1700","880","8996","18804","21212","47.84","34.12"
"67","000","00","004","0401","0000","830","629","201","59","889","1791","0","49.64","35.12"
"67","000","00","004","0401","0165","514","400","114","45","559","1166","0","47.94","34.31"
"67","000","00","004","0401","0166","316","229","87","14","330","625","0","52.8","36.64"
"67","000","00","004","0402","0000","695","559","136","42","737","1572","0","46.88","35.56"
"67","000","00","004","0402","0167","282","225","57","24","306","738","0","41.46","30.49"
"67","000","00","004","0402","0168","413","334","79","18","431","834","0","51.68","40.05"
"67","000","00","004","0403","0000","456","332","124","39","495","1104","0","44.84","30.07"
"67","000","00","004","0403","0169","456","332","124","39","495","1104","0","44.84","30.07"
"67","000","00","004","0404","0000","1209","966","243","140","1349","2735","0","49.32","35.32"
"67","000","00","004","0404","0170","394","311","83","21","415","1015","0","40.89","30.64"
"67","000","00","004","0404","0171","815","655","160","119","934","1720","0","54.3","38.08"
"67","000","00","004","0405","0000","591","476","115","64","655","1391","0","47.09","34.22"
"67","000","00","004","0405","0172","591","476","115","64","655","1391","0","47.09","34.22"
"67","000","00","004","0406","0000","281","232","49","27","308","743","0","41.45","31.22"
"67","000","00","004","0406","0173","177","145","32","8","185","425","0","43.53","34.12"
"67","000","00","004","0406","0174","104","87","17","19","123","318","0","38.68","27.36"
"67","000","00","004","0407","0000","643","506","137","73","716","1483","0","48.28","34.12"
"67","000","00","004","0407","0175","332","254","78","40","372","753","0","49.4","33.73"
"67","000","00","004","0407","0176","311","252","59","33","344","730","0","47.12","34.52"
"67","000","00","004","0408","0000","830","654","176","105","935","1809","0","51.69","36.15"
"67","000","00","004","0408","0177","313","247","66","36","349","725","0","48.14","34.07"
"67","000","00","004","0408","0178","377","303","74","39","416","787","0","52.86","38.5"
"67","000","00","004","0408","0179","140","104","36","30","170","297","0","57.24","35.02"
"67","000","00","004","0409","0000","631","517","114","95","726","1313","0","55.29","39.38"
"67","000","00","004","0409","0180","329","273","56","39","368","673","0","54.68","40.56"
"67","000","00","004","0409","0181","302","244","58","56","358","640","0","55.94","38.13"
"67","000","00","004","0410","0000","255","192","63","26","281","660","0","42.58","29.09"
"67","000","00","004","0410","0182","255","192","63","26","281","660","0","42.58","29.09"
"67","000","00","004","0411","0000","551","446","105","46","597","1414","0","42.22","31.54"
"67","000","00","004","0411","0183","465","376","89","42","507","1212","0","41.83","31.02"
"67","000","00","004","0411","0184","86","70","16","4","90","202","0","44.55","34.65"
"67","000","00","004","0412","0000","495","395","100","77","572","1207","0","47.39","32.73"
"67","000","00","004","0412","0185","428","340","88","75","503","1049","0","47.95","32.41"
"67","000","00","004","0412","0186","67","55","12","2","69","158","0","43.67","34.81"
"67","000","00","004","0413","0000","649","512","137","87","736","1582","0","46.52","32.36"
"67","000","00","004","0413","0187","400","307","93","64","464","921","0","50.38","33.33"
"67","000","00","004","0413","0188","188","155","33","19","207","504","0","41.07","30.75"
"67","000","00","004","0413","0189","61","50","11","4","65","157","0","41.4","31.85"
"67","000","00","005","0000","0000","8173","6384","1789","1083","9256","20841","23424","44.41","30.63"
"67","000","00","005","0501","0000","764","618","146","86","850","1641","0","51.8","37.66"
"67","000","00","005","0501","0001","361","288","73","65","426","743","0","57.34","38.76"
"67","000","00","005","0501","0002","403","330","73","21","424","898","0","47.22","36.75"
"67","000","00","005","0502","0000","526","397","129","109","635","1320","0","48.11","30.08"
"67","000","00","005","0502","0003","313","234","79","51","364","786","0","46.31","29.77"
"67","000","00","005","0502","0004","213","163","50","58","271","534","0","50.75","30.52"
"67","000","00","005","0503","0000","545","409","136","89","634","1266","0","50.08","32.31"
"67","000","00","005","0503","0005","458","354","104","70","528","1034","0","51.06","34.24"
"67","000","00","005","0503","0006","87","55","32","19","106","232","0","45.69","23.71"
"67","000","00","005","0504","0000","534","417","117","66","600","1316","0","45.59","31.69"
"67","000","00","005","0504","0007","192","150","42","41","233","479","0","48.64","31.32"
"67","000","00","005","0504","0008","342","267","75","25","367","837","0","43.85","31.9"
"67","000","00","005","0510","0000","509","412","97","46","555","1399","0","39.67","29.45"
"67","000","00","005","0510","0021","289","234","55","13","302","958","0","31.52","24.43"
"67","000","00","005","0510","0022","220","178","42","33","253","441","0","57.37","40.36"
"67","000","00","005","0511","0000","736","580","156","141","877","1673","0","52.42","34.67"
"67","000","00","005","0511","0023","295","226","69","63","358","677","0","52.88","33.38"
"67","000","00","005","0511","0024","441","354","87","78","519","996","0","52.11","35.54"
"67","000","00","005","0512","0000","491","374","117","31","522","1255","0","41.59","29.8"
"67","000","00","005","0512","0025","491","374","117","31","522","1255","0","41.59","29.8"
"67","000","00","005","0513","0000","453","358","95","24","477","1231","0","38.75","29.08"
"67","000","00","005","0513","0026","268","213","55","15","283","678","0","41.74","31.42"
"67","000","00","005","0513","0027","185","145","40","9","194","553","0","35.08","26.22"
"67","000","00","005","0514","0000","689","540","149","42","731","1805","0","40.5","29.92"
"67","000","00","005","0514","0028","189","148","41","14","203","616","0","32.95","24.03"
"67","000","00","005","0514","0029","500","392","108","28","528","1189","0","44.41","32.97"
"67","000","00","005","0518","0000","581","449","132","105","686","1475","0","46.51","30.44"
"67","000","00","005","0518","0013","143","116","27","29","172","371","0","46.36","31.27"
"67","000","00","005","0518","0014","275","205","70","49","324","676","0","47.93","30.33"
"67","000","00","005","0518","0015","163","128","35","27","190","428","0","44.39","29.91"
"67","000","00","005","0519","0000","361","261","100","63","424","1002","0","42.32","26.05"
"67","000","00","005","0519","0016","181","138","43","12","193","547","0","35.28","25.23"
"67","000","00","005","0519","0017","180","123","57","51","231","455","0","50.77","27.03"
"67","000","00","005","0522","0000","703","553","150","133","836","2003","0","41.74","27.61"
"67","000","00","005","0522","0018","330","245","85","70","400","984","0","40.65","24.9"
"67","000","00","005","0522","0019","182","143","39","31","213","483","0","44.1","29.61"
"67","000","00","005","0522","0020","191","165","26","32","223","536","0","41.6","30.78"
"67","000","00","005","0523","0000","743","587","156","56","799","2242","0","35.64","26.18"
"67","000","00","005","0523","0009","382","287","95","33","415","1085","0","38.25","26.45"
"67","000","00","005","0523","0010","361","300","61","23","384","1157","0","33.19","25.93"
"67","000","00","005","0524","0000","538","429","109","92","630","1213","0","51.94","35.37"
"67","000","00","005","0524","0011","324","269","55","60","384","755","0","50.86","35.63"
"67","000","00","005","0524","0012","214","160","54","32","246","458","0","53.71","34.93"
"67","000","00","006","0000","0000","5978","4639","1339","743","6721","18471","20870","36.39","25.12"
"67","000","00","006","0601","0000","559","436","123","62","621","1401","0","44.33","31.12"
"67","000","00","006","0601","0062","559","436","123","62","621","1401","0","44.33","31.12"
"67","000","00","006","0602","0000","896","696","200","92","988","2488","0","39.71","27.97"
"67","000","00","006","0602","0063","433","354","79","29","462","1185","0","38.99","29.87"
"67","000","00","006","0602","0064","463","342","121","63","526","1303","0","40.37","26.25"
"67","000","00","006","0603","0000","495","384","111","66","561","1453","0","38.61","26.43"
"67","000","00","006","0603","0065","258","199","59","32","290","732","0","39.62","27.19"
"67","000","00","006","0603","0066","237","185","52","34","271","721","0","37.59","25.66"
"67","000","00","006","0604","0000","339","265","74","23","362","943","0","38.39","28.1"
"67","000","00","006","0604","0068","339","265","74","23","362","943","0","38.39","28.1"
"67","000","00","006","0605","0000","348","256","92","46","394","1104","0","35.69","23.19"
"67","000","00","006","0605","0067","348","256","92","46","394","1104","0","35.69","23.19"
"67","000","00","006","0606","0000","356","293","63","73","429","1249","0","34.35","23.46"
"67","000","00","006","0606","0069","135","115","20","4","139","653","0","21.29","17.61"
"67","000","00","006","0606","0070","221","178","43","69","290","596","0","48.66","29.87"
"67","000","00","006","0607","0000","326","241","85","65","391","878","0","44.53","27.45"
"67","000","00","006","0607","0071","326","241","85","65","391","878","0","44.53","27.45"
"67","000","00","006","0608","0000","93","72","21","2","95","425","0","22.35","16.94"
"67","000","00","006","0608","0075","93","72","21","2","95","425","0","22.35","16.94"
"67","000","00","006","0609","0000","127","105","22","17","144","394","0","36.55","26.65"
"67","000","00","006","0609","0076","127","105","22","17","144","394","0","36.55","26.65"
"67","000","00","006","0610","0000","159","123","36","26","185","373","0","49.6","32.98"
"67","000","00","006","0610","0077","159","123","36","26","185","373","0","49.6","32.98"
"67","000","00","006","0611","0000","545","430","115","40","585","2144","0","27.29","20.06"
"67","000","00","006","0611","0078","356","281","75","33","389","1257","0","30.95","22.35"
"67","000","00","006","0611","0079","189","149","40","7","196","887","0","22.1","16.8"
"67","000","00","006","0612","0000","147","119","28","12","159","658","0","24.16","18.09"
"67","000","00","006","0612","0080","147","119","28","12","159","658","0","24.16","18.09"
"67","000","00","006","0613","0000","281","212","69","26","307","1101","0","27.88","19.26"
"67","000","00","006","0613","0081","281","212","69","26","307","1101","0","27.88","19.26"
"67","000","00","006","0614","0000","241","182","59","18","259","1057","0","24.5","17.22"
"67","000","00","006","0614","0082","241","182","59","18","259","1057","0","24.5","17.22"
"67","000","00","006","0615","0000","367","282","85","53","420","909","0","46.2","31.02"
"67","000","00","006","0615","0083","260","204","56","43","303","639","0","47.42","31.92"
"67","000","00","006","0615","0084","107","78","29","10","117","270","0","43.33","28.89"
"67","000","00","006","0616","0000","699","543","156","122","821","1894","0","43.35","28.67"
"67","000","00","006","0616","0072","261","191","70","58","319","771","0","41.37","24.77"
"67","000","00","006","0616","0073","183","145","38","26","209","483","0","43.27","30.02"
"67","000","00","006","0616","0074","255","207","48","38","293","640","0","45.78","32.34"
"67","000","00","007","0000","0000","16730","12768","3962","1110","17840","37963","44306","46.99","33.63"
"67","000","00","007","0703","0000","1345","1016","329","96","1441","2587","0","55.7","39.27"
"67","000","00","007","0703","0385","648","490","158","53","701","1262","0","55.55","38.83"
"67","000","00","007","0703","0386","697","526","171","43","740","1325","0","55.85","39.7"
"67","000","00","007","0704","0000","1158","878","280","52","1210","2505","0","48.3","35.05"
"67","000","00","007","0704","0387","624","483","141","31","655","1384","0","47.33","34.9"
"67","000","00","007","0704","0388","534","395","139","21","555","1121","0","49.51","35.24"
"67","000","00","007","0705","0000","994","738","256","52","1046","2120","0","49.34","34.81"
"67","000","00","007","0705","0383","257","174","83","15","272","523","0","52.01","33.27"
"67","000","00","007","0705","0384","737","564","173","37","774","1597","0","48.47","35.32"
"67","000","00","007","0706","0000","878","642","236","51","929","1975","0","47.04","32.51"
"67","000","00","007","0706","0389","453","328","125","15","468","1021","0","45.84","32.13"
"67","000","00","007","0706","0390","425","314","111","36","461","954","0","48.32","32.91"
"67","000","00","007","0707","0000","600","442","158","32","632","1513","0","41.77","29.21"
"67","000","00","007","0707","0391","600","442","158","32","632","1513","0","41.77","29.21"
"67","000","00","007","0709","0000","1518","1200","318","101","1619","3530","0","45.86","33.99"
"67","000","00","007","0709","0392","692","536","156","41","733","1726","0","42.47","31.05"
"67","000","00","007","0709","0393","826","664","162","60","886","1804","0","49.11","36.81"
"67","000","00","007","0710","0000","468","338","130","26","494","1106","0","44.67","30.56"
"67","000","00","007","0710","0394","468","338","130","26","494","1106","0","44.67","30.56"
"67","000","00","007","0711","0000","1291","988","303","93","1384","2805","0","49.34","35.22"
"67","000","00","007","0711","0395","683","520","163","44","727","1503","0","48.37","34.6"
"67","000","00","007","0711","0396","608","468","140","49","657","1302","0","50.46","35.94"
"67","000","00","007","0714","0000","955","741","214","54","1009","2330","0","43.3","31.8"
"67","000","00","007","0714","0399","676","519","157","39","715","1612","0","44.35","32.2"
"67","000","00","007","0714","0400","279","222","57","15","294","718","0","40.95","30.92"
"67","000","00","007","0715","0000","639","496","143","22","661","1656","0","39.92","29.95"
"67","000","00","007","0715","0401","639","496","143","22","661","1656","0","39.92","29.95"
"67","000","00","007","0717","0000","928","732","196","97","1025","2332","0","43.95","31.39"
"67","000","00","007","0717","0402","593","458","135","69","662","1355","0","48.86","33.8"
"67","000","00","007","0717","0403","335","274","61","28","363","977","0","37.15","28.05"
"67","000","00","007","0719","0000","833","635","198","58","891","2105","0","42.33","30.17"
"67","000","00","007","0719","0404","402","305","97","33","435","1012","0","42.98","30.14"
"67","000","00","007","0719","0405","303","230","73","21","324","626","0","51.76","36.74"
"67","000","00","007","0719","0406","128","100","28","4","132","467","0","28.27","21.41"
"67","000","00","007","0721","0000","520","394","126","19","539","1260","0","42.78","31.27"
"67","000","00","007","0721","0407","520","394","126","19","539","1260","0","42.78","31.27"
"67","000","00","007","0722","0000","514","396","118","41","555","1111","0","49.95","35.64"
"67","000","00","007","0722","0408","514","396","118","41","555","1111","0","49.95","35.64"
"67","000","00","007","0724","0000","634","474","160","54","688","1348","0","51.04","35.16"
"67","000","00","007","0724","0409","269","207","62","16","285","550","0","51.82","37.64"
"67","000","00","007","0724","0410","365","267","98","38","403","798","0","50.5","33.46"
"67","000","00","007","0728","0000","364","286","78","13","377","941","0","40.06","30.39"
"67","000","00","007","0728","0413","364","286","78","13","377","941","0","40.06","30.39"
"67","000","00","007","0730","0000","880","665","215","84","964","1865","0","51.69","35.66"
"67","000","00","007","0730","0381","549","419","130","47","596","1205","0","49.46","34.77"
"67","000","00","007","0730","0382","331","246","85","37","368","660","0","55.76","37.27"
"67","000","00","007","0731","0000","737","583","154","86","823","1682","0","48.93","34.66"
"67","000","00","007","0731","0411","432","343","89","75","507","852","0","59.51","40.26"
"67","000","00","007","0731","0412","305","240","65","11","316","830","0","38.07","28.92"
"67","000","00","007","0732","0000","775","590","185","42","817","1770","0","46.16","33.33"
"67","000","00","007","0732","0414","525","400","125","33","558","1158","0","48.19","34.54"
"67","000","00","007","0732","0415","250","190","60","9","259","612","0","42.32","31.05"
"67","000","00","007","0733","0000","699","534","165","37","736","1422","0","51.76","37.55"
"67","000","00","007","0733","0397","285","223","62","14","299","645","0","46.36","34.57"
"67","000","00","007","0733","0398","414","311","103","23","437","777","0","56.24","40.03"
"67","000","00","008","0000","0000","8561","6734","1827","882","9443","20947","23938","45.08","32.15"
"67","000","00","008","0801","0000","571","452","119","46","617","1558","0","39.6","29.01"
"67","000","00","008","0801","0343","571","452","119","46","617","1558","0","39.6","29.01"
"67","000","00","008","0802","0000","758","586","172","85","843","2005","0","42.04","29.23"
"67","000","00","008","0802","0344","394","298","96","27","421","1112","0","37.86","26.8"
"67","000","00","008","0802","0345","364","288","76","58","422","893","0","47.26","32.25"
"67","000","00","008","0803","0000","589","464","125","49","638","1623","0","39.31","28.59"
"67","000","00","008","0803","0346","589","464","125","49","638","1623","0","39.31","28.59"
"67","000","00","008","0804","0000","676","529","147","86","762","1568","0","48.6","33.74"
"67","000","00","008","0804","0347","676","529","147","86","762","1568","0","48.6","33.74"
"67","000","00","008","0805","0000","832","674","158","68","900","1938","0","46.44","34.78"
"67","000","00","008","0805","0348","455","356","99","50","505","985","0","51.27","36.14"
"67","000","00","008","0805","0349","377","318","59","18","395","953","0","41.45","33.37"
"67","000","00","008","0806","0000","955","739","216","96","1051","2108","0","49.86","35.06"
"67","000","00","008","0806","0350","427","335","92","29","456","1031","0","44.23","32.49"
"67","000","00","008","0806","0351","528","404","124","67","595","1077","0","55.25","37.51"
"67","000","00","008","0811","0000","823","667","156","91","914","1894","0","48.26","35.22"
"67","000","00","008","0811","0356","428","346","82","61","489","959","0","50.99","36.08"
"67","000","00","008","0811","0357","395","321","74","30","425","935","0","45.45","34.33"
"67","000","00","008","0812","0000","404","319","85","43","447","893","0","50.06","35.72"
"67","000","00","008","0812","0358","404","319","85","43","447","893","0","50.06","35.72"
"67","000","00","008","0813","0000","590","476","114","77","667","1293","0","51.59","36.81"
"67","000","00","008","0813","0359","590","476","114","77","667","1293","0","51.59","36.81"
"67","000","00","008","0816","0000","936","737","199","65","1001","2255","0","44.39","32.68"
"67","000","00","008","0816","0354","509","398","111","45","554","1164","0","47.59","34.19"
"67","000","00","008","0816","0355","427","339","88","20","447","1091","0","40.97","31.07"
"67","000","00","008","0817","0000","563","434","129","56","619","1557","0","39.76","27.87"
"67","000","00","008","0817","0352","245","182","63","35","280","703","0","39.83","25.89"
"67","000","00","008","0817","0353","318","252","66","21","339","854","0","39.7","29.51"
"67","000","00","008","0818","0000","864","657","207","120","984","2255","0","43.64","29.14"
"67","000","00","008","0818","0360","524","385","139","102","626","1185","0","52.83","32.49"
"67","000","00","008","0818","0361","340","272","68","18","358","1070","0","33.46","25.42"
"67","000","00","009","0000","0000","8208","6274","1934","904","9112","19144","22196","47.6","32.77"
"67","000","00","009","0901","0000","1298","1012","286","121","1419","2908","0","48.8","34.8"
"67","000","00","009","0901","0362","411","309","102","53","464","819","0","56.65","37.73"
"67","000","00","009","0901","0363","293","227","66","21","314","645","0","48.68","35.19"
"67","000","00","009","0901","0364","594","476","118","47","641","1444","0","44.39","32.96"
"67","000","00","009","0902","0000","1005","786","219","104","1109","2725","0","40.7","28.84"
"67","000","00","009","0902","0365","569","441","128","59","628","1554","0","40.41","28.38"
"67","000","00","009","0902","0366","436","345","91","45","481","1171","0","41.08","29.46"
"67","000","00","009","0903","0000","581","437","144","66","647","1351","0","47.89","32.35"
"67","000","00","009","0903","0367","581","437","144","66","647","1351","0","47.89","32.35"
"67","000","00","009","0905","0000","769","587","182","128","897","1929","0","46.5","30.43"
"67","000","00","009","0905","0368","397","290","107","68","465","1010","0","46.04","28.71"
"67","000","00","009","0905","0369","372","297","75","60","432","919","0","47.01","32.32"
"67","000","00","009","0906","0000","1524","1163","361","182","1706","3360","0","50.77","34.61"
"67","000","00","009","0906","0370","582","443","139","68","650","1369","0","47.48","32.36"
"67","000","00","009","0906","0371","443","347","96","57","500","976","0","51.23","35.55"
"67","000","00","009","0906","0372","499","373","126","57","556","1015","0","54.78","36.75"
"67","000","00","009","0907","0000","908","682","226","84","992","2115","0","46.9","32.25"
"67","000","00","009","0907","0373","482","365","117","30","512","1176","0","43.54","31.04"
"67","000","00","009","0907","0374","426","317","109","54","480","939","0","51.12","33.76"
"67","000","00","009","0908","0000","739","560","179","87","826","1593","0","51.85","35.15"
"67","000","00","009","0908","0375","324","236","88","45","369","712","0","51.83","33.15"
"67","000","00","009","0908","0376","415","324","91","42","457","881","0","51.87","36.78"
"67","000","00","009","0909","0000","632","486","146","58","690","1184","0","58.28","41.05"
"67","000","00","009","0909","0377","632","486","146","58","690","1184","0","58.28","41.05"
"67","000","00","009","0910","0000","328","237","91","34","362","599","0","60.43","39.57"
"67","000","00","009","0910","0378","328","237","91","34","362","599","0","60.43","39.57"
"67","000","00","009","0911","0000","209","164","45","11","220","759","0","28.99","21.61"
"67","000","00","009","0911","0379","209","164","45","11","220","759","0","28.99","21.61"
"67","000","00","009","0912","0000","215","160","55","29","244","621","0","39.29","25.76"
"67","000","00","009","0912","0380","215","160","55","29","244","621","0","39.29","25.76"
"67","000","00","010","0000","0000","8062","6127","1935","681","8743","18675","21329","46.82","32.81"
"67","000","00","010","1001","0000","882","673","209","58","940","2069","0","45.43","32.53"
"67","000","00","010","1001","0416","453","345","108","13","466","1104","0","42.21","31.25"
"67","000","00","010","1001","0417","429","328","101","45","474","965","0","49.12","33.99"
"67","000","00","010","1002","0000","1450","1105","345","131","1581","3055","0","51.75","36.17"
"67","000","00","010","1002","0418","636","498","138","41","677","1402","0","48.29","35.52"
"67","000","00","010","1002","0419","814","607","207","90","904","1653","0","54.69","36.72"
"67","000","00","010","1005","0000","104","84","20","5","109","402","0","27.11","20.9"
"67","000","00","010","1005","0422","104","84","20","5","109","402","0","27.11","20.9"
"67","000","00","010","1006","0000","829","629","200","35","864","1957","0","44.15","32.14"
"67","000","00","010","1006","0423","453","344","109","8","461","982","0","46.95","35.03"
"67","000","00","010","1006","0424","376","285","91","27","403","975","0","41.33","29.23"
"67","000","00","010","1007","0000","1558","1206","352","120","1678","3375","0","49.72","35.73"
"67","000","00","010","1007","0425","359","272","87","39","398","802","0","49.63","33.92"
"67","000","00","010","1007","0426","543","424","119","51","594","1118","0","53.13","37.92"
"67","000","00","010","1007","0427","656","510","146","30","686","1455","0","47.15","35.05"
"67","000","00","010","1008","0000","556","425","131","30","586","1208","0","48.51","35.18"
"67","000","00","010","1008","0428","556","425","131","30","586","1208","0","48.51","35.18"
"67","000","00","010","1013","0000","309","250","59","17","326","873","0","37.34","28.64"
"67","000","00","010","1013","0435","309","250","59","17","326","873","0","37.34","28.64"
"67","000","00","010","1014","0000","493","358","135","65","558","1250","0","44.64","28.64"
"67","000","00","010","1014","0420","385","281","104","51","436","966","0","45.13","29.09"
"67","000","00","010","1014","0421","108","77","31","14","122","284","0","42.96","27.11"
"67","000","00","010","1015","0000","1144","846","298","142","1286","2586","0","49.73","32.71"
"67","000","00","010","1015","0431","205","156","49","34","239","501","0","47.7","31.14"
"67","000","00","010","1015","0432","342","262","80","54","396","728","0","54.4","35.99"
"67","000","00","010","1015","0433","360","258","102","16","376","842","0","44.66","30.64"
"67","000","00","010","1015","0434","237","170","67","38","275","515","0","53.4","33.01"
"67","000","00","010","1016","0000","737","551","186","78","815","1900","0","42.89","29.0"
"67","000","00","010","1016","0429","517","382","135","59","576","1293","0","44.55","29.54"
"67","000","00","010","1016","0430","220","169","51","19","239","607","0","39.37","27.84"
"67","000","00","011","0000","0000","3576","2868","708","450","4026","8654","9643","46.52","33.14"
"67","000","00","011","1101","0000","353","274","79","54","407","1021","0","39.86","26.84"
"67","000","00","011","1101","0436","272","208","64","52","324","759","0","42.69","27.4"
"67","000","00","011","1101","0437","81","66","15","2","83","262","0","31.68","25.19"
"67","000","00","011","1102","0000","196","163","33","14","210","646","0","32.51","25.23"
"67","000","00","011","1102","0438","196","163","33","14","210","646","0","32.51","25.23"
"67","000","00","011","1103","0000","513","412","101","70","583","1473","0","39.58","27.97"
"67","000","00","011","1103","0439","513","412","101","70","583","1473","0","39.58","27.97"
"67","000","00","011","1104","0000","423","352","71","68","491","915","0","53.66","38.47"
"67","000","00","011","1104","0440","423","352","71","68","491","915","0","53.66","38.47"
"67","000","00","011","1105","0000","392","302","90","36","428","779","0","54.94","38.77"
"67","000","00","011","1105","0441","392","302","90","36","428","779","0","54.94","38.77"
"67","000","00","011","1106","0000","335","258","77","53","388","637","0","60.91","40.5"
"67","000","00","011","1106","0442","335","258","77","53","388","637","0","60.91","40.5"
"67","000","00","011","1107","0000","382","289","93","35","417","993","0","41.99","29.1"
"67","000","00","011","1107","0443","382","289","93","35","417","993","0","41.99","29.1"
"67","000","00","011","1108","0000","371","307","64","38","409","766","0","53.39","40.08"
"67","000","00","011","1108","0444","371","307","64","38","409","766","0","53.39","40.08"
"67","000","00","011","1109","0000","373","318","55","37","410","841","0","48.75","37.81"
"67","000","00","011","1109","0445","373","318","55","37","410","841","0","48.75","37.81"
"67","000","00","011","1110","0000","238","193","45","45","283","583","0","48.54","33.1"
"67","000","00","011","1110","0446","238","193","45","45","283","583","0","48.54","33.1"
"67","000","00","012","0000","0000","23967","19007","4960","1833","25800","50407","59087","51.18","37.71"
"67","000","00","012","1201","0000","1153","883","270","99","1252","2220","0","56.4","39.77"
"67","000","00","012","1201","0282","703","532","171","67","770","1391","0","55.36","38.25"
"67","000","00","012","1201","0283","450","351","99","32","482","829","0","58.14","42.34"
"67","000","00","012","1202","0000","1169","936","233","39","1208","2853","0","42.34","32.81"
"67","000","00","012","1202","0284","590","465","125","20","610","1401","0","43.54","33.19"
"67","000","00","012","1202","0285","579","471","108","19","598","1452","0","41.18","32.44"
"67","000","00","012","1203","0000","2674","2121","553","240","2914","5611","0","51.93","37.8"
"67","000","00","012","1203","0286","675","527","148","58","733","1382","0","53.04","38.13"
"67","000","00","012","1203","0287","693","560","133","73","766","1463","0","52.36","38.28"
"67","000","00","012","1203","0288","570","460","110","41","611","1280","0","47.73","35.94"
"67","000","00","012","1203","0289","736","574","162","68","804","1486","0","54.1","38.63"
"67","000","00","012","1204","0000","1933","1537","396","167","2100","4204","0","49.95","36.56"
"67","000","00","012","1204","0297","656","517","139","48","704","1425","0","49.4","36.28"
"67","000","00","012","1204","0298","609","488","121","46","655","1255","0","52.19","38.88"
"67","000","00","012","1204","0299","668","532","136","73","741","1524","0","48.62","34.91"
"67","000","00","012","1205","0000","2863","2277","586","288","3151","5877","0","53.62","38.74"
"67","000","00","012","1205","0290","684","531","153","70","754","1378","0","54.72","38.53"
"67","000","00","012","1205","0291","739","578","161","60","799","1505","0","53.09","38.41"
"67","000","00","012","1205","0292","877","717","160","88","965","1860","0","51.88","38.55"
"67","000","00","012","1205","0293","563","451","112","70","633","1134","0","55.82","39.77"
"67","000","00","012","1206","0000","1950","1535","415","84","2034","4059","0","50.11","37.82"
"67","000","00","012","1206","0303","665","532","133","41","706","1381","0","51.12","38.52"
"67","000","00","012","1206","0304","636","507","129","16","652","1364","0","47.8","37.17"
"67","000","00","012","1206","0305","649","496","153","27","676","1314","0","51.45","37.75"
"67","000","00","012","1207","0000","1040","793","247","105","1145","2125","0","53.88","37.32"
"67","000","00","012","1207","0306","578","441","137","55","633","1164","0","54.38","37.89"
"67","000","00","012","1207","0307","462","352","110","50","512","961","0","53.28","36.63"
"67","000","00","012","1212","0000","969","746","223","88","1057","2209","0","47.85","33.77"
"67","000","00","012","1212","0312","662","502","160","51","713","1507","0","47.31","33.31"
"67","000","00","012","1212","0313","307","244","63","37","344","702","0","49.0","34.76"
"67","000","00","012","1219","0000","686","566","120","73","759","1513","0","50.17","37.41"
"67","000","00","012","1219","0319","686","566","120","73","759","1513","0","50.17","37.41"
"67","000","00","012","1220","0000","987","752","235","87","1074","2410","0","44.56","31.2"
"67","000","00","012","1220","0320","270","216","54","19","289","714","0","40.48","30.25"
"67","000","00","012","1220","0321","328","253","75","40","368","745","0","49.4","33.96"
"67","000","00","012","1220","0322","389","283","106","28","417","951","0","43.85","29.76"
"67","000","00","012","1222","0000","477","364","113","35","512","1072","0","47.76","33.96"
"67","000","00","012","1222","0310","319","254","65","25","344","689","0","49.93","36.87"
"67","000","00","012","1222","0311","158","110","48","10","168","383","0","43.86","28.72"
"67","000","00","012","1223","0000","2539","2047","492","182","2721","5111","0","53.24","40.05"
"67","000","00","012","1223","0294","696","545","151","64","760","1426","0","53.3","38.22"
"67","000","00","012","1223","0295","866","706","160","59","925","1779","0","52.0","39.69"
"67","000","00","012","1223","0296","977","796","181","59","1036","1906","0","54.35","41.76"
"67","000","00","012","1224","0000","988","858","130","66","1054","2137","0","49.32","40.15"
"67","000","00","012","1224","0308","538","520","18","47","585","1218","0","48.03","42.69"
"67","000","00","012","1224","0309","450","338","112","19","469","919","0","51.03","36.78"
"67","000","00","012","1225","0000","958","735","223","87","1045","1844","0","56.67","39.86"
"67","000","00","012","1225","0314","453","355","98","42","495","907","0","54.58","39.14"
"67","000","00","012","1225","0315","505","380","125","45","550","937","0","58.7","40.55"
"67","000","00","012","1226","0000","1320","1026","294","77","1397","2798","0","49.93","36.67"
"67","000","00","012","1226","0316","536","401","135","10","546","1030","0","53.01","38.93"
"67","000","00","012","1226","0317","458","358","100","45","503","981","0","51.27","36.49"
"67","000","00","012","1226","0318","326","267","59","22","348","787","0","44.22","33.93"
"67","000","00","012","1227","0000","2261","1831","430","116","2377","4364","0","54.47","41.96"
"67","000","00","012","1227","0300","768","612","156","45","813","1631","0","49.85","37.52"
"67","000","00","012","1227","0301","833","685","148","29","862","1546","0","55.76","44.31"
"67","000","00","012","1227","0302","660","534","126","42","702","1187","0","59.14","44.99"
"67","000","00","013","0000","0000","9589","7444","2145","862","10451","22567","25725","46.31","32.99"
"67","000","00","013","1301","0000","1800","1395","405","168","1968","3852","0","51.09","36.21"
"67","000","00","013","1301","0216","650","517","133","36","686","1370","0","50.07","37.74"
"67","000","00","013","1301","0217","548","402","146","54","602","1117","0","53.89","35.99"
"67","000","00","013","1301","0218","602","476","126","78","680","1365","0","49.82","34.87"
"67","000","00","013","1302","0000","980","790","190","68","1048","2235","0","46.89","35.35"
"67","000","00","013","1302","0221","453","367","86","47","500","1052","0","47.53","34.89"
"67","000","00","013","1302","0222","527","423","104","21","548","1183","0","46.32","35.76"
"67","000","00","013","1303","0000","408","316","92","24","432","1238","0","34.89","25.53"
"67","000","00","013","1303","0227","271","227","44","19","290","832","0","34.86","27.28"
"67","000","00","013","1303","0228","137","89","48","5","142","406","0","34.98","21.92"
"67","000","00","013","1304","0000","382","301","81","42","424","818","0","51.83","36.8"
"67","000","00","013","1304","0229","382","301","81","42","424","818","0","51.83","36.8"
"67","000","00","013","1305","0000","802","654","148","74","876","1900","0","46.11","34.42"
"67","000","00","013","1305","0213","290","232","58","35","325","635","0","51.18","36.54"
"67","000","00","013","1305","0214","345","288","57","21","366","822","0","44.53","35.04"
"67","000","00","013","1305","0215","167","134","33","18","185","443","0","41.76","30.25"
"67","000","00","013","1306","0000","1187","870","317","98","1285","2409","0","53.34","36.11"
"67","000","00","013","1306","0208","420","299","121","59","479","862","0","55.57","34.69"
"67","000","00","013","1306","0209","324","237","87","10","334","611","0","54.66","38.79"
"67","000","00","013","1306","0210","443","334","109","29","472","936","0","50.43","35.68"
"67","000","00","013","1307","0000","917","687","230","62","979","1935","0","50.59","35.5"
"67","000","00","013","1307","0211","470","350","120","31","501","1066","0","47.0","32.83"
"67","000","00","013","1307","0212","447","337","110","31","478","869","0","55.01","38.78"
"67","000","00","013","1308","0000","487","364","123","66","553","1241","0","44.56","29.33"
"67","000","00","013","1308","0224","487","364","123","66","553","1241","0","44.56","29.33"
"67","000","00","013","1309","0000","362","281","81","17","379","1052","0","36.03","26.71"
"67","000","00","013","1309","0230","362","281","81","17","379","1052","0","36.03","26.71"
"67","000","00","013","1310","0000","852","670","182","114","966","2116","0","45.65","31.66"
"67","000","00","013","1310","0219","642","514","128","72","714","1489","0","47.95","34.52"
"67","000","00","013","1310","0220","210","156","54","42","252","627","0","40.19","24.88"
"67","000","00","013","1311","0000","364","285","79","27","391","979","0","39.94","29.11"
"67","000","00","013","1311","0223","364","285","79","27","391","979","0","39.94","29.11"
"67","000","00","013","1312","0000","514","400","114","44","558","1369","0","40.76","29.22"
"67","000","00","013","1312","0231","216","161","55","11","227","578","0","39.27","27.85"
"67","000","00","013","1312","0232","144","105","39","23","167","430","0","38.84","24.42"
"67","000","00","013","1312","0233","154","134","20","10","164","361","0","45.43","37.12"
"67","000","00","013","1313","0000","534","431","103","58","592","1423","0","41.6","30.29"
"67","000","00","013","1313","0225","290","242","48","23","313","843","0","37.13","28.71"
"67","000","00","013","1313","0226","244","189","55","35","279","580","0","48.1","32.59"
"67","000","00","014","0000","0000","8927","7029","1898","665","9592","21564","24724","44.48","32.6"
"67","000","00","014","1401","0000","1421","1111","310","63","1484","3148","0","47.14","35.29"
"67","000","00","014","1401","0323","423","342","81","18","441","933","0","47.27","36.66"
"67","000","00","014","1401","0324","436","321","115","22","458","901","0","50.83","35.63"
"67","000","00","014","1401","0325","562","448","114","23","585","1314","0","44.52","34.09"
"67","000","00","014","1402","0000","950","740","210","66","1016","2401","0","42.32","30.82"
"67","000","00","014","1402","0329","669","537","132","53","722","1663","0","43.42","32.29"
"67","000","00","014","1402","0330","281","203","78","13","294","738","0","39.84","27.51"
"67","000","00","014","1403","0000","747","597","150","77","824","1593","0","51.73","37.48"
"67","000","00","014","1403","0331","593","483","110","52","645","1211","0","53.26","39.88"
"67","000","00","014","1403","0332","154","114","40","25","179","382","0","46.86","29.84"
"67","000","00","014","1404","0000","657","520","137","29","686","1624","0","42.24","32.02"
"67","000","00","014","1404","0333","312","246","66","14","326","786","0","41.48","31.3"
"67","000","00","014","1404","0334","345","274","71","15","360","838","0","42.96","32.7"
"67","000","00","014","1405","0000","525","409","116","41","566","1449","0","39.06","28.23"
"67","000","00","014","1405","0335","525","409","116","41","566","1449","0","39.06","28.23"
"67","000","00","014","1406","0000","535","429","106","24","559","1479","0","37.8","29.01"
"67","000","00","014","1406","0336","535","429","106","24","559","1479","0","37.8","29.01"
"67","000","00","014","1407","0000","352","287","65","68","420","763","0","55.05","37.61"
"67","000","00","014","1407","0337","352","287","65","68","420","763","0","55.05","37.61"
"67","000","00","014","1408","0000","496","386","110","24","520","1297","0","40.09","29.76"
"67","000","00","014","1408","0338","496","386","110","24","520","1297","0","40.09","29.76"
"67","000","00","014","1409","0000","563","433","130","34","597","1393","0","42.86","31.08"
"67","000","00","014","1409","0339","563","433","130","34","597","1393","0","42.86","31.08"
"67","000","00","014","1410","0000","515","404","111","35","550","1349","0","40.77","29.95"
"67","000","00","014","1410","0340","334","257","77","16","350","958","0","36.53","26.83"
"67","000","00","014","1410","0341","181","147","34","19","200","391","0","51.15","37.6"
"67","000","00","014","1411","0000","369","291","78","52","421","805","0","52.3","36.15"
"67","000","00","014","1411","0342","369","291","78","52","421","805","0","52.3","36.15"
"67","000","00","014","1412","0000","1797","1422","375","152","1949","4263","0","45.72","33.36"
"67","000","00","014","1412","0326","619","486","133","71","690","1349","0","51.15","36.03"
"67","000","00","014","1412","0327","514","398","116","45","559","1014","0","55.13","39.25"
"67","000","00","014","1412","0328","664","538","126","36","700","1900","0","36.84","28.32"
"67","000","00","015","0000","0000","7689","6088","1601","715","8404","19950","22810","42.13","30.52"
"67","000","00","015","1501","0000","446","344","102","29","475","1042","0","45.59","33.01"
"67","000","00","015","1501","0258","208","166","42","15","223","534","0","41.76","31.09"
"67","000","00","015","1501","0259","238","178","60","14","252","508","0","49.61","35.04"
"67","000","00","015","1502","0000","195","161","34","5","200","665","0","30.08","24.21"
"67","000","00","015","1502","0260","195","161","34","5","200","665","0","30.08","24.21"
"67","000","00","015","1504","0000","311","256","55","21","332","834","0","39.81","30.7"
"67","000","00","015","1504","0261","311","256","55","21","332","834","0","39.81","30.7"
"67","000","00","015","1505","0000","280","226","54","16","296","810","0","36.54","27.9"
"67","000","00","015","1505","0262","280","226","54","16","296","810","0","36.54","27.9"
"67","000","00","015","1506","0000","143","114","29","7","150","480","0","31.25","23.75"
"67","000","00","015","1506","0263","143","114","29","7","150","480","0","31.25","23.75"
"67","000","00","015","1507","0000","148","122","26","4","152","445","0","34.16","27.42"
"67","000","00","015","1507","0264","148","122","26","4","152","445","0","34.16","27.42"
"67","000","00","015","1508","0000","464","375","89","27","491","1618","0","30.35","23.18"
"67","000","00","015","1508","0266","236","192","44","9","245","838","0","29.24","22.91"
"67","000","00","015","1508","0267","228","183","45","18","246","780","0","31.54","23.46"
"67","000","00","015","1509","0000","165","133","32","17","182","350","0","52.0","38.0"
"67","000","00","015","1509","0268","165","133","32","17","182","350","0","52.0","38.0"
"67","000","00","015","1510","0000","455","349","106","62","517","907","0","57.0","38.48"
"67","000","00","015","1510","0269","455","349","106","62","517","907","0","57.0","38.48"
"67","000","00","015","1511","0000","296","239","57","16","312","780","0","40.0","30.64"
"67","000","00","015","1511","0270","296","239","57","16","312","780","0","40.0","30.64"
"67","000","00","015","1512","0000","981","798","183","72","1053","2571","0","40.96","31.04"
"67","000","00","015","1512","0271","634","518","116","40","674","1658","0","40.65","31.24"
"67","000","00","015","1512","0272","347","280","67","32","379","913","0","41.51","30.67"
"67","000","00","015","1515","0000","765","622","143","60","825","1898","0","43.47","32.77"
"67","000","00","015","1515","0273","535","428","107","54","589","1202","0","49.0","35.61"
"67","000","00","015","1515","0274","230","194","36","6","236","696","0","33.91","27.87"
"67","000","00","015","1517","0000","168","130","38","10","178","680","0","26.18","19.12"
"67","000","00","015","1517","0265","168","130","38","10","178","680","0","26.18","19.12"
"67","000","00","015","1518","0000","608","479","129","80","688","1269","0","54.22","37.75"
"67","000","00","015","1518","0275","271","210","61","32","303","647","0","46.83","32.46"
"67","000","00","015","1518","0276","337","269","68","48","385","622","0","61.9","43.25"
"67","000","00","015","1519","0000","860","674","186","107","967","1873","0","51.63","35.99"
"67","000","00","015","1519","0277","581","459","122","86","667","1175","0","56.77","39.06"
"67","000","00","015","1519","0278","279","215","64","21","300","698","0","42.98","30.8"
"67","000","00","015","1521","0000","442","340","102","66","508","983","0","51.68","34.59"
"67","000","00","015","1521","0279","442","340","102","66","508","983","0","51.68","34.59"
"67","000","00","015","1522","0000","439","323","116","38","477","1366","0","34.92","23.65"
"67","000","00","015","1522","0280","439","323","116","38","477","1366","0","34.92","23.65"
"67","000","00","015","1523","0000","523","403","120","78","601","1379","0","43.58","29.22"
"67","000","00","015","1523","0281","523","403","120","78","601","1379","0","43.58","29.22"
"67","000","00","016","0000","0000","6550","5144","1406","631","7181","17754","19691","40.45","28.97"
"67","000","00","016","1601","0000","550","420","130","70","620","1110","0","55.86","37.84"
"67","000","00","016","1601","0234","550","420","130","70","620","1110","0","55.86","37.84"
"67","000","00","016","1613","0000","286","228","58","14","300","849","0","35.34","26.86"
"67","000","00","016","1613","0250","286","228","58","14","300","849","0","35.34","26.86"
"67","000","00","016","1614","0000","225","179","46","28","253","645","0","39.22","27.75"
"67","000","00","016","1614","0251","225","179","46","28","253","645","0","39.22","27.75"
"67","000","00","016","1615","0000","393","317","76","34","427","1353","0","31.56","23.43"
"67","000","00","016","1615","0252","216","172","44","27","243","690","0","35.22","24.93"
"67","000","00","016","1615","0253","177","145","32","7","184","663","0","27.75","21.87"
"67","000","00","016","1616","0000","373","300","73","29","402","1175","0","34.21","25.53"
"67","000","00","016","1616","0254","373","300","73","29","402","1175","0","34.21","25.53"
"67","000","00","016","1617","0000","686","540","146","143","829","1898","0","43.68","28.45"
"67","000","00","016","1617","0255","245","201","44","28","273","837","0","32.62","24.01"
"67","000","00","016","1617","0256","441","339","102","115","556","1061","0","52.4","31.95"
"67","000","00","016","1618","0000","281","233","48","22","303","976","0","31.05","23.87"
"67","000","00","016","1618","0257","281","233","48","22","303","976","0","31.05","23.87"
"67","000","00","016","1619","0000","371","287","84","25","396","1223","0","32.38","23.47"
"67","000","00","016","1619","0245","204","155","49","11","215","650","0","33.08","23.85"
"67","000","00","016","1619","0246","167","132","35","14","181","573","0","31.59","23.04"
"67","000","00","016","1620","0000","1004","807","197","44","1048","2387","0","43.9","33.81"
"67","000","00","016","1620","0235","598","481","117","25","623","1418","0","43.94","33.92"
"67","000","00","016","1620","0236","406","326","80","19","425","969","0","43.86","33.64"
"67","000","00","016","1621","0000","1078","814","264","105","1183","2482","0","47.66","32.8"
"67","000","00","016","1621","0237","263","205","58","36","299","519","0","57.61","39.5"
"67","000","00","016","1621","0238","485","358","127","16","501","1106","0","45.3","32.37"
"67","000","00","016","1621","0239","225","170","55","42","267","542","0","49.26","31.37"
"67","000","00","016","1621","0240","105","81","24","11","116","315","0","36.83","25.71"
"67","000","00","016","1622","0000","692","533","159","55","747","2032","0","36.76","26.23"
"67","000","00","016","1622","0241","117","79","38","20","137","584","0","23.46","13.53"
"67","000","00","016","1622","0242","167","136","31","7","174","398","0","43.72","34.17"
"67","000","00","016","1622","0243","209","168","41","13","222","608","0","36.51","27.63"
"67","000","00","016","1622","0244","199","150","49","15","214","442","0","48.42","33.94"
"67","000","00","016","1623","0000","611","486","125","62","673","1624","0","41.44","29.93"
"67","000","00","016","1623","0247","195","155","40","9","204","617","0","33.06","25.12"
"67","000","00","016","1623","0248","228","181","47","29","257","573","0","44.85","31.59"
"67","000","00","016","1623","0249","188","150","38","24","212","434","0","48.85","34.56"
"67","000","00","017","0000","0000","3505","2791","714","286","3791","9925","11099","38.2","28.12"
"67","000","00","017","1701","0000","500","406","94","16","516","1341","0","38.48","30.28"
"67","000","00","017","1701","0196","282","227","55","5","287","742","0","38.68","30.59"
"67","000","00","017","1701","0197","218","179","39","11","229","599","0","38.23","29.88"
"67","000","00","017","1702","0000","162","128","34","13","175","473","0","37.0","27.06"
"67","000","00","017","1702","0201","162","128","34","13","175","473","0","37.0","27.06"
"67","000","00","017","1705","0000","330","271","59","21","351","838","0","41.89","32.34"
"67","000","00","017","1705","0192","145","119","26","6","151","456","0","33.11","26.1"
"67","000","00","017","1705","0193","185","152","33","15","200","382","0","52.36","39.79"
"67","000","00","017","1706","0000","263","213","50","17","280","954","0","29.35","22.33"
"67","000","00","017","1706","0202","263","213","50","17","280","954","0","29.35","22.33"
"67","000","00","017","1707","0000","369","283","86","44","413","1200","0","34.42","23.58"
"67","000","00","017","1707","0204","201","157","44","16","217","679","0","31.96","23.12"
"67","000","00","017","1707","0205","168","126","42","28","196","521","0","37.62","24.18"
"67","000","00","017","1709","0000","283","223","60","26","309","745","0","41.48","29.93"
"67","000","00","017","1709","0194","155","124","31","20","175","356","0","49.16","34.83"
"67","000","00","017","1709","0195","128","99","29","6","134","389","0","34.45","25.45"
"67","000","00","017","1711","0000","350","294","56","38","388","737","0","52.65","39.89"
"67","000","00","017","1711","0203","350","294","56","38","388","737","0","52.65","39.89"
"67","000","00","017","1713","0000","332","246","86","29","361","885","0","40.79","27.8"
"67","000","00","017","1713","0190","184","123","61","14","198","484","0","40.91","25.41"
"67","000","00","017","1713","0191","148","123","25","15","163","401","0","40.65","30.67"
"67","000","00","017","1714","0000","529","415","114","52","581","1484","0","39.15","27.96"
"67","000","00","017","1714","0198","220","174","46","23","243","594","0","40.91","29.29"
"67","000","00","017","1714","0199","219","173","46","25","244","572","0","42.66","30.24"
"67","000","00","017","1714","0200","90","68","22","4","94","318","0","29.56","21.38"
"67","000","00","017","1715","0000","387","312","75","30","417","1268","0","32.89","24.61"
"67","000","00","017","1715","0206","191","150","41","16","207","632","0","32.75","23.73"
"67","000","00","017","1715","0207","196","162","34","14","210","636","0","33.02","25.47"
"67","000","00","018","0000","0000","17848","13968","3880","1819","19667","37296","43516","52.73","37.45"
"67","000","00","018","1801","0000","1704","1333","371","179","1883","3165","0","59.49","42.12"
"67","000","00","018","1801","0581","414","340","74","38","452","746","0","60.59","45.58"
"67","000","00","018","1801","0582","607","458","149","43","650","1102","0","58.98","41.56"
"67","000","00","018","1801","0583","191","154","37","23","214","370","0","57.84","41.62"
"67","000","00","018","1801","0584","492","381","111","75","567","947","0","59.87","40.23"
"67","000","00","018","1802","0000","1949","1540","409","216","2165","3951","0","54.8","38.98"
"67","000","00","018","1802","0585","546","436","110","64","610","1154","0","52.86","37.78"
"67","000","00","018","1802","0586","544","424","120","63","607","1082","0","56.1","39.19"
"67","000","00","018","1802","0587","548","432","116","63","611","1075","0","56.84","40.19"
"67","000","00","018","1802","0588","311","248","63","26","337","640","0","52.66","38.75"
"67","000","00","018","1803","0000","1209","947","262","105","1314","2757","0","47.66","34.35"
"67","000","00","018","1803","0589","180","138","42","19","199","410","0","48.54","33.66"
"67","000","00","018","1803","0590","242","196","46","28","270","533","0","50.66","36.77"
"67","000","00","018","1803","0591","401","310","91","26","427","836","0","51.08","37.08"
"67","000","00","018","1803","0592","386","303","83","32","418","978","0","42.74","30.98"
"67","000","00","018","1804","0000","2075","1621","454","182","2257","4380","0","51.53","37.01"
"67","000","00","018","1804","0593","654","497","157","50","704","1348","0","52.23","36.87"
"67","000","00","018","1804","0594","486","388","98","49","535","1015","0","52.71","38.23"
"67","000","00","018","1804","0595","531","425","106","35","566","1228","0","46.09","34.61"
"67","000","00","018","1804","0596","404","311","93","48","452","789","0","57.29","39.42"
"67","000","00","018","1809","0000","1570","1229","341","116","1686","3272","0","51.53","37.56"
"67","000","00","018","1809","0597","479","365","114","24","503","1022","0","49.22","35.71"
"67","000","00","018","1809","0598","450","365","85","27","477","1021","0","46.72","35.75"
"67","000","00","018","1809","0599","641","499","142","65","706","1229","0","57.45","40.6"
"67","000","00","018","1810","0000","929","730","199","44","973","2165","0","44.94","33.72"
"67","000","00","018","1810","0600","553","435","118","22","575","1153","0","49.87","37.73"
"67","000","00","018","1810","0601","376","295","81","22","398","1012","0","39.33","29.15"
"67","000","00","018","1811","0000","717","576","141","76","793","1458","0","54.39","39.51"
"67","000","00","018","1811","0602","717","576","141","76","793","1458","0","54.39","39.51"
"67","000","00","018","1812","0000","1620","1276","344","141","1761","3220","0","54.69","39.63"
"67","000","00","018","1812","0603","840","657","183","68","908","1645","0","55.2","39.94"
"67","000","00","018","1812","0604","524","415","109","62","586","1016","0","57.68","40.85"
"67","000","00","018","1812","0605","256","204","52","11","267","559","0","47.76","36.49"
"67","000","00","018","1813","0000","1491","1182","309","102","1593","2784","0","57.22","42.46"
"67","000","00","018","1813","0606","639","503","136","37","676","1222","0","55.32","41.16"
"67","000","00","018","1813","0607","852","679","173","65","917","1562","0","58.71","43.47"
"67","000","00","018","1814","0000","879","689","190","130","1009","2007","0","50.27","34.33"
"67","000","00","018","1814","0608","410","327","83","38","448","994","0","45.07","32.9"
"67","000","00","018","1814","0609","469","362","107","92","561","1013","0","55.38","35.74"
"67","000","00","018","1815","0000","1053","782","271","126","1179","2218","0","53.16","35.26"
"67","000","00","018","1815","0610","596","446","150","75","671","1197","0","56.06","37.26"
"67","000","00","018","1815","0611","457","336","121","51","508","1021","0","49.76","32.91"
"67","000","00","018","1816","0000","565","457","108","81","646","1428","0","45.24","32.0"
"67","000","00","018","1816","0612","565","457","108","81","646","1428","0","45.24","32.0"
"67","000","00","018","1817","0000","182","138","44","33","215","456","0","47.15","30.26"
"67","000","00","018","1817","0613","182","138","44","33","215","456","0","47.15","30.26"
"67","000","00","018","1818","0000","1051","816","235","137","1188","2134","0","55.67","38.24"
"67","000","00","018","1818","0614","517","399","118","59","576","1037","0","55.54","38.48"
"67","000","00","018","1818","0615","534","417","117","78","612","1097","0","55.79","38.01"
"67","000","00","018","1819","0000","439","330","109","58","497","902","0","55.1","36.59"
"67","000","00","018","1819","0616","439","330","109","58","497","902","0","55.1","36.59"
"67","000","00","018","1820","0000","415","322","93","93","508","999","0","50.85","32.23"
"67","000","00","018","1820","0617","415","322","93","93","508","999","0","50.85","32.23"
"67","000","00","019","0000","0000","18466","14134","4332","1553","20019","39950","48870","50.11","35.38"
"67","000","00","019","1901","0000","461","355","106","31","492","1132","0","43.46","31.36"
"67","000","00","019","1901","0492","461","355","106","31","492","1132","0","43.46","31.36"
"67","000","00","019","1902","0000","1794","1388","406","161","1955","3935","0","49.68","35.27"
"67","000","00","019","1902","0493","841","642","199","66","907","1845","0","49.16","34.8"
"67","000","00","019","1902","0494","953","746","207","95","1048","2090","0","50.14","35.69"
"67","000","00","019","1903","0000","2604","2036","568","219","2823","5301","0","53.25","38.41"
"67","000","00","019","1903","0495","791","645","146","80","871","1582","0","55.06","40.77"
"67","000","00","019","1903","0496","963","734","229","78","1041","1901","0","54.76","38.61"
"67","000","00","019","1903","0497","850","657","193","61","911","1818","0","50.11","36.14"
"67","000","00","019","1904","0000","1339","1026","313","113","1452","2700","0","53.78","38.0"
"67","000","00","019","1904","0498","787","604","183","71","858","1639","0","52.35","36.85"
"67","000","00","019","1904","0499","552","422","130","42","594","1061","0","55.98","39.77"
"67","000","00","019","1905","0000","875","685","190","105","980","1786","0","54.87","38.35"
"67","000","00","019","1905","0500","875","685","190","105","980","1786","0","54.87","38.35"
"67","000","00","019","1908","0000","715","541","174","72","787","1581","0","49.78","34.22"
"67","000","00","019","1908","0502","715","541","174","72","787","1581","0","49.78","34.22"
"67","000","00","019","1909","0000","559","405","154","94","653","1240","0","52.66","32.66"
"67","000","00","019","1909","0503","559","405","154","94","653","1240","0","52.66","32.66"
"67","000","00","019","1910","0000","624","458","166","26","650","1743","0","37.29","26.28"
"67","000","00","019","1910","0504","624","458","166","26","650","1743","0","37.29","26.28"
"67","000","00","019","1911","0000","642","479","163","51","693","1246","0","55.62","38.44"
"67","000","00","019","1911","0505","642","479","163","51","693","1246","0","55.62","38.44"
"67","000","00","019","1912","0000","840","626","214","40","880","1899","0","46.34","32.96"
"67","000","00","019","1912","0506","431","314","117","27","458","961","0","47.66","32.67"
"67","000","00","019","1912","0507","409","312","97","13","422","938","0","44.99","33.26"
"67","000","00","019","1913","0000","326","246","80","17","343","722","0","47.51","34.07"
"67","000","00","019","1913","0508","326","246","80","17","343","722","0","47.51","34.07"
"67","000","00","019","1914","0000","428","339","89","21","449","1062","0","42.28","31.92"
"67","000","00","019","1914","0509","428","339","89","21","449","1062","0","42.28","31.92"
"67","000","00","019","1915","0000","770","608","162","91","861","1715","0","50.2","35.45"
"67","000","00","019","1915","0510","770","608","162","91","861","1715","0","50.2","35.45"
"67","000","00","019","1918","0000","753","559","194","63","816","1574","0","51.84","35.51"
"67","000","00","019","1918","0513","753","559","194","63","816","1574","0","51.84","35.51"
"67","000","00","019","1919","0000","622","487","135","70","692","1535","0","45.08","31.73"
"67","000","00","019","1919","0514","622","487","135","70","692","1535","0","45.08","31.73"
"67","000","00","019","1920","0000","517","378","139","61","578","1106","0","52.26","34.18"
"67","000","00","019","1920","0515","517","378","139","61","578","1106","0","52.26","34.18"
"67","000","00","019","1921","0000","1984","1506","478","168","2152","4240","0","50.75","35.52"
"67","000","00","019","1921","0516","608","457","151","40","648","1402","0","46.22","32.6"
"67","000","00","019","1921","0517","785","587","198","83","868","1458","0","59.53","40.26"
"67","000","00","019","1921","0518","591","462","129","45","636","1380","0","46.09","33.48"
"67","000","00","019","1922","0000","546","425","121","34","580","1147","0","50.57","37.05"
"67","000","00","019","1922","0501","546","425","121","34","580","1147","0","50.57","37.05"
"67","000","00","019","1923","0000","871","651","220","95","966","1985","0","48.66","32.8"
"67","000","00","019","1923","0511","483","368","115","54","537","1120","0","47.95","32.86"
"67","000","00","019","1923","0512","388","283","105","41","429","865","0","49.6","32.72"
"67","000","00","019","1924","0000","1196","936","260","21","1217","2301","0","52.89","40.68"
"67","000","00","019","1924","0519","633","488","145","9","642","1232","0","52.11","39.61"
"67","000","00","019","1924","0520","563","448","115","12","575","1069","0","53.79","41.91"
"67","000","00","020","0000","0000","14807","11296","3511","1203","16010","30386","36824","52.69","37.18"
"67","000","00","020","2001","0000","1425","1112","313","90","1515","2928","0","51.74","37.98"
"67","000","00","020","2001","0545","428","344","84","22","450","960","0","46.88","35.83"
"67","000","00","020","2001","0546","606","460","146","45","651","1118","0","58.23","41.14"
"67","000","00","020","2001","0547","391","308","83","23","414","850","0","48.71","36.24"
"67","000","00","020","2002","0000","3056","2311","745","253","3309","6063","0","54.58","38.12"
"67","000","00","020","2002","0548","597","484","113","64","661","1241","0","53.26","39.0"
"67","000","00","020","2002","0549","660","505","155","40","700","1297","0","53.97","38.94"
"67","000","00","020","2002","0550","498","418","80","43","541","962","0","56.24","43.45"
"67","000","00","020","2002","0551","640","392","248","57","697","1237","0","56.35","31.69"
"67","000","00","020","2002","0552","661","512","149","49","710","1326","0","53.54","38.61"
"67","000","00","020","2003","0000","1239","926","313","110","1349","2516","0","53.62","36.8"
"67","000","00","020","2003","0553","630","476","154","64","694","1211","0","57.31","39.31"
"67","000","00","020","2003","0554","609","450","159","46","655","1305","0","50.19","34.48"
"67","000","00","020","2004","0000","315","239","76","61","376","688","0","54.65","34.74"
"67","000","00","020","2004","0555","315","239","76","61","376","688","0","54.65","34.74"
"67","000","00","020","2005","0000","477","356","121","35","512","911","0","56.2","39.08"
"67","000","00","020","2005","0556","477","356","121","35","512","911","0","56.2","39.08"
"67","000","00","020","2006","0000","672","515","157","45","717","1525","0","47.02","33.77"
"67","000","00","020","2006","0557","672","515","157","45","717","1525","0","47.02","33.77"
"67","000","00","020","2007","0000","1430","1137","293","50","1480","3262","0","45.37","34.86"
"67","000","00","020","2007","0558","412","336","76","3","415","1091","0","38.04","30.8"
"67","000","00","020","2007","0559","542","429","113","21","563","1122","0","50.18","38.24"
"67","000","00","020","2007","0560","476","372","104","26","502","1049","0","47.86","35.46"
"67","000","00","020","2008","0000","2010","1568","442","115","2125","4457","0","47.68","35.18"
"67","000","00","020","2008","0561","624","479","145","27","651","1564","0","41.62","30.63"
"67","000","00","020","2008","0562","752","597","155","56","808","1515","0","53.33","39.41"
"67","000","00","020","2008","0563","634","492","142","32","666","1378","0","48.33","35.7"
"67","000","00","020","2009","0000","977","765","212","146","1123","1787","0","62.84","42.81"
"67","000","00","020","2009","0564","455","364","91","59","514","827","0","62.15","44.01"
"67","000","00","020","2009","0565","522","401","121","87","609","960","0","63.44","41.77"
"67","000","00","020","2010","0000","1639","1149","490","151","1790","3388","0","52.83","33.91"
"67","000","00","020","2010","0566","442","340","102","56","498","951","0","52.37","35.75"
"67","000","00","020","2010","0567","627","369","258","69","696","1264","0","55.06","29.19"
"67","000","00","020","2010","0568","570","440","130","26","596","1173","0","50.81","37.51"
"67","000","00","020","2011","0000","1567","1218","349","147","1714","2861","0","59.91","42.57"
"67","000","00","020","2011","0569","362","269","93","21","383","684","0","55.99","39.33"
"67","000","00","020","2011","0570","573","452","121","74","647","1055","0","61.33","42.84"
"67","000","00","020","2011","0571","632","497","135","52","684","1122","0","60.96","44.3"
"67","000","00","021","0000","0000","12476","9675","2801","1199","13675","26104","30522","52.39","37.06"
"67","000","00","021","2101","0000","1116","859","257","123","1239","2150","0","57.63","39.95"
"67","000","00","021","2101","0521","682","527","155","84","766","1251","0","61.23","42.13"
"67","000","00","021","2101","0522","434","332","102","39","473","899","0","52.61","36.93"
"67","000","00","021","2102","0000","990","750","240","137","1127","2054","0","54.87","36.51"
"67","000","00","021","2102","0523","520","398","122","82","602","1106","0","54.43","35.99"
"67","000","00","021","2102","0524","470","352","118","55","525","948","0","55.38","37.13"
"67","000","00","021","2103","0000","635","479","156","31","666","1442","0","46.19","33.22"
"67","000","00","021","2103","0525","635","479","156","31","666","1442","0","46.19","33.22"
"67","000","00","021","2104","0000","1006","774","232","95","1101","2186","0","50.37","35.41"
"67","000","00","021","2104","0526","598","449","149","44","642","1385","0","46.35","32.42"
"67","000","00","021","2104","0527","408","325","83","51","459","801","0","57.3","40.57"
"67","000","00","021","2106","0000","665","521","144","70","735","1517","0","48.45","34.34"
"67","000","00","021","2106","0528","302","234","68","32","334","736","0","45.38","31.79"
"67","000","00","021","2106","0529","363","287","76","38","401","781","0","51.34","36.75"
"67","000","00","021","2107","0000","858","673","185","60","918","1657","0","55.4","40.62"
"67","000","00","021","2107","0530","394","302","92","20","414","795","0","52.08","37.99"
"67","000","00","021","2107","0531","464","371","93","40","504","862","0","58.47","43.04"
"67","000","00","021","2108","0000","1310","1050","260","57","1367","2872","0","47.6","36.56"
"67","000","00","021","2108","0532","663","531","132","31","694","1487","0","46.67","35.71"
"67","000","00","021","2108","0533","647","519","128","26","673","1385","0","48.59","37.47"
"67","000","00","021","2109","0000","1213","923","290","95","1308","2612","0","50.08","35.34"
"67","000","00","021","2109","0534","639","473","166","33","672","1518","0","44.27","31.16"
"67","000","00","021","2109","0535","574","450","124","62","636","1094","0","58.14","41.13"
"67","000","00","021","2112","0000","358","275","83","44","402","716","0","56.15","38.41"
"67","000","00","021","2112","0538","358","275","83","44","402","716","0","56.15","38.41"
"67","000","00","021","2113","0000","1216","953","263","112","1328","2435","0","54.54","39.14"
"67","000","00","021","2113","0539","750","580","170","63","813","1492","0","54.49","38.87"
"67","000","00","021","2113","0540","466","373","93","49","515","943","0","54.61","39.55"
"67","000","00","021","2114","0000","1198","946","252","143","1341","2541","0","52.77","37.23"
"67","000","00","021","2114","0541","542","438","104","32","574","1157","0","49.61","37.86"
"67","000","00","021","2114","0542","656","508","148","111","767","1384","0","55.42","36.71"
"67","000","00","021","2117","0000","762","608","154","80","842","1578","0","53.36","38.53"
"67","000","00","021","2117","0543","471","364","107","50","521","967","0","53.88","37.64"
"67","000","00","021","2117","0544","291","244","47","30","321","611","0","52.54","39.93"
"67","000","00","021","2118","0000","1149","864","285","152","1301","2344","0","55.5","36.86"
"67","000","00","021","2118","0536","765","562","203","117","882","1590","0","55.47","35.35"
"67","000","00","021","2118","0537","384","302","82","35","419","754","0","55.57","40.05"
"67","000","00","022","0000","0000","2502","1960","542","264","2766","6511","7328","42.48","30.1"
"67","000","00","022","2201","0000","576","461","115","97","673","1691","0","39.8","27.26"
"67","000","00","022","2201","0572","298","240","58","60","358","855","0","41.87","28.07"
"67","000","00","022","2201","0573","278","221","57","37","315","836","0","37.68","26.44"
"67","000","00","022","2202","0000","656","496","160","82","738","1541","0","47.89","32.19"
"67","000","00","022","2202","0574","326","239","87","39","365","753","0","48.47","31.74"
"67","000","00","022","2202","0575","330","257","73","43","373","788","0","47.34","32.61"
"67","000","00","022","2203","0000","448","364","84","42","490","984","0","49.8","36.99"
"67","000","00","022","2203","0576","448","364","84","42","490","984","0","49.8","36.99"
"67","000","00","022","2204","0000","376","283","93","10","386","972","0","39.71","29.12"
"67","000","00","022","2204","0577","376","283","93","10","386","972","0","39.71","29.12"
"67","000","00","022","2205","0000","152","124","28","5","157","553","0","28.39","22.42"
"67","000","00","022","2205","0578","152","124","28","5","157","553","0","28.39","22.42"
"67","000","00","022","2206","0000","136","111","25","5","141","378","0","37.3","29.37"
"67","000","00","022","2206","0579","136","111","25","5","141","378","0","37.3","29.37"
"67","000","00","022","2207","0000","158","121","37","23","181","392","0","46.17","30.87"
"67","000","00","022","2207","0580","158","121","37","23","181","392","0","46.17","30.87"
"67","000","00","023","0000","0000","5324","4278","1046","470","5794","12357","14021","46.89","34.62"
"67","000","00","023","2301","0000","548","444","104","28","576","1242","0","46.38","35.75"
"67","000","00","023","2301","0466","548","444","104","28","576","1242","0","46.38","35.75"
"67","000","00","023","2302","0000","1686","1370","316","133","1819","3637","0","50.01","37.67"
"67","000","00","023","2302","0467","546","447","99","42","588","1141","0","51.53","39.18"
"67","000","00","023","2302","0468","300","234","66","21","321","698","0","45.99","33.52"
"67","000","00","023","2302","0469","382","298","84","22","404","849","0","47.59","35.1"
"67","000","00","023","2302","0470","458","391","67","48","506","949","0","53.32","41.2"
"67","000","00","023","2303","0000","508","413","95","22","530","1212","0","43.73","34.08"
"67","000","00","023","2303","0471","283","229","54","18","301","618","0","48.71","37.06"
"67","000","00","023","2303","0472","225","184","41","4","229","594","0","38.55","30.98"
"67","000","00","023","2304","0000","588","479","109","56","644","1439","0","44.75","33.29"
"67","000","00","023","2304","0473","364","291","73","9","373","927","0","40.24","31.39"
"67","000","00","023","2304","0474","224","188","36","47","271","512","0","52.93","36.72"
"67","000","00","023","2305","0000","211","167","44","31","242","509","0","47.54","32.81"
"67","000","00","023","2305","0475","211","167","44","31","242","509","0","47.54","32.81"
"67","000","00","023","2306","0000","240","187","53","20","260","496","0","52.42","37.7"
"67","000","00","023","2306","0476","240","187","53","20","260","496","0","52.42","37.7"
"67","000","00","023","2307","0000","310","242","68","9","319","759","0","42.03","31.88"
"67","000","00","023","2307","0477","310","242","68","9","319","759","0","42.03","31.88"
"67","000","00","023","2308","0000","543","435","108","79","622","1456","0","42.72","29.88"
"67","000","00","023","2308","0478","228","180","48","11","239","669","0","35.72","26.91"
"67","000","00","023","2308","0479","315","255","60","68","383","787","0","48.67","32.4"
"67","000","00","023","2309","0000","241","179","62","40","281","620","0","45.32","28.87"
"67","000","00","023","2309","0480","241","179","62","40","281","620","0","45.32","28.87"
"67","000","00","023","2310","0000","449","362","87","52","501","987","0","50.76","36.68"
"67","000","00","023","2310","0481","449","362","87","52","501","987","0","50.76","36.68"
"67","000","00","024","0000","0000","3343","2647","696","312","3655","8528","9572","42.86","31.04"
"67","000","00","024","2401","0000","858","669","189","91","949","1848","0","51.35","36.2"
"67","000","00","024","2401","0447","429","335","94","47","476","978","0","48.67","34.25"
"67","000","00","024","2401","0448","429","334","95","44","473","870","0","54.37","38.39"
"67","000","00","024","2402","0000","323","244","79","11","334","1160","0","28.79","21.03"
"67","000","00","024","2402","0449","323","244","79","11","334","1160","0","28.79","21.03"
"67","000","00","024","2403","0000","260","207","53","23","283","699","0","40.49","29.61"
"67","000","00","024","2403","0450","260","207","53","23","283","699","0","40.49","29.61"
"67","000","00","024","2404","0000","321","266","55","14","335","990","0","33.84","26.87"
"67","000","00","024","2404","0451","321","266","55","14","335","990","0","33.84","26.87"
"67","000","00","024","2405","0000","369","297","72","25","394","928","0","42.46","32.0"
"67","000","00","024","2405","0452","369","297","72","25","394","928","0","42.46","32.0"
"67","000","00","024","2406","0000","263","219","44","47","310","660","0","46.97","33.18"
"67","000","00","024","2406","0453","263","219","44","47","310","660","0","46.97","33.18"
"67","000","00","024","2407","0000","949","745","204","101","1050","2243","0","46.81","33.21"
"67","000","00","024","2407","0454","503","388","115","72","575","1187","0","48.44","32.69"
"67","000","00","024","2407","0455","446","357","89","29","475","1056","0","44.98","33.81"
"67","000","00","025","0000","0000","3275","2581","694","343","3618","7786","8741","46.47","33.15"
"67","000","00","025","2501","0000","652","504","148","95","747","1385","0","53.94","36.39"
"67","000","00","025","2501","0456","324","252","72","42","366","690","0","53.04","36.52"
"67","000","00","025","2501","0457","328","252","76","53","381","695","0","54.82","36.26"
"67","000","00","025","2502","0000","319","248","71","39","358","806","0","44.42","30.77"
"67","000","00","025","2502","0458","319","248","71","39","358","806","0","44.42","30.77"
"67","000","00","025","2503","0000","183","135","48","22","205","425","0","48.24","31.76"
"67","000","00","025","2503","0461","183","135","48","22","205","425","0","48.24","31.76"
"67","000","00","025","2504","0000","244","196","48","30","274","559","0","49.02","35.06"
"67","000","00","025","2504","0462","244","196","48","30","274","559","0","49.02","35.06"
"67","000","00","025","2505","0000","229","191","38","40","269","654","0","41.13","29.2"
"67","000","00","025","2505","0459","229","191","38","40","269","654","0","41.13","29.2"
"67","000","00","025","2506","0000","251","198","53","31","282","783","0","36.02","25.29"
"67","000","00","025","2506","0460","251","198","53","31","282","783","0","36.02","25.29"
"67","000","00","025","2507","0000","443","359","84","25","468","1189","0","39.36","30.19"
"67","000","00","025","2507","0463","443","359","84","25","468","1189","0","39.36","30.19"
"67","000","00","025","2508","0000","493","381","112","34","527","1044","0","50.48","36.49"
"67","000","00","025","2508","0464","493","381","112","34","527","1044","0","50.48","36.49"
"67","000","00","025","2509","0000","461","369","92","27","488","941","0","51.86","39.21"
"67","000","00","025","2509","0465","461","369","92","27","488","941","0","51.86","39.21"
"67","000","00","026","0000","0000","1663","1315","348","246","1909","4418","4801","43.21","29.76"
"67","000","00","026","2601","0000","164","133","31","23","187","392","0","47.7","33.93"
"67","000","00","026","2601","0482","164","133","31","23","187","392","0","47.7","33.93"
"67","000","00","026","2602","0000","293","250","43","42","335","644","0","52.02","38.82"
"67","000","00","026","2602","0483","293","250","43","42","335","644","0","52.02","38.82"
"67","000","00","026","2603","0000","164","128","36","18","182","468","0","38.89","27.35"
"67","000","00","026","2603","0484","164","128","36","18","182","468","0","38.89","27.35"
"67","000","00","026","2604","0000","264","198","66","48","312","753","0","41.43","26.29"
"67","000","00","026","2604","0485","264","198","66","48","312","753","0","41.43","26.29"
"67","000","00","026","2605","0000","129","102","27","28","157","345","0","45.51","29.57"
"67","000","00","026","2605","0486","129","102","27","28","157","345","0","45.51","29.57"
"67","000","00","026","2606","0000","150","120","30","15","165","393","0","41.98","30.53"
"67","000","00","026","2606","0487","150","120","30","15","165","393","0","41.98","30.53"
"67","000","00","026","2607","0000","175","128","47","45","220","504","0","43.65","25.4"
"67","000","00","026","2607","0491","175","128","47","45","220","504","0","43.65","25.4"
"67","000","00","026","2608","0000","158","126","32","14","172","420","0","40.95","30.0"
"67","000","00","026","2608","0488","158","126","32","14","172","420","0","40.95","30.0"
"67","000","00","026","2609","0000","107","82","25","8","115","313","0","36.74","26.2"
"67","000","00","026","2609","0489","107","82","25","8","115","313","0","36.74","26.2"
"67","000","00","026","2610","0000","59","48","11","5","64","186","0","34.41","25.81"
"67","000","00","026","2610","0490","59","48","11","5","64","186","0","34.41","25.81"
"67","000","00","027","0000","0000","31093","24241","6852","2493","33586","64632","75797","51.96","37.51"
"67","000","00","027","2701","0000","2661","2061","600","307","2968","5381","0","55.16","38.3"
"67","000","00","027","2701","1188","640","488","152","80","720","1318","0","54.63","37.03"
"67","000","00","027","2701","1189","700","559","141","69","769","1406","0","54.69","39.76"
"67","000","00","027","2701","1190","677","524","153","86","763","1465","0","52.08","35.77"
"67","000","00","027","2701","1191","644","490","154","72","716","1192","0","60.07","41.11"
"67","000","00","027","2702","0000","1367","1050","317","178","1545","2749","0","56.2","38.2"
"67","000","00","027","2702","1192","755","597","158","67","822","1429","0","57.52","41.78"
"67","000","00","027","2702","1193","612","453","159","111","723","1320","0","54.77","34.32"
"67","000","00","027","2703","0000","1422","1131","291","157","1579","2703","0","58.42","41.84"
"67","000","00","027","2703","1194","729","598","131","92","821","1373","0","59.8","43.55"
"67","000","00","027","2703","1195","693","533","160","65","758","1330","0","56.99","40.08"
"67","000","00","027","2704","0000","3561","2817","744","190","3751","7201","0","52.09","39.12"
"67","000","00","027","2704","1196","892","704","188","26","918","1687","0","54.42","41.73"
"67","000","00","027","2704","1197","696","529","167","58","754","1491","0","50.57","35.48"
"67","000","00","027","2704","1198","504","395","109","34","538","1151","0","46.74","34.32"
"67","000","00","027","2704","1199","691","581","110","24","715","1407","0","50.82","41.29"
"67","000","00","027","2704","1200","778","608","170","48","826","1465","0","56.38","41.5"
"67","000","00","027","2705","0000","4568","3497","1071","364","4932","9066","0","54.4","38.57"
"67","000","00","027","2705","1201","706","531","175","43","749","1335","0","56.1","39.78"
"67","000","00","027","2705","1202","720","544","176","63","783","1490","0","52.55","36.51"
"67","000","00","027","2705","1203","794","611","183","58","852","1453","0","58.64","42.05"
"67","000","00","027","2705","1204","452","352","100","30","482","990","0","48.69","35.56"
"67","000","00","027","2705","1205","803","631","172","78","881","1573","0","56.01","40.11"
"67","000","00","027","2705","1206","504","372","132","61","565","1031","0","54.8","36.08"
"67","000","00","027","2705","1207","589","456","133","31","620","1194","0","51.93","38.19"
"67","000","00","027","2706","0000","1558","1205","353","107","1665","3342","0","49.82","36.06"
"67","000","00","027","2706","1208","595","470","125","53","648","1268","0","51.1","37.07"
"67","000","00","027","2706","1209","467","339","128","42","509","929","0","54.79","36.49"
"67","000","00","027","2706","1210","496","396","100","12","508","1145","0","44.37","34.59"
"67","000","00","027","2707","0000","4436","3472","964","376","4812","9116","0","52.79","38.09"
"67","000","00","027","2707","1211","640","499","141","66","706","1413","0","49.96","35.31"
"67","000","00","027","2707","1212","683","546","137","103","786","1465","0","53.65","37.27"
"67","000","00","027","2707","1213","745","569","176","51","796","1390","0","57.27","40.94"
"67","000","00","027","2707","1214","691","536","155","69","760","1396","0","54.44","38.4"
"67","000","00","027","2707","1215","942","738","204","50","992","1906","0","52.05","38.72"
"67","000","00","027","2707","1216","735","584","151","37","772","1546","0","49.94","37.77"
"67","000","00","027","2708","0000","2752","2171","581","224","2976","5833","0","51.02","37.22"
"67","000","00","027","2708","1217","640","502","138","28","668","1546","0","43.21","32.47"
"67","000","00","027","2708","1218","693","554","139","49","742","1399","0","53.04","39.6"
"67","000","00","027","2708","1219","817","643","174","107","924","1748","0","52.86","36.78"
"67","000","00","027","2708","1220","602","472","130","40","642","1140","0","56.32","41.4"
"67","000","00","027","2711","0000","1178","920","258","67","1245","2763","0","45.06","33.3"
"67","000","00","027","2711","1223","610","470","140","39","649","1414","0","45.9","33.24"
"67","000","00","027","2711","1224","568","450","118","28","596","1349","0","44.18","33.36"
"67","000","00","027","2712","0000","2173","1722","451","114","2287","4659","0","49.09","36.96"
"67","000","00","027","2712","1225","671","518","153","31","702","1471","0","47.72","35.21"
"67","000","00","027","2712","1226","628","484","144","19","647","1324","0","48.87","36.56"
"67","000","00","027","2712","1227","589","497","92","38","627","1310","0","47.86","37.94"
"67","000","00","027","2712","1228","285","223","62","26","311","554","0","56.14","40.25"
"67","000","00","027","2713","0000","715","618","97","33","748","1395","0","53.62","44.3"
"67","000","00","027","2713","1229","715","618","97","33","748","1395","0","53.62","44.3"
"67","000","00","027","2714","0000","594","482","112","19","613","1264","0","48.5","38.13"
"67","000","00","027","2714","1230","594","482","112","19","613","1264","0","48.5","38.13"
"67","000","00","027","2715","0000","907","694","213","117","1024","2108","0","48.58","32.92"
"67","000","00","027","2715","1231","536","417","119","79","615","1180","0","52.12","35.34"
"67","000","00","027","2715","1232","371","277","94","38","409","928","0","44.07","29.85"
"67","000","00","027","2716","0000","866","565","301","49","915","2084","0","43.91","27.11"
"67","000","00","027","2716","1233","398","200","198","21","419","965","0","43.42","20.73"
"67","000","00","027","2716","1234","468","365","103","28","496","1119","0","44.33","32.62"
"67","000","00","027","2717","0000","1174","908","266","113","1287","2672","0","48.17","33.98"
"67","000","00","027","2717","1235","572","442","130","75","647","1206","0","53.65","36.65"
"67","000","00","027","2717","1236","602","466","136","38","640","1466","0","43.66","31.79"
"67","000","00","027","2719","0000","1161","928","233","78","1239","2296","0","53.96","40.42"
"67","000","00","027","2719","1221","573","461","112","27","600","1277","0","46.99","36.1"
"67","000","00","027","2719","1222","588","467","121","51","639","1019","0","62.71","45.83"
"67","000","00","028","0000","0000","27444","21131","6313","2191","29635","57387","68391","51.64","36.82"
"67","000","00","028","2801","0000","2860","2178","682","260","3120","5916","0","52.74","36.82"
"67","000","00","028","2801","1237","717","563","154","79","796","1560","0","51.03","36.09"
"67","000","00","028","2801","1238","767","584","183","67","834","1383","0","60.3","42.23"
"67","000","00","028","2801","1239","725","552","173","42","767","1491","0","51.44","37.02"
"67","000","00","028","2801","1240","651","479","172","72","723","1482","0","48.79","32.32"
"67","000","00","028","2802","0000","1577","1216","361","128","1705","3756","0","45.39","32.37"
"67","000","00","028","2802","1244","528","406","122","33","561","1336","0","41.99","30.39"
"67","000","00","028","2802","1245","513","391","122","73","586","1183","0","49.54","33.05"
"67","000","00","028","2802","1246","536","419","117","22","558","1237","0","45.11","33.87"
"67","000","00","028","2803","0000","1161","879","282","104","1265","2293","0","55.17","38.33"
"67","000","00","028","2803","1271","640","483","157","69","709","1245","0","56.95","38.8"
"67","000","00","028","2803","1272","521","396","125","35","556","1048","0","53.05","37.79"
"67","000","00","028","2804","0000","1639","1242","397","150","1789","3286","0","54.44","37.8"
"67","000","00","028","2804","1249","551","413","138","7","558","1105","0","50.5","37.38"
"67","000","00","028","2804","1250","539","407","132","62","601","1099","0","54.69","37.03"
"67","000","00","028","2804","1251","549","422","127","81","630","1082","0","58.23","39.0"
"67","000","00","028","2805","0000","1519","1192","327","116","1635","3301","0","49.53","36.11"
"67","000","00","028","2805","1254","519","391","128","51","570","1090","0","52.29","35.87"
"67","000","00","028","2805","1255","514","406","108","33","547","1131","0","48.36","35.9"
"67","000","00","028","2805","1256","486","395","91","32","518","1080","0","47.96","36.57"
"67","000","00","028","2806","0000","1584","1200","384","133","1717","3285","0","52.27","36.53"
"67","000","00","028","2806","1259","541","402","139","74","615","1128","0","54.52","35.64"
"67","000","00","028","2806","1260","499","382","117","27","526","1055","0","49.86","36.21"
"67","000","00","028","2806","1261","544","416","128","32","576","1102","0","52.27","37.75"
"67","000","00","028","2807","0000","1056","817","239","114","1170","2101","0","55.69","38.89"
"67","000","00","028","2807","1262","537","426","111","41","578","1068","0","54.12","39.89"
"67","000","00","028","2807","1263","519","391","128","73","592","1033","0","57.31","37.85"
"67","000","00","028","2808","0000","638","501","137","32","670","1772","0","37.81","28.27"
"67","000","00","028","2808","1264","638","501","137","32","670","1772","0","37.81","28.27"
"67","000","00","028","2809","0000","1440","1117","323","97","1537","2943","0","52.23","37.95"
"67","000","00","028","2809","1265","695","526","169","71","766","1399","0","54.75","37.6"
"67","000","00","028","2809","1266","745","591","154","26","771","1544","0","49.94","38.28"
"67","000","00","028","2810","0000","278","220","58","8","286","684","0","41.81","32.16"
"67","000","00","028","2810","1267","278","220","58","8","286","684","0","41.81","32.16"
"67","000","00","028","2811","0000","967","718","249","100","1067","1853","0","57.58","38.75"
"67","000","00","028","2811","1268","444","329","115","40","484","839","0","57.69","39.21"
"67","000","00","028","2811","1269","523","389","134","60","583","1014","0","57.5","38.36"
"67","000","00","028","2812","0000","655","511","144","36","691","1906","0","36.25","26.81"
"67","000","00","028","2812","1270","655","511","144","36","691","1906","0","36.25","26.81"
"67","000","00","028","2813","0000","1148","887","261","54","1202","2586","0","46.48","34.3"
"67","000","00","028","2813","1273","543","429","114","23","566","1175","0","48.17","36.51"
"67","000","00","028","2813","1274","605","458","147","31","636","1411","0","45.07","32.46"
"67","000","00","028","2814","0000","1628","1279","349","125","1753","3192","0","54.92","40.07"
"67","000","00","028","2814","1275","801","628","173","51","852","1514","0","56.27","41.48"
"67","000","00","028","2814","1276","827","651","176","74","901","1678","0","53.69","38.8"
"67","000","00","028","2815","0000","1008","783","225","97","1105","1958","0","56.44","39.99"
"67","000","00","028","2815","1277","476","384","92","35","511","949","0","53.85","40.46"
"67","000","00","028","2815","1278","532","399","133","62","594","1009","0","58.87","39.54"
"67","000","00","028","2816","0000","978","747","231","48","1026","1740","0","58.97","42.93"
"67","000","00","028","2816","1279","575","427","148","6","581","984","0","59.04","43.39"
"67","000","00","028","2816","1280","403","320","83","42","445","756","0","58.86","42.33"
"67","000","00","028","2817","0000","1595","1251","344","136","1731","2945","0","58.78","42.48"
"67","000","00","028","2817","1281","808","634","174","66","874","1478","0","59.13","42.9"
"67","000","00","028","2817","1282","787","617","170","70","857","1467","0","58.42","42.06"
"67","000","00","028","2818","0000","2030","1552","478","107","2137","4145","0","51.56","37.44"
"67","000","00","028","2818","1241","643","494","149","33","676","1330","0","50.83","37.14"
"67","000","00","028","2818","1242","732","552","180","48","780","1399","0","55.75","39.46"
"67","000","00","028","2818","1243","655","506","149","26","681","1416","0","48.09","35.73"
"67","000","00","028","2819","0000","1093","831","262","111","1204","2457","0","49.0","33.82"
"67","000","00","028","2819","1257","459","350","109","26","485","1121","0","43.26","31.22"
"67","000","00","028","2819","1258","634","481","153","85","719","1336","0","53.82","36.0"
"67","000","00","028","2820","0000","1098","856","242","106","1204","2282","0","52.76","37.51"
"67","000","00","028","2820","1247","561","442","119","72","633","1133","0","55.87","39.01"
"67","000","00","028","2820","1248","537","414","123","34","571","1149","0","49.7","36.03"
"67","000","00","028","2821","0000","1492","1154","338","129","1621","2986","0","54.29","38.65"
"67","000","00","028","2821","1252","732","582","150","55","787","1519","0","51.81","38.31"
"67","000","00","028","2821","1253","760","572","188","74","834","1467","0","56.85","38.99"
"67","000","00","029","0000","0000","14154","11016","3138","1190","15344","29913","34387","51.3","36.83"
"67","000","00","029","2901","0000","1072","832","240","76","1148","2138","0","53.7","38.91"
"67","000","00","029","2901","1283","455","342","113","30","485","982","0","49.39","34.83"
"67","000","00","029","2901","1284","617","490","127","46","663","1156","0","57.35","42.39"
"67","000","00","029","2902","0000","1007","752","255","85","1092","2049","0","53.29","36.7"
"67","000","00","029","2902","1285","435","343","92","27","462","1006","0","45.92","34.1"
"67","000","00","029","2902","1286","572","409","163","58","630","1043","0","60.4","39.21"
"67","000","00","029","2903","0000","1520","1210","310","138","1658","3319","0","49.95","36.46"
"67","000","00","029","2903","1287","499","390","109","82","581","1012","0","57.41","38.54"
"67","000","00","029","2903","1288","410","324","86","25","435","1013","0","42.94","31.98"
"67","000","00","029","2903","1289","611","496","115","31","642","1294","0","49.61","38.33"
"67","000","00","029","2904","0000","1124","883","241","82","1206","2430","0","49.63","36.34"
"67","000","00","029","2904","1290","575","450","125","39","614","1264","0","48.58","35.6"
"67","000","00","029","2904","1291","549","433","116","43","592","1166","0","50.77","37.14"
"67","000","00","029","2905","0000","443","340","103","20","463","1018","0","45.48","33.4"
"67","000","00","029","2905","1292","443","340","103","20","463","1018","0","45.48","33.4"
"67","000","00","029","2906","0000","301","235","66","40","341","733","0","46.52","32.06"
"67","000","00","029","2906","1293","301","235","66","40","341","733","0","46.52","32.06"
"67","000","00","029","2907","0000","1638","1293","345","105","1743","3152","0","55.3","41.02"
"67","000","00","029","2907","1294","571","446","125","35","606","1093","0","55.44","40.81"
"67","000","00","029","2907","1295","541","449","92","26","567","1081","0","52.45","41.54"
"67","000","00","029","2907","1296","526","398","128","44","570","978","0","58.28","40.7"
"67","000","00","029","2908","0000","1466","1109","357","158","1624","3133","0","51.84","35.4"
"67","000","00","029","2908","1297","482","356","126","21","503","1116","0","45.07","31.9"
"67","000","00","029","2908","1298","467","364","103","51","518","972","0","53.29","37.45"
"67","000","00","029","2908","1299","517","389","128","86","603","1045","0","57.7","37.22"
"67","000","00","029","2909","0000","954","746","208","72","1026","1879","0","54.6","39.7"
"67","000","00","029","2909","1300","426","339","87","32","458","872","0","52.52","38.88"
"67","000","00","029","2909","1301","528","407","121","40","568","1007","0","56.41","40.42"
"67","000","00","029","2912","0000","706","542","164","88","794","1524","0","52.1","35.56"
"67","000","00","029","2912","1306","387","294","93","70","457","804","0","56.84","36.57"
"67","000","00","029","2912","1307","319","248","71","18","337","720","0","46.81","34.44"
"67","000","00","029","2913","0000","490","400","90","27","517","1201","0","43.05","33.31"
"67","000","00","029","2913","1308","333","277","56","17","350","843","0","41.52","32.86"
"67","000","00","029","2913","1309","157","123","34","10","167","358","0","46.65","34.36"
"67","000","00","029","2916","0000","826","652","174","39","865","1867","0","46.33","34.92"
"67","000","00","029","2916","1312","387","302","85","17","404","904","0","44.69","33.41"
"67","000","00","029","2916","1313","439","350","89","22","461","963","0","47.87","36.34"
"67","000","00","029","2917","0000","236","182","54","7","243","489","0","49.69","37.22"
"67","000","00","029","2917","1314","236","182","54","7","243","489","0","49.69","37.22"
"67","000","00","029","2918","0000","1724","1327","397","178","1902","3475","0","54.73","38.19"
"67","000","00","029","2918","1302","396","294","102","60","456","763","0","59.76","38.53"
"67","000","00","029","2918","1303","301","237","64","33","334","630","0","53.02","37.62"
"67","000","00","029","2918","1304","495","364","131","58","553","959","0","57.66","37.96"
"67","000","00","029","2918","1305","532","432","100","27","559","1123","0","49.78","38.47"
"67","000","00","029","2919","0000","647","513","134","75","722","1506","0","47.94","34.06"
"67","000","00","029","2919","1310","365","288","77","61","426","797","0","53.45","36.14"
"67","000","00","029","2919","1311","282","225","57","14","296","709","0","41.75","31.73"
"67","000","00","030","0000","0000","1531","1201","330","164","1695","3713","3999","45.65","32.35"
"67","000","00","030","3001","0000","468","360","108","62","530","1047","0","50.62","34.38"
"67","000","00","030","3001","1315","468","360","108","62","530","1047","0","50.62","34.38"
"67","000","00","030","3002","0000","250","198","52","23","273","630","0","43.33","31.43"
"67","000","00","030","3002","1316","250","198","52","23","273","630","0","43.33","31.43"
"67","000","00","030","3003","0000","46","38","8","3","49","141","0","34.75","26.95"
"67","000","00","030","3003","1317","46","38","8","3","49","141","0","34.75","26.95"
"67","000","00","030","3004","0000","159","117","42","15","174","367","0","47.41","31.88"
"67","000","00","030","3004","1318","159","117","42","15","174","367","0","47.41","31.88"
"67","000","00","030","3005","0000","146","119","27","14","160","337","0","47.48","35.31"
"67","000","00","030","3005","1319","146","119","27","14","160","337","0","47.48","35.31"
"67","000","00","030","3006","0000","115","88","27","8","123","318","0","38.68","27.67"
"67","000","00","030","3006","1320","115","88","27","8","123","318","0","38.68","27.67"
"67","000","00","030","3007","0000","191","164","27","22","213","427","0","49.88","38.41"
"67","000","00","030","3007","1321","191","164","27","22","213","427","0","49.88","38.41"
"67","000","00","030","3008","0000","156","117","39","17","173","446","0","38.79","26.23"
"67","000","00","030","3008","1322","156","117","39","17","173","446","0","38.79","26.23"
"67","000","00","031","0000","0000","93196","73031","20165","6228","99424","195001","234921","50.99","37.45"
"67","000","00","031","3101","0000","2597","2029","568","177","2774","5671","0","48.92","35.78"
"67","000","00","031","3101","0708","702","560","142","62","764","1398","0","54.65","40.06"
"67","000","00","031","3101","0709","598","450","148","31","629","1478","0","42.56","30.45"
"67","000","00","031","3101","0710","678","532","146","39","717","1442","0","49.72","36.89"
"67","000","00","031","3101","0711","619","487","132","45","664","1353","0","49.08","35.99"
"67","000","00","031","3102","0000","3128","2415","713","214","3342","6821","0","49.0","35.41"
"67","000","00","031","3102","0719","772","579","193","60","832","1709","0","48.68","33.88"
"67","000","00","031","3102","0720","777","615","162","56","833","1717","0","48.51","35.82"
"67","000","00","031","3102","0721","794","602","192","45","839","1759","0","47.7","34.22"
"67","000","00","031","3102","0722","785","619","166","53","838","1636","0","51.22","37.84"
"67","000","00","031","3103","0000","3700","2928","772","260","3960","8791","0","45.05","33.31"
"67","000","00","031","3103","0728","700","551","149","41","741","1389","0","53.35","39.67"
"67","000","00","031","3103","0729","662","525","137","55","717","1369","0","52.37","38.35"
"67","000","00","031","3103","0730","679","529","150","86","765","1415","0","54.06","37.39"
"67","000","00","031","3103","0731","576","448","128","16","592","1386","0","42.71","32.32"
"67","000","00","031","3103","0732","379","323","56","7","386","1747","0","22.1","18.49"
"67","000","00","031","3103","0733","704","552","152","55","759","1485","0","51.11","37.17"
"67","000","00","031","3104","0000","3200","2557","643","215","3415","7088","0","48.18","36.08"
"67","000","00","031","3104","0734","813","644","169","73","886","1747","0","50.72","36.86"
"67","000","00","031","3104","0735","700","546","154","45","745","1744","0","42.72","31.31"
"67","000","00","031","3104","0736","786","643","143","36","822","1797","0","45.74","35.78"
"67","000","00","031","3104","0737","901","724","177","61","962","1800","0","53.44","40.22"
"67","000","00","031","3105","0000","2920","2269","651","174","3094","5710","0","54.19","39.74"
"67","000","00","031","3105","0745","768","591","177","55","823","1531","0","53.76","38.6"
"67","000","00","031","3105","0746","710","552","158","49","759","1327","0","57.2","41.6"
"67","000","00","031","3105","0747","715","555","160","23","738","1456","0","50.69","38.12"
"67","000","00","031","3105","0748","727","571","156","47","774","1396","0","55.44","40.9"
"67","000","00","031","3106","0000","1227","936","291","93","1320","2525","0","52.28","37.07"
"67","000","00","031","3106","0785","670","503","167","68","738","1285","0","57.43","39.14"
"67","000","00","031","3106","0786","557","433","124","25","582","1240","0","46.94","34.92"
"67","000","00","031","3107","0000","1316","1033","283","114","1430","2670","0","53.56","38.69"
"67","000","00","031","3107","0787","603","478","125","66","669","1343","0","49.81","35.59"
"67","000","00","031","3107","0788","713","555","158","48","761","1327","0","57.35","41.82"
"67","000","00","031","3108","0000","952","750","202","40","992","1862","0","53.28","40.28"
"67","000","00","031","3108","0758","447","343","104","12","459","924","0","49.68","37.12"
"67","000","00","031","3108","0759","505","407","98","28","533","938","0","56.82","43.39"
"67","000","00","031","3109","0000","744","598","146","69","813","1453","0","55.95","41.16"
"67","000","00","031","3109","0760","505","415","90","33","538","957","0","56.22","43.36"
"67","000","00","031","3109","0761","239","183","56","36","275","496","0","55.44","36.9"
"67","000","00","031","3110","0000","2263","1726","537","126","2389","4886","0","48.89","35.33"
"67","000","00","031","3110","0762","840","638","202","64","904","1717","0","52.65","37.16"
"67","000","00","031","3110","0763","708","534","174","34","742","1615","0","45.94","33.07"
"67","000","00","031","3110","0764","715","554","161","28","743","1554","0","47.81","35.65"
"67","000","00","031","3111","0000","1222","928","294","118","1340","2276","0","58.88","40.77"
"67","000","00","031","3111","0772","476","370","106","40","516","890","0","57.98","41.57"
"67","000","00","031","3111","0773","555","416","139","55","610","1018","0","59.92","40.86"
"67","000","00","031","3111","0774","191","142","49","23","214","368","0","58.15","38.59"
"67","000","00","031","3112","0000","1644","1280","364","141","1785","3366","0","53.03","38.03"
"67","000","00","031","3112","0795","513","407","106","74","587","1117","0","52.55","36.44"
"67","000","00","031","3112","0796","473","349","124","28","501","1069","0","46.87","32.65"
"67","000","00","031","3112","0797","658","524","134","39","697","1180","0","59.07","44.41"
"67","000","00","031","3113","0000","1732","1348","384","226","1958","3542","0","55.28","38.06"
"67","000","00","031","3113","0798","553","454","99","90","643","1176","0","54.68","38.61"
"67","000","00","031","3113","0799","550","411","139","58","608","1158","0","52.5","35.49"
"67","000","00","031","3113","0800","629","483","146","78","707","1208","0","58.53","39.98"
"67","000","00","031","3114","0000","3660","2857","803","286","3946","7237","0","54.53","39.48"
"67","000","00","031","3114","0801","713","543","170","88","801","1501","0","53.36","36.18"
"67","000","00","031","3114","0802","667","508","159","39","706","1298","0","54.39","39.14"
"67","000","00","031","3114","0803","729","582","147","35","764","1542","0","49.55","37.74"
"67","000","00","031","3114","0804","804","630","174","53","857","1537","0","55.76","40.99"
"67","000","00","031","3114","0805","747","594","153","71","818","1359","0","60.19","43.71"
"67","000","00","031","3115","0000","1708","1301","407","158","1866","3835","0","48.66","33.92"
"67","000","00","031","3115","0806","476","370","106","41","517","1139","0","45.39","32.48"
"67","000","00","031","3115","0807","527","398","129","47","574","1158","0","49.57","34.37"
"67","000","00","031","3115","0808","705","533","172","70","775","1538","0","50.39","34.66"
"67","000","00","031","3116","0000","2830","2110","720","174","3004","5872","0","51.16","35.93"
"67","000","00","031","3116","0809","521","420","101","20","541","1166","0","46.4","36.02"
"67","000","00","031","3116","0810","546","440","106","26","572","1228","0","46.58","35.83"
"67","000","00","031","3116","0811","626","482","144","54","680","1200","0","56.67","40.17"
"67","000","00","031","3116","0812","589","334","255","44","633","1131","0","55.97","29.53"
"67","000","00","031","3116","0813","548","434","114","30","578","1147","0","50.39","37.84"
"67","000","00","031","3117","0000","1766","1385","381","119","1885","4027","0","46.81","34.39"
"67","000","00","031","3117","0814","671","525","146","56","727","1442","0","50.42","36.41"
"67","000","00","031","3117","0815","567","448","119","26","593","1325","0","44.75","33.81"
"67","000","00","031","3117","0816","528","412","116","37","565","1260","0","44.84","32.7"
"67","000","00","031","3118","0000","1067","826","241","153","1220","2099","0","58.12","39.35"
"67","000","00","031","3118","0793","501","381","120","73","574","983","0","58.39","38.76"
"67","000","00","031","3118","0794","566","445","121","80","646","1116","0","57.89","39.87"
"67","000","00","031","3119","0000","861","701","160","56","917","1988","0","46.13","35.26"
"67","000","00","031","3119","0820","463","374","89","34","497","1012","0","49.11","36.96"
"67","000","00","031","3119","0821","398","327","71","22","420","976","0","43.03","33.5"
"67","000","00","031","3120","0000","3969","3153","816","242","4211","8430","0","49.95","37.4"
"67","000","00","031","3120","0825","654","523","131","43","697","1307","0","53.33","40.02"
"67","000","00","031","3120","0826","649","538","111","26","675","1482","0","45.55","36.3"
"67","000","00","031","3120","0827","583","463","120","33","616","1341","0","45.94","34.53"
"67","000","00","031","3120","0828","657","523","134","44","701","1376","0","50.94","38.01"
"67","000","00","031","3120","0829","643","511","132","48","691","1390","0","49.71","36.76"
"67","000","00","031","3120","0830","783","595","188","48","831","1534","0","54.17","38.79"
"67","000","00","031","3121","0000","859","698","161","78","937","1796","0","52.17","38.86"
"67","000","00","031","3121","0823","428","350","78","45","473","859","0","55.06","40.75"
"67","000","00","031","3121","0824","431","348","83","33","464","937","0","49.52","37.14"
"67","000","00","031","3122","0000","543","433","110","44","587","1151","0","51.0","37.62"
"67","000","00","031","3122","0838","543","433","110","44","587","1151","0","51.0","37.62"
"67","000","00","031","3123","0000","2998","2333","665","227","3225","5980","0","53.93","39.01"
"67","000","00","031","3123","0789","760","594","166","51","811","1565","0","51.82","37.96"
"67","000","00","031","3123","0790","738","593","145","82","820","1476","0","55.56","40.18"
"67","000","00","031","3123","0791","716","556","160","45","761","1476","0","51.56","37.67"
"67","000","00","031","3123","0792","784","590","194","49","833","1463","0","56.94","40.33"
"67","000","00","031","3124","0000","1088","881","207","72","1160","2097","0","55.32","42.01"
"67","000","00","031","3124","0839","612","500","112","48","660","1026","0","64.33","48.73"
"67","000","00","031","3124","0840","476","381","95","24","500","1071","0","46.69","35.57"
"67","000","00","031","3125","0000","1628","1238","390","109","1737","3387","0","51.28","36.55"
"67","000","00","031","3125","0843","830","629","201","65","895","1687","0","53.05","37.29"
"67","000","00","031","3125","0844","798","609","189","44","842","1700","0","49.53","35.82"
"67","000","00","031","3126","0000","3610","2852","758","210","3820","7729","0","49.42","36.9"
"67","000","00","031","3126","0845","751","584","167","46","797","1444","0","55.19","40.44"
"67","000","00","031","3126","0846","711","575","136","44","755","1485","0","50.84","38.72"
"67","000","00","031","3126","0847","764","599","165","38","802","1717","0","46.71","34.89"
"67","000","00","031","3126","0848","746","588","158","51","797","1701","0","46.85","34.57"
"67","000","00","031","3126","0849","638","506","132","31","669","1382","0","48.41","36.61"
"67","000","00","031","3127","0000","2756","2153","603","225","2981","6072","0","49.09","35.46"
"67","000","00","031","3127","0778","662","517","145","68","730","1405","0","51.96","36.8"
"67","000","00","031","3127","0779","656","516","140","66","722","1445","0","49.97","35.71"
"67","000","00","031","3127","0780","786","621","165","63","849","1687","0","50.33","36.81"
"67","000","00","031","3127","0781","652","499","153","28","680","1535","0","44.3","32.51"
"67","000","00","031","3128","0000","260","217","43","21","281","531","0","52.92","40.87"
"67","000","00","031","3128","0822","260","217","43","21","281","531","0","52.92","40.87"
"67","000","00","031","3129","0000","2745","2122","623","151","2896","5725","0","50.59","37.07"
"67","000","00","031","3129","0768","708","547","161","24","732","1457","0","50.24","37.54"
"67","000","00","031","3129","0769","721","578","143","18","739","1451","0","50.93","39.83"
"67","000","00","031","3129","0770","609","447","162","74","683","1423","0","48.0","31.41"
"67","000","00","031","3129","0771","707","550","157","35","742","1394","0","53.23","39.45"
"67","000","00","031","3130","0000","3616","2880","736","233","3849","7784","0","49.45","37.0"
"67","000","00","031","3130","0723","685","547","138","70","755","1442","0","52.36","37.93"
"67","000","00","031","3130","0724","733","584","149","45","778","1545","0","50.36","37.8"
"67","000","00","031","3130","0725","743","605","138","43","786","1565","0","50.22","38.66"
"67","000","00","031","3130","0726","765","588","177","47","812","1684","0","48.22","34.92"
"67","000","00","031","3130","0727","690","556","134","28","718","1548","0","46.38","35.92"
"67","000","00","031","3131","0000","2719","2136","583","166","2885","5428","0","53.15","39.35"
"67","000","00","031","3131","0715","617","484","133","40","657","1317","0","49.89","36.75"
"67","000","00","031","3131","0716","659","535","124","45","704","1376","0","51.16","38.88"
"67","000","00","031","3131","0717","688","542","146","38","726","1361","0","53.34","39.82"
"67","000","00","031","3131","0718","755","575","180","43","798","1374","0","58.08","41.85"
"67","000","00","031","3132","0000","1646","1286","360","70","1716","3447","0","49.78","37.31"
"67","000","00","031","3132","0712","533","417","116","28","561","1160","0","48.36","35.95"
"67","000","00","031","3132","0713","566","451","115","29","595","1122","0","53.03","40.2"
"67","000","00","031","3132","0714","547","418","129","13","560","1165","0","48.07","35.88"
"67","000","00","031","3133","0000","2839","2212","627","166","3005","5917","0","50.79","37.38"
"67","000","00","031","3133","0749","774","591","183","68","842","1636","0","51.47","36.12"
"67","000","00","031","3133","0750","803","631","172","53","856","1592","0","53.77","39.64"
"67","000","00","031","3133","0751","922","728","194","34","956","2017","0","47.4","36.09"
"67","000","00","031","3133","0752","340","262","78","11","351","672","0","52.23","38.99"
"67","000","00","031","3134","0000","2071","1620","451","76","2147","4811","0","44.63","33.67"
"67","000","00","031","3134","0755","706","566","140","20","726","1660","0","43.73","34.1"
"67","000","00","031","3134","0756","652","510","142","30","682","1561","0","43.69","32.67"
"67","000","00","031","3134","0757","713","544","169","26","739","1590","0","46.48","34.21"
"67","000","00","031","3135","0000","1436","1121","315","79","1515","3113","0","48.67","36.01"
"67","000","00","031","3135","0753","698","541","157","29","727","1611","0","45.13","33.58"
"67","000","00","031","3135","0754","738","580","158","50","788","1502","0","52.46","38.62"
"67","000","00","031","3136","0000","1851","1406","445","122","1973","3776","0","52.25","37.24"
"67","000","00","031","3136","0775","661","501","160","50","711","1208","0","58.86","41.47"
"67","000","00","031","3136","0776","523","380","143","38","561","1187","0","47.26","32.01"
"67","000","00","031","3136","0777","667","525","142","34","701","1381","0","50.76","38.02"
"67","000","00","031","3137","0000","4639","3735","904","267","4906","9284","0","52.84","40.23"
"67","000","00","031","3137","0831","755","617","138","47","802","1460","0","54.93","42.26"
"67","000","00","031","3137","0832","658","544","114","26","684","1383","0","49.46","39.33"
"67","000","00","031","3137","0833","610","480","130","47","657","1299","0","50.58","36.95"
"67","000","00","031","3137","0834","661","526","135","34","695","1264","0","54.98","41.61"
"67","000","00","031","3137","0835","711","569","142","54","765","1355","0","56.46","41.99"
"67","000","00","031","3137","0836","647","523","124","28","675","1414","0","47.74","36.99"
"67","000","00","031","3137","0837","597","476","121","31","628","1109","0","56.63","42.92"
"67","000","00","031","3138","0000","3871","3073","798","234","4105","7603","0","53.99","40.42"
"67","000","00","031","3138","0740","780","612","168","30","810","1519","0","53.32","40.29"
"67","000","00","031","3138","0741","751","573","178","87","838","1497","0","55.98","38.28"
"67","000","00","031","3138","0742","700","568","132","21","721","1509","0","47.78","37.64"
"67","000","00","031","3138","0743","826","653","173","73","899","1542","0","58.3","42.35"
"67","000","00","031","3138","0744","814","667","147","23","837","1536","0","54.49","43.42"
"67","000","00","031","3139","0000","1581","1207","374","92","1673","2764","0","60.53","43.67"
"67","000","00","031","3139","0841","821","633","188","48","869","1387","0","62.65","45.64"
"67","000","00","031","3139","0842","760","574","186","44","804","1377","0","58.39","41.68"
"67","000","00","031","3140","0000","2237","1751","486","137","2374","4846","0","48.99","36.13"
"67","000","00","031","3140","0817","748","579","169","51","799","1631","0","48.99","35.5"
"67","000","00","031","3140","0818","718","584","134","50","768","1549","0","49.58","37.7"
"67","000","00","031","3140","0819","771","588","183","36","807","1666","0","48.44","35.29"
"67","000","00","031","3141","0000","1659","1327","332","66","1725","3428","0","50.32","38.71"
"67","000","00","031","3141","0738","786","642","144","22","808","1720","0","46.98","37.33"
"67","000","00","031","3141","0739","873","685","188","44","917","1708","0","53.69","40.11"
"67","000","00","031","3142","0000","2269","1833","436","123","2392","4498","0","53.18","40.75"
"67","000","00","031","3142","0782","783","631","152","53","836","1542","0","54.22","40.92"
"67","000","00","031","3142","0783","776","616","160","36","812","1618","0","50.19","38.07"
"67","000","00","031","3142","0784","710","586","124","34","744","1338","0","55.61","43.8"
"67","000","00","031","3143","0000","1769","1387","382","105","1874","3685","0","50.85","37.64"
"67","000","00","031","3143","0765","529","416","113","27","556","1196","0","46.49","34.78"
"67","000","00","031","3143","0766","626","490","136","39","665","1274","0","52.2","38.46"
"67","000","00","031","3143","0767","614","481","133","39","653","1215","0","53.74","39.59"
"67","000","00","032","0000","0000","77421","59256","18165","5127","82548","153359","186117","53.83","38.64"
"67","000","00","032","3201","0000","1063","820","243","60","1123","2191","0","51.26","37.43"
"67","000","00","032","3201","1170","1063","820","243","60","1123","2191","0","51.26","37.43"
"67","000","00","032","3202","0000","1482","1146","336","144","1626","2944","0","55.23","38.93"
"67","000","00","032","3202","1166","633","491","142","76","709","1287","0","55.09","38.15"
"67","000","00","032","3202","1167","849","655","194","68","917","1657","0","55.34","39.53"
"67","000","00","032","3203","0000","3191","2570","621","207","3398","6583","0","51.62","39.04"
"67","000","00","032","3203","1113","942","732","210","104","1046","2067","0","50.6","35.41"
"67","000","00","032","3203","1114","1092","902","190","35","1127","2153","0","52.35","41.9"
"67","000","00","032","3203","1115","1157","936","221","68","1225","2363","0","51.84","39.61"
"67","000","00","032","3204","0000","1549","1161","388","138","1687","2869","0","58.8","40.47"
"67","000","00","032","3204","1097","845","626","219","87","932","1491","0","62.51","41.99"
"67","000","00","032","3204","1098","704","535","169","51","755","1378","0","54.79","38.82"
"67","000","00","032","3205","0000","2311","1684","627","182","2493","4730","0","52.71","35.6"
"67","000","00","032","3205","1180","747","570","177","38","785","1486","0","52.83","38.36"
"67","000","00","032","3205","1181","798","551","247","71","869","1560","0","55.71","35.32"
"67","000","00","032","3205","1182","766","563","203","73","839","1684","0","49.82","33.43"
"67","000","00","032","3206","0000","1960","1537","423","145","2105","4455","0","47.25","34.5"
"67","000","00","032","3206","1118","890","700","190","61","951","2115","0","44.96","33.1"
"67","000","00","032","3206","1119","1070","837","233","84","1154","2340","0","49.32","35.77"
"67","000","00","032","3207","0000","1462","1097","365","111","1573","2932","0","53.65","37.41"
"67","000","00","032","3207","1139","737","559","178","42","779","1489","0","52.32","37.54"
"67","000","00","032","3207","1140","725","538","187","69","794","1443","0","55.02","37.28"
"67","000","00","032","3208","0000","2626","1978","648","117","2743","4858","0","56.46","40.72"
"67","000","00","032","3208","1141","852","627","225","53","905","1498","0","60.41","41.86"
"67","000","00","032","3208","1142","849","632","217","27","876","1622","0","54.01","38.96"
"67","000","00","032","3208","1143","925","719","206","37","962","1738","0","55.35","41.37"
"67","000","00","032","3209","0000","1268","919","349","78","1346","2433","0","55.32","37.77"
"67","000","00","032","3209","1161","556","410","146","19","575","1101","0","52.23","37.24"
"67","000","00","032","3209","1162","712","509","203","59","771","1332","0","57.88","38.21"
"67","000","00","032","3210","0000","1581","1197","384","78","1659","3086","0","53.76","38.79"
"67","000","00","032","3210","1158","792","588","204","28","820","1589","0","51.6","37.0"
"67","000","00","032","3210","1159","789","609","180","50","839","1497","0","56.05","40.68"
"67","000","00","032","3211","0000","664","490","174","58","722","1386","0","52.09","35.35"
"67","000","00","032","3211","1160","664","490","174","58","722","1386","0","52.09","35.35"
"67","000","00","032","3212","0000","2123","1679","444","136","2259","4048","0","55.81","41.48"
"67","000","00","032","3212","1173","983","776","207","91","1074","1863","0","57.65","41.65"
"67","000","00","032","3212","1174","1140","903","237","45","1185","2185","0","54.23","41.33"
"67","000","00","032","3213","0000","2529","1924","605","190","2719","5122","0","53.08","37.56"
"67","000","00","032","3213","1129","802","602","200","73","875","1708","0","51.23","35.25"
"67","000","00","032","3213","1130","803","620","183","54","857","1560","0","54.94","39.74"
"67","000","00","032","3213","1131","924","702","222","63","987","1854","0","53.24","37.86"
"67","000","00","032","3214","0000","2437","1873","564","140","2577","4865","0","52.97","38.5"
"67","000","00","032","3214","1120","1274","958","316","67","1341","2474","0","54.2","38.72"
"67","000","00","032","3214","1121","1163","915","248","73","1236","2391","0","51.69","38.27"
"67","000","00","032","3215","0000","871","683","188","49","920","1602","0","57.43","42.63"
"67","000","00","032","3215","1177","871","683","188","49","920","1602","0","57.43","42.63"
"67","000","00","032","3216","0000","771","586","185","93","864","1556","0","55.53","37.66"
"67","000","00","032","3216","1176","771","586","185","93","864","1556","0","55.53","37.66"
"67","000","00","032","3217","0000","2206","1735","471","122","2328","4335","0","53.7","40.02"
"67","000","00","032","3217","1133","998","776","222","52","1050","2093","0","50.17","37.08"
"67","000","00","032","3217","1134","1208","959","249","70","1278","2242","0","57.0","42.77"
"67","000","00","032","3218","0000","716","551","165","41","757","1517","0","49.9","36.32"
"67","000","00","032","3218","1165","716","551","165","41","757","1517","0","49.9","36.32"
"67","000","00","032","3219","0000","2574","1937","637","196","2770","4992","0","55.49","38.8"
"67","000","00","032","3219","1102","882","650","232","58","940","1639","0","57.35","39.66"
"67","000","00","032","3219","1103","864","661","203","59","923","1724","0","53.54","38.34"
"67","000","00","032","3219","1104","828","626","202","79","907","1629","0","55.68","38.43"
"67","000","00","032","3220","0000","2205","1645","560","165","2370","4484","0","52.85","36.69"
"67","000","00","032","3220","1168","1117","849","268","104","1221","2238","0","54.56","37.94"
"67","000","00","032","3220","1169","1088","796","292","61","1149","2246","0","51.16","35.44"
"67","000","00","032","3221","0000","985","714","271","69","1054","1986","0","53.07","35.95"
"67","000","00","032","3221","1156","559","407","152","19","578","1090","0","53.03","37.34"
"67","000","00","032","3221","1157","426","307","119","50","476","896","0","53.13","34.26"
"67","000","00","032","3222","0000","2220","1733","487","154","2374","4242","0","55.96","40.85"
"67","000","00","032","3222","1148","780","610","170","42","822","1427","0","57.6","42.75"
"67","000","00","032","3222","1149","708","534","174","63","771","1427","0","54.03","37.42"
"67","000","00","032","3222","1150","732","589","143","49","781","1388","0","56.27","42.44"
"67","000","00","032","3223","0000","651","469","182","35","686","1131","0","60.65","41.47"
"67","000","00","032","3223","1151","651","469","182","35","686","1131","0","60.65","41.47"
"67","000","00","032","3224","0000","2425","1762","663","104","2529","4615","0","54.8","38.18"
"67","000","00","032","3224","1183","860","614","246","50","910","1653","0","55.05","37.14"
"67","000","00","032","3224","1184","815","580","235","20","835","1554","0","53.73","37.32"
"67","000","00","032","3224","1185","750","568","182","34","784","1408","0","55.68","40.34"
"67","000","00","032","3225","0000","2509","1885","624","158","2667","4874","0","54.72","38.67"
"67","000","00","032","3225","1122","873","637","236","58","931","1673","0","55.65","38.08"
"67","000","00","032","3225","1123","773","584","189","43","816","1594","0","51.19","36.64"
"67","000","00","032","3225","1124","863","664","199","57","920","1607","0","57.25","41.32"
"67","000","00","032","3226","0000","1551","1209","342","79","1630","2982","0","54.66","40.54"
"67","000","00","032","3226","1116","738","582","156","45","783","1427","0","54.87","40.78"
"67","000","00","032","3226","1117","813","627","186","34","847","1555","0","54.47","40.32"
"67","000","00","032","3227","0000","1731","1313","418","112","1843","3593","0","51.29","36.54"
"67","000","00","032","3227","1146","839","628","211","44","883","1829","0","48.28","34.34"
"67","000","00","032","3227","1147","892","685","207","68","960","1764","0","54.42","38.83"
"67","000","00","032","3228","0000","760","583","177","52","812","1721","0","47.18","33.88"
"67","000","00","032","3228","1175","760","583","177","52","812","1721","0","47.18","33.88"
"67","000","00","032","3229","0000","2182","1679","503","150","2332","4240","0","55.0","39.6"
"67","000","00","032","3229","1171","1011","775","236","66","1077","2063","0","52.21","37.57"
"67","000","00","032","3229","1172","1171","904","267","84","1255","2177","0","57.65","41.53"
"67","000","00","032","3230","0000","1285","1011","274","116","1401","2447","0","57.25","41.32"
"67","000","00","032","3230","1163","606","489","117","59","665","1185","0","56.12","41.27"
"67","000","00","032","3230","1164","679","522","157","57","736","1262","0","58.32","41.36"
"67","000","00","032","3231","0000","1485","1105","380","132","1617","2983","0","54.21","37.04"
"67","000","00","032","3231","1144","723","544","179","69","792","1501","0","52.76","36.24"
"67","000","00","032","3231","1145","762","561","201","63","825","1482","0","55.67","37.85"
"67","000","00","032","3232","0000","2358","1795","563","169","2527","4472","0","56.51","40.14"
"67","000","00","032","3232","1099","808","624","184","65","873","1552","0","56.25","40.21"
"67","000","00","032","3232","1100","723","533","190","33","756","1326","0","57.01","40.2"
"67","000","00","032","3232","1101","827","638","189","71","898","1594","0","56.34","40.03"
"67","000","00","032","3233","0000","1096","848","248","75","1171","2296","0","51.0","36.93"
"67","000","00","032","3233","1111","538","416","122","46","584","1039","0","56.21","40.04"
"67","000","00","032","3233","1112","558","432","126","29","587","1257","0","46.7","34.37"
"67","000","00","032","3234","0000","1034","773","261","43","1077","2278","0","47.28","33.93"
"67","000","00","032","3234","1132","1034","773","261","43","1077","2278","0","47.28","33.93"
"67","000","00","032","3235","0000","1501","1194","307","71","1572","2933","0","53.6","40.71"
"67","000","00","032","3235","1105","718","572","146","34","752","1399","0","53.75","40.89"
"67","000","00","032","3235","1106","783","622","161","37","820","1534","0","53.46","40.55"
"67","000","00","032","3236","0000","917","645","272","126","1043","1882","0","55.42","34.27"
"67","000","00","032","3236","1154","452","332","120","46","498","935","0","53.26","35.51"
"67","000","00","032","3236","1155","465","313","152","80","545","947","0","57.55","33.05"
"67","000","00","032","3237","0000","996","762","234","88","1084","1996","0","54.31","38.18"
"67","000","00","032","3237","1152","486","370","116","48","534","1000","0","53.4","37.0"
"67","000","00","032","3237","1153","510","392","118","40","550","996","0","55.22","39.36"
"67","000","00","032","3238","0000","1346","1035","311","141","1487","2905","0","51.19","35.63"
"67","000","00","032","3238","1178","717","573","144","84","801","1523","0","52.59","37.62"
"67","000","00","032","3238","1179","629","462","167","57","686","1382","0","49.64","33.43"
"67","000","00","032","3239","0000","2100","1599","501","120","2220","3980","0","55.78","40.18"
"67","000","00","032","3239","1186","1148","873","275","41","1189","2084","0","57.05","41.89"
"67","000","00","032","3239","1187","952","726","226","79","1031","1896","0","54.38","38.29"
"67","000","00","032","3240","0000","1847","1403","444","95","1942","4492","0","43.23","31.23"
"67","000","00","032","3240","1095","988","758","230","59","1047","2681","0","39.05","28.27"
"67","000","00","032","3240","1096","859","645","214","36","895","1811","0","49.42","35.62"
"67","000","00","032","3241","0000","3149","2505","644","194","3343","5929","0","56.38","42.25"
"67","000","00","032","3241","1107","879","685","194","58","937","1656","0","56.58","41.36"
"67","000","00","032","3241","1108","666","539","127","62","728","1322","0","55.07","40.77"
"67","000","00","032","3241","1109","834","648","186","37","871","1620","0","53.77","40.0"
"67","000","00","032","3241","1110","770","633","137","37","807","1331","0","60.63","47.56"
"67","000","00","032","3242","0000","1605","1202","403","147","1752","3308","0","52.96","36.34"
"67","000","00","032","3242","1127","805","612","193","101","906","1696","0","53.42","36.08"
"67","000","00","032","3242","1128","800","590","210","46","846","1612","0","52.48","36.6"
"67","000","00","032","3243","0000","2455","1951","504","83","2538","4456","0","56.96","43.78"
"67","000","00","032","3243","1125","1153","928","225","37","1190","2087","0","57.02","44.47"
"67","000","00","032","3243","1126","1302","1023","279","46","1348","2369","0","56.9","43.18"
"67","000","00","032","3244","0000","1417","1121","296","69","1486","2470","0","60.16","45.38"
"67","000","00","032","3244","1135","644","509","135","46","690","1152","0","59.9","44.18"
"67","000","00","032","3244","1136","773","612","161","23","796","1318","0","60.39","46.43"
"67","000","00","032","3245","0000","2227","1748","479","95","2322","4160","0","55.82","42.02"
"67","000","00","032","3245","1137","1128","886","242","51","1179","2200","0","53.59","40.27"
"67","000","00","032","3245","1138","1099","862","237","44","1143","1960","0","58.32","43.98"
"67","000","00","033","0000","0000","49872","37899","11973","4423","54295","108650","124790","49.97","34.88"
"67","000","00","033","3301","0000","780","586","194","70","850","1637","0","51.92","35.8"
"67","000","00","033","3301","1024","780","586","194","70","850","1637","0","51.92","35.8"
"67","000","00","033","3303","0000","375","292","83","15","390","871","0","44.78","33.52"
"67","000","00","033","3303","1025","375","292","83","15","390","871","0","44.78","33.52"
"67","000","00","033","3304","0000","795","601","194","63","858","1390","0","61.73","43.24"
"67","000","00","033","3304","1026","315","239","76","19","334","589","0","56.71","40.58"
"67","000","00","033","3304","1027","480","362","118","44","524","801","0","65.42","45.19"
"67","000","00","033","3305","0000","1102","799","303","80","1182","2262","0","52.25","35.32"
"67","000","00","033","3305","1035","536","377","159","27","563","1127","0","49.96","33.45"
"67","000","00","033","3305","1036","566","422","144","53","619","1135","0","54.54","37.18"
"67","000","00","033","3306","0000","1058","791","267","99","1157","2277","0","50.81","34.74"
"67","000","00","033","3306","1037","603","449","154","66","669","1263","0","52.97","35.55"
"67","000","00","033","3306","1038","455","342","113","33","488","1014","0","48.13","33.73"
"67","000","00","033","3307","0000","1219","882","337","69","1288","2774","0","46.43","31.8"
"67","000","00","033","3307","1031","551","391","160","38","589","1204","0","48.92","32.48"
"67","000","00","033","3307","1032","668","491","177","31","699","1570","0","44.52","31.27"
"67","000","00","033","3308","0000","1715","1331","384","189","1904","3209","0","59.33","41.48"
"67","000","00","033","3308","1028","510","402","108","58","568","990","0","57.37","40.61"
"67","000","00","033","3308","1029","683","527","156","54","737","1222","0","60.31","43.13"
"67","000","00","033","3308","1030","522","402","120","77","599","997","0","60.08","40.32"
"67","000","00","033","3309","0000","1448","1092","356","150","1598","3006","0","53.16","36.33"
"67","000","00","033","3309","1047","770","577","193","58","828","1542","0","53.7","37.42"
"67","000","00","033","3309","1048","678","515","163","92","770","1464","0","52.6","35.18"
"67","000","00","033","3311","0000","1857","1447","410","210","2067","4217","0","49.02","34.31"
"67","000","00","033","3311","1052","591","459","132","83","674","1419","0","47.5","32.35"
"67","000","00","033","3311","1053","601","466","135","65","666","1333","0","49.96","34.96"
"67","000","00","033","3311","1054","665","522","143","62","727","1465","0","49.62","35.63"
"67","000","00","033","3313","0000","1640","1259","381","154","1794","3607","0","49.74","34.9"
"67","000","00","033","3313","1055","522","391","131","27","549","1099","0","49.95","35.58"
"67","000","00","033","3313","1056","514","412","102","22","536","1133","0","47.31","36.36"
"67","000","00","033","3313","1057","604","456","148","105","709","1375","0","51.56","33.16"
"67","000","00","033","3314","0000","825","631","194","93","918","2064","0","44.48","30.57"
"67","000","00","033","3314","1082","825","631","194","93","918","2064","0","44.48","30.57"
"67","000","00","033","3315","0000","975","743","232","100","1075","2173","0","49.47","34.19"
"67","000","00","033","3315","1079","580","454","126","67","647","1119","0","57.82","40.57"
"67","000","00","033","3315","1080","395","289","106","33","428","1054","0","40.61","27.42"
"67","000","00","033","3316","0000","534","409","125","105","639","1245","0","51.33","32.85"
"67","000","00","033","3316","1081","534","409","125","105","639","1245","0","51.33","32.85"
"67","000","00","033","3317","0000","1279","979","300","58","1337","3429","0","38.99","28.55"
"67","000","00","033","3317","1083","734","557","177","32","766","2056","0","37.26","27.09"
"67","000","00","033","3317","1084","545","422","123","26","571","1373","0","41.59","30.74"
"67","000","00","033","3318","0000","943","726","217","69","1012","2109","0","47.98","34.42"
"67","000","00","033","3318","1093","441","331","110","41","482","1093","0","44.1","30.28"
"67","000","00","033","3318","1094","502","395","107","28","530","1016","0","52.17","38.88"
"67","000","00","033","3319","0000","945","701","244","104","1049","2162","0","48.52","32.42"
"67","000","00","033","3319","1091","356","257","99","34","390","897","0","43.48","28.65"
"67","000","00","033","3319","1092","589","444","145","70","659","1265","0","52.09","35.1"
"67","000","00","033","3320","0000","1227","928","299","154","1381","2544","0","54.28","36.48"
"67","000","00","033","3320","1089","568","436","132","72","640","1186","0","53.96","36.76"
"67","000","00","033","3320","1090","659","492","167","82","741","1358","0","54.57","36.23"
"67","000","00","033","3321","0000","1202","966","236","74","1276","2272","0","56.16","42.52"
"67","000","00","033","3321","1017","622","492","130","42","664","1150","0","57.74","42.78"
"67","000","00","033","3321","1018","580","474","106","32","612","1122","0","54.55","42.25"
"67","000","00","033","3322","0000","2112","1594","518","168","2280","4507","0","50.59","35.37"
"67","000","00","033","3322","1019","635","490","145","49","684","1444","0","47.37","33.93"
"67","000","00","033","3322","1020","799","605","194","64","863","1765","0","48.9","34.28"
"67","000","00","033","3322","1021","678","499","179","55","733","1298","0","56.47","38.44"
"67","000","00","033","3323","0000","1549","1199","350","124","1673","3392","0","49.32","35.35"
"67","000","00","033","3323","1015","626","491","135","43","669","1221","0","54.79","40.21"
"67","000","00","033","3323","1016","923","708","215","81","1004","2171","0","46.25","32.61"
"67","000","00","033","3324","0000","1647","1363","284","71","1718","3398","0","50.56","40.11"
"67","000","00","033","3324","1022","763","622","141","37","800","1458","0","54.87","42.66"
"67","000","00","033","3324","1023","884","741","143","34","918","1940","0","47.32","38.2"
"67","000","00","033","3325","0000","1082","803","279","80","1162","2298","0","50.57","34.94"
"67","000","00","033","3325","1033","619","452","167","51","670","1222","0","54.83","36.99"
"67","000","00","033","3325","1034","463","351","112","29","492","1076","0","45.72","32.62"
"67","000","00","033","3326","0000","1524","1115","409","144","1668","3341","0","49.93","33.37"
"67","000","00","033","3326","1061","814","601","213","91","905","1640","0","55.18","36.65"
"67","000","00","033","3326","1062","710","514","196","53","763","1701","0","44.86","30.22"
"67","000","00","033","3327","0000","1622","1219","403","119","1741","3306","0","52.66","36.87"
"67","000","00","033","3327","1039","755","547","208","76","831","1491","0","55.73","36.69"
"67","000","00","033","3327","1040","867","672","195","43","910","1815","0","50.14","37.02"
"67","000","00","033","3328","0000","2329","1727","602","221","2550","5017","0","50.83","34.42"
"67","000","00","033","3328","1044","780","575","205","89","869","1626","0","53.44","35.36"
"67","000","00","033","3328","1045","773","561","212","42","815","1761","0","46.28","31.86"
"67","000","00","033","3328","1046","776","591","185","90","866","1630","0","53.13","36.26"
"67","000","00","033","3329","0000","1031","779","252","78","1109","2734","0","40.56","28.49"
"67","000","00","033","3329","1068","504","378","126","28","532","1657","0","32.11","22.81"
"67","000","00","033","3329","1069","527","401","126","50","577","1077","0","53.57","37.23"
"67","000","00","033","3330","0000","2368","1747","621","218","2586","5719","0","45.22","30.55"
"67","000","00","033","3330","1072","799","623","176","41","840","1985","0","42.32","31.39"
"67","000","00","033","3330","1073","819","592","227","86","905","2017","0","44.87","29.35"
"67","000","00","033","3330","1074","750","532","218","91","841","1717","0","48.98","30.98"
"67","000","00","033","3331","0000","827","617","210","73","900","1624","0","55.42","37.99"
"67","000","00","033","3331","1075","461","355","106","45","506","929","0","54.47","38.21"
"67","000","00","033","3331","1076","366","262","104","28","394","695","0","56.69","37.7"
"67","000","00","033","3332","0000","2470","1862","608","188","2658","5094","0","52.18","36.55"
"67","000","00","033","3332","1065","943","724","219","90","1033","1774","0","58.23","40.81"
"67","000","00","033","3332","1066","761","558","203","69","830","1613","0","51.46","34.59"
"67","000","00","033","3332","1067","766","580","186","29","795","1707","0","46.57","33.98"
"67","000","00","033","3333","0000","1550","1223","327","215","1765","3568","0","49.47","34.28"
"67","000","00","033","3333","1063","640","499","141","107","747","1541","0","48.48","32.38"
"67","000","00","033","3333","1064","910","724","186","108","1018","2027","0","50.22","35.72"
"67","000","00","033","3334","0000","2211","1694","517","142","2353","4809","0","48.93","35.23"
"67","000","00","033","3334","1058","734","560","174","38","772","1781","0","43.35","31.44"
"67","000","00","033","3334","1059","813","630","183","62","875","1542","0","56.74","40.86"
"67","000","00","033","3334","1060","664","504","160","42","706","1486","0","47.51","33.92"
"67","000","00","033","3335","0000","2351","1798","553","146","2497","5092","0","49.04","35.31"
"67","000","00","033","3335","1041","646","498","148","26","672","1398","0","48.07","35.62"
"67","000","00","033","3335","1042","845","650","195","50","895","2107","0","42.48","30.85"
"67","000","00","033","3335","1043","860","650","210","70","930","1587","0","58.6","40.96"
"67","000","00","033","3336","0000","695","563","132","59","754","1781","0","42.34","31.61"
"67","000","00","033","3336","1077","393","311","82","30","423","997","0","42.43","31.19"
"67","000","00","033","3336","1078","302","252","50","29","331","784","0","42.22","32.14"
"67","000","00","033","3337","0000","841","627","214","129","970","1775","0","54.65","35.32"
"67","000","00","033","3337","1087","487","362","125","75","562","1031","0","54.51","35.11"
"67","000","00","033","3337","1088","354","265","89","54","408","744","0","54.84","35.62"
"67","000","00","033","3338","0000","745","543","202","104","849","1762","0","48.18","30.82"
"67","000","00","033","3338","1085","371","270","101","37","408","1002","0","40.72","26.95"
"67","000","00","033","3338","1086","374","273","101","67","441","760","0","58.03","35.92"
"67","000","00","033","3339","0000","1181","912","269","102","1283","2434","0","52.71","37.47"
"67","000","00","033","3339","1070","586","467","119","40","626","1185","0","52.83","39.41"
"67","000","00","033","3339","1071","595","445","150","62","657","1249","0","52.6","35.63"
"67","000","00","033","3340","0000","1818","1351","467","186","2004","3751","0","53.43","36.02"
"67","000","00","033","3340","1049","796","572","224","108","904","1727","0","52.35","33.12"
"67","000","00","033","3340","1050","588","443","145","58","646","1085","0","59.54","40.83"
"67","000","00","033","3340","1051","434","336","98","20","454","939","0","48.35","35.78"
"67","000","00","034","0000","0000","54688","41806","12882","3681","58369","110906","132020","52.63","37.69"
"67","000","00","034","3401","0000","1558","1207","351","131","1689","3501","0","48.24","34.48"
"67","000","00","034","3401","0850","830","654","176","79","909","1793","0","50.7","36.48"
"67","000","00","034","3401","0851","728","553","175","52","780","1708","0","45.67","32.38"
"67","000","00","034","3404","0000","1116","865","251","75","1191","2030","0","58.67","42.61"
"67","000","00","034","3404","0862","584","472","112","41","625","1076","0","58.09","43.87"
"67","000","00","034","3404","0863","532","393","139","34","566","954","0","59.33","41.19"
"67","000","00","034","3405","0000","1286","1015","271","70","1356","2451","0","55.32","41.41"
"67","000","00","034","3405","0858","579","454","125","35","614","1189","0","51.64","38.18"
"67","000","00","034","3405","0859","707","561","146","35","742","1262","0","58.8","44.45"
"67","000","00","034","3407","0000","975","756","219","35","1010","1964","0","51.43","38.49"
"67","000","00","034","3407","0867","479","369","110","16","495","974","0","50.82","37.89"
"67","000","00","034","3407","0868","496","387","109","19","515","990","0","52.02","39.09"
"67","000","00","034","3408","0000","1113","799","314","71","1184","2069","0","57.23","38.62"
"67","000","00","034","3408","0869","575","418","157","24","599","1016","0","58.96","41.14"
"67","000","00","034","3408","0870","538","381","157","47","585","1053","0","55.56","36.18"
"67","000","00","034","3418","0000","1942","1466","476","174","2116","4291","0","49.31","34.16"
"67","000","00","034","3418","0926","599","463","136","34","633","1502","0","42.14","30.83"
"67","000","00","034","3418","0927","730","552","178","49","779","1470","0","52.99","37.55"
"67","000","00","034","3418","0928","613","451","162","91","704","1319","0","53.37","34.19"
"67","000","00","034","3419","0000","979","763","216","46","1025","1864","0","54.99","40.93"
"67","000","00","034","3419","0860","569","449","120","26","595","1017","0","58.51","44.15"
"67","000","00","034","3419","0861","410","314","96","20","430","847","0","50.77","37.07"
"67","000","00","034","3420","0000","2572","1971","601","86","2658","4824","0","55.1","40.86"
"67","000","00","034","3420","0908","904","707","197","23","927","1709","0","54.24","41.37"
"67","000","00","034","3420","0909","866","678","188","43","909","1517","0","59.92","44.69"
"67","000","00","034","3420","0910","802","586","216","20","822","1598","0","51.44","36.67"
"67","000","00","034","3423","0000","1380","1033","347","90","1470","3203","0","45.89","32.25"
"67","000","00","034","3423","0894","481","364","117","20","501","1091","0","45.92","33.36"
"67","000","00","034","3423","0895","454","339","115","31","485","993","0","48.84","34.14"
"67","000","00","034","3423","0896","445","330","115","39","484","1119","0","43.25","29.49"
"67","000","00","034","3424","0000","2199","1687","512","164","2363","4442","0","53.2","37.98"
"67","000","00","034","3424","0897","836","635","201","86","922","1685","0","54.72","37.69"
"67","000","00","034","3424","0898","679","518","161","20","699","1368","0","51.1","37.87"
"67","000","00","034","3424","0899","684","534","150","58","742","1389","0","53.42","38.44"
"67","000","00","034","3425","0000","1599","1247","352","89","1688","3296","0","51.21","37.83"
"67","000","00","034","3425","0919","824","640","184","60","884","1662","0","53.19","38.51"
"67","000","00","034","3425","0920","775","607","168","29","804","1634","0","49.2","37.15"
"67","000","00","034","3426","0000","2563","1971","592","228","2791","5387","0","51.81","36.59"
"67","000","00","034","3426","0923","905","680","225","101","1006","1874","0","53.68","36.29"
"67","000","00","034","3426","0924","826","648","178","71","897","1760","0","50.97","36.82"
"67","000","00","034","3426","0925","832","643","189","56","888","1753","0","50.66","36.68"
"67","000","00","034","3432","0000","691","508","183","70","761","1466","0","51.91","34.65"
"67","000","00","034","3432","0871","691","508","183","70","761","1466","0","51.91","34.65"
"67","000","00","034","3433","0000","884","671","213","109","993","1829","0","54.29","36.69"
"67","000","00","034","3433","0884","451","335","116","63","514","892","0","57.62","37.56"
"67","000","00","034","3433","0885","433","336","97","46","479","937","0","51.12","35.86"
"67","000","00","034","3438","0000","1747","1364","383","73","1820","3800","0","47.89","35.89"
"67","000","00","034","3438","0852","488","391","97","22","510","997","0","51.15","39.22"
"67","000","00","034","3438","0853","617","480","137","33","650","1452","0","44.77","33.06"
"67","000","00","034","3438","0854","642","493","149","18","660","1351","0","48.85","36.49"
"67","000","00","034","3439","0000","1512","1146","366","135","1647","3079","0","53.49","37.22"
"67","000","00","034","3439","0872","775","589","186","70","845","1535","0","55.05","38.37"
"67","000","00","034","3439","0873","737","557","180","65","802","1544","0","51.94","36.08"
"67","000","00","034","3440","0000","2298","1766","532","137","2435","4317","0","56.4","40.91"
"67","000","00","034","3440","0905","713","548","165","69","782","1340","0","58.36","40.9"
"67","000","00","034","3440","0906","755","573","182","37","792","1464","0","54.1","39.14"
"67","000","00","034","3440","0907","830","645","185","31","861","1513","0","56.91","42.63"
"67","000","00","034","3441","0000","1544","1207","337","81","1625","2975","0","54.62","40.57"
"67","000","00","034","3441","0915","722","547","175","36","758","1391","0","54.49","39.32"
"67","000","00","034","3441","0916","822","660","162","45","867","1584","0","54.73","41.67"
"67","000","00","034","3442","0000","1871","1439","432","138","2009","3665","0","54.82","39.26"
"67","000","00","034","3442","0921","925","716","209","90","1015","1793","0","56.61","39.93"
"67","000","00","034","3442","0922","946","723","223","48","994","1872","0","53.1","38.62"
"67","000","00","034","3443","0000","1802","1387","415","109","1911","3596","0","53.14","38.57"
"67","000","00","034","3443","0929","963","760","203","69","1032","1876","0","55.01","40.51"
"67","000","00","034","3443","0930","839","627","212","40","879","1720","0","51.1","36.45"
"67","000","00","034","3444","0000","1998","1611","387","160","2158","4008","0","53.84","40.19"
"67","000","00","034","3444","0864","627","509","118","62","689","1300","0","53.0","39.15"
"67","000","00","034","3444","0865","675","555","120","54","729","1390","0","52.45","39.93"
"67","000","00","034","3444","0866","696","547","149","44","740","1318","0","56.15","41.5"
"67","000","00","034","3445","0000","1881","1421","460","137","2018","3534","0","57.1","40.21"
"67","000","00","034","3445","0855","757","572","185","68","825","1323","0","62.36","43.24"
"67","000","00","034","3445","0856","550","408","142","33","583","1073","0","54.33","38.02"
"67","000","00","034","3445","0857","574","441","133","36","610","1138","0","53.6","38.75"
"67","000","00","034","3446","0000","2678","2065","613","181","2859","5305","0","53.89","38.93"
"67","000","00","034","3446","0874","914","716","198","61","975","1760","0","55.4","40.68"
"67","000","00","034","3446","0875","584","427","157","36","620","1372","0","45.19","31.12"
"67","000","00","034","3446","0876","546","434","112","40","586","1002","0","58.48","43.31"
"67","000","00","034","3446","0877","634","488","146","44","678","1171","0","57.9","41.67"
"67","000","00","034","3447","0000","1814","1375","439","139","1953","3964","0","49.27","34.69"
"67","000","00","034","3447","0891","689","533","156","44","733","1522","0","48.16","35.02"
"67","000","00","034","3447","0892","596","451","145","33","629","1278","0","49.22","35.29"
"67","000","00","034","3447","0893","529","391","138","62","591","1164","0","50.77","33.59"
"67","000","00","034","3448","0000","2362","1920","442","163","2525","4860","0","51.95","39.51"
"67","000","00","034","3448","0878","578","484","94","25","603","1285","0","46.93","37.67"
"67","000","00","034","3448","0879","507","426","81","35","542","1036","0","52.32","41.12"
"67","000","00","034","3448","0880","698","573","125","48","746","1392","0","53.59","41.16"
"67","000","00","034","3448","0881","579","437","142","55","634","1147","0","55.27","38.1"
"67","000","00","034","3449","0000","1352","697","655","80","1432","3085","0","46.42","22.59"
"67","000","00","034","3449","0882","618","148","470","39","657","1526","0","43.05","9.7"
"67","000","00","034","3449","0883","734","549","185","41","775","1559","0","49.71","35.21"
"67","000","00","034","3450","0000","1297","979","318","74","1371","2797","0","49.02","35.0"
"67","000","00","034","3450","0889","646","473","173","61","707","1346","0","52.53","35.14"
"67","000","00","034","3450","0890","651","506","145","13","664","1451","0","45.76","34.87"
"67","000","00","034","3451","0000","1801","1353","448","191","1992","4176","0","47.7","32.4"
"67","000","00","034","3451","0886","737","550","187","92","829","1449","0","57.21","37.96"
"67","000","00","034","3451","0887","547","417","130","24","571","1160","0","49.22","35.95"
"67","000","00","034","3451","0888","517","386","131","75","592","1567","0","37.78","24.63"
"67","000","00","034","3452","0000","1663","1316","347","94","1757","3124","0","56.24","42.13"
"67","000","00","034","3452","0900","785","629","156","24","809","1469","0","55.07","42.82"
"67","000","00","034","3452","0901","878","687","191","70","948","1655","0","57.28","41.51"
"67","000","00","034","3453","0000","2175","1691","484","103","2278","4187","0","54.41","40.39"
"67","000","00","034","3453","0902","679","527","152","32","711","1261","0","56.38","41.79"
"67","000","00","034","3453","0903","715","563","152","26","741","1490","0","49.73","37.79"
"67","000","00","034","3453","0904","781","601","180","45","826","1436","0","57.52","41.85"
"67","000","00","034","3454","0000","1273","957","316","99","1372","2613","0","52.51","36.62"
"67","000","00","034","3454","0911","684","515","169","52","736","1399","0","52.61","36.81"
"67","000","00","034","3454","0912","589","442","147","47","636","1214","0","52.39","36.41"
"67","000","00","034","3455","0000","1215","935","280","79","1294","2212","0","58.5","42.27"
"67","000","00","034","3455","0913","567","446","121","27","594","1064","0","55.83","41.92"
"67","000","00","034","3455","0914","648","489","159","52","700","1148","0","60.98","42.6"
"67","000","00","034","3456","0000","1548","1218","330","70","1618","2992","0","54.08","40.71"
"67","000","00","034","3456","0917","850","675","175","38","888","1595","0","55.67","42.32"
"67","000","00","034","3456","0918","698","543","155","32","730","1397","0","52.25","38.87"
"67","000","00","035","0000","0000","75649","58644","17005","6515","82164","159654","193163","51.46","36.73"
"67","000","00","035","3501","0000","1253","983","270","47","1300","2549","0","51.0","38.56"
"67","000","00","035","3501","0618","1253","983","270","47","1300","2549","0","51.0","38.56"
"67","000","00","035","3502","0000","2126","1675","451","144","2270","4600","0","49.35","36.41"
"67","000","00","035","3502","0624","894","698","196","50","944","2143","0","44.05","32.57"
"67","000","00","035","3502","0625","1232","977","255","94","1326","2457","0","53.97","39.76"
"67","000","00","035","3503","0000","2182","1704","478","146","2328","4477","0","52.0","38.06"
"67","000","00","035","3503","0619","1065","826","239","73","1138","2321","0","49.03","35.59"
"67","000","00","035","3503","0620","1117","878","239","73","1190","2156","0","55.19","40.72"
"67","000","00","035","3504","0000","2404","1858","546","259","2663","4799","0","55.49","38.72"
"67","000","00","035","3504","0621","888","680","208","81","969","1662","0","58.3","40.91"
"67","000","00","035","3504","0622","767","603","164","106","873","1512","0","57.74","39.88"
"67","000","00","035","3504","0623","749","575","174","72","821","1625","0","50.52","35.38"
"67","000","00","035","3505","0000","2219","1713","506","204","2423","4512","0","53.7","37.97"
"67","000","00","035","3505","0626","1089","838","251","109","1198","2148","0","55.77","39.01"
"67","000","00","035","3505","0627","1130","875","255","95","1225","2364","0","51.82","37.01"
"67","000","00","035","3506","0000","1468","1165","303","144","1612","2805","0","57.47","41.53"
"67","000","00","035","3506","0644","783","628","155","58","841","1447","0","58.12","43.4"
"67","000","00","035","3506","0645","685","537","148","86","771","1358","0","56.77","39.54"
"67","000","00","035","3507","0000","1803","1364","439","167","1970","3494","0","56.38","39.04"
"67","000","00","035","3507","0639","871","635","236","93","964","1721","0","56.01","36.9"
"67","000","00","035","3507","0640","932","729","203","74","1006","1773","0","56.74","41.12"
"67","000","00","035","3508","0000","1993","1576","417","161","2154","4546","0","47.38","34.67"
"67","000","00","035","3508","0631","928","728","200","82","1010","2291","0","44.09","31.78"
"67","000","00","035","3508","0632","1065","848","217","79","1144","2255","0","50.73","37.61"
"67","000","00","035","3509","0000","2809","2179","630","202","3011","5977","0","50.38","36.46"
"67","000","00","035","3509","0633","852","640","212","81","933","1940","0","48.09","32.99"
"67","000","00","035","3509","0634","995","767","228","44","1039","2013","0","51.61","38.1"
"67","000","00","035","3509","0635","962","772","190","77","1039","2024","0","51.33","38.14"
"67","000","00","035","3510","0000","2946","2324","622","186","3132","5933","0","52.79","39.17"
"67","000","00","035","3510","0628","821","640","181","44","865","1868","0","46.31","34.26"
"67","000","00","035","3510","0629","964","768","196","79","1043","1797","0","58.04","42.74"
"67","000","00","035","3510","0630","1161","916","245","63","1224","2268","0","53.97","40.39"
"67","000","00","035","3511","0000","1047","827","220","114","1161","2188","0","53.06","37.8"
"67","000","00","035","3511","0654","1047","827","220","114","1161","2188","0","53.06","37.8"
"67","000","00","035","3512","0000","907","686","221","111","1018","1835","0","55.48","37.38"
"67","000","00","035","3512","0659","907","686","221","111","1018","1835","0","55.48","37.38"
"67","000","00","035","3513","0000","2016","1577","439","182","2198","4646","0","47.31","33.94"
"67","000","00","035","3513","0655","1064","845","219","107","1171","2399","0","48.81","35.22"
"67","000","00","035","3513","0656","952","732","220","75","1027","2247","0","45.71","32.58"
"67","000","00","035","3514","0000","646","493","153","74","720","1165","0","61.8","42.32"
"67","000","00","035","3514","0657","646","493","153","74","720","1165","0","61.8","42.32"
"67","000","00","035","3515","0000","2379","1846","533","231","2610","5476","0","47.66","33.71"
"67","000","00","035","3515","0670","601","491","110","94","695","1547","0","44.93","31.74"
"67","000","00","035","3515","0671","827","623","204","71","898","1784","0","50.34","34.92"
"67","000","00","035","3515","0672","951","732","219","66","1017","2145","0","47.41","34.13"
"67","000","00","035","3516","0000","1333","1053","280","122","1455","2728","0","53.34","38.6"
"67","000","00","035","3516","0668","875","698","177","67","942","1763","0","53.43","39.59"
"67","000","00","035","3516","0669","458","355","103","55","513","965","0","53.16","36.79"
"67","000","00","035","3517","0000","1067","823","244","146","1213","1978","0","61.32","41.61"
"67","000","00","035","3517","0693","495","366","129","57","552","905","0","60.99","40.44"
"67","000","00","035","3517","0694","572","457","115","89","661","1073","0","61.6","42.59"
"67","000","00","035","3518","0000","3468","2710","758","236","3704","7488","0","49.47","36.19"
"67","000","00","035","3518","0673","1226","986","240","72","1298","2443","0","53.13","40.36"
"67","000","00","035","3518","0674","1054","810","244","67","1121","2565","0","43.7","31.58"
"67","000","00","035","3518","0675","1188","914","274","97","1285","2480","0","51.81","36.85"
"67","000","00","035","3519","0000","555","417","138","65","620","977","0","63.46","42.68"
"67","000","00","035","3519","0662","555","417","138","65","620","977","0","63.46","42.68"
"67","000","00","035","3520","0000","2010","1552","458","193","2203","4517","0","48.77","34.36"
"67","000","00","035","3520","0676","951","747","204","104","1055","2349","0","44.91","31.8"
"67","000","00","035","3520","0677","1059","805","254","89","1148","2168","0","52.95","37.13"
"67","000","00","035","3521","0000","1478","1114","364","149","1627","3228","0","50.4","34.51"
"67","000","00","035","3521","0666","627","476","151","70","697","1319","0","52.84","36.09"
"67","000","00","035","3521","0667","851","638","213","79","930","1909","0","48.72","33.42"
"67","000","00","035","3522","0000","1575","1240","335","116","1691","3339","0","50.64","37.14"
"67","000","00","035","3522","0663","712","563","149","41","753","1642","0","45.86","34.29"
"67","000","00","035","3522","0664","863","677","186","75","938","1697","0","55.27","39.89"
"67","000","00","035","3523","0000","850","676","174","58","908","1966","0","46.19","34.38"
"67","000","00","035","3523","0665","850","676","174","58","908","1966","0","46.19","34.38"
"67","000","00","035","3524","0000","816","648","168","56","872","1501","0","58.09","43.17"
"67","000","00","035","3524","0707","816","648","168","56","872","1501","0","58.09","43.17"
"67","000","00","035","3525","0000","863","642","221","105","968","1797","0","53.87","35.73"
"67","000","00","035","3525","0660","863","642","221","105","968","1797","0","53.87","35.73"
"67","000","00","035","3526","0000","975","737","238","105","1080","2223","0","48.58","33.15"
"67","000","00","035","3526","0661","975","737","238","105","1080","2223","0","48.58","33.15"
"67","000","00","035","3527","0000","833","658","175","76","909","1579","0","57.57","41.67"
"67","000","00","035","3527","0695","833","658","175","76","909","1579","0","57.57","41.67"
"67","000","00","035","3528","0000","600","456","144","39","639","1462","0","43.71","31.19"
"67","000","00","035","3528","0700","600","456","144","39","639","1462","0","43.71","31.19"
"67","000","00","035","3529","0000","529","423","106","67","596","1044","0","57.09","40.52"
"67","000","00","035","3529","0701","529","423","106","67","596","1044","0","57.09","40.52"
"67","000","00","035","3530","0000","1390","1069","321","175","1565","3070","0","50.98","34.82"
"67","000","00","035","3530","0696","846","647","199","119","965","1876","0","51.44","34.49"
"67","000","00","035","3530","0697","544","422","122","56","600","1194","0","50.25","35.34"
"67","000","00","035","3531","0000","613","491","122","27","640","1380","0","46.38","35.58"
"67","000","00","035","3531","0699","613","491","122","27","640","1380","0","46.38","35.58"
"67","000","00","035","3532","0000","513","410","103","30","543","1475","0","36.81","27.8"
"67","000","00","035","3532","0698","513","410","103","30","543","1475","0","36.81","27.8"
"67","000","00","035","3533","0000","711","537","174","82","793","1293","0","61.33","41.53"
"67","000","00","035","3533","0702","340","260","80","55","395","603","0","65.51","43.12"
"67","000","00","035","3533","0703","371","277","94","27","398","690","0","57.68","40.14"
"67","000","00","035","3534","0000","648","490","158","68","716","1447","0","49.48","33.86"
"67","000","00","035","3534","0704","648","490","158","68","716","1447","0","49.48","33.86"
"67","000","00","035","3535","0000","549","431","118","48","597","910","0","65.6","47.36"
"67","000","00","035","3535","0705","549","431","118","48","597","910","0","65.6","47.36"
"67","000","00","035","3536","0000","796","632","164","95","891","1850","0","48.16","34.16"
"67","000","00","035","3536","0706","796","632","164","95","891","1850","0","48.16","34.16"
"67","000","00","035","3537","0000","1034","802","232","80","1114","2143","0","51.98","37.42"
"67","000","00","035","3537","0638","1034","802","232","80","1114","2143","0","51.98","37.42"
"67","000","00","035","3538","0000","1435","1096","339","133","1568","2791","0","56.18","39.27"
"67","000","00","035","3538","0636","888","670","218","92","980","1613","0","60.76","41.54"
"67","000","00","035","3538","0637","547","426","121","41","588","1178","0","49.92","36.16"
"67","000","00","035","3539","0000","2193","1682","511","151","2344","4412","0","53.13","38.12"
"67","000","00","035","3539","0641","697","538","159","25","722","1428","0","50.56","37.68"
"67","000","00","035","3539","0642","824","635","189","67","891","1626","0","54.8","39.05"
"67","000","00","035","3539","0643","672","509","163","59","731","1358","0","53.83","37.48"
"67","000","00","035","3540","0000","1614","1251","363","178","1792","3120","0","57.44","40.1"
"67","000","00","035","3540","0680","892","713","179","117","1009","1627","0","62.02","43.82"
"67","000","00","035","3540","0681","722","538","184","61","783","1493","0","52.44","36.03"
"67","000","00","035","3541","0000","2080","1593","487","173","2253","4273","0","52.73","37.28"
"67","000","00","035","3541","0682","700","515","185","84","784","1397","0","56.12","36.86"
"67","000","00","035","3541","0683","669","528","141","61","730","1416","0","51.55","37.29"
"67","000","00","035","3541","0684","711","550","161","28","739","1460","0","50.62","37.67"
"67","000","00","035","3542","0000","1590","1226","364","117","1707","3661","0","46.63","33.49"
"67","000","00","035","3542","0691","774","578","196","75","849","1815","0","46.78","31.85"
"67","000","00","035","3542","0692","816","648","168","42","858","1846","0","46.48","35.1"
"67","000","00","035","3543","0000","1958","1508","450","107","2065","4437","0","46.54","33.99"
"67","000","00","035","3543","0646","941","714","227","60","1001","2116","0","47.31","33.74"
"67","000","00","035","3543","0647","1017","794","223","47","1064","2321","0","45.84","34.21"
"67","000","00","035","3544","0000","1844","1422","422","122","1966","4044","0","48.62","35.16"
"67","000","00","035","3544","0648","966","773","193","49","1015","2117","0","47.95","36.51"
"67","000","00","035","3544","0649","878","649","229","73","951","1927","0","49.35","33.68"
"67","000","00","035","3545","0000","2041","1578","463","195","2236","4576","0","48.86","34.48"
"67","000","00","035","3545","0650","1000","765","235","142","1142","2242","0","50.94","34.12"
"67","000","00","035","3545","0651","1041","813","228","53","1094","2334","0","46.87","34.83"
"67","000","00","035","3546","0000","1871","1456","415","177","2048","3809","0","53.77","38.23"
"67","000","00","035","3546","0686","988","778","210","107","1095","2070","0","52.9","37.58"
"67","000","00","035","3546","0687","883","678","205","70","953","1739","0","54.8","38.99"
"67","000","00","035","3547","0000","1432","1133","299","113","1545","3305","0","46.75","34.28"
"67","000","00","035","3547","0678","761","607","154","62","823","1630","0","50.49","37.24"
"67","000","00","035","3547","0679","671","526","145","51","722","1675","0","43.1","31.4"
"67","000","00","035","3548","0000","705","551","154","60","765","1539","0","49.71","35.8"
"67","000","00","035","3548","0658","705","551","154","60","765","1539","0","49.71","35.8"
"67","000","00","035","3549","0000","909","699","210","51","960","2222","0","43.2","31.46"
"67","000","00","035","3549","0685","909","699","210","51","960","2222","0","43.2","31.46"
"67","000","00","035","3550","0000","2747","2102","645","257","3004","5433","0","55.29","38.69"
"67","000","00","035","3550","0688","835","657","178","102","937","1830","0","51.2","35.9"
"67","000","00","035","3550","0689","973","743","230","81","1054","1803","0","58.46","41.21"
"67","000","00","035","3550","0690","939","702","237","74","1013","1800","0","56.28","39.0"
"67","000","00","035","3551","0000","1826","1366","460","171","1997","3635","0","54.94","37.58"
"67","000","00","035","3551","0652","922","698","224","68","990","1822","0","54.34","38.31"
"67","000","00","035","3551","0653","904","668","236","103","1007","1813","0","55.54","36.85"
"67","000","00","036","0000","0000","25909","19987","5922","1649","27558","55379","66677","49.76","36.09"
"67","000","00","036","3602","0000","902","706","196","83","985","2001","0","49.23","35.28"
"67","000","00","036","3602","1014","902","706","196","83","985","2001","0","49.23","35.28"
"67","000","00","036","3604","0000","167","125","42","11","178","438","0","40.64","28.54"
"67","000","00","036","3604","1007","167","125","42","11","178","438","0","40.64","28.54"
"67","000","00","036","3605","0000","2369","1831","538","133","2502","4954","0","50.5","36.96"
"67","000","00","036","3605","0986","1177","903","274","75","1252","2547","0","49.16","35.45"
"67","000","00","036","3605","0987","1192","928","264","58","1250","2407","0","51.93","38.55"
"67","000","00","036","3606","0000","1904","1459","445","90","1994","4202","0","47.45","34.72"
"67","000","00","036","3606","0988","883","695","188","49","932","2070","0","45.02","33.57"
"67","000","00","036","3606","0989","1021","764","257","41","1062","2132","0","49.81","35.83"
"67","000","00","036","3607","0000","2336","1804","532","130","2466","4810","0","51.27","37.51"
"67","000","00","036","3607","0990","729","561","168","27","756","1450","0","52.14","38.69"
"67","000","00","036","3607","0991","741","575","166","29","770","1605","0","47.98","35.83"
"67","000","00","036","3607","0992","866","668","198","74","940","1755","0","53.56","38.06"
"67","000","00","036","3608","0000","3202","2479","723","192","3394","7011","0","48.41","35.36"
"67","000","00","036","3608","0993","762","593","169","51","813","1728","0","47.05","34.32"
"67","000","00","036","3608","0994","683","512","171","35","718","1754","0","40.94","29.19"
"67","000","00","036","3608","0995","816","645","171","56","872","1686","0","51.72","38.26"
"67","000","00","036","3608","0996","941","729","212","50","991","1843","0","53.77","39.56"
"67","000","00","036","3609","0000","2528","1991","537","191","2719","4994","0","54.45","39.87"
"67","000","00","036","3609","0983","881","679","202","83","964","1753","0","54.99","38.73"
"67","000","00","036","3609","0984","893","718","175","55","948","1859","0","51.0","38.62"
"67","000","00","036","3609","0985","754","594","160","53","807","1382","0","58.39","42.98"
"67","000","00","036","3610","0000","3318","2539","779","210","3528","6842","0","51.56","37.11"
"67","000","00","036","3610","1003","855","665","190","66","921","1675","0","54.99","39.7"
"67","000","00","036","3610","1004","954","704","250","58","1012","1979","0","51.14","35.57"
"67","000","00","036","3610","1005","757","573","184","35","792","1602","0","49.44","35.77"
"67","000","00","036","3610","1006","752","597","155","51","803","1586","0","50.63","37.64"
"67","000","00","036","3611","0000","3450","2716","734","150","3600","7611","0","47.3","35.69"
"67","000","00","036","3611","0999","747","560","187","23","770","1653","0","46.58","33.88"
"67","000","00","036","3611","1000","772","628","144","26","798","1697","0","47.02","37.01"
"67","000","00","036","3611","1001","962","762","200","45","1007","2154","0","46.75","35.38"
"67","000","00","036","3611","1002","969","766","203","56","1025","2107","0","48.65","36.36"
"67","000","00","036","3612","0000","1461","1139","322","78","1539","2853","0","53.94","39.92"
"67","000","00","036","3612","0997","824","628","196","46","870","1565","0","55.59","40.13"
"67","000","00","036","3612","0998","637","511","126","32","669","1288","0","51.94","39.67"
"67","000","00","036","3615","0000","1532","1155","377","115","1647","3403","0","48.4","33.94"
"67","000","00","036","3615","1008","814","622","192","82","896","1780","0","50.34","34.94"
"67","000","00","036","3615","1009","718","533","185","33","751","1623","0","46.27","32.84"
"67","000","00","036","3616","0000","1508","1114","394","151","1659","3443","0","48.18","32.36"
"67","000","00","036","3616","1010","953","707","246","104","1057","2157","0","49.0","32.78"
"67","000","00","036","3616","1011","555","407","148","47","602","1286","0","46.81","31.65"
"67","000","00","036","3617","0000","1232","929","303","115","1347","2817","0","47.82","32.98"
"67","000","00","036","3617","1012","702","520","182","80","782","1492","0","52.41","34.85"
"67","000","00","036","3617","1013","530","409","121","35","565","1325","0","42.64","30.87"
"67","000","00","037","0000","0000","33015","24805","8210","2651","35666","65261","78093","54.65","38.01"
"67","000","00","037","3705","0000","1928","1417","511","187","2115","3854","0","54.88","36.77"
"67","000","00","037","3705","0931","677","493","184","57","734","1332","0","55.11","37.01"
"67","000","00","037","3705","0932","638","478","160","74","712","1246","0","57.14","38.36"
"67","000","00","037","3705","0933","613","446","167","56","669","1276","0","52.43","34.95"
"67","000","00","037","3707","0000","1610","1212","398","112","1722","3047","0","56.51","39.78"
"67","000","00","037","3707","0934","829","629","200","58","887","1583","0","56.03","39.73"
"67","000","00","037","3707","0935","781","583","198","54","835","1464","0","57.04","39.82"
"67","000","00","037","3709","0000","1342","1000","342","71","1413","2602","0","54.3","38.43"
"67","000","00","037","3709","0936","604","467","137","24","628","1234","0","50.89","37.84"
"67","000","00","037","3709","0937","738","533","205","47","785","1368","0","57.38","38.96"
"67","000","00","037","3711","0000","1148","836","312","91","1239","2538","0","48.82","32.94"
"67","000","00","037","3711","0938","566","428","138","32","598","1322","0","45.23","32.38"
"67","000","00","037","3711","0939","582","408","174","59","641","1216","0","52.71","33.55"
"67","000","00","037","3716","0000","1268","920","348","90","1358","2526","0","53.76","36.42"
"67","000","00","037","3716","0940","624","429","195","41","665","1289","0","51.59","33.28"
"67","000","00","037","3716","0941","644","491","153","49","693","1237","0","56.02","39.69"
"67","000","00","037","3722","0000","1699","1257","442","161","1860","3455","0","53.84","36.38"
"67","000","00","037","3722","0942","518","374","144","33","551","1189","0","46.34","31.46"
"67","000","00","037","3722","0943","606","439","167","67","673","1201","0","56.04","36.55"
"67","000","00","037","3722","0944","575","444","131","61","636","1065","0","59.72","41.69"
"67","000","00","037","3725","0000","1936","1498","438","128","2064","3505","0","58.89","42.74"
"67","000","00","037","3725","0945","551","425","126","45","596","1055","0","56.49","40.28"
"67","000","00","037","3725","0946","668","518","150","43","711","1170","0","60.77","44.27"
"67","000","00","037","3725","0947","717","555","162","40","757","1280","0","59.14","43.36"
"67","000","00","037","3731","0000","1336","1017","319","107","1443","2515","0","57.38","40.44"
"67","000","00","037","3731","0948","647","479","168","42","689","1223","0","56.34","39.17"
"67","000","00","037","3731","0949","689","538","151","65","754","1292","0","58.36","41.64"
"67","000","00","037","3733","0000","2896","2181","715","173","3069","5398","0","56.85","40.4"
"67","000","00","037","3733","0950","551","412","139","17","568","993","0","57.2","41.49"
"67","000","00","037","3733","0951","781","580","201","47","828","1541","0","53.73","37.64"
"67","000","00","037","3733","0952","910","694","216","76","986","1652","0","59.69","42.01"
"67","000","00","037","3733","0953","654","495","159","33","687","1212","0","56.68","40.84"
"67","000","00","037","3734","0000","2520","1884","636","172","2692","4876","0","55.21","38.64"
"67","000","00","037","3734","0954","856","651","205","67","923","1621","0","56.94","40.16"
"67","000","00","037","3734","0955","861","630","231","45","906","1660","0","54.58","37.95"
"67","000","00","037","3734","0956","803","603","200","60","863","1595","0","54.11","37.81"
"67","000","00","037","3739","0000","1839","1377","462","171","2010","3557","0","56.51","38.71"
"67","000","00","037","3739","0957","703","519","184","59","762","1436","0","53.06","36.14"
"67","000","00","037","3739","0958","660","487","173","62","722","1265","0","57.08","38.5"
"67","000","00","037","3739","0959","476","371","105","50","526","856","0","61.45","43.34"
"67","000","00","037","3740","0000","1728","1251","477","156","1884","3297","0","57.14","37.94"
"67","000","00","037","3740","0960","562","392","170","53","615","1168","0","52.65","33.56"
"67","000","00","037","3740","0961","615","456","159","43","658","1134","0","58.02","40.21"
"67","000","00","037","3740","0962","551","403","148","60","611","995","0","61.41","40.5"
"67","000","00","037","3741","0000","1454","1162","292","95","1549","2578","0","60.09","45.07"
"67","000","00","037","3741","0963","758","622","136","43","801","1313","0","61.01","47.37"
"67","000","00","037","3741","0964","696","540","156","52","748","1265","0","59.13","42.69"
"67","000","00","037","3742","0000","1558","1187","371","153","1711","3150","0","54.32","37.68"
"67","000","00","037","3742","0965","601","455","146","50","651","1215","0","53.58","37.45"
"67","000","00","037","3742","0966","625","497","128","58","683","1248","0","54.73","39.82"
"67","000","00","037","3742","0967","332","235","97","45","377","687","0","54.88","34.21"
"67","000","00","037","3743","0000","1086","823","263","114","1200","2110","0","56.87","39.0"
"67","000","00","037","3743","0968","564","423","141","70","634","1139","0","55.66","37.14"
"67","000","00","037","3743","0969","522","400","122","44","566","971","0","58.29","41.19"
"67","000","00","037","3744","0000","1792","1379","413","168","1960","3978","0","49.27","34.67"
"67","000","00","037","3744","0970","484","364","120","59","543","1254","0","43.3","29.03"
"67","000","00","037","3744","0971","493","391","102","37","530","979","0","54.14","39.94"
"67","000","00","037","3744","0972","815","624","191","72","887","1745","0","50.83","35.76"
"67","000","00","037","3745","0000","1192","867","325","96","1288","2510","0","51.31","34.54"
"67","000","00","037","3745","0973","528","374","154","51","579","1074","0","53.91","34.82"
"67","000","00","037","3745","0974","664","493","171","45","709","1436","0","49.37","34.33"
"67","000","00","037","3746","0000","1019","767","252","106","1125","2029","0","55.45","37.8"
"67","000","00","037","3746","0975","434","314","120","55","489","865","0","56.53","36.3"
"67","000","00","037","3746","0976","585","453","132","51","636","1164","0","54.64","38.92"
"67","000","00","037","3747","0000","1784","1327","457","130","1914","4067","0","47.06","32.63"
"67","000","00","037","3747","0977","573","412","161","24","597","1285","0","46.46","32.06"
"67","000","00","037","3747","0978","539","400","139","52","591","1078","0","54.82","37.11"
"67","000","00","037","3747","0979","672","515","157","54","726","1704","0","42.61","30.22"
"67","000","00","037","3748","0000","1880","1443","437","170","2050","3669","0","55.87","39.33"
"67","000","00","037","3748","0980","670","514","156","83","753","1296","0","58.1","39.66"
"67","000","00","037","3748","0981","577","447","130","42","619","1128","0","54.88","39.63"
"67","000","00","037","3748","0982","633","482","151","45","678","1245","0","54.46","38.71"
"64","000","00","000","0000","0000","1263139","990802","272337","92579","1355718","2353342","2772624","57.61","42.1"
"64","000","00","001","0000","0000","11234","8437","2797","652","11886","21617","24098","54.98","39.03"
"64","000","00","001","0101","0000","760","548","212","48","808","1304","0","61.96","42.02"
"64","000","00","001","0101","0845","760","548","212","48","808","1304","0","61.96","42.02"
"64","000","00","001","0102","0000","194","154","40","23","217","357","0","60.78","43.14"
"64","000","00","001","0102","0846","194","154","40","23","217","357","0","60.78","43.14"
"64","000","00","001","0103","0000","349","254","95","26","375","651","0","57.6","39.02"
"64","000","00","001","0103","0847","349","254","95","26","375","651","0","57.6","39.02"
"64","000","00","001","0104","0000","612","460","152","26","638","1322","0","48.26","34.8"
"64","000","00","001","0104","0848","612","460","152","26","638","1322","0","48.26","34.8"
"64","000","00","001","0105","0000","573","445","128","20","593","1056","0","56.16","42.14"
"64","000","00","001","0105","0849","573","445","128","20","593","1056","0","56.16","42.14"
"64","000","00","001","0106","0000","1065","805","260","51","1116","2034","0","54.87","39.58"
"64","000","00","001","0106","0850","491","363","128","21","512","904","0","56.64","40.15"
"64","000","00","001","0106","0851","574","442","132","30","604","1130","0","53.45","39.12"
"64","000","00","001","0107","0000","482","401","81","19","501","840","0","59.64","47.74"
"64","000","00","001","0107","0852","482","401","81","19","501","840","0","59.64","47.74"
"64","000","00","001","0108","0000","403","297","106","32","435","616","0","70.62","48.21"
"64","000","00","001","0108","0853","403","297","106","32","435","616","0","70.62","48.21"
"64","000","00","001","0109","0000","670","491","179","45","715","1397","0","51.18","35.15"
"64","000","00","001","0109","0854","670","491","179","45","715","1397","0","51.18","35.15"
"64","000","00","001","0110","0000","403","279","124","16","419","766","0","54.7","36.42"
"64","000","00","001","0110","0855","403","279","124","16","419","766","0","54.7","36.42"
"64","000","00","001","0111","0000","922","694","228","59","981","1644","0","59.67","42.21"
"64","000","00","001","0111","0856","464","354","110","44","508","839","0","60.55","42.19"
"64","000","00","001","0111","0857","458","340","118","15","473","805","0","58.76","42.24"
"64","000","00","001","0112","0000","371","288","83","23","394","750","0","52.53","38.4"
"64","000","00","001","0112","0858","371","288","83","23","394","750","0","52.53","38.4"
"64","000","00","001","0113","0000","497","366","131","35","532","986","0","53.96","37.12"
"64","000","00","001","0113","0859","497","366","131","35","532","986","0","53.96","37.12"
"64","000","00","001","0114","0000","479","372","107","16","495","1068","0","46.35","34.83"
"64","000","00","001","0114","0860","479","372","107","16","495","1068","0","46.35","34.83"
"64","000","00","001","0115","0000","577","424","153","55","632","1060","0","59.62","40.0"
"64","000","00","001","0115","0861","577","424","153","55","632","1060","0","59.62","40.0"
"64","000","00","001","0116","0000","404","302","102","37","441","805","0","54.78","37.52"
"64","000","00","001","0116","0862","404","302","102","37","441","805","0","54.78","37.52"
"64","000","00","001","0117","0000","933","711","222","49","982","1994","0","49.25","35.66"
"64","000","00","001","0117","0863","498","382","116","19","517","1073","0","48.18","35.6"
"64","000","00","001","0117","0864","435","329","106","30","465","921","0","50.49","35.72"
"64","000","00","001","0118","0000","598","455","143","22","620","1171","0","52.95","38.86"
"64","000","00","001","0118","0865","598","455","143","22","620","1171","0","52.95","38.86"
"64","000","00","001","0119","0000","319","231","88","18","337","594","0","56.73","38.89"
"64","000","00","001","0119","0866","319","231","88","18","337","594","0","56.73","38.89"
"64","000","00","001","0120","0000","330","252","78","17","347","592","0","58.61","42.57"
"64","000","00","001","0120","0867","330","252","78","17","347","592","0","58.61","42.57"
"64","000","00","001","0121","0000","293","208","85","15","308","610","0","50.49","34.1"
"64","000","00","001","0121","0868","293","208","85","15","308","610","0","50.49","34.1"
"64","000","00","002","0000","0000","63042","49511","13531","3914","66956","114979","139894","58.23","43.06"
"64","000","00","002","0201","0000","1078","873","205","67","1145","1959","0","58.45","44.56"
"64","000","00","002","0201","0768","469","379","90","21","490","959","0","51.09","39.52"
"64","000","00","002","0201","0769","609","494","115","46","655","1000","0","65.5","49.4"
"64","000","00","002","0202","0000","1147","942","205","67","1214","1995","0","60.85","47.22"
"64","000","00","002","0202","0770","490","391","99","13","503","910","0","55.27","42.97"
"64","000","00","002","0202","0771","657","551","106","54","711","1085","0","65.53","50.78"
"64","000","00","002","0203","0000","2234","1818","416","135","2369","4147","0","57.13","43.84"
"64","000","00","002","0203","0772","663","517","146","46","709","1484","0","47.78","34.84"
"64","000","00","002","0203","0773","784","646","138","27","811","1393","0","58.22","46.37"
"64","000","00","002","0203","0774","787","655","132","62","849","1270","0","66.85","51.57"
"64","000","00","002","0204","0000","1837","1389","448","127","1964","3402","0","57.73","40.83"
"64","000","00","002","0204","0775","527","416","111","49","576","1055","0","54.6","39.43"
"64","000","00","002","0204","0776","625","462","163","30","655","1172","0","55.89","39.42"
"64","000","00","002","0204","0777","685","511","174","48","733","1175","0","62.38","43.49"
"64","000","00","002","0205","0000","693","527","166","46","739","1274","0","58.01","41.37"
"64","000","00","002","0205","0778","693","527","166","46","739","1274","0","58.01","41.37"
"64","000","00","002","0206","0000","503","394","109","52","555","1085","0","51.15","36.31"
"64","000","00","002","0206","0779","503","394","109","52","555","1085","0","51.15","36.31"
"64","000","00","002","0207","0000","1368","1064","304","120","1488","2444","0","60.88","43.54"
"64","000","00","002","0207","0780","785","643","142","69","854","1470","0","58.1","43.74"
"64","000","00","002","0207","0781","583","421","162","51","634","974","0","65.09","43.22"
"64","000","00","002","0208","0000","2018","1532","486","174","2192","3719","0","58.94","41.19"
"64","000","00","002","0208","0782","717","541","176","88","805","1275","0","63.14","42.43"
"64","000","00","002","0208","0783","633","479","154","56","689","1206","0","57.13","39.72"
"64","000","00","002","0208","0784","668","512","156","30","698","1238","0","56.38","41.36"
"64","000","00","002","0209","0000","480","440","40","16","496","721","0","68.79","61.03"
"64","000","00","002","0209","0785","480","440","40","16","496","721","0","68.79","61.03"
"64","000","00","002","0210","0000","615","483","132","28","643","1220","0","52.7","39.59"
"64","000","00","002","0210","0786","615","483","132","28","643","1220","0","52.7","39.59"
"64","000","00","002","0211","0000","866","679","187","49","915","1966","0","46.54","34.54"
"64","000","00","002","0211","0787","866","679","187","49","915","1966","0","46.54","34.54"
"64","000","00","002","0212","0000","1678","1290","388","95","1773","3442","0","51.51","37.48"
"64","000","00","002","0212","0788","835","615","220","69","904","1722","0","52.5","35.71"
"64","000","00","002","0212","0789","843","675","168","26","869","1720","0","50.52","39.24"
"64","000","00","002","0213","0000","1275","992","283","151","1426","2656","0","53.69","37.35"
"64","000","00","002","0213","0790","696","545","151","105","801","1287","0","62.24","42.35"
"64","000","00","002","0213","0791","579","447","132","46","625","1369","0","45.65","32.65"
"64","000","00","002","0214","0000","1602","1292","310","80","1682","2992","0","56.22","43.18"
"64","000","00","002","0214","0792","715","580","135","27","742","1222","0","60.72","47.46"
"64","000","00","002","0214","0793","887","712","175","53","940","1770","0","53.11","40.23"
"64","000","00","002","0215","0000","8478","6514","1964","393","8871","14867","0","59.67","43.82"
"64","000","00","002","0215","0794","1029","798","231","36","1065","1860","0","57.26","42.9"
"64","000","00","002","0215","0795","986","667","319","52","1038","1857","0","55.9","35.92"
"64","000","00","002","0215","0796","1023","791","232","47","1070","1841","0","58.12","42.97"
"64","000","00","002","0215","0797","1058","846","212","67","1125","1830","0","61.48","46.23"
"64","000","00","002","0215","0798","1007","790","217","65","1072","1809","0","59.26","43.67"
"64","000","00","002","0215","0799","1098","873","225","37","1135","1894","0","59.93","46.09"
"64","000","00","002","0215","0800","1121","875","246","30","1151","1882","0","61.16","46.49"
"64","000","00","002","0215","0801","1156","874","282","59","1215","1894","0","64.15","46.15"
"64","000","00","002","0216","0000","12384","9766","2618","485","12869","20876","0","61.64","46.78"
"64","000","00","002","0216","0802","966","781","185","40","1006","1745","0","57.65","44.76"
"64","000","00","002","0216","0803","1020","815","205","19","1039","1887","0","55.06","43.19"
"64","000","00","002","0216","0804","1171","911","260","59","1230","1891","0","65.04","48.18"
"64","000","00","002","0216","0805","1109","868","241","55","1164","1903","0","61.17","45.61"
"64","000","00","002","0216","0806","1159","864","295","50","1209","1998","0","60.51","43.24"
"64","000","00","002","0216","0807","1124","919","205","48","1172","1912","0","61.3","48.06"
"64","000","00","002","0216","0808","1133","890","243","67","1200","1923","0","62.4","46.28"
"64","000","00","002","0216","0809","1138","886","252","29","1167","1888","0","61.81","46.93"
"64","000","00","002","0216","0810","1122","898","224","20","1142","1873","0","60.97","47.94"
"64","000","00","002","0216","0811","1255","975","280","50","1305","1959","0","66.62","49.77"
"64","000","00","002","0216","0812","1187","959","228","48","1235","1897","0","65.1","50.55"
"64","000","00","002","0217","0000","9241","7403","1838","376","9617","16100","0","59.73","45.98"
"64","000","00","002","0217","0813","1392","1119","273","43","1435","2362","0","60.75","47.38"
"64","000","00","002","0217","0814","1094","859","235","71","1165","1850","0","62.97","46.43"
"64","000","00","002","0217","0815","1144","902","242","34","1178","1928","0","61.1","46.78"
"64","000","00","002","0217","0816","1065","873","192","32","1097","1937","0","56.63","45.07"
"64","000","00","002","0217","0817","1188","966","222","74","1262","2123","0","59.44","45.5"
"64","000","00","002","0217","0818","1045","813","232","40","1085","1861","0","58.3","43.69"
"64","000","00","002","0217","0819","1065","882","183","27","1092","1892","0","57.72","46.62"
"64","000","00","002","0217","0820","1248","989","259","55","1303","2147","0","60.69","46.06"
"64","000","00","002","0218","0000","2233","1784","449","83","2316","3938","0","58.81","45.3"
"64","000","00","002","0218","0821","1109","898","211","51","1160","1897","0","61.15","47.34"
"64","000","00","002","0218","0822","1124","886","238","32","1156","2041","0","56.64","43.41"
"64","000","00","002","0219","0000","1770","1413","357","115","1885","3176","0","59.35","44.49"
"64","000","00","002","0219","0823","720","589","131","56","776","1309","0","59.28","45.0"
"64","000","00","002","0219","0824","1050","824","226","59","1109","1867","0","59.4","44.13"
"64","000","00","002","0220","0000","1594","1271","323","89","1683","2556","0","65.85","49.73"
"64","000","00","002","0220","0825","743","598","145","39","782","1152","0","67.88","51.91"
"64","000","00","002","0220","0826","851","673","178","50","901","1404","0","64.17","47.93"
"64","000","00","002","0221","0000","424","327","97","24","448","1210","0","37.02","27.02"
"64","000","00","002","0221","0827","424","327","97","24","448","1210","0","37.02","27.02"
"64","000","00","002","0222","0000","576","423","153","51","627","1135","0","55.24","37.27"
"64","000","00","002","0222","0828","576","423","153","51","627","1135","0","55.24","37.27"
"64","000","00","002","0223","0000","576","441","135","86","662","1831","0","36.16","24.09"
"64","000","00","002","0223","0829","576","441","135","86","662","1831","0","36.16","24.09"
"64","000","00","002","0224","0000","685","535","150","72","757","1288","0","58.77","41.54"
"64","000","00","002","0224","0830","685","535","150","72","757","1288","0","58.77","41.54"
"64","000","00","002","0225","0000","616","493","123","34","650","1241","0","52.38","39.73"
"64","000","00","002","0225","0831","616","493","123","34","650","1241","0","52.38","39.73"
"64","000","00","002","0226","0000","747","597","150","78","825","1342","0","61.48","44.49"
"64","000","00","002","0226","0832","747","597","150","78","825","1342","0","61.48","44.49"
"64","000","00","002","0227","0000","771","599","172","96","867","1422","0","60.97","42.12"
"64","000","00","002","0227","0833","771","599","172","96","867","1422","0","60.97","42.12"
"64","000","00","002","0228","0000","817","648","169","100","917","1453","0","63.11","44.6"
"64","000","00","002","0228","0834","817","648","169","100","917","1453","0","63.11","44.6"
"64","000","00","002","0229","0000","355","265","90","43","398","616","0","64.61","43.02"
"64","000","00","002","0229","0835","355","265","90","43","398","616","0","64.61","43.02"
"64","000","00","002","0230","0000","423","304","119","80","503","834","0","60.31","36.45"
"64","000","00","002","0230","0836","423","304","119","80","503","834","0","60.31","36.45"
"64","000","00","002","0231","0000","499","382","117","115","614","969","0","63.36","39.42"
"64","000","00","002","0231","0837","499","382","117","115","614","969","0","63.36","39.42"
"64","000","00","002","0232","0000","484","367","117","87","571","978","0","58.38","37.53"
"64","000","00","002","0232","0838","484","367","117","87","571","978","0","58.38","37.53"
"64","000","00","002","0233","0000","407","294","113","79","486","760","0","63.95","38.68"
"64","000","00","002","0233","0839","407","294","113","79","486","760","0","63.95","38.68"
"64","000","00","002","0234","0000","675","536","139","70","745","1248","0","59.7","42.95"
"64","000","00","002","0234","0840","675","536","139","70","745","1248","0","59.7","42.95"
"64","000","00","002","0235","0000","534","386","148","33","567","1143","0","49.61","33.77"
"64","000","00","002","0235","0841","534","386","148","33","567","1143","0","49.61","33.77"
"64","000","00","002","0236","0000","590","441","149","80","670","1358","0","49.34","32.47"
"64","000","00","002","0236","0842","590","441","149","80","670","1358","0","49.34","32.47"
"64","000","00","002","0237","0000","489","398","91","18","507","1036","0","48.94","38.42"
"64","000","00","002","0237","0843","489","398","91","18","507","1036","0","48.94","38.42"
"64","000","00","002","0238","0000","280","209","71","20","300","580","0","51.72","36.03"
"64","000","00","002","0238","0844","280","209","71","20","300","580","0","51.72","36.03"
"64","000","00","003","0000","0000","91233","73230","18003","5165","96398","161367","196749","59.74","45.38"
"64","000","00","003","0301","0000","818","639","179","58","876","2604","0","33.64","24.54"
"64","000","00","003","0301","0534","818","639","179","58","876","2604","0","33.64","24.54"
"64","000","00","003","0302","0000","567","427","140","81","648","1037","0","62.49","41.18"
"64","000","00","003","0302","0535","567","427","140","81","648","1037","0","62.49","41.18"
"64","000","00","003","0303","0000","306","240","66","47","353","542","0","65.13","44.28"
"64","000","00","003","0303","0536","306","240","66","47","353","542","0","65.13","44.28"
"64","000","00","003","0304","0000","336","257","79","53","389","635","0","61.26","40.47"
"64","000","00","003","0304","0537","336","257","79","53","389","635","0","61.26","40.47"
"64","000","00","003","0305","0000","222","181","41","20","242","518","0","46.72","34.94"
"64","000","00","003","0305","0538","222","181","41","20","242","518","0","46.72","34.94"
"64","000","00","003","0306","0000","378","284","94","62","440","813","0","54.12","34.93"
"64","000","00","003","0306","0539","378","284","94","62","440","813","0","54.12","34.93"
"64","000","00","003","0307","0000","461","329","132","82","543","889","0","61.08","37.01"
"64","000","00","003","0307","0540","461","329","132","82","543","889","0","61.08","37.01"
"64","000","00","003","0308","0000","397","300","97","74","471","731","0","64.43","41.04"
"64","000","00","003","0308","0541","397","300","97","74","471","731","0","64.43","41.04"
"64","000","00","003","0309","0000","1695","1290","405","104","1799","3301","0","54.5","39.08"
"64","000","00","003","0309","0542","740","563","177","48","788","1592","0","49.5","35.36"
"64","000","00","003","0309","0543","955","727","228","56","1011","1709","0","59.16","42.54"
"64","000","00","003","0311","0000","881","758","123","62","943","1588","0","59.38","47.73"
"64","000","00","003","0311","0544","881","758","123","62","943","1588","0","59.38","47.73"
"64","000","00","003","0312","0000","190","176","14","6","196","358","0","54.75","49.16"
"64","000","00","003","0312","0545","190","176","14","6","196","358","0","54.75","49.16"
"64","000","00","003","0313","0000","443","403","40","13","456","666","0","68.47","60.51"
"64","000","00","003","0313","0546","443","403","40","13","456","666","0","68.47","60.51"
"64","000","00","003","0315","0000","915","754","161","72","987","1748","0","56.46","43.14"
"64","000","00","003","0315","0547","915","754","161","72","987","1748","0","56.46","43.14"
"64","000","00","003","0316","0000","1455","1121","334","91","1546","2436","0","63.46","46.02"
"64","000","00","003","0316","0548","742","556","186","25","767","1196","0","64.13","46.49"
"64","000","00","003","0316","0549","713","565","148","66","779","1240","0","62.82","45.56"
"64","000","00","003","0317","0000","1539","1369","170","74","1613","2575","0","62.64","53.17"
"64","000","00","003","0317","0550","818","726","92","46","864","1402","0","61.63","51.78"
"64","000","00","003","0317","0551","721","643","78","28","749","1173","0","63.85","54.82"
"64","000","00","003","0319","0000","438","373","65","21","459","641","0","71.61","58.19"
"64","000","00","003","0319","0552","438","373","65","21","459","641","0","71.61","58.19"
"64","000","00","003","0321","0000","476","336","140","45","521","951","0","54.78","35.33"
"64","000","00","003","0321","0553","476","336","140","45","521","951","0","54.78","35.33"
"64","000","00","003","0322","0000","372","284","88","46","418","732","0","57.1","38.8"
"64","000","00","003","0322","0554","372","284","88","46","418","732","0","57.1","38.8"
"64","000","00","003","0323","0000","167","125","42","12","179","339","0","52.8","36.87"
"64","000","00","003","0323","0555","167","125","42","12","179","339","0","52.8","36.87"
"64","000","00","003","0324","0000","276","221","55","16","292","519","0","56.26","42.58"
"64","000","00","003","0324","0556","276","221","55","16","292","519","0","56.26","42.58"
"64","000","00","003","0325","0000","282","206","76","60","342","514","0","66.54","40.08"
"64","000","00","003","0325","0557","282","206","76","60","342","514","0","66.54","40.08"
"64","000","00","003","0326","0000","397","316","81","61","458","720","0","63.61","43.89"
"64","000","00","003","0326","0558","397","316","81","61","458","720","0","63.61","43.89"
"64","000","00","003","0327","0000","220","163","57","49","269","411","0","65.45","39.66"
"64","000","00","003","0327","0559","220","163","57","49","269","411","0","65.45","39.66"
"64","000","00","003","0328","0000","354","258","96","43","397","603","0","65.84","42.79"
"64","000","00","003","0328","0560","354","258","96","43","397","603","0","65.84","42.79"
"64","000","00","003","0329","0000","478","353","125","79","557","904","0","61.62","39.05"
"64","000","00","003","0329","0561","478","353","125","79","557","904","0","61.62","39.05"
"64","000","00","003","0330","0000","614","484","130","44","658","1318","0","49.92","36.72"
"64","000","00","003","0330","0562","614","484","130","44","658","1318","0","49.92","36.72"
"64","000","00","003","0331","0000","463","347","116","25","488","966","0","50.52","35.92"
"64","000","00","003","0331","0563","463","347","116","25","488","966","0","50.52","35.92"
"64","000","00","003","0332","0000","3213","2789","424","188","3401","5792","0","58.72","48.15"
"64","000","00","003","0332","0564","806","686","120","40","846","1440","0","58.75","47.64"
"64","000","00","003","0332","0565","1049","913","136","44","1093","1990","0","54.92","45.88"
"64","000","00","003","0332","0566","637","567","70","32","669","1090","0","61.38","52.02"
"64","000","00","003","0332","0567","721","623","98","72","793","1272","0","62.34","48.98"
"64","000","00","003","0334","0000","1872","1521","351","67","1939","3059","0","63.39","49.72"
"64","000","00","003","0334","0568","946","776","170","29","975","1558","0","62.58","49.81"
"64","000","00","003","0334","0569","926","745","181","38","964","1501","0","64.22","49.63"
"64","000","00","003","0335","0000","239","199","40","8","247","360","0","68.61","55.28"
"64","000","00","003","0335","0570","239","199","40","8","247","360","0","68.61","55.28"
"64","000","00","003","0336","0000","1543","1364","179","57","1600","2694","0","59.39","50.63"
"64","000","00","003","0336","0571","773","700","73","35","808","1335","0","60.52","52.43"
"64","000","00","003","0336","0572","770","664","106","22","792","1359","0","58.28","48.86"
"64","000","00","003","0337","0000","855","703","152","58","913","1487","0","61.4","47.28"
"64","000","00","003","0337","0573","855","703","152","58","913","1487","0","61.4","47.28"
"64","000","00","003","0338","0000","870","731","139","57","927","1637","0","56.63","44.65"
"64","000","00","003","0338","0574","870","731","139","57","927","1637","0","56.63","44.65"
"64","000","00","003","0339","0000","7624","6214","1410","493","8117","13089","0","62.01","47.47"
"64","000","00","003","0339","0575","917","763","154","44","961","1553","0","61.88","49.13"
"64","000","00","003","0339","0576","922","726","196","72","994","1564","0","63.55","46.42"
"64","000","00","003","0339","0577","1095","864","231","58","1153","1788","0","64.49","48.32"
"64","000","00","003","0339","0578","1155","936","219","101","1256","2028","0","61.93","46.15"
"64","000","00","003","0339","0579","1140","901","239","96","1236","2037","0","60.68","44.23"
"64","000","00","003","0339","0580","1234","990","244","58","1292","2101","0","61.49","47.12"
"64","000","00","003","0339","0581","1161","1034","127","64","1225","2018","0","60.7","51.24"
"64","000","00","003","0340","0000","14362","11186","3176","708","15070","25058","0","60.14","44.64"
"64","000","00","003","0340","0582","1144","851","293","96","1240","1925","0","64.42","44.21"
"64","000","00","003","0340","0583","1091","834","257","37","1128","1989","0","56.71","41.93"
"64","000","00","003","0340","0584","880","703","177","42","922","1780","0","51.8","39.49"
"64","000","00","003","0340","0585","1044","807","237","35","1079","1778","0","60.69","45.39"
"64","000","00","003","0340","0586","879","698","181","33","912","1496","0","60.96","46.66"
"64","000","00","003","0340","0587","907","707","200","55","962","1538","0","62.55","45.97"
"64","000","00","003","0340","0588","1183","933","250","70","1253","2058","0","60.88","45.34"
"64","000","00","003","0340","0589","1140","889","251","34","1174","1992","0","58.94","44.63"
"64","000","00","003","0340","0590","1192","942","250","75","1267","2058","0","61.56","45.77"
"64","000","00","003","0340","0591","1213","969","244","53","1266","2090","0","60.57","46.36"
"64","000","00","003","0340","0592","1182","899","283","43","1225","2157","0","56.79","41.68"
"64","000","00","003","0340","0593","1263","1000","263","47","1310","2096","0","62.5","47.71"
"64","000","00","003","0340","0594","1244","954","290","88","1332","2101","0","63.4","45.41"
"64","000","00","003","0341","0000","2667","2087","580","261","2928","4843","0","60.46","43.09"
"64","000","00","003","0341","0595","921","735","186","73","994","1649","0","60.28","44.57"
"64","000","00","003","0341","0596","804","619","185","91","895","1516","0","59.04","40.83"
"64","000","00","003","0341","0597","942","733","209","97","1039","1678","0","61.92","43.68"
"64","000","00","003","0342","0000","7380","5971","1409","332","7712","13054","0","59.08","45.74"
"64","000","00","003","0342","0598","1074","831","243","76","1150","1898","0","60.59","43.78"
"64","000","00","003","0342","0599","1000","789","211","58","1058","1837","0","57.59","42.95"
"64","000","00","003","0342","0600","1026","891","135","24","1050","1922","0","54.63","46.36"
"64","000","00","003","0342","0601","1064","858","206","58","1122","1785","0","62.86","48.07"
"64","000","00","003","0342","0602","1033","839","194","31","1064","1886","0","56.42","44.49"
"64","000","00","003","0342","0603","1106","892","214","49","1155","1895","0","60.95","47.07"
"64","000","00","003","0342","0604","1077","871","206","36","1113","1831","0","60.79","47.57"
"64","000","00","003","0343","0000","16093","12788","3305","706","16799","27814","0","60.4","45.98"
"64","000","00","003","0343","0605","1135","921","214","41","1176","2050","0","57.37","44.93"
"64","000","00","003","0343","0606","1433","1145","288","48","1481","2251","0","65.79","50.87"
"64","000","00","003","0343","0607","1279","1011","268","38","1317","2126","0","61.95","47.55"
"64","000","00","003","0343","0608","1018","820","198","34","1052","1928","0","54.56","42.53"
"64","000","00","003","0343","0609","1168","917","251","60","1228","2166","0","56.69","42.34"
"64","000","00","003","0343","0610","1158","938","220","60","1218","2031","0","59.97","46.18"
"64","000","00","003","0343","0611","1171","946","225","66","1237","1987","0","62.25","47.61"
"64","000","00","003","0343","0612","1280","1032","248","41","1321","2166","0","60.99","47.65"
"64","000","00","003","0343","0613","1078","817","261","59","1137","1856","0","61.26","44.02"
"64","000","00","003","0343","0614","1351","997","354","49","1400","2289","0","61.16","43.56"
"64","000","00","003","0343","0615","1116","924","192","48","1164","1973","0","59.0","46.83"
"64","000","00","003","0343","0616","1037","827","210","90","1127","1818","0","61.99","45.49"
"64","000","00","003","0343","0617","861","676","185","32","893","1565","0","57.06","43.19"
"64","000","00","003","0343","0618","1008","817","191","40","1048","1608","0","65.17","50.81"
"64","000","00","003","0344","0000","19375","15683","3692","830","20205","33421","0","60.46","46.93"
"64","000","00","003","0344","0619","1118","904","214","58","1176","1812","0","64.9","49.89"
"64","000","00","003","0344","0620","976","795","181","21","997","1821","0","54.75","43.66"
"64","000","00","003","0344","0621","1135","892","243","60","1195","1907","0","62.66","46.78"
"64","000","00","003","0344","0622","1023","866","157","50","1073","1812","0","59.22","47.79"
"64","000","00","003","0344","0623","1113","886","227","40","1153","1833","0","62.9","48.34"
"64","000","00","003","0344","0624","1082","861","221","62","1144","1850","0","61.84","46.54"
"64","000","00","003","0344","0625","962","788","174","63","1025","1738","0","58.98","45.34"
"64","000","00","003","0344","0626","1149","949","200","59","1208","1864","0","64.81","50.91"
"64","000","00","003","0344","0627","1137","900","237","51","1188","1887","0","62.96","47.69"
"64","000","00","003","0344","0628","1008","833","175","31","1039","1870","0","55.56","44.55"
"64","000","00","003","0344","0629","1050","878","172","33","1083","1866","0","58.04","47.05"
"64","000","00","003","0344","0630","1045","838","207","16","1061","1862","0","56.98","45.01"
"64","000","00","003","0344","0631","1061","876","185","34","1095","1816","0","60.3","48.24"
"64","000","00","003","0344","0632","1049","844","205","47","1096","1833","0","59.79","46.04"
"64","000","00","003","0344","0633","996","770","226","56","1052","1676","0","62.77","45.94"
"64","000","00","003","0344","0634","1069","867","202","61","1130","1843","0","61.31","47.04"
"64","000","00","003","0344","0635","1112","889","223","41","1153","1872","0","61.59","47.49"
"64","000","00","003","0344","0636","1290","1047","243","47","1337","2259","0","59.19","46.35"
"64","000","00","004","0000","0000","83876","66374","17502","7019","90895","153132","185318","59.36","43.34"
"64","000","00","004","0401","0000","11040","8700","2340","647","11687","20704","0","56.45","42.02"
"64","000","00","004","0401","0435","773","616","157","48","821","1309","0","62.72","47.06"
"64","000","00","004","0401","0436","789","611","178","34","823","1408","0","58.45","43.39"
"64","000","00","004","0401","0437","1035","808","227","60","1095","1851","0","59.16","43.65"
"64","000","00","004","0401","0438","911","687","224","67","978","1578","0","61.98","43.54"
"64","000","00","004","0401","0439","934","745","189","38","972","1715","0","56.68","43.44"
"64","000","00","004","0401","0440","852","680","172","35","887","1611","0","55.06","42.21"
"64","000","00","004","0401","0441","1036","856","180","73","1109","2024","0","54.79","42.29"
"64","000","00","004","0401","0442","960","761","199","43","1003","1890","0","53.07","40.26"
"64","000","00","004","0401","0443","854","671","183","31","885","1762","0","50.23","38.08"
"64","000","00","004","0401","0444","969","757","212","69","1038","1888","0","54.98","40.1"
"64","000","00","004","0401","0445","956","760","196","79","1035","1822","0","56.81","41.71"
"64","000","00","004","0401","0446","971","748","223","70","1041","1846","0","56.39","40.52"
"64","000","00","004","0402","0000","2310","1811","499","162","2472","3940","0","62.74","45.96"
"64","000","00","004","0402","0447","712","570","142","75","787","1268","0","62.07","44.95"
"64","000","00","004","0402","0448","750","592","158","54","804","1240","0","64.84","47.74"
"64","000","00","004","0402","0449","848","649","199","33","881","1432","0","61.52","45.32"
"64","000","00","004","0403","0000","3211","2555","656","283","3494","5991","0","58.32","42.65"
"64","000","00","004","0403","0450","798","656","142","61","859","1490","0","57.65","44.03"
"64","000","00","004","0403","0451","860","700","160","61","921","1464","0","62.91","47.81"
"64","000","00","004","0403","0452","739","558","181","79","818","1435","0","57.0","38.89"
"64","000","00","004","0403","0453","814","641","173","82","896","1602","0","55.93","40.01"
"64","000","00","004","0404","0000","1607","1244","363","159","1766","3091","0","57.13","40.25"
"64","000","00","004","0404","0454","784","613","171","52","836","1500","0","55.73","40.87"
"64","000","00","004","0404","0455","823","631","192","107","930","1591","0","58.45","39.66"
"64","000","00","004","0405","0000","1640","1269","371","179","1819","3197","0","56.9","39.69"
"64","000","00","004","0405","0458","800","631","169","88","888","1559","0","56.96","40.47"
"64","000","00","004","0405","0459","840","638","202","91","931","1638","0","56.84","38.95"
"64","000","00","004","0406","0000","1436","1083","353","120","1556","3138","0","49.59","34.51"
"64","000","00","004","0406","0456","599","440","159","59","658","1669","0","39.42","26.36"
"64","000","00","004","0406","0457","837","643","194","61","898","1469","0","61.13","43.77"
"64","000","00","004","0407","0000","2089","1629","460","210","2299","3872","0","59.38","42.07"
"64","000","00","004","0407","0460","1070","842","228","82","1152","1960","0","58.78","42.96"
"64","000","00","004","0407","0461","1019","787","232","128","1147","1912","0","59.99","41.16"
"64","000","00","004","0408","0000","2540","2042","498","127","2667","4678","0","57.01","43.65"
"64","000","00","004","0408","0462","836","678","158","63","899","1559","0","57.67","43.49"
"64","000","00","004","0408","0463","753","610","143","51","804","1423","0","56.5","42.87"
"64","000","00","004","0408","0464","951","754","197","13","964","1696","0","56.84","44.46"
"64","000","00","004","0409","0000","1556","1152","404","250","1806","3020","0","59.8","38.15"
"64","000","00","004","0409","0465","726","528","198","160","886","1493","0","59.34","35.37"
"64","000","00","004","0409","0466","830","624","206","90","920","1527","0","60.25","40.86"
"64","000","00","004","0410","0000","1186","872","314","166","1352","2217","0","60.98","39.33"
"64","000","00","004","0410","0467","562","403","159","86","648","1020","0","63.53","39.51"
"64","000","00","004","0410","0468","624","469","155","80","704","1197","0","58.81","39.18"
"64","000","00","004","0411","0000","1618","1166","452","199","1817","3446","0","52.73","33.84"
"64","000","00","004","0411","0469","743","519","224","89","832","1528","0","54.45","33.97"
"64","000","00","004","0411","0470","875","647","228","110","985","1918","0","51.36","33.73"
"64","000","00","004","0412","0000","723","551","172","100","823","1458","0","56.45","37.79"
"64","000","00","004","0412","0471","723","551","172","100","823","1458","0","56.45","37.79"
"64","000","00","004","0413","0000","2049","1597","452","191","2240","3635","0","61.62","43.93"
"64","000","00","004","0413","0472","995","763","232","106","1101","1790","0","61.51","42.63"
"64","000","00","004","0413","0473","1054","834","220","85","1139","1845","0","61.73","45.2"
"64","000","00","004","0414","0000","8586","7018","1568","519","9105","15761","0","57.77","44.53"
"64","000","00","004","0414","0474","1118","922","196","77","1195","2037","0","58.66","45.26"
"64","000","00","004","0414","0475","1048","868","180","60","1108","1964","0","56.42","44.2"
"64","000","00","004","0414","0476","1075","874","201","35","1110","2006","0","55.33","43.57"
"64","000","00","004","0414","0477","1042","835","207","64","1106","1951","0","56.69","42.8"
"64","000","00","004","0414","0478","1012","819","193","71","1083","1951","0","55.51","41.98"
"64","000","00","004","0414","0479","1119","921","198","74","1193","2008","0","59.41","45.87"
"64","000","00","004","0414","0480","1080","884","196","85","1165","1923","0","60.58","45.97"
"64","000","00","004","0414","0481","1092","895","197","53","1145","1921","0","59.6","46.59"
"64","000","00","004","0415","0000","545","414","131","40","585","832","0","70.31","49.76"
"64","000","00","004","0415","0482","545","414","131","40","585","832","0","70.31","49.76"
"64","000","00","004","0416","0000","1258","892","366","116","1374","2281","0","60.24","39.11"
"64","000","00","004","0416","0483","638","451","187","53","691","1156","0","59.78","39.01"
"64","000","00","004","0416","0484","620","441","179","63","683","1125","0","60.71","39.2"
"64","000","00","004","0417","0000","1462","1132","330","131","1593","2562","0","62.18","44.18"
"64","000","00","004","0417","0485","615","456","159","60","675","1060","0","63.68","43.02"
"64","000","00","004","0417","0486","847","676","171","71","918","1502","0","61.12","45.01"
"64","000","00","004","0418","0000","1522","1156","366","163","1685","2956","0","57.0","39.11"
"64","000","00","004","0418","0487","765","568","197","93","858","1404","0","61.11","40.46"
"64","000","00","004","0418","0488","757","588","169","70","827","1552","0","53.29","37.89"
"64","000","00","004","0419","0000","1371","1062","309","132","1503","2775","0","54.16","38.27"
"64","000","00","004","0419","0489","711","529","182","71","782","1460","0","53.56","36.23"
"64","000","00","004","0419","0490","660","533","127","61","721","1315","0","54.83","40.53"
"64","000","00","004","0420","0000","1193","947","246","136","1329","2140","0","62.1","44.25"
"64","000","00","004","0420","0491","600","464","136","69","669","1062","0","62.99","43.69"
"64","000","00","004","0420","0492","593","483","110","67","660","1078","0","61.22","44.81"
"64","000","00","004","0421","0000","1140","885","255","181","1321","1978","0","66.78","44.74"
"64","000","00","004","0421","0493","525","407","118","87","612","914","0","66.96","44.53"
"64","000","00","004","0421","0494","615","478","137","94","709","1064","0","66.64","44.92"
"64","000","00","004","0422","0000","3014","2451","563","232","3246","5350","0","60.67","45.81"
"64","000","00","004","0422","0495","950","728","222","91","1041","1705","0","61.06","42.7"
"64","000","00","004","0422","0496","979","819","160","68","1047","1728","0","60.59","47.4"
"64","000","00","004","0422","0497","1085","904","181","73","1158","1917","0","60.41","47.16"
"64","000","00","004","0423","0000","717","568","149","99","816","1439","0","56.71","39.47"
"64","000","00","004","0423","0498","717","568","149","99","816","1439","0","56.71","39.47"
"64","000","00","004","0424","0000","2430","1994","436","230","2660","4196","0","63.39","47.52"
"64","000","00","004","0424","0499","711","594","117","77","788","1287","0","61.23","46.15"
"64","000","00","004","0424","0500","872","705","167","77","949","1504","0","63.1","46.88"
"64","000","00","004","0424","0501","847","695","152","76","923","1405","0","65.69","49.47"
"64","000","00","004","0425","0000","1458","1226","232","137","1595","2582","0","61.77","47.48"
"64","000","00","004","0425","0502","706","641","65","80","786","1287","0","61.07","49.81"
"64","000","00","004","0425","0503","752","585","167","57","809","1295","0","62.47","45.17"
"64","000","00","004","0426","0000","1894","1494","400","132","2026","3132","0","64.69","47.7"
"64","000","00","004","0426","0504","875","676","199","58","933","1483","0","62.91","45.58"
"64","000","00","004","0426","0505","1019","818","201","74","1093","1649","0","66.28","49.61"
"64","000","00","004","0427","0000","1172","945","227","147","1319","2023","0","65.2","46.71"
"64","000","00","004","0427","0506","572","469","103","78","650","998","0","65.13","46.99"
"64","000","00","004","0427","0507","600","476","124","69","669","1025","0","65.27","46.44"
"64","000","00","004","0428","0000","1872","1463","409","182","2054","3124","0","65.75","46.83"
"64","000","00","004","0428","0508","1018","810","208","80","1098","1671","0","65.71","48.47"
"64","000","00","004","0428","0509","854","653","201","102","956","1453","0","65.79","44.94"
"64","000","00","004","0429","0000","1799","1445","354","150","1949","3326","0","58.6","43.45"
"64","000","00","004","0429","0510","908","721","187","92","1000","1673","0","59.77","43.1"
"64","000","00","004","0429","0511","891","724","167","58","949","1653","0","57.41","43.8"
"64","000","00","004","0430","0000","1306","1039","267","112","1418","2161","0","65.62","48.08"
"64","000","00","004","0430","0512","587","456","131","54","641","1034","0","61.99","44.1"
"64","000","00","004","0430","0513","719","583","136","58","777","1127","0","68.94","51.73"
"64","000","00","004","0431","0000","2462","1960","502","224","2686","4512","0","59.53","43.44"
"64","000","00","004","0431","0514","818","641","177","95","913","1575","0","57.97","40.7"
"64","000","00","004","0431","0515","900","725","175","68","968","1559","0","62.09","46.5"
"64","000","00","004","0431","0516","744","594","150","61","805","1378","0","58.42","43.11"
"64","000","00","004","0432","0000","1923","1508","415","170","2093","3435","0","60.93","43.9"
"64","000","00","004","0432","0517","963","746","217","82","1045","1714","0","60.97","43.52"
"64","000","00","004","0432","0518","960","762","198","88","1048","1721","0","60.89","44.28"
"64","000","00","004","0433","0000","4889","3943","946","354","5243","8227","0","63.73","47.93"
"64","000","00","004","0433","0519","909","708","201","67","976","1628","0","59.95","43.49"
"64","000","00","004","0433","0520","992","804","188","89","1081","1590","0","67.99","50.57"
"64","000","00","004","0433","0521","924","743","181","72","996","1628","0","61.18","45.64"
"64","000","00","004","0433","0522","1074","881","193","53","1127","1739","0","64.81","50.66"
"64","000","00","004","0433","0523","990","807","183","73","1063","1642","0","64.74","49.15"
"64","000","00","004","0434","0000","2562","2130","432","201","2763","4997","0","55.29","42.63"
"64","000","00","004","0434","0524","899","737","162","89","988","1766","0","55.95","41.73"
"64","000","00","004","0434","0525","786","643","143","74","860","1482","0","58.03","43.39"
"64","000","00","004","0434","0526","877","750","127","38","915","1749","0","52.32","42.88"
"64","000","00","004","0435","0000","3866","3127","739","205","4071","6433","0","63.28","48.61"
"64","000","00","004","0435","0527","911","710","201","53","964","1591","0","60.59","44.63"
"64","000","00","004","0435","0528","949","767","182","45","994","1545","0","64.34","49.64"
"64","000","00","004","0435","0529","1027","834","193","43","1070","1651","0","64.81","50.51"
"64","000","00","004","0435","0530","979","816","163","64","1043","1646","0","63.37","49.57"
"64","000","00","004","0436","0000","846","657","189","82","928","1496","0","62.03","43.92"
"64","000","00","004","0436","0531","846","657","189","82","928","1496","0","62.03","43.92"
"64","000","00","004","0437","0000","1584","1247","337","151","1735","3027","0","57.32","41.2"
"64","000","00","004","0437","0532","708","547","161","92","800","1403","0","57.02","38.99"
"64","000","00","004","0437","0533","876","700","176","59","935","1624","0","57.57","43.1"
"64","000","00","005","0000","0000","157411","121925","35486","10419","167830","289519","341230","57.97","42.11"
"64","000","00","005","0501","0000","1959","1527","432","194","2153","3875","0","55.56","39.41"
"64","000","00","005","0501","0887","992","772","220","93","1085","1893","0","57.32","40.78"
"64","000","00","005","0501","0888","967","755","212","101","1068","1982","0","53.88","38.09"
"64","000","00","005","0502","0000","3928","3142","786","245","4173","7408","0","56.33","42.41"
"64","000","00","005","0502","0889","888","723","165","82","970","1661","0","58.4","43.53"
"64","000","00","005","0502","0890","977","785","192","27","1004","1894","0","53.01","41.45"
"64","000","00","005","0502","0891","979","784","195","65","1044","1839","0","56.77","42.63"
"64","000","00","005","0502","0892","1084","850","234","71","1155","2014","0","57.35","42.2"
"64","000","00","005","0503","0000","1977","1535","442","176","2153","3913","0","55.02","39.23"
"64","000","00","005","0503","0893","993","788","205","123","1116","1897","0","58.83","41.54"
"64","000","00","005","0503","0894","984","747","237","53","1037","2016","0","51.44","37.05"
"64","000","00","005","0504","0000","1953","1535","418","115","2068","3673","0","56.3","41.79"
"64","000","00","005","0504","0895","984","771","213","52","1036","1924","0","53.85","40.07"
"64","000","00","005","0504","0896","969","764","205","63","1032","1749","0","59.01","43.68"
"64","000","00","005","0505","0000","3840","3044","796","246","4086","7080","0","57.71","42.99"
"64","000","00","005","0505","0897","1089","865","224","79","1168","1845","0","63.31","46.88"
"64","000","00","005","0505","0898","855","676","179","44","899","1724","0","52.15","39.21"
"64","000","00","005","0505","0899","1019","818","201","51","1070","1889","0","56.64","43.3"
"64","000","00","005","0505","0900","877","685","192","72","949","1622","0","58.51","42.23"
"64","000","00","005","0506","0000","1903","1430","473","115","2018","3393","0","59.48","42.15"
"64","000","00","005","0506","0901","1019","774","245","41","1060","1870","0","56.68","41.39"
"64","000","00","005","0506","0902","884","656","228","74","958","1523","0","62.9","43.07"
"64","000","00","005","0507","0000","11360","8859","2501","640","12000","20639","0","58.14","42.92"
"64","000","00","005","0507","0903","948","724","224","75","1023","2006","0","51.0","36.09"
"64","000","00","005","0507","0904","1226","949","277","76","1302","2076","0","62.72","45.71"
"64","000","00","005","0507","0905","1142","802","340","33","1175","2073","0","56.68","38.69"
"64","000","00","005","0507","0906","1130","919","211","68","1198","2045","0","58.58","44.94"
"64","000","00","005","0507","0907","961","756","205","77","1038","2070","0","50.14","36.52"
"64","000","00","005","0507","0908","1056","795","261","71","1127","2035","0","55.38","39.07"
"64","000","00","005","0507","0909","1222","948","274","61","1283","2075","0","61.83","45.69"
"64","000","00","005","0507","0910","1158","946","212","39","1197","2053","0","58.3","46.08"
"64","000","00","005","0507","0911","1226","989","237","78","1304","2063","0","63.21","47.94"
"64","000","00","005","0507","0912","1291","1031","260","62","1353","2143","0","63.14","48.11"
"64","000","00","005","0508","0000","4526","3540","986","298","4824","8519","0","56.63","41.55"
"64","000","00","005","0508","0913","995","733","262","87","1082","1746","0","61.97","41.98"
"64","000","00","005","0508","0914","836","642","194","29","865","1735","0","49.86","37.0"
"64","000","00","005","0508","0915","846","668","178","69","915","1655","0","55.29","40.36"
"64","000","00","005","0508","0916","883","712","171","61","944","1583","0","59.63","44.98"
"64","000","00","005","0508","0917","966","785","181","52","1018","1800","0","56.56","43.61"
"64","000","00","005","0509","0000","3891","3033","858","187","4078","7001","0","58.25","43.32"
"64","000","00","005","0509","0918","975","763","212","40","1015","1730","0","58.67","44.1"
"64","000","00","005","0509","0919","923","715","208","30","953","1715","0","55.57","41.69"
"64","000","00","005","0509","0920","948","711","237","59","1007","1691","0","59.55","42.05"
"64","000","00","005","0509","0921","1045","844","201","58","1103","1865","0","59.14","45.25"
"64","000","00","005","0510","0000","1228","948","280","100","1328","1990","0","66.73","47.64"
"64","000","00","005","0510","0922","654","512","142","37","691","1073","0","64.4","47.72"
"64","000","00","005","0510","0923","574","436","138","63","637","917","0","69.47","47.55"
"64","000","00","005","0511","0000","918","785","133","58","976","1647","0","59.26","47.66"
"64","000","00","005","0511","0924","918","785","133","58","976","1647","0","59.26","47.66"
"64","000","00","005","0512","0000","2938","2299","639","182","3120","5126","0","60.87","44.85"
"64","000","00","005","0512","0925","937","720","217","70","1007","1654","0","60.88","43.53"
"64","000","00","005","0512","0926","961","752","209","49","1010","1639","0","61.62","45.88"
"64","000","00","005","0512","0927","1040","827","213","63","1103","1833","0","60.17","45.12"
"64","000","00","005","0513","0000","2638","2046","592","132","2770","4401","0","62.94","46.49"
"64","000","00","005","0513","0928","842","651","191","42","884","1362","0","64.9","47.8"
"64","000","00","005","0513","0929","924","721","203","63","987","1557","0","63.39","46.31"
"64","000","00","005","0513","0930","872","674","198","27","899","1482","0","60.66","45.48"
"64","000","00","005","0514","0000","2704","2070","634","120","2824","4583","0","61.62","45.17"
"64","000","00","005","0514","0931","924","707","217","44","968","1563","0","61.93","45.23"
"64","000","00","005","0514","0932","866","658","208","34","900","1497","0","60.12","43.95"
"64","000","00","005","0514","0933","914","705","209","42","956","1523","0","62.77","46.29"
"64","000","00","005","0515","0000","4364","3349","1015","259","4623","7198","0","64.23","46.53"
"64","000","00","005","0515","0934","811","622","189","56","867","1293","0","67.05","48.11"
"64","000","00","005","0515","0935","990","780","210","59","1049","1662","0","63.12","46.93"
"64","000","00","005","0515","0936","800","607","193","62","862","1441","0","59.82","42.12"
"64","000","00","005","0515","0937","847","647","200","49","896","1326","0","67.57","48.79"
"64","000","00","005","0515","0938","916","693","223","33","949","1476","0","64.3","46.95"
"64","000","00","005","0516","0000","1750","1372","378","60","1810","3586","0","50.47","38.26"
"64","000","00","005","0516","0939","959","756","203","32","991","1968","0","50.36","38.41"
"64","000","00","005","0516","0940","791","616","175","28","819","1618","0","50.62","38.07"
"64","000","00","005","0517","0000","2719","2127","592","152","2871","5000","0","57.42","42.54"
"64","000","00","005","0517","0941","1032","814","218","56","1088","1873","0","58.09","43.46"
"64","000","00","005","0517","0942","825","674","151","71","896","1487","0","60.26","45.33"
"64","000","00","005","0517","0943","862","639","223","25","887","1640","0","54.09","38.96"
"64","000","00","005","0518","0000","1966","1577","389","80","2046","3858","0","53.03","40.88"
"64","000","00","005","0518","0944","967","775","192","35","1002","1889","0","53.04","41.03"
"64","000","00","005","0518","0945","999","802","197","45","1044","1969","0","53.02","40.73"
"64","000","00","005","0519","0000","3629","2834","795","280","3909","6475","0","60.37","43.77"
"64","000","00","005","0519","0946","786","593","193","95","881","1466","0","60.1","40.45"
"64","000","00","005","0519","0947","978","763","215","65","1043","1697","0","61.46","44.96"
"64","000","00","005","0519","0948","957","767","190","71","1028","1663","0","61.82","46.12"
"64","000","00","005","0519","0949","908","711","197","49","957","1649","0","58.04","43.12"
"64","000","00","005","0520","0000","1555","1196","359","75","1630","2981","0","54.68","40.12"
"64","000","00","005","0520","0950","786","609","177","45","831","1486","0","55.92","40.98"
"64","000","00","005","0520","0951","769","587","182","30","799","1495","0","53.44","39.26"
"64","000","00","005","0521","0000","1742","1370","372","57","1799","3041","0","59.16","45.05"
"64","000","00","005","0521","0952","938","748","190","28","966","1548","0","62.4","48.32"
"64","000","00","005","0521","0953","804","622","182","29","833","1493","0","55.79","41.66"
"64","000","00","005","0522","0000","4253","3505","748","236","4489","7649","0","58.69","45.82"
"64","000","00","005","0522","0954","863","688","175","30","893","1445","0","61.8","47.61"
"64","000","00","005","0522","0955","818","670","148","43","861","1529","0","56.31","43.82"
"64","000","00","005","0522","0956","799","644","155","31","830","1506","0","55.11","42.76"
"64","000","00","005","0522","0957","908","731","177","60","968","1549","0","62.49","47.19"
"64","000","00","005","0522","0958","865","772","93","72","937","1620","0","57.84","47.65"
"64","000","00","005","0523","0000","1807","1398","409","117","1924","3038","0","63.33","46.02"
"64","000","00","005","0523","0959","923","715","208","61","984","1550","0","63.48","46.13"
"64","000","00","005","0523","0960","884","683","201","56","940","1488","0","63.17","45.9"
"64","000","00","005","0524","0000","1532","1217","315","115","1647","2667","0","61.75","45.63"
"64","000","00","005","0524","0961","774","614","160","57","831","1335","0","62.25","45.99"
"64","000","00","005","0524","0962","758","603","155","58","816","1332","0","61.26","45.27"
"64","000","00","005","0525","0000","2984","2295","689","214","3198","5268","0","60.71","43.56"
"64","000","00","005","0525","0963","988","761","227","94","1082","1764","0","61.34","43.14"
"64","000","00","005","0525","0964","995","766","229","47","1042","1811","0","57.54","42.3"
"64","000","00","005","0525","0965","1001","768","233","73","1074","1693","0","63.44","45.36"
"64","000","00","005","0526","0000","2876","2254","622","192","3068","4867","0","63.04","46.31"
"64","000","00","005","0526","0966","1036","789","247","84","1120","1684","0","66.51","46.85"
"64","000","00","005","0526","0967","774","621","153","68","842","1464","0","57.51","42.42"
"64","000","00","005","0526","0968","1066","844","222","40","1106","1719","0","64.34","49.1"
"64","000","00","005","0527","0000","3738","2959","779","195","3933","6858","0","57.35","43.15"
"64","000","00","005","0527","0969","959","736","223","39","998","1749","0","57.06","42.08"
"64","000","00","005","0527","0970","995","808","187","44","1039","1908","0","54.45","42.35"
"64","000","00","005","0527","0971","905","735","170","62","967","1573","0","61.47","46.73"
"64","000","00","005","0527","0972","879","680","199","50","929","1628","0","57.06","41.77"
"64","000","00","005","0528","0000","2177","1691","486","162","2339","4095","0","57.12","41.29"
"64","000","00","005","0528","0973","652","488","164","53","705","1377","0","51.2","35.44"
"64","000","00","005","0528","0974","911","718","193","57","968","1530","0","63.27","46.93"
"64","000","00","005","0528","0975","614","485","129","52","666","1188","0","56.06","40.82"
"64","000","00","005","0529","0000","2767","2155","612","199","2966","6302","0","47.06","34.2"
"64","000","00","005","0529","0976","785","601","184","39","824","2791","0","29.52","21.53"
"64","000","00","005","0529","0977","1021","814","207","62","1083","1840","0","58.86","44.24"
"64","000","00","005","0529","0978","961","740","221","98","1059","1671","0","63.38","44.28"
"64","000","00","005","0530","0000","4705","3674","1031","273","4978","7969","0","62.47","46.1"
"64","000","00","005","0530","0979","916","693","223","64","980","1624","0","60.34","42.67"
"64","000","00","005","0530","0980","988","770","218","70","1058","1555","0","68.04","49.52"
"64","000","00","005","0530","0981","935","726","209","48","983","1489","0","66.02","48.76"
"64","000","00","005","0530","0982","971","777","194","67","1038","1662","0","62.45","46.75"
"64","000","00","005","0530","0983","895","708","187","24","919","1639","0","56.07","43.2"
"64","000","00","005","0531","0000","2042","1596","446","178","2220","3840","0","57.81","41.56"
"64","000","00","005","0531","0984","1001","764","237","86","1087","1872","0","58.07","40.81"
"64","000","00","005","0531","0985","1041","832","209","92","1133","1968","0","57.57","42.28"
"64","000","00","005","0532","0000","1484","1168","316","181","1665","3005","0","55.41","38.87"
"64","000","00","005","0532","0986","673","538","135","113","786","1471","0","53.43","36.57"
"64","000","00","005","0532","0987","811","630","181","68","879","1534","0","57.3","41.07"
"64","000","00","005","0533","0000","2581","2039","542","192","2773","5282","0","52.5","38.6"
"64","000","00","005","0533","0988","818","636","182","88","906","1659","0","54.61","38.34"
"64","000","00","005","0533","0989","846","675","171","46","892","1815","0","49.15","37.19"
"64","000","00","005","0533","0990","917","728","189","58","975","1808","0","53.93","40.27"
"64","000","00","005","0534","0000","1330","1024","306","75","1405","2630","0","53.42","38.94"
"64","000","00","005","0534","0991","601","463","138","36","637","1224","0","52.04","37.83"
"64","000","00","005","0534","0992","729","561","168","39","768","1406","0","54.62","39.9"
"64","000","00","005","0535","0000","1041","789","252","74","1115","1889","0","59.03","41.77"
"64","000","00","005","0535","0993","486","380","106","32","518","945","0","54.81","40.21"
"64","000","00","005","0535","0994","555","409","146","42","597","944","0","63.24","43.33"
"64","000","00","005","0536","0000","1718","1248","470","164","1882","3142","0","59.9","39.72"
"64","000","00","005","0536","0995","890","660","230","80","970","1669","0","58.12","39.54"
"64","000","00","005","0536","0996","828","588","240","84","912","1473","0","61.91","39.92"
"64","000","00","005","0537","0000","1481","1141","340","131","1612","3558","0","45.31","32.07"
"64","000","00","005","0537","0997","889","692","197","68","957","1876","0","51.01","36.89"
"64","000","00","005","0537","0998","592","449","143","63","655","1682","0","38.94","26.69"
"64","000","00","005","0538","0000","6261","4894","1367","317","6578","11459","0","57.4","42.71"
"64","000","00","005","0538","0999","912","703","209","48","960","1791","0","53.6","39.25"
"64","000","00","005","0538","1000","1025","781","244","66","1091","1808","0","60.34","43.2"
"64","000","00","005","0538","1001","929","729","200","61","990","1798","0","55.06","40.55"
"64","000","00","005","0538","1002","1179","907","272","75","1254","2030","0","61.77","44.68"
"64","000","00","005","0538","1003","1112","892","220","30","1142","2034","0","56.15","43.85"
"64","000","00","005","0538","1004","1104","882","222","37","1141","1998","0","57.11","44.14"
"64","000","00","005","0539","0000","1957","1524","433","91","2048","3879","0","52.8","39.29"
"64","000","00","005","0539","1005","949","730","219","39","988","1914","0","51.62","38.14"
"64","000","00","005","0539","1006","1008","794","214","52","1060","1965","0","53.94","40.41"
"64","000","00","005","0540","0000","996","746","250","97","1093","1885","0","57.98","39.58"
"64","000","00","005","0540","1007","996","746","250","97","1093","1885","0","57.98","39.58"
"64","000","00","005","0541","0000","1273","985","288","87","1360","2277","0","59.73","43.26"
"64","000","00","005","0541","1008","714","575","139","12","726","1220","0","59.51","47.13"
"64","000","00","005","0541","1009","559","410","149","75","634","1057","0","59.98","38.79"
"64","000","00","005","0542","0000","1215","948","267","78","1293","2784","0","46.44","34.05"
"64","000","00","005","0542","1010","619","470","149","29","648","1434","0","45.19","32.78"
"64","000","00","005","0542","1011","596","478","118","49","645","1350","0","47.78","35.41"
"64","000","00","005","0543","0000","845","655","190","45","890","1826","0","48.74","35.87"
"64","000","00","005","0543","1012","377","294","83","25","402","872","0","46.1","33.72"
"64","000","00","005","0543","1013","468","361","107","20","488","954","0","51.15","37.84"
"64","000","00","005","0544","0000","2400","1882","518","128","2528","4415","0","57.26","42.63"
"64","000","00","005","0544","1014","933","758","175","25","958","1689","0","56.72","44.88"
"64","000","00","005","0544","1015","741","582","159","24","765","1390","0","55.04","41.87"
"64","000","00","005","0544","1016","726","542","184","79","805","1336","0","60.25","40.57"
"64","000","00","005","0545","0000","2551","1944","607","172","2723","4402","0","61.86","44.16"
"64","000","00","005","0545","1017","894","670","224","58","952","1437","0","66.25","46.62"
"64","000","00","005","0545","1018","806","630","176","31","837","1452","0","57.64","43.39"
"64","000","00","005","0545","1019","851","644","207","83","934","1513","0","61.73","42.56"
"64","000","00","005","0546","0000","1702","1244","458","187","1889","2848","0","66.33","43.68"
"64","000","00","005","0546","1020","848","628","220","105","953","1467","0","64.96","42.81"
"64","000","00","005","0546","1021","854","616","238","82","936","1381","0","67.78","44.61"
"64","000","00","005","0547","0000","1370","1029","341","93","1463","2444","0","59.86","42.1"
"64","000","00","005","0547","1022","598","435","163","56","654","1117","0","58.55","38.94"
"64","000","00","005","0547","1023","772","594","178","37","809","1327","0","60.96","44.76"
"64","000","00","005","0548","0000","734","558","176","38","772","1304","0","59.2","42.79"
"64","000","00","005","0548","1024","734","558","176","38","772","1304","0","59.2","42.79"
"64","000","00","005","0549","0000","731","528","203","38","769","1483","0","51.85","35.6"
"64","000","00","005","0549","1025","731","528","203","38","769","1483","0","51.85","35.6"
"64","000","00","005","0550","0000","850","609","241","52","902","1473","0","61.24","41.34"
"64","000","00","005","0550","1026","850","609","241","52","902","1473","0","61.24","41.34"
"64","000","00","005","0551","0000","563","435","128","37","600","980","0","61.22","44.39"
"64","000","00","005","0551","1027","563","435","128","37","600","980","0","61.22","44.39"
"64","000","00","005","0552","0000","1502","1124","378","119","1621","2639","0","61.42","42.59"
"64","000","00","005","0552","1028","803","616","187","68","871","1409","0","61.82","43.72"
"64","000","00","005","0552","1029","699","508","191","51","750","1230","0","60.98","41.3"
"64","000","00","005","0553","0000","1281","944","337","119","1400","2154","0","65.0","43.83"
"64","000","00","005","0553","1030","618","455","163","65","683","1024","0","66.7","44.43"
"64","000","00","005","0553","1031","663","489","174","54","717","1130","0","63.45","43.27"
"64","000","00","005","0554","0000","933","696","237","38","971","1889","0","51.4","36.84"
"64","000","00","005","0554","1032","933","696","237","38","971","1889","0","51.4","36.84"
"64","000","00","005","0555","0000","782","572","210","36","818","1427","0","57.32","40.08"
"64","000","00","005","0555","1033","782","572","210","36","818","1427","0","57.32","40.08"
"64","000","00","005","0556","0000","449","356","93","20","469","791","0","59.29","45.01"
"64","000","00","005","0556","1034","449","356","93","20","469","791","0","59.29","45.01"
"64","000","00","005","0557","0000","671","504","167","88","759","1079","0","70.34","46.71"
"64","000","00","005","0557","1035","671","504","167","88","759","1079","0","70.34","46.71"
"64","000","00","005","0558","0000","813","576","237","80","893","1492","0","59.85","38.61"
"64","000","00","005","0558","1036","813","576","237","80","893","1492","0","59.85","38.61"
"64","000","00","005","0559","0000","1153","854","299","81","1234","2021","0","61.06","42.26"
"64","000","00","005","0559","1037","591","432","159","68","659","1020","0","64.61","42.35"
"64","000","00","005","0559","1038","562","422","140","13","575","1001","0","57.44","42.16"
"64","000","00","005","0560","0000","1631","1218","413","102","1733","3052","0","56.78","39.91"
"64","000","00","005","0560","1039","858","656","202","52","910","1581","0","57.56","41.49"
"64","000","00","005","0560","1040","773","562","211","50","823","1471","0","55.95","38.21"
"64","000","00","005","0561","0000","2133","1627","506","145","2278","3760","0","60.59","43.27"
"64","000","00","005","0561","1041","631","488","143","26","657","1151","0","57.08","42.4"
"64","000","00","005","0561","1042","784","582","202","66","850","1334","0","63.72","43.63"
"64","000","00","005","0561","1043","718","557","161","53","771","1275","0","60.47","43.69"
"64","000","00","005","0562","0000","2059","1562","497","119","2178","4051","0","53.76","38.56"
"64","000","00","005","0562","1044","710","536","174","50","760","1688","0","45.02","31.75"
"64","000","00","005","0562","1045","656","485","171","39","695","1214","0","57.25","39.95"
"64","000","00","005","0562","1046","693","541","152","30","723","1149","0","62.92","47.08"
"64","000","00","005","0563","0000","927","695","232","99","1026","1667","0","61.55","41.69"
"64","000","00","005","0563","1047","927","695","232","99","1026","1667","0","61.55","41.69"
"64","000","00","005","0564","0000","865","645","220","45","910","1786","0","50.95","36.11"
"64","000","00","005","0564","1048","865","645","220","45","910","1786","0","50.95","36.11"
"64","000","00","005","0565","0000","1042","802","240","77","1119","1821","0","61.45","44.04"
"64","000","00","005","0565","1049","515","376","139","23","538","896","0","60.04","41.96"
"64","000","00","005","0565","1050","527","426","101","54","581","925","0","62.81","46.05"
"64","000","00","005","0566","0000","412","312","100","52","464","684","0","67.84","45.61"
"64","000","00","005","0566","1051","412","312","100","52","464","684","0","67.84","45.61"
"64","000","00","005","0567","0000","600","444","156","57","657","981","0","66.97","45.26"
"64","000","00","005","0567","1052","600","444","156","57","657","981","0","66.97","45.26"
"64","000","00","005","0568","0000","661","492","169","95","756","1383","0","54.66","35.57"
"64","000","00","005","0568","1053","661","492","169","95","756","1383","0","54.66","35.57"
"64","000","00","005","0569","0000","735","543","192","58","793","1382","0","57.38","39.29"
"64","000","00","005","0569","1054","735","543","192","58","793","1382","0","57.38","39.29"
"64","000","00","005","0570","0000","425","340","85","27","452","808","0","55.94","42.08"
"64","000","00","005","0570","1055","425","340","85","27","452","808","0","55.94","42.08"
"64","000","00","005","0572","0000","672","502","170","32","704","1197","0","58.81","41.94"
"64","000","00","005","0572","1056","672","502","170","32","704","1197","0","58.81","41.94"
"64","000","00","005","0573","0000","2223","1670","553","141","2364","4047","0","58.41","41.27"
"64","000","00","005","0573","1057","703","541","162","56","759","1344","0","56.47","40.25"
"64","000","00","005","0573","1058","749","533","216","65","814","1344","0","60.57","39.66"
"64","000","00","005","0573","1059","771","596","175","20","791","1359","0","58.2","43.86"
"64","000","00","005","0574","0000","629","486","143","53","682","1073","0","63.56","45.29"
"64","000","00","005","0574","1060","629","486","143","53","682","1073","0","63.56","45.29"
"64","000","00","005","0575","0000","615","477","138","55","670","1186","0","56.49","40.22"
"64","000","00","005","0575","1061","615","477","138","55","670","1186","0","56.49","40.22"
"64","000","00","005","0576","0000","950","709","241","85","1035","1749","0","59.18","40.54"
"64","000","00","005","0576","1062","950","709","241","85","1035","1749","0","59.18","40.54"
"64","000","00","005","0577","0000","431","332","99","18","449","877","0","51.2","37.86"
"64","000","00","005","0577","1063","431","332","99","18","449","877","0","51.2","37.86"
"64","000","00","005","0578","0000","806","600","206","105","911","1402","0","64.98","42.8"
"64","000","00","005","0578","1064","806","600","206","105","911","1402","0","64.98","42.8"
"64","000","00","005","0579","0000","467","364","103","23","490","769","0","63.72","47.33"
"64","000","00","005","0579","1065","467","364","103","23","490","769","0","63.72","47.33"
"64","000","00","005","0581","0000","1273","993","280","119","1392","2477","0","56.2","40.09"
"64","000","00","005","0581","1066","679","534","145","67","746","1207","0","61.81","44.24"
"64","000","00","005","0581","1067","594","459","135","52","646","1270","0","50.87","36.14"
"64","000","00","005","0582","0000","664","518","146","60","724","1248","0","58.01","41.51"
"64","000","00","005","0582","1068","664","518","146","60","724","1248","0","58.01","41.51"
"64","000","00","005","0583","0000","699","553","146","86","785","1263","0","62.15","43.78"
"64","000","00","005","0583","1069","699","553","146","86","785","1263","0","62.15","43.78"
"64","000","00","005","0584","0000","604","465","139","37","641","1101","0","58.22","42.23"
"64","000","00","005","0584","1070","604","465","139","37","641","1101","0","58.22","42.23"
"64","000","00","005","0585","0000","620","490","130","32","652","1116","0","58.42","43.91"
"64","000","00","005","0585","1071","620","490","130","32","652","1116","0","58.42","43.91"
"64","000","00","005","0586","0000","631","483","148","33","664","1152","0","57.64","41.93"
"64","000","00","005","0586","1072","631","483","148","33","664","1152","0","57.64","41.93"
"64","000","00","005","0587","0000","586","455","131","77","663","1057","0","62.72","43.05"
"64","000","00","005","0587","1073","586","455","131","77","663","1057","0","62.72","43.05"
"64","000","00","005","0588","0000","1015","770","245","77","1092","2033","0","53.71","37.88"
"64","000","00","005","0588","1074","466","359","107","52","518","971","0","53.35","36.97"
"64","000","00","005","0588","1075","549","411","138","25","574","1062","0","54.05","38.7"
"64","000","00","006","0000","0000","24792","18956","5836","1698","26490","44355","50942","59.72","42.74"
"64","000","00","006","0601","0000","1024","783","241","98","1122","1791","0","62.65","43.72"
"64","000","00","006","0601","1098","453","342","111","35","488","828","0","58.94","41.3"
"64","000","00","006","0601","1099","571","441","130","63","634","963","0","65.84","45.79"
"64","000","00","006","0602","0000","549","426","123","29","578","1075","0","53.77","39.63"
"64","000","00","006","0602","1100","549","426","123","29","578","1075","0","53.77","39.63"
"64","000","00","006","0603","0000","1623","1266","357","71","1694","2926","0","57.89","43.27"
"64","000","00","006","0603","1101","825","634","191","29","854","1488","0","57.39","42.61"
"64","000","00","006","0603","1102","798","632","166","42","840","1438","0","58.41","43.95"
"64","000","00","006","0604","0000","609","467","142","31","640","1049","0","61.01","44.52"
"64","000","00","006","0604","1103","609","467","142","31","640","1049","0","61.01","44.52"
"64","000","00","006","0605","0000","822","596","226","97","919","1378","0","66.69","43.25"
"64","000","00","006","0605","1104","822","596","226","97","919","1378","0","66.69","43.25"
"64","000","00","006","0606","0000","399","308","91","37","436","666","0","65.47","46.25"
"64","000","00","006","0606","1105","399","308","91","37","436","666","0","65.47","46.25"
"64","000","00","006","0607","0000","550","403","147","27","577","981","0","58.82","41.08"
"64","000","00","006","0607","1106","550","403","147","27","577","981","0","58.82","41.08"
"64","000","00","006","0608","0000","1116","854","262","62","1178","1920","0","61.35","44.48"
"64","000","00","006","0608","1107","575","425","150","33","608","933","0","65.17","45.55"
"64","000","00","006","0608","1108","541","429","112","29","570","987","0","57.75","43.47"
"64","000","00","006","0609","0000","572","463","109","42","614","988","0","62.15","46.86"
"64","000","00","006","0609","1109","572","463","109","42","614","988","0","62.15","46.86"
"64","000","00","006","0610","0000","437","343","94","45","482","735","0","65.58","46.67"
"64","000","00","006","0610","1110","437","343","94","45","482","735","0","65.58","46.67"
"64","000","00","006","0611","0000","746","554","192","33","779","1317","0","59.15","42.07"
"64","000","00","006","0611","1111","746","554","192","33","779","1317","0","59.15","42.07"
"64","000","00","006","0612","0000","393","315","78","17","410","800","0","51.25","39.38"
"64","000","00","006","0612","1112","393","315","78","17","410","800","0","51.25","39.38"
"64","000","00","006","0613","0000","1092","848","244","70","1162","1881","0","61.78","45.08"
"64","000","00","006","0613","1113","561","432","129","43","604","968","0","62.4","44.63"
"64","000","00","006","0613","1114","531","416","115","27","558","913","0","61.12","45.56"
"64","000","00","006","0614","0000","1605","1197","408","78","1683","2617","0","64.31","45.74"
"64","000","00","006","0614","1115","830","604","226","27","857","1389","0","61.7","43.48"
"64","000","00","006","0614","1116","775","593","182","51","826","1228","0","67.26","48.29"
"64","000","00","006","0615","0000","1318","1039","279","96","1414","2312","0","61.16","44.94"
"64","000","00","006","0615","1117","686","535","151","80","766","1211","0","63.25","44.18"
"64","000","00","006","0615","1118","632","504","128","16","648","1101","0","58.86","45.78"
"64","000","00","006","0616","0000","1009","782","227","76","1085","1625","0","66.77","48.12"
"64","000","00","006","0616","1119","449","358","91","19","468","752","0","62.23","47.61"
"64","000","00","006","0616","1120","560","424","136","57","617","873","0","70.68","48.57"
"64","000","00","006","0617","0000","1954","1454","500","104","2058","3345","0","61.52","43.47"
"64","000","00","006","0617","1121","927","669","258","43","970","1609","0","60.29","41.58"
"64","000","00","006","0617","1122","1027","785","242","61","1088","1736","0","62.67","45.22"
"64","000","00","006","0618","0000","676","538","138","28","704","1258","0","55.96","42.77"
"64","000","00","006","0618","1123","676","538","138","28","704","1258","0","55.96","42.77"
"64","000","00","006","0619","0000","628","475","153","58","686","1105","0","62.08","42.99"
"64","000","00","006","0619","1124","628","475","153","58","686","1105","0","62.08","42.99"
"64","000","00","006","0620","0000","479","364","115","53","532","851","0","62.51","42.77"
"64","000","00","006","0620","1125","479","364","115","53","532","851","0","62.51","42.77"
"64","000","00","006","0621","0000","593","447","146","41","634","1011","0","62.71","44.21"
"64","000","00","006","0621","1126","593","447","146","41","634","1011","0","62.71","44.21"
"64","000","00","006","0622","0000","1095","825","270","101","1196","1893","0","63.18","43.58"
"64","000","00","006","0622","1127","548","395","153","69","617","888","0","69.48","44.48"
"64","000","00","006","0622","1128","547","430","117","32","579","1005","0","57.61","42.79"
"64","000","00","006","0623","0000","1375","1047","328","76","1451","2763","0","52.52","37.89"
"64","000","00","006","0623","1129","579","442","137","19","598","1375","0","43.49","32.15"
"64","000","00","006","0623","1130","796","605","191","57","853","1388","0","61.46","43.59"
"64","000","00","006","0624","0000","378","303","75","50","428","719","0","59.53","42.14"
"64","000","00","006","0624","1131","378","303","75","50","428","719","0","59.53","42.14"
"64","000","00","006","0625","0000","571","427","144","77","648","1077","0","60.17","39.65"
"64","000","00","006","0625","1132","571","427","144","77","648","1077","0","60.17","39.65"
"64","000","00","006","0626","0000","407","311","96","17","424","875","0","48.46","35.54"
"64","000","00","006","0626","1133","407","311","96","17","424","875","0","48.46","35.54"
"64","000","00","006","0627","0000","479","367","112","23","502","936","0","53.63","39.21"
"64","000","00","006","0627","1134","479","367","112","23","502","936","0","53.63","39.21"
"64","000","00","006","0628","0000","491","382","109","62","553","944","0","58.58","40.47"
"64","000","00","006","0628","1135","491","382","109","62","553","944","0","58.58","40.47"
"64","000","00","006","0629","0000","406","312","94","32","438","833","0","52.58","37.45"
"64","000","00","006","0629","1136","406","312","94","32","438","833","0","52.58","37.45"
"64","000","00","006","0630","0000","395","296","99","13","408","708","0","57.63","41.81"
"64","000","00","006","0630","1137","395","296","99","13","408","708","0","57.63","41.81"
"64","000","00","006","0631","0000","405","338","67","18","423","741","0","57.09","45.61"
"64","000","00","006","0631","1138","405","338","67","18","423","741","0","57.09","45.61"
"64","000","00","006","0632","0000","596","426","170","36","632","1235","0","51.17","34.49"
"64","000","00","006","0632","1139","596","426","170","36","632","1235","0","51.17","34.49"
"64","000","00","007","0000","0000","13203","10022","3181","900","14103","23928","26732","58.94","41.88"
"64","000","00","007","0701","0000","332","256","76","18","350","673","0","52.01","38.04"
"64","000","00","007","0701","1076","332","256","76","18","350","673","0","52.01","38.04"
"64","000","00","007","0702","0000","595","483","112","25","620","1022","0","60.67","47.26"
"64","000","00","007","0702","1077","595","483","112","25","620","1022","0","60.67","47.26"
"64","000","00","007","0703","0000","673","541","132","41","714","1324","0","53.93","40.86"
"64","000","00","007","0703","1078","673","541","132","41","714","1324","0","53.93","40.86"
"64","000","00","007","0704","0000","458","353","105","50","508","839","0","60.55","42.07"
"64","000","00","007","0704","1079","458","353","105","50","508","839","0","60.55","42.07"
"64","000","00","007","0705","0000","517","373","144","74","591","975","0","60.62","38.26"
"64","000","00","007","0705","1080","517","373","144","74","591","975","0","60.62","38.26"
"64","000","00","007","0706","0000","1973","1558","415","113","2086","3587","0","58.15","43.43"
"64","000","00","007","0706","1081","995","805","190","70","1065","1806","0","58.97","44.57"
"64","000","00","007","0706","1082","978","753","225","43","1021","1781","0","57.33","42.28"
"64","000","00","007","0707","0000","413","317","96","37","450","717","0","62.76","44.21"
"64","000","00","007","0707","1083","413","317","96","37","450","717","0","62.76","44.21"
"64","000","00","007","0708","0000","601","464","137","12","613","1097","0","55.88","42.3"
"64","000","00","007","0708","1084","601","464","137","12","613","1097","0","55.88","42.3"
"64","000","00","007","0709","0000","884","670","214","33","917","1633","0","56.15","41.03"
"64","000","00","007","0709","1085","884","670","214","33","917","1633","0","56.15","41.03"
"64","000","00","007","0710","0000","477","360","117","37","514","759","0","67.72","47.43"
"64","000","00","007","0710","1086","477","360","117","37","514","759","0","67.72","47.43"
"64","000","00","007","0711","0000","566","417","149","56","622","948","0","65.61","43.99"
"64","000","00","007","0711","1087","566","417","149","56","622","948","0","65.61","43.99"
"64","000","00","007","0712","0000","486","345","141","77","563","1009","0","55.8","34.19"
"64","000","00","007","0712","1088","486","345","141","77","563","1009","0","55.8","34.19"
"64","000","00","007","0713","0000","537","420","117","32","569","945","0","60.21","44.44"
"64","000","00","007","0713","1089","537","420","117","32","569","945","0","60.21","44.44"
"64","000","00","007","0714","0000","893","683","210","52","945","1529","0","61.81","44.67"
"64","000","00","007","0714","1090","430","331","99","26","456","772","0","59.07","42.88"
"64","000","00","007","0714","1091","463","352","111","26","489","757","0","64.6","46.5"
"64","000","00","007","0715","0000","605","475","130","41","646","1047","0","61.7","45.37"
"64","000","00","007","0715","1092","605","475","130","41","646","1047","0","61.7","45.37"
"64","000","00","007","0716","0000","575","421","154","48","623","985","0","63.25","42.74"
"64","000","00","007","0716","1093","575","421","154","48","623","985","0","63.25","42.74"
"64","000","00","007","0717","0000","875","557","318","26","901","1674","0","53.82","33.27"
"64","000","00","007","0717","1094","875","557","318","26","901","1674","0","53.82","33.27"
"64","000","00","007","0718","0000","584","448","136","31","615","1088","0","56.53","41.18"
"64","000","00","007","0718","1095","584","448","136","31","615","1088","0","56.53","41.18"
"64","000","00","007","0719","0000","546","416","130","55","601","893","0","67.3","46.58"
"64","000","00","007","0719","1096","546","416","130","55","601","893","0","67.3","46.58"
"64","000","00","007","0720","0000","613","465","148","42","655","1184","0","55.32","39.27"
"64","000","00","007","0720","1097","613","465","148","42","655","1184","0","55.32","39.27"
"64","000","00","008","0000","0000","81881","62964","18917","5252","87133","146786","169840","59.36","42.9"
"64","000","00","008","0801","0000","419","315","104","30","449","718","0","62.53","43.87"
"64","000","00","008","0801","1140","419","315","104","30","449","718","0","62.53","43.87"
"64","000","00","008","0802","0000","800","655","145","46","846","1492","0","56.7","43.9"
"64","000","00","008","0802","1141","800","655","145","46","846","1492","0","56.7","43.9"
"64","000","00","008","0803","0000","683","539","144","47","730","1210","0","60.33","44.55"
"64","000","00","008","0803","1142","683","539","144","47","730","1210","0","60.33","44.55"
"64","000","00","008","0804","0000","762","603","159","30","792","1617","0","48.98","37.29"
"64","000","00","008","0804","1143","762","603","159","30","792","1617","0","48.98","37.29"
"64","000","00","008","0805","0000","798","636","162","80","878","1428","0","61.48","44.54"
"64","000","00","008","0805","1144","798","636","162","80","878","1428","0","61.48","44.54"
"64","000","00","008","0806","0000","687","514","173","51","738","1444","0","51.11","35.6"
"64","000","00","008","0806","1145","687","514","173","51","738","1444","0","51.11","35.6"
"64","000","00","008","0807","0000","792","599","193","77","869","1452","0","59.85","41.25"
"64","000","00","008","0807","1146","792","599","193","77","869","1452","0","59.85","41.25"
"64","000","00","008","0808","0000","316","237","79","39","355","554","0","64.08","42.78"
"64","000","00","008","0808","1147","316","237","79","39","355","554","0","64.08","42.78"
"64","000","00","008","0809","0000","1002","738","264","37","1039","1928","0","53.89","38.28"
"64","000","00","008","0809","1148","502","369","133","19","521","950","0","54.84","38.84"
"64","000","00","008","0809","1149","500","369","131","18","518","978","0","52.97","37.73"
"64","000","00","008","0810","0000","1818","1378","440","95","1913","3718","0","51.45","37.06"
"64","000","00","008","0810","1150","804","608","196","36","840","1673","0","50.21","36.34"
"64","000","00","008","0810","1151","1014","770","244","59","1073","2045","0","52.47","37.65"
"64","000","00","008","0811","0000","521","378","143","69","590","939","0","62.83","40.26"
"64","000","00","008","0811","1152","521","378","143","69","590","939","0","62.83","40.26"
"64","000","00","008","0812","0000","655","515","140","37","692","1284","0","53.89","40.11"
"64","000","00","008","0812","1153","655","515","140","37","692","1284","0","53.89","40.11"
"64","000","00","008","0813","0000","960","753","207","43","1003","1746","0","57.45","43.13"
"64","000","00","008","0813","1154","516","405","111","27","543","908","0","59.8","44.6"
"64","000","00","008","0813","1155","444","348","96","16","460","838","0","54.89","41.53"
"64","000","00","008","0814","0000","732","552","180","39","771","1267","0","60.85","43.57"
"64","000","00","008","0814","1156","732","552","180","39","771","1267","0","60.85","43.57"
"64","000","00","008","0815","0000","592","331","261","72","664","1768","0","37.56","18.72"
"64","000","00","008","0815","1157","212","65","147","51","263","994","0","26.46","6.54"
"64","000","00","008","0815","1158","380","266","114","21","401","774","0","51.81","34.37"
"64","000","00","008","0816","0000","631","494","137","27","658","1121","0","58.7","44.07"
"64","000","00","008","0816","1159","631","494","137","27","658","1121","0","58.7","44.07"
"64","000","00","008","0817","0000","1672","1244","428","136","1808","2999","0","60.29","41.48"
"64","000","00","008","0817","1160","801","589","212","65","866","1474","0","58.75","39.96"
"64","000","00","008","0817","1161","871","655","216","71","942","1525","0","61.77","42.95"
"64","000","00","008","0818","0000","1223","1049","174","68","1291","2161","0","59.74","48.54"
"64","000","00","008","0818","1162","624","594","30","32","656","1147","0","57.19","51.79"
"64","000","00","008","0818","1163","599","455","144","36","635","1014","0","62.62","44.87"
"64","000","00","008","0819","0000","1719","1285","434","128","1847","2995","0","61.67","42.9"
"64","000","00","008","0819","1164","847","615","232","59","906","1496","0","60.56","41.11"
"64","000","00","008","0819","1165","872","670","202","69","941","1499","0","62.78","44.7"
"64","000","00","008","0820","0000","1201","940","261","72","1273","1977","0","64.39","47.55"
"64","000","00","008","0820","1166","663","521","142","31","694","1138","0","60.98","45.78"
"64","000","00","008","0820","1167","538","419","119","41","579","839","0","69.01","49.94"
"64","000","00","008","0821","0000","671","529","142","43","714","2088","0","34.2","25.34"
"64","000","00","008","0821","1168","671","529","142","43","714","2088","0","34.2","25.34"
"64","000","00","008","0822","0000","1811","1380","431","107","1918","3271","0","58.64","42.19"
"64","000","00","008","0822","1169","927","704","223","39","966","1648","0","58.62","42.72"
"64","000","00","008","0822","1170","884","676","208","68","952","1623","0","58.66","41.65"
"64","000","00","008","0823","0000","1169","805","364","58","1227","1932","0","63.51","41.67"
"64","000","00","008","0823","1171","1169","805","364","58","1227","1932","0","63.51","41.67"
"64","000","00","008","0824","0000","1486","1172","314","49","1535","2283","0","67.24","51.34"
"64","000","00","008","0824","1172","737","587","150","24","761","1127","0","67.52","52.09"
"64","000","00","008","0824","1173","749","585","164","25","774","1156","0","66.96","50.61"
"64","000","00","008","0825","0000","867","671","196","36","903","1465","0","61.64","45.8"
"64","000","00","008","0825","1174","867","671","196","36","903","1465","0","61.64","45.8"
"64","000","00","008","0826","0000","332","268","64","29","361","690","0","52.32","38.84"
"64","000","00","008","0826","1175","332","268","64","29","361","690","0","52.32","38.84"
"64","000","00","008","0827","0000","638","492","146","93","731","1283","0","56.98","38.35"
"64","000","00","008","0827","1176","638","492","146","93","731","1283","0","56.98","38.35"
"64","000","00","008","0828","0000","1520","1179","341","123","1643","2745","0","59.85","42.95"
"64","000","00","008","0828","1177","785","600","185","75","860","1432","0","60.06","41.9"
"64","000","00","008","0828","1178","735","579","156","48","783","1313","0","59.63","44.1"
"64","000","00","008","0829","0000","807","606","201","24","831","1579","0","52.63","38.38"
"64","000","00","008","0829","1179","807","606","201","24","831","1579","0","52.63","38.38"
"64","000","00","008","0830","0000","1590","1224","366","130","1720","2834","0","60.69","43.19"
"64","000","00","008","0830","1180","767","570","197","67","834","1385","0","60.22","41.16"
"64","000","00","008","0830","1181","823","654","169","63","886","1449","0","61.15","45.13"
"64","000","00","008","0831","0000","1095","860","235","48","1143","1834","0","62.32","46.89"
"64","000","00","008","0831","1182","1095","860","235","48","1143","1834","0","62.32","46.89"
"64","000","00","008","0832","0000","1701","1314","387","113","1814","2867","0","63.27","45.83"
"64","000","00","008","0832","1183","840","641","199","58","898","1436","0","62.53","44.64"
"64","000","00","008","0832","1184","861","673","188","55","916","1431","0","64.01","47.03"
"64","000","00","008","0833","0000","1666","1295","371","55","1721","2718","0","63.32","47.65"
"64","000","00","008","0833","1185","773","588","185","16","789","1248","0","63.22","47.12"
"64","000","00","008","0833","1186","893","707","186","39","932","1470","0","63.4","48.1"
"64","000","00","008","0834","0000","936","743","193","82","1018","1540","0","66.1","48.25"
"64","000","00","008","0834","1187","936","743","193","82","1018","1540","0","66.1","48.25"
"64","000","00","008","0835","0000","1359","1046","313","54","1413","2213","0","63.85","47.27"
"64","000","00","008","0835","1188","829","637","192","30","859","1374","0","62.52","46.36"
"64","000","00","008","0835","1189","530","409","121","24","554","839","0","66.03","48.75"
"64","000","00","008","0836","0000","1317","1051","266","51","1368","2084","0","65.64","50.43"
"64","000","00","008","0836","1190","653","519","134","36","689","1022","0","67.42","50.78"
"64","000","00","008","0836","1191","664","532","132","15","679","1062","0","63.94","50.09"
"64","000","00","008","0837","0000","1319","1002","317","46","1365","2195","0","62.19","45.65"
"64","000","00","008","0837","1192","626","483","143","21","647","1078","0","60.02","44.81"
"64","000","00","008","0837","1193","693","519","174","25","718","1117","0","64.28","46.46"
"64","000","00","008","0838","0000","893","690","203","43","936","1516","0","61.74","45.51"
"64","000","00","008","0838","1194","893","690","203","43","936","1516","0","61.74","45.51"
"64","000","00","008","0839","0000","774","559","215","114","888","1440","0","61.67","38.82"
"64","000","00","008","0839","1195","774","559","215","114","888","1440","0","61.67","38.82"
"64","000","00","008","0840","0000","934","717","217","64","998","1727","0","57.79","41.52"
"64","000","00","008","0840","1196","475","358","117","37","512","839","0","61.03","42.67"
"64","000","00","008","0840","1197","459","359","100","27","486","888","0","54.73","40.43"
"64","000","00","008","0841","0000","1311","986","325","94","1405","2105","0","66.75","46.84"
"64","000","00","008","0841","1198","660","501","159","31","691","1101","0","62.76","45.5"
"64","000","00","008","0841","1199","651","485","166","63","714","1004","0","71.12","48.31"
"64","000","00","008","0842","0000","2204","1683","521","154","2358","3779","0","62.4","44.54"
"64","000","00","008","0842","1200","809","624","185","64","873","1427","0","61.18","43.73"
"64","000","00","008","0842","1201","659","502","157","31","690","1168","0","59.08","42.98"
"64","000","00","008","0842","1202","736","557","179","59","795","1184","0","67.15","47.04"
"64","000","00","008","0843","0000","1005","773","232","49","1054","1823","0","57.82","42.4"
"64","000","00","008","0843","1203","579","442","137","35","614","974","0","63.04","45.38"
"64","000","00","008","0843","1204","426","331","95","14","440","849","0","51.83","38.99"
"64","000","00","008","0844","0000","1044","822","222","52","1096","1821","0","60.19","45.14"
"64","000","00","008","0844","1205","1044","822","222","52","1096","1821","0","60.19","45.14"
"64","000","00","008","0845","0000","2247","1710","537","130","2377","3906","0","60.86","43.78"
"64","000","00","008","0845","1206","765","587","178","54","819","1306","0","62.71","44.95"
"64","000","00","008","0845","1207","703","540","163","26","729","1185","0","61.52","45.57"
"64","000","00","008","0845","1208","779","583","196","50","829","1415","0","58.59","41.2"
"64","000","00","008","0846","0000","1111","849","262","110","1221","1926","0","63.4","44.08"
"64","000","00","008","0846","1209","592","455","137","40","632","962","0","65.7","47.3"
"64","000","00","008","0846","1210","519","394","125","70","589","964","0","61.1","40.87"
"64","000","00","008","0847","0000","863","659","204","35","898","1524","0","58.92","43.24"
"64","000","00","008","0847","1211","863","659","204","35","898","1524","0","58.92","43.24"
"64","000","00","008","0848","0000","847","611","236","30","877","1455","0","60.27","41.99"
"64","000","00","008","0848","1212","847","611","236","30","877","1455","0","60.27","41.99"
"64","000","00","008","0849","0000","1276","978","298","71","1347","2528","0","53.28","38.69"
"64","000","00","008","0849","1213","632","478","154","41","673","1272","0","52.91","37.58"
"64","000","00","008","0849","1214","644","500","144","30","674","1256","0","53.66","39.81"
"64","000","00","008","0850","0000","638","508","130","34","672","1203","0","55.86","42.23"
"64","000","00","008","0850","1215","638","508","130","34","672","1203","0","55.86","42.23"
"64","000","00","008","0851","0000","619","500","119","20","639","1062","0","60.17","47.08"
"64","000","00","008","0851","1216","619","500","119","20","639","1062","0","60.17","47.08"
"64","000","00","008","0852","0000","1095","824","271","151","1246","1860","0","66.99","44.3"
"64","000","00","008","0852","1217","504","379","125","64","568","850","0","66.82","44.59"
"64","000","00","008","0852","1218","591","445","146","87","678","1010","0","67.13","44.06"
"64","000","00","008","0853","0000","1136","904","232","87","1223","2055","0","59.51","43.99"
"64","000","00","008","0853","1219","600","483","117","31","631","1118","0","56.44","43.2"
"64","000","00","008","0853","1220","536","421","115","56","592","937","0","63.18","44.93"
"64","000","00","008","0854","0000","1385","1091","294","60","1445","2676","0","54.0","40.77"
"64","000","00","008","0854","1221","707","551","156","30","737","1493","0","49.36","36.91"
"64","000","00","008","0854","1222","678","540","138","30","708","1183","0","59.85","45.65"
"64","000","00","008","0855","0000","1366","1061","305","85","1451","2680","0","54.14","39.59"
"64","000","00","008","0855","1223","625","508","117","33","658","1318","0","49.92","38.54"
"64","000","00","008","0855","1224","741","553","188","52","793","1362","0","58.22","40.6"
"64","000","00","008","0856","0000","1380","1059","321","157","1537","2583","0","59.5","41.0"
"64","000","00","008","0856","1225","577","434","143","88","665","1102","0","60.34","39.38"
"64","000","00","008","0856","1226","803","625","178","69","872","1481","0","58.88","42.2"
"64","000","00","008","0857","0000","966","730","236","79","1045","1786","0","58.51","40.87"
"64","000","00","008","0857","1227","524","399","125","58","582","878","0","66.29","45.44"
"64","000","00","008","0857","1228","442","331","111","21","463","908","0","50.99","36.45"
"64","000","00","008","0858","0000","1178","920","258","89","1267","2147","0","59.01","42.85"
"64","000","00","008","0858","1229","638","502","136","50","688","1056","0","65.15","47.54"
"64","000","00","008","0858","1230","540","418","122","39","579","1091","0","53.07","38.31"
"64","000","00","008","0859","0000","1244","930","314","70","1314","2039","0","64.44","45.61"
"64","000","00","008","0859","1231","583","440","143","25","608","976","0","62.3","45.08"
"64","000","00","008","0859","1232","661","490","171","45","706","1063","0","66.42","46.1"
"64","000","00","008","0860","0000","1612","1203","409","103","1715","2774","0","61.82","43.37"
"64","000","00","008","0860","1233","867","680","187","70","937","1484","0","63.14","45.82"
"64","000","00","008","0860","1234","745","523","222","33","778","1290","0","60.31","40.54"
"64","000","00","008","0861","0000","2870","2285","585","156","3026","4982","0","60.74","45.87"
"64","000","00","008","0861","1235","999","779","220","63","1062","1740","0","61.03","44.77"
"64","000","00","008","0861","1236","974","777","197","68","1042","1594","0","65.37","48.75"
"64","000","00","008","0861","1237","897","729","168","25","922","1648","0","55.95","44.24"
"64","000","00","008","0862","0000","2127","1649","478","138","2265","3730","0","60.72","44.21"
"64","000","00","008","0862","1238","738","588","150","62","800","1236","0","64.72","47.57"
"64","000","00","008","0862","1239","698","534","164","45","743","1211","0","61.35","44.1"
"64","000","00","008","0862","1240","691","527","164","31","722","1283","0","56.27","41.08"
"64","000","00","008","0863","0000","2066","1580","486","149","2215","3522","0","62.89","44.86"
"64","000","00","008","0863","1241","1041","797","244","86","1127","1804","0","62.47","44.18"
"64","000","00","008","0863","1242","1025","783","242","63","1088","1718","0","63.33","45.58"
"64","000","00","008","0864","0000","2321","1786","535","170","2491","4053","0","61.46","44.07"
"64","000","00","008","0864","1243","759","596","163","56","815","1297","0","62.84","45.95"
"64","000","00","008","0864","1244","807","613","194","84","891","1449","0","61.49","42.31"
"64","000","00","008","0864","1245","755","577","178","30","785","1307","0","60.06","44.15"
"64","000","00","008","0865","0000","1464","1130","334","131","1595","2434","0","65.53","46.43"
"64","000","00","008","0865","1246","700","551","149","51","751","1184","0","63.43","46.54"
"64","000","00","008","0865","1247","764","579","185","80","844","1250","0","67.52","46.32"
"64","000","00","008","0866","0000","1406","1081","325","62","1468","2531","0","58.0","42.71"
"64","000","00","008","0866","1248","677","507","170","36","713","1248","0","57.13","40.63"
"64","000","00","008","0866","1249","729","574","155","26","755","1283","0","58.85","44.74"
"64","000","00","008","0867","0000","2080","1641","439","89","2169","3718","0","58.34","44.14"
"64","000","00","008","0867","1250","637","513","124","30","667","1121","0","59.5","45.76"
"64","000","00","008","0867","1251","711","540","171","26","737","1258","0","58.59","42.93"
"64","000","00","008","0867","1252","732","588","144","33","765","1339","0","57.13","43.91"
"64","000","00","008","0868","0000","1038","770","268","60","1098","1986","0","55.29","38.77"
"64","000","00","008","0868","1253","1038","770","268","60","1098","1986","0","55.29","38.77"
"64","000","00","008","0869","0000","1114","883","231","52","1166","1976","0","59.01","44.69"
"64","000","00","008","0869","1254","563","451","112","34","597","1028","0","58.07","43.87"
"64","000","00","008","0869","1255","551","432","119","18","569","948","0","60.02","45.57"
"64","000","00","009","0000","0000","85669","66683","18986","7156","92825","161797","188516","57.37","41.21"
"64","000","00","009","0901","0000","4256","3204","1052","440","4696","9323","0","50.37","34.37"
"64","000","00","009","0901","1484","776","554","222","130","906","1809","0","50.08","30.62"
"64","000","00","009","0901","1485","930","698","232","91","1021","1835","0","55.64","38.04"
"64","000","00","009","0901","1486","765","592","173","78","843","1890","0","44.6","31.32"
"64","000","00","009","0901","1487","912","706","206","66","978","2013","0","48.58","35.07"
"64","000","00","009","0901","1488","873","654","219","75","948","1776","0","53.38","36.82"
"64","000","00","009","0902","0000","1081","820","261","172","1253","2377","0","52.71","34.5"
"64","000","00","009","0902","1489","735","549","186","96","831","1705","0","48.74","32.2"
"64","000","00","009","0902","1490","346","271","75","76","422","672","0","62.8","40.33"
"64","000","00","009","0903","0000","2516","1938","578","209","2725","5013","0","54.36","38.66"
"64","000","00","009","0903","1491","753","577","176","92","845","1726","0","48.96","33.43"
"64","000","00","009","0903","1492","845","663","182","35","880","1597","0","55.1","41.52"
"64","000","00","009","0903","1493","918","698","220","82","1000","1690","0","59.17","41.3"
"64","000","00","009","0904","0000","1312","1010","302","139","1451","2239","0","64.81","45.11"
"64","000","00","009","0904","1494","613","480","133","73","686","1080","0","63.52","44.44"
"64","000","00","009","0904","1495","699","530","169","66","765","1159","0","66.01","45.73"
"64","000","00","009","0905","0000","639","501","138","74","713","1314","0","54.26","38.13"
"64","000","00","009","0905","1496","639","501","138","74","713","1314","0","54.26","38.13"
"64","000","00","009","0906","0000","1050","833","217","104","1154","1898","0","60.8","43.89"
"64","000","00","009","0906","1497","495","405","90","65","560","896","0","62.5","45.2"
"64","000","00","009","0906","1498","555","428","127","39","594","1002","0","59.28","42.71"
"64","000","00","009","0907","0000","954","731","223","112","1066","2765","0","38.55","26.44"
"64","000","00","009","0907","1499","954","731","223","112","1066","2765","0","38.55","26.44"
"64","000","00","009","0908","0000","309","260","49","69","378","600","0","63.0","43.33"
"64","000","00","009","0908","1500","309","260","49","69","378","600","0","63.0","43.33"
"64","000","00","009","0909","0000","469","353","116","48","517","1466","0","35.27","24.08"
"64","000","00","009","0909","1501","469","353","116","48","517","1466","0","35.27","24.08"
"64","000","00","009","0910","0000","711","551","160","46","757","1449","0","52.24","38.03"
"64","000","00","009","0910","1502","711","551","160","46","757","1449","0","52.24","38.03"
"64","000","00","009","0911","0000","1163","914","249","136","1299","2239","0","58.02","40.82"
"64","000","00","009","0911","1503","488","381","107","57","545","991","0","54.99","38.45"
"64","000","00","009","0911","1504","675","533","142","79","754","1248","0","60.42","42.71"
"64","000","00","009","0912","0000","579","456","123","100","679","1066","0","63.7","42.78"
"64","000","00","009","0912","1505","579","456","123","100","679","1066","0","63.7","42.78"
"64","000","00","009","0913","0000","297","233","64","33","330","706","0","46.74","33.0"
"64","000","00","009","0913","1506","297","233","64","33","330","706","0","46.74","33.0"
"64","000","00","009","0914","0000","332","255","77","37","369","713","0","51.75","35.76"
"64","000","00","009","0914","1507","332","255","77","37","369","713","0","51.75","35.76"
"64","000","00","009","0915","0000","637","470","167","43","680","1344","0","50.6","34.97"
"64","000","00","009","0915","1508","637","470","167","43","680","1344","0","50.6","34.97"
"64","000","00","009","0916","0000","862","630","232","96","958","1729","0","55.41","36.44"
"64","000","00","009","0916","1509","463","344","119","54","517","856","0","60.4","40.19"
"64","000","00","009","0916","1510","399","286","113","42","441","873","0","50.52","32.76"
"64","000","00","009","0917","0000","1001","771","230","70","1071","2226","0","48.11","34.64"
"64","000","00","009","0917","1511","519","409","110","49","568","1114","0","50.99","36.71"
"64","000","00","009","0917","1512","482","362","120","21","503","1112","0","45.23","32.55"
"64","000","00","009","0918","0000","983","745","238","118","1101","1984","0","55.49","37.55"
"64","000","00","009","0918","1513","521","396","125","64","585","1044","0","56.03","37.93"
"64","000","00","009","0918","1514","462","349","113","54","516","940","0","54.89","37.13"
"64","000","00","009","0919","0000","2249","1742","507","178","2427","4064","0","59.72","42.86"
"64","000","00","009","0919","1515","628","492","136","74","702","1342","0","52.31","36.66"
"64","000","00","009","0919","1516","865","673","192","62","927","1402","0","66.12","48.0"
"64","000","00","009","0919","1517","756","577","179","42","798","1320","0","60.45","43.71"
"64","000","00","009","0920","0000","502","384","118","70","572","958","0","59.71","40.08"
"64","000","00","009","0920","1518","502","384","118","70","572","958","0","59.71","40.08"
"64","000","00","009","0921","0000","1638","1315","323","141","1779","2735","0","65.05","48.08"
"64","000","00","009","0921","1519","824","658","166","44","868","1276","0","68.03","51.57"
"64","000","00","009","0921","1520","814","657","157","97","911","1459","0","62.44","45.03"
"64","000","00","009","0922","0000","340","239","101","20","360","761","0","47.31","31.41"
"64","000","00","009","0922","1521","340","239","101","20","360","761","0","47.31","31.41"
"64","000","00","009","0923","0000","538","404","134","23","561","1093","0","51.33","36.96"
"64","000","00","009","0923","1522","538","404","134","23","561","1093","0","51.33","36.96"
"64","000","00","009","0924","0000","2741","2316","425","165","2906","4899","0","59.32","47.27"
"64","000","00","009","0924","1523","919","783","136","42","961","1521","0","63.18","51.48"
"64","000","00","009","0924","1524","913","767","146","45","958","1557","0","61.53","49.26"
"64","000","00","009","0924","1525","909","766","143","78","987","1821","0","54.2","42.06"
"64","000","00","009","0925","0000","1359","1160","199","60","1419","2112","0","67.19","54.92"
"64","000","00","009","0925","1526","698","583","115","39","737","1066","0","69.14","54.69"
"64","000","00","009","0925","1527","661","577","84","21","682","1046","0","65.2","55.16"
"64","000","00","009","0928","0000","1913","1423","490","143","2056","3432","0","59.91","41.46"
"64","000","00","009","0928","1528","937","686","251","55","992","1709","0","58.05","40.14"
"64","000","00","009","0928","1529","976","737","239","88","1064","1723","0","61.75","42.77"
"64","000","00","009","0929","0000","2459","1863","596","144","2603","3994","0","65.17","46.64"
"64","000","00","009","0929","1530","734","556","178","53","787","1202","0","65.47","46.26"
"64","000","00","009","0929","1531","796","577","219","42","838","1279","0","65.52","45.11"
"64","000","00","009","0929","1532","929","730","199","49","978","1513","0","64.64","48.25"
"64","000","00","009","0930","0000","690","578","112","18","708","1260","0","56.19","45.87"
"64","000","00","009","0930","1533","690","578","112","18","708","1260","0","56.19","45.87"
"64","000","00","009","0931","0000","1375","1053","322","133","1508","2279","0","66.17","46.2"
"64","000","00","009","0931","1534","664","506","158","84","748","1139","0","65.67","44.42"
"64","000","00","009","0931","1535","711","547","164","49","760","1140","0","66.67","47.98"
"64","000","00","009","0932","0000","1635","1253","382","126","1761","2821","0","62.42","44.42"
"64","000","00","009","0932","1536","846","642","204","73","919","1462","0","62.86","43.91"
"64","000","00","009","0932","1537","789","611","178","53","842","1359","0","61.96","44.96"
"64","000","00","009","0933","0000","963","701","262","97","1060","2037","0","52.04","34.41"
"64","000","00","009","0933","1538","963","701","262","97","1060","2037","0","52.04","34.41"
"64","000","00","009","0934","0000","1443","1115","328","51","1494","2717","0","54.99","41.04"
"64","000","00","009","0934","1539","736","591","145","28","764","1410","0","54.18","41.91"
"64","000","00","009","0934","1540","707","524","183","23","730","1307","0","55.85","40.09"
"64","000","00","009","0935","0000","1639","1206","433","168","1807","3003","0","60.17","40.16"
"64","000","00","009","0935","1541","804","593","211","87","891","1512","0","58.93","39.22"
"64","000","00","009","0935","1542","835","613","222","81","916","1491","0","61.44","41.11"
"64","000","00","009","0936","0000","1595","1260","335","163","1758","3143","0","55.93","40.09"
"64","000","00","009","0936","1543","860","672","188","91","951","1621","0","58.67","41.46"
"64","000","00","009","0936","1544","735","588","147","72","807","1522","0","53.02","38.63"
"64","000","00","009","0937","0000","3014","2302","712","247","3261","5348","0","60.98","43.04"
"64","000","00","009","0937","1545","882","659","223","65","947","1593","0","59.45","41.37"
"64","000","00","009","0937","1546","1051","816","235","92","1143","1885","0","60.64","43.29"
"64","000","00","009","0937","1547","1081","827","254","90","1171","1870","0","62.62","44.22"
"64","000","00","009","0938","0000","1513","1153","360","99","1612","2736","0","58.92","42.14"
"64","000","00","009","0938","1548","771","576","195","31","802","1388","0","57.78","41.5"
"64","000","00","009","0938","1549","742","577","165","68","810","1348","0","60.09","42.8"
"64","000","00","009","0939","0000","1487","1138","349","152","1639","2705","0","60.59","42.07"
"64","000","00","009","0939","1550","665","529","136","111","776","1341","0","57.87","39.45"
"64","000","00","009","0939","1551","822","609","213","41","863","1364","0","63.27","44.65"
"64","000","00","009","0940","0000","1444","1080","364","164","1608","2693","0","59.71","40.1"
"64","000","00","009","0940","1552","750","567","183","79","829","1367","0","60.64","41.48"
"64","000","00","009","0940","1553","694","513","181","85","779","1326","0","58.75","38.69"
"64","000","00","009","0941","0000","1206","975","231","70","1276","2178","0","58.59","44.77"
"64","000","00","009","0941","1554","569","456","113","44","613","1059","0","57.88","43.06"
"64","000","00","009","0941","1555","637","519","118","26","663","1119","0","59.25","46.38"
"64","000","00","009","0942","0000","3720","2987","733","208","3928","6642","0","59.14","44.97"
"64","000","00","009","0942","1556","782","598","184","42","824","1565","0","52.65","38.21"
"64","000","00","009","0942","1557","826","721","105","77","903","1549","0","58.3","46.55"
"64","000","00","009","0942","1558","1053","823","230","43","1096","1691","0","64.81","48.67"
"64","000","00","009","0942","1559","1059","845","214","46","1105","1837","0","60.15","46.0"
"64","000","00","009","0943","0000","1291","1010","281","82","1373","2218","0","61.9","45.54"
"64","000","00","009","0943","1560","644","512","132","24","668","1092","0","61.17","46.89"
"64","000","00","009","0943","1561","647","498","149","58","705","1126","0","62.61","44.23"
"64","000","00","009","0944","0000","2379","1820","559","142","2521","4106","0","61.4","44.33"
"64","000","00","009","0944","1562","623","489","134","83","706","1215","0","58.11","40.25"
"64","000","00","009","0944","1563","822","618","204","31","853","1443","0","59.11","42.83"
"64","000","00","009","0944","1564","934","713","221","28","962","1448","0","66.44","49.24"
"64","000","00","009","0945","0000","1721","1348","373","181","1902","3251","0","58.51","41.46"
"64","000","00","009","0945","1565","916","732","184","93","1009","1648","0","61.23","44.42"
"64","000","00","009","0945","1566","805","616","189","88","893","1603","0","55.71","38.43"
"64","000","00","009","0946","0000","744","600","144","34","778","1596","0","48.75","37.59"
"64","000","00","009","0946","1567","744","600","144","34","778","1596","0","48.75","37.59"
"64","000","00","009","0947","0000","2350","1841","509","229","2579","4607","0","55.98","39.96"
"64","000","00","009","0947","1568","668","534","134","41","709","1450","0","48.9","36.83"
"64","000","00","009","0947","1569","743","599","144","94","837","1510","0","55.43","39.67"
"64","000","00","009","0947","1570","939","708","231","94","1033","1647","0","62.72","42.99"
"64","000","00","009","0948","0000","1383","1113","270","123","1506","2726","0","55.25","40.83"
"64","000","00","009","0948","1571","698","565","133","72","770","1342","0","57.38","42.1"
"64","000","00","009","0948","1572","685","548","137","51","736","1384","0","53.18","39.6"
"64","000","00","009","0949","0000","2494","1986","508","186","2680","4620","0","58.01","42.99"
"64","000","00","009","0949","1573","763","623","140","75","838","1479","0","56.66","42.12"
"64","000","00","009","0949","1574","835","663","172","39","874","1546","0","56.53","42.88"
"64","000","00","009","0949","1575","896","700","196","72","968","1595","0","60.69","43.89"
"64","000","00","009","0950","0000","1223","981","242","94","1317","2283","0","57.69","42.97"
"64","000","00","009","0950","1576","672","549","123","69","741","1201","0","61.7","45.71"
"64","000","00","009","0950","1577","551","432","119","25","576","1082","0","53.23","39.93"
"64","000","00","009","0951","0000","991","778","213","127","1118","1928","0","57.99","40.35"
"64","000","00","009","0951","1578","498","397","101","43","541","996","0","54.32","39.86"
"64","000","00","009","0951","1579","493","381","112","84","577","932","0","61.91","40.88"
"64","000","00","009","0952","0000","2044","1612","432","105","2149","3574","0","60.13","45.1"
"64","000","00","009","0952","1580","637","479","158","51","688","1146","0","60.03","41.8"
"64","000","00","009","0952","1581","615","482","133","33","648","1096","0","59.12","43.98"
"64","000","00","009","0952","1582","792","651","141","21","813","1332","0","61.04","48.87"
"64","000","00","009","0953","0000","1912","1493","419","181","2093","3477","0","60.2","42.94"
"64","000","00","009","0953","1583","631","479","152","40","671","1175","0","57.11","40.77"
"64","000","00","009","0953","1584","537","426","111","62","599","986","0","60.75","43.2"
"64","000","00","009","0953","1585","744","588","156","79","823","1316","0","62.54","44.68"
"64","000","00","009","0954","0000","1654","1267","387","144","1798","3181","0","56.52","39.83"
"64","000","00","009","0954","1586","746","569","177","65","811","1559","0","52.02","36.5"
"64","000","00","009","0954","1587","908","698","210","79","987","1622","0","60.85","43.03"
"64","000","00","009","0955","0000","1373","1078","295","141","1514","2609","0","58.03","41.32"
"64","000","00","009","0955","1588","679","553","126","37","716","1310","0","54.66","42.21"
"64","000","00","009","0955","1589","694","525","169","104","798","1299","0","61.43","40.42"
"64","000","00","009","0956","0000","1404","1127","277","102","1506","2566","0","58.69","43.92"
"64","000","00","009","0956","1590","720","567","153","73","793","1191","0","66.58","47.61"
"64","000","00","009","0956","1591","684","560","124","29","713","1375","0","51.85","40.73"
"64","000","00","009","0957","0000","1330","1038","292","62","1392","2513","0","55.39","41.31"
"64","000","00","009","0957","1592","723","574","149","36","759","1338","0","56.73","42.9"
"64","000","00","009","0957","1593","607","464","143","26","633","1175","0","53.87","39.49"
"64","000","00","009","0958","0000","1430","1108","322","88","1518","2544","0","59.67","43.55"
"64","000","00","009","0958","1594","719","580","139","27","746","1357","0","54.97","42.74"
"64","000","00","009","0958","1595","711","528","183","61","772","1187","0","65.04","44.48"
"64","000","00","009","0959","0000","1310","1029","281","114","1424","2383","0","59.76","43.18"
"64","000","00","009","0959","1596","611","480","131","49","660","1164","0","56.7","41.24"
"64","000","00","009","0959","1597","699","549","150","65","764","1219","0","62.67","45.04"
"64","000","00","009","0960","0000","2391","1851","540","174","2565","4454","0","57.59","41.56"
"64","000","00","009","0960","1598","751","565","186","25","776","1428","0","54.34","39.57"
"64","000","00","009","0960","1599","773","579","194","108","881","1495","0","58.93","38.73"
"64","000","00","009","0960","1600","867","707","160","41","908","1531","0","59.31","46.18"
"64","000","00","009","0961","0000","1631","1281","350","161","1792","3100","0","57.81","41.32"
"64","000","00","009","0961","1601","811","648","163","86","897","1509","0","59.44","42.94"
"64","000","00","009","0961","1602","820","633","187","75","895","1591","0","56.25","39.79"
"64","000","00","010","0000","0000","11038","8332","2706","1261","12299","24860","28533","49.47","33.52"
"64","000","00","010","1001","0000","612","440","172","118","730","1177","0","62.02","37.38"
"64","000","00","010","1001","0869","612","440","172","118","730","1177","0","62.02","37.38"
"64","000","00","010","1002","0000","492","388","104","50","542","1109","0","48.87","34.99"
"64","000","00","010","1002","0870","492","388","104","50","542","1109","0","48.87","34.99"
"64","000","00","010","1003","0000","681","508","173","29","710","1642","0","43.24","30.94"
"64","000","00","010","1003","0871","681","508","173","29","710","1642","0","43.24","30.94"
"64","000","00","010","1004","0000","1022","798","224","160","1182","2321","0","50.93","34.38"
"64","000","00","010","1004","0872","554","445","109","106","660","1209","0","54.59","36.81"
"64","000","00","010","1004","0873","468","353","115","54","522","1112","0","46.94","31.74"
"64","000","00","010","1005","0000","1331","1033","298","132","1463","2943","0","49.71","35.1"
"64","000","00","010","1005","0874","748","546","202","101","849","1483","0","57.25","36.82"
"64","000","00","010","1005","0875","583","487","96","31","614","1460","0","42.05","33.36"
"64","000","00","010","1006","0000","824","601","223","159","983","1572","0","62.53","38.23"
"64","000","00","010","1006","0876","824","601","223","159","983","1572","0","62.53","38.23"
"64","000","00","010","1007","0000","593","476","117","30","623","1384","0","45.01","34.39"
"64","000","00","010","1007","0877","593","476","117","30","623","1384","0","45.01","34.39"
"64","000","00","010","1008","0000","1131","862","269","103","1234","2629","0","46.94","32.79"
"64","000","00","010","1008","0878","592","459","133","41","633","1390","0","45.54","33.02"
"64","000","00","010","1008","0879","539","403","136","62","601","1239","0","48.51","32.53"
"64","000","00","010","1009","0000","908","663","245","130","1038","2045","0","50.76","32.42"
"64","000","00","010","1009","0880","908","663","245","130","1038","2045","0","50.76","32.42"
"64","000","00","010","1010","0000","1231","893","338","160","1391","2759","0","50.42","32.37"
"64","000","00","010","1010","0881","392","290","102","23","415","893","0","46.47","32.47"
"64","000","00","010","1010","0882","839","603","236","137","976","1866","0","52.3","32.32"
"64","000","00","010","1011","0000","686","504","182","34","720","1874","0","38.42","26.89"
"64","000","00","010","1011","0883","686","504","182","34","720","1874","0","38.42","26.89"
"64","000","00","010","1012","0000","388","300","88","67","455","893","0","50.95","33.59"
"64","000","00","010","1012","0884","388","300","88","67","455","893","0","50.95","33.59"
"64","000","00","010","1013","0000","1139","866","273","89","1228","2512","0","48.89","34.47"
"64","000","00","010","1013","0885","586","420","166","41","627","1215","0","51.6","34.57"
"64","000","00","010","1013","0886","553","446","107","48","601","1297","0","46.34","34.39"
"64","000","00","011","0000","0000","71301","55974","15327","4956","76257","132733","157685","57.45","42.17"
"64","000","00","011","1101","0000","1316","1043","273","108","1424","2279","0","62.48","45.77"
"64","000","00","011","1101","1603","648","520","128","48","696","1108","0","62.82","46.93"
"64","000","00","011","1101","1604","668","523","145","60","728","1171","0","62.17","44.66"
"64","000","00","011","1102","0000","1778","1369","409","47","1825","3225","0","56.59","42.45"
"64","000","00","011","1102","1605","939","690","249","26","965","1557","0","61.98","44.32"
"64","000","00","011","1102","1606","839","679","160","21","860","1668","0","51.56","40.71"
"64","000","00","011","1103","0000","1446","1251","195","51","1497","2555","0","58.59","48.96"
"64","000","00","011","1103","1607","695","661","34","24","719","1183","0","60.78","55.87"
"64","000","00","011","1103","1608","751","590","161","27","778","1372","0","56.71","43.0"
"64","000","00","011","1104","0000","990","776","214","53","1043","1737","0","60.05","44.67"
"64","000","00","011","1104","1609","990","776","214","53","1043","1737","0","60.05","44.67"
"64","000","00","011","1105","0000","1591","1206","385","144","1735","3144","0","55.18","38.36"
"64","000","00","011","1105","1610","830","592","238","69","899","1586","0","56.68","37.33"
"64","000","00","011","1105","1611","761","614","147","75","836","1558","0","53.66","39.41"
"64","000","00","011","1106","0000","1517","1171","346","126","1643","2533","0","64.86","46.23"
"64","000","00","011","1106","1612","777","595","182","69","846","1284","0","65.89","46.34"
"64","000","00","011","1106","1613","740","576","164","57","797","1249","0","63.81","46.12"
"64","000","00","011","1107","0000","1008","797","211","118","1126","2400","0","46.92","33.21"
"64","000","00","011","1107","1614","1008","797","211","118","1126","2400","0","46.92","33.21"
"64","000","00","011","1108","0000","1238","950","288","76","1314","2260","0","58.14","42.04"
"64","000","00","011","1108","1615","660","493","167","45","705","1181","0","59.7","41.74"
"64","000","00","011","1108","1616","578","457","121","31","609","1079","0","56.44","42.35"
"64","000","00","011","1109","0000","1452","1145","307","97","1549","2576","0","60.13","44.45"
"64","000","00","011","1109","1617","745","577","168","38","783","1335","0","58.65","43.22"
"64","000","00","011","1109","1618","707","568","139","59","766","1241","0","61.72","45.77"
"64","000","00","011","1110","0000","3154","2482","672","206","3360","5796","0","57.97","42.82"
"64","000","00","011","1110","1619","809","627","182","63","872","1513","0","57.63","41.44"
"64","000","00","011","1110","1620","764","606","158","67","831","1349","0","61.6","44.92"
"64","000","00","011","1110","1621","778","600","178","46","824","1483","0","55.56","40.46"
"64","000","00","011","1110","1622","803","649","154","30","833","1451","0","57.41","44.73"
"64","000","00","011","1111","0000","1405","1066","339","93","1498","2503","0","59.85","42.59"
"64","000","00","011","1111","1623","630","495","135","25","655","1241","0","52.78","39.89"
"64","000","00","011","1111","1624","775","571","204","68","843","1262","0","66.8","45.25"
"64","000","00","011","1112","0000","1872","1484","388","133","2005","3690","0","54.34","40.22"
"64","000","00","011","1112","1625","1006","780","226","94","1100","1813","0","60.67","43.02"
"64","000","00","011","1112","1626","866","704","162","39","905","1877","0","48.22","37.51"
"64","000","00","011","1113","0000","1567","1207","360","61","1628","2844","0","57.24","42.44"
"64","000","00","011","1113","1627","743","570","173","29","772","1391","0","55.5","40.98"
"64","000","00","011","1113","1628","824","637","187","32","856","1453","0","58.91","43.84"
"64","000","00","011","1114","0000","2279","1772","507","165","2444","4056","0","60.26","43.69"
"64","000","00","011","1114","1629","778","586","192","42","820","1374","0","59.68","42.65"
"64","000","00","011","1114","1630","727","564","163","60","787","1348","0","58.38","41.84"
"64","000","00","011","1114","1631","774","622","152","63","837","1334","0","62.74","46.63"
"64","000","00","011","1115","0000","2344","1906","438","132","2476","4369","0","56.67","43.63"
"64","000","00","011","1115","1632","758","585","173","37","795","1433","0","55.48","40.82"
"64","000","00","011","1115","1633","705","548","157","19","724","1448","0","50.0","37.85"
"64","000","00","011","1115","1634","881","773","108","76","957","1488","0","64.31","51.95"
"64","000","00","011","1116","0000","1565","1241","324","120","1685","2584","0","65.21","48.03"
"64","000","00","011","1116","1635","725","578","147","63","788","1278","0","61.66","45.23"
"64","000","00","011","1116","1636","840","663","177","57","897","1306","0","68.68","50.77"
"64","000","00","011","1117","0000","1858","1458","400","158","2016","3265","0","61.75","44.66"
"64","000","00","011","1117","1637","898","704","194","75","973","1625","0","59.88","43.32"
"64","000","00","011","1117","1638","960","754","206","83","1043","1640","0","63.6","45.98"
"64","000","00","011","1118","0000","1561","1233","328","110","1671","2944","0","56.76","41.88"
"64","000","00","011","1118","1639","824","657","167","52","876","1506","0","58.17","43.63"
"64","000","00","011","1118","1640","737","576","161","58","795","1438","0","55.29","40.06"
"64","000","00","011","1119","0000","1332","1079","253","52","1384","2272","0","60.92","47.49"
"64","000","00","011","1119","1641","703","566","137","34","737","1105","0","66.7","51.22"
"64","000","00","011","1119","1642","629","513","116","18","647","1167","0","55.44","43.96"
"64","000","00","011","1120","0000","2339","1922","417","126","2465","4039","0","61.03","47.59"
"64","000","00","011","1120","1643","823","672","151","31","854","1420","0","60.14","47.32"
"64","000","00","011","1120","1644","841","682","159","67","908","1380","0","65.8","49.42"
"64","000","00","011","1120","1645","675","568","107","28","703","1239","0","56.74","45.84"
"64","000","00","011","1121","0000","1809","1426","383","131","1940","3207","0","60.49","44.47"
"64","000","00","011","1121","1646","900","705","195","60","960","1563","0","61.42","45.11"
"64","000","00","011","1121","1647","909","721","188","71","980","1644","0","59.61","43.86"
"64","000","00","011","1122","0000","5845","4560","1285","453","6298","11107","0","56.7","41.06"
"64","000","00","011","1122","1648","1007","799","208","76","1083","1895","0","57.15","42.16"
"64","000","00","011","1122","1649","894","707","187","93","987","1748","0","56.46","40.45"
"64","000","00","011","1122","1650","872","618","254","99","971","1579","0","61.49","39.14"
"64","000","00","011","1122","1651","1135","884","251","55","1190","2135","0","55.74","41.41"
"64","000","00","011","1122","1652","925","719","206","83","1008","1728","0","58.33","41.61"
"64","000","00","011","1122","1653","1012","833","179","47","1059","2022","0","52.37","41.2"
"64","000","00","011","1123","0000","1955","1558","397","154","2109","3916","0","53.86","39.79"
"64","000","00","011","1123","1654","586","482","104","23","609","1329","0","45.82","36.27"
"64","000","00","011","1123","1655","681","537","144","43","724","1320","0","54.85","40.68"
"64","000","00","011","1123","1656","688","539","149","88","776","1267","0","61.25","42.54"
"64","000","00","011","1124","0000","1510","1175","335","103","1613","2587","0","62.35","45.42"
"64","000","00","011","1124","1657","755","577","178","71","826","1298","0","63.64","44.45"
"64","000","00","011","1124","1658","755","598","157","32","787","1289","0","61.06","46.39"
"64","000","00","011","1125","0000","1700","1343","357","83","1783","3028","0","58.88","44.35"
"64","000","00","011","1125","1659","863","688","175","44","907","1534","0","59.13","44.85"
"64","000","00","011","1125","1660","837","655","182","39","876","1494","0","58.63","43.84"
"64","000","00","011","1126","0000","1546","1231","315","144","1690","2721","0","62.11","45.24"
"64","000","00","011","1126","1661","754","562","192","74","828","1377","0","60.13","40.81"
"64","000","00","011","1126","1662","792","669","123","70","862","1344","0","64.14","49.78"
"64","000","00","011","1127","0000","3088","2420","668","196","3284","5757","0","57.04","42.04"
"64","000","00","011","1127","1663","790","629","161","71","861","1508","0","57.1","41.71"
"64","000","00","011","1127","1664","738","536","202","29","767","1400","0","54.79","38.29"
"64","000","00","011","1127","1665","817","673","144","65","882","1457","0","60.54","46.19"
"64","000","00","011","1127","1666","743","582","161","31","774","1392","0","55.6","41.81"
"64","000","00","011","1128","0000","2357","1885","472","149","2506","4487","0","55.85","42.01"
"64","000","00","011","1128","1667","1017","790","227","68","1085","1983","0","54.72","39.84"
"64","000","00","011","1128","1668","633","528","105","28","661","1204","0","54.9","43.85"
"64","000","00","011","1128","1669","707","567","140","53","760","1300","0","58.46","43.62"
"64","000","00","011","1129","0000","1910","1493","417","126","2036","3423","0","59.48","43.62"
"64","000","00","011","1129","1670","1062","805","257","92","1154","1857","0","62.14","43.35"
"64","000","00","011","1129","1671","848","688","160","34","882","1566","0","56.32","43.93"
"64","000","00","011","1130","0000","1516","1203","313","172","1688","2579","0","65.45","46.65"
"64","000","00","011","1130","1672","799","635","164","85","884","1343","0","65.82","47.28"
"64","000","00","011","1130","1673","717","568","149","87","804","1236","0","65.05","45.95"
"64","000","00","011","1131","0000","4265","3273","992","223","4488","7715","0","58.17","42.42"
"64","000","00","011","1131","1674","884","691","193","94","978","1564","0","62.53","44.18"
"64","000","00","011","1131","1675","833","607","226","13","846","1484","0","57.01","40.9"
"64","000","00","011","1131","1676","787","603","184","40","827","1477","0","55.99","40.83"
"64","000","00","011","1131","1677","881","686","195","37","918","1482","0","61.94","46.29"
"64","000","00","011","1131","1678","880","686","194","39","919","1708","0","53.81","40.16"
"64","000","00","011","1132","0000","1814","1410","404","92","1906","3576","0","53.3","39.43"
"64","000","00","011","1132","1679","1000","752","248","67","1067","1867","0","57.15","40.28"
"64","000","00","011","1132","1680","814","658","156","25","839","1709","0","49.09","38.5"
"64","000","00","011","1133","0000","1466","1139","327","114","1580","3121","0","50.62","36.49"
"64","000","00","011","1133","1681","717","546","171","64","781","1425","0","54.81","38.32"
"64","000","00","011","1133","1682","749","593","156","50","799","1696","0","47.11","34.96"
"64","000","00","011","1134","0000","1498","1168","330","165","1663","3053","0","54.47","38.26"
"64","000","00","011","1134","1683","682","530","152","77","759","1522","0","49.87","34.82"
"64","000","00","011","1134","1684","816","638","178","88","904","1531","0","59.05","41.67"
"64","000","00","011","1135","0000","1080","809","271","142","1222","2215","0","55.17","36.52"
"64","000","00","011","1135","1685","1080","809","271","142","1222","2215","0","55.17","36.52"
"64","000","00","011","1136","0000","1442","1105","337","72","1514","3050","0","49.64","36.23"
"64","000","00","011","1136","1686","755","589","166","31","786","1515","0","51.88","38.88"
"64","000","00","011","1136","1687","687","516","171","41","728","1535","0","47.43","33.62"
"64","000","00","011","1137","0000","1215","944","271","68","1283","2493","0","51.46","37.87"
"64","000","00","011","1137","1688","657","512","145","32","689","1276","0","54.0","40.13"
"64","000","00","011","1137","1689","558","432","126","36","594","1217","0","48.81","35.5"
"64","000","00","011","1138","0000","1673","1274","399","193","1866","3627","0","51.45","35.13"
"64","000","00","011","1138","1690","767","600","167","78","845","1707","0","49.5","35.15"
"64","000","00","011","1138","1691","906","674","232","115","1021","1920","0","53.18","35.1"
"64","000","00","012","0000","0000","164773","130829","33944","11240","176013","300510","359100","58.57","43.54"
"64","000","00","012","1201","0000","239","203","36","11","250","423","0","59.1","47.99"
"64","000","00","012","1201","1306","239","203","36","11","250","423","0","59.1","47.99"
"64","000","00","012","1202","0000","334","241","93","20","354","618","0","57.28","39.0"
"64","000","00","012","1202","1305","334","241","93","20","354","618","0","57.28","39.0"
"64","000","00","012","1203","0000","706","544","162","59","765","1312","0","58.31","41.46"
"64","000","00","012","1203","1307","706","544","162","59","765","1312","0","58.31","41.46"
"64","000","00","012","1204","0000","582","464","118","45","627","875","0","71.66","53.03"
"64","000","00","012","1204","1321","582","464","118","45","627","875","0","71.66","53.03"
"64","000","00","012","1205","0000","487","363","124","30","517","882","0","58.62","41.16"
"64","000","00","012","1205","1314","487","363","124","30","517","882","0","58.62","41.16"
"64","000","00","012","1206","0000","1151","920","231","51","1202","1982","0","60.65","46.42"
"64","000","00","012","1206","1308","424","329","95","30","454","769","0","59.04","42.78"
"64","000","00","012","1206","1309","727","591","136","21","748","1213","0","61.67","48.72"
"64","000","00","012","1207","0000","657","505","152","52","709","1080","0","65.65","46.76"
"64","000","00","012","1207","1256","657","505","152","52","709","1080","0","65.65","46.76"
"64","000","00","012","1208","0000","2044","1570","474","167","2211","3395","0","65.13","46.24"
"64","000","00","012","1208","1334","686","514","172","59","745","1159","0","64.28","44.35"
"64","000","00","012","1208","1335","610","491","119","63","673","1127","0","59.72","43.57"
"64","000","00","012","1208","1336","748","565","183","45","793","1109","0","71.51","50.95"
"64","000","00","012","1209","0000","4392","3532","860","260","4652","8473","0","54.9","41.69"
"64","000","00","012","1209","1268","810","654","156","78","888","1496","0","59.36","43.72"
"64","000","00","012","1209","1269","979","785","194","65","1044","2094","0","49.86","37.49"
"64","000","00","012","1209","1270","880","704","176","27","907","1672","0","54.25","42.11"
"64","000","00","012","1209","1271","924","752","172","29","953","1761","0","54.12","42.7"
"64","000","00","012","1209","1272","799","637","162","61","860","1450","0","59.31","43.93"
"64","000","00","012","1210","0000","478","384","94","37","515","819","0","62.88","46.89"
"64","000","00","012","1210","1257","478","384","94","37","515","819","0","62.88","46.89"
"64","000","00","012","1211","0000","2000","1569","431","135","2135","3533","0","60.43","44.41"
"64","000","00","012","1211","1277","704","540","164","68","772","1247","0","61.91","43.3"
"64","000","00","012","1211","1278","611","474","137","47","658","1087","0","60.53","43.61"
"64","000","00","012","1211","1279","685","555","130","20","705","1199","0","58.8","46.29"
"64","000","00","012","1212","0000","2693","2125","568","150","2843","4957","0","57.35","42.87"
"64","000","00","012","1212","1260","719","579","140","33","752","1223","0","61.49","47.34"
"64","000","00","012","1212","1261","705","551","154","40","745","1207","0","61.72","45.65"
"64","000","00","012","1212","1262","695","522","173","38","733","1339","0","54.74","38.98"
"64","000","00","012","1212","1263","574","473","101","39","613","1188","0","51.6","39.81"
"64","000","00","012","1213","0000","1278","1019","259","78","1356","2465","0","55.01","41.34"
"64","000","00","012","1213","1340","760","596","164","58","818","1432","0","57.12","41.62"
"64","000","00","012","1213","1341","518","423","95","20","538","1033","0","52.08","40.95"
"64","000","00","012","1214","0000","3129","2561","568","178","3307","5972","0","55.38","42.88"
"64","000","00","012","1214","1362","794","630","164","53","847","1521","0","55.69","41.42"
"64","000","00","012","1214","1363","695","571","124","40","735","1407","0","52.24","40.58"
"64","000","00","012","1214","1364","875","720","155","63","938","1542","0","60.83","46.69"
"64","000","00","012","1214","1365","765","640","125","22","787","1502","0","52.4","42.61"
"64","000","00","012","1215","0000","2367","2027","340","167","2534","4111","0","61.64","49.31"
"64","000","00","012","1215","1366","773","629","144","52","825","1320","0","62.5","47.65"
"64","000","00","012","1215","1367","804","711","93","31","835","1507","0","55.41","47.18"
"64","000","00","012","1215","1368","790","687","103","84","874","1284","0","68.07","53.5"
"64","000","00","012","1216","0000","2535","2008","527","196","2731","4722","0","57.84","42.52"
"64","000","00","012","1216","1445","575","468","107","52","627","1058","0","59.26","44.23"
"64","000","00","012","1216","1446","583","477","106","52","635","976","0","65.06","48.87"
"64","000","00","012","1216","1447","757","598","159","39","796","1545","0","51.52","38.71"
"64","000","00","012","1216","1448","620","465","155","53","673","1143","0","58.88","40.68"
"64","000","00","012","1217","0000","3420","2700","720","241","3661","6769","0","54.08","39.89"
"64","000","00","012","1217","1407","649","506","143","37","686","1314","0","52.21","38.51"
"64","000","00","012","1217","1408","790","639","151","24","814","1649","0","49.36","38.75"
"64","000","00","012","1217","1409","800","625","175","93","893","1601","0","55.78","39.04"
"64","000","00","012","1217","1410","603","473","130","25","628","1155","0","54.37","40.95"
"64","000","00","012","1217","1411","578","457","121","62","640","1050","0","60.95","43.52"
"64","000","00","012","1218","0000","2828","2227","601","196","3024","4988","0","60.63","44.65"
"64","000","00","012","1218","1342","720","551","169","82","802","1253","0","64.01","43.97"
"64","000","00","012","1218","1343","702","546","156","24","726","1217","0","59.65","44.86"
"64","000","00","012","1218","1344","759","620","139","48","807","1267","0","63.69","48.93"
"64","000","00","012","1218","1345","647","510","137","42","689","1251","0","55.08","40.77"
"64","000","00","012","1219","0000","2708","2150","558","163","2871","4562","0","62.93","47.13"
"64","000","00","012","1219","1325","628","491","137","38","666","974","0","68.38","50.41"
"64","000","00","012","1219","1326","561","469","92","39","600","987","0","60.79","47.52"
"64","000","00","012","1219","1327","755","612","143","21","776","1210","0","64.13","50.58"
"64","000","00","012","1219","1328","764","578","186","65","829","1391","0","59.6","41.55"
"64","000","00","012","1220","0000","2277","1836","441","113","2390","3682","0","64.91","49.86"
"64","000","00","012","1220","1337","1128","895","233","64","1192","1879","0","63.44","47.63"
"64","000","00","012","1220","1338","1149","941","208","49","1198","1803","0","66.44","52.19"
"64","000","00","012","1221","0000","877","680","197","129","1006","2513","0","40.03","27.06"
"64","000","00","012","1221","1316","458","358","100","75","533","853","0","62.49","41.97"
"64","000","00","012","1221","1317","419","322","97","54","473","1660","0","28.49","19.4"
"64","000","00","012","1222","0000","1581","1315","266","122","1703","2926","0","58.2","44.94"
"64","000","00","012","1222","1369","750","610","140","40","790","1441","0","54.82","42.33"
"64","000","00","012","1222","1370","831","705","126","82","913","1485","0","61.48","47.47"
"64","000","00","012","1224","0000","1951","1505","446","95","2046","3411","0","59.98","44.12"
"64","000","00","012","1224","1275","1104","797","307","66","1170","1713","0","68.3","46.53"
"64","000","00","012","1224","1276","847","708","139","29","876","1698","0","51.59","41.7"
"64","000","00","012","1225","0000","1516","1175","341","64","1580","2870","0","55.05","40.94"
"64","000","00","012","1225","1387","789","618","171","23","812","1525","0","53.25","40.52"
"64","000","00","012","1225","1388","727","557","170","41","768","1345","0","57.1","41.41"
"64","000","00","012","1226","0000","2668","2129","539","168","2836","4708","0","60.24","45.22"
"64","000","00","012","1226","1383","508","404","104","44","552","942","0","58.6","42.89"
"64","000","00","012","1226","1384","621","501","120","34","655","1206","0","54.31","41.54"
"64","000","00","012","1226","1385","713","565","148","35","748","1159","0","64.54","48.75"
"64","000","00","012","1226","1386","826","659","167","55","881","1401","0","62.88","47.04"
"64","000","00","012","1227","0000","3494","2653","841","340","3834","6189","0","61.95","42.87"
"64","000","00","012","1227","1429","799","632","167","69","868","1405","0","61.78","44.98"
"64","000","00","012","1227","1430","637","484","153","77","714","1097","0","65.09","44.12"
"64","000","00","012","1227","1431","730","531","199","87","817","1248","0","65.46","42.55"
"64","000","00","012","1227","1432","692","519","173","70","762","1225","0","62.2","42.37"
"64","000","00","012","1227","1433","636","487","149","37","673","1214","0","55.44","40.12"
"64","000","00","012","1228","0000","1722","1331","391","190","1912","3269","0","58.49","40.72"
"64","000","00","012","1228","1437","512","384","128","54","566","968","0","58.47","39.67"
"64","000","00","012","1228","1438","608","488","120","68","676","1200","0","56.33","40.67"
"64","000","00","012","1228","1439","602","459","143","68","670","1101","0","60.85","41.69"
"64","000","00","012","1229","0000","2990","2359","631","275","3265","5759","0","56.69","40.96"
"64","000","00","012","1229","1474","533","447","86","66","599","1042","0","57.49","42.9"
"64","000","00","012","1229","1475","600","471","129","61","661","1098","0","60.2","42.9"
"64","000","00","012","1229","1476","626","488","138","23","649","1284","0","50.55","38.01"
"64","000","00","012","1229","1477","619","471","148","48","667","1242","0","53.7","37.92"
"64","000","00","012","1229","1478","612","482","130","77","689","1093","0","63.04","44.1"
"64","000","00","012","1230","0000","2991","2441","550","232","3223","5398","0","59.71","45.22"
"64","000","00","012","1230","1349","817","659","158","42","859","1588","0","54.09","41.5"
"64","000","00","012","1230","1350","750","646","104","51","801","1255","0","63.82","51.47"
"64","000","00","012","1230","1351","697","551","146","67","764","1264","0","60.44","43.59"
"64","000","00","012","1230","1352","727","585","142","72","799","1291","0","61.89","45.31"
"64","000","00","012","1231","0000","2735","2213","522","200","2935","4819","0","60.9","45.92"
"64","000","00","012","1231","1346","863","706","157","75","938","1563","0","60.01","45.17"
"64","000","00","012","1231","1347","1099","910","189","62","1161","1888","0","61.49","48.2"
"64","000","00","012","1231","1348","773","597","176","63","836","1368","0","61.11","43.64"
"64","000","00","012","1232","0000","1756","1357","399","139","1895","3455","0","54.85","39.28"
"64","000","00","012","1232","1465","590","448","142","56","646","1154","0","55.98","38.82"
"64","000","00","012","1232","1466","637","490","147","62","699","1153","0","60.62","42.5"
"64","000","00","012","1232","1467","529","419","110","21","550","1148","0","47.91","36.5"
"64","000","00","012","1233","0000","2971","2355","616","176","3147","5211","0","60.39","45.19"
"64","000","00","012","1233","1397","699","544","155","24","723","1388","0","52.09","39.19"
"64","000","00","012","1233","1398","698","545","153","73","771","1241","0","62.13","43.92"
"64","000","00","012","1233","1399","829","667","162","51","880","1394","0","63.13","47.85"
"64","000","00","012","1233","1400","745","599","146","28","773","1188","0","65.07","50.42"
"64","000","00","012","1234","0000","2062","1548","514","158","2220","3815","0","58.19","40.58"
"64","000","00","012","1234","1371","632","457","175","68","700","1205","0","58.09","37.93"
"64","000","00","012","1234","1372","674","528","146","21","695","1284","0","54.13","41.12"
"64","000","00","012","1234","1373","756","563","193","69","825","1326","0","62.22","42.46"
"64","000","00","012","1235","0000","3272","2617","655","184","3456","5984","0","57.75","43.73"
"64","000","00","012","1235","1359","1138","898","240","75","1213","2173","0","55.82","41.33"
"64","000","00","012","1235","1360","1251","1001","250","68","1319","2255","0","58.49","44.39"
"64","000","00","012","1235","1361","883","718","165","41","924","1556","0","59.38","46.14"
"64","000","00","012","1236","0000","2024","1603","421","88","2112","3999","0","52.81","40.09"
"64","000","00","012","1236","1404","613","493","120","30","643","1216","0","52.88","40.54"
"64","000","00","012","1236","1405","619","475","144","35","654","1318","0","49.62","36.04"
"64","000","00","012","1236","1406","792","635","157","23","815","1465","0","55.63","43.34"
"64","000","00","012","1237","0000","1938","1483","455","153","2091","3295","0","63.46","45.01"
"64","000","00","012","1237","1374","617","469","148","24","641","1096","0","58.49","42.79"
"64","000","00","012","1237","1375","682","512","170","74","756","1182","0","63.96","43.32"
"64","000","00","012","1237","1376","639","502","137","55","694","1017","0","68.24","49.36"
"64","000","00","012","1238","0000","1246","933","313","114","1360","2479","0","54.86","37.64"
"64","000","00","012","1238","1377","628","463","165","81","709","1198","0","59.18","38.65"
"64","000","00","012","1238","1378","618","470","148","33","651","1281","0","50.82","36.69"
"64","000","00","012","1239","0000","4819","3872","947","238","5057","8716","0","58.02","44.42"
"64","000","00","012","1239","1291","1015","805","210","42","1057","1751","0","60.37","45.97"
"64","000","00","012","1239","1292","1003","795","208","44","1047","1758","0","59.56","45.22"
"64","000","00","012","1239","1293","953","754","199","82","1035","1749","0","59.18","43.11"
"64","000","00","012","1239","1294","934","771","163","21","955","1746","0","54.7","44.16"
"64","000","00","012","1239","1295","914","747","167","49","963","1712","0","56.25","43.63"
"64","000","00","012","1240","0000","7074","5841","1233","403","7477","12977","0","57.62","45.01"
"64","000","00","012","1240","1421","768","597","171","106","874","1688","0","51.78","35.37"
"64","000","00","012","1240","1422","853","707","146","67","920","1657","0","55.52","42.67"
"64","000","00","012","1240","1423","865","811","54","43","908","1729","0","52.52","46.91"
"64","000","00","012","1240","1424","926","741","185","52","978","1628","0","60.07","45.52"
"64","000","00","012","1240","1425","909","732","177","19","928","1891","0","49.07","38.71"
"64","000","00","012","1240","1426","1030","863","167","55","1085","1594","0","68.07","54.14"
"64","000","00","012","1240","1427","818","674","144","19","837","1342","0","62.37","50.22"
"64","000","00","012","1240","1428","905","716","189","42","947","1448","0","65.4","49.45"
"64","000","00","012","1241","0000","1096","862","234","106","1202","1926","0","62.41","44.76"
"64","000","00","012","1241","1258","464","380","84","67","531","851","0","62.4","44.65"
"64","000","00","012","1241","1259","632","482","150","39","671","1075","0","62.42","44.84"
"64","000","00","012","1242","0000","1900","1465","435","137","2037","3418","0","59.6","42.86"
"64","000","00","012","1242","1318","652","514","138","37","689","1124","0","61.3","45.73"
"64","000","00","012","1242","1319","632","465","167","60","692","1112","0","62.23","41.82"
"64","000","00","012","1242","1320","616","486","130","40","656","1182","0","55.5","41.12"
"64","000","00","012","1243","0000","1711","1316","395","214","1925","2966","0","64.9","44.37"
"64","000","00","012","1243","1471","585","454","131","54","639","1026","0","62.28","44.25"
"64","000","00","012","1243","1472","585","429","156","90","675","993","0","67.98","43.2"
"64","000","00","012","1243","1473","541","433","108","70","611","947","0","64.52","45.72"
"64","000","00","012","1244","0000","3165","2545","620","217","3382","5672","0","59.63","44.87"
"64","000","00","012","1244","1329","594","458","136","22","616","1241","0","49.64","36.91"
"64","000","00","012","1244","1330","596","483","113","48","644","1000","0","64.4","48.3"
"64","000","00","012","1244","1331","620","511","109","44","664","1092","0","60.81","46.79"
"64","000","00","012","1244","1332","762","612","150","48","810","1308","0","61.93","46.79"
"64","000","00","012","1244","1333","593","481","112","55","648","1031","0","62.85","46.65"
"64","000","00","012","1245","0000","1016","842","174","88","1104","2045","0","53.99","41.17"
"64","000","00","012","1245","1339","1016","842","174","88","1104","2045","0","53.99","41.17"
"64","000","00","012","1246","0000","2778","2133","645","160","2938","4742","0","61.96","44.98"
"64","000","00","012","1246","1310","684","548","136","34","718","1107","0","64.86","49.5"
"64","000","00","012","1246","1311","679","511","168","30","709","1188","0","59.68","43.01"
"64","000","00","012","1246","1312","690","528","162","41","731","1183","0","61.79","44.63"
"64","000","00","012","1246","1313","725","546","179","55","780","1264","0","61.71","43.2"
"64","000","00","012","1247","0000","1964","1480","484","131","2095","3351","0","62.52","44.17"
"64","000","00","012","1247","1322","595","441","154","44","639","1040","0","61.44","42.4"
"64","000","00","012","1247","1323","671","514","157","26","697","1094","0","63.71","46.98"
"64","000","00","012","1247","1324","698","525","173","61","759","1217","0","62.37","43.14"
"64","000","00","012","1248","0000","3239","2526","713","224","3463","6178","0","56.05","40.89"
"64","000","00","012","1248","1286","613","499","114","33","646","1247","0","51.8","40.02"
"64","000","00","012","1248","1287","773","607","166","76","849","1538","0","55.2","39.47"
"64","000","00","012","1248","1288","578","436","142","36","614","1097","0","55.97","39.74"
"64","000","00","012","1248","1289","596","451","145","25","621","1221","0","50.86","36.94"
"64","000","00","012","1248","1290","679","533","146","54","733","1075","0","68.19","49.58"
"64","000","00","012","1249","0000","2367","1868","499","208","2575","4308","0","59.77","43.36"
"64","000","00","012","1249","1481","735","572","163","65","800","1309","0","61.12","43.7"
"64","000","00","012","1249","1482","885","707","178","55","940","1627","0","57.78","43.45"
"64","000","00","012","1249","1483","747","589","158","88","835","1372","0","60.86","42.93"
"64","000","00","012","1250","0000","1382","1145","237","79","1461","2520","0","57.98","45.44"
"64","000","00","012","1250","1353","663","555","108","39","702","1224","0","57.35","45.34"
"64","000","00","012","1250","1354","719","590","129","40","759","1296","0","58.56","45.52"
"64","000","00","012","1251","0000","657","506","151","46","703","1007","0","69.81","50.25"
"64","000","00","012","1251","1315","657","506","151","46","703","1007","0","69.81","50.25"
"64","000","00","012","1253","0000","2241","1830","411","198","2439","4102","0","59.46","44.61"
"64","000","00","012","1253","1264","585","490","95","55","640","1055","0","60.66","46.45"
"64","000","00","012","1253","1265","569","467","102","68","637","1109","0","57.44","42.11"
"64","000","00","012","1253","1266","479","382","97","39","518","756","0","68.52","50.53"
"64","000","00","012","1253","1267","608","491","117","36","644","1182","0","54.48","41.54"
"64","000","00","012","1254","0000","879","680","199","42","921","2551","0","36.1","26.66"
"64","000","00","012","1254","1449","318","254","64","15","333","1301","0","25.6","19.52"
"64","000","00","012","1254","1450","561","426","135","27","588","1250","0","47.04","34.08"
"64","000","00","012","1255","0000","4391","3473","918","319","4710","7753","0","60.75","44.8"
"64","000","00","012","1255","1459","755","613","142","31","786","1291","0","60.88","47.48"
"64","000","00","012","1255","1460","523","419","104","69","592","938","0","63.11","44.67"
"64","000","00","012","1255","1461","984","753","231","52","1036","1783","0","58.1","42.23"
"64","000","00","012","1255","1462","624","519","105","37","661","1105","0","59.82","46.97"
"64","000","00","012","1255","1463","716","545","171","89","805","1392","0","57.83","39.15"
"64","000","00","012","1255","1464","789","624","165","41","830","1244","0","66.72","50.16"
"64","000","00","012","1256","0000","4621","3790","831","209","4830","8179","0","59.05","46.34"
"64","000","00","012","1256","1280","846","752","94","53","899","1559","0","57.67","48.24"
"64","000","00","012","1256","1281","687","561","126","41","728","1233","0","59.04","45.5"
"64","000","00","012","1256","1282","710","563","147","48","758","1277","0","59.36","44.09"
"64","000","00","012","1256","1283","791","672","119","20","811","1481","0","54.76","45.37"
"64","000","00","012","1256","1284","720","566","154","16","736","1154","0","63.78","49.05"
"64","000","00","012","1256","1285","867","676","191","31","898","1475","0","60.88","45.83"
"64","000","00","012","1257","0000","2049","1601","448","173","2222","4340","0","51.2","36.89"
"64","000","00","012","1257","1468","705","555","150","121","826","1432","0","57.68","38.76"
"64","000","00","012","1257","1469","562","419","143","25","587","1429","0","41.08","29.32"
"64","000","00","012","1257","1470","782","627","155","27","809","1479","0","54.7","42.39"
"64","000","00","012","1258","0000","1385","1089","296","99","1484","2689","0","55.19","40.5"
"64","000","00","012","1258","1273","714","566","148","38","752","1455","0","51.68","38.9"
"64","000","00","012","1258","1274","671","523","148","61","732","1234","0","59.32","42.38"
"64","000","00","012","1259","0000","2273","1796","477","143","2416","4003","0","60.35","44.87"
"64","000","00","012","1259","1296","716","588","128","37","753","1247","0","60.38","47.15"
"64","000","00","012","1259","1297","803","613","190","54","857","1409","0","60.82","43.51"
"64","000","00","012","1259","1298","754","595","159","52","806","1347","0","59.84","44.17"
"64","000","00","012","1260","0000","5136","4124","1012","214","5350","9265","0","57.74","44.51"
"64","000","00","012","1260","1299","954","759","195","27","981","1771","0","55.39","42.86"
"64","000","00","012","1260","1300","855","698","157","16","871","1537","0","56.67","45.41"
"64","000","00","012","1260","1301","919","746","173","27","946","1605","0","58.94","46.48"
"64","000","00","012","1260","1302","771","627","144","52","823","1375","0","59.85","45.6"
"64","000","00","012","1260","1303","807","640","167","65","872","1393","0","62.6","45.94"
"64","000","00","012","1260","1304","830","654","176","27","857","1584","0","54.1","41.29"
"64","000","00","012","1261","0000","1210","973","237","95","1305","2055","0","63.5","47.35"
"64","000","00","012","1261","1355","505","406","99","51","556","826","0","67.31","49.15"
"64","000","00","012","1261","1356","705","567","138","44","749","1229","0","60.94","46.14"
"64","000","00","012","1262","0000","1540","1276","264","108","1648","2685","0","61.38","47.52"
"64","000","00","012","1262","1357","856","726","130","47","903","1467","0","61.55","49.49"
"64","000","00","012","1262","1358","684","550","134","61","745","1218","0","61.17","45.16"
"64","000","00","012","1263","0000","1582","1244","338","83","1665","2584","0","64.43","48.14"
"64","000","00","012","1263","1379","814","627","187","43","857","1358","0","63.11","46.17"
"64","000","00","012","1263","1380","768","617","151","40","808","1226","0","65.91","50.33"
"64","000","00","012","1264","0000","1331","1060","271","100","1431","2298","0","62.27","46.13"
"64","000","00","012","1264","1381","649","524","125","62","711","1098","0","64.75","47.72"
"64","000","00","012","1264","1382","682","536","146","38","720","1200","0","60.0","44.67"
"64","000","00","012","1265","0000","2150","1633","517","139","2289","3785","0","60.48","43.14"
"64","000","00","012","1265","1401","624","474","150","39","663","1112","0","59.62","42.63"
"64","000","00","012","1265","1402","725","540","185","56","781","1198","0","65.19","45.08"
"64","000","00","012","1265","1403","801","619","182","44","845","1475","0","57.29","41.97"
"64","000","00","012","1266","0000","1249","983","266","65","1314","2286","0","57.48","43.0"
"64","000","00","012","1266","1389","693","544","149","39","732","1180","0","62.03","46.1"
"64","000","00","012","1266","1390","556","439","117","26","582","1106","0","52.62","39.69"
"64","000","00","012","1267","0000","2499","1977","522","171","2670","4313","0","61.91","45.84"
"64","000","00","012","1267","1394","751","627","124","23","774","1361","0","56.87","46.07"
"64","000","00","012","1267","1395","809","615","194","73","882","1416","0","62.29","43.43"
"64","000","00","012","1267","1396","939","735","204","75","1014","1536","0","66.02","47.85"
"64","000","00","012","1268","0000","2366","1851","515","135","2501","4061","0","61.59","45.58"
"64","000","00","012","1268","1391","860","679","181","60","920","1442","0","63.8","47.09"
"64","000","00","012","1268","1392","810","633","177","46","856","1376","0","62.21","46.0"
"64","000","00","012","1268","1393","696","539","157","29","725","1243","0","58.33","43.36"
"64","000","00","012","1269","0000","1343","1114","229","72","1415","2515","0","56.26","44.29"
"64","000","00","012","1269","1415","654","547","107","49","703","1190","0","59.08","45.97"
"64","000","00","012","1269","1416","689","567","122","23","712","1325","0","53.74","42.79"
"64","000","00","012","1270","0000","2443","1940","503","171","2614","4481","0","58.34","43.29"
"64","000","00","012","1270","1417","594","472","122","60","654","1049","0","62.35","45.0"
"64","000","00","012","1270","1418","563","477","86","34","597","1026","0","58.19","46.49"
"64","000","00","012","1270","1419","666","498","168","54","720","1152","0","62.5","43.23"
"64","000","00","012","1270","1420","620","493","127","23","643","1254","0","51.28","39.31"
"64","000","00","012","1271","0000","2369","1890","479","150","2519","4456","0","56.53","42.41"
"64","000","00","012","1271","1412","687","553","134","24","711","1417","0","50.18","39.03"
"64","000","00","012","1271","1413","820","656","164","63","883","1525","0","57.9","43.02"
"64","000","00","012","1271","1414","862","681","181","63","925","1514","0","61.1","44.98"
"64","000","00","012","1272","0000","2425","1885","540","176","2601","4447","0","58.49","42.39"
"64","000","00","012","1272","1440","701","535","166","42","743","1369","0","54.27","39.08"
"64","000","00","012","1272","1441","832","643","189","76","908","1542","0","58.88","41.7"
"64","000","00","012","1272","1442","892","707","185","58","950","1536","0","61.85","46.03"
"64","000","00","012","1273","0000","1467","1106","361","127","1594","2834","0","56.25","39.03"
"64","000","00","012","1273","1443","688","521","167","30","718","1382","0","51.95","37.7"
"64","000","00","012","1273","1444","779","585","194","97","876","1452","0","60.33","40.29"
"64","000","00","012","1274","0000","1383","1101","282","96","1479","2432","0","60.81","45.27"
"64","000","00","012","1274","1455","661","520","141","56","717","1125","0","63.73","46.22"
"64","000","00","012","1274","1456","722","581","141","40","762","1307","0","58.3","44.45"
"64","000","00","012","1275","0000","2882","2312","570","271","3153","5431","0","58.06","42.57"
"64","000","00","012","1275","1451","651","524","127","56","707","1208","0","58.53","43.38"
"64","000","00","012","1275","1452","649","523","126","91","740","1202","0","61.56","43.51"
"64","000","00","012","1275","1453","785","632","153","73","858","1499","0","57.24","42.16"
"64","000","00","012","1275","1454","797","633","164","51","848","1522","0","55.72","41.59"
"64","000","00","012","1276","0000","1447","1105","342","143","1590","2657","0","59.84","41.59"
"64","000","00","012","1276","1457","759","564","195","71","830","1405","0","59.07","40.14"
"64","000","00","012","1276","1458","688","541","147","72","760","1252","0","60.7","43.21"
"64","000","00","012","1277","0000","1369","1046","323","74","1443","2706","0","53.33","38.65"
"64","000","00","012","1277","1479","700","521","179","48","748","1353","0","55.28","38.51"
"64","000","00","012","1277","1480","669","525","144","26","695","1353","0","51.37","38.8"
"64","000","00","012","1278","0000","3476","2904","572","240","3716","6056","0","61.36","47.95"
"64","000","00","012","1278","1434","1186","1052","134","88","1274","2032","0","62.7","51.77"
"64","000","00","012","1278","1435","1065","861","204","80","1145","1927","0","59.42","44.68"
"64","000","00","012","1278","1436","1225","991","234","72","1297","2097","0","61.85","47.26"
"64","000","00","013","0000","0000","29643","23394","6249","2480","32123","59129","69829","54.33","39.56"
"64","000","00","013","1301","0000","1424","1100","324","155","1579","2824","0","55.91","38.95"
"64","000","00","013","1301","1773","673","532","141","87","760","1262","0","60.22","42.16"
"64","000","00","013","1301","1774","751","568","183","68","819","1562","0","52.43","36.36"
"64","000","00","013","1302","0000","1759","1390","369","139","1898","3252","0","58.36","42.74"
"64","000","00","013","1302","1775","566","460","106","30","596","1078","0","55.29","42.67"
"64","000","00","013","1302","1776","567","438","129","59","626","979","0","63.94","44.74"
"64","000","00","013","1302","1777","626","492","134","50","676","1195","0","56.57","41.17"
"64","000","00","013","1303","0000","1970","1504","466","163","2133","3929","0","54.29","38.28"
"64","000","00","013","1303","1778","689","529","160","65","754","1380","0","54.64","38.33"
"64","000","00","013","1303","1779","651","495","156","74","725","1280","0","56.64","38.67"
"64","000","00","013","1303","1780","630","480","150","24","654","1269","0","51.54","37.83"
"64","000","00","013","1304","0000","1262","1047","215","87","1349","2794","0","48.28","37.47"
"64","000","00","013","1304","1781","647","510","137","19","666","1568","0","42.47","32.53"
"64","000","00","013","1304","1782","615","537","78","68","683","1226","0","55.71","43.8"
"64","000","00","013","1305","0000","1535","1236","299","112","1647","2939","0","56.04","42.06"
"64","000","00","013","1305","1783","732","601","131","58","790","1480","0","53.38","40.61"
"64","000","00","013","1305","1784","803","635","168","54","857","1459","0","58.74","43.52"
"64","000","00","013","1306","0000","1227","968","259","117","1344","2488","0","54.02","38.91"
"64","000","00","013","1306","1785","767","608","159","43","810","1593","0","50.85","38.17"
"64","000","00","013","1306","1786","460","360","100","74","534","895","0","59.66","40.22"
"64","000","00","013","1307","0000","2330","1799","531","223","2553","4455","0","57.31","40.38"
"64","000","00","013","1307","1787","542","421","121","34","576","1110","0","51.89","37.93"
"64","000","00","013","1307","1788","660","510","150","65","725","1348","0","53.78","37.83"
"64","000","00","013","1307","1789","495","380","115","55","550","912","0","60.31","41.67"
"64","000","00","013","1307","1790","633","488","145","69","702","1085","0","64.7","44.98"
"64","000","00","013","1308","0000","964","781","183","85","1049","1834","0","57.2","42.58"
"64","000","00","013","1308","1791","476","385","91","30","506","955","0","52.98","40.31"
"64","000","00","013","1308","1792","488","396","92","55","543","879","0","61.77","45.05"
"64","000","00","013","1309","0000","1754","1391","363","163","1917","3449","0","55.58","40.33"
"64","000","00","013","1309","1793","573","459","114","66","639","1103","0","57.93","41.61"
"64","000","00","013","1309","1794","616","489","127","73","689","1054","0","65.37","46.39"
"64","000","00","013","1309","1795","565","443","122","24","589","1292","0","45.59","34.29"
"64","000","00","013","1310","0000","721","586","135","25","746","1683","0","44.33","34.82"
"64","000","00","013","1310","1796","721","586","135","25","746","1683","0","44.33","34.82"
"64","000","00","013","1311","0000","837","654","183","105","942","1619","0","58.18","40.4"
"64","000","00","013","1311","1797","314","260","54","36","350","607","0","57.66","42.83"
"64","000","00","013","1311","1798","523","394","129","69","592","1012","0","58.5","38.93"
"64","000","00","013","1312","0000","964","789","175","69","1033","1960","0","52.7","40.26"
"64","000","00","013","1312","1799","565","460","105","51","616","1046","0","58.89","43.98"
"64","000","00","013","1312","1800","399","329","70","18","417","914","0","45.62","36.0"
"64","000","00","013","1313","0000","2058","1672","386","167","2225","3874","0","57.43","43.16"
"64","000","00","013","1313","1801","747","599","148","69","816","1405","0","58.08","42.63"
"64","000","00","013","1313","1802","721","560","161","67","788","1299","0","60.66","43.11"
"64","000","00","013","1313","1803","590","513","77","31","621","1170","0","53.08","43.85"
"64","000","00","013","1314","0000","558","422","136","36","594","1299","0","45.73","32.49"
"64","000","00","013","1314","1804","558","422","136","36","594","1299","0","45.73","32.49"
"64","000","00","013","1315","0000","954","727","227","58","1012","1880","0","53.83","38.67"
"64","000","00","013","1315","1805","538","411","127","43","581","1031","0","56.35","39.86"
"64","000","00","013","1315","1806","416","316","100","15","431","849","0","50.77","37.22"
"64","000","00","013","1316","0000","877","673","204","92","969","1776","0","54.56","37.89"
"64","000","00","013","1316","1807","389","278","111","64","453","838","0","54.06","33.17"
"64","000","00","013","1316","1808","488","395","93","28","516","938","0","55.01","42.11"
"64","000","00","013","1317","0000","888","716","172","96","984","1837","0","53.57","38.98"
"64","000","00","013","1317","1809","463","388","75","43","506","1051","0","48.14","36.92"
"64","000","00","013","1317","1810","425","328","97","53","478","786","0","60.81","41.73"
"64","000","00","013","1318","0000","484","384","100","74","558","894","0","62.42","42.95"
"64","000","00","013","1318","1811","484","384","100","74","558","894","0","62.42","42.95"
"64","000","00","013","1319","0000","262","220","42","15","277","749","0","36.98","29.37"
"64","000","00","013","1319","1812","262","220","42","15","277","749","0","36.98","29.37"
"64","000","00","013","1320","0000","1648","1265","383","130","1778","2963","0","60.01","42.69"
"64","000","00","013","1320","1813","821","650","171","41","862","1485","0","58.05","43.77"
"64","000","00","013","1320","1814","827","615","212","89","916","1478","0","61.98","41.61"
"64","000","00","013","1321","0000","1278","999","279","152","1430","2383","0","60.01","41.92"
"64","000","00","013","1321","1815","765","615","150","90","855","1345","0","63.57","45.72"
"64","000","00","013","1321","1816","513","384","129","62","575","1038","0","55.39","36.99"
"64","000","00","013","1322","0000","1738","1360","378","76","1814","3366","0","53.89","40.4"
"64","000","00","013","1322","1817","661","503","158","33","694","1203","0","57.69","41.81"
"64","000","00","013","1322","1818","592","459","133","24","616","1138","0","54.13","40.33"
"64","000","00","013","1322","1819","485","398","87","19","504","1025","0","49.17","38.83"
"64","000","00","013","1323","0000","1229","985","244","101","1330","2559","0","51.97","38.49"
"64","000","00","013","1323","1820","709","568","141","77","786","1341","0","58.61","42.36"
"64","000","00","013","1323","1821","520","417","103","24","544","1218","0","44.66","34.24"
"64","000","00","013","1324","0000","922","726","196","40","962","2323","0","41.41","31.25"
"64","000","00","013","1324","1822","453","357","96","22","475","1147","0","41.41","31.12"
"64","000","00","013","1324","1823","469","369","100","18","487","1176","0","41.41","31.38"
"64","000","00","014","0000","0000","50697","40259","10438","3833","54530","97309","112334","56.04","41.37"
"64","000","00","014","1401","0000","636","485","151","48","684","1445","0","47.34","33.56"
"64","000","00","014","1401","1692","321","248","73","30","351","727","0","48.28","34.11"
"64","000","00","014","1401","1693","315","237","78","18","333","718","0","46.38","33.01"
"64","000","00","014","1402","0000","2550","2040","510","165","2715","5733","0","47.36","35.58"
"64","000","00","014","1402","1694","615","496","119","43","658","1340","0","49.1","37.01"
"64","000","00","014","1402","1695","693","538","155","46","739","1575","0","46.92","34.16"
"64","000","00","014","1402","1696","236","187","49","26","262","444","0","59.01","42.12"
"64","000","00","014","1402","1697","1006","819","187","50","1056","2374","0","44.48","34.5"
"64","000","00","014","1403","0000","3379","2638","741","277","3656","6681","0","54.72","39.49"
"64","000","00","014","1403","1698","650","515","135","72","722","1291","0","55.93","39.89"
"64","000","00","014","1403","1699","736","579","157","70","806","1400","0","57.57","41.36"
"64","000","00","014","1403","1700","707","552","155","31","738","1390","0","53.09","39.71"
"64","000","00","014","1403","1701","707","539","168","74","781","1401","0","55.75","38.47"
"64","000","00","014","1403","1702","579","453","126","30","609","1199","0","50.79","37.78"
"64","000","00","014","1404","0000","1173","901","272","72","1245","2405","0","51.77","37.46"
"64","000","00","014","1404","1703","552","422","130","29","581","1210","0","48.02","34.88"
"64","000","00","014","1404","1704","621","479","142","43","664","1195","0","55.56","40.08"
"64","000","00","014","1405","0000","2263","1774","489","158","2421","4595","0","52.69","38.61"
"64","000","00","014","1405","1705","557","452","105","23","580","1166","0","49.74","38.77"
"64","000","00","014","1405","1706","699","539","160","44","743","1353","0","54.92","39.84"
"64","000","00","014","1405","1707","577","450","127","67","644","1052","0","61.22","42.78"
"64","000","00","014","1405","1708","430","333","97","24","454","1024","0","44.34","32.52"
"64","000","00","014","1406","0000","2259","1770","489","185","2444","4334","0","56.39","40.84"
"64","000","00","014","1406","1709","623","472","151","31","654","1189","0","55.0","39.7"
"64","000","00","014","1406","1710","831","665","166","85","916","1512","0","60.58","43.98"
"64","000","00","014","1406","1711","805","633","172","69","874","1633","0","53.52","38.76"
"64","000","00","014","1407","0000","2123","1651","472","145","2268","3795","0","59.76","43.5"
"64","000","00","014","1407","1712","679","533","146","39","718","1214","0","59.14","43.9"
"64","000","00","014","1407","1713","721","573","148","81","802","1258","0","63.75","45.55"
"64","000","00","014","1407","1714","723","545","178","25","748","1323","0","56.54","41.19"
"64","000","00","014","1408","0000","1296","1074","222","103","1399","2288","0","61.15","46.94"
"64","000","00","014","1408","1715","707","595","112","49","756","1253","0","60.34","47.49"
"64","000","00","014","1408","1716","589","479","110","54","643","1035","0","62.13","46.28"
"64","000","00","014","1409","0000","5760","4536","1224","401","6161","10761","0","57.25","42.15"
"64","000","00","014","1409","1717","573","447","126","29","602","1106","0","54.43","40.42"
"64","000","00","014","1409","1718","644","506","138","40","684","1195","0","57.24","42.34"
"64","000","00","014","1409","1719","553","440","113","35","588","1051","0","55.95","41.86"
"64","000","00","014","1409","1720","768","611","157","83","851","1425","0","59.72","42.88"
"64","000","00","014","1409","1721","851","655","196","58","909","1635","0","55.6","40.06"
"64","000","00","014","1409","1722","748","564","184","58","806","1359","0","59.31","41.5"
"64","000","00","014","1409","1723","748","614","134","56","804","1361","0","59.07","45.11"
"64","000","00","014","1409","1724","875","699","176","42","917","1629","0","56.29","42.91"
"64","000","00","014","1410","0000","3941","3137","804","232","4173","7606","0","54.86","41.24"
"64","000","00","014","1410","1725","830","661","169","49","879","1518","0","57.91","43.54"
"64","000","00","014","1410","1726","817","654","163","74","891","1620","0","55.0","40.37"
"64","000","00","014","1410","1727","832","658","174","27","859","1648","0","52.12","39.93"
"64","000","00","014","1410","1728","734","595","139","55","789","1385","0","56.97","42.96"
"64","000","00","014","1410","1729","728","569","159","27","755","1435","0","52.61","39.65"
"64","000","00","014","1411","0000","927","685","242","55","982","1835","0","53.51","37.33"
"64","000","00","014","1411","1730","543","405","138","22","565","1046","0","54.02","38.72"
"64","000","00","014","1411","1731","384","280","104","33","417","789","0","52.85","35.49"
"64","000","00","014","1412","0000","867","665","202","58","925","1642","0","56.33","40.5"
"64","000","00","014","1412","1732","462","361","101","30","492","909","0","54.13","39.71"
"64","000","00","014","1412","1733","405","304","101","28","433","733","0","59.07","41.47"
"64","000","00","014","1413","0000","1233","977","256","102","1335","2475","0","53.94","39.47"
"64","000","00","014","1413","1734","764","595","169","73","837","1553","0","53.9","38.31"
"64","000","00","014","1413","1735","469","382","87","29","498","922","0","54.01","41.43"
"64","000","00","014","1414","0000","1495","1161","334","184","1679","3001","0","55.95","38.69"
"64","000","00","014","1414","1736","514","398","116","72","586","1012","0","57.91","39.33"
"64","000","00","014","1414","1737","477","373","104","65","542","968","0","55.99","38.53"
"64","000","00","014","1414","1738","504","390","114","47","551","1021","0","53.97","38.2"
"64","000","00","014","1415","0000","671","532","139","76","747","1554","0","48.07","34.23"
"64","000","00","014","1415","1739","671","532","139","76","747","1554","0","48.07","34.23"
"64","000","00","014","1416","0000","3087","2529","558","215","3302","6101","0","54.12","41.45"
"64","000","00","014","1416","1740","635","487","148","52","687","1120","0","61.34","43.48"
"64","000","00","014","1416","1741","704","661","43","61","765","1225","0","62.45","53.96"
"64","000","00","014","1416","1742","485","381","104","27","512","1320","0","38.79","28.86"
"64","000","00","014","1416","1743","690","548","142","51","741","1317","0","56.26","41.61"
"64","000","00","014","1416","1744","573","452","121","24","597","1119","0","53.35","40.39"
"64","000","00","014","1417","0000","4286","3438","848","243","4529","7467","0","60.65","46.04"
"64","000","00","014","1417","1745","673","539","134","48","721","1190","0","60.59","45.29"
"64","000","00","014","1417","1746","704","559","145","51","755","1229","0","61.43","45.48"
"64","000","00","014","1417","1747","707","572","135","47","754","1178","0","64.01","48.56"
"64","000","00","014","1417","1748","764","614","150","28","792","1272","0","62.26","48.27"
"64","000","00","014","1417","1749","748","599","149","20","768","1413","0","54.35","42.39"
"64","000","00","014","1417","1750","690","555","135","49","739","1185","0","62.36","46.84"
"64","000","00","014","1418","0000","294","248","46","6","300","553","0","54.25","44.85"
"64","000","00","014","1418","1751","294","248","46","6","300","553","0","54.25","44.85"
"64","000","00","014","1419","0000","3680","2907","773","256","3936","6837","0","57.57","42.52"
"64","000","00","014","1419","1752","549","432","117","75","624","1121","0","55.66","38.54"
"64","000","00","014","1419","1753","658","529","129","26","684","1227","0","55.75","43.11"
"64","000","00","014","1419","1754","647","508","139","70","717","1058","0","67.77","48.02"
"64","000","00","014","1419","1755","660","511","149","35","695","1209","0","57.49","42.27"
"64","000","00","014","1419","1756","607","487","120","23","630","1100","0","57.27","44.27"
"64","000","00","014","1419","1757","559","440","119","27","586","1122","0","52.23","39.22"
"64","000","00","014","1420","0000","1145","881","264","98","1243","2175","0","57.15","40.51"
"64","000","00","014","1420","1758","568","432","136","75","643","983","0","65.41","43.95"
"64","000","00","014","1420","1759","577","449","128","23","600","1192","0","50.34","37.67"
"64","000","00","014","1421","0000","794","633","161","77","871","1548","0","56.27","40.89"
"64","000","00","014","1421","1760","351","281","70","35","386","719","0","53.69","39.08"
"64","000","00","014","1421","1761","443","352","91","42","485","829","0","58.5","42.46"
"64","000","00","014","1422","0000","1047","811","236","168","1215","1846","0","65.82","43.93"
"64","000","00","014","1422","1762","459","365","94","74","533","771","0","69.13","47.34"
"64","000","00","014","1422","1763","588","446","142","94","682","1075","0","63.44","41.49"
"64","000","00","014","1423","0000","1917","1485","432","183","2100","3669","0","57.24","40.47"
"64","000","00","014","1423","1764","697","542","155","83","780","1280","0","60.94","42.34"
"64","000","00","014","1423","1765","619","471","148","73","692","1179","0","58.69","39.95"
"64","000","00","014","1423","1766","601","472","129","27","628","1210","0","51.9","39.01"
"64","000","00","014","1424","0000","108","91","17","8","116","189","0","61.38","48.15"
"64","000","00","014","1424","1767","108","91","17","8","116","189","0","61.38","48.15"
"64","000","00","014","1425","0000","3766","3210","556","318","4084","6774","0","60.29","47.39"
"64","000","00","014","1425","1768","689","551","138","63","752","1228","0","61.24","44.87"
"64","000","00","014","1425","1769","637","528","109","41","678","1170","0","57.95","45.13"
"64","000","00","014","1425","1770","817","680","137","56","873","1416","0","61.65","48.02"
"64","000","00","014","1425","1771","861","810","51","100","961","1482","0","64.84","54.66"
"64","000","00","014","1425","1772","762","641","121","58","820","1478","0","55.48","43.37"
"64","000","00","015","0000","0000","18468","14634","3834","1480","19948","36772","42431","54.25","39.8"
"64","000","00","015","1501","0000","1536","1215","321","44","1580","2701","0","58.5","44.98"
"64","000","00","015","1501","0736","720","551","169","23","743","1386","0","53.61","39.75"
"64","000","00","015","1501","0737","816","664","152","21","837","1315","0","63.65","50.49"
"64","000","00","015","1502","0000","2533","2037","496","165","2698","5000","0","53.96","40.74"
"64","000","00","015","1502","0738","1244","993","251","72","1316","2461","0","53.47","40.35"
"64","000","00","015","1502","0739","636","511","125","32","668","1274","0","52.43","40.11"
"64","000","00","015","1502","0740","653","533","120","61","714","1265","0","56.44","42.13"
"64","000","00","015","1503","0000","2019","1602","417","156","2175","4126","0","52.71","38.83"
"64","000","00","015","1503","0741","766","610","156","67","833","1504","0","55.39","40.56"
"64","000","00","015","1503","0742","493","372","121","20","513","1049","0","48.9","35.46"
"64","000","00","015","1503","0743","760","620","140","69","829","1573","0","52.7","39.42"
"64","000","00","015","1504","0000","1140","916","224","82","1222","2328","0","52.49","39.35"
"64","000","00","015","1504","0744","491","412","79","31","522","1121","0","46.57","36.75"
"64","000","00","015","1504","0745","649","504","145","51","700","1207","0","58.0","41.76"
"64","000","00","015","1505","0000","1180","905","275","64","1244","2258","0","55.09","40.08"
"64","000","00","015","1505","0746","568","444","124","23","591","1134","0","52.12","39.15"
"64","000","00","015","1505","0747","612","461","151","41","653","1124","0","58.1","41.01"
"64","000","00","015","1506","0000","1845","1455","390","217","2062","3492","0","59.05","41.67"
"64","000","00","015","1506","0748","627","496","131","90","717","1259","0","56.95","39.4"
"64","000","00","015","1506","0749","633","502","131","68","701","1105","0","63.44","45.43"
"64","000","00","015","1506","0750","585","457","128","59","644","1128","0","57.09","40.51"
"64","000","00","015","1507","0000","507","394","113","89","596","1079","0","55.24","36.52"
"64","000","00","015","1507","0751","507","394","113","89","596","1079","0","55.24","36.52"
"64","000","00","015","1508","0000","469","376","93","38","507","1025","0","49.46","36.68"
"64","000","00","015","1508","0752","469","376","93","38","507","1025","0","49.46","36.68"
"64","000","00","015","1509","0000","475","379","96","55","530","950","0","55.79","39.89"
"64","000","00","015","1509","0753","475","379","96","55","530","950","0","55.79","39.89"
"64","000","00","015","1510","0000","719","542","177","93","812","1433","0","56.66","37.82"
"64","000","00","015","1510","0754","719","542","177","93","812","1433","0","56.66","37.82"
"64","000","00","015","1511","0000","634","490","144","33","667","1575","0","42.35","31.11"
"64","000","00","015","1511","0755","355","284","71","21","376","794","0","47.36","35.77"
"64","000","00","015","1511","0756","279","206","73","12","291","781","0","37.26","26.38"
"64","000","00","015","1512","0000","581","442","139","21","602","1318","0","45.68","33.54"
"64","000","00","015","1512","0757","581","442","139","21","602","1318","0","45.68","33.54"
"64","000","00","015","1513","0000","817","631","186","65","882","1783","0","49.47","35.39"
"64","000","00","015","1513","0758","362","290","72","42","404","736","0","54.89","39.4"
"64","000","00","015","1513","0759","455","341","114","23","478","1047","0","45.65","32.57"
"64","000","00","015","1514","0000","1200","924","276","105","1305","2457","0","53.11","37.61"
"64","000","00","015","1514","0760","673","520","153","75","748","1271","0","58.85","40.91"
"64","000","00","015","1514","0761","527","404","123","30","557","1186","0","46.96","34.06"
"64","000","00","015","1515","0000","527","415","112","46","573","1007","0","56.9","41.21"
"64","000","00","015","1515","0762","527","415","112","46","573","1007","0","56.9","41.21"
"64","000","00","015","1516","0000","772","634","138","73","845","1594","0","53.01","39.77"
"64","000","00","015","1516","0763","455","363","92","57","512","859","0","59.6","42.26"
"64","000","00","015","1516","0764","317","271","46","16","333","735","0","45.31","36.87"
"64","000","00","015","1517","0000","1175","1004","171","114","1289","1926","0","66.93","52.13"
"64","000","00","015","1517","0765","566","451","115","72","638","1046","0","60.99","43.12"
"64","000","00","015","1517","0766","609","553","56","42","651","880","0","73.98","62.84"
"64","000","00","015","1518","0000","339","273","66","20","359","720","0","49.86","37.92"
"64","000","00","015","1518","0767","339","273","66","20","359","720","0","49.86","37.92"
"64","000","00","016","0000","0000","15511","11644","3867","1271","16782","30046","34591","55.85","38.75"
"64","000","00","016","1601","0000","459","353","106","73","532","950","0","56.0","37.16"
"64","000","00","016","1601","0637","459","353","106","73","532","950","0","56.0","37.16"
"64","000","00","016","1602","0000","1400","1132","268","80","1480","3162","0","46.81","35.8"
"64","000","00","016","1602","0638","612","484","128","45","657","1306","0","50.31","37.06"
"64","000","00","016","1602","0639","788","648","140","35","823","1856","0","44.34","34.91"
"64","000","00","016","1603","0000","2500","1571","929","241","2741","4968","0","55.17","31.62"
"64","000","00","016","1603","0640","571","148","423","63","634","986","0","64.3","15.01"
"64","000","00","016","1603","0641","515","401","114","58","573","1116","0","51.34","35.93"
"64","000","00","016","1603","0642","734","543","191","72","806","1253","0","64.33","43.34"
"64","000","00","016","1603","0643","680","479","201","48","728","1613","0","45.13","29.7"
"64","000","00","016","1604","0000","826","640","186","50","876","1679","0","52.17","38.12"
"64","000","00","016","1604","0659","319","246","73","17","336","745","0","45.1","33.02"
"64","000","00","016","1604","0660","507","394","113","33","540","934","0","57.82","42.18"
"64","000","00","016","1605","0000","1398","1072","326","114","1512","2661","0","56.82","40.29"
"64","000","00","016","1605","0646","541","444","97","66","607","1004","0","60.46","44.22"
"64","000","00","016","1605","0647","465","360","105","34","499","879","0","56.77","40.96"
"64","000","00","016","1605","0648","392","268","124","14","406","778","0","52.19","34.45"
"64","000","00","016","1606","0000","2977","2283","694","253","3230","5391","0","59.91","42.35"
"64","000","00","016","1606","0649","613","475","138","62","675","1110","0","60.81","42.79"
"64","000","00","016","1606","0650","743","577","166","53","796","1432","0","55.59","40.29"
"64","000","00","016","1606","0651","800","632","168","49","849","1466","0","57.91","43.11"
"64","000","00","016","1606","0652","821","599","222","89","910","1383","0","65.8","43.31"
"64","000","00","016","1607","0000","2571","1994","577","205","2776","4950","0","56.08","40.28"
"64","000","00","016","1607","0653","903","726","177","78","981","1645","0","59.64","44.13"
"64","000","00","016","1607","0654","738","556","182","45","783","1555","0","50.35","35.76"
"64","000","00","016","1607","0655","930","712","218","82","1012","1750","0","57.83","40.69"
"64","000","00","016","1608","0000","1725","1360","365","160","1885","3156","0","59.73","43.09"
"64","000","00","016","1608","0656","596","467","129","55","651","1111","0","58.6","42.03"
"64","000","00","016","1608","0657","628","492","136","69","697","1133","0","61.52","43.42"
"64","000","00","016","1608","0658","501","401","100","36","537","912","0","58.88","43.97"
"64","000","00","016","1609","0000","1655","1239","416","95","1750","3129","0","55.93","39.6"
"64","000","00","016","1609","0644","725","551","174","48","773","1455","0","53.13","37.87"
"64","000","00","016","1609","0645","930","688","242","47","977","1674","0","58.36","41.1"
"64","000","00","017","0000","0000","39792","31665","8127","2375","42167","73611","87415","57.28","43.02"
"64","000","00","017","1701","0000","2356","1868","488","120","2476","4050","0","61.14","46.12"
"64","000","00","017","1701","0661","1050","832","218","51","1101","1777","0","61.96","46.82"
"64","000","00","017","1701","0662","1306","1036","270","69","1375","2273","0","60.49","45.58"
"64","000","00","017","1702","0000","4369","3507","862","262","4631","7511","0","61.66","46.69"
"64","000","00","017","1702","0663","834","662","172","80","914","1384","0","66.04","47.83"
"64","000","00","017","1702","0664","631","494","137","58","689","1170","0","58.89","42.22"
"64","000","00","017","1702","0665","755","585","170","60","815","1216","0","67.02","48.11"
"64","000","00","017","1702","0666","864","700","164","22","886","1598","0","55.44","43.8"
"64","000","00","017","1702","0667","1285","1066","219","42","1327","2143","0","61.92","49.74"
"64","000","00","017","1703","0000","1427","1118","309","132","1559","2638","0","59.1","42.38"
"64","000","00","017","1703","0668","690","545","145","58","748","1300","0","57.54","41.92"
"64","000","00","017","1703","0669","737","573","164","74","811","1338","0","60.61","42.83"
"64","000","00","017","1704","0000","1831","1425","406","134","1965","3823","0","51.4","37.27"
"64","000","00","017","1704","0670","613","464","149","21","634","1217","0","52.1","38.13"
"64","000","00","017","1704","0671","545","424","121","71","616","1202","0","51.25","35.27"
"64","000","00","017","1704","0672","673","537","136","42","715","1404","0","50.93","38.25"
"64","000","00","017","1705","0000","430","328","102","50","480","830","0","57.83","39.52"
"64","000","00","017","1705","0673","430","328","102","50","480","830","0","57.83","39.52"
"64","000","00","017","1706","0000","2438","1962","476","147","2585","5417","0","47.72","36.22"
"64","000","00","017","1706","0674","734","566","168","39","773","1802","0","42.9","31.41"
"64","000","00","017","1706","0675","919","768","151","67","986","1877","0","52.53","40.92"
"64","000","00","017","1706","0676","785","628","157","41","826","1738","0","47.53","36.13"
"64","000","00","017","1707","0000","4666","3745","921","249","4915","8679","0","56.63","43.15"
"64","000","00","017","1707","0677","803","640","163","53","856","1549","0","55.26","41.32"
"64","000","00","017","1707","0678","874","685","189","52","926","1579","0","58.64","43.38"
"64","000","00","017","1707","0679","711","584","127","32","743","1406","0","52.84","41.54"
"64","000","00","017","1707","0680","791","661","130","30","821","1461","0","56.19","45.24"
"64","000","00","017","1707","0681","768","588","180","52","820","1311","0","62.55","44.85"
"64","000","00","017","1707","0682","719","587","132","30","749","1373","0","54.55","42.75"
"64","000","00","017","1708","0000","1057","769","288","59","1116","2216","0","50.36","34.7"
"64","000","00","017","1708","0683","467","333","134","20","487","1035","0","47.05","32.17"
"64","000","00","017","1708","0684","590","436","154","39","629","1181","0","53.26","36.92"
"64","000","00","017","1709","0000","9024","7311","1713","463","9487","15899","0","59.67","45.98"
"64","000","00","017","1709","0685","850","685","165","45","895","1670","0","53.59","41.02"
"64","000","00","017","1709","0686","820","634","186","31","851","1576","0","54.0","40.23"
"64","000","00","017","1709","0687","910","739","171","66","976","1576","0","61.93","46.89"
"64","000","00","017","1709","0688","1122","904","218","46","1168","1915","0","60.99","47.21"
"64","000","00","017","1709","0689","918","761","157","25","943","1758","0","53.64","43.29"
"64","000","00","017","1709","0690","1131","929","202","62","1193","1892","0","63.05","49.1"
"64","000","00","017","1709","0691","1155","934","221","69","1224","2025","0","60.44","46.12"
"64","000","00","017","1709","0692","1179","975","204","60","1239","2014","0","61.52","48.41"
"64","000","00","017","1709","0693","939","750","189","59","998","1473","0","67.75","50.92"
"64","000","00","017","1710","0000","979","784","195","59","1038","1923","0","53.98","40.77"
"64","000","00","017","1710","0694","476","378","98","36","512","979","0","52.3","38.61"
"64","000","00","017","1710","0695","503","406","97","23","526","944","0","55.72","43.01"
"64","000","00","017","1711","0000","1279","1018","261","123","1402","2481","0","56.51","41.03"
"64","000","00","017","1711","0696","618","490","128","82","700","1153","0","60.71","42.5"
"64","000","00","017","1711","0697","661","528","133","41","702","1328","0","52.86","39.76"
"64","000","00","017","1712","0000","917","688","229","73","990","1657","0","59.75","41.52"
"64","000","00","017","1712","0698","917","688","229","73","990","1657","0","59.75","41.52"
"64","000","00","017","1713","0000","2542","2016","526","171","2713","4564","0","59.44","44.17"
"64","000","00","017","1713","0699","745","605","140","72","817","1545","0","52.88","39.16"
"64","000","00","017","1713","0700","815","635","180","56","871","1417","0","61.47","44.81"
"64","000","00","017","1713","0701","982","776","206","43","1025","1602","0","63.98","48.44"
"64","000","00","017","1714","0000","2129","1666","463","111","2240","3737","0","59.94","44.58"
"64","000","00","017","1714","0702","1092","861","231","76","1168","1823","0","64.07","47.23"
"64","000","00","017","1714","0703","1037","805","232","35","1072","1914","0","56.01","42.06"
"64","000","00","017","1715","0000","3243","2605","638","164","3407","6019","0","56.6","43.28"
"64","000","00","017","1715","0704","1078","875","203","52","1130","1992","0","56.73","43.93"
"64","000","00","017","1715","0705","1019","818","201","49","1068","2045","0","52.22","40.0"
"64","000","00","017","1715","0706","1146","912","234","63","1209","1982","0","61.0","46.01"
"64","000","00","017","1716","0000","1105","855","250","58","1163","2167","0","53.67","39.46"
"64","000","00","017","1716","0707","1105","855","250","58","1163","2167","0","53.67","39.46"
"64","000","00","018","0000","0000","21976","16980","4996","1467","23443","39191","44387","59.82","43.33"
"64","000","00","018","1801","0000","5437","4152","1285","362","5799","10030","0","57.82","41.4"
"64","000","00","018","1801","0708","929","694","235","63","992","1678","0","59.12","41.36"
"64","000","00","018","1801","0709","849","663","186","65","914","1682","0","54.34","39.42"
"64","000","00","018","1801","0710","694","533","161","49","743","1225","0","60.65","43.51"
"64","000","00","018","1801","0711","669","516","153","62","731","1322","0","55.3","39.03"
"64","000","00","018","1801","0712","679","534","145","58","737","1215","0","60.66","43.95"
"64","000","00","018","1801","0713","904","687","217","48","952","1779","0","53.51","38.62"
"64","000","00","018","1801","0714","713","525","188","17","730","1129","0","64.66","46.5"
"64","000","00","018","1802","0000","2670","2006","664","166","2836","4682","0","60.57","42.84"
"64","000","00","018","1802","0715","794","624","170","62","856","1374","0","62.3","45.41"
"64","000","00","018","1802","0716","590","411","179","33","623","1089","0","57.21","37.74"
"64","000","00","018","1802","0717","1286","971","315","71","1357","2219","0","61.15","43.76"
"64","000","00","018","1803","0000","5761","4429","1332","301","6062","9817","0","61.75","45.12"
"64","000","00","018","1803","0718","893","679","214","33","926","1634","0","56.67","41.55"
"64","000","00","018","1803","0719","921","746","175","65","986","1553","0","63.49","48.04"
"64","000","00","018","1803","0720","947","725","222","48","995","1572","0","63.3","46.12"
"64","000","00","018","1803","0721","1014","772","242","45","1059","1688","0","62.74","45.73"
"64","000","00","018","1803","0722","947","690","257","38","985","1626","0","60.58","42.44"
"64","000","00","018","1803","0723","1039","817","222","72","1111","1744","0","63.7","46.85"
"64","000","00","018","1804","0000","1973","1554","419","200","2173","3548","0","61.25","43.8"
"64","000","00","018","1804","0724","627","492","135","57","684","1230","0","55.61","40.0"
"64","000","00","018","1804","0725","679","538","141","95","774","1201","0","64.45","44.8"
"64","000","00","018","1804","0726","667","524","143","48","715","1117","0","64.01","46.91"
"64","000","00","018","1805","0000","3414","2699","715","242","3656","6462","0","56.58","41.77"
"64","000","00","018","1805","0727","654","516","138","61","715","1255","0","56.97","41.12"
"64","000","00","018","1805","0728","694","545","149","41","735","1432","0","51.33","38.06"
"64","000","00","018","1805","0729","675","521","154","29","704","1370","0","51.39","38.03"
"64","000","00","018","1805","0730","799","653","146","54","853","1364","0","62.54","47.87"
"64","000","00","018","1805","0731","592","464","128","57","649","1041","0","62.34","44.57"
"64","000","00","018","1806","0000","469","366","103","38","507","702","0","72.22","52.14"
"64","000","00","018","1806","0732","469","366","103","38","507","702","0","72.22","52.14"
"64","000","00","018","1807","0000","2252","1774","478","158","2410","3950","0","61.01","44.91"
"64","000","00","018","1807","0733","658","499","159","73","731","1212","0","60.31","41.17"
"64","000","00","018","1807","0734","700","572","128","52","752","1289","0","58.34","44.38"
"64","000","00","018","1807","0735","894","703","191","33","927","1449","0","63.98","48.52"
"64","000","00","019","0000","0000","46117","37008","9109","3112","49229","81244","97072","60.59","45.55"
"64","000","00","019","1901","0000","689","521","168","75","764","1159","0","65.92","44.95"
"64","000","00","019","1901","0268","689","521","168","75","764","1159","0","65.92","44.95"
"64","000","00","019","1902","0000","2387","1925","462","130","2517","4358","0","57.76","44.17"
"64","000","00","019","1902","0261","829","671","158","44","873","1345","0","64.91","49.89"
"64","000","00","019","1902","0262","443","334","109","21","464","1045","0","44.4","31.96"
"64","000","00","019","1902","0263","593","494","99","46","639","1051","0","60.8","47.0"
"64","000","00","019","1902","0264","522","426","96","19","541","917","0","59.0","46.46"
"64","000","00","019","1903","0000","1964","1553","411","128","2092","3239","0","64.59","47.95"
"64","000","00","019","1903","0265","568","435","133","34","602","934","0","64.45","46.57"
"64","000","00","019","1903","0266","635","501","134","53","688","1097","0","62.72","45.67"
"64","000","00","019","1903","0267","761","617","144","41","802","1208","0","66.39","51.08"
"64","000","00","019","1904","0000","569","436","133","54","623","1018","0","61.2","42.83"
"64","000","00","019","1904","0269","569","436","133","54","623","1018","0","61.2","42.83"
"64","000","00","019","1905","0000","2246","1843","403","89","2335","4091","0","57.08","45.05"
"64","000","00","019","1905","0274","667","551","116","41","708","1328","0","53.31","41.49"
"64","000","00","019","1905","0275","774","619","155","25","799","1382","0","57.81","44.79"
"64","000","00","019","1905","0276","805","673","132","23","828","1381","0","59.96","48.73"
"64","000","00","019","1906","0000","612","480","132","39","651","1316","0","49.47","36.47"
"64","000","00","019","1906","0270","612","480","132","39","651","1316","0","49.47","36.47"
"64","000","00","019","1907","0000","1767","1538","229","72","1839","2895","0","63.52","53.13"
"64","000","00","019","1907","0325","783","679","104","36","819","1336","0","61.3","50.82"
"64","000","00","019","1907","0326","743","672","71","19","762","1218","0","62.56","55.17"
"64","000","00","019","1907","0327","241","187","54","17","258","341","0","75.66","54.84"
"64","000","00","019","1908","0000","228","177","51","13","241","318","0","75.79","55.66"
"64","000","00","019","1908","0332","228","177","51","13","241","318","0","75.79","55.66"
"64","000","00","019","1909","0000","1501","1203","298","100","1601","2795","0","57.28","43.04"
"64","000","00","019","1909","0293","720","565","155","56","776","1283","0","60.48","44.04"
"64","000","00","019","1909","0294","781","638","143","44","825","1512","0","54.56","42.2"
"64","000","00","019","1910","0000","672","516","156","33","705","1413","0","49.89","36.52"
"64","000","00","019","1910","0309","672","516","156","33","705","1413","0","49.89","36.52"
"64","000","00","019","1911","0000","2082","1655","427","173","2255","3607","0","62.52","45.88"
"64","000","00","019","1911","0304","727","582","145","50","777","1272","0","61.08","45.75"
"64","000","00","019","1911","0305","650","520","130","49","699","1080","0","64.72","48.15"
"64","000","00","019","1911","0306","705","553","152","74","779","1255","0","62.07","44.06"
"64","000","00","019","1912","0000","3204","2559","645","208","3412","5535","0","61.64","46.23"
"64","000","00","019","1912","0300","782","622","160","59","841","1360","0","61.84","45.74"
"64","000","00","019","1912","0301","794","632","162","33","827","1363","0","60.67","46.37"
"64","000","00","019","1912","0302","819","656","163","56","875","1352","0","64.72","48.52"
"64","000","00","019","1912","0303","809","649","160","60","869","1460","0","59.52","44.45"
"64","000","00","019","1913","0000","1043","867","176","66","1109","1613","0","68.75","53.75"
"64","000","00","019","1913","0330","532","421","111","43","575","851","0","67.57","49.47"
"64","000","00","019","1913","0331","511","446","65","23","534","762","0","70.08","58.53"
"64","000","00","019","1914","0000","432","330","102","80","512","756","0","67.72","43.65"
"64","000","00","019","1914","0320","432","330","102","80","512","756","0","67.72","43.65"
"64","000","00","019","1915","0000","358","289","69","19","377","866","0","43.53","33.37"
"64","000","00","019","1915","0323","358","289","69","19","377","866","0","43.53","33.37"
"64","000","00","019","1916","0000","1849","1474","375","141","1990","3350","0","59.4","44.0"
"64","000","00","019","1916","0297","618","481","137","60","678","1096","0","61.86","43.89"
"64","000","00","019","1916","0298","604","477","127","43","647","1066","0","60.69","44.75"
"64","000","00","019","1916","0299","627","516","111","38","665","1188","0","55.98","43.43"
"64","000","00","019","1917","0000","2092","1674","418","154","2246","3849","0","58.35","43.49"
"64","000","00","019","1917","0277","691","546","145","72","763","1282","0","59.52","42.59"
"64","000","00","019","1917","0278","667","511","156","22","689","1240","0","55.56","41.21"
"64","000","00","019","1917","0279","734","617","117","60","794","1327","0","59.83","46.5"
"64","000","00","019","1918","0000","2286","1819","467","138","2424","4065","0","59.63","44.75"
"64","000","00","019","1918","0271","745","607","138","32","777","1345","0","57.77","45.13"
"64","000","00","019","1918","0272","757","588","169","49","806","1295","0","62.24","45.41"
"64","000","00","019","1918","0273","784","624","160","57","841","1425","0","59.02","43.79"
"64","000","00","019","1919","0000","3647","2944","703","217","3864","6674","0","57.9","44.11"
"64","000","00","019","1919","0280","908","751","157","55","963","1736","0","55.47","43.26"
"64","000","00","019","1919","0281","881","680","201","69","950","1566","0","60.66","43.42"
"64","000","00","019","1919","0282","932","776","156","29","961","1779","0","54.02","43.62"
"64","000","00","019","1919","0283","926","737","189","64","990","1593","0","62.15","46.26"
"64","000","00","019","1920","0000","3174","2492","682","204","3378","5402","0","62.53","46.13"
"64","000","00","019","1920","0284","856","680","176","61","917","1480","0","61.96","45.95"
"64","000","00","019","1920","0285","775","611","164","35","810","1364","0","59.38","44.79"
"64","000","00","019","1920","0286","816","641","175","47","863","1410","0","61.21","45.46"
"64","000","00","019","1920","0287","727","560","167","61","788","1148","0","68.64","48.78"
"64","000","00","019","1921","0000","1066","847","219","56","1122","1830","0","61.31","46.28"
"64","000","00","019","1921","0289","556","454","102","39","595","969","0","61.4","46.85"
"64","000","00","019","1921","0290","510","393","117","17","527","861","0","61.21","45.64"
"64","000","00","019","1922","0000","1060","822","238","52","1112","1808","0","61.5","45.46"
"64","000","00","019","1922","0310","417","321","96","18","435","765","0","56.86","41.96"
"64","000","00","019","1922","0311","643","501","142","34","677","1043","0","64.91","48.03"
"64","000","00","019","1923","0000","1092","861","231","63","1155","1837","0","62.87","46.87"
"64","000","00","019","1923","0312","397","329","68","30","427","844","0","50.59","38.98"
"64","000","00","019","1923","0313","695","532","163","33","728","993","0","73.31","53.58"
"64","000","00","019","1924","0000","600","471","129","70","670","1038","0","64.55","45.38"
"64","000","00","019","1924","0314","600","471","129","70","670","1038","0","64.55","45.38"
"64","000","00","019","1925","0000","950","737","213","75","1025","1712","0","59.87","43.05"
"64","000","00","019","1925","0291","413","330","83","17","430","823","0","52.25","40.1"
"64","000","00","019","1925","0292","537","407","130","58","595","889","0","66.93","45.78"
"64","000","00","019","1926","0000","1935","1588","347","169","2104","3442","0","61.13","46.14"
"64","000","00","019","1926","0315","589","446","143","69","658","1070","0","61.5","41.68"
"64","000","00","019","1926","0316","611","571","40","70","681","1023","0","66.57","55.82"
"64","000","00","019","1926","0317","735","571","164","30","765","1349","0","56.71","42.33"
"64","000","00","019","1927","0000","936","733","203","55","991","1753","0","56.53","41.81"
"64","000","00","019","1927","0318","746","591","155","41","787","1452","0","54.2","40.7"
"64","000","00","019","1927","0319","190","142","48","14","204","301","0","67.77","47.18"
"64","000","00","019","1928","0000","852","664","188","86","938","1587","0","59.11","41.84"
"64","000","00","019","1928","0321","333","255","78","14","347","733","0","47.34","34.79"
"64","000","00","019","1928","0322","519","409","110","72","591","854","0","69.2","47.89"
"64","000","00","019","1929","0000","505","396","109","59","564","978","0","57.67","40.49"
"64","000","00","019","1929","0324","505","396","109","59","564","978","0","57.67","40.49"
"64","000","00","019","1930","0000","1327","1069","258","96","1423","2175","0","65.43","49.15"
"64","000","00","019","1930","0307","580","456","124","49","629","938","0","67.06","48.61"
"64","000","00","019","1930","0308","747","613","134","47","794","1237","0","64.19","49.56"
"64","000","00","019","1931","0000","358","273","85","47","405","625","0","64.8","43.68"
"64","000","00","019","1931","0288","358","273","85","47","405","625","0","64.8","43.68"
"64","000","00","019","1932","0000","1315","1044","271","107","1422","2245","0","63.34","46.5"
"64","000","00","019","1932","0295","614","477","137","58","672","983","0","68.36","48.52"
"64","000","00","019","1932","0296","701","567","134","49","750","1262","0","59.43","44.93"
"64","000","00","019","1933","0000","1319","1208","111","44","1363","1895","0","71.93","63.75"
"64","000","00","019","1933","0328","688","635","53","26","714","955","0","74.76","66.49"
"64","000","00","019","1933","0329","631","573","58","18","649","940","0","69.04","60.96"
"64","000","00","020","0000","0000","18235","14112","4123","1669","19904","32565","37647","61.12","43.33"
"64","000","00","020","2001","0000","1226","936","290","120","1346","2078","0","64.77","45.04"
"64","000","00","020","2001","0404","599","458","141","69","668","1005","0","66.47","45.57"
"64","000","00","020","2001","0405","627","478","149","51","678","1073","0","63.19","44.55"
"64","000","00","020","2002","0000","608","479","129","37","645","1129","0","57.13","42.43"
"64","000","00","020","2002","0406","608","479","129","37","645","1129","0","57.13","42.43"
"64","000","00","020","2003","0000","1285","993","292","115","1400","2335","0","59.96","42.53"
"64","000","00","020","2003","0407","703","536","167","78","781","1244","0","62.78","43.09"
"64","000","00","020","2003","0408","582","457","125","37","619","1091","0","56.74","41.89"
"64","000","00","020","2004","0000","1472","1146","326","94","1566","2469","0","63.43","46.42"
"64","000","00","020","2004","0409","807","647","160","52","859","1329","0","64.64","48.68"
"64","000","00","020","2004","0410","665","499","166","42","707","1140","0","62.02","43.77"
"64","000","00","020","2005","0000","683","503","180","72","755","1220","0","61.89","41.23"
"64","000","00","020","2005","0411","683","503","180","72","755","1220","0","61.89","41.23"
"64","000","00","020","2006","0000","1339","1013","326","155","1494","2362","0","63.25","42.89"
"64","000","00","020","2006","0412","651","493","158","59","710","1047","0","67.81","47.09"
"64","000","00","020","2006","0413","688","520","168","96","784","1315","0","59.62","39.54"
"64","000","00","020","2007","0000","764","571","193","99","863","1411","0","61.16","40.47"
"64","000","00","020","2007","0414","352","261","91","34","386","691","0","55.86","37.77"
"64","000","00","020","2007","0415","412","310","102","65","477","720","0","66.25","43.06"
"64","000","00","020","2008","0000","1905","1479","426","167","2072","3271","0","63.34","45.22"
"64","000","00","020","2008","0416","678","521","157","67","745","1192","0","62.5","43.71"
"64","000","00","020","2008","0417","783","599","184","53","836","1318","0","63.43","45.45"
"64","000","00","020","2008","0418","444","359","85","47","491","761","0","64.52","47.17"
"64","000","00","020","2009","0000","864","683","181","54","918","1560","0","58.85","43.78"
"64","000","00","020","2009","0419","532","421","111","24","556","973","0","57.14","43.27"
"64","000","00","020","2009","0420","332","262","70","30","362","587","0","61.67","44.63"
"64","000","00","020","2010","0000","1466","1154","312","86","1552","2421","0","64.11","47.67"
"64","000","00","020","2010","0421","484","364","120","43","527","812","0","64.9","44.83"
"64","000","00","020","2010","0422","201","150","51","13","214","343","0","62.39","43.73"
"64","000","00","020","2010","0423","781","640","141","30","811","1266","0","64.06","50.55"
"64","000","00","020","2011","0000","1155","916","239","147","1302","2012","0","64.71","45.53"
"64","000","00","020","2011","0424","653","515","138","86","739","1128","0","65.51","45.66"
"64","000","00","020","2011","0425","502","401","101","61","563","884","0","63.69","45.36"
"64","000","00","020","2012","0000","1324","1047","277","144","1468","2446","0","60.02","42.8"
"64","000","00","020","2012","0426","620","498","122","70","690","1187","0","58.13","41.95"
"64","000","00","020","2012","0427","704","549","155","74","778","1259","0","61.8","43.61"
"64","000","00","020","2013","0000","677","524","153","74","751","1361","0","55.18","38.5"
"64","000","00","020","2013","0428","677","524","153","74","751","1361","0","55.18","38.5"
"64","000","00","020","2014","0000","323","249","74","29","352","671","0","52.46","37.11"
"64","000","00","020","2014","0429","323","249","74","29","352","671","0","52.46","37.11"
"64","000","00","020","2015","0000","2142","1634","508","229","2371","3689","0","64.27","44.29"
"64","000","00","020","2015","0430","707","549","158","69","776","1215","0","63.87","45.19"
"64","000","00","020","2015","0431","703","511","192","102","805","1255","0","64.14","40.72"
"64","000","00","020","2015","0432","732","574","158","58","790","1219","0","64.81","47.09"
"64","000","00","020","2016","0000","712","562","150","36","748","1372","0","54.52","40.96"
"64","000","00","020","2016","0433","712","562","150","36","748","1372","0","54.52","40.96"
"64","000","00","020","2017","0000","290","223","67","11","301","758","0","39.71","29.42"
"64","000","00","020","2017","0434","290","223","67","11","301","758","0","39.71","29.42"
"64","000","00","021","0000","0000","13342","10583","2759","1259","14601","26012","29809","56.13","40.69"
"64","000","00","021","2101","0000","580","465","115","76","656","1152","0","56.94","40.36"
"64","000","00","021","2101","0333","580","465","115","76","656","1152","0","56.94","40.36"
"64","000","00","021","2102","0000","1195","926","269","78","1273","2094","0","60.79","44.22"
"64","000","00","021","2102","0334","611","478","133","22","633","1120","0","56.52","42.68"
"64","000","00","021","2102","0335","584","448","136","56","640","974","0","65.71","46.0"
"64","000","00","021","2103","0000","1472","1138","334","128","1600","3353","0","47.72","33.94"
"64","000","00","021","2103","0336","513","398","115","20","533","1019","0","52.31","39.06"
"64","000","00","021","2103","0337","524","393","131","72","596","1058","0","56.33","37.15"
"64","000","00","021","2103","0338","395","312","83","35","430","1017","0","42.28","30.68"
"64","000","00","021","2103","0339","40","35","5","1","41","259","0","15.83","13.51"
"64","000","00","021","2104","0000","1500","1210","290","140","1640","2652","0","61.84","45.63"
"64","000","00","021","2104","0340","552","456","96","62","614","926","0","66.31","49.24"
"64","000","00","021","2104","0341","290","236","54","19","309","624","0","49.52","37.82"
"64","000","00","021","2104","0342","658","518","140","59","717","1102","0","65.06","47.01"
"64","000","00","021","2105","0000","1247","978","269","104","1351","2433","0","55.53","40.2"
"64","000","00","021","2105","0343","533","426","107","45","578","1072","0","53.92","39.74"
"64","000","00","021","2105","0344","714","552","162","59","773","1361","0","56.8","40.56"
"64","000","00","021","2106","0000","255","212","43","32","287","472","0","60.81","44.92"
"64","000","00","021","2106","0345","255","212","43","32","287","472","0","60.81","44.92"
"64","000","00","021","2107","0000","1233","967","266","134","1367","2331","0","58.64","41.48"
"64","000","00","021","2107","0346","575","445","130","53","628","1197","0","52.46","37.18"
"64","000","00","021","2107","0347","658","522","136","81","739","1134","0","65.17","46.03"
"64","000","00","021","2108","0000","1985","1601","384","149","2134","3757","0","56.8","42.61"
"64","000","00","021","2108","0348","563","439","124","42","605","1148","0","52.7","38.24"
"64","000","00","021","2108","0349","590","495","95","65","655","1207","0","54.27","41.01"
"64","000","00","021","2108","0350","832","667","165","42","874","1402","0","62.34","47.57"
"64","000","00","021","2109","0000","1830","1469","361","200","2030","3401","0","59.69","43.19"
"64","000","00","021","2109","0351","536","422","114","71","607","1000","0","60.7","42.2"
"64","000","00","021","2109","0352","612","487","125","69","681","1110","0","61.35","43.87"
"64","000","00","021","2109","0353","682","560","122","60","742","1291","0","57.47","43.38"
"64","000","00","021","2110","0000","920","712","208","132","1052","1895","0","55.51","37.57"
"64","000","00","021","2110","0354","410","318","92","76","486","797","0","60.98","39.9"
"64","000","00","021","2110","0355","510","394","116","56","566","1098","0","51.55","35.88"
"64","000","00","021","2111","0000","1125","905","220","86","1211","2472","0","48.99","36.61"
"64","000","00","021","2111","0356","684","538","146","67","751","1393","0","53.91","38.62"
"64","000","00","021","2111","0357","441","367","74","19","460","1079","0","42.63","34.01"
"64","000","00","022","0000","0000","2740","2119","621","340","3080","6671","7196","46.17","31.76"
"64","000","00","022","2201","0000","136","111","25","5","141","369","0","38.21","30.08"
"64","000","00","022","2201","0237","136","111","25","5","141","369","0","38.21","30.08"
"64","000","00","022","2202","0000","354","282","72","31","385","1062","0","36.25","26.55"
"64","000","00","022","2202","0238","248","193","55","21","269","656","0","41.01","29.42"
"64","000","00","022","2202","0239","106","89","17","10","116","406","0","28.57","21.92"
"64","000","00","022","2203","0000","171","125","46","17","188","380","0","49.47","32.89"
"64","000","00","022","2203","0240","171","125","46","17","188","380","0","49.47","32.89"
"64","000","00","022","2204","0000","173","136","37","19","192","379","0","50.66","35.88"
"64","000","00","022","2204","0241","173","136","37","19","192","379","0","50.66","35.88"
"64","000","00","022","2205","0000","293","224","69","56","349","625","0","55.84","35.84"
"64","000","00","022","2205","0242","293","224","69","56","349","625","0","55.84","35.84"
"64","000","00","022","2206","0000","412","335","77","20","432","946","0","45.67","35.41"
"64","000","00","022","2206","0243","412","335","77","20","432","946","0","45.67","35.41"
"64","000","00","022","2207","0000","324","250","74","50","374","794","0","47.1","31.49"
"64","000","00","022","2207","0244","324","250","74","50","374","794","0","47.1","31.49"
"64","000","00","022","2208","0000","146","111","35","22","168","382","0","43.98","29.06"
"64","000","00","022","2208","0245","146","111","35","22","168","382","0","43.98","29.06"
"64","000","00","022","2209","0000","159","110","49","40","199","513","0","38.79","21.44"
"64","000","00","022","2209","0246","159","110","49","40","199","513","0","38.79","21.44"
"64","000","00","022","2210","0000","572","435","137","80","652","1221","0","53.4","35.63"
"64","000","00","022","2210","0247","270","200","70","21","291","601","0","48.42","33.28"
"64","000","00","022","2210","0248","302","235","67","59","361","620","0","58.23","37.9"
"64","000","00","023","0000","0000","12040","9426","2614","871","12911","24534","28676","52.62","38.42"
"64","000","00","023","2301","0000","556","406","150","41","597","1299","0","45.96","31.25"
"64","000","00","023","2301","0216","556","406","150","41","597","1299","0","45.96","31.25"
"64","000","00","023","2302","0000","943","732","211","72","1015","2005","0","50.62","36.51"
"64","000","00","023","2302","0217","537","420","117","41","578","1107","0","52.21","37.94"
"64","000","00","023","2302","0218","406","312","94","31","437","898","0","48.66","34.74"
"64","000","00","023","2303","0000","594","452","142","80","674","1259","0","53.53","35.9"
"64","000","00","023","2303","0219","594","452","142","80","674","1259","0","53.53","35.9"
"64","000","00","023","2304","0000","1066","850","216","52","1118","2143","0","52.17","39.66"
"64","000","00","023","2304","0220","756","608","148","47","803","1579","0","50.85","38.51"
"64","000","00","023","2304","0221","310","242","68","5","315","564","0","55.85","42.91"
"64","000","00","023","2305","0000","451","354","97","45","496","768","0","64.58","46.09"
"64","000","00","023","2305","0222","451","354","97","45","496","768","0","64.58","46.09"
"64","000","00","023","2306","0000","2500","1969","531","150","2650","4886","0","54.24","40.3"
"64","000","00","023","2306","0223","592","477","115","43","635","1092","0","58.15","43.68"
"64","000","00","023","2306","0224","568","429","139","55","623","1099","0","56.69","39.04"
"64","000","00","023","2306","0225","595","488","107","24","619","1134","0","54.59","43.03"
"64","000","00","023","2306","0226","745","575","170","28","773","1561","0","49.52","36.84"
"64","000","00","023","2307","0000","1344","1013","331","108","1452","2649","0","54.81","38.24"
"64","000","00","023","2307","0227","817","603","214","82","899","1533","0","58.64","39.33"
"64","000","00","023","2307","0228","527","410","117","26","553","1116","0","49.55","36.74"
"64","000","00","023","2308","0000","1133","889","244","96","1229","2314","0","53.11","38.42"
"64","000","00","023","2308","0229","510","397","113","38","548","1054","0","51.99","37.67"
"64","000","00","023","2308","0230","623","492","131","58","681","1260","0","54.05","39.05"
"64","000","00","023","2309","0000","720","583","137","72","792","1504","0","52.66","38.76"
"64","000","00","023","2309","0231","720","583","137","72","792","1504","0","52.66","38.76"
"64","000","00","023","2310","0000","781","626","155","37","818","1671","0","48.95","37.46"
"64","000","00","023","2310","0232","378","299","79","16","394","848","0","46.46","35.26"
"64","000","00","023","2310","0233","403","327","76","21","424","823","0","51.52","39.73"
"64","000","00","023","2311","0000","523","424","99","30","553","1021","0","54.16","41.53"
"64","000","00","023","2311","0234","523","424","99","30","553","1021","0","54.16","41.53"
"64","000","00","023","2312","0000","1429","1128","301","88","1517","3015","0","50.32","37.41"
"64","000","00","023","2312","0235","795","643","152","39","834","1715","0","48.63","37.49"
"64","000","00","023","2312","0236","634","485","149","49","683","1300","0","52.54","37.31"
"64","000","00","024","0000","0000","23526","18361","5165","1997","25523","43850","52578","58.21","41.87"
"64","000","00","024","2401","0000","1666","1296","370","168","1834","3222","0","56.92","40.22"
"64","000","00","024","2401","0175","489","393","96","29","518","1026","0","50.49","38.3"
"64","000","00","024","2401","0176","557","431","126","70","627","1069","0","58.65","40.32"
"64","000","00","024","2401","0177","620","472","148","69","689","1127","0","61.14","41.88"
"64","000","00","024","2402","0000","589","465","124","75","664","1179","0","56.32","39.44"
"64","000","00","024","2402","0178","589","465","124","75","664","1179","0","56.32","39.44"
"64","000","00","024","2403","0000","614","464","150","88","702","1237","0","56.75","37.51"
"64","000","00","024","2403","0179","614","464","150","88","702","1237","0","56.75","37.51"
"64","000","00","024","2404","0000","591","461","130","65","656","1096","0","59.85","42.06"
"64","000","00","024","2404","0180","591","461","130","65","656","1096","0","59.85","42.06"
"64","000","00","024","2405","0000","725","570","155","72","797","1272","0","62.66","44.81"
"64","000","00","024","2405","0181","725","570","155","72","797","1272","0","62.66","44.81"
"64","000","00","024","2406","0000","1242","983","259","105","1347","2309","0","58.34","42.57"
"64","000","00","024","2406","0182","637","494","143","57","694","1182","0","58.71","41.79"
"64","000","00","024","2406","0183","605","489","116","48","653","1127","0","57.94","43.39"
"64","000","00","024","2407","0000","1140","878","262","94","1234","2088","0","59.1","42.05"
"64","000","00","024","2407","0184","527","409","118","44","571","956","0","59.73","42.78"
"64","000","00","024","2407","0185","613","469","144","50","663","1132","0","58.57","41.43"
"64","000","00","024","2408","0000","1706","1387","319","164","1870","3333","0","56.11","41.61"
"64","000","00","024","2408","0186","580","476","104","75","655","1025","0","63.9","46.44"
"64","000","00","024","2408","0187","494","398","96","28","522","1007","0","51.84","39.52"
"64","000","00","024","2408","0188","632","513","119","61","693","1301","0","53.27","39.43"
"64","000","00","024","2409","0000","1349","1053","296","112","1461","2652","0","55.09","39.71"
"64","000","00","024","2409","0189","471","381","90","34","505","885","0","57.06","43.05"
"64","000","00","024","2409","0190","373","272","101","18","391","837","0","46.71","32.5"
"64","000","00","024","2409","0191","505","400","105","60","565","930","0","60.75","43.01"
"64","000","00","024","2410","0000","899","692","207","110","1009","1804","0","55.93","38.36"
"64","000","00","024","2410","0192","355","280","75","47","402","781","0","51.47","35.85"
"64","000","00","024","2410","0193","544","412","132","63","607","1023","0","59.34","40.27"
"64","000","00","024","2411","0000","1803","1396","407","134","1937","3400","0","56.97","41.06"
"64","000","00","024","2411","0194","955","770","185","78","1033","1763","0","58.59","43.68"
"64","000","00","024","2411","0195","848","626","222","56","904","1637","0","55.22","38.24"
"64","000","00","024","2412","0000","1186","916","270","109","1295","2247","0","57.63","40.77"
"64","000","00","024","2412","0196","550","414","136","37","587","1070","0","54.86","38.69"
"64","000","00","024","2412","0197","636","502","134","72","708","1177","0","60.15","42.65"
"64","000","00","024","2413","0000","1655","1248","407","103","1758","3050","0","57.64","40.92"
"64","000","00","024","2413","0198","554","389","165","38","592","1007","0","58.79","38.63"
"64","000","00","024","2413","0199","556","432","124","30","586","1026","0","57.12","42.11"
"64","000","00","024","2413","0200","545","427","118","35","580","1017","0","57.03","41.99"
"64","000","00","024","2414","0000","1297","1025","272","97","1394","2353","0","59.24","43.56"
"64","000","00","024","2414","0201","680","529","151","53","733","1264","0","57.99","41.85"
"64","000","00","024","2414","0202","617","496","121","44","661","1089","0","60.7","45.55"
"64","000","00","024","2415","0000","450","340","110","41","491","851","0","57.7","39.95"
"64","000","00","024","2415","0203","450","340","110","41","491","851","0","57.7","39.95"
"64","000","00","024","2416","0000","1154","878","276","72","1226","1948","0","62.94","45.07"
"64","000","00","024","2416","0204","579","441","138","43","622","1011","0","61.52","43.62"
"64","000","00","024","2416","0205","575","437","138","29","604","937","0","64.46","46.64"
"64","000","00","024","2417","0000","917","715","202","41","958","1730","0","55.38","41.33"
"64","000","00","024","2417","0206","364","276","88","14","378","820","0","46.1","33.66"
"64","000","00","024","2417","0207","553","439","114","27","580","910","0","63.74","48.24"
"64","000","00","024","2418","0000","445","334","111","48","493","867","0","56.86","38.52"
"64","000","00","024","2418","0208","445","334","111","48","493","867","0","56.86","38.52"
"64","000","00","024","2419","0000","1479","1159","320","112","1591","2737","0","58.13","42.35"
"64","000","00","024","2419","0209","494","386","108","33","527","937","0","56.24","41.2"
"64","000","00","024","2419","0210","489","385","104","23","512","900","0","56.89","42.78"
"64","000","00","024","2419","0211","496","388","108","56","552","900","0","61.33","43.11"
"64","000","00","024","2420","0000","2619","2101","518","187","2806","4475","0","62.7","46.95"
"64","000","00","024","2420","0212","511","430","81","35","546","918","0","59.48","46.84"
"64","000","00","024","2420","0213","517","403","114","41","558","870","0","64.14","46.32"
"64","000","00","024","2420","0214","673","525","148","48","721","1150","0","62.7","45.65"
"64","000","00","024","2420","0215","918","743","175","63","981","1537","0","63.83","48.34"
"64","000","00","025","0000","0000","12901","10110","2791","967","13868","25729","29812","53.9","39.29"
"64","000","00","025","2501","0000","510","388","122","38","548","1112","0","49.28","34.89"
"64","000","00","025","2501","0151","510","388","122","38","548","1112","0","49.28","34.89"
"64","000","00","025","2502","0000","495","392","103","82","577","1017","0","56.74","38.54"
"64","000","00","025","2502","0152","495","392","103","82","577","1017","0","56.74","38.54"
"64","000","00","025","2503","0000","375","285","90","29","404","796","0","50.75","35.8"
"64","000","00","025","2503","0153","375","285","90","29","404","796","0","50.75","35.8"
"64","000","00","025","2504","0000","1199","925","274","58","1257","2194","0","57.29","42.16"
"64","000","00","025","2504","0154","613","484","129","32","645","1079","0","59.78","44.86"
"64","000","00","025","2504","0155","586","441","145","26","612","1115","0","54.89","39.55"
"64","000","00","025","2505","0000","1282","1015","267","73","1355","2630","0","51.52","38.59"
"64","000","00","025","2505","0156","641","507","134","39","680","1311","0","51.87","38.67"
"64","000","00","025","2505","0157","641","508","133","34","675","1319","0","51.18","38.51"
"64","000","00","025","2506","0000","2074","1639","435","184","2258","3634","0","62.14","45.1"
"64","000","00","025","2506","0158","714","559","155","70","784","1244","0","63.02","44.94"
"64","000","00","025","2506","0159","715","553","162","50","765","1227","0","62.35","45.07"
"64","000","00","025","2506","0160","645","527","118","64","709","1163","0","60.96","45.31"
"64","000","00","025","2507","0000","557","432","125","32","589","981","0","60.04","44.04"
"64","000","00","025","2507","0161","557","432","125","32","589","981","0","60.04","44.04"
"64","000","00","025","2508","0000","1968","1560","408","125","2093","3680","0","56.88","42.39"
"64","000","00","025","2508","0162","376","304","72","16","392","780","0","50.26","38.97"
"64","000","00","025","2508","0163","422","339","83","52","474","832","0","56.97","40.75"
"64","000","00","025","2508","0164","599","460","139","36","635","1017","0","62.44","45.23"
"64","000","00","025","2508","0165","571","457","114","21","592","1051","0","56.33","43.48"
"64","000","00","025","2509","0000","877","676","201","84","961","1804","0","53.27","37.47"
"64","000","00","025","2509","0166","454","354","100","31","485","941","0","51.54","37.62"
"64","000","00","025","2509","0167","423","322","101","53","476","863","0","55.16","37.31"
"64","000","00","025","2510","0000","576","455","121","52","628","1160","0","54.14","39.22"
"64","000","00","025","2510","0168","576","455","121","52","628","1160","0","54.14","39.22"
"64","000","00","025","2511","0000","1019","773","246","79","1098","2212","0","49.64","34.95"
"64","000","00","025","2511","0169","431","337","94","23","454","1090","0","41.65","30.92"
"64","000","00","025","2511","0170","588","436","152","56","644","1122","0","57.4","38.86"
"64","000","00","025","2512","0000","473","390","83","28","501","1123","0","44.61","34.73"
"64","000","00","025","2512","0171","473","390","83","28","501","1123","0","44.61","34.73"
"64","000","00","025","2513","0000","330","261","69","27","357","684","0","52.19","38.16"
"64","000","00","025","2513","0172","330","261","69","27","357","684","0","52.19","38.16"
"64","000","00","025","2514","0000","1166","919","247","76","1242","2702","0","45.97","34.01"
"64","000","00","025","2514","0173","578","458","120","27","605","1249","0","48.44","36.67"
"64","000","00","025","2514","0174","588","461","127","49","637","1453","0","43.84","31.73"
"64","000","00","026","0000","0000","12380","9361","3019","1344","13724","26212","30055","52.36","35.71"
"64","000","00","026","2601","0000","401","310","91","22","423","976","0","43.34","31.76"
"64","000","00","026","2601","0130","401","310","91","22","423","976","0","43.34","31.76"
"64","000","00","026","2602","0000","425","311","114","59","484","887","0","54.57","35.06"
"64","000","00","026","2602","0131","425","311","114","59","484","887","0","54.57","35.06"
"64","000","00","026","2603","0000","809","625","184","30","839","1710","0","49.06","36.55"
"64","000","00","026","2603","0132","809","625","184","30","839","1710","0","49.06","36.55"
"64","000","00","026","2604","0000","1857","1417","440","91","1948","3751","0","51.93","37.78"
"64","000","00","026","2604","0133","517","398","119","44","561","1280","0","43.83","31.09"
"64","000","00","026","2604","0134","684","513","171","30","714","1314","0","54.34","39.04"
"64","000","00","026","2604","0135","656","506","150","17","673","1157","0","58.17","43.73"
"64","000","00","026","2605","0000","863","652","211","118","981","1785","0","54.96","36.53"
"64","000","00","026","2605","0136","863","652","211","118","981","1785","0","54.96","36.53"
"64","000","00","026","2606","0000","537","384","153","82","619","1139","0","54.35","33.71"
"64","000","00","026","2606","0142","537","384","153","82","619","1139","0","54.35","33.71"
"64","000","00","026","2607","0000","1480","1115","365","210","1690","2961","0","57.08","37.66"
"64","000","00","026","2607","0143","657","508","149","107","764","1363","0","56.05","37.27"
"64","000","00","026","2607","0144","823","607","216","103","926","1598","0","57.95","37.98"
"64","000","00","026","2608","0000","365","272","93","49","414","925","0","44.76","29.41"
"64","000","00","026","2608","0146","365","272","93","49","414","925","0","44.76","29.41"
"64","000","00","026","2609","0000","531","407","124","68","599","1111","0","53.92","36.63"
"64","000","00","026","2609","0145","531","407","124","68","599","1111","0","53.92","36.63"
"64","000","00","026","2610","0000","550","417","133","65","615","1148","0","53.57","36.32"
"64","000","00","026","2610","0147","550","417","133","65","615","1148","0","53.57","36.32"
"64","000","00","026","2611","0000","1100","818","282","176","1276","2087","0","61.14","39.2"
"64","000","00","026","2611","0137","391","282","109","92","483","838","0","57.64","33.65"
"64","000","00","026","2611","0138","709","536","173","84","793","1249","0","63.49","42.91"
"64","000","00","026","2612","0000","510","394","116","98","608","1116","0","54.48","35.3"
"64","000","00","026","2612","0139","510","394","116","98","608","1116","0","54.48","35.3"
"64","000","00","026","2613","0000","421","327","94","51","472","978","0","48.26","33.44"
"64","000","00","026","2613","0140","421","327","94","51","472","978","0","48.26","33.44"
"64","000","00","026","2614","0000","448","335","113","46","494","1125","0","43.91","29.78"
"64","000","00","026","2614","0141","448","335","113","46","494","1125","0","43.91","29.78"
"64","000","00","026","2615","0000","2083","1577","506","179","2262","4513","0","50.12","34.94"
"64","000","00","026","2615","0148","609","453","156","49","658","1353","0","48.63","33.48"
"64","000","00","026","2615","0149","655","495","160","64","719","1331","0","54.02","37.19"
"64","000","00","026","2615","0150","819","629","190","66","885","1829","0","48.39","34.39"
"64","000","00","027","0000","0000","6880","5315","1565","606","7486","12001","13888","62.38","44.29"
"64","000","00","027","2701","0000","901","700","201","109","1010","1574","0","64.17","44.47"
"64","000","00","027","2701","0249","460","370","90","38","498","756","0","65.87","48.94"
"64","000","00","027","2701","0250","441","330","111","71","512","818","0","62.59","40.34"
"64","000","00","027","2702","0000","1099","838","261","109","1208","1817","0","66.48","46.12"
"64","000","00","027","2702","0251","550","424","126","45","595","866","0","68.71","48.96"
"64","000","00","027","2702","0252","549","414","135","64","613","951","0","64.46","43.53"
"64","000","00","027","2703","0000","1203","920","283","106","1309","2339","0","55.96","39.33"
"64","000","00","027","2703","0253","558","421","137","64","622","992","0","62.7","42.44"
"64","000","00","027","2703","0254","288","218","70","19","307","682","0","45.01","31.96"
"64","000","00","027","2703","0255","357","281","76","23","380","665","0","57.14","42.26"
"64","000","00","027","2704","0000","187","141","46","16","203","371","0","54.72","38.01"
"64","000","00","027","2704","0256","187","141","46","16","203","371","0","54.72","38.01"
"64","000","00","027","2705","0000","1497","1160","337","107","1604","2532","0","63.35","45.81"
"64","000","00","027","2705","0257","660","509","151","68","728","1114","0","65.35","45.69"
"64","000","00","027","2705","0258","837","651","186","39","876","1418","0","61.78","45.91"
"64","000","00","027","2706","0000","1993","1556","437","159","2152","3368","0","63.9","46.2"
"64","000","00","027","2706","0259","889","687","202","76","965","1477","0","65.34","46.51"
"64","000","00","027","2706","0260","1104","869","235","83","1187","1891","0","62.77","45.95"
"64","000","00","028","0000","0000","8992","7027","1965","1060","10052","16487","19266","60.97","42.62"
"64","000","00","028","2801","0000","670","504","166","78","748","1246","0","60.03","40.45"
"64","000","00","028","2801","0358","670","504","166","78","748","1246","0","60.03","40.45"
"64","000","00","028","2802","0000","1069","806","263","124","1193","1840","0","64.84","43.8"
"64","000","00","028","2802","0359","487","366","121","60","547","885","0","61.81","41.36"
"64","000","00","028","2802","0360","582","440","142","64","646","955","0","67.64","46.07"
"64","000","00","028","2803","0000","270","199","71","44","314","534","0","58.8","37.27"
"64","000","00","028","2803","0361","270","199","71","44","314","534","0","58.8","37.27"
"64","000","00","028","2804","0000","415","320","95","30","445","738","0","60.3","43.36"
"64","000","00","028","2804","0362","415","320","95","30","445","738","0","60.3","43.36"
"64","000","00","028","2805","0000","986","825","161","146","1132","1732","0","65.36","47.63"
"64","000","00","028","2805","0363","533","425","108","42","575","855","0","67.25","49.71"
"64","000","00","028","2805","0364","453","400","53","104","557","877","0","63.51","45.61"
"64","000","00","028","2806","0000","861","667","194","105","966","1589","0","60.79","41.98"
"64","000","00","028","2806","0365","431","339","92","72","503","781","0","64.4","43.41"
"64","000","00","028","2806","0366","430","328","102","33","463","808","0","57.3","40.59"
"64","000","00","028","2807","0000","861","670","191","92","953","1729","0","55.12","38.75"
"64","000","00","028","2807","0367","419","326","93","35","454","904","0","50.22","36.06"
"64","000","00","028","2807","0368","442","344","98","57","499","825","0","60.48","41.7"
"64","000","00","028","2808","0000","1111","878","233","100","1211","2037","0","59.45","43.1"
"64","000","00","028","2808","0370","533","414","119","36","569","1013","0","56.17","40.87"
"64","000","00","028","2808","0371","578","464","114","64","642","1024","0","62.7","45.31"
"64","000","00","028","2809","0000","445","334","111","73","518","941","0","55.05","35.49"
"64","000","00","028","2809","0369","445","334","111","73","518","941","0","55.05","35.49"
"64","000","00","028","2810","0000","413","348","65","22","435","861","0","50.52","40.42"
"64","000","00","028","2810","0372","413","348","65","22","435","861","0","50.52","40.42"
"64","000","00","028","2811","0000","653","503","150","72","725","1163","0","62.34","43.25"
"64","000","00","028","2811","0373","653","503","150","72","725","1163","0","62.34","43.25"
"64","000","00","028","2812","0000","1238","973","265","174","1412","2077","0","67.98","46.85"
"64","000","00","028","2812","0374","699","552","147","91","790","1216","0","64.97","45.39"
"64","000","00","028","2812","0375","539","421","118","83","622","861","0","72.24","48.9"
"64","000","00","029","0000","0000","16220","12760","3460","1448","17668","31025","35896","56.95","41.13"
"64","000","00","029","2901","0000","1171","840","331","139","1310","2124","0","61.68","39.55"
"64","000","00","029","2901","0376","606","402","204","68","674","1061","0","63.52","37.89"
"64","000","00","029","2901","0377","565","438","127","71","636","1063","0","59.83","41.2"
"64","000","00","029","2902","0000","1026","779","247","54","1080","2047","0","52.76","38.06"
"64","000","00","029","2902","0378","509","389","120","33","542","969","0","55.93","40.14"
"64","000","00","029","2902","0379","517","390","127","21","538","1078","0","49.91","36.18"
"64","000","00","029","2903","0000","1218","933","285","117","1335","2231","0","59.84","41.82"
"64","000","00","029","2903","0380","458","341","117","62","520","838","0","62.05","40.69"
"64","000","00","029","2903","0381","356","270","86","23","379","611","0","62.03","44.19"
"64","000","00","029","2903","0382","404","322","82","32","436","782","0","55.75","41.18"
"64","000","00","029","2904","0000","857","671","186","86","943","1451","0","64.99","46.24"
"64","000","00","029","2904","0383","857","671","186","86","943","1451","0","64.99","46.24"
"64","000","00","029","2905","0000","575","426","149","27","602","1144","0","52.62","37.24"
"64","000","00","029","2905","0384","575","426","149","27","602","1144","0","52.62","37.24"
"64","000","00","029","2906","0000","852","672","180","119","971","1827","0","53.15","36.78"
"64","000","00","029","2906","0389","490","403","87","82","572","1112","0","51.44","36.24"
"64","000","00","029","2906","0390","362","269","93","37","399","715","0","55.8","37.62"
"64","000","00","029","2907","0000","1136","971","165","205","1341","2072","0","64.72","46.86"
"64","000","00","029","2907","0394","591","538","53","104","695","1052","0","66.06","51.14"
"64","000","00","029","2907","0395","545","433","112","101","646","1020","0","63.33","42.45"
"64","000","00","029","2908","0000","1414","1106","308","83","1497","2855","0","52.43","38.74"
"64","000","00","029","2908","0396","608","471","137","37","645","1260","0","51.19","37.38"
"64","000","00","029","2908","0397","806","635","171","46","852","1595","0","53.42","39.81"
"64","000","00","029","2909","0000","1225","980","245","65","1290","2361","0","54.64","41.51"
"64","000","00","029","2909","0398","460","364","96","35","495","829","0","59.71","43.91"
"64","000","00","029","2909","0399","765","616","149","30","795","1532","0","51.89","40.21"
"64","000","00","029","2910","0000","461","353","108","14","475","975","0","48.72","36.21"
"64","000","00","029","2910","0385","461","353","108","14","475","975","0","48.72","36.21"
"64","000","00","029","2911","0000","1946","1519","427","160","2106","3608","0","58.37","42.1"
"64","000","00","029","2911","0386","686","538","148","48","734","1317","0","55.73","40.85"
"64","000","00","029","2911","0387","676","522","154","77","753","1218","0","61.82","42.86"
"64","000","00","029","2911","0388","584","459","125","35","619","1073","0","57.69","42.78"
"64","000","00","029","2912","0000","1114","965","149","86","1200","2250","0","53.33","42.89"
"64","000","00","029","2912","0391","640","602","38","54","694","1311","0","52.94","45.92"
"64","000","00","029","2912","0392","474","363","111","32","506","939","0","53.89","38.66"
"64","000","00","029","2913","0000","478","377","101","37","515","824","0","62.5","45.75"
"64","000","00","029","2913","0393","478","377","101","37","515","824","0","62.5","45.75"
"64","000","00","029","2914","0000","1313","1018","295","153","1466","2338","0","62.7","43.54"
"64","000","00","029","2914","0400","685","527","158","74","759","1195","0","63.51","44.1"
"64","000","00","029","2914","0401","628","491","137","79","707","1143","0","61.85","42.96"
"64","000","00","029","2915","0000","1434","1150","284","103","1537","2918","0","52.67","39.41"
"64","000","00","029","2915","0402","673","523","150","61","734","1186","0","61.89","44.1"
"64","000","00","029","2915","0403","761","627","134","42","803","1732","0","46.36","36.2"
"64","000","00","030","0000","0000","16110","12737","3373","1400","17510","31996","36695","54.73","39.81"
"64","000","00","030","3001","0000","1123","921","202","100","1223","2185","0","55.97","42.15"
"64","000","00","030","3001","0060","581","487","94","52","633","1060","0","59.72","45.94"
"64","000","00","030","3001","0061","542","434","108","48","590","1125","0","52.44","38.58"
"64","000","00","030","3002","0000","1308","1059","249","49","1357","2338","0","58.04","45.3"
"64","000","00","030","3002","0062","619","507","112","26","645","1100","0","58.64","46.09"
"64","000","00","030","3002","0063","689","552","137","23","712","1238","0","57.51","44.59"
"64","000","00","030","3003","0000","827","674","153","39","866","1660","0","52.17","40.6"
"64","000","00","030","3003","0064","499","413","86","23","522","933","0","55.95","44.27"
"64","000","00","030","3003","0065","328","261","67","16","344","727","0","47.32","35.9"
"64","000","00","030","3004","0000","896","723","173","81","977","1815","0","53.83","39.83"
"64","000","00","030","3004","0066","544","439","105","51","595","1071","0","55.56","40.99"
"64","000","00","030","3004","0067","352","284","68","30","382","744","0","51.34","38.17"
"64","000","00","030","3005","0000","663","515","148","44","707","1469","0","48.13","35.06"
"64","000","00","030","3005","0068","485","375","110","29","514","1100","0","46.73","34.09"
"64","000","00","030","3005","0069","178","140","38","15","193","369","0","52.3","37.94"
"64","000","00","030","3006","0000","558","423","135","17","575","1398","0","41.13","30.26"
"64","000","00","030","3006","0070","363","278","85","10","373","888","0","42.0","31.31"
"64","000","00","030","3006","0071","195","145","50","7","202","510","0","39.61","28.43"
"64","000","00","030","3007","0000","561","422","139","84","645","1042","0","61.9","40.5"
"64","000","00","030","3007","0072","561","422","139","84","645","1042","0","61.9","40.5"
"64","000","00","030","3008","0000","389","307","82","45","434","791","0","54.87","38.81"
"64","000","00","030","3008","0073","389","307","82","45","434","791","0","54.87","38.81"
"64","000","00","030","3009","0000","1052","814","238","108","1160","2157","0","53.78","37.74"
"64","000","00","030","3009","0074","490","381","109","73","563","939","0","59.96","40.58"
"64","000","00","030","3009","0075","562","433","129","35","597","1218","0","49.01","35.55"
"64","000","00","030","3010","0000","73","51","22","22","95","178","0","53.37","28.65"
"64","000","00","030","3010","0076","73","51","22","22","95","178","0","53.37","28.65"
"64","000","00","030","3011","0000","1036","788","248","88","1124","1971","0","57.03","39.98"
"64","000","00","030","3011","0077","532","416","116","56","588","946","0","62.16","43.97"
"64","000","00","030","3011","0078","504","372","132","32","536","1025","0","52.29","36.29"
"64","000","00","030","3012","0000","552","453","99","74","626","1040","0","60.19","43.56"
"64","000","00","030","3012","0079","552","453","99","74","626","1040","0","60.19","43.56"
"64","000","00","030","3013","0000","835","645","190","70","905","1563","0","57.9","41.27"
"64","000","00","030","3013","0080","524","400","124","50","574","900","0","63.78","44.44"
"64","000","00","030","3013","0081","311","245","66","20","331","663","0","49.92","36.95"
"64","000","00","030","3014","0000","986","791","195","93","1079","2014","0","53.57","39.28"
"64","000","00","030","3014","0082","472","382","90","58","530","954","0","55.56","40.04"
"64","000","00","030","3014","0083","514","409","105","35","549","1060","0","51.79","38.58"
"64","000","00","030","3015","0000","1779","1408","371","134","1913","3323","0","57.57","42.37"
"64","000","00","030","3015","0084","609","480","129","53","662","1110","0","59.64","43.24"
"64","000","00","030","3015","0085","584","455","129","45","629","1062","0","59.23","42.84"
"64","000","00","030","3015","0086","586","473","113","36","622","1151","0","54.04","41.09"
"64","000","00","030","3016","0000","1086","821","265","91","1177","2206","0","53.35","37.22"
"64","000","00","030","3016","0087","137","102","35","27","164","266","0","61.65","38.35"
"64","000","00","030","3016","0088","356","265","91","34","390","633","0","61.61","41.86"
"64","000","00","030","3016","0089","593","454","139","30","623","1307","0","47.67","34.74"
"64","000","00","030","3017","0000","362","257","105","63","425","754","0","56.37","34.08"
"64","000","00","030","3017","0090","362","257","105","63","425","754","0","56.37","34.08"
"64","000","00","030","3018","0000","638","588","50","99","737","1296","0","56.87","45.37"
"64","000","00","030","3018","0091","638","588","50","99","737","1296","0","56.87","45.37"
"64","000","00","030","3019","0000","347","270","77","19","366","839","0","43.62","32.18"
"64","000","00","030","3019","0092","347","270","77","19","366","839","0","43.62","32.18"
"64","000","00","030","3020","0000","698","535","163","51","749","1329","0","56.36","40.26"
"64","000","00","030","3020","0093","698","535","163","51","749","1329","0","56.36","40.26"
"64","000","00","030","3021","0000","341","272","69","29","370","628","0","58.92","43.31"
"64","000","00","030","3021","0094","341","272","69","29","370","628","0","58.92","43.31"
"64","000","00","031","0000","0000","17464","13876","3588","1617","19081","35311","39630","54.04","39.3"
"64","000","00","031","3101","0000","1284","1004","280","95","1379","2613","0","52.77","38.42"
"64","000","00","031","3101","0095","619","485","134","69","688","1175","0","58.55","41.28"
"64","000","00","031","3101","0096","665","519","146","26","691","1438","0","48.05","36.09"
"64","000","00","031","3102","0000","1119","880","239","109","1228","2416","0","50.83","36.42"
"64","000","00","031","3102","0097","363","285","78","43","406","989","0","41.05","28.82"
"64","000","00","031","3102","0098","756","595","161","66","822","1427","0","57.6","41.7"
"64","000","00","031","3103","0000","1350","1081","269","154","1504","2572","0","58.48","42.03"
"64","000","00","031","3103","0099","678","547","131","61","739","1309","0","56.46","41.79"
"64","000","00","031","3103","0100","672","534","138","93","765","1263","0","60.57","42.28"
"64","000","00","031","3104","0000","1119","920","199","99","1218","2061","0","59.1","44.64"
"64","000","00","031","3104","0101","548","450","98","53","601","997","0","60.28","45.14"
"64","000","00","031","3104","0102","571","470","101","46","617","1064","0","57.99","44.17"
"64","000","00","031","3105","0000","740","598","142","70","810","1498","0","54.07","39.92"
"64","000","00","031","3105","0103","740","598","142","70","810","1498","0","54.07","39.92"
"64","000","00","031","3106","0000","1130","920","210","128","1258","2150","0","58.51","42.79"
"64","000","00","031","3106","0104","589","484","105","67","656","1119","0","58.62","43.25"
"64","000","00","031","3106","0105","541","436","105","61","602","1031","0","58.39","42.29"
"64","000","00","031","3107","0000","1256","993","263","126","1382","2508","0","55.1","39.59"
"64","000","00","031","3107","0106","701","555","146","73","774","1437","0","53.86","38.62"
"64","000","00","031","3107","0107","555","438","117","53","608","1071","0","56.77","40.9"
"64","000","00","031","3108","0000","650","524","126","52","702","1462","0","48.02","35.84"
"64","000","00","031","3108","0108","346","283","63","35","381","687","0","55.46","41.19"
"64","000","00","031","3108","0109","304","241","63","17","321","775","0","41.42","31.1"
"64","000","00","031","3109","0000","628","471","157","66","694","1353","0","51.29","34.81"
"64","000","00","031","3109","0110","628","471","157","66","694","1353","0","51.29","34.81"
"64","000","00","031","3110","0000","533","423","110","50","583","1191","0","48.95","35.52"
"64","000","00","031","3110","0111","533","423","110","50","583","1191","0","48.95","35.52"
"64","000","00","031","3111","0000","1051","845","206","68","1119","2084","0","53.69","40.55"
"64","000","00","031","3111","0112","395","311","84","33","428","906","0","47.24","34.33"
"64","000","00","031","3111","0113","656","534","122","35","691","1178","0","58.66","45.33"
"64","000","00","031","3112","0000","559","455","104","27","586","1252","0","46.81","36.34"
"64","000","00","031","3112","0114","559","455","104","27","586","1252","0","46.81","36.34"
"64","000","00","031","3113","0000","819","656","163","52","871","1549","0","56.23","42.35"
"64","000","00","031","3113","0115","819","656","163","52","871","1549","0","56.23","42.35"
"64","000","00","031","3114","0000","1096","882","214","88","1184","2204","0","53.72","40.02"
"64","000","00","031","3114","0116","505","419","86","44","549","1088","0","50.46","38.51"
"64","000","00","031","3114","0117","591","463","128","44","635","1116","0","56.9","41.49"
"64","000","00","031","3115","0000","947","732","215","90","1037","1793","0","57.84","40.83"
"64","000","00","031","3115","0118","497","382","115","30","527","977","0","53.94","39.1"
"64","000","00","031","3115","0119","450","350","100","60","510","816","0","62.5","42.89"
"64","000","00","031","3116","0000","895","735","160","84","979","1898","0","51.58","38.72"
"64","000","00","031","3116","0120","402","341","61","28","430","955","0","45.03","35.71"
"64","000","00","031","3116","0121","493","394","99","56","549","943","0","58.22","41.78"
"64","000","00","031","3117","0000","661","519","142","39","700","1371","0","51.06","37.86"
"64","000","00","031","3117","0122","661","519","142","39","700","1371","0","51.06","37.86"
"64","000","00","031","3118","0000","966","721","245","108","1074","1834","0","58.56","39.31"
"64","000","00","031","3118","0123","450","331","119","62","512","919","0","55.71","36.02"
"64","000","00","031","3118","0124","516","390","126","46","562","915","0","61.42","42.62"
"64","000","00","031","3119","0000","661","517","144","112","773","1502","0","51.46","34.42"
"64","000","00","031","3119","0125","398","316","82","58","456","828","0","55.07","38.16"
"64","000","00","031","3119","0126","263","201","62","54","317","674","0","47.03","29.82"
"64","000","00","032","0000","0000","4767","3692","1075","621","5388","11501","12984","46.85","32.1"
"64","000","00","032","3201","0000","343","250","93","28","371","760","0","48.82","32.89"
"64","000","00","032","3201","0020","343","250","93","28","371","760","0","48.82","32.89"
"64","000","00","032","3202","0000","276","203","73","31","307","666","0","46.1","30.48"
"64","000","00","032","3202","0021","276","203","73","31","307","666","0","46.1","30.48"
"64","000","00","032","3203","0000","357","279","78","42","399","704","0","56.68","39.63"
"64","000","00","032","3203","0022","357","279","78","42","399","704","0","56.68","39.63"
"64","000","00","032","3204","0000","458","354","104","51","509","1003","0","50.75","35.29"
"64","000","00","032","3204","0023","458","354","104","51","509","1003","0","50.75","35.29"
"64","000","00","032","3205","0000","556","447","109","97","653","1382","0","47.25","32.34"
"64","000","00","032","3205","0024","556","447","109","97","653","1382","0","47.25","32.34"
"64","000","00","032","3206","0000","354","277","77","68","422","986","0","42.8","28.09"
"64","000","00","032","3206","0025","354","277","77","68","422","986","0","42.8","28.09"
"64","000","00","032","3207","0000","480","371","109","45","525","1046","0","50.19","35.47"
"64","000","00","032","3207","0026","480","371","109","45","525","1046","0","50.19","35.47"
"64","000","00","032","3208","0000","329","248","81","53","382","812","0","47.04","30.54"
"64","000","00","032","3208","0027","329","248","81","53","382","812","0","47.04","30.54"
"64","000","00","032","3209","0000","595","465","130","70","665","1431","0","46.47","32.49"
"64","000","00","032","3209","0028","595","465","130","70","665","1431","0","46.47","32.49"
"64","000","00","032","3210","0000","408","342","66","69","477","912","0","52.3","37.5"
"64","000","00","032","3210","0029","408","342","66","69","477","912","0","52.3","37.5"
"64","000","00","032","3211","0000","491","364","127","44","535","1472","0","36.35","24.73"
"64","000","00","032","3211","0030","491","364","127","44","535","1472","0","36.35","24.73"
"64","000","00","032","3212","0000","120","92","28","23","143","327","0","43.73","28.13"
"64","000","00","032","3212","0031","120","92","28","23","143","327","0","43.73","28.13"
"64","000","00","033","0000","0000","2337","1893","444","260","2597","5417","6051","47.94","34.95"
"64","000","00","033","3301","0000","154","124","30","7","161","472","0","34.11","26.27"
"64","000","00","033","3301","0013","154","124","30","7","161","472","0","34.11","26.27"
"64","000","00","033","3302","0000","504","411","93","50","554","882","0","62.81","46.6"
"64","000","00","033","3302","0014","504","411","93","50","554","882","0","62.81","46.6"
"64","000","00","033","3303","0000","316","259","57","38","354","668","0","52.99","38.77"
"64","000","00","033","3303","0015","316","259","57","38","354","668","0","52.99","38.77"
"64","000","00","033","3304","0000","683","537","146","111","794","1581","0","50.22","33.97"
"64","000","00","033","3304","0016","683","537","146","111","794","1581","0","50.22","33.97"
"64","000","00","033","3305","0000","205","169","36","8","213","673","0","31.65","25.11"
"64","000","00","033","3305","0017","205","169","36","8","213","673","0","31.65","25.11"
"64","000","00","033","3306","0000","244","203","41","34","278","607","0","45.8","33.44"
"64","000","00","033","3306","0018","244","203","41","34","278","607","0","45.8","33.44"
"64","000","00","033","3307","0000","231","190","41","12","243","534","0","45.51","35.58"
"64","000","00","033","3307","0019","231","190","41","12","243","534","0","45.51","35.58"
"64","000","00","034","0000","0000","4282","3301","981","451","4733","10607","11828","44.62","31.12"
"64","000","00","034","3401","0000","272","211","61","44","316","640","0","49.38","32.97"
"64","000","00","034","3401","0032","272","211","61","44","316","640","0","49.38","32.97"
"64","000","00","034","3402","0000","270","215","55","24","294","696","0","42.24","30.89"
"64","000","00","034","3402","0033","270","215","55","24","294","696","0","42.24","30.89"
"64","000","00","034","3403","0000","409","302","107","38","447","1284","0","34.81","23.52"
"64","000","00","034","3403","0034","409","302","107","38","447","1284","0","34.81","23.52"
"64","000","00","034","3404","0000","584","457","127","82","666","1509","0","44.14","30.28"
"64","000","00","034","3404","0035","379","289","90","57","436","1027","0","42.45","28.14"
"64","000","00","034","3404","0036","205","168","37","25","230","482","0","47.72","34.85"
"64","000","00","034","3405","0000","788","602","186","113","901","1627","0","55.38","37.0"
"64","000","00","034","3405","0037","788","602","186","113","901","1627","0","55.38","37.0"
"64","000","00","034","3406","0000","678","543","135","32","710","1630","0","43.56","33.31"
"64","000","00","034","3406","0038","678","543","135","32","710","1630","0","43.56","33.31"
"64","000","00","034","3407","0000","589","445","144","74","663","1261","0","52.58","35.29"
"64","000","00","034","3407","0041","589","445","144","74","663","1261","0","52.58","35.29"
"64","000","00","034","3408","0000","692","526","166","44","736","1960","0","37.55","26.84"
"64","000","00","034","3408","0039","327","242","85","20","347","973","0","35.66","24.87"
"64","000","00","034","3408","0040","365","284","81","24","389","987","0","39.41","28.77"
"64","000","00","035","0000","0000","5414","4181","1233","697","6111","13002","14465","47.0","32.16"
"64","000","00","035","3501","0000","385","303","82","55","440","969","0","45.41","31.27"
"64","000","00","035","3501","0042","385","303","82","55","440","969","0","45.41","31.27"
"64","000","00","035","3502","0000","230","187","43","17","247","652","0","37.88","28.68"
"64","000","00","035","3502","0043","230","187","43","17","247","652","0","37.88","28.68"
"64","000","00","035","3503","0000","429","314","115","83","512","961","0","53.28","32.67"
"64","000","00","035","3503","0044","429","314","115","83","512","961","0","53.28","32.67"
"64","000","00","035","3504","0000","156","138","18","6","162","426","0","38.03","32.39"
"64","000","00","035","3504","0045","156","138","18","6","162","426","0","38.03","32.39"
"64","000","00","035","3505","0000","164","135","29","16","180","398","0","45.23","33.92"
"64","000","00","035","3505","0046","164","135","29","16","180","398","0","45.23","33.92"
"64","000","00","035","3506","0000","203","165","38","16","219","508","0","43.11","32.48"
"64","000","00","035","3506","0047","203","165","38","16","219","508","0","43.11","32.48"
"64","000","00","035","3507","0000","494","399","95","78","572","980","0","58.37","40.71"
"64","000","00","035","3507","0048","494","399","95","78","572","980","0","58.37","40.71"
"64","000","00","035","3508","0000","488","371","117","45","533","1225","0","43.51","30.29"
"64","000","00","035","3508","0049","488","371","117","45","533","1225","0","43.51","30.29"
"64","000","00","035","3509","0000","806","608","198","140","946","1722","0","54.94","35.31"
"64","000","00","035","3509","0050","806","608","198","140","946","1722","0","54.94","35.31"
"64","000","00","035","3510","0000","245","172","73","30","275","560","0","49.11","30.71"
"64","000","00","035","3510","0051","245","172","73","30","275","560","0","49.11","30.71"
"64","000","00","035","3511","0000","289","227","62","21","310","801","0","38.7","28.34"
"64","000","00","035","3511","0052","289","227","62","21","310","801","0","38.7","28.34"
"64","000","00","035","3512","0000","196","149","47","19","215","423","0","50.83","35.22"
"64","000","00","035","3512","0053","196","149","47","19","215","423","0","50.83","35.22"
"64","000","00","035","3513","0000","203","151","52","33","236","497","0","47.48","30.38"
"64","000","00","035","3513","0054","203","151","52","33","236","497","0","47.48","30.38"
"64","000","00","035","3514","0000","284","211","73","32","316","677","0","46.68","31.17"
"64","000","00","035","3514","0055","284","211","73","32","316","677","0","46.68","31.17"
"64","000","00","035","3515","0000","186","150","36","10","196","593","0","33.05","25.3"
"64","000","00","035","3515","0056","186","150","36","10","196","593","0","33.05","25.3"
"64","000","00","035","3516","0000","203","151","52","45","248","597","0","41.54","25.29"
"64","000","00","035","3516","0057","203","151","52","45","248","597","0","41.54","25.29"
"64","000","00","035","3517","0000","129","106","23","9","138","343","0","40.23","30.9"
"64","000","00","035","3517","0058","129","106","23","9","138","343","0","40.23","30.9"
"64","000","00","035","3518","0000","324","244","80","42","366","670","0","54.63","36.42"
"64","000","00","035","3518","0059","324","244","80","42","366","670","0","54.63","36.42"
"64","000","00","036","0000","0000","975","809","166","79","1054","1615","1999","65.26","50.09"
"64","000","00","036","3601","0000","412","344","68","28","440","726","0","60.61","47.38"
"64","000","00","036","3601","0129","412","344","68","28","440","726","0","60.61","47.38"
"64","000","00","036","3602","0000","239","200","39","19","258","382","0","67.54","52.36"
"64","000","00","036","3602","0128","239","200","39","19","258","382","0","67.54","52.36"
"64","000","00","036","3603","0000","324","265","59","32","356","507","0","70.22","52.27"
"64","000","00","036","3603","0127","324","265","59","32","356","507","0","70.22","52.27"
"64","000","00","037","0000","0000","1644","1339","305","99","1743","3498","4310","49.83","38.28"
"64","000","00","037","3701","0000","298","243","55","12","310","783","0","39.59","31.03"
"64","000","00","037","3701","0005","298","243","55","12","310","783","0","39.59","31.03"
"64","000","00","037","3702","0000","227","182","45","21","248","472","0","52.54","38.56"
"64","000","00","037","3702","0008","227","182","45","21","248","472","0","52.54","38.56"
"64","000","00","037","3703","0000","383","319","64","32","415","612","0","67.81","52.12"
"64","000","00","037","3703","0007","383","319","64","32","415","612","0","67.81","52.12"
"64","000","00","037","3704","0000","232","197","35","8","240","632","0","37.97","31.17"
"64","000","00","037","3704","0006","232","197","35","8","240","632","0","37.97","31.17"
"64","000","00","037","3705","0000","106","73","33","3","109","223","0","48.88","32.74"
"64","000","00","037","3705","0004","106","73","33","3","109","223","0","48.88","32.74"
"64","000","00","037","3706","0000","167","143","24","7","174","279","0","62.37","51.25"
"64","000","00","037","3706","0003","167","143","24","7","174","279","0","62.37","51.25"
"64","000","00","037","3707","0000","155","122","33","16","171","233","0","73.39","52.36"
"64","000","00","037","3707","0002","155","122","33","16","171","233","0","73.39","52.36"
"64","000","00","037","3708","0000","76","60","16","0","76","264","0","28.79","22.73"
"64","000","00","037","3708","0001","76","60","16","0","76","264","0","28.79","22.73"
"64","000","00","038","0000","0000","1233","979","254","144","1377","2424","3143","56.81","40.39"
"64","000","00","038","3801","0000","671","522","149","78","749","1326","0","56.49","39.37"
"64","000","00","038","3801","0009","314","249","65","14","328","741","0","44.26","33.6"
"64","000","00","038","3801","0010","357","273","84","64","421","585","0","71.97","46.67"
"64","000","00","038","3802","0000","404","339","65","60","464","609","0","76.19","55.67"
"64","000","00","038","3802","0011","404","339","65","60","464","609","0","76.19","55.67"
"64","000","00","038","3803","0000","158","118","40","6","164","489","0","33.54","24.13"
"64","000","00","038","3803","0012","158","118","40","6","164","489","0","33.54","24.13"
"10","004","00","000","0000","0000","237046","191602","45444","12685","249731","445051","556307","56.11","43.05"
"10","004","00","001","0000","0000","76095","61066","15029","3506","79601","137129","186411","58.05","44.53"
"10","004","00","001","0101","0000","3417","2791","626","142","3559","5988","0","59.44","46.61"
"10","004","00","001","0101","0041","732","600","132","24","756","1301","0","58.11","46.12"
"10","004","00","001","0101","0042","995","813","182","49","1044","1798","0","58.06","45.22"
"10","004","00","001","0101","0043","814","656","158","34","848","1427","0","59.43","45.97"
"10","004","00","001","0101","0044","876","722","154","35","911","1462","0","62.31","49.38"
"10","004","00","001","0102","0000","5505","4397","1108","151","5656","9417","0","60.06","46.69"
"10","004","00","001","0102","0001","831","677","154","23","854","1319","0","64.75","51.33"
"10","004","00","001","0102","0002","773","604","169","28","801","1321","0","60.64","45.72"
"10","004","00","001","0102","0003","766","602","164","32","798","1272","0","62.74","47.33"
"10","004","00","001","0102","0004","811","672","139","31","842","1467","0","57.4","45.81"
"10","004","00","001","0102","0005","678","530","148","13","691","1226","0","56.36","43.23"
"10","004","00","001","0102","0006","781","617","164","15","796","1412","0","56.37","43.7"
"10","004","00","001","0102","0007","865","695","170","9","874","1400","0","62.43","49.64"
"10","004","00","001","0103","0000","5714","4440","1274","173","5887","10185","0","57.8","43.59"
"10","004","00","001","0103","0008","850","657","193","28","878","1415","0","62.05","46.43"
"10","004","00","001","0103","0009","763","615","148","26","789","1361","0","57.97","45.19"
"10","004","00","001","0103","0010","809","650","159","19","828","1515","0","54.65","42.9"
"10","004","00","001","0103","0011","863","678","185","23","886","1495","0","59.26","45.35"
"10","004","00","001","0103","0012","816","630","186","22","838","1417","0","59.14","44.46"
"10","004","00","001","0103","0013","855","642","213","29","884","1548","0","57.11","41.47"
"10","004","00","001","0103","0014","758","568","190","26","784","1434","0","54.67","39.61"
"10","004","00","001","0104","0000","3781","2998","783","140","3921","6515","0","60.18","46.02"
"10","004","00","001","0104","0015","776","605","171","32","808","1385","0","58.34","43.68"
"10","004","00","001","0104","0016","761","614","147","30","791","1247","0","63.43","49.24"
"10","004","00","001","0104","0017","777","593","184","19","796","1373","0","57.98","43.19"
"10","004","00","001","0104","0018","834","657","177","23","857","1345","0","63.72","48.85"
"10","004","00","001","0104","0019","633","529","104","36","669","1165","0","57.42","45.41"
"10","004","00","001","0105","0000","1429","1132","297","70","1499","2376","0","63.09","47.64"
"10","004","00","001","0105","0020","709","564","145","36","745","1164","0","64.0","48.45"
"10","004","00","001","0105","0021","720","568","152","34","754","1212","0","62.21","46.86"
"10","004","00","001","0106","0000","1603","1258","345","63","1666","3083","0","54.04","40.8"
"10","004","00","001","0106","0022","730","601","129","28","758","1507","0","50.3","39.88"
"10","004","00","001","0106","0023","873","657","216","35","908","1576","0","57.61","41.69"
"10","004","00","001","0107","0000","3306","2687","619","168","3474","6111","0","56.85","43.97"
"10","004","00","001","0107","0056","755","619","136","31","786","1477","0","53.22","41.91"
"10","004","00","001","0107","0057","940","757","183","42","982","1611","0","60.96","46.99"
"10","004","00","001","0107","0058","847","682","165","59","906","1555","0","58.26","43.86"
"10","004","00","001","0107","0059","764","629","135","36","800","1468","0","54.5","42.85"
"10","004","00","001","0108","0000","4930","3989","941","291","5221","8856","0","58.95","45.04"
"10","004","00","001","0108","0060","848","692","156","47","895","1509","0","59.31","45.86"
"10","004","00","001","0108","0061","847","680","167","45","892","1602","0","55.68","42.45"
"10","004","00","001","0108","0062","818","659","159","48","866","1448","0","59.81","45.51"
"10","004","00","001","0108","0063","742","612","130","53","795","1318","0","60.32","46.43"
"10","004","00","001","0108","0064","949","778","171","52","1001","1634","0","61.26","47.61"
"10","004","00","001","0108","0065","726","568","158","46","772","1345","0","57.4","42.23"
"10","004","00","001","0109","0000","2872","2310","562","112","2984","5746","0","51.93","40.2"
"10","004","00","001","0109","0069","827","671","156","26","853","1483","0","57.52","45.25"
"10","004","00","001","0109","0070","712","578","134","37","749","1332","0","56.23","43.39"
"10","004","00","001","0109","0071","734","596","138","28","762","1482","0","51.42","40.22"
"10","004","00","001","0109","0072","599","465","134","21","620","1449","0","42.79","32.09"
"10","004","00","001","0110","0000","2925","2361","564","142","3067","5703","0","53.78","41.4"
"10","004","00","001","0110","0073","694","572","122","22","716","1319","0","54.28","43.37"
"10","004","00","001","0110","0074","692","559","133","32","724","1332","0","54.35","41.97"
"10","004","00","001","0110","0075","708","558","150","42","750","1412","0","53.12","39.52"
"10","004","00","001","0110","0076","831","672","159","46","877","1640","0","53.48","40.98"
"10","004","00","001","0111","0000","3657","2977","680","214","3871","6849","0","56.52","43.47"
"10","004","00","001","0111","0077","713","572","141","43","756","1323","0","57.14","43.24"
"10","004","00","001","0111","0078","804","649","155","47","851","1428","0","59.59","45.45"
"10","004","00","001","0111","0079","852","696","156","46","898","1533","0","58.58","45.4"
"10","004","00","001","0111","0080","670","556","114","27","697","1346","0","51.78","41.31"
"10","004","00","001","0111","0081","618","504","114","51","669","1219","0","54.88","41.35"
"10","004","00","001","0112","0000","2406","1953","453","103","2509","4458","0","56.28","43.81"
"10","004","00","001","0112","0086","783","638","145","46","829","1383","0","59.94","46.13"
"10","004","00","001","0112","0087","864","686","178","32","896","1569","0","57.11","43.72"
"10","004","00","001","0112","0088","759","629","130","25","784","1506","0","52.06","41.77"
"10","004","00","001","0113","0000","1051","845","206","80","1131","1951","0","57.97","43.31"
"10","004","00","001","0113","0089","466","373","93","40","506","877","0","57.7","42.53"
"10","004","00","001","0113","0090","585","472","113","40","625","1074","0","58.19","43.95"
"10","004","00","001","0114","0000","1404","1129","275","91","1495","2425","0","61.65","46.56"
"10","004","00","001","0114","0091","669","537","132","33","702","1089","0","64.46","49.31"
"10","004","00","001","0114","0092","735","592","143","58","793","1336","0","59.36","44.31"
"10","004","00","001","0115","0000","1231","979","252","87","1318","2143","0","61.5","45.68"
"10","004","00","001","0115","0094","575","455","120","51","626","937","0","66.81","48.56"
"10","004","00","001","0115","0095","656","524","132","36","692","1206","0","57.38","43.45"
"10","004","00","001","0116","0000","634","492","142","47","681","1205","0","56.51","40.83"
"10","004","00","001","0116","0096","634","492","142","47","681","1205","0","56.51","40.83"
"10","004","00","001","0117","0000","854","659","195","73","927","1585","0","58.49","41.58"
"10","004","00","001","0117","0098","478","366","112","45","523","917","0","57.03","39.91"
"10","004","00","001","0117","0099","376","293","83","28","404","668","0","60.48","43.86"
"10","004","00","001","0118","0000","976","780","196","70","1046","1914","0","54.65","40.75"
"10","004","00","001","0118","0102","545","435","110","55","600","977","0","61.41","44.52"
"10","004","00","001","0118","0103","431","345","86","15","446","937","0","47.6","36.82"
"10","004","00","001","0119","0000","969","773","196","59","1028","1718","0","59.84","44.99"
"10","004","00","001","0119","0097","969","773","196","59","1028","1718","0","59.84","44.99"
"10","004","00","001","0120","0000","822","656","166","95","917","1606","0","57.1","40.85"
"10","004","00","001","0120","0100","423","340","83","30","453","824","0","54.98","41.26"
"10","004","00","001","0120","0101","399","316","83","65","464","782","0","59.34","40.41"
"10","004","00","001","0121","0000","3541","2837","704","112","3653","6176","0","59.15","45.94"
"10","004","00","001","0121","0030","704","558","146","30","734","1196","0","61.37","46.66"
"10","004","00","001","0121","0031","722","576","146","20","742","1235","0","60.08","46.64"
"10","004","00","001","0121","0032","661","527","134","21","682","1204","0","56.64","43.77"
"10","004","00","001","0121","0033","766","629","137","27","793","1308","0","60.63","48.09"
"10","004","00","001","0121","0034","688","547","141","14","702","1233","0","56.93","44.36"
"10","004","00","001","0122","0000","2987","2448","539","167","3154","5664","0","55.69","43.22"
"10","004","00","001","0122","0082","835","674","161","57","892","1466","0","60.85","45.98"
"10","004","00","001","0122","0083","602","486","116","30","632","1147","0","55.1","42.37"
"10","004","00","001","0122","0084","717","591","126","35","752","1529","0","49.18","38.65"
"10","004","00","001","0122","0085","833","697","136","45","878","1522","0","57.69","45.8"
"10","004","00","001","0123","0000","538","418","120","63","601","1058","0","56.81","39.51"
"10","004","00","001","0123","0093","538","418","120","63","601","1058","0","56.81","39.51"
"10","004","00","001","0124","0000","2266","1821","445","95","2361","3738","0","63.16","48.72"
"10","004","00","001","0124","0049","690","545","145","30","720","1181","0","60.97","46.15"
"10","004","00","001","0124","0050","821","674","147","41","862","1329","0","64.86","50.71"
"10","004","00","001","0124","0051","755","602","153","24","779","1228","0","63.44","49.02"
"10","004","00","001","0125","0000","3247","2571","676","130","3377","5989","0","56.39","42.93"
"10","004","00","001","0125","0052","846","671","175","30","876","1552","0","56.44","43.23"
"10","004","00","001","0125","0053","862","679","183","31","893","1480","0","60.34","45.88"
"10","004","00","001","0125","0054","770","598","172","31","801","1487","0","53.87","40.22"
"10","004","00","001","0125","0055","769","623","146","38","807","1470","0","54.9","42.38"
"10","004","00","001","0126","0000","1886","1528","358","119","2005","3204","0","62.58","47.69"
"10","004","00","001","0126","0066","607","504","103","27","634","958","0","66.18","52.61"
"10","004","00","001","0126","0067","669","548","121","33","702","1112","0","63.13","49.28"
"10","004","00","001","0126","0068","610","476","134","59","669","1134","0","58.99","41.98"
"10","004","00","001","0127","0000","3089","2460","629","124","3213","5749","0","55.89","42.79"
"10","004","00","001","0127","0024","800","644","156","28","828","1464","0","56.56","43.99"
"10","004","00","001","0127","0025","789","638","151","28","817","1428","0","57.21","44.68"
"10","004","00","001","0127","0026","711","532","179","18","729","1442","0","50.55","36.89"
"10","004","00","001","0127","0027","789","646","143","50","839","1415","0","59.29","45.65"
"10","004","00","001","0128","0000","1727","1368","359","58","1785","3417","0","52.24","40.04"
"10","004","00","001","0128","0028","831","669","162","17","848","1666","0","50.9","40.16"
"10","004","00","001","0128","0029","896","699","197","41","937","1751","0","53.51","39.92"
"10","004","00","001","0129","0000","1959","1635","324","83","2042","3312","0","61.65","49.37"
"10","004","00","001","0129","0035","647","525","122","25","672","1129","0","59.52","46.5"
"10","004","00","001","0129","0036","637","543","94","22","659","1069","0","61.65","50.8"
"10","004","00","001","0129","0037","675","567","108","36","711","1114","0","63.82","50.9"
"10","004","00","001","0130","0000","1990","1617","373","82","2072","3265","0","63.46","49.53"
"10","004","00","001","0130","0038","646","530","116","24","670","1103","0","60.74","48.05"
"10","004","00","001","0130","0039","644","532","112","26","670","1029","0","65.11","51.7"
"10","004","00","001","0130","0040","700","555","145","32","732","1133","0","64.61","48.98"
"10","004","00","001","0131","0000","3379","2757","622","102","3481","5723","0","60.82","48.17"
"10","004","00","001","0131","0045","829","672","157","27","856","1342","0","63.79","50.07"
"10","004","00","001","0131","0046","865","722","143","29","894","1480","0","60.41","48.78"
"10","004","00","001","0131","0047","904","735","169","24","928","1645","0","56.41","44.68"
"10","004","00","001","0131","0048","781","628","153","22","803","1256","0","63.93","50.0"
"10","004","00","002","0000","0000","40141","32641","7500","2098","42239","78794","96358","53.61","41.43"
"10","004","00","002","0201","0000","145","121","24","7","152","309","0","49.19","39.16"
"10","004","00","002","0201","0104","145","121","24","7","152","309","0","49.19","39.16"
"10","004","00","002","0202","0000","191","145","46","24","215","416","0","51.68","34.86"
"10","004","00","002","0202","0105","191","145","46","24","215","416","0","51.68","34.86"
"10","004","00","002","0203","0000","188","155","33","4","192","386","0","49.74","40.16"
"10","004","00","002","0203","0106","188","155","33","4","192","386","0","49.74","40.16"
"10","004","00","002","0204","0000","1088","902","186","36","1124","2225","0","50.52","40.54"
"10","004","00","002","0204","0107","446","367","79","21","467","950","0","49.16","38.63"
"10","004","00","002","0204","0108","642","535","107","15","657","1275","0","51.53","41.96"
"10","004","00","002","0205","0000","1722","1441","281","83","1805","3283","0","54.98","43.89"
"10","004","00","002","0205","0116","696","575","121","33","729","1292","0","56.42","44.5"
"10","004","00","002","0205","0117","540","456","84","14","554","1111","0","49.86","41.04"
"10","004","00","002","0205","0118","486","410","76","36","522","880","0","59.32","46.59"
"10","004","00","002","0206","0000","4619","3833","786","238","4857","9177","0","52.93","41.77"
"10","004","00","002","0206","0109","625","509","116","32","657","1213","0","54.16","41.96"
"10","004","00","002","0206","0110","831","697","134","34","865","1548","0","55.88","45.03"
"10","004","00","002","0206","0111","597","510","87","26","623","1246","0","50.0","40.93"
"10","004","00","002","0206","0112","538","444","94","37","575","1252","0","45.93","35.46"
"10","004","00","002","0206","0113","674","573","101","44","718","1359","0","52.83","42.16"
"10","004","00","002","0206","0114","633","502","131","36","669","1255","0","53.31","40.0"
"10","004","00","002","0206","0115","721","598","123","29","750","1304","0","57.52","45.86"
"10","004","00","002","0207","0000","2415","1995","420","136","2551","4569","0","55.83","43.66"
"10","004","00","002","0207","0121","563","462","101","44","607","1126","0","53.91","41.03"
"10","004","00","002","0207","0122","551","456","95","38","589","1073","0","54.89","42.5"
"10","004","00","002","0207","0123","656","516","140","39","695","1215","0","57.2","42.47"
"10","004","00","002","0207","0124","645","561","84","15","660","1155","0","57.14","48.57"
"10","004","00","002","0208","0000","354","286","68","24","378","704","0","53.69","40.63"
"10","004","00","002","0208","0128","354","286","68","24","378","704","0","53.69","40.63"
"10","004","00","002","0209","0000","1349","1105","244","60","1409","3048","0","46.23","36.25"
"10","004","00","002","0209","0129","351","293","58","31","382","951","0","40.17","30.81"
"10","004","00","002","0209","0130","536","432","104","19","555","984","0","56.4","43.9"
"10","004","00","002","0209","0131","462","380","82","10","472","1113","0","42.41","34.14"
"10","004","00","002","0210","0000","764","599","165","60","824","1357","0","60.72","44.14"
"10","004","00","002","0210","0132","336","265","71","20","356","595","0","59.83","44.54"
"10","004","00","002","0210","0133","428","334","94","40","468","762","0","61.42","43.83"
"10","004","00","002","0211","0000","773","599","174","47","820","1400","0","58.57","42.79"
"10","004","00","002","0211","0142","402","315","87","37","439","715","0","61.4","44.06"
"10","004","00","002","0211","0143","371","284","87","10","381","685","0","55.62","41.46"
"10","004","00","002","0212","0000","1873","1517","356","89","1962","3875","0","50.63","39.15"
"10","004","00","002","0212","0136","597","480","117","22","619","1310","0","47.25","36.64"
"10","004","00","002","0212","0137","668","552","116","36","704","1434","0","49.09","38.49"
"10","004","00","002","0212","0138","608","485","123","31","639","1131","0","56.5","42.88"
"10","004","00","002","0213","0000","1705","1391","314","89","1794","3317","0","54.09","41.94"
"10","004","00","002","0213","0139","505","424","81","23","528","967","0","54.6","43.85"
"10","004","00","002","0213","0140","580","455","125","32","612","1196","0","51.17","38.04"
"10","004","00","002","0213","0141","620","512","108","34","654","1154","0","56.67","44.37"
"10","004","00","002","0214","0000","3634","2965","669","144","3778","7555","0","50.01","39.25"
"10","004","00","002","0214","0149","614","503","111","12","626","1248","0","50.16","40.3"
"10","004","00","002","0214","0150","536","434","102","29","565","1263","0","44.73","34.36"
"10","004","00","002","0214","0151","569","466","103","21","590","1232","0","47.89","37.82"
"10","004","00","002","0214","0152","521","421","100","20","541","1143","0","47.33","36.83"
"10","004","00","002","0214","0153","800","658","142","30","830","1529","0","54.28","43.03"
"10","004","00","002","0214","0154","594","483","111","32","626","1140","0","54.91","42.37"
"10","004","00","002","0215","0000","3130","2568","562","203","3333","6204","0","53.72","41.39"
"10","004","00","002","0215","0156","634","519","115","22","656","1345","0","48.77","38.59"
"10","004","00","002","0215","0157","670","536","134","61","731","1381","0","52.93","38.81"
"10","004","00","002","0215","0158","714","603","111","50","764","1379","0","55.4","43.73"
"10","004","00","002","0215","0159","558","455","103","43","601","1033","0","58.18","44.05"
"10","004","00","002","0215","0160","554","455","99","27","581","1066","0","54.5","42.68"
"10","004","00","002","0216","0000","2320","1862","458","112","2432","4350","0","55.91","42.8"
"10","004","00","002","0216","0169","591","472","119","34","625","1083","0","57.71","43.58"
"10","004","00","002","0216","0170","576","461","115","29","605","1102","0","54.9","41.83"
"10","004","00","002","0216","0171","557","454","103","20","577","1068","0","54.03","42.51"
"10","004","00","002","0216","0172","596","475","121","29","625","1097","0","56.97","43.3"
"10","004","00","002","0217","0000","952","758","194","45","997","1871","0","53.29","40.51"
"10","004","00","002","0217","0173","458","375","83","21","479","962","0","49.79","38.98"
"10","004","00","002","0217","0174","494","383","111","24","518","909","0","56.99","42.13"
"10","004","00","002","0218","0000","279","234","45","23","302","603","0","50.08","38.81"
"10","004","00","002","0218","0175","279","234","45","23","302","603","0","50.08","38.81"
"10","004","00","002","0219","0000","5241","4183","1058","286","5527","10396","0","53.16","40.24"
"10","004","00","002","0219","0161","516","416","100","38","554","938","0","59.06","44.35"
"10","004","00","002","0219","0162","546","447","99","40","586","952","0","61.55","46.95"
"10","004","00","002","0219","0163","843","685","158","41","884","1468","0","60.22","46.66"
"10","004","00","002","0219","0164","934","737","197","42","976","1915","0","50.97","38.49"
"10","004","00","002","0219","0165","595","480","115","37","632","1220","0","51.8","39.34"
"10","004","00","002","0219","0166","508","414","94","23","531","1166","0","45.54","35.51"
"10","004","00","002","0219","0167","687","556","131","25","712","1492","0","47.72","37.27"
"10","004","00","002","0219","0168","612","448","164","40","652","1245","0","52.37","35.98"
"10","004","00","002","0220","0000","940","737","203","71","1011","1727","0","58.54","42.68"
"10","004","00","002","0220","0125","445","353","92","40","485","852","0","56.92","41.43"
"10","004","00","002","0220","0126","495","384","111","31","526","875","0","60.11","43.89"
"10","004","00","002","0221","0000","1071","895","176","46","1117","1914","0","58.36","46.76"
"10","004","00","002","0221","0119","376","313","63","16","392","670","0","58.51","46.72"
"10","004","00","002","0221","0120","695","582","113","30","725","1244","0","58.28","46.78"
"10","004","00","002","0222","0000","621","496","125","33","654","1070","0","61.12","46.36"
"10","004","00","002","0222","0127","621","496","125","33","654","1070","0","61.12","46.36"
"10","004","00","002","0223","0000","3608","2957","651","191","3799","6892","0","55.12","42.9"
"10","004","00","002","0223","0144","674","554","120","44","718","1352","0","53.11","40.98"
"10","004","00","002","0223","0145","746","630","116","60","806","1407","0","57.29","44.78"
"10","004","00","002","0223","0146","729","581","148","1","730","1362","0","53.6","42.66"
"10","004","00","002","0223","0147","715","600","115","37","752","1330","0","56.54","45.11"
"10","004","00","002","0223","0148","744","592","152","49","793","1441","0","55.03","41.08"
"10","004","00","002","0224","0000","812","626","186","30","842","1576","0","53.43","39.72"
"10","004","00","002","0224","0134","407","319","88","15","422","763","0","55.31","41.81"
"10","004","00","002","0224","0135","405","307","98","15","420","813","0","51.66","37.76"
"10","004","00","002","0225","0000","347","271","76","17","364","570","0","63.86","47.54"
"10","004","00","002","0225","0155","347","271","76","17","364","570","0","63.86","47.54"
"10","004","00","003","0000","0000","15226","12327","2899","971","16197","28894","33106","56.06","42.66"
"10","004","00","003","0301","0000","611","494","117","45","656","1139","0","57.59","43.37"
"10","004","00","003","0301","0194","611","494","117","45","656","1139","0","57.59","43.37"
"10","004","00","003","0302","0000","466","390","76","15","481","861","0","55.87","45.3"
"10","004","00","003","0302","0195","466","390","76","15","481","861","0","55.87","45.3"
"10","004","00","003","0303","0000","2070","1675","395","121","2191","4271","0","51.3","39.22"
"10","004","00","003","0303","0196","538","439","99","19","557","1093","0","50.96","40.16"
"10","004","00","003","0303","0197","473","371","102","35","508","978","0","51.94","37.93"
"10","004","00","003","0303","0198","480","403","77","26","506","1040","0","48.65","38.75"
"10","004","00","003","0303","0199","579","462","117","41","620","1160","0","53.45","39.83"
"10","004","00","003","0304","0000","1070","874","196","62","1132","1965","0","57.61","44.48"
"10","004","00","003","0304","0184","517","419","98","21","538","948","0","56.75","44.2"
"10","004","00","003","0304","0185","553","455","98","41","594","1017","0","58.41","44.74"
"10","004","00","003","0305","0000","1755","1380","375","110","1865","3320","0","56.17","41.57"
"10","004","00","003","0305","0186","675","548","127","38","713","1176","0","60.63","46.6"
"10","004","00","003","0305","0187","640","487","153","58","698","1122","0","62.21","43.4"
"10","004","00","003","0305","0188","440","345","95","14","454","1022","0","44.42","33.76"
"10","004","00","003","0306","0000","910","760","150","58","968","1829","0","52.93","41.55"
"10","004","00","003","0306","0182","488","404","84","32","520","924","0","56.28","43.72"
"10","004","00","003","0306","0183","422","356","66","26","448","905","0","49.5","39.34"
"10","004","00","003","0307","0000","1433","1176","257","77","1510","2526","0","59.78","46.56"
"10","004","00","003","0307","0179","493","410","83","33","526","935","0","56.26","43.85"
"10","004","00","003","0307","0180","407","326","81","26","433","753","0","57.5","43.29"
"10","004","00","003","0307","0181","533","440","93","18","551","838","0","65.75","52.51"
"10","004","00","003","0308","0000","548","462","86","38","586","983","0","59.61","47.0"
"10","004","00","003","0308","0176","548","462","86","38","586","983","0","59.61","47.0"
"10","004","00","003","0309","0000","342","261","81","27","369","597","0","61.81","43.72"
"10","004","00","003","0309","0177","342","261","81","27","369","597","0","61.81","43.72"
"10","004","00","003","0310","0000","578","478","100","17","595","1070","0","55.61","44.67"
"10","004","00","003","0310","0178","578","478","100","17","595","1070","0","55.61","44.67"
"10","004","00","003","0311","0000","1018","840","178","54","1072","1832","0","58.52","45.85"
"10","004","00","003","0311","0200","548","452","96","27","575","950","0","60.53","47.58"
"10","004","00","003","0311","0201","470","388","82","27","497","882","0","56.35","43.99"
"10","004","00","003","0312","0000","1292","1037","255","97","1389","2493","0","55.72","41.6"
"10","004","00","003","0312","0202","681","530","151","57","738","1281","0","57.61","41.37"
"10","004","00","003","0312","0203","611","507","104","40","651","1212","0","53.71","41.83"
"10","004","00","003","0313","0000","447","362","85","38","485","1013","0","47.88","35.74"
"10","004","00","003","0313","0204","447","362","85","38","485","1013","0","47.88","35.74"
"10","004","00","003","0314","0000","371","305","66","31","402","630","0","63.81","48.41"
"10","004","00","003","0314","0205","371","305","66","31","402","630","0","63.81","48.41"
"10","004","00","003","0315","0000","630","501","129","48","678","1144","0","59.27","43.79"
"10","004","00","003","0315","0193","630","501","129","48","678","1144","0","59.27","43.79"
"10","004","00","003","0316","0000","669","535","134","42","711","1429","0","49.76","37.44"
"10","004","00","003","0316","0189","669","535","134","42","711","1429","0","49.76","37.44"
"10","004","00","003","0317","0000","275","221","54","30","305","451","0","67.63","49.0"
"10","004","00","003","0317","0190","275","221","54","30","305","451","0","67.63","49.0"
"10","004","00","003","0318","0000","379","284","95","31","410","724","0","56.63","39.23"
"10","004","00","003","0318","0191","379","284","95","31","410","724","0","56.63","39.23"
"10","004","00","003","0319","0000","362","292","70","30","392","617","0","63.53","47.33"
"10","004","00","003","0319","0192","362","292","70","30","392","617","0","63.53","47.33"
"10","004","00","004","0000","0000","13165","10714","2451","803","13968","24712","28659","56.52","43.36"
"10","004","00","004","0401","0000","283","248","35","24","307","480","0","63.96","51.67"
"10","004","00","004","0401","0206","283","248","35","24","307","480","0","63.96","51.67"
"10","004","00","004","0402","0000","1072","860","212","63","1135","1923","0","59.02","44.72"
"10","004","00","004","0402","0207","509","407","102","32","541","903","0","59.91","45.07"
"10","004","00","004","0402","0208","563","453","110","31","594","1020","0","58.24","44.41"
"10","004","00","004","0403","0000","360","293","67","17","377","705","0","53.48","41.56"
"10","004","00","004","0403","0209","360","293","67","17","377","705","0","53.48","41.56"
"10","004","00","004","0404","0000","1921","1552","369","110","2031","3618","0","56.14","42.9"
"10","004","00","004","0404","0210","548","438","110","29","577","1056","0","54.64","41.48"
"10","004","00","004","0404","0211","661","532","129","39","700","1275","0","54.9","41.73"
"10","004","00","004","0404","0212","712","582","130","42","754","1287","0","58.59","45.22"
"10","004","00","004","0405","0000","531","427","104","38","569","1046","0","54.4","40.82"
"10","004","00","004","0405","0214","531","427","104","38","569","1046","0","54.4","40.82"
"10","004","00","004","0406","0000","441","361","80","25","466","771","0","60.44","46.82"
"10","004","00","004","0406","0213","441","361","80","25","466","771","0","60.44","46.82"
"10","004","00","004","0407","0000","567","440","127","35","602","1030","0","58.45","42.72"
"10","004","00","004","0407","0215","567","440","127","35","602","1030","0","58.45","42.72"
"10","004","00","004","0408","0000","1822","1511","311","106","1928","3653","0","52.78","41.36"
"10","004","00","004","0408","0216","651","548","103","36","687","1208","0","56.87","45.36"
"10","004","00","004","0408","0217","493","429","64","37","530","1095","0","48.4","39.18"
"10","004","00","004","0408","0218","678","534","144","33","711","1350","0","52.67","39.56"
"10","004","00","004","0409","0000","688","559","129","55","743","1362","0","54.55","41.04"
"10","004","00","004","0409","0220","688","559","129","55","743","1362","0","54.55","41.04"
"10","004","00","004","0410","0000","251","202","49","16","267","551","0","48.46","36.66"
"10","004","00","004","0410","0222","251","202","49","16","267","551","0","48.46","36.66"
"10","004","00","004","0411","0000","291","245","46","28","319","572","0","55.77","42.83"
"10","004","00","004","0411","0224","291","245","46","28","319","572","0","55.77","42.83"
"10","004","00","004","0412","0000","485","377","108","22","507","943","0","53.76","39.98"
"10","004","00","004","0412","0225","485","377","108","22","507","943","0","53.76","39.98"
"10","004","00","004","0413","0000","180","148","32","11","191","461","0","41.43","32.1"
"10","004","00","004","0413","0223","180","148","32","11","191","461","0","41.43","32.1"
"10","004","00","004","0414","0000","434","330","104","35","469","808","0","58.04","40.84"
"10","004","00","004","0414","0226","434","330","104","35","469","808","0","58.04","40.84"
"10","004","00","004","0415","0000","1060","884","176","56","1116","1826","0","61.12","48.41"
"10","004","00","004","0415","0227","561","469","92","21","582","923","0","63.06","50.81"
"10","004","00","004","0415","0228","499","415","84","35","534","903","0","59.14","45.96"
"10","004","00","004","0416","0000","473","372","101","32","505","824","0","61.29","45.15"
"10","004","00","004","0416","0230","473","372","101","32","505","824","0","61.29","45.15"
"10","004","00","004","0417","0000","327","270","57","16","343","559","0","61.36","48.3"
"10","004","00","004","0417","0231","327","270","57","16","343","559","0","61.36","48.3"
"10","004","00","004","0418","0000","507","429","78","27","534","854","0","62.53","50.23"
"10","004","00","004","0418","0232","507","429","78","27","534","854","0","62.53","50.23"
"10","004","00","004","0419","0000","512","427","85","24","536","846","0","63.36","50.47"
"10","004","00","004","0419","0219","512","427","85","24","536","846","0","63.36","50.47"
"10","004","00","004","0420","0000","423","340","83","24","447","903","0","49.5","37.65"
"10","004","00","004","0420","0221","423","340","83","24","447","903","0","49.5","37.65"
"10","004","00","004","0421","0000","537","439","98","39","576","977","0","58.96","44.93"
"10","004","00","004","0421","0229","537","439","98","39","576","977","0","58.96","44.93"
"10","004","00","005","0000","0000","33732","27505","6227","1748","35480","63511","77604","55.86","43.31"
"10","004","00","005","0501","0000","718","577","141","50","768","1272","0","60.38","45.36"
"10","004","00","005","0501","0245","718","577","141","50","768","1272","0","60.38","45.36"
"10","004","00","005","0502","0000","482","387","95","37","519","851","0","60.99","45.48"
"10","004","00","005","0502","0244","482","387","95","37","519","851","0","60.99","45.48"
"10","004","00","005","0503","0000","2214","1818","396","129","2343","3993","0","58.68","45.53"
"10","004","00","005","0503","0241","778","617","161","41","819","1444","0","56.72","42.73"
"10","004","00","005","0503","0242","765","639","126","73","838","1347","0","62.21","47.44"
"10","004","00","005","0503","0243","671","562","109","15","686","1202","0","57.07","46.76"
"10","004","00","005","0504","0000","2859","2343","516","182","3041","5202","0","58.46","45.04"
"10","004","00","005","0504","0250","711","579","132","43","754","1402","0","53.78","41.3"
"10","004","00","005","0504","0251","655","540","115","53","708","1183","0","59.85","45.65"
"10","004","00","005","0504","0252","737","614","123","39","776","1282","0","60.53","47.89"
"10","004","00","005","0504","0253","756","610","146","47","803","1335","0","60.15","45.69"
"10","004","00","005","0505","0000","1610","1293","317","83","1693","2835","0","59.72","45.61"
"10","004","00","005","0505","0246","683","556","127","38","721","1275","0","56.55","43.61"
"10","004","00","005","0505","0247","927","737","190","45","972","1560","0","62.31","47.24"
"10","004","00","005","0506","0000","2523","2047","476","131","2654","4714","0","56.3","43.42"
"10","004","00","005","0506","0238","950","767","183","49","999","1719","0","58.12","44.62"
"10","004","00","005","0506","0239","679","550","129","39","718","1162","0","61.79","47.33"
"10","004","00","005","0506","0240","894","730","164","43","937","1833","0","51.12","39.83"
"10","004","00","005","0507","0000","1511","1188","323","63","1574","2898","0","54.31","40.99"
"10","004","00","005","0507","0233","669","526","143","37","706","1393","0","50.68","37.76"
"10","004","00","005","0507","0234","842","662","180","26","868","1505","0","57.67","43.99"
"10","004","00","005","0508","0000","1533","1282","251","70","1603","3140","0","51.05","40.83"
"10","004","00","005","0508","0258","569","469","100","32","601","1193","0","50.38","39.31"
"10","004","00","005","0508","0259","964","813","151","38","1002","1947","0","51.46","41.76"
"10","004","00","005","0509","0000","630","495","135","48","678","1125","0","60.27","44.0"
"10","004","00","005","0509","0260","630","495","135","48","678","1125","0","60.27","44.0"
"10","004","00","005","0510","0000","1519","1244","275","91","1610","2783","0","57.85","44.7"
"10","004","00","005","0510","0261","566","461","105","45","611","1050","0","58.19","43.9"
"10","004","00","005","0510","0262","953","783","170","46","999","1733","0","57.65","45.18"
"10","004","00","005","0511","0000","1329","1112","217","61","1390","2346","0","59.25","47.4"
"10","004","00","005","0511","0263","724","597","127","35","759","1284","0","59.11","46.5"
"10","004","00","005","0511","0264","605","515","90","26","631","1062","0","59.42","48.49"
"10","004","00","005","0512","0000","815","689","126","48","863","1547","0","55.79","44.54"
"10","004","00","005","0512","0265","815","689","126","48","863","1547","0","55.79","44.54"
"10","004","00","005","0513","0000","1284","1018","266","74","1358","2197","0","61.81","46.34"
"10","004","00","005","0513","0256","640","526","114","32","672","1082","0","62.11","48.61"
"10","004","00","005","0513","0257","644","492","152","42","686","1115","0","61.52","44.13"
"10","004","00","005","0514","0000","2483","2033","450","136","2619","5072","0","51.64","40.08"
"10","004","00","005","0514","0270","571","463","108","30","601","1058","0","56.81","43.76"
"10","004","00","005","0514","0271","482","406","76","24","506","1220","0","41.48","33.28"
"10","004","00","005","0514","0272","713","571","142","33","746","1333","0","55.96","42.84"
"10","004","00","005","0514","0273","717","593","124","49","766","1461","0","52.43","40.59"
"10","004","00","005","0515","0000","1629","1307","322","90","1719","3233","0","53.17","40.43"
"10","004","00","005","0515","0277","706","541","165","35","741","1495","0","49.57","36.19"
"10","004","00","005","0515","0278","404","337","67","30","434","752","0","57.71","44.81"
"10","004","00","005","0515","0279","519","429","90","25","544","986","0","55.17","43.51"
"10","004","00","005","0516","0000","2787","2322","465","100","2887","5896","0","48.97","39.38"
"10","004","00","005","0516","0266","701","570","131","36","737","1494","0","49.33","38.15"
"10","004","00","005","0516","0267","765","640","125","24","789","1634","0","48.29","39.17"
"10","004","00","005","0516","0268","649","564","85","18","667","1444","0","46.19","39.06"
"10","004","00","005","0516","0269","672","548","124","22","694","1324","0","52.42","41.39"
"10","004","00","005","0517","0000","1859","1526","333","56","1915","3370","0","56.82","45.28"
"10","004","00","005","0517","0254","887","717","170","40","927","1493","0","62.09","48.02"
"10","004","00","005","0517","0255","972","809","163","16","988","1877","0","52.64","43.1"
"10","004","00","005","0518","0000","1588","1294","294","120","1708","2876","0","59.39","44.99"
"10","004","00","005","0518","0248","660","521","139","72","732","1147","0","63.82","45.42"
"10","004","00","005","0518","0249","928","773","155","48","976","1729","0","56.45","44.71"
"10","004","00","005","0519","0000","2312","1844","468","105","2417","4123","0","58.62","44.72"
"10","004","00","005","0519","0235","735","574","161","25","760","1188","0","63.97","48.32"
"10","004","00","005","0519","0236","680","539","141","46","726","1267","0","57.3","42.54"
"10","004","00","005","0519","0237","897","731","166","34","931","1668","0","55.82","43.82"
"10","004","00","005","0520","0000","2047","1686","361","74","2121","4038","0","52.53","41.75"
"10","004","00","005","0520","0274","725","581","144","21","746","1429","0","52.2","40.66"
"10","004","00","005","0520","0275","687","570","117","18","705","1506","0","46.81","37.85"
"10","004","00","005","0520","0276","635","535","100","35","670","1103","0","60.74","48.5"
"10","004","00","006","0000","0000","24111","19499","4612","1385","25496","45790","56957","55.68","42.58"
"10","004","00","006","0601","0000","526","419","107","51","577","1080","0","53.43","38.8"
"10","004","00","006","0601","0280","526","419","107","51","577","1080","0","53.43","38.8"
"10","004","00","006","0602","0000","896","715","181","52","948","1799","0","52.7","39.74"
"10","004","00","006","0602","0288","429","331","98","30","459","824","0","55.7","40.17"
"10","004","00","006","0602","0289","467","384","83","22","489","975","0","50.15","39.38"
"10","004","00","006","0603","0000","950","728","222","53","1003","1841","0","54.48","39.54"
"10","004","00","006","0603","0281","444","329","115","24","468","887","0","52.76","37.09"
"10","004","00","006","0603","0282","506","399","107","29","535","954","0","56.08","41.82"
"10","004","00","006","0604","0000","1365","1049","316","129","1494","2743","0","54.47","38.24"
"10","004","00","006","0604","0291","754","598","156","79","833","1477","0","56.4","40.49"
"10","004","00","006","0604","0292","611","451","160","50","661","1266","0","52.21","35.62"
"10","004","00","006","0605","0000","899","719","180","63","962","1765","0","54.5","40.74"
"10","004","00","006","0605","0286","483","385","98","39","522","891","0","58.59","43.21"
"10","004","00","006","0605","0287","416","334","82","24","440","874","0","50.34","38.22"
"10","004","00","006","0606","0000","429","349","80","48","477","847","0","56.32","41.2"
"10","004","00","006","0606","0290","429","349","80","48","477","847","0","56.32","41.2"
"10","004","00","006","0607","0000","1719","1386","333","92","1811","3232","0","56.03","42.88"
"10","004","00","006","0607","0283","522","422","100","26","548","1003","0","54.64","42.07"
"10","004","00","006","0607","0284","570","467","103","34","604","1106","0","54.61","42.22"
"10","004","00","006","0607","0285","627","497","130","32","659","1123","0","58.68","44.26"
"10","004","00","006","0608","0000","2707","2185","522","194","2901","5237","0","55.39","41.72"
"10","004","00","006","0608","0305","733","608","125","53","786","1302","0","60.37","46.7"
"10","004","00","006","0608","0306","728","570","158","60","788","1410","0","55.89","40.43"
"10","004","00","006","0608","0307","655","523","132","40","695","1267","0","54.85","41.28"
"10","004","00","006","0608","0308","591","484","107","41","632","1258","0","50.24","38.47"
"10","004","00","006","0609","0000","1019","781","238","115","1134","2092","0","54.21","37.33"
"10","004","00","006","0609","0293","493","390","103","66","559","1029","0","54.32","37.9"
"10","004","00","006","0609","0294","526","391","135","49","575","1063","0","54.09","36.78"
"10","004","00","006","0610","0000","1347","1138","209","46","1393","2500","0","55.72","45.52"
"10","004","00","006","0610","0295","559","455","104","27","586","1055","0","55.55","43.13"
"10","004","00","006","0610","0296","788","683","105","19","807","1445","0","55.85","47.27"
"10","004","00","006","0611","0000","2413","1998","415","95","2508","4382","0","57.23","45.6"
"10","004","00","006","0611","0311","649","541","108","31","680","1157","0","58.77","46.76"
"10","004","00","006","0611","0312","543","442","101","29","572","1089","0","52.53","40.59"
"10","004","00","006","0611","0313","632","522","110","16","648","1160","0","55.86","45.0"
"10","004","00","006","0611","0314","589","493","96","19","608","976","0","62.3","50.51"
"10","004","00","006","0612","0000","761","595","166","12","773","1486","0","52.02","40.04"
"10","004","00","006","0612","0303","761","595","166","12","773","1486","0","52.02","40.04"
"10","004","00","006","0613","0000","609","490","119","58","667","1067","0","62.51","45.92"
"10","004","00","006","0613","0304","609","490","119","58","667","1067","0","62.51","45.92"
"10","004","00","006","0614","0000","2044","1701","343","87","2131","3519","0","60.56","48.34"
"10","004","00","006","0614","0297","834","692","142","31","865","1413","0","61.22","48.97"
"10","004","00","006","0614","0298","588","473","115","30","618","971","0","63.65","48.71"
"10","004","00","006","0614","0299","622","536","86","26","648","1135","0","57.09","47.22"
"10","004","00","006","0615","0000","2251","1829","422","111","2362","4188","0","56.4","43.67"
"10","004","00","006","0615","0300","643","514","129","37","680","1269","0","53.59","40.5"
"10","004","00","006","0615","0301","678","540","138","32","710","1257","0","56.48","42.96"
"10","004","00","006","0615","0302","930","775","155","42","972","1662","0","58.48","46.63"
"10","004","00","006","0616","0000","2837","2336","501","123","2960","5339","0","55.44","43.75"
"10","004","00","006","0616","0315","772","634","138","38","810","1443","0","56.13","43.94"
"10","004","00","006","0616","0316","604","479","125","21","625","1247","0","50.12","38.41"
"10","004","00","006","0616","0317","766","638","128","23","789","1411","0","55.92","45.22"
"10","004","00","006","0616","0318","695","585","110","41","736","1238","0","59.45","47.25"
"10","004","00","006","0617","0000","1339","1081","258","56","1395","2673","0","52.19","40.44"
"10","004","00","006","0617","0309","573","467","106","20","593","1217","0","48.73","38.37"
"10","004","00","006","0617","0310","766","614","152","36","802","1456","0","55.08","42.17"
"10","004","00","007","0000","0000","9526","7631","1895","592","10118","17293","20043","58.51","44.13"
"10","004","00","007","0701","0000","350","275","75","22","372","534","0","69.66","51.5"
"10","004","00","007","0701","0320","350","275","75","22","372","534","0","69.66","51.5"
"10","004","00","007","0702","0000","234","176","58","9","243","417","0","58.27","42.21"
"10","004","00","007","0702","0319","234","176","58","9","243","417","0","58.27","42.21"
"10","004","00","007","0703","0000","535","431","104","30","565","963","0","58.67","44.76"
"10","004","00","007","0703","0321","535","431","104","30","565","963","0","58.67","44.76"
"10","004","00","007","0704","0000","250","194","56","21","271","418","0","64.83","46.41"
"10","004","00","007","0704","0322","250","194","56","21","271","418","0","64.83","46.41"
"10","004","00","007","0705","0000","1315","1055","260","82","1397","2666","0","52.4","39.57"
"10","004","00","007","0705","0323","679","548","131","41","720","1312","0","54.88","41.77"
"10","004","00","007","0705","0324","636","507","129","41","677","1354","0","50.0","37.44"
"10","004","00","007","0706","0000","887","719","168","72","959","1582","0","60.62","45.45"
"10","004","00","007","0706","0325","432","342","90","38","470","785","0","59.87","43.57"
"10","004","00","007","0706","0326","455","377","78","34","489","797","0","61.36","47.3"
"10","004","00","007","0707","0000","352","284","68","22","374","623","0","60.03","45.59"
"10","004","00","007","0707","0327","352","284","68","22","374","623","0","60.03","45.59"
"10","004","00","007","0708","0000","405","321","84","30","435","759","0","57.31","42.29"
"10","004","00","007","0708","0328","405","321","84","30","435","759","0","57.31","42.29"
"10","004","00","007","0709","0000","1249","1028","221","69","1318","2401","0","54.89","42.82"
"10","004","00","007","0709","0329","612","499","113","33","645","1272","0","50.71","39.23"
"10","004","00","007","0709","0330","637","529","108","36","673","1129","0","59.61","46.86"
"10","004","00","007","0710","0000","899","718","181","67","966","1552","0","62.24","46.26"
"10","004","00","007","0710","0331","418","328","90","27","445","713","0","62.41","46.0"
"10","004","00","007","0710","0332","481","390","91","40","521","839","0","62.1","46.48"
"10","004","00","007","0711","0000","2441","1951","490","122","2563","4276","0","59.94","45.63"
"10","004","00","007","0711","0333","701","559","142","32","733","1123","0","65.27","49.78"
"10","004","00","007","0711","0334","562","462","100","16","578","981","0","58.92","47.09"
"10","004","00","007","0711","0335","610","468","142","46","656","1078","0","60.85","43.41"
"10","004","00","007","0711","0336","568","462","106","28","596","1094","0","54.48","42.23"
"10","004","00","007","0712","0000","609","479","130","46","655","1102","0","59.44","43.47"
"10","004","00","007","0712","0337","609","479","130","46","655","1102","0","59.44","43.47"
"10","004","00","008","0000","0000","6239","5073","1166","430","6669","11346","13013","58.78","44.71"
"10","004","00","008","0801","0000","1941","1559","382","122","2063","3404","0","60.61","45.8"
"10","004","00","008","0801","0338","706","569","137","46","752","1231","0","61.09","46.22"
"10","004","00","008","0801","0339","581","470","111","44","625","1041","0","60.04","45.15"
"10","004","00","008","0801","0340","654","520","134","32","686","1132","0","60.6","45.94"
"10","004","00","008","0802","0000","471","395","76","34","505","859","0","58.79","45.98"
"10","004","00","008","0802","0341","471","395","76","34","505","859","0","58.79","45.98"
"10","004","00","008","0803","0000","103","81","22","14","117","204","0","57.35","39.71"
"10","004","00","008","0803","0342","103","81","22","14","117","204","0","57.35","39.71"
"10","004","00","008","0804","0000","91","72","19","9","100","222","0","45.05","32.43"
"10","004","00","008","0804","0343","91","72","19","9","100","222","0","45.05","32.43"
"10","004","00","008","0805","0000","195","154","41","22","217","338","0","64.2","45.56"
"10","004","00","008","0805","0344","195","154","41","22","217","338","0","64.2","45.56"
"10","004","00","008","0806","0000","461","389","72","31","492","916","0","53.71","42.47"
"10","004","00","008","0806","0345","461","389","72","31","492","916","0","53.71","42.47"
"10","004","00","008","0807","0000","211","172","39","15","226","463","0","48.81","37.15"
"10","004","00","008","0807","0348","211","172","39","15","226","463","0","48.81","37.15"
"10","004","00","008","0808","0000","530","433","97","49","579","978","0","59.2","44.27"
"10","004","00","008","0808","0349","400","333","67","38","438","690","0","63.48","48.26"
"10","004","00","008","0808","0350","130","100","30","11","141","288","0","48.96","34.72"
"10","004","00","008","0809","0000","927","757","170","52","979","1553","0","63.04","48.74"
"10","004","00","008","0809","0351","418","342","76","24","442","685","0","64.53","49.93"
"10","004","00","008","0809","0352","509","415","94","28","537","868","0","61.87","47.81"
"10","004","00","008","0810","0000","905","727","178","60","965","1561","0","61.82","46.57"
"10","004","00","008","0810","0353","905","727","178","60","965","1561","0","61.82","46.57"
"10","004","00","008","0811","0000","404","334","70","22","426","848","0","50.24","39.39"
"10","004","00","008","0811","0346","228","193","35","10","238","573","0","41.54","33.68"
"10","004","00","008","0811","0347","176","141","35","12","188","275","0","68.36","51.27"
"10","004","00","009","0000","0000","4317","3535","782","227","4544","8180","9352","55.55","43.22"
"10","004","00","009","0901","0000","547","442","105","17","564","1158","0","48.7","38.17"
"10","004","00","009","0901","0354","547","442","105","17","564","1158","0","48.7","38.17"
"10","004","00","009","0902","0000","689","543","146","44","733","1238","0","59.21","43.86"
"10","004","00","009","0902","0355","689","543","146","44","733","1238","0","59.21","43.86"
"10","004","00","009","0903","0000","1384","1146","238","85","1469","2584","0","56.85","44.35"
"10","004","00","009","0903","0357","514","422","92","25","539","931","0","57.89","45.33"
"10","004","00","009","0903","0358","870","724","146","60","930","1653","0","56.26","43.8"
"10","004","00","009","0904","0000","456","376","80","27","483","845","0","57.16","44.5"
"10","004","00","009","0904","0359","456","376","80","27","483","845","0","57.16","44.5"
"10","004","00","009","0905","0000","199","167","32","9","208","384","0","54.17","43.49"
"10","004","00","009","0905","0360","199","167","32","9","208","384","0","54.17","43.49"
"10","004","00","009","0906","0000","410","349","61","9","419","763","0","54.91","45.74"
"10","004","00","009","0906","0361","410","349","61","9","419","763","0","54.91","45.74"
"10","004","00","009","0907","0000","319","248","71","18","337","580","0","58.1","42.76"
"10","004","00","009","0907","0356","319","248","71","18","337","580","0","58.1","42.76"
"10","004","00","009","0908","0000","172","142","30","13","185","333","0","55.56","42.64"
"10","004","00","009","0908","0362","172","142","30","13","185","333","0","55.56","42.64"
"10","004","00","009","0909","0000","141","122","19","5","146","295","0","49.49","41.36"
"10","004","00","009","0909","0363","141","122","19","5","146","295","0","49.49","41.36"
"10","004","00","010","0000","0000","7190","5773","1417","398","7588","12973","14681","58.49","44.5"
"10","004","00","010","1001","0000","1423","1135","288","67","1490","2595","0","57.42","43.74"
"10","004","00","010","1001","0364","624","503","121","43","667","1158","0","57.6","43.44"
"10","004","00","010","1001","0365","799","632","167","24","823","1437","0","57.27","43.98"
"10","004","00","010","1002","0000","1046","838","208","54","1100","1900","0","57.89","44.11"
"10","004","00","010","1002","0368","1046","838","208","54","1100","1900","0","57.89","44.11"
"10","004","00","010","1003","0000","513","412","101","24","537","1056","0","50.85","39.02"
"10","004","00","010","1003","0369","513","412","101","24","537","1056","0","50.85","39.02"
"10","004","00","010","1004","0000","708","562","146","49","757","1205","0","62.82","46.64"
"10","004","00","010","1004","0370","708","562","146","49","757","1205","0","62.82","46.64"
"10","004","00","010","1005","0000","485","413","72","32","517","846","0","61.11","48.82"
"10","004","00","010","1005","0372","485","413","72","32","517","846","0","61.11","48.82"
"10","004","00","010","1006","0000","412","345","67","28","440","766","0","57.44","45.04"
"10","004","00","010","1006","0371","412","345","67","28","440","766","0","57.44","45.04"
"10","004","00","010","1007","0000","340","256","84","12","352","554","0","63.54","46.21"
"10","004","00","010","1007","0375","340","256","84","12","352","554","0","63.54","46.21"
"10","004","00","010","1008","0000","461","372","89","28","489","804","0","60.82","46.27"
"10","004","00","010","1008","0373","461","372","89","28","489","804","0","60.82","46.27"
"10","004","00","010","1009","0000","348","288","60","13","361","607","0","59.47","47.45"
"10","004","00","010","1009","0374","348","288","60","13","361","607","0","59.47","47.45"
"10","004","00","010","1010","0000","1454","1152","302","91","1545","2640","0","58.52","43.64"
"10","004","00","010","1010","0366","792","631","161","45","837","1470","0","56.94","42.93"
"10","004","00","010","1010","0367","662","521","141","46","708","1170","0","60.51","44.53"
"10","004","00","011","0000","0000","2808","2238","570","242","3050","5068","5638","60.18","44.16"
"10","004","00","011","1101","0000","525","427","98","45","570","879","0","64.85","48.58"
"10","004","00","011","1101","0376","525","427","98","45","570","879","0","64.85","48.58"
"10","004","00","011","1102","0000","391","309","82","40","431","683","0","63.1","45.24"
"10","004","00","011","1102","0377","391","309","82","40","431","683","0","63.1","45.24"
"10","004","00","011","1103","0000","345","267","78","20","365","604","0","60.43","44.21"
"10","004","00","011","1103","0378","345","267","78","20","365","604","0","60.43","44.21"
"10","004","00","011","1104","0000","782","639","143","75","857","1406","0","60.95","45.45"
"10","004","00","011","1104","0381","782","639","143","75","857","1406","0","60.95","45.45"
"10","004","00","011","1105","0000","289","227","62","24","313","615","0","50.89","36.91"
"10","004","00","011","1105","0379","181","145","36","18","199","339","0","58.7","42.77"
"10","004","00","011","1105","0380","108","82","26","6","114","276","0","41.3","29.71"
"10","004","00","011","1106","0000","476","369","107","38","514","881","0","58.34","41.88"
"10","004","00","011","1106","0382","265","219","46","24","289","462","0","62.55","47.4"
"10","004","00","011","1106","0383","211","150","61","14","225","419","0","53.7","35.8"
"10","004","00","012","0000","0000","2923","2358","565","210","3133","7364","9683","42.54","32.02"
"10","004","00","012","1201","0000","259","210","49","19","278","599","0","46.41","35.06"
"10","004","00","012","1201","0386","96","80","16","14","110","225","0","48.89","35.56"
"10","004","00","012","1201","0387","163","130","33","5","168","374","0","44.92","34.76"
"10","004","00","012","1202","0000","339","281","58","14","353","831","0","42.48","33.81"
"10","004","00","012","1202","0384","177","141","36","8","185","474","0","39.03","29.75"
"10","004","00","012","1202","0385","162","140","22","6","168","357","0","47.06","39.22"
"10","004","00","012","1203","0000","494","410","84","23","517","1263","0","40.93","32.46"
"10","004","00","012","1203","0388","298","250","48","7","305","773","0","39.46","32.34"
"10","004","00","012","1203","0389","196","160","36","16","212","490","0","43.27","32.65"
"10","004","00","012","1204","0000","343","250","93","57","400","613","0","65.25","40.78"
"10","004","00","012","1204","0392","343","250","93","57","400","613","0","65.25","40.78"
"10","004","00","012","1205","0000","431","352","79","9","440","1191","0","36.94","29.55"
"10","004","00","012","1205","0390","176","141","35","4","180","531","0","33.9","26.55"
"10","004","00","012","1205","0391","255","211","44","5","260","660","0","39.39","31.97"
"10","004","00","012","1206","0000","571","465","106","28","599","1294","0","46.29","35.94"
"10","004","00","012","1206","0393","255","206","49","2","257","593","0","43.34","34.74"
"10","004","00","012","1206","0394","239","191","48","19","258","575","0","44.87","33.22"
"10","004","00","012","1206","0395","77","68","9","7","84","126","0","66.67","53.97"
"10","004","00","012","1207","0000","486","390","96","60","546","1573","0","34.71","24.79"
"10","004","00","012","1207","0396","161","132","29","4","165","499","0","33.07","26.45"
"10","004","00","012","1207","0397","204","153","51","14","218","785","0","27.77","19.49"
"10","004","00","012","1207","0398","121","105","16","42","163","289","0","56.4","36.33"
"10","004","00","013","0000","0000","1573","1242","331","75","1648","3997","4802","41.23","31.07"
"10","004","00","013","1301","0000","620","483","137","40","660","1385","0","47.65","34.87"
"10","004","00","013","1301","0399","329","255","74","28","357","672","0","53.13","37.95"
"10","004","00","013","1301","0400","291","228","63","12","303","713","0","42.5","31.98"
"10","004","00","013","1302","0000","276","210","66","5","281","727","0","38.65","28.89"
"10","004","00","013","1302","0403","276","210","66","5","281","727","0","38.65","28.89"
"10","004","00","013","1303","0000","139","106","33","6","145","395","0","36.71","26.84"
"10","004","00","013","1303","0404","139","106","33","6","145","395","0","36.71","26.84"
"10","004","00","013","1304","0000","538","443","95","24","562","1490","0","37.72","29.73"
"10","004","00","013","1304","0401","190","158","32","6","196","594","0","33.0","26.6"
"10","004","00","013","1304","0402","348","285","63","18","366","896","0","40.85","31.81"
"10","005","00","000","0000","0000","245333","198009","47324","15647","260980","461580","549798","56.54","42.9"
"10","005","00","001","0000","0000","40884","33815","7069","1931","42815","74249","88300","57.66","45.54"
"10","005","00","001","0101","0000","597","509","88","28","625","1087","0","57.5","46.83"
"10","005","00","001","0101","0001","597","509","88","28","625","1087","0","57.5","46.83"
"10","005","00","001","0102","0000","2330","1976","354","110","2440","4075","0","59.88","48.49"
"10","005","00","001","0102","0049","613","514","99","30","643","1003","0","64.11","51.25"
"10","005","00","001","0102","0050","562","472","90","19","581","1000","0","58.1","47.2"
"10","005","00","001","0102","0051","562","481","81","28","590","1047","0","56.35","45.94"
"10","005","00","001","0102","0052","593","509","84","33","626","1025","0","61.07","49.66"
"10","005","00","001","0103","0000","538","456","82","33","571","1018","0","56.09","44.79"
"10","005","00","001","0103","0002","538","456","82","33","571","1018","0","56.09","44.79"
"10","005","00","001","0104","0000","1283","1069","214","58","1341","2234","0","60.03","47.85"
"10","005","00","001","0104","0009","637","529","108","19","656","1115","0","58.83","47.44"
"10","005","00","001","0104","0010","646","540","106","39","685","1119","0","61.22","48.26"
"10","005","00","001","0105","0000","2108","1747","361","88","2196","3685","0","59.59","47.41"
"10","005","00","001","0105","0011","668","530","138","28","696","1132","0","61.48","46.82"
"10","005","00","001","0105","0012","710","598","112","31","741","1289","0","57.49","46.39"
"10","005","00","001","0105","0013","730","619","111","29","759","1264","0","60.05","48.97"
"10","005","00","001","0106","0000","2105","1737","368","104","2209","3702","0","59.67","46.92"
"10","005","00","001","0106","0006","685","572","113","33","718","1203","0","59.68","47.55"
"10","005","00","001","0106","0007","742","628","114","33","775","1306","0","59.34","48.09"
"10","005","00","001","0106","0008","678","537","141","38","716","1193","0","60.02","45.01"
"10","005","00","001","0107","0000","1803","1505","298","85","1888","3358","0","56.22","44.82"
"10","005","00","001","0107","0003","617","522","95","17","634","1156","0","54.84","45.16"
"10","005","00","001","0107","0004","584","496","88","27","611","1118","0","54.65","44.36"
"10","005","00","001","0107","0005","602","487","115","41","643","1084","0","59.32","44.93"
"10","005","00","001","0108","0000","473","396","77","19","492","870","0","56.55","45.52"
"10","005","00","001","0108","0014","473","396","77","19","492","870","0","56.55","45.52"
"10","005","00","001","0109","0000","1656","1377","279","71","1727","3163","0","54.6","43.53"
"10","005","00","001","0109","0015","486","406","80","27","513","1008","0","50.89","40.28"
"10","005","00","001","0109","0016","545","451","94","24","569","1078","0","52.78","41.84"
"10","005","00","001","0109","0017","625","520","105","20","645","1077","0","59.89","48.28"
"10","005","00","001","0110","0000","458","364","94","45","503","894","0","56.26","40.72"
"10","005","00","001","0110","0019","458","364","94","45","503","894","0","56.26","40.72"
"10","005","00","001","0111","0000","286","239","47","18","304","522","0","58.24","45.79"
"10","005","00","001","0111","0020","286","239","47","18","304","522","0","58.24","45.79"
"10","005","00","001","0112","0000","474","386","88","33","507","880","0","57.61","43.86"
"10","005","00","001","0112","0018","474","386","88","33","507","880","0","57.61","43.86"
"10","005","00","001","0113","0000","2300","1864","436","100","2400","3964","0","60.54","47.02"
"10","005","00","001","0113","0024","679","551","128","30","709","1272","0","55.74","43.32"
"10","005","00","001","0113","0025","676","546","130","34","710","1112","0","63.85","49.1"
"10","005","00","001","0113","0026","527","438","89","17","544","813","0","66.91","53.87"
"10","005","00","001","0113","0027","418","329","89","19","437","767","0","56.98","42.89"
"10","005","00","001","0114","0000","821","661","160","50","871","1376","0","63.3","48.04"
"10","005","00","001","0114","0021","821","661","160","50","871","1376","0","63.3","48.04"
"10","005","00","001","0115","0000","932","771","161","44","976","1597","0","61.11","48.28"
"10","005","00","001","0115","0031","351","293","58","13","364","607","0","59.97","48.27"
"10","005","00","001","0115","0032","581","478","103","31","612","990","0","61.82","48.28"
"10","005","00","001","0116","0000","2750","2311","439","138","2888","5087","0","56.77","45.43"
"10","005","00","001","0116","0033","624","510","114","42","666","1230","0","54.15","41.46"
"10","005","00","001","0116","0034","761","635","126","32","793","1372","0","57.8","46.28"
"10","005","00","001","0116","0035","672","573","99","33","705","1213","0","58.12","47.24"
"10","005","00","001","0116","0036","693","593","100","31","724","1272","0","56.92","46.62"
"10","005","00","001","0117","0000","1718","1424","294","66","1784","3157","0","56.51","45.11"
"10","005","00","001","0117","0028","546","444","102","17","563","1010","0","55.74","43.96"
"10","005","00","001","0117","0029","634","535","99","32","666","1182","0","56.35","45.26"
"10","005","00","001","0117","0030","538","445","93","17","555","965","0","57.51","46.11"
"10","005","00","001","0118","0000","1924","1582","342","76","2000","3496","0","57.21","45.25"
"10","005","00","001","0118","0037","724","597","127","26","750","1221","0","61.43","48.89"
"10","005","00","001","0118","0038","613","490","123","32","645","1104","0","58.42","44.38"
"10","005","00","001","0118","0039","587","495","92","18","605","1171","0","51.67","42.27"
"10","005","00","001","0119","0000","2263","1843","420","119","2382","4135","0","57.61","44.57"
"10","005","00","001","0119","0040","749","608","141","35","784","1392","0","56.32","43.68"
"10","005","00","001","0119","0041","759","609","150","36","795","1356","0","58.63","44.91"
"10","005","00","001","0119","0042","755","626","129","48","803","1387","0","57.89","45.13"
"10","005","00","001","0120","0000","612","507","105","35","647","1180","0","54.83","42.97"
"10","005","00","001","0120","0063","612","507","105","35","647","1180","0","54.83","42.97"
"10","005","00","001","0121","0000","2059","1686","373","93","2152","3644","0","59.06","46.27"
"10","005","00","001","0121","0057","665","540","125","25","690","1125","0","61.33","48.0"
"10","005","00","001","0121","0058","665","549","116","30","695","1241","0","56.0","44.24"
"10","005","00","001","0121","0059","729","597","132","38","767","1278","0","60.02","46.71"
"10","005","00","001","0122","0000","2687","2244","443","108","2795","5200","0","53.75","43.15"
"10","005","00","001","0122","0053","597","499","98","14","611","1130","0","54.07","44.16"
"10","005","00","001","0122","0054","633","534","99","21","654","1146","0","57.07","46.6"
"10","005","00","001","0122","0055","790","654","136","44","834","1432","0","58.24","45.67"
"10","005","00","001","0122","0056","667","557","110","29","696","1492","0","46.65","37.33"
"10","005","00","001","0123","0000","1324","1103","221","74","1398","2472","0","56.55","44.62"
"10","005","00","001","0123","0022","723","611","112","27","750","1391","0","53.92","43.93"
"10","005","00","001","0123","0023","601","492","109","47","648","1081","0","59.94","45.51"
"10","005","00","001","0124","0000","812","661","151","44","856","1665","0","51.41","39.7"
"10","005","00","001","0124","0066","400","327","73","26","426","796","0","53.52","41.08"
"10","005","00","001","0124","0067","412","334","78","18","430","869","0","49.48","38.43"
"10","005","00","001","0125","0000","1901","1541","360","101","2002","3412","0","58.68","45.16"
"10","005","00","001","0125","0043","657","551","106","34","691","1206","0","57.3","45.69"
"10","005","00","001","0125","0044","604","481","123","34","638","1004","0","63.55","47.91"
"10","005","00","001","0125","0045","640","509","131","33","673","1202","0","55.99","42.35"
"10","005","00","001","0126","0000","1773","1459","314","65","1838","2900","0","63.38","50.31"
"10","005","00","001","0126","0046","618","505","113","24","642","1052","0","61.03","48.0"
"10","005","00","001","0126","0047","521","430","91","22","543","873","0","62.2","49.26"
"10","005","00","001","0126","0048","634","524","110","19","653","975","0","66.97","53.74"
"10","005","00","001","0127","0000","1067","889","178","51","1118","1984","0","56.35","44.81"
"10","005","00","001","0127","0064","604","490","114","32","636","1072","0","59.33","45.71"
"10","005","00","001","0127","0065","463","399","64","19","482","912","0","52.85","43.75"
"10","005","00","001","0128","0000","1830","1508","322","75","1905","3492","0","54.55","43.18"
"10","005","00","001","0128","0060","691","584","107","22","713","1293","0","55.14","45.17"
"10","005","00","001","0128","0061","684","559","125","28","712","1342","0","53.06","41.65"
"10","005","00","001","0128","0062","455","365","90","25","480","857","0","56.01","42.59"
"10","005","00","002","0000","0000","20449","15998","4451","1621","22070","38890","45367","56.75","41.14"
"10","005","00","002","0201","0000","1222","935","287","89","1311","2219","0","59.08","42.14"
"10","005","00","002","0201","0183","475","345","130","47","522","873","0","59.79","39.52"
"10","005","00","002","0201","0184","747","590","157","42","789","1346","0","58.62","43.83"
"10","005","00","002","0202","0000","872","673","199","65","937","1566","0","59.83","42.98"
"10","005","00","002","0202","0185","566","438","128","52","618","951","0","64.98","46.06"
"10","005","00","002","0202","0186","306","235","71","13","319","615","0","51.87","38.21"
"10","005","00","002","0203","0000","482","372","110","67","549","878","0","62.53","42.37"
"10","005","00","002","0203","0187","482","372","110","67","549","878","0","62.53","42.37"
"10","005","00","002","0204","0000","838","645","193","63","901","1543","0","58.39","41.8"
"10","005","00","002","0204","0188","440","346","94","28","468","767","0","61.02","45.11"
"10","005","00","002","0204","0189","398","299","99","35","433","776","0","55.8","38.53"
"10","005","00","002","0205","0000","574","458","116","59","633","1231","0","51.42","37.21"
"10","005","00","002","0205","0190","574","458","116","59","633","1231","0","51.42","37.21"
"10","005","00","002","0206","0000","1065","827","238","74","1139","1995","0","57.09","41.45"
"10","005","00","002","0206","0191","631","483","148","40","671","1145","0","58.6","42.18"
"10","005","00","002","0206","0192","434","344","90","34","468","850","0","55.06","40.47"
"10","005","00","002","0207","0000","531","399","132","48","579","1052","0","55.04","37.93"
"10","005","00","002","0207","0193","531","399","132","48","579","1052","0","55.04","37.93"
"10","005","00","002","0208","0000","1217","936","281","97","1314","2250","0","58.4","41.6"
"10","005","00","002","0208","0194","601","460","141","38","639","1114","0","57.36","41.29"
"10","005","00","002","0208","0195","616","476","140","59","675","1136","0","59.42","41.9"
"10","005","00","002","0209","0000","2126","1679","447","149","2275","3922","0","58.01","42.81"
"10","005","00","002","0209","0196","620","482","138","42","662","1194","0","55.44","40.37"
"10","005","00","002","0209","0197","849","684","165","53","902","1579","0","57.12","43.32"
"10","005","00","002","0209","0198","657","513","144","54","711","1149","0","61.88","44.65"
"10","005","00","002","0210","0000","1110","866","244","69","1179","2158","0","54.63","40.13"
"10","005","00","002","0210","0199","588","452","136","52","640","1057","0","60.55","42.76"
"10","005","00","002","0210","0200","522","414","108","17","539","1101","0","48.96","37.6"
"10","005","00","002","0211","0000","382","287","95","42","424","912","0","46.49","31.47"
"10","005","00","002","0211","0201","382","287","95","42","424","912","0","46.49","31.47"
"10","005","00","002","0212","0000","331","254","77","33","364","652","0","55.83","38.96"
"10","005","00","002","0212","0202","331","254","77","33","364","652","0","55.83","38.96"
"10","005","00","002","0213","0000","720","572","148","59","779","1348","0","57.79","42.43"
"10","005","00","002","0213","0203","720","572","148","59","779","1348","0","57.79","42.43"
"10","005","00","002","0214","0000","638","498","140","33","671","1395","0","48.1","35.7"
"10","005","00","002","0214","0204","322","239","83","21","343","733","0","46.79","32.61"
"10","005","00","002","0214","0205","316","259","57","12","328","662","0","49.55","39.12"
"10","005","00","002","0215","0000","975","804","171","86","1061","1803","0","58.85","44.59"
"10","005","00","002","0215","0206","473","390","83","43","516","893","0","57.78","43.67"
"10","005","00","002","0215","0207","502","414","88","43","545","910","0","59.89","45.49"
"10","005","00","002","0216","0000","627","489","138","67","694","1270","0","54.65","38.5"
"10","005","00","002","0216","0208","627","489","138","67","694","1270","0","54.65","38.5"
"10","005","00","002","0217","0000","268","219","49","24","292","545","0","53.58","40.18"
"10","005","00","002","0217","0209","268","219","49","24","292","545","0","53.58","40.18"
"10","005","00","002","0218","0000","450","369","81","52","502","792","0","63.38","46.59"
"10","005","00","002","0218","0210","450","369","81","52","502","792","0","63.38","46.59"
"10","005","00","002","0219","0000","1301","1006","295","80","1381","2316","0","59.63","43.44"
"10","005","00","002","0219","0218","607","478","129","25","632","1082","0","58.41","44.18"
"10","005","00","002","0219","0219","694","528","166","55","749","1234","0","60.7","42.79"
"10","005","00","002","0220","0000","739","592","147","65","804","1609","0","49.97","36.79"
"10","005","00","002","0220","0212","325","266","59","16","341","827","0","41.23","32.16"
"10","005","00","002","0220","0213","414","326","88","49","463","782","0","59.21","41.69"
"10","005","00","002","0221","0000","831","647","184","65","896","1634","0","54.83","39.6"
"10","005","00","002","0221","0214","410","320","90","25","435","788","0","55.2","40.61"
"10","005","00","002","0221","0215","421","327","94","40","461","846","0","54.49","38.65"
"10","005","00","002","0222","0000","979","778","201","75","1054","1771","0","59.51","43.93"
"10","005","00","002","0222","0216","461","359","102","43","504","828","0","60.87","43.36"
"10","005","00","002","0222","0217","518","419","99","32","550","943","0","58.32","44.43"
"10","005","00","002","0223","0000","383","297","86","34","417","726","0","57.44","40.91"
"10","005","00","002","0223","0211","383","297","86","34","417","726","0","57.44","40.91"
"10","005","00","002","0224","0000","732","589","143","52","784","1434","0","54.67","41.07"
"10","005","00","002","0224","0220","732","589","143","52","784","1434","0","54.67","41.07"
"10","005","00","002","0225","0000","1056","807","249","74","1130","1869","0","60.46","43.18"
"10","005","00","002","0225","0221","533","428","105","35","568","987","0","57.55","43.36"
"10","005","00","002","0225","0222","523","379","144","39","562","882","0","63.72","42.97"
"10","005","00","003","0000","0000","14596","11314","3282","1351","15947","29709","34122","53.68","38.08"
"10","005","00","003","0301","0000","579","429","150","72","651","1142","0","57.01","37.57"
"10","005","00","003","0301","0149","579","429","150","72","651","1142","0","57.01","37.57"
"10","005","00","003","0302","0000","1049","793","256","122","1171","1952","0","59.99","40.63"
"10","005","00","003","0302","0150","510","381","129","62","572","884","0","64.71","43.1"
"10","005","00","003","0302","0151","539","412","127","60","599","1068","0","56.09","38.58"
"10","005","00","003","0303","0000","1043","787","256","84","1127","1868","0","60.33","42.13"
"10","005","00","003","0303","0152","527","402","125","39","566","1009","0","56.1","39.84"
"10","005","00","003","0303","0153","516","385","131","45","561","859","0","65.31","44.82"
"10","005","00","003","0304","0000","826","625","201","74","900","1551","0","58.03","40.3"
"10","005","00","003","0304","0157","452","333","119","51","503","761","0","66.1","43.76"
"10","005","00","003","0304","0158","374","292","82","23","397","790","0","50.25","36.96"
"10","005","00","003","0305","0000","356","273","83","52","408","686","0","59.48","39.8"
"10","005","00","003","0305","0156","356","273","83","52","408","686","0","59.48","39.8"
"10","005","00","003","0306","0000","1310","997","313","155","1465","2709","0","54.08","36.8"
"10","005","00","003","0306","0159","480","352","128","50","530","966","0","54.87","36.44"
"10","005","00","003","0306","0160","448","350","98","55","503","972","0","51.75","36.01"
"10","005","00","003","0306","0161","382","295","87","50","432","771","0","56.03","38.26"
"10","005","00","003","0307","0000","323","254","69","24","347","684","0","50.73","37.13"
"10","005","00","003","0307","0168","323","254","69","24","347","684","0","50.73","37.13"
"10","005","00","003","0308","0000","403","313","90","37","440","943","0","46.66","33.19"
"10","005","00","003","0308","0169","403","313","90","37","440","943","0","46.66","33.19"
"10","005","00","003","0309","0000","417","316","101","60","477","790","0","60.38","40.0"
"10","005","00","003","0309","0170","417","316","101","60","477","790","0","60.38","40.0"
"10","005","00","003","0310","0000","319","260","59","12","331","673","0","49.18","38.63"
"10","005","00","003","0310","0171","319","260","59","12","331","673","0","49.18","38.63"
"10","005","00","003","0311","0000","597","483","114","51","648","1232","0","52.6","39.2"
"10","005","00","003","0311","0172","597","483","114","51","648","1232","0","52.6","39.2"
"10","005","00","003","0312","0000","692","544","148","64","756","1286","0","58.79","42.3"
"10","005","00","003","0312","0173","692","544","148","64","756","1286","0","58.79","42.3"
"10","005","00","003","0313","0000","713","545","168","60","773","1418","0","54.51","38.43"
"10","005","00","003","0313","0174","349","259","90","38","387","649","0","59.63","39.91"
"10","005","00","003","0313","0175","364","286","78","22","386","769","0","50.2","37.19"
"10","005","00","003","0314","0000","842","638","204","68","910","1836","0","49.56","34.75"
"10","005","00","003","0314","0162","297","235","62","31","328","758","0","43.27","31.0"
"10","005","00","003","0314","0163","545","403","142","37","582","1078","0","53.99","37.38"
"10","005","00","003","0315","0000","175","135","40","24","199","459","0","43.36","29.41"
"10","005","00","003","0315","0164","175","135","40","24","199","459","0","43.36","29.41"
"10","005","00","003","0316","0000","404","322","82","45","449","894","0","50.22","36.02"
"10","005","00","003","0316","0165","404","322","82","45","449","894","0","50.22","36.02"
"10","005","00","003","0317","0000","151","120","31","8","159","402","0","39.55","29.85"
"10","005","00","003","0317","0166","151","120","31","8","159","402","0","39.55","29.85"
"10","005","00","003","0318","0000","405","313","92","29","434","802","0","54.11","39.03"
"10","005","00","003","0318","0167","405","313","92","29","434","802","0","54.11","39.03"
"10","005","00","003","0319","0000","1083","817","266","122","1205","2286","0","52.71","35.74"
"10","005","00","003","0319","0176","568","430","138","62","630","1148","0","54.88","37.46"
"10","005","00","003","0319","0177","515","387","128","60","575","1138","0","50.53","34.01"
"10","005","00","003","0320","0000","500","377","123","43","543","1121","0","48.44","33.63"
"10","005","00","003","0320","0178","500","377","123","43","543","1121","0","48.44","33.63"
"10","005","00","003","0321","0000","409","326","83","18","427","769","0","55.53","42.39"
"10","005","00","003","0321","0179","409","326","83","18","427","769","0","55.53","42.39"
"10","005","00","003","0322","0000","685","523","162","49","734","1415","0","51.87","36.96"
"10","005","00","003","0322","0180","282","201","81","15","297","616","0","48.21","32.63"
"10","005","00","003","0322","0181","403","322","81","34","437","799","0","54.69","40.3"
"10","005","00","003","0323","0000","347","286","61","25","372","743","0","50.07","38.49"
"10","005","00","003","0323","0182","347","286","61","25","372","743","0","50.07","38.49"
"10","005","00","003","0324","0000","968","838","130","53","1021","2048","0","49.85","40.92"
"10","005","00","003","0324","0154","559","518","41","42","601","1040","0","57.79","49.81"
"10","005","00","003","0324","0155","409","320","89","11","420","1008","0","41.67","31.75"
"10","005","00","004","0000","0000","36217","29221","6996","2120","38337","68528","86056","55.94","42.64"
"10","005","00","004","0401","0000","1074","850","224","63","1137","1912","0","59.47","44.46"
"10","005","00","004","0401","0270","619","475","144","32","651","1086","0","59.94","43.74"
"10","005","00","004","0401","0271","455","375","80","31","486","826","0","58.84","45.4"
"10","005","00","004","0402","0000","1757","1423","334","144","1901","3302","0","57.57","43.1"
"10","005","00","004","0402","0272","507","409","98","46","553","1051","0","52.62","38.92"
"10","005","00","004","0402","0273","694","573","121","40","734","1235","0","59.43","46.4"
"10","005","00","004","0402","0274","556","441","115","58","614","1016","0","60.43","43.41"
"10","005","00","004","0403","0000","1350","1066","284","82","1432","2773","0","51.64","38.44"
"10","005","00","004","0403","0275","741","572","169","55","796","1472","0","54.08","38.86"
"10","005","00","004","0403","0276","609","494","115","27","636","1301","0","48.89","37.97"
"10","005","00","004","0404","0000","2268","1788","480","115","2383","4519","0","52.73","39.57"
"10","005","00","004","0404","0277","741","581","160","38","779","1544","0","50.45","37.63"
"10","005","00","004","0404","0278","801","639","162","29","830","1512","0","54.89","42.26"
"10","005","00","004","0404","0279","726","568","158","48","774","1463","0","52.9","38.82"
"10","005","00","004","0405","0000","2922","2385","537","123","3045","5258","0","57.91","45.36"
"10","005","00","004","0405","0280","538","433","105","30","568","1073","0","52.94","40.35"
"10","005","00","004","0405","0281","800","649","151","34","834","1453","0","57.4","44.67"
"10","005","00","004","0405","0282","721","593","128","33","754","1245","0","60.56","47.63"
"10","005","00","004","0405","0283","863","710","153","26","889","1487","0","59.78","47.75"
"10","005","00","004","0406","0000","1854","1443","411","107","1961","3445","0","56.92","41.89"
"10","005","00","004","0406","0284","565","431","134","40","605","1018","0","59.43","42.34"
"10","005","00","004","0406","0285","630","501","129","26","656","1105","0","59.37","45.34"
"10","005","00","004","0406","0286","659","511","148","41","700","1322","0","52.95","38.65"
"10","005","00","004","0407","0000","1940","1576","364","92","2032","3343","0","60.78","47.14"
"10","005","00","004","0407","0287","639","516","123","21","660","1140","0","57.89","45.26"
"10","005","00","004","0407","0288","622","514","108","33","655","1067","0","61.39","48.17"
"10","005","00","004","0407","0289","679","546","133","38","717","1136","0","63.12","48.06"
"10","005","00","004","0408","0000","1598","1302","296","124","1722","3237","0","53.2","40.22"
"10","005","00","004","0408","0290","609","509","100","44","653","1253","0","52.11","40.62"
"10","005","00","004","0408","0291","473","386","87","40","513","963","0","53.27","40.08"
"10","005","00","004","0408","0292","516","407","109","40","556","1021","0","54.46","39.86"
"10","005","00","004","0409","0000","1172","983","189","67","1239","2111","0","58.69","46.57"
"10","005","00","004","0409","0297","524","432","92","38","562","989","0","56.83","43.68"
"10","005","00","004","0409","0298","648","551","97","29","677","1122","0","60.34","49.11"
"10","005","00","004","0410","0000","2272","1899","373","127","2399","4607","0","52.07","41.22"
"10","005","00","004","0410","0299","487","393","94","36","523","1111","0","47.07","35.37"
"10","005","00","004","0410","0300","572","485","87","44","616","1036","0","59.46","46.81"
"10","005","00","004","0410","0301","531","430","101","29","560","1112","0","50.36","38.67"
"10","005","00","004","0410","0302","682","591","91","18","700","1348","0","51.93","43.84"
"10","005","00","004","0411","0000","606","505","101","45","651","1059","0","61.47","47.69"
"10","005","00","004","0411","0306","606","505","101","45","651","1059","0","61.47","47.69"
"10","005","00","004","0412","0000","1572","1239","333","97","1669","2834","0","58.89","43.72"
"10","005","00","004","0412","0307","475","364","111","40","515","869","0","59.26","41.89"
"10","005","00","004","0412","0308","419","327","92","23","442","800","0","55.25","40.88"
"10","005","00","004","0412","0309","678","548","130","34","712","1165","0","61.12","47.04"
"10","005","00","004","0413","0000","777","613","164","58","835","1468","0","56.88","41.76"
"10","005","00","004","0413","0310","428","347","81","34","462","791","0","58.41","43.87"
"10","005","00","004","0413","0311","349","266","83","24","373","677","0","55.1","39.29"
"10","005","00","004","0414","0000","1096","910","186","74","1170","1988","0","58.85","45.77"
"10","005","00","004","0414","0312","476","390","86","41","517","797","0","64.87","48.93"
"10","005","00","004","0414","0313","620","520","100","33","653","1191","0","54.83","43.66"
"10","005","00","004","0415","0000","519","422","97","16","535","1027","0","52.09","41.09"
"10","005","00","004","0415","0314","519","422","97","16","535","1027","0","52.09","41.09"
"10","005","00","004","0416","0000","2046","1672","374","129","2175","3935","0","55.27","42.49"
"10","005","00","004","0416","0315","740","611","129","51","791","1341","0","58.99","45.56"
"10","005","00","004","0416","0316","652","540","112","51","703","1378","0","51.02","39.19"
"10","005","00","004","0416","0317","654","521","133","27","681","1216","0","56.0","42.85"
"10","005","00","004","0417","0000","1094","882","212","58","1152","2108","0","54.65","41.84"
"10","005","00","004","0417","0318","792","638","154","30","822","1570","0","52.36","40.64"
"10","005","00","004","0417","0319","302","244","58","28","330","538","0","61.34","45.35"
"10","005","00","004","0418","0000","532","439","93","13","545","1166","0","46.74","37.65"
"10","005","00","004","0418","0320","532","439","93","13","545","1166","0","46.74","37.65"
"10","005","00","004","0419","0000","2040","1637","403","117","2157","4119","0","52.37","39.74"
"10","005","00","004","0419","0321","745","579","166","31","776","1488","0","52.15","38.91"
"10","005","00","004","0419","0322","698","585","113","22","720","1449","0","49.69","40.37"
"10","005","00","004","0419","0323","597","473","124","64","661","1182","0","55.92","40.02"
"10","005","00","004","0420","0000","1128","894","234","97","1225","2158","0","56.77","41.43"
"10","005","00","004","0420","0324","608","474","134","60","668","1175","0","56.85","40.34"
"10","005","00","004","0420","0325","520","420","100","37","557","983","0","56.66","42.73"
"10","005","00","004","0421","0000","1965","1563","402","125","2090","3715","0","56.26","42.07"
"10","005","00","004","0421","0326","286","245","41","23","309","492","0","62.8","49.8"
"10","005","00","004","0421","0327","589","461","128","33","622","1074","0","57.91","42.92"
"10","005","00","004","0421","0328","428","315","113","40","468","852","0","54.93","36.97"
"10","005","00","004","0421","0329","662","542","120","29","691","1297","0","53.28","41.79"
"10","005","00","004","0422","0000","517","412","105","41","558","1028","0","54.28","40.08"
"10","005","00","004","0422","0330","517","412","105","41","558","1028","0","54.28","40.08"
"10","005","00","004","0423","0000","1726","1376","350","87","1813","3111","0","58.28","44.23"
"10","005","00","004","0423","0303","621","506","115","21","642","1114","0","57.63","45.42"
"10","005","00","004","0423","0304","630","481","149","40","670","1119","0","59.87","42.98"
"10","005","00","004","0423","0305","475","389","86","26","501","878","0","57.06","44.31"
"10","005","00","004","0424","0000","1172","966","206","51","1223","2109","0","57.99","45.8"
"10","005","00","004","0424","0295","709","584","125","34","743","1293","0","57.46","45.17"
"10","005","00","004","0424","0296","463","382","81","17","480","816","0","58.82","46.81"
"10","005","00","004","0425","0000","1220","976","244","68","1288","2196","0","58.65","44.44"
"10","005","00","004","0425","0293","647","521","126","45","692","1154","0","59.97","45.15"
"10","005","00","004","0425","0294","573","455","118","23","596","1042","0","57.2","43.67"
"10","005","00","005","0000","0000","44639","36143","8496","2330","46969","83617","103007","56.17","43.22"
"10","005","00","005","0501","0000","1148","919","229","84","1232","2207","0","55.82","41.64"
"10","005","00","005","0501","0331","451","362","89","46","497","915","0","54.32","39.56"
"10","005","00","005","0501","0332","697","557","140","38","735","1292","0","56.89","43.11"
"10","005","00","005","0502","0000","923","448","475","35","958","1763","0","54.34","25.41"
"10","005","00","005","0502","0333","528","117","411","24","552","928","0","59.48","12.61"
"10","005","00","005","0502","0334","395","331","64","11","406","835","0","48.62","39.64"
"10","005","00","005","0503","0000","1475","1193","282","80","1555","2988","0","52.04","39.93"
"10","005","00","005","0503","0335","560","459","101","27","587","1070","0","54.86","42.9"
"10","005","00","005","0503","0336","418","336","82","12","430","879","0","48.92","38.23"
"10","005","00","005","0503","0337","497","398","99","41","538","1039","0","51.78","38.31"
"10","005","00","005","0504","0000","1878","1519","359","141","2019","3716","0","54.33","40.88"
"10","005","00","005","0504","0338","609","500","109","49","658","1129","0","58.28","44.29"
"10","005","00","005","0504","0339","537","446","91","35","572","1041","0","54.95","42.84"
"10","005","00","005","0504","0340","732","573","159","57","789","1546","0","51.03","37.06"
"10","005","00","005","0505","0000","2115","1705","410","126","2241","4361","0","51.39","39.1"
"10","005","00","005","0505","0341","434","319","115","29","463","935","0","49.52","34.12"
"10","005","00","005","0505","0342","575","449","126","42","617","1180","0","52.29","38.05"
"10","005","00","005","0505","0343","717","598","119","40","757","1499","0","50.5","39.89"
"10","005","00","005","0505","0344","389","339","50","15","404","747","0","54.08","45.38"
"10","005","00","005","0506","0000","1353","1089","264","66","1419","2599","0","54.6","41.9"
"10","005","00","005","0506","0345","730","590","140","18","748","1406","0","53.2","41.96"
"10","005","00","005","0506","0346","623","499","124","48","671","1193","0","56.24","41.83"
"10","005","00","005","0507","0000","522","409","113","30","552","948","0","58.23","43.14"
"10","005","00","005","0507","0347","522","409","113","30","552","948","0","58.23","43.14"
"10","005","00","005","0508","0000","1747","1421","326","81","1828","3297","0","55.44","43.1"
"10","005","00","005","0508","0348","437","368","69","27","464","869","0","53.39","42.35"
"10","005","00","005","0508","0349","634","510","124","32","666","1142","0","58.32","44.66"
"10","005","00","005","0508","0350","676","543","133","22","698","1286","0","54.28","42.22"
"10","005","00","005","0509","0000","1768","1471","297","91","1859","3105","0","59.87","47.38"
"10","005","00","005","0509","0351","504","416","88","32","536","903","0","59.36","46.07"
"10","005","00","005","0509","0352","696","567","129","39","735","1186","0","61.97","47.81"
"10","005","00","005","0509","0353","568","488","80","20","588","1016","0","57.87","48.03"
"10","005","00","005","0510","0000","860","697","163","65","925","1536","0","60.22","45.38"
"10","005","00","005","0510","0357","486","409","77","33","519","890","0","58.31","45.96"
"10","005","00","005","0510","0358","374","288","86","32","406","646","0","62.85","44.58"
"10","005","00","005","0511","0000","437","365","72","27","464","947","0","49.0","38.54"
"10","005","00","005","0511","0356","437","365","72","27","464","947","0","49.0","38.54"
"10","005","00","005","0512","0000","626","508","118","43","669","1030","0","64.95","49.32"
"10","005","00","005","0512","0363","626","508","118","43","669","1030","0","64.95","49.32"
"10","005","00","005","0513","0000","1025","836","189","44","1069","1968","0","54.32","42.48"
"10","005","00","005","0513","0384","559","458","101","24","583","1121","0","52.01","40.86"
"10","005","00","005","0513","0385","466","378","88","20","486","847","0","57.38","44.63"
"10","005","00","005","0514","0000","1708","1430","278","107","1815","3454","0","52.55","41.4"
"10","005","00","005","0514","0388","779","654","125","47","826","1655","0","49.91","39.52"
"10","005","00","005","0514","0389","929","776","153","60","989","1799","0","54.97","43.14"
"10","005","00","005","0515","0000","2221","1849","372","90","2311","3884","0","59.5","47.61"
"10","005","00","005","0515","0367","767","636","131","30","797","1326","0","60.11","47.96"
"10","005","00","005","0515","0368","775","656","119","26","801","1270","0","63.07","51.65"
"10","005","00","005","0515","0369","679","557","122","34","713","1288","0","55.36","43.25"
"10","005","00","005","0516","0000","2084","1747","337","65","2149","3830","0","56.11","45.61"
"10","005","00","005","0516","0364","740","614","126","32","772","1338","0","57.7","45.89"
"10","005","00","005","0516","0365","757","629","128","15","772","1450","0","53.24","43.38"
"10","005","00","005","0516","0366","587","504","83","18","605","1042","0","58.06","48.37"
"10","005","00","005","0517","0000","1624","1359","265","64","1688","3125","0","54.02","43.49"
"10","005","00","005","0517","0376","848","721","127","29","877","1551","0","56.54","46.49"
"10","005","00","005","0517","0377","776","638","138","35","811","1574","0","51.52","40.53"
"10","005","00","005","0518","0000","2001","1620","381","92","2093","3984","0","52.54","40.66"
"10","005","00","005","0518","0390","634","518","116","28","662","1141","0","58.02","45.4"
"10","005","00","005","0518","0391","740","580","160","41","781","1431","0","54.58","40.53"
"10","005","00","005","0518","0392","627","522","105","23","650","1412","0","46.03","36.97"
"10","005","00","005","0519","0000","752","585","167","48","800","1344","0","59.52","43.53"
"10","005","00","005","0519","0395","752","585","167","48","800","1344","0","59.52","43.53"
"10","005","00","005","0520","0000","915","712","203","57","972","1990","0","48.84","35.78"
"10","005","00","005","0520","0359","538","409","129","42","580","975","0","59.49","41.95"
"10","005","00","005","0520","0360","377","303","74","15","392","1015","0","38.62","29.85"
"10","005","00","005","0521","0000","1461","1176","285","88","1549","2542","0","60.94","46.26"
"10","005","00","005","0521","0361","816","656","160","48","864","1399","0","61.76","46.89"
"10","005","00","005","0521","0362","645","520","125","40","685","1143","0","59.93","45.49"
"10","005","00","005","0522","0000","797","655","142","46","843","1363","0","61.85","48.06"
"10","005","00","005","0522","0396","797","655","142","46","843","1363","0","61.85","48.06"
"10","005","00","005","0523","0000","1402","1130","272","79","1481","2595","0","57.07","43.55"
"10","005","00","005","0523","0398","659","532","127","49","708","1182","0","59.9","45.01"
"10","005","00","005","0523","0399","743","598","145","30","773","1413","0","54.71","42.32"
"10","005","00","005","0524","0000","520","421","99","42","562","898","0","62.58","46.88"
"10","005","00","005","0524","0397","520","421","99","42","562","898","0","62.58","46.88"
"10","005","00","005","0525","0000","1252","989","263","59","1311","2171","0","60.39","45.56"
"10","005","00","005","0525","0400","589","468","121","27","616","991","0","62.16","47.23"
"10","005","00","005","0525","0401","663","521","142","32","695","1180","0","58.9","44.15"
"10","005","00","005","0526","0000","1119","907","212","49","1168","2048","0","57.03","44.29"
"10","005","00","005","0526","0386","574","467","107","24","598","993","0","60.22","47.03"
"10","005","00","005","0526","0387","545","440","105","25","570","1055","0","54.03","41.71"
"10","005","00","005","0527","0000","1233","1012","221","73","1306","2319","0","56.32","43.64"
"10","005","00","005","0527","0393","530","425","105","34","564","1074","0","52.51","39.57"
"10","005","00","005","0527","0394","703","587","116","39","742","1245","0","59.6","47.15"
"10","005","00","005","0528","0000","1995","1640","355","103","2098","3507","0","59.82","46.76"
"10","005","00","005","0528","0378","688","560","128","31","719","1262","0","56.97","44.37"
"10","005","00","005","0528","0379","650","545","105","36","686","1171","0","58.58","46.54"
"10","005","00","005","0528","0380","657","535","122","36","693","1074","0","64.53","49.81"
"10","005","00","005","0529","0000","1999","1614","385","89","2088","3586","0","58.23","45.01"
"10","005","00","005","0529","0381","675","535","140","28","703","1141","0","61.61","46.89"
"10","005","00","005","0529","0382","698","557","141","32","730","1259","0","57.98","44.24"
"10","005","00","005","0529","0383","626","522","104","29","655","1186","0","55.23","44.01"
"10","005","00","005","0530","0000","1069","885","184","55","1124","2022","0","55.59","43.77"
"10","005","00","005","0530","0354","532","435","97","28","560","985","0","56.85","44.16"
"10","005","00","005","0530","0355","537","450","87","27","564","1037","0","54.39","43.39"
"10","005","00","005","0531","0000","1408","1184","224","59","1467","2523","0","58.15","46.93"
"10","005","00","005","0531","0370","681","573","108","34","715","1243","0","57.52","46.1"
"10","005","00","005","0531","0371","727","611","116","25","752","1280","0","58.75","47.73"
"10","005","00","005","0532","0000","1755","1446","309","84","1839","3377","0","54.46","42.82"
"10","005","00","005","0532","0372","855","698","157","51","906","1618","0","56.0","43.14"
"10","005","00","005","0532","0373","900","748","152","33","933","1759","0","53.04","42.52"
"10","005","00","005","0533","0000","1447","1202","245","68","1515","2590","0","58.49","46.41"
"10","005","00","005","0533","0374","714","586","128","36","750","1264","0","59.34","46.36"
"10","005","00","005","0533","0375","733","616","117","32","765","1326","0","57.69","46.46"
"10","005","00","006","0000","0000","15558","12288","3270","1426","16984","30948","36332","54.88","39.71"
"10","005","00","006","0601","0000","821","642","179","78","899","1473","0","61.03","43.58"
"10","005","00","006","0601","0223","310","236","74","31","341","590","0","57.8","40.0"
"10","005","00","006","0601","0224","511","406","105","47","558","883","0","63.19","45.98"
"10","005","00","006","0602","0000","445","348","97","49","494","793","0","62.3","43.88"
"10","005","00","006","0602","0225","445","348","97","49","494","793","0","62.3","43.88"
"10","005","00","006","0603","0000","734","548","186","63","797","1324","0","60.2","41.39"
"10","005","00","006","0603","0226","409","311","98","30","439","732","0","59.97","42.49"
"10","005","00","006","0603","0227","325","237","88","33","358","592","0","60.47","40.03"
"10","005","00","006","0604","0000","2234","1798","436","161","2395","4218","0","56.78","42.63"
"10","005","00","006","0604","0228","622","477","145","41","663","1113","0","59.57","42.86"
"10","005","00","006","0604","0229","627","516","111","50","677","1195","0","56.65","43.18"
"10","005","00","006","0604","0230","579","477","102","41","620","997","0","62.19","47.84"
"10","005","00","006","0604","0231","406","328","78","29","435","913","0","47.65","35.93"
"10","005","00","006","0605","0000","1171","921","250","103","1274","2304","0","55.3","39.97"
"10","005","00","006","0605","0246","577","448","129","48","625","1107","0","56.46","40.47"
"10","005","00","006","0605","0247","594","473","121","55","649","1197","0","54.22","39.52"
"10","005","00","006","0606","0000","792","641","151","60","852","1216","0","70.07","52.71"
"10","005","00","006","0606","0236","792","641","151","60","852","1216","0","70.07","52.71"
"10","005","00","006","0607","0000","505","416","89","28","533","977","0","54.55","42.58"
"10","005","00","006","0607","0237","505","416","89","28","533","977","0","54.55","42.58"
"10","005","00","006","0608","0000","1321","1024","297","149","1470","2704","0","54.36","37.87"
"10","005","00","006","0608","0238","422","320","102","53","475","943","0","50.37","33.93"
"10","005","00","006","0608","0239","470","352","118","51","521","910","0","57.25","38.68"
"10","005","00","006","0608","0240","429","352","77","45","474","851","0","55.7","41.36"
"10","005","00","006","0609","0000","766","616","150","73","839","1375","0","61.02","44.8"
"10","005","00","006","0609","0241","417","335","82","33","450","725","0","62.07","46.21"
"10","005","00","006","0609","0242","349","281","68","40","389","650","0","59.85","43.23"
"10","005","00","006","0610","0000","322","254","68","46","368","706","0","52.12","35.98"
"10","005","00","006","0610","0243","322","254","68","46","368","706","0","52.12","35.98"
"10","005","00","006","0611","0000","713","571","142","59","772","1489","0","51.85","38.35"
"10","005","00","006","0611","0232","307","241","66","28","335","641","0","52.26","37.6"
"10","005","00","006","0611","0233","406","330","76","31","437","848","0","51.53","38.92"
"10","005","00","006","0612","0000","720","569","151","86","806","1549","0","52.03","36.73"
"10","005","00","006","0612","0244","380","292","88","51","431","748","0","57.62","39.04"
"10","005","00","006","0612","0245","340","277","63","35","375","801","0","46.82","34.58"
"10","005","00","006","0613","0000","626","486","140","76","702","1264","0","55.54","38.45"
"10","005","00","006","0613","0234","626","486","140","76","702","1264","0","55.54","38.45"
"10","005","00","006","0614","0000","456","364","92","33","489","965","0","50.67","37.72"
"10","005","00","006","0614","0235","456","364","92","33","489","965","0","50.67","37.72"
"10","005","00","006","0615","0000","485","392","93","41","526","1036","0","50.77","37.84"
"10","005","00","006","0615","0248","485","392","93","41","526","1036","0","50.77","37.84"
"10","005","00","006","0616","0000","373","281","92","39","412","913","0","45.13","30.78"
"10","005","00","006","0616","0249","373","281","92","39","412","913","0","45.13","30.78"
"10","005","00","006","0617","0000","402","325","77","38","440","719","0","61.2","45.2"
"10","005","00","006","0617","0250","402","325","77","38","440","719","0","61.2","45.2"
"10","005","00","006","0618","0000","513","419","94","86","599","1037","0","57.76","40.41"
"10","005","00","006","0618","0251","513","419","94","86","599","1037","0","57.76","40.41"
"10","005","00","006","0619","0000","291","234","57","15","306","601","0","50.92","38.94"
"10","005","00","006","0619","0252","291","234","57","15","306","601","0","50.92","38.94"
"10","005","00","006","0620","0000","536","411","125","42","578","1269","0","45.55","32.39"
"10","005","00","006","0620","0253","536","411","125","42","578","1269","0","45.55","32.39"
"10","005","00","006","0621","0000","334","263","71","22","356","735","0","48.44","35.78"
"10","005","00","006","0621","0254","334","263","71","22","356","735","0","48.44","35.78"
"10","005","00","006","0622","0000","473","363","110","29","502","1047","0","47.95","34.67"
"10","005","00","006","0622","0255","135","99","36","9","144","422","0","34.12","23.46"
"10","005","00","006","0622","0256","338","264","74","20","358","625","0","57.28","42.24"
"10","005","00","006","0623","0000","525","402","123","50","575","1234","0","46.6","32.58"
"10","005","00","006","0623","0257","525","402","123","50","575","1234","0","46.6","32.58"
"10","005","00","007","0000","0000","8003","6482","1521","538","8541","14772","16818","57.82","43.88"
"10","005","00","007","0701","0000","423","341","82","24","447","745","0","60.0","45.77"
"10","005","00","007","0701","0445","423","341","82","24","447","745","0","60.0","45.77"
"10","005","00","007","0702","0000","745","606","139","40","785","1528","0","51.37","39.66"
"10","005","00","007","0702","0446","405","325","80","24","429","783","0","54.79","41.51"
"10","005","00","007","0702","0447","340","281","59","16","356","745","0","47.79","37.72"
"10","005","00","007","0703","0000","1194","960","234","106","1300","2079","0","62.53","46.18"
"10","005","00","007","0703","0451","493","398","95","43","536","865","0","61.97","46.01"
"10","005","00","007","0703","0452","484","381","103","36","520","828","0","62.8","46.01"
"10","005","00","007","0703","0453","217","181","36","27","244","386","0","63.21","46.89"
"10","005","00","007","0704","0000","460","383","77","22","482","999","0","48.25","38.34"
"10","005","00","007","0704","0448","460","383","77","22","482","999","0","48.25","38.34"
"10","005","00","007","0705","0000","431","363","68","30","461","757","0","60.9","47.95"
"10","005","00","007","0705","0449","390","324","66","28","418","671","0","62.3","48.29"
"10","005","00","007","0705","0459","41","39","2","2","43","86","0","50.0","45.35"
"10","005","00","007","0706","0000","497","410","87","10","507","940","0","53.94","43.62"
"10","005","00","007","0706","0460","497","410","87","10","507","940","0","53.94","43.62"
"10","005","00","007","0707","0000","1066","882","184","92","1158","1978","0","58.54","44.59"
"10","005","00","007","0707","0442","544","468","76","42","586","961","0","60.98","48.7"
"10","005","00","007","0707","0443","522","414","108","50","572","1017","0","56.24","40.71"
"10","005","00","007","0708","0000","649","498","151","51","700","1095","0","63.93","45.48"
"10","005","00","007","0708","0444","649","498","151","51","700","1095","0","63.93","45.48"
"10","005","00","007","0709","0000","1274","1006","268","91","1365","2209","0","61.79","45.54"
"10","005","00","007","0709","0454","408","328","80","36","444","688","0","64.53","47.67"
"10","005","00","007","0709","0455","457","348","109","34","491","792","0","61.99","43.94"
"10","005","00","007","0709","0456","409","330","79","21","430","729","0","58.98","45.27"
"10","005","00","007","0710","0000","438","358","80","41","479","734","0","65.26","48.77"
"10","005","00","007","0710","0450","438","358","80","41","479","734","0","65.26","48.77"
"10","005","00","007","0711","0000","826","675","151","31","857","1708","0","50.18","39.52"
"10","005","00","007","0711","0457","488","388","100","24","512","1093","0","46.84","35.5"
"10","005","00","007","0711","0458","338","287","51","7","345","615","0","56.1","46.67"
"10","005","00","008","0000","0000","6265","5128","1137","458","6723","12653","14521","53.13","40.53"
"10","005","00","008","0801","0000","843","700","143","45","888","1625","0","54.65","43.08"
"10","005","00","008","0801","0420","382","312","70","21","403","744","0","54.17","41.94"
"10","005","00","008","0801","0421","461","388","73","24","485","881","0","55.05","44.04"
"10","005","00","008","0802","0000","306","253","53","33","339","596","0","56.88","42.45"
"10","005","00","008","0802","0422","306","253","53","33","339","596","0","56.88","42.45"
"10","005","00","008","0803","0000","912","769","143","53","965","1790","0","53.91","42.96"
"10","005","00","008","0803","0424","433","362","71","22","455","867","0","52.48","41.75"
"10","005","00","008","0803","0425","479","407","72","31","510","923","0","55.25","44.1"
"10","005","00","008","0804","0000","665","528","137","72","737","1395","0","52.83","37.85"
"10","005","00","008","0804","0426","665","528","137","72","737","1395","0","52.83","37.85"
"10","005","00","008","0805","0000","187","149","38","15","202","561","0","36.01","26.56"
"10","005","00","008","0805","0427","187","149","38","15","202","561","0","36.01","26.56"
"10","005","00","008","0806","0000","598","477","121","54","652","1260","0","51.75","37.86"
"10","005","00","008","0806","0423","598","477","121","54","652","1260","0","51.75","37.86"
"10","005","00","008","0807","0000","351","274","77","19","370","638","0","57.99","42.95"
"10","005","00","008","0807","0428","351","274","77","19","370","638","0","57.99","42.95"
"10","005","00","008","0808","0000","713","583","130","53","766","1495","0","51.24","39.0"
"10","005","00","008","0808","0431","325","270","55","33","358","652","0","54.91","41.41"
"10","005","00","008","0808","0432","388","313","75","20","408","843","0","48.4","37.13"
"10","005","00","008","0809","0000","368","299","69","32","400","754","0","53.05","39.66"
"10","005","00","008","0809","0429","368","299","69","32","400","754","0","53.05","39.66"
"10","005","00","008","0810","0000","234","186","48","13","247","501","0","49.3","37.13"
"10","005","00","008","0810","0430","234","186","48","13","247","501","0","49.3","37.13"
"10","005","00","008","0811","0000","540","449","91","38","578","1020","0","56.67","44.02"
"10","005","00","008","0811","0433","540","449","91","38","578","1020","0","56.67","44.02"
"10","005","00","008","0812","0000","548","461","87","31","579","1018","0","56.88","45.28"
"10","005","00","008","0812","0434","548","461","87","31","579","1018","0","56.88","45.28"
"10","005","00","009","0000","0000","15661","12634","3027","1054","16715","28318","33327","59.03","44.61"
"10","005","00","009","0901","0000","966","770","196","75","1041","1581","0","65.84","48.7"
"10","005","00","009","0901","0068","477","365","112","43","520","789","0","65.91","46.26"
"10","005","00","009","0901","0069","489","405","84","32","521","792","0","65.78","51.14"
"10","005","00","009","0902","0000","1383","1079","304","119","1502","2372","0","63.32","45.49"
"10","005","00","009","0902","0070","652","505","147","65","717","1117","0","64.19","45.21"
"10","005","00","009","0902","0071","731","574","157","54","785","1255","0","62.55","45.74"
"10","005","00","009","0903","0000","1969","1606","363","97","2066","3413","0","60.53","47.06"
"10","005","00","009","0903","0072","650","532","118","34","684","1141","0","59.95","46.63"
"10","005","00","009","0903","0073","657","532","125","30","687","1172","0","58.62","45.39"
"10","005","00","009","0903","0074","662","542","120","33","695","1100","0","63.18","49.27"
"10","005","00","009","0904","0000","503","403","100","50","553","964","0","57.37","41.8"
"10","005","00","009","0904","0079","503","403","100","50","553","964","0","57.37","41.8"
"10","005","00","009","0905","0000","1138","927","211","83","1221","2313","0","52.79","40.08"
"10","005","00","009","0905","0075","611","496","115","41","652","1232","0","52.92","40.26"
"10","005","00","009","0905","0076","527","431","96","42","569","1081","0","52.64","39.87"
"10","005","00","009","0906","0000","1327","1108","219","79","1406","2331","0","60.32","47.53"
"10","005","00","009","0906","0077","729","628","101","46","775","1250","0","62.0","50.24"
"10","005","00","009","0906","0078","598","480","118","33","631","1081","0","58.37","44.4"
"10","005","00","009","0907","0000","816","659","157","49","865","1507","0","57.4","43.73"
"10","005","00","009","0907","0084","414","333","81","16","430","719","0","59.81","46.31"
"10","005","00","009","0907","0085","402","326","76","33","435","788","0","55.2","41.37"
"10","005","00","009","0908","0000","585","459","126","47","632","1038","0","60.89","44.22"
"10","005","00","009","0908","0080","585","459","126","47","632","1038","0","60.89","44.22"
"10","005","00","009","0909","0000","1073","858","215","77","1150","2031","0","56.62","42.25"
"10","005","00","009","0909","0082","455","362","93","43","498","865","0","57.57","41.85"
"10","005","00","009","0909","0083","618","496","122","34","652","1166","0","55.92","42.54"
"10","005","00","009","0910","0000","175","140","35","27","202","303","0","66.67","46.2"
"10","005","00","009","0910","0086","175","140","35","27","202","303","0","66.67","46.2"
"10","005","00","009","0911","0000","212","159","53","15","227","360","0","63.06","44.17"
"10","005","00","009","0911","0081","212","159","53","15","227","360","0","63.06","44.17"
"10","005","00","009","0912","0000","1254","1015","239","75","1329","2255","0","58.94","45.01"
"10","005","00","009","0912","0087","756","614","142","38","794","1322","0","60.06","46.44"
"10","005","00","009","0912","0088","498","401","97","37","535","933","0","57.34","42.98"
"10","005","00","009","0913","0000","747","616","131","45","792","1455","0","54.43","42.34"
"10","005","00","009","0913","0089","747","616","131","45","792","1455","0","54.43","42.34"
"10","005","00","009","0914","0000","934","753","181","65","999","1615","0","61.86","46.63"
"10","005","00","009","0914","0090","934","753","181","65","999","1615","0","61.86","46.63"
"10","005","00","009","0915","0000","762","628","134","43","805","1451","0","55.48","43.28"
"10","005","00","009","0915","0091","762","628","134","43","805","1451","0","55.48","43.28"
"10","005","00","009","0916","0000","696","552","144","41","737","1317","0","55.96","41.91"
"10","005","00","009","0916","0093","696","552","144","41","737","1317","0","55.96","41.91"
"10","005","00","009","0917","0000","832","666","166","50","882","1462","0","60.33","45.55"
"10","005","00","009","0917","0092","832","666","166","50","882","1462","0","60.33","45.55"
"10","005","00","009","0918","0000","123","103","20","8","131","221","0","59.28","46.61"
"10","005","00","009","0918","0094","123","103","20","8","131","221","0","59.28","46.61"
"10","005","00","009","0919","0000","166","133","33","9","175","329","0","53.19","40.43"
"10","005","00","009","0919","0095","166","133","33","9","175","329","0","53.19","40.43"
"10","005","00","010","0000","0000","8198","6726","1472","444","8642","15424","17922","56.03","43.61"
"10","005","00","010","1001","0000","563","484","79","33","596","1029","0","57.92","47.04"
"10","005","00","010","1001","0114","563","484","79","33","596","1029","0","57.92","47.04"
"10","005","00","010","1002","0000","2560","2107","453","116","2676","4463","0","59.96","47.21"
"10","005","00","010","1002","0108","523","438","85","25","548","887","0","61.78","49.38"
"10","005","00","010","1002","0109","593","492","101","37","630","1052","0","59.89","46.77"
"10","005","00","010","1002","0110","799","648","151","27","826","1347","0","61.32","48.11"
"10","005","00","010","1002","0111","645","529","116","27","672","1177","0","57.09","44.94"
"10","005","00","010","1003","0000","934","768","166","53","987","1655","0","59.64","46.4"
"10","005","00","010","1003","0115","495","421","74","26","521","905","0","57.57","46.52"
"10","005","00","010","1003","0116","439","347","92","27","466","750","0","62.13","46.27"
"10","005","00","010","1004","0000","650","528","122","33","683","1268","0","53.86","41.64"
"10","005","00","010","1004","0112","650","528","122","33","683","1268","0","53.86","41.64"
"10","005","00","010","1005","0000","551","440","111","26","577","1185","0","48.69","37.13"
"10","005","00","010","1005","0113","551","440","111","26","577","1185","0","48.69","37.13"
"10","005","00","010","1006","0000","532","437","95","32","564","1080","0","52.22","40.46"
"10","005","00","010","1006","0117","532","437","95","32","564","1080","0","52.22","40.46"
"10","005","00","010","1007","0000","1625","1326","299","80","1705","3186","0","53.52","41.62"
"10","005","00","010","1007","0118","568","450","118","33","601","1108","0","54.24","40.61"
"10","005","00","010","1007","0119","432","376","56","25","457","862","0","53.02","43.62"
"10","005","00","010","1007","0120","625","500","125","22","647","1216","0","53.21","41.12"
"10","005","00","010","1008","0000","277","223","54","26","303","588","0","51.53","37.93"
"10","005","00","010","1008","0121","277","223","54","26","303","588","0","51.53","37.93"
"10","005","00","010","1009","0000","208","165","43","26","234","429","0","54.55","38.46"
"10","005","00","010","1009","0122","208","165","43","26","234","429","0","54.55","38.46"
"10","005","00","010","1010","0000","298","248","50","19","317","541","0","58.6","45.84"
"10","005","00","010","1010","0123","298","248","50","19","317","541","0","58.6","45.84"
"10","005","00","011","0000","0000","3997","3104","893","311","4308","8784","10130","49.04","35.34"
"10","005","00","011","1101","0000","588","473","115","51","639","1155","0","55.32","40.95"
"10","005","00","011","1101","0411","588","473","115","51","639","1155","0","55.32","40.95"
"10","005","00","011","1102","0000","324","252","72","43","367","650","0","56.46","38.77"
"10","005","00","011","1102","0412","324","252","72","43","367","650","0","56.46","38.77"
"10","005","00","011","1103","0000","641","407","234","58","699","1353","0","51.66","30.08"
"10","005","00","011","1103","0413","641","407","234","58","699","1353","0","51.66","30.08"
"10","005","00","011","1104","0000","326","276","50","29","355","813","0","43.67","33.95"
"10","005","00","011","1104","0414","326","276","50","29","355","813","0","43.67","33.95"
"10","005","00","011","1105","0000","335","274","61","22","357","837","0","42.65","32.74"
"10","005","00","011","1105","0415","335","274","61","22","357","837","0","42.65","32.74"
"10","005","00","011","1106","0000","549","446","103","25","574","1093","0","52.52","40.81"
"10","005","00","011","1106","0416","549","446","103","25","574","1093","0","52.52","40.81"
"10","005","00","011","1107","0000","520","390","130","50","570","1048","0","54.39","37.21"
"10","005","00","011","1107","0417","520","390","130","50","570","1048","0","54.39","37.21"
"10","005","00","011","1108","0000","420","340","80","27","447","872","0","51.26","38.99"
"10","005","00","011","1108","0418","420","340","80","27","447","872","0","51.26","38.99"
"10","005","00","011","1109","0000","294","246","48","6","300","963","0","31.15","25.55"
"10","005","00","011","1109","0419","294","246","48","6","300","963","0","31.15","25.55"
"10","005","00","012","0000","0000","5778","4766","1012","308","6086","9390","10711","64.81","50.76"
"10","005","00","012","1201","0000","1630","1388","242","92","1722","2503","0","68.8","55.45"
"10","005","00","012","1201","0096","849","751","98","44","893","1335","0","66.89","56.25"
"10","005","00","012","1201","0097","781","637","144","48","829","1168","0","70.98","54.54"
"10","005","00","012","1202","0000","1055","846","209","42","1097","1851","0","59.27","45.71"
"10","005","00","012","1202","0103","487","377","110","17","504","844","0","59.72","44.67"
"10","005","00","012","1202","0104","568","469","99","25","593","1007","0","58.89","46.57"
"10","005","00","012","1203","0000","438","364","74","24","462","725","0","63.72","50.21"
"10","005","00","012","1203","0100","438","364","74","24","462","725","0","63.72","50.21"
"10","005","00","012","1204","0000","1116","901","215","58","1174","1710","0","68.65","52.69"
"10","005","00","012","1204","0098","496","386","110","20","516","792","0","65.15","48.74"
"10","005","00","012","1204","0099","620","515","105","38","658","918","0","71.68","56.1"
"10","005","00","012","1205","0000","534","445","89","22","556","899","0","61.85","49.5"
"10","005","00","012","1205","0101","534","445","89","22","556","899","0","61.85","49.5"
"10","005","00","012","1206","0000","171","139","32","10","181","369","0","49.05","37.67"
"10","005","00","012","1206","0102","171","139","32","10","181","369","0","49.05","37.67"
"10","005","00","012","1207","0000","615","514","101","42","657","1005","0","65.37","51.14"
"10","005","00","012","1207","0105","472","394","78","28","500","794","0","62.97","49.62"
"10","005","00","012","1207","0106","143","120","23","14","157","211","0","74.41","56.87"
"10","005","00","012","1208","0000","219","169","50","18","237","328","0","72.26","51.52"
"10","005","00","012","1208","0107","219","169","50","18","237","328","0","72.26","51.52"
"10","005","00","013","0000","0000","7722","6388","1334","413","8135","13889","16277","58.57","45.99"
"10","005","00","013","1301","0000","2316","1928","388","114","2430","4132","0","58.81","46.66"
"10","005","00","013","1301","0124","489","405","84","34","523","853","0","61.31","47.48"
"10","005","00","013","1301","0125","588","500","88","23","611","983","0","62.16","50.86"
"10","005","00","013","1301","0126","613","509","104","35","648","1080","0","60.0","47.13"
"10","005","00","013","1301","0127","626","514","112","22","648","1216","0","53.29","42.27"
"10","005","00","013","1302","0000","959","775","184","45","1004","1825","0","55.01","42.47"
"10","005","00","013","1302","0132","482","386","96","33","515","991","0","51.97","38.95"
"10","005","00","013","1302","0133","477","389","88","12","489","834","0","58.63","46.64"
"10","005","00","013","1303","0000","769","624","145","56","825","1371","0","60.18","45.51"
"10","005","00","013","1303","0134","342","276","66","24","366","622","0","58.84","44.37"
"10","005","00","013","1303","0135","427","348","79","32","459","749","0","61.28","46.46"
"10","005","00","013","1304","0000","1847","1570","277","72","1919","3395","0","56.52","46.24"
"10","005","00","013","1304","0128","578","493","85","25","603","1017","0","59.29","48.48"
"10","005","00","013","1304","0129","600","504","96","32","632","1180","0","53.56","42.71"
"10","005","00","013","1304","0130","669","573","96","15","684","1198","0","57.1","47.83"
"10","005","00","013","1305","0000","939","770","169","56","995","1451","0","68.57","53.07"
"10","005","00","013","1305","0136","439","364","75","21","460","692","0","66.47","52.6"
"10","005","00","013","1305","0137","500","406","94","35","535","759","0","70.49","53.49"
"10","005","00","013","1306","0000","224","185","39","17","241","417","0","57.79","44.36"
"10","005","00","013","1306","0131","224","185","39","17","241","417","0","57.79","44.36"
"10","005","00","013","1307","0000","668","536","132","53","721","1298","0","55.55","41.29"
"10","005","00","013","1307","0138","312","258","54","23","335","629","0","53.26","41.02"
"10","005","00","013","1307","0139","356","278","78","30","386","669","0","57.7","41.55"
"10","005","00","014","0000","0000","3341","2724","617","184","3525","6382","7072","55.23","42.68"
"10","005","00","014","1401","0000","311","253","58","14","325","601","0","54.08","42.1"
"10","005","00","014","1401","0140","311","253","58","14","325","601","0","54.08","42.1"
"10","005","00","014","1402","0000","322","277","45","19","341","566","0","60.25","48.94"
"10","005","00","014","1402","0141","322","277","45","19","341","566","0","60.25","48.94"
"10","005","00","014","1403","0000","464","371","93","26","490","843","0","58.13","44.01"
"10","005","00","014","1403","0142","464","371","93","26","490","843","0","58.13","44.01"
"10","005","00","014","1404","0000","329","259","70","13","342","648","0","52.78","39.97"
"10","005","00","014","1404","0143","329","259","70","13","342","648","0","52.78","39.97"
"10","005","00","014","1405","0000","282","237","45","13","295","515","0","57.28","46.02"
"10","005","00","014","1405","0146","282","237","45","13","295","515","0","57.28","46.02"
"10","005","00","014","1406","0000","241","199","42","6","247","461","0","53.58","43.17"
"10","005","00","014","1406","0145","241","199","42","6","247","461","0","53.58","43.17"
"10","005","00","014","1407","0000","455","360","95","19","474","936","0","50.64","38.46"
"10","005","00","014","1407","0144","455","360","95","19","474","936","0","50.64","38.46"
"10","005","00","014","1408","0000","566","464","102","49","615","1141","0","53.9","40.67"
"10","005","00","014","1408","0147","566","464","102","49","615","1141","0","53.9","40.67"
"10","005","00","014","1409","0000","371","304","67","25","396","671","0","59.02","45.31"
"10","005","00","014","1409","0148","371","304","67","25","396","671","0","59.02","45.31"
"10","005","00","015","0000","0000","5900","4744","1156","515","6415","11027","12728","58.18","43.02"
"10","005","00","015","1501","0000","1204","993","211","85","1289","2060","0","62.57","48.2"
"10","005","00","015","1501","0258","712","590","122","52","764","1171","0","65.24","50.38"
"10","005","00","015","1501","0259","492","403","89","33","525","889","0","59.06","45.33"
"10","005","00","015","1502","0000","218","186","32","18","236","479","0","49.27","38.83"
"10","005","00","015","1502","0260","218","186","32","18","236","479","0","49.27","38.83"
"10","005","00","015","1503","0000","558","451","107","44","602","1024","0","58.79","44.04"
"10","005","00","015","1503","0261","558","451","107","44","602","1024","0","58.79","44.04"
"10","005","00","015","1504","0000","1681","1325","356","144","1825","3442","0","53.02","38.5"
"10","005","00","015","1504","0262","603","447","156","54","657","1214","0","54.12","36.82"
"10","005","00","015","1504","0263","523","426","97","39","562","1071","0","52.47","39.78"
"10","005","00","015","1504","0264","555","452","103","51","606","1157","0","52.38","39.07"
"10","005","00","015","1505","0000","271","224","47","26","297","512","0","58.01","43.75"
"10","005","00","015","1505","0265","271","224","47","26","297","512","0","58.01","43.75"
"10","005","00","015","1506","0000","289","245","44","21","310","491","0","63.14","49.9"
"10","005","00","015","1506","0266","289","245","44","21","310","491","0","63.14","49.9"
"10","005","00","015","1507","0000","712","581","131","54","766","1272","0","60.22","45.68"
"10","005","00","015","1507","0267","712","581","131","54","766","1272","0","60.22","45.68"
"10","005","00","015","1508","0000","418","333","85","33","451","785","0","57.45","42.42"
"10","005","00","015","1508","0268","418","333","85","33","451","785","0","57.45","42.42"
"10","005","00","015","1509","0000","549","406","143","90","639","962","0","66.42","42.2"
"10","005","00","015","1509","0269","549","406","143","90","639","962","0","66.42","42.2"
"10","005","00","016","0000","0000","3115","2464","651","260","3375","5852","6662","57.67","42.11"
"10","005","00","016","1601","0000","1191","957","234","95","1286","2201","0","58.43","43.48"
"10","005","00","016","1601","0402","559","462","97","36","595","996","0","59.74","46.39"
"10","005","00","016","1601","0403","632","495","137","59","691","1205","0","57.34","41.08"
"10","005","00","016","1602","0000","354","274","80","33","387","635","0","60.94","43.15"
"10","005","00","016","1602","0404","354","274","80","33","387","635","0","60.94","43.15"
"10","005","00","016","1603","0000","454","351","103","39","493","862","0","57.19","40.72"
"10","005","00","016","1603","0405","454","351","103","39","493","862","0","57.19","40.72"
"10","005","00","016","1604","0000","109","92","17","9","118","238","0","49.58","38.66"
"10","005","00","016","1604","0406","109","92","17","9","118","238","0","49.58","38.66"
"10","005","00","016","1605","0000","270","215","55","23","293","541","0","54.16","39.74"
"10","005","00","016","1605","0407","270","215","55","23","293","541","0","54.16","39.74"
"10","005","00","016","1606","0000","276","217","59","22","298","578","0","51.56","37.54"
"10","005","00","016","1606","0408","276","217","59","22","298","578","0","51.56","37.54"
"10","005","00","016","1607","0000","252","192","60","26","278","405","0","68.64","47.41"
"10","005","00","016","1607","0409","252","192","60","26","278","405","0","68.64","47.41"
"10","005","00","016","1608","0000","209","166","43","13","222","392","0","56.63","42.35"
"10","005","00","016","1608","0410","209","166","43","13","222","392","0","56.63","42.35"
"10","005","00","017","0000","0000","1876","1552","324","143","2019","3968","4370","50.88","39.11"
"10","005","00","017","1701","0000","121","108","13","6","127","328","0","38.72","32.93"
"10","005","00","017","1701","0435","121","108","13","6","127","328","0","38.72","32.93"
"10","005","00","017","1702","0000","218","178","40","30","248","565","0","43.89","31.5"
"10","005","00","017","1702","0436","218","178","40","30","248","565","0","43.89","31.5"
"10","005","00","017","1703","0000","475","389","86","49","524","911","0","57.52","42.7"
"10","005","00","017","1703","0437","475","389","86","49","524","911","0","57.52","42.7"
"10","005","00","017","1704","0000","251","197","54","17","268","568","0","47.18","34.68"
"10","005","00","017","1704","0438","251","197","54","17","268","568","0","47.18","34.68"
"10","005","00","017","1705","0000","321","265","56","20","341","580","0","58.79","45.69"
"10","005","00","017","1705","0439","321","265","56","20","341","580","0","58.79","45.69"
"10","005","00","017","1706","0000","161","139","22","5","166","333","0","49.85","41.74"
"10","005","00","017","1706","0440","161","139","22","5","166","333","0","49.85","41.74"
"10","005","00","017","1707","0000","329","276","53","16","345","683","0","50.51","40.41"
"10","005","00","017","1707","0441","329","276","53","16","345","683","0","50.51","40.41"
"10","005","00","018","0000","0000","3134","2518","616","240","3374","5180","6076","65.14","48.61"
"10","005","00","018","1801","0000","137","109","28","10","147","325","0","45.23","33.54"
"10","005","00","018","1801","0461","137","109","28","10","147","325","0","45.23","33.54"
"10","005","00","018","1802","0000","705","551","154","66","771","1150","0","67.04","47.91"
"10","005","00","018","1802","0462","263","207","56","22","285","484","0","58.88","42.77"
"10","005","00","018","1802","0463","442","344","98","44","486","666","0","72.97","51.65"
"10","005","00","018","1803","0000","512","420","92","49","561","907","0","61.85","46.31"
"10","005","00","018","1803","0464","352","282","70","38","390","574","0","67.94","49.13"
"10","005","00","018","1803","0465","160","138","22","11","171","333","0","51.35","41.44"
"10","005","00","018","1804","0000","323","272","51","12","335","495","0","67.68","54.95"
"10","005","00","018","1804","0466","323","272","51","12","335","495","0","67.68","54.95"
"10","005","00","018","1805","0000","360","290","70","32","392","544","0","72.06","53.31"
"10","005","00","018","1805","0467","360","290","70","32","392","544","0","72.06","53.31"
"10","005","00","018","1806","0000","221","173","48","15","236","500","0","47.2","34.6"
"10","005","00","018","1806","0468","221","173","48","15","236","500","0","47.2","34.6"
"10","005","00","018","1807","0000","428","332","96","51","479","670","0","71.49","49.55"
"10","005","00","018","1807","0469","428","332","96","51","479","670","0","71.49","49.55"
"10","005","00","018","1808","0000","448","371","77","5","453","589","0","76.91","62.99"
"10","005","00","018","1808","0470","448","371","77","5","453","589","0","76.91","62.99"
"10","007","00","000","0000","0000","563364","452334","111030","45223","608587","1066994","1278437","57.04","42.39"
"10","007","00","001","0000","0000","107662","85910","21752","7322","114984","190995","232709","60.2","44.98"
"10","007","00","001","0101","0000","783","606","177","47","830","1295","0","64.09","46.8"
"10","007","00","001","0101","0117","399","303","96","26","425","662","0","64.2","45.77"
"10","007","00","001","0101","0118","384","303","81","21","405","633","0","63.98","47.87"
"10","007","00","001","0102","0000","2876","2315","561","199","3075","5001","0","61.49","46.29"
"10","007","00","001","0102","0125","687","540","147","74","761","1263","0","60.25","42.76"
"10","007","00","001","0102","0126","758","626","132","39","797","1268","0","62.85","49.37"
"10","007","00","001","0102","0127","715","569","146","57","772","1258","0","61.37","45.23"
"10","007","00","001","0102","0128","716","580","136","29","745","1212","0","61.47","47.85"
"10","007","00","001","0103","0000","941","717","224","62","1003","1656","0","60.57","43.3"
"10","007","00","001","0103","0112","457","338","119","28","485","781","0","62.1","43.28"
"10","007","00","001","0103","0113","484","379","105","34","518","875","0","59.2","43.31"
"10","007","00","001","0104","0000","456","347","109","29","485","816","0","59.44","42.52"
"10","007","00","001","0104","0114","456","347","109","29","485","816","0","59.44","42.52"
"10","007","00","001","0105","0000","836","657","179","72","908","1414","0","64.21","46.46"
"10","007","00","001","0105","0115","397","305","92","38","435","687","0","63.32","44.4"
"10","007","00","001","0105","0116","439","352","87","34","473","727","0","65.06","48.42"
"10","007","00","001","0106","0000","1001","770","231","76","1077","1759","0","61.23","43.77"
"10","007","00","001","0106","0119","550","417","133","37","587","906","0","64.79","46.03"
"10","007","00","001","0106","0120","451","353","98","39","490","853","0","57.44","41.38"
"10","007","00","001","0107","0000","2357","1902","455","147","2504","3986","0","62.82","47.72"
"10","007","00","001","0107","0121","607","478","129","37","644","1027","0","62.71","46.54"
"10","007","00","001","0107","0122","590","489","101","43","633","993","0","63.75","49.24"
"10","007","00","001","0107","0123","478","376","102","45","523","848","0","61.67","44.34"
"10","007","00","001","0107","0124","682","559","123","22","704","1118","0","62.97","50.0"
"10","007","00","001","0108","0000","2838","2223","615","139","2977","5156","0","57.74","43.11"
"10","007","00","001","0108","0106","664","505","159","6","670","1156","0","57.96","43.69"
"10","007","00","001","0108","0107","705","544","161","49","754","1235","0","61.05","44.05"
"10","007","00","001","0108","0108","713","567","146","51","764","1376","0","55.52","41.21"
"10","007","00","001","0108","0109","756","607","149","33","789","1389","0","56.8","43.7"
"10","007","00","001","0109","0000","1041","820","221","72","1113","1705","0","65.28","48.09"
"10","007","00","001","0109","0110","517","396","121","42","559","846","0","66.08","46.81"
"10","007","00","001","0109","0111","524","424","100","30","554","859","0","64.49","49.36"
"10","007","00","001","0110","0000","987","783","204","58","1045","1883","0","55.5","41.58"
"10","007","00","001","0110","0104","476","386","90","14","490","975","0","50.26","39.59"
"10","007","00","001","0110","0105","511","397","114","44","555","908","0","61.12","43.72"
"10","007","00","001","0111","0000","479","368","111","33","512","773","0","66.24","47.61"
"10","007","00","001","0111","0103","479","368","111","33","512","773","0","66.24","47.61"
"10","007","00","001","0112","0000","814","626","188","64","878","1420","0","61.83","44.08"
"10","007","00","001","0112","0101","411","301","110","33","444","692","0","64.16","43.5"
"10","007","00","001","0112","0102","403","325","78","31","434","728","0","59.62","44.64"
"10","007","00","001","0113","0000","534","413","121","42","576","893","0","64.5","46.25"
"10","007","00","001","0113","0099","534","413","121","42","576","893","0","64.5","46.25"
"10","007","00","001","0114","0000","417","317","100","46","463","691","0","67.0","45.88"
"10","007","00","001","0114","0098","417","317","100","46","463","691","0","67.0","45.88"
"10","007","00","001","0115","0000","410","314","96","47","457","733","0","62.35","42.84"
"10","007","00","001","0115","0100","410","314","96","47","457","733","0","62.35","42.84"
"10","007","00","001","0116","0000","495","363","132","61","556","910","0","61.1","39.89"
"10","007","00","001","0116","0054","495","363","132","61","556","910","0","61.1","39.89"
"10","007","00","001","0117","0000","451","340","111","44","495","771","0","64.2","44.1"
"10","007","00","001","0117","0051","451","340","111","44","495","771","0","64.2","44.1"
"10","007","00","001","0118","0000","484","366","118","43","527","868","0","60.71","42.17"
"10","007","00","001","0118","0052","484","366","118","43","527","868","0","60.71","42.17"
"10","007","00","001","0119","0000","629","487","142","60","689","1135","0","60.7","42.91"
"10","007","00","001","0119","0053","629","487","142","60","689","1135","0","60.7","42.91"
"10","007","00","001","0120","0000","2021","1664","357","130","2151","3360","0","64.02","49.52"
"10","007","00","001","0120","0056","626","508","118","45","671","1077","0","62.3","47.17"
"10","007","00","001","0120","0057","775","644","131","53","828","1258","0","65.82","51.19"
"10","007","00","001","0120","0058","620","512","108","32","652","1025","0","63.61","49.95"
"10","007","00","001","0121","0000","2067","1690","377","150","2217","3648","0","60.77","46.33"
"10","007","00","001","0121","0059","687","565","122","56","743","1177","0","63.13","48.0"
"10","007","00","001","0121","0060","674","553","121","43","717","1262","0","56.81","43.82"
"10","007","00","001","0121","0061","706","572","134","51","757","1209","0","62.61","47.31"
"10","007","00","001","0122","0000","625","496","129","74","699","1203","0","58.1","41.23"
"10","007","00","001","0122","0065","625","496","129","74","699","1203","0","58.1","41.23"
"10","007","00","001","0123","0000","1786","1462","324","131","1917","3145","0","60.95","46.49"
"10","007","00","001","0123","0062","627","507","120","34","661","1041","0","63.5","48.7"
"10","007","00","001","0123","0063","627","516","111","38","665","1075","0","61.86","48.0"
"10","007","00","001","0123","0064","532","439","93","59","591","1029","0","57.43","42.66"
"10","007","00","001","0124","0000","2184","1749","435","137","2321","4157","0","55.83","42.07"
"10","007","00","001","0124","0066","547","431","116","38","585","1014","0","57.69","42.5"
"10","007","00","001","0124","0067","609","483","126","37","646","1069","0","60.43","45.18"
"10","007","00","001","0124","0068","473","390","83","24","497","969","0","51.29","40.25"
"10","007","00","001","0124","0069","555","445","110","38","593","1105","0","53.67","40.27"
"10","007","00","001","0125","0000","570","442","128","33","603","1004","0","60.06","44.02"
"10","007","00","001","0125","0055","570","442","128","33","603","1004","0","60.06","44.02"
"10","007","00","001","0126","0000","1917","1470","447","167","2084","3496","0","59.61","42.05"
"10","007","00","001","0126","0090","644","501","143","52","696","1201","0","57.95","41.72"
"10","007","00","001","0126","0091","616","456","160","47","663","1057","0","62.72","43.14"
"10","007","00","001","0126","0092","657","513","144","68","725","1238","0","58.56","41.44"
"10","007","00","001","0127","0000","1166","923","243","111","1277","2130","0","59.95","43.33"
"10","007","00","001","0127","0088","607","481","126","67","674","1153","0","58.46","41.72"
"10","007","00","001","0127","0089","559","442","117","44","603","977","0","61.72","45.24"
"10","007","00","001","0128","0000","1006","830","176","80","1086","1799","0","60.37","46.14"
"10","007","00","001","0128","0086","433","356","77","34","467","799","0","58.45","44.56"
"10","007","00","001","0128","0087","573","474","99","46","619","1000","0","61.9","47.4"
"10","007","00","001","0129","0000","1794","1463","331","94","1888","3091","0","61.08","47.33"
"10","007","00","001","0129","0083","512","425","87","37","549","890","0","61.69","47.75"
"10","007","00","001","0129","0084","675","540","135","32","707","1104","0","64.04","48.91"
"10","007","00","001","0129","0085","607","498","109","25","632","1097","0","57.61","45.4"
"10","007","00","001","0130","0000","1957","1576","381","117","2074","3297","0","62.91","47.8"
"10","007","00","001","0130","0093","703","550","153","44","747","1210","0","61.74","45.45"
"10","007","00","001","0130","0094","599","492","107","37","636","1026","0","61.99","47.95"
"10","007","00","001","0130","0095","655","534","121","36","691","1061","0","65.13","50.33"
"10","007","00","001","0131","0000","2576","1975","601","152","2728","4213","0","64.75","46.88"
"10","007","00","001","0131","0070","583","469","114","40","623","981","0","63.51","47.81"
"10","007","00","001","0131","0071","737","500","237","52","789","1095","0","72.05","45.66"
"10","007","00","001","0131","0072","656","534","122","23","679","1087","0","62.47","49.13"
"10","007","00","001","0131","0073","600","472","128","37","637","1050","0","60.67","44.95"
"10","007","00","001","0132","0000","1378","1095","283","105","1483","2545","0","58.27","43.03"
"10","007","00","001","0132","0001","480","382","98","33","513","871","0","58.9","43.86"
"10","007","00","001","0132","0002","328","263","65","34","362","751","0","48.2","35.02"
"10","007","00","001","0132","0003","570","450","120","38","608","923","0","65.87","48.75"
"10","007","00","001","0133","0000","1404","1118","286","87","1491","2477","0","60.19","45.14"
"10","007","00","001","0133","0096","674","540","134","49","723","1213","0","59.6","44.52"
"10","007","00","001","0133","0097","730","578","152","38","768","1264","0","60.76","45.73"
"10","007","00","001","0134","0000","884","668","216","81","965","1558","0","61.94","42.88"
"10","007","00","001","0134","0004","439","323","116","45","484","779","0","62.13","41.46"
"10","007","00","001","0134","0005","445","345","100","36","481","779","0","61.75","44.29"
"10","007","00","001","0135","0000","545","426","119","37","582","1027","0","56.67","41.48"
"10","007","00","001","0135","0010","545","426","119","37","582","1027","0","56.67","41.48"
"10","007","00","001","0136","0000","653","521","132","62","715","1249","0","57.25","41.71"
"10","007","00","001","0136","0011","653","521","132","62","715","1249","0","57.25","41.71"
"10","007","00","001","0137","0000","1061","848","213","92","1153","1814","0","63.56","46.75"
"10","007","00","001","0137","0008","467","385","82","33","500","767","0","65.19","50.2"
"10","007","00","001","0137","0009","594","463","131","59","653","1047","0","62.37","44.22"
"10","007","00","001","0138","0000","793","611","182","76","869","1469","0","59.16","41.59"
"10","007","00","001","0138","0006","383","293","90","41","424","720","0","58.89","40.69"
"10","007","00","001","0138","0007","410","318","92","35","445","749","0","59.41","42.46"
"10","007","00","001","0139","0000","4284","3407","877","247","4531","7563","0","59.91","45.05"
"10","007","00","001","0139","0035","551","441","110","42","593","1045","0","56.75","42.2"
"10","007","00","001","0139","0036","613","476","137","19","632","1097","0","57.61","43.39"
"10","007","00","001","0139","0037","652","521","131","40","692","1190","0","58.15","43.78"
"10","007","00","001","0139","0038","653","510","143","40","693","1106","0","62.66","46.11"
"10","007","00","001","0139","0039","630","510","120","32","662","1097","0","60.35","46.49"
"10","007","00","001","0139","0040","597","464","133","44","641","1048","0","61.16","44.27"
"10","007","00","001","0139","0041","588","485","103","30","618","980","0","63.06","49.49"
"10","007","00","001","0140","0000","879","690","189","54","933","1516","0","61.54","45.51"
"10","007","00","001","0140","0042","422","324","98","22","444","707","0","62.8","45.83"
"10","007","00","001","0140","0043","457","366","91","32","489","809","0","60.44","45.24"
"10","007","00","001","0141","0000","2675","2150","525","190","2865","4896","0","58.52","43.91"
"10","007","00","001","0141","0025","634","509","125","52","686","1207","0","56.84","42.17"
"10","007","00","001","0141","0026","639","544","95","52","691","1161","0","59.52","46.86"
"10","007","00","001","0141","0027","616","454","162","38","654","1166","0","56.09","38.94"
"10","007","00","001","0141","0028","786","643","143","48","834","1362","0","61.23","47.21"
"10","007","00","001","0142","0000","4088","3240","848","228","4316","7131","0","60.52","45.44"
"10","007","00","001","0142","0029","732","559","173","38","770","1236","0","62.3","45.23"
"10","007","00","001","0142","0030","613","491","122","41","654","1065","0","61.41","46.1"
"10","007","00","001","0142","0031","668","537","131","55","723","1199","0","60.3","44.79"
"10","007","00","001","0142","0032","713","561","152","31","744","1233","0","60.34","45.5"
"10","007","00","001","0142","0033","692","573","119","29","721","1245","0","57.91","46.02"
"10","007","00","001","0142","0034","670","519","151","34","704","1153","0","61.06","45.01"
"10","007","00","001","0143","0000","1598","1267","331","112","1710","2928","0","58.4","43.27"
"10","007","00","001","0143","0045","463","360","103","50","513","901","0","56.94","39.96"
"10","007","00","001","0143","0046","519","408","111","29","548","951","0","57.62","42.9"
"10","007","00","001","0143","0047","616","499","117","33","649","1076","0","60.32","46.38"
"10","007","00","001","0144","0000","1606","1228","378","118","1724","2932","0","58.8","41.88"
"10","007","00","001","0144","0048","529","394","135","34","563","1022","0","55.09","38.55"
"10","007","00","001","0144","0049","489","380","109","46","535","894","0","59.84","42.51"
"10","007","00","001","0144","0050","588","454","134","38","626","1016","0","61.61","44.69"
"10","007","00","001","0145","0000","814","646","168","47","861","1409","0","61.11","45.85"
"10","007","00","001","0145","0014","458","362","96","25","483","766","0","63.05","47.26"
"10","007","00","001","0145","0015","356","284","72","22","378","643","0","58.79","44.17"
"10","007","00","001","0146","0000","1164","932","232","86","1250","2552","0","48.98","36.52"
"10","007","00","001","0146","0016","687","566","121","55","742","1251","0","59.31","45.24"
"10","007","00","001","0146","0017","477","366","111","31","508","1301","0","39.05","28.13"
"10","007","00","001","0147","0000","4942","4012","930","254","5196","8589","0","60.5","46.71"
"10","007","00","001","0147","0018","727","595","132","41","768","1280","0","60.0","46.48"
"10","007","00","001","0147","0019","686","559","127","40","726","1179","0","61.58","47.41"
"10","007","00","001","0147","0020","656","537","119","32","688","1168","0","58.9","45.98"
"10","007","00","001","0147","0021","671","536","135","44","715","1218","0","58.7","44.01"
"10","007","00","001","0147","0022","820","688","132","50","870","1351","0","64.4","50.93"
"10","007","00","001","0147","0023","693","530","163","29","722","1204","0","59.97","44.02"
"10","007","00","001","0147","0024","689","567","122","18","707","1189","0","59.46","47.69"
"10","007","00","001","0148","0000","1325","1044","281","95","1420","2305","0","61.61","45.29"
"10","007","00","001","0148","0012","657","511","146","40","697","1136","0","61.36","44.98"
"10","007","00","001","0148","0013","668","533","135","55","723","1169","0","61.85","45.59"
"10","007","00","001","0149","0000","582","447","135","48","630","1008","0","62.5","44.35"
"10","007","00","001","0149","0044","582","447","135","48","630","1008","0","62.5","44.35"
"10","007","00","001","0150","0000","1781","1458","323","120","1901","3262","0","58.28","44.7"
"10","007","00","001","0150","0177","564","444","120","51","615","1002","0","61.38","44.31"
"10","007","00","001","0150","0178","618","520","98","22","640","1148","0","55.75","45.3"
"10","007","00","001","0150","0179","599","494","105","47","646","1112","0","58.09","44.42"
"10","007","00","001","0151","0000","994","804","190","66","1060","1685","0","62.91","47.72"
"10","007","00","001","0151","0153","483","402","81","24","507","800","0","63.38","50.25"
"10","007","00","001","0151","0154","511","402","109","42","553","885","0","62.49","45.42"
"10","007","00","001","0152","0000","1081","879","202","59","1140","1903","0","59.91","46.19"
"10","007","00","001","0152","0174","517","430","87","28","545","930","0","58.6","46.24"
"10","007","00","001","0152","0175","564","449","115","31","595","973","0","61.15","46.15"
"10","007","00","001","0153","0000","1784","1471","313","92","1876","3282","0","57.16","44.82"
"10","007","00","001","0153","0155","593","487","106","13","606","1000","0","60.6","48.7"
"10","007","00","001","0153","0156","586","487","99","43","629","1159","0","54.27","42.02"
"10","007","00","001","0153","0157","605","497","108","36","641","1123","0","57.08","44.26"
"10","007","00","001","0154","0000","1610","1256","354","192","1802","2908","0","61.97","43.19"
"10","007","00","001","0154","0158","542","398","144","61","603","907","0","66.48","43.88"
"10","007","00","001","0154","0159","496","401","95","65","561","989","0","56.72","40.55"
"10","007","00","001","0154","0160","572","457","115","66","638","1012","0","63.04","45.16"
"10","007","00","001","0155","0000","3681","2897","784","271","3952","6789","0","58.21","42.67"
"10","007","00","001","0155","0168","567","427","140","52","619","1120","0","55.27","38.13"
"10","007","00","001","0155","0169","648","538","110","29","677","1269","0","53.35","42.4"
"10","007","00","001","0155","0170","659","527","132","46","705","1159","0","60.83","45.47"
"10","007","00","001","0155","0171","673","519","154","54","727","1184","0","61.4","43.83"
"10","007","00","001","0155","0172","597","465","132","38","635","1089","0","58.31","42.7"
"10","007","00","001","0155","0173","537","421","116","52","589","968","0","60.85","43.49"
"10","007","00","001","0156","0000","1356","1073","283","101","1457","2485","0","58.63","43.18"
"10","007","00","001","0156","0151","721","575","146","59","780","1372","0","56.85","41.91"
"10","007","00","001","0156","0152","635","498","137","42","677","1113","0","60.83","44.74"
"10","007","00","001","0157","0000","576","451","125","31","607","1184","0","51.27","38.09"
"10","007","00","001","0157","0176","576","451","125","31","607","1184","0","51.27","38.09"
"10","007","00","001","0158","0000","1449","1132","317","113","1562","2445","0","63.89","46.3"
"10","007","00","001","0158","0165","467","362","105","36","503","770","0","65.32","47.01"
"10","007","00","001","0158","0166","533","402","131","24","557","889","0","62.65","45.22"
"10","007","00","001","0158","0167","449","368","81","53","502","786","0","63.87","46.82"
"10","007","00","001","0159","0000","713","579","134","66","779","1249","0","62.37","46.36"
"10","007","00","001","0159","0133","713","579","134","66","779","1249","0","62.37","46.36"
"10","007","00","001","0160","0000","522","427","95","51","573","924","0","62.01","46.21"
"10","007","00","001","0160","0129","522","427","95","51","573","924","0","62.01","46.21"
"10","007","00","001","0161","0000","1768","1431","337","124","1892","2873","0","65.85","49.81"
"10","007","00","001","0161","0130","569","456","113","28","597","939","0","63.58","48.56"
"10","007","00","001","0161","0131","589","464","125","56","645","953","0","67.68","48.69"
"10","007","00","001","0161","0132","610","511","99","40","650","981","0","66.26","52.09"
"10","007","00","001","0162","0000","4610","3779","831","264","4874","8267","0","58.96","45.71"
"10","007","00","001","0162","0137","687","569","118","28","715","1156","0","61.85","49.22"
"10","007","00","001","0162","0138","707","583","124","31","738","1291","0","57.16","45.16"
"10","007","00","001","0162","0139","632","516","116","27","659","1139","0","57.86","45.3"
"10","007","00","001","0162","0140","653","538","115","42","695","1125","0","61.78","47.82"
"10","007","00","001","0162","0141","650","546","104","53","703","1258","0","55.88","43.4"
"10","007","00","001","0162","0142","626","510","116","37","663","1123","0","59.04","45.41"
"10","007","00","001","0162","0143","655","517","138","46","701","1175","0","59.66","44.0"
"10","007","00","001","0163","0000","1318","1059","259","124","1442","2378","0","60.64","44.53"
"10","007","00","001","0163","0134","460","365","95","50","510","817","0","62.42","44.68"
"10","007","00","001","0163","0135","487","386","101","46","533","872","0","61.12","44.27"
"10","007","00","001","0163","0136","371","308","63","28","399","689","0","57.91","44.7"
"10","007","00","001","0164","0000","2298","1877","421","121","2419","4160","0","58.15","45.12"
"10","007","00","001","0164","0147","538","450","88","21","559","1003","0","55.73","44.87"
"10","007","00","001","0164","0148","486","393","93","22","508","915","0","55.52","42.95"
"10","007","00","001","0164","0149","626","501","125","42","668","1158","0","57.69","43.26"
"10","007","00","001","0164","0150","648","533","115","36","684","1084","0","63.1","49.17"
"10","007","00","001","0165","0000","1596","1250","346","83","1679","2631","0","63.82","47.51"
"10","007","00","001","0165","0144","541","417","124","29","570","862","0","66.13","48.38"
"10","007","00","001","0165","0145","489","377","112","39","528","872","0","60.55","43.23"
"10","007","00","001","0165","0146","566","456","110","15","581","897","0","64.77","50.84"
"10","007","00","001","0166","0000","600","485","115","59","659","1161","0","56.76","41.77"
"10","007","00","001","0166","0184","600","485","115","59","659","1161","0","56.76","41.77"
"10","007","00","001","0167","0000","684","587","97","71","755","1276","0","59.17","46.0"
"10","007","00","001","0167","0183","684","587","97","71","755","1276","0","59.17","46.0"
"10","007","00","001","0168","0000","388","315","73","36","424","823","0","51.52","38.27"
"10","007","00","001","0168","0182","388","315","73","36","424","823","0","51.52","38.27"
"10","007","00","001","0169","0000","577","488","89","44","621","907","0","68.47","53.8"
"10","007","00","001","0169","0180","577","488","89","44","621","907","0","68.47","53.8"
"10","007","00","001","0170","0000","623","526","97","58","681","1112","0","61.24","47.3"
"10","007","00","001","0170","0181","623","526","97","58","681","1112","0","61.24","47.3"
"10","007","00","001","0171","0000","2473","2023","450","129","2602","4367","0","59.58","46.32"
"10","007","00","001","0171","0161","519","418","101","27","546","1033","0","52.86","40.46"
"10","007","00","001","0171","0162","640","526","114","40","680","1116","0","60.93","47.13"
"10","007","00","001","0171","0163","683","565","118","26","709","1154","0","61.44","48.96"
"10","007","00","001","0171","0164","631","514","117","36","667","1064","0","62.69","48.31"
"10","007","00","001","0172","0000","3000","2424","576","173","3173","5370","0","59.09","45.14"
"10","007","00","001","0172","0074","720","582","138","52","772","1252","0","61.66","46.49"
"10","007","00","001","0172","0075","584","473","111","34","618","1113","0","55.53","42.5"
"10","007","00","001","0172","0076","608","494","114","27","635","1009","0","62.93","48.96"
"10","007","00","001","0172","0077","543","436","107","35","578","999","0","57.86","43.64"
"10","007","00","001","0172","0078","545","439","106","25","570","997","0","57.17","44.03"
"10","007","00","001","0173","0000","3007","2415","592","138","3145","5178","0","60.74","46.64"
"10","007","00","001","0173","0079","707","566","141","41","748","1145","0","65.33","49.43"
"10","007","00","001","0173","0080","694","558","136","24","718","1227","0","58.52","45.48"
"10","007","00","001","0173","0081","719","561","158","33","752","1208","0","62.25","46.44"
"10","007","00","001","0173","0082","887","730","157","40","927","1598","0","58.01","45.68"
"10","007","00","002","0000","0000","37447","30219","7228","3228","40675","70505","86762","57.69","42.86"
"10","007","00","002","0201","0000","658","503","155","53","711","1140","0","62.37","44.12"
"10","007","00","002","0201","0243","658","503","155","53","711","1140","0","62.37","44.12"
"10","007","00","002","0202","0000","275","214","61","29","304","511","0","59.49","41.88"
"10","007","00","002","0202","0244","275","214","61","29","304","511","0","59.49","41.88"
"10","007","00","002","0203","0000","375","304","71","25","400","857","0","46.67","35.47"
"10","007","00","002","0203","0245","375","304","71","25","400","857","0","46.67","35.47"
"10","007","00","002","0204","0000","554","435","119","55","609","946","0","64.38","45.98"
"10","007","00","002","0204","0246","554","435","119","55","609","946","0","64.38","45.98"
"10","007","00","002","0205","0000","4151","3352","799","314","4465","7584","0","58.87","44.2"
"10","007","00","002","0205","0302","670","530","140","65","735","1299","0","56.58","40.8"
"10","007","00","002","0205","0303","761","635","126","40","801","1298","0","61.71","48.92"
"10","007","00","002","0205","0304","789","639","150","50","839","1458","0","57.54","43.83"
"10","007","00","002","0205","0305","621","485","136","46","667","1138","0","58.61","42.62"
"10","007","00","002","0205","0306","624","507","117","58","682","1170","0","58.29","43.33"
"10","007","00","002","0205","0307","686","556","130","55","741","1221","0","60.69","45.54"
"10","007","00","002","0206","0000","2674","2122","552","208","2882","5161","0","55.84","41.12"
"10","007","00","002","0206","0298","676","525","151","58","734","1227","0","59.82","42.79"
"10","007","00","002","0206","0299","652","519","133","59","711","1187","0","59.9","43.72"
"10","007","00","002","0206","0300","663","555","108","21","684","1296","0","52.78","42.82"
"10","007","00","002","0206","0301","683","523","160","70","753","1451","0","51.9","36.04"
"10","007","00","002","0207","0000","2569","2075","494","205","2774","4946","0","56.09","41.95"
"10","007","00","002","0207","0247","528","425","103","35","563","945","0","59.58","44.97"
"10","007","00","002","0207","0248","598","483","115","50","648","1097","0","59.07","44.03"
"10","007","00","002","0207","0249","672","545","127","38","710","1479","0","48.01","36.85"
"10","007","00","002","0207","0250","771","622","149","82","853","1425","0","59.86","43.65"
"10","007","00","002","0208","0000","2284","1835","449","182","2466","4335","0","56.89","42.33"
"10","007","00","002","0208","0253","573","451","122","72","645","1047","0","61.6","43.08"
"10","007","00","002","0208","0254","540","426","114","22","562","1097","0","51.23","38.83"
"10","007","00","002","0208","0255","547","449","98","46","593","1030","0","57.57","43.59"
"10","007","00","002","0208","0256","624","509","115","42","666","1161","0","57.36","43.84"
"10","007","00","002","0209","0000","288","232","56","52","340","540","0","62.96","42.96"
"10","007","00","002","0209","0257","288","232","56","52","340","540","0","62.96","42.96"
"10","007","00","002","0210","0000","494","396","98","68","562","880","0","63.86","45.0"
"10","007","00","002","0210","0251","494","396","98","68","562","880","0","63.86","45.0"
"10","007","00","002","0211","0000","591","459","132","67","658","1183","0","55.62","38.8"
"10","007","00","002","0211","0252","591","459","132","67","658","1183","0","55.62","38.8"
"10","007","00","002","0212","0000","601","452","149","64","665","1127","0","59.01","40.11"
"10","007","00","002","0212","0262","601","452","149","64","665","1127","0","59.01","40.11"
"10","007","00","002","0213","0000","694","549","145","77","771","1178","0","65.45","46.6"
"10","007","00","002","0213","0263","694","549","145","77","771","1178","0","65.45","46.6"
"10","007","00","002","0214","0000","152","124","28","17","169","284","0","59.51","43.66"
"10","007","00","002","0214","0264","152","124","28","17","169","284","0","59.51","43.66"
"10","007","00","002","0215","0000","395","312","83","38","433","659","0","65.71","47.34"
"10","007","00","002","0215","0266","395","312","83","38","433","659","0","65.71","47.34"
"10","007","00","002","0216","0000","310","236","74","35","345","584","0","59.08","40.41"
"10","007","00","002","0216","0265","310","236","74","35","345","584","0","59.08","40.41"
"10","007","00","002","0217","0000","469","368","101","16","485","915","0","53.01","40.22"
"10","007","00","002","0217","0267","469","368","101","16","485","915","0","53.01","40.22"
"10","007","00","002","0218","0000","1271","1021","250","133","1404","2208","0","63.59","46.24"
"10","007","00","002","0218","0268","610","487","123","64","674","1079","0","62.47","45.13"
"10","007","00","002","0218","0269","661","534","127","69","730","1129","0","64.66","47.3"
"10","007","00","002","0219","0000","1991","1656","335","170","2161","3820","0","56.57","43.35"
"10","007","00","002","0219","0286","736","607","129","80","816","1505","0","54.22","40.33"
"10","007","00","002","0219","0287","566","477","89","37","603","1092","0","55.22","43.68"
"10","007","00","002","0219","0288","689","572","117","53","742","1223","0","60.67","46.77"
"10","007","00","002","0220","0000","1265","1044","221","85","1350","2575","0","52.43","40.54"
"10","007","00","002","0220","0289","692","575","117","39","731","1572","0","46.5","36.58"
"10","007","00","002","0220","0290","573","469","104","46","619","1003","0","61.71","46.76"
"10","007","00","002","0221","0000","2261","1876","385","130","2391","4070","0","58.75","46.09"
"10","007","00","002","0221","0295","829","684","145","58","887","1397","0","63.49","48.96"
"10","007","00","002","0221","0296","688","550","138","33","721","1229","0","58.67","44.75"
"10","007","00","002","0221","0297","744","642","102","39","783","1444","0","54.22","44.46"
"10","007","00","002","0222","0000","2248","1802","446","147","2395","4152","0","57.68","43.4"
"10","007","00","002","0222","0291","525","439","86","30","555","933","0","59.49","47.05"
"10","007","00","002","0222","0292","608","479","129","55","663","1093","0","60.66","43.82"
"10","007","00","002","0222","0293","487","386","101","18","505","907","0","55.68","42.56"
"10","007","00","002","0222","0294","628","498","130","44","672","1219","0","55.13","40.85"
"10","007","00","002","0223","0000","1694","1410","284","133","1827","3167","0","57.69","44.52"
"10","007","00","002","0223","0278","506","443","63","31","537","984","0","54.57","45.02"
"10","007","00","002","0223","0279","593","488","105","52","645","1018","0","63.36","47.94"
"10","007","00","002","0223","0280","595","479","116","50","645","1165","0","55.36","41.12"
"10","007","00","002","0224","0000","1084","890","194","86","1170","2181","0","53.65","40.81"
"10","007","00","002","0224","0281","570","472","98","44","614","1161","0","52.89","40.65"
"10","007","00","002","0224","0282","514","418","96","42","556","1020","0","54.51","40.98"
"10","007","00","002","0225","0000","1642","1328","314","177","1819","3066","0","59.33","43.31"
"10","007","00","002","0225","0283","561","447","114","54","615","1068","0","57.58","41.85"
"10","007","00","002","0225","0284","566","467","99","39","605","1024","0","59.08","45.61"
"10","007","00","002","0225","0285","515","414","101","84","599","974","0","61.5","42.51"
"10","007","00","002","0226","0000","1767","1441","326","186","1953","3557","0","54.91","40.51"
"10","007","00","002","0226","0272","537","442","95","93","630","1137","0","55.41","38.87"
"10","007","00","002","0226","0273","615","495","120","47","662","1195","0","55.4","41.42"
"10","007","00","002","0226","0274","615","504","111","46","661","1225","0","53.96","41.14"
"10","007","00","002","0227","0000","970","790","180","104","1074","1979","0","54.27","39.92"
"10","007","00","002","0227","0270","636","508","128","67","703","1273","0","55.22","39.91"
"10","007","00","002","0227","0271","334","282","52","37","371","706","0","52.55","39.94"
"10","007","00","002","0228","0000","1281","1055","226","181","1462","2438","0","59.97","43.27"
"10","007","00","002","0228","0275","575","478","97","55","630","957","0","65.83","49.95"
"10","007","00","002","0228","0276","338","274","64","64","402","758","0","53.03","36.15"
"10","007","00","002","0228","0277","368","303","65","62","430","723","0","59.47","41.91"
"10","007","00","002","0229","0000","2439","1938","501","191","2630","4462","0","58.94","43.43"
"10","007","00","002","0229","0258","601","474","127","44","645","1135","0","56.83","41.76"
"10","007","00","002","0229","0259","609","481","128","57","666","1155","0","57.66","41.65"
"10","007","00","002","0229","0260","653","538","115","43","696","1127","0","61.76","47.74"
"10","007","00","002","0229","0261","576","445","131","47","623","1045","0","59.62","42.58"
"10","007","00","003","0000","0000","40024","32445","7579","2554","42578","75286","90786","56.56","43.1"
"10","007","00","003","0301","0000","3036","2445","591","162","3198","6061","0","52.76","40.34"
"10","007","00","003","0301","0373","685","542","143","54","739","1341","0","55.11","40.42"
"10","007","00","003","0301","0374","719","594","125","51","770","1480","0","52.03","40.14"
"10","007","00","003","0301","0375","816","655","161","37","853","1529","0","55.79","42.84"
"10","007","00","003","0301","0376","816","654","162","20","836","1711","0","48.86","38.22"
"10","007","00","003","0302","0000","2399","1944","455","182","2581","4313","0","59.84","45.07"
"10","007","00","003","0302","0377","577","454","123","37","614","1057","0","58.09","42.95"
"10","007","00","003","0302","0378","572","469","103","38","610","1032","0","59.11","45.45"
"10","007","00","003","0302","0379","565","473","92","61","626","1015","0","61.67","46.6"
"10","007","00","003","0302","0380","685","548","137","46","731","1209","0","60.46","45.33"
"10","007","00","003","0303","0000","229","182","47","22","251","430","0","58.37","42.33"
"10","007","00","003","0303","0381","229","182","47","22","251","430","0","58.37","42.33"
"10","007","00","003","0304","0000","1009","849","160","41","1050","1822","0","57.63","46.6"
"10","007","00","003","0304","0382","452","374","78","15","467","856","0","54.56","43.69"
"10","007","00","003","0304","0383","557","475","82","26","583","966","0","60.35","49.17"
"10","007","00","003","0305","0000","1719","1367","352","96","1815","3242","0","55.98","42.17"
"10","007","00","003","0305","0384","564","435","129","19","583","1059","0","55.05","41.08"
"10","007","00","003","0305","0385","603","488","115","35","638","1117","0","57.12","43.69"
"10","007","00","003","0305","0386","552","444","108","42","594","1066","0","55.72","41.65"
"10","007","00","003","0306","0000","1395","1142","253","84","1479","2780","0","53.2","41.08"
"10","007","00","003","0306","0387","631","510","121","42","673","1252","0","53.75","40.73"
"10","007","00","003","0306","0388","764","632","132","42","806","1528","0","52.75","41.36"
"10","007","00","003","0307","0000","928","764","164","48","976","1680","0","58.1","45.48"
"10","007","00","003","0307","0389","470","373","97","27","497","826","0","60.17","45.16"
"10","007","00","003","0307","0390","458","391","67","21","479","854","0","56.09","45.78"
"10","007","00","003","0308","0000","492","385","107","29","521","860","0","60.58","44.77"
"10","007","00","003","0308","0429","492","385","107","29","521","860","0","60.58","44.77"
"10","007","00","003","0309","0000","1139","935","204","78","1217","2152","0","56.55","43.45"
"10","007","00","003","0309","0391","686","573","113","54","740","1387","0","53.35","41.31"
"10","007","00","003","0309","0392","453","362","91","24","477","765","0","62.35","47.32"
"10","007","00","003","0310","0000","1469","1225","244","112","1581","2834","0","55.79","43.23"
"10","007","00","003","0310","0393","704","595","109","46","750","1438","0","52.16","41.38"
"10","007","00","003","0310","0394","765","630","135","66","831","1396","0","59.53","45.13"
"10","007","00","003","0311","0000","837","670","167","56","893","1467","0","60.87","45.67"
"10","007","00","003","0311","0395","359","272","87","20","379","658","0","57.6","41.34"
"10","007","00","003","0311","0396","478","398","80","36","514","809","0","63.54","49.2"
"10","007","00","003","0312","0000","921","752","169","47","968","1820","0","53.19","41.32"
"10","007","00","003","0312","0397","473","384","89","9","482","932","0","51.72","41.2"
"10","007","00","003","0312","0398","448","368","80","38","486","888","0","54.73","41.44"
"10","007","00","003","0313","0000","1231","996","235","78","1309","2221","0","58.94","44.84"
"10","007","00","003","0313","0399","659","510","149","40","699","1144","0","61.1","44.58"
"10","007","00","003","0313","0400","572","486","86","38","610","1077","0","56.64","45.13"
"10","007","00","003","0314","0000","656","530","126","51","707","1349","0","52.41","39.29"
"10","007","00","003","0314","0401","656","530","126","51","707","1349","0","52.41","39.29"
"10","007","00","003","0315","0000","2742","2273","469","143","2885","5134","0","56.19","44.27"
"10","007","00","003","0315","0402","679","549","130","44","723","1155","0","62.6","47.53"
"10","007","00","003","0315","0403","659","542","117","36","695","1253","0","55.47","43.26"
"10","007","00","003","0315","0404","645","548","97","40","685","1252","0","54.71","43.77"
"10","007","00","003","0315","0405","759","634","125","23","782","1474","0","53.05","43.01"
"10","007","00","003","0316","0000","1100","878","222","67","1167","1910","0","61.1","45.97"
"10","007","00","003","0316","0408","595","481","114","25","620","999","0","62.06","48.15"
"10","007","00","003","0316","0409","505","397","108","42","547","911","0","60.04","43.58"
"10","007","00","003","0317","0000","1437","1141","296","71","1508","2632","0","57.29","43.35"
"10","007","00","003","0317","0412","724","571","153","38","762","1308","0","58.26","43.65"
"10","007","00","003","0317","0413","713","570","143","33","746","1324","0","56.34","43.05"
"10","007","00","003","0318","0000","1081","840","241","70","1151","1972","0","58.37","42.6"
"10","007","00","003","0318","0410","557","418","139","32","589","1005","0","58.61","41.59"
"10","007","00","003","0318","0411","524","422","102","38","562","967","0","58.12","43.64"
"10","007","00","003","0319","0000","1833","1531","302","135","1968","3437","0","57.26","44.54"
"10","007","00","003","0319","0414","613","461","152","43","656","1102","0","59.53","41.83"
"10","007","00","003","0319","0415","563","530","33","46","609","1124","0","54.18","47.15"
"10","007","00","003","0319","0416","657","540","117","46","703","1211","0","58.05","44.59"
"10","007","00","003","0320","0000","556","436","120","30","586","884","0","66.29","49.32"
"10","007","00","003","0320","0417","556","436","120","30","586","884","0","66.29","49.32"
"10","007","00","003","0321","0000","1273","1009","264","111","1384","2419","0","57.21","41.71"
"10","007","00","003","0321","0418","594","448","146","57","651","1119","0","58.18","40.04"
"10","007","00","003","0321","0419","679","561","118","54","733","1300","0","56.38","43.15"
"10","007","00","003","0322","0000","1266","1029","237","78","1344","2317","0","58.01","44.41"
"10","007","00","003","0322","0420","569","466","103","37","606","1104","0","54.89","42.21"
"10","007","00","003","0322","0421","697","563","134","41","738","1213","0","60.84","46.41"
"10","007","00","003","0323","0000","529","408","121","44","573","1127","0","50.84","36.2"
"10","007","00","003","0323","0422","529","408","121","44","573","1127","0","50.84","36.2"
"10","007","00","003","0324","0000","1577","1258","319","131","1708","2864","0","59.64","43.92"
"10","007","00","003","0324","0423","470","384","86","51","521","919","0","56.69","41.78"
"10","007","00","003","0324","0424","548","443","105","48","596","987","0","60.39","44.88"
"10","007","00","003","0324","0425","559","431","128","32","591","958","0","61.69","44.99"
"10","007","00","003","0325","0000","2278","1862","416","105","2383","4228","0","56.36","44.04"
"10","007","00","003","0325","0426","740","603","137","49","789","1362","0","57.93","44.27"
"10","007","00","003","0325","0427","766","627","139","28","794","1461","0","54.35","42.92"
"10","007","00","003","0325","0428","772","632","140","28","800","1405","0","56.94","44.98"
"10","007","00","003","0326","0000","922","749","173","54","976","1746","0","55.9","42.9"
"10","007","00","003","0326","0430","457","380","77","15","472","875","0","53.94","43.43"
"10","007","00","003","0326","0431","465","369","96","39","504","871","0","57.86","42.37"
"10","007","00","003","0327","0000","512","416","96","38","550","883","0","62.29","47.11"
"10","007","00","003","0327","0432","512","416","96","38","550","883","0","62.29","47.11"
"10","007","00","003","0328","0000","606","474","132","57","663","1224","0","54.17","38.73"
"10","007","00","003","0328","0433","606","474","132","57","663","1224","0","54.17","38.73"
"10","007","00","003","0329","0000","1062","854","208","80","1142","2031","0","56.23","42.05"
"10","007","00","003","0329","0434","552","444","108","46","598","1075","0","55.63","41.3"
"10","007","00","003","0329","0435","510","410","100","34","544","956","0","56.9","42.89"
"10","007","00","003","0330","0000","1600","1287","313","115","1715","3071","0","55.85","41.91"
"10","007","00","003","0330","0436","534","428","106","46","580","1037","0","55.93","41.27"
"10","007","00","003","0330","0437","546","445","101","19","565","1011","0","55.89","44.02"
"10","007","00","003","0330","0438","520","414","106","50","570","1023","0","55.72","40.47"
"10","007","00","003","0331","0000","840","679","161","68","908","1632","0","55.64","41.61"
"10","007","00","003","0331","0439","369","302","67","22","391","719","0","54.38","42.0"
"10","007","00","003","0331","0440","471","377","94","46","517","913","0","56.63","41.29"
"10","007","00","003","0332","0000","1350","1135","215","71","1421","2744","0","51.79","41.36"
"10","007","00","003","0332","0406","660","558","102","33","693","1396","0","49.64","39.97"
"10","007","00","003","0332","0407","690","577","113","38","728","1348","0","54.01","42.8"
"10","007","00","004","0000","0000","7728","6361","1367","637","8365","14065","16872","59.47","45.23"
"10","007","00","004","0401","0000","1236","1018","218","62","1298","2237","0","58.02","45.51"
"10","007","00","004","0401","0469","585","482","103","25","610","1071","0","56.96","45.0"
"10","007","00","004","0401","0470","651","536","115","37","688","1166","0","59.01","45.97"
"10","007","00","004","0402","0000","689","574","115","63","752","1269","0","59.26","45.23"
"10","007","00","004","0402","0471","689","574","115","63","752","1269","0","59.26","45.23"
"10","007","00","004","0403","0000","1260","1022","238","111","1371","2266","0","60.5","45.1"
"10","007","00","004","0403","0472","609","488","121","43","652","1138","0","57.29","42.88"
"10","007","00","004","0403","0473","651","534","117","68","719","1128","0","63.74","47.34"
"10","007","00","004","0404","0000","684","569","115","80","764","1275","0","59.92","44.63"
"10","007","00","004","0404","0474","684","569","115","80","764","1275","0","59.92","44.63"
"10","007","00","004","0405","0000","649","543","106","58","707","1187","0","59.56","45.75"
"10","007","00","004","0405","0475","649","543","106","58","707","1187","0","59.56","45.75"
"10","007","00","004","0406","0000","1061","856","205","103","1164","1929","0","60.34","44.38"
"10","007","00","004","0406","0476","558","454","104","45","603","991","0","60.85","45.81"
"10","007","00","004","0406","0477","503","402","101","58","561","938","0","59.81","42.86"
"10","007","00","004","0407","0000","1342","1106","236","93","1435","2561","0","56.03","43.19"
"10","007","00","004","0407","0478","633","515","118","46","679","1276","0","53.21","40.36"
"10","007","00","004","0407","0479","709","591","118","47","756","1285","0","58.83","45.99"
"10","007","00","004","0408","0000","807","673","134","67","874","1341","0","65.18","50.19"
"10","007","00","004","0408","0480","807","673","134","67","874","1341","0","65.18","50.19"
"10","007","00","005","0000","0000","15950","13300","2650","1254","17204","30407","37062","56.58","43.74"
"10","007","00","005","0501","0000","821","684","137","76","897","1700","0","52.76","40.24"
"10","007","00","005","0501","0456","423","348","75","47","470","854","0","55.04","40.75"
"10","007","00","005","0501","0457","398","336","62","29","427","846","0","50.47","39.72"
"10","007","00","005","0502","0000","516","421","95","93","609","1143","0","53.28","36.83"
"10","007","00","005","0502","0458","516","421","95","93","609","1143","0","53.28","36.83"
"10","007","00","005","0503","0000","728","601","127","49","777","1317","0","59.0","45.63"
"10","007","00","005","0503","0463","728","601","127","49","777","1317","0","59.0","45.63"
"10","007","00","005","0504","0000","978","813","165","86","1064","1912","0","55.65","42.52"
"10","007","00","005","0504","0447","459","383","76","45","504","904","0","55.75","42.37"
"10","007","00","005","0504","0448","519","430","89","41","560","1008","0","55.56","42.66"
"10","007","00","005","0505","0000","1100","921","179","90","1190","1993","0","59.71","46.21"
"10","007","00","005","0505","0453","594","487","107","53","647","1085","0","59.63","44.88"
"10","007","00","005","0505","0454","506","434","72","37","543","908","0","59.8","47.8"
"10","007","00","005","0506","0000","720","621","99","37","757","1264","0","59.89","49.13"
"10","007","00","005","0506","0455","720","621","99","37","757","1264","0","59.89","49.13"
"10","007","00","005","0507","0000","965","799","166","81","1046","1839","0","56.88","43.45"
"10","007","00","005","0507","0443","518","431","87","41","559","966","0","57.87","44.62"
"10","007","00","005","0507","0444","447","368","79","40","487","873","0","55.78","42.15"
"10","007","00","005","0508","0000","914","753","161","70","984","1687","0","58.33","44.64"
"10","007","00","005","0508","0445","452","368","84","40","492","812","0","60.59","45.32"
"10","007","00","005","0508","0446","462","385","77","30","492","875","0","56.23","44.0"
"10","007","00","005","0509","0000","1354","1104","250","116","1470","2640","0","55.68","41.82"
"10","007","00","005","0509","0449","637","524","113","49","686","1154","0","59.45","45.41"
"10","007","00","005","0509","0450","717","580","137","67","784","1486","0","52.76","39.03"
"10","007","00","005","0510","0000","2700","2170","530","183","2883","5139","0","56.1","42.23"
"10","007","00","005","0510","0459","720","592","128","29","749","1357","0","55.2","43.63"
"10","007","00","005","0510","0460","687","533","154","75","762","1349","0","56.49","39.51"
"10","007","00","005","0510","0461","630","509","121","46","676","1154","0","58.58","44.11"
"10","007","00","005","0510","0462","663","536","127","33","696","1279","0","54.42","41.91"
"10","007","00","005","0511","0000","1091","947","144","76","1167","2182","0","53.48","43.4"
"10","007","00","005","0511","0451","555","463","92","53","608","1095","0","55.53","42.28"
"10","007","00","005","0511","0452","536","484","52","23","559","1087","0","51.43","44.53"
"10","007","00","005","0512","0000","1241","1064","177","68","1309","2348","0","55.75","45.32"
"10","007","00","005","0512","0441","561","480","81","31","592","1182","0","50.08","40.61"
"10","007","00","005","0512","0442","680","584","96","37","717","1166","0","61.49","50.09"
"10","007","00","005","0513","0000","1677","1472","205","106","1783","3020","0","59.04","48.74"
"10","007","00","005","0513","0464","563","459","104","43","606","990","0","61.21","46.36"
"10","007","00","005","0513","0465","471","397","74","31","502","852","0","58.92","46.6"
"10","007","00","005","0513","0466","643","616","27","32","675","1178","0","57.3","52.29"
"10","007","00","005","0514","0000","1145","930","215","123","1268","2223","0","57.04","41.84"
"10","007","00","005","0514","0467","551","444","107","70","621","1088","0","57.08","40.81"
"10","007","00","005","0514","0468","594","486","108","53","647","1135","0","57.0","42.82"
"10","007","00","006","0000","0000","19623","15627","3996","1927","21550","39745","47166","54.22","39.32"
"10","007","00","006","0601","0000","697","530","167","91","788","1492","0","52.82","35.52"
"10","007","00","006","0601","0319","697","530","167","91","788","1492","0","52.82","35.52"
"10","007","00","006","0602","0000","622","466","156","33","655","1458","0","44.92","31.96"
"10","007","00","006","0602","0318","622","466","156","33","655","1458","0","44.92","31.96"
"10","007","00","006","0603","0000","621","491","130","43","664","1251","0","53.08","39.25"
"10","007","00","006","0603","0313","621","491","130","43","664","1251","0","53.08","39.25"
"10","007","00","006","0604","0000","706","586","120","57","763","1464","0","52.12","40.03"
"10","007","00","006","0604","0312","706","586","120","57","763","1464","0","52.12","40.03"
"10","007","00","006","0605","0000","540","410","130","93","633","1166","0","54.29","35.16"
"10","007","00","006","0605","0311","540","410","130","93","633","1166","0","54.29","35.16"
"10","007","00","006","0606","0000","592","495","97","67","659","1256","0","52.47","39.41"
"10","007","00","006","0606","0310","592","495","97","67","659","1256","0","52.47","39.41"
"10","007","00","006","0607","0000","690","508","182","52","742","1363","0","54.44","37.27"
"10","007","00","006","0607","0308","690","508","182","52","742","1363","0","54.44","37.27"
"10","007","00","006","0608","0000","438","348","90","34","472","821","0","57.49","42.39"
"10","007","00","006","0608","0309","438","348","90","34","472","821","0","57.49","42.39"
"10","007","00","006","0609","0000","1153","916","237","90","1243","2425","0","51.26","37.77"
"10","007","00","006","0609","0314","713","570","143","61","774","1465","0","52.83","38.91"
"10","007","00","006","0609","0315","440","346","94","29","469","960","0","48.85","36.04"
"10","007","00","006","0610","0000","1326","1042","284","142","1468","2688","0","54.61","38.76"
"10","007","00","006","0610","0316","633","504","129","82","715","1323","0","54.04","38.1"
"10","007","00","006","0610","0317","693","538","155","60","753","1365","0","55.16","39.41"
"10","007","00","006","0611","0000","1170","934","236","90","1260","2477","0","50.87","37.71"
"10","007","00","006","0611","0324","516","405","111","40","556","1085","0","51.24","37.33"
"10","007","00","006","0611","0325","654","529","125","50","704","1392","0","50.57","38.0"
"10","007","00","006","0612","0000","633","516","117","59","692","1216","0","56.91","42.43"
"10","007","00","006","0612","0331","633","516","117","59","692","1216","0","56.91","42.43"
"10","007","00","006","0613","0000","577","491","86","55","632","1063","0","59.45","46.19"
"10","007","00","006","0613","0332","577","491","86","55","632","1063","0","59.45","46.19"
"10","007","00","006","0614","0000","1141","926","215","155","1296","2229","0","58.14","41.54"
"10","007","00","006","0614","0339","613","500","113","78","691","1079","0","64.04","46.34"
"10","007","00","006","0614","0340","528","426","102","77","605","1150","0","52.61","37.04"
"10","007","00","006","0615","0000","968","777","191","102","1070","1921","0","55.7","40.45"
"10","007","00","006","0615","0337","493","398","95","56","549","926","0","59.29","42.98"
"10","007","00","006","0615","0338","475","379","96","46","521","995","0","52.36","38.09"
"10","007","00","006","0616","0000","1188","944","244","111","1299","2305","0","56.36","40.95"
"10","007","00","006","0616","0335","518","398","120","40","558","994","0","56.14","40.04"
"10","007","00","006","0616","0336","670","546","124","71","741","1311","0","56.52","41.65"
"10","007","00","006","0617","0000","542","422","120","53","595","1287","0","46.23","32.79"
"10","007","00","006","0617","0334","542","422","120","53","595","1287","0","46.23","32.79"
"10","007","00","006","0618","0000","638","513","125","68","706","1306","0","54.06","39.28"
"10","007","00","006","0618","0333","638","513","125","68","706","1306","0","54.06","39.28"
"10","007","00","006","0619","0000","2030","1640","390","176","2206","3672","0","60.08","44.66"
"10","007","00","006","0619","0326","694","580","114","80","774","1316","0","58.81","44.07"
"10","007","00","006","0619","0327","712","556","156","48","760","1255","0","60.56","44.3"
"10","007","00","006","0619","0328","624","504","120","48","672","1101","0","61.04","45.78"
"10","007","00","006","0620","0000","1233","1022","211","160","1393","2560","0","54.41","39.92"
"10","007","00","006","0620","0329","578","490","88","78","656","1167","0","56.21","41.99"
"10","007","00","006","0620","0330","655","532","123","82","737","1393","0","52.91","38.19"
"10","007","00","006","0621","0000","1146","883","263","115","1261","2383","0","52.92","37.05"
"10","007","00","006","0621","0322","473","372","101","49","522","1043","0","50.05","35.67"
"10","007","00","006","0621","0323","673","511","162","66","739","1340","0","55.15","38.13"
"10","007","00","006","0622","0000","972","767","205","81","1053","1942","0","54.22","39.5"
"10","007","00","006","0622","0320","402","322","80","23","425","888","0","47.86","36.26"
"10","007","00","006","0622","0321","570","445","125","58","628","1054","0","59.58","42.22"
"10","007","00","007","0000","0000","17859","14290","3569","1289","19148","32394","39300","59.11","44.11"
"10","007","00","007","0701","0000","952","757","195","113","1065","1686","0","63.17","44.9"
"10","007","00","007","0701","0341","593","483","110","75","668","1066","0","62.66","45.31"
"10","007","00","007","0701","0342","359","274","85","38","397","620","0","64.03","44.19"
"10","007","00","007","0702","0000","1124","891","233","56","1180","2072","0","56.95","43.0"
"10","007","00","007","0702","0343","427","341","86","15","442","876","0","50.46","38.93"
"10","007","00","007","0702","0344","697","550","147","41","738","1196","0","61.71","45.99"
"10","007","00","007","0703","0000","1455","1154","301","90","1545","2642","0","58.48","43.68"
"10","007","00","007","0703","0345","746","599","147","44","790","1369","0","57.71","43.75"
"10","007","00","007","0703","0346","709","555","154","46","755","1273","0","59.31","43.6"
"10","007","00","007","0704","0000","1063","842","221","42","1105","1888","0","58.53","44.6"
"10","007","00","007","0704","0348","550","435","115","20","570","967","0","58.95","44.98"
"10","007","00","007","0704","0349","513","407","106","22","535","921","0","58.09","44.19"
"10","007","00","007","0705","0000","757","619","138","48","805","1433","0","56.18","43.2"
"10","007","00","007","0705","0347","757","619","138","48","805","1433","0","56.18","43.2"
"10","007","00","007","0706","0000","2158","1722","436","160","2318","3910","0","59.28","44.04"
"10","007","00","007","0706","0350","403","329","74","30","433","689","0","62.84","47.75"
"10","007","00","007","0706","0351","378","290","88","43","421","688","0","61.19","42.15"
"10","007","00","007","0706","0352","730","582","148","52","782","1252","0","62.46","46.49"
"10","007","00","007","0706","0353","647","521","126","35","682","1281","0","53.24","40.67"
"10","007","00","007","0707","0000","1664","1352","312","99","1763","3211","0","54.91","42.11"
"10","007","00","007","0707","0354","399","317","82","20","419","754","0","55.57","42.04"
"10","007","00","007","0707","0355","532","430","102","50","582","1024","0","56.84","41.99"
"10","007","00","007","0707","0356","733","605","128","29","762","1433","0","53.18","42.22"
"10","007","00","007","0708","0000","1332","1052","280","86","1418","2261","0","62.72","46.53"
"10","007","00","007","0708","0357","828","655","173","45","873","1366","0","63.91","47.95"
"10","007","00","007","0708","0358","504","397","107","41","545","895","0","60.89","44.36"
"10","007","00","007","0709","0000","683","558","125","71","754","1386","0","54.4","40.26"
"10","007","00","007","0709","0359","683","558","125","71","754","1386","0","54.4","40.26"
"10","007","00","007","0710","0000","2586","2091","495","214","2800","4454","0","62.86","46.95"
"10","007","00","007","0710","0360","490","385","105","55","545","896","0","60.83","42.97"
"10","007","00","007","0710","0361","495","382","113","34","529","804","0","65.8","47.51"
"10","007","00","007","0710","0362","491","411","80","26","517","827","0","62.52","49.7"
"10","007","00","007","0710","0363","543","447","96","50","593","996","0","59.54","44.88"
"10","007","00","007","0710","0364","567","466","101","49","616","931","0","66.17","50.05"
"10","007","00","007","0711","0000","1088","847","241","84","1172","1944","0","60.29","43.57"
"10","007","00","007","0711","0365","375","297","78","30","405","715","0","56.64","41.54"
"10","007","00","007","0711","0366","713","550","163","54","767","1229","0","62.41","44.75"
"10","007","00","007","0712","0000","905","721","184","62","967","1701","0","56.85","42.39"
"10","007","00","007","0712","0367","431","350","81","27","458","890","0","51.46","39.33"
"10","007","00","007","0712","0368","474","371","103","35","509","811","0","62.76","45.75"
"10","007","00","007","0713","0000","965","768","197","63","1028","1717","0","59.87","44.73"
"10","007","00","007","0713","0369","453","349","104","33","486","786","0","61.83","44.4"
"10","007","00","007","0713","0370","512","419","93","30","542","931","0","58.22","45.01"
"10","007","00","007","0714","0000","1127","916","211","101","1228","2089","0","58.78","43.85"
"10","007","00","007","0714","0371","702","563","139","66","768","1265","0","60.71","44.51"
"10","007","00","007","0714","0372","425","353","72","35","460","824","0","55.83","42.84"
"10","007","00","008","0000","0000","21012","16953","4059","1692","22704","38924","45922","58.33","43.55"
"10","007","00","008","0801","0000","1739","1418","321","91","1830","3257","0","56.19","43.54"
"10","007","00","008","0801","0185","496","389","107","43","539","901","0","59.82","43.17"
"10","007","00","008","0801","0186","602","495","107","30","632","1042","0","60.65","47.5"
"10","007","00","008","0801","0187","641","534","107","18","659","1314","0","50.15","40.64"
"10","007","00","008","0802","0000","979","765","214","98","1077","1827","0","58.95","41.87"
"10","007","00","008","0802","0188","441","345","96","48","489","808","0","60.52","42.7"
"10","007","00","008","0802","0189","538","420","118","50","588","1019","0","57.7","41.22"
"10","007","00","008","0803","0000","1277","1067","210","150","1427","2384","0","59.86","44.76"
"10","007","00","008","0803","0190","632","485","147","69","701","1144","0","61.28","42.4"
"10","007","00","008","0803","0191","645","582","63","81","726","1240","0","58.55","46.94"
"10","007","00","008","0804","0000","621","498","123","65","686","1095","0","62.65","45.48"
"10","007","00","008","0804","0193","621","498","123","65","686","1095","0","62.65","45.48"
"10","007","00","008","0805","0000","801","638","163","81","882","1425","0","61.89","44.77"
"10","007","00","008","0805","0192","801","638","163","81","882","1425","0","61.89","44.77"
"10","007","00","008","0806","0000","1056","835","221","67","1123","1892","0","59.36","44.13"
"10","007","00","008","0806","0194","508","401","107","38","546","910","0","60.0","44.07"
"10","007","00","008","0806","0195","548","434","114","29","577","982","0","58.76","44.2"
"10","007","00","008","0807","0000","459","368","91","41","500","764","0","65.45","48.17"
"10","007","00","008","0807","0198","459","368","91","41","500","764","0","65.45","48.17"
"10","007","00","008","0808","0000","899","711","188","42","941","1770","0","53.16","40.17"
"10","007","00","008","0808","0196","548","426","122","22","570","1070","0","53.27","39.81"
"10","007","00","008","0808","0197","351","285","66","20","371","700","0","53.0","40.71"
"10","007","00","008","0809","0000","2709","2233","476","201","2910","4967","0","58.59","44.96"
"10","007","00","008","0809","0207","577","470","107","57","634","1169","0","54.23","40.21"
"10","007","00","008","0809","0208","711","572","139","53","764","1274","0","59.97","44.9"
"10","007","00","008","0809","0209","748","622","126","43","791","1280","0","61.8","48.59"
"10","007","00","008","0809","0210","673","569","104","48","721","1244","0","57.96","45.74"
"10","007","00","008","0810","0000","1671","1324","347","135","1806","3038","0","59.45","43.58"
"10","007","00","008","0810","0199","555","430","125","48","603","953","0","63.27","45.12"
"10","007","00","008","0810","0200","529","434","95","26","555","974","0","56.98","44.56"
"10","007","00","008","0810","0201","587","460","127","61","648","1111","0","58.33","41.4"
"10","007","00","008","0811","0000","2466","2012","454","191","2657","4576","0","58.06","43.97"
"10","007","00","008","0811","0202","610","508","102","63","673","1101","0","61.13","46.14"
"10","007","00","008","0811","0203","565","473","92","43","608","1110","0","54.77","42.61"
"10","007","00","008","0811","0204","676","560","116","59","735","1262","0","58.24","44.37"
"10","007","00","008","0811","0205","615","471","144","26","641","1103","0","58.11","42.7"
"10","007","00","008","0812","0000","620","483","137","77","697","1347","0","51.74","35.86"
"10","007","00","008","0812","0206","620","483","137","77","697","1347","0","51.74","35.86"
"10","007","00","008","0813","0000","1821","1459","362","141","1962","3312","0","59.24","44.05"
"10","007","00","008","0813","0211","621","482","139","58","679","1159","0","58.58","41.59"
"10","007","00","008","0813","0212","619","512","107","40","659","1042","0","63.24","49.14"
"10","007","00","008","0813","0213","581","465","116","43","624","1111","0","56.17","41.85"
"10","007","00","008","0814","0000","521","415","106","46","567","893","0","63.49","46.47"
"10","007","00","008","0814","0214","521","415","106","46","567","893","0","63.49","46.47"
"10","007","00","008","0815","0000","503","401","102","62","565","953","0","59.29","42.08"
"10","007","00","008","0815","0215","503","401","102","62","565","953","0","59.29","42.08"
"10","007","00","008","0816","0000","1023","830","193","92","1115","1912","0","58.32","43.41"
"10","007","00","008","0816","0216","481","398","83","36","517","987","0","52.38","40.32"
"10","007","00","008","0816","0217","542","432","110","56","598","925","0","64.65","46.7"
"10","007","00","008","0817","0000","1015","829","186","52","1067","1906","0","55.98","43.49"
"10","007","00","008","0817","0218","499","423","76","24","523","951","0","54.99","44.48"
"10","007","00","008","0817","0219","516","406","110","28","544","955","0","56.96","42.51"
"10","007","00","008","0818","0000","832","667","165","60","892","1606","0","55.54","41.53"
"10","007","00","008","0818","0220","452","363","89","28","480","895","0","53.63","40.56"
"10","007","00","008","0818","0221","380","304","76","32","412","711","0","57.95","42.76"
"10","007","00","009","0000","0000","10322","8346","1976","960","11282","20408","23594","55.28","40.9"
"10","007","00","009","0901","0000","887","738","149","101","988","1752","0","56.39","42.12"
"10","007","00","009","0901","0222","487","411","76","47","534","958","0","55.74","42.9"
"10","007","00","009","0901","0223","400","327","73","54","454","794","0","57.18","41.18"
"10","007","00","009","0902","0000","665","543","122","82","747","1415","0","52.79","38.37"
"10","007","00","009","0902","0224","665","543","122","82","747","1415","0","52.79","38.37"
"10","007","00","009","0903","0000","978","799","179","65","1043","1758","0","59.33","45.45"
"10","007","00","009","0903","0225","540","428","112","29","569","927","0","61.38","46.17"
"10","007","00","009","0903","0226","438","371","67","36","474","831","0","57.04","44.65"
"10","007","00","009","0904","0000","1201","970","231","114","1315","2465","0","53.35","39.35"
"10","007","00","009","0904","0228","589","466","123","46","635","1227","0","51.75","37.98"
"10","007","00","009","0904","0229","612","504","108","68","680","1238","0","54.93","40.71"
"10","007","00","009","0905","0000","1240","990","250","126","1366","2351","0","58.1","42.11"
"10","007","00","009","0905","0230","723","579","144","62","785","1362","0","57.64","42.51"
"10","007","00","009","0905","0231","517","411","106","64","581","989","0","58.75","41.56"
"10","007","00","009","0906","0000","988","822","166","76","1064","1661","0","64.06","49.49"
"10","007","00","009","0906","0232","617","514","103","49","666","1054","0","63.19","48.77"
"10","007","00","009","0906","0233","371","308","63","27","398","607","0","65.57","50.74"
"10","007","00","009","0907","0000","495","406","89","39","534","882","0","60.54","46.03"
"10","007","00","009","0907","0234","495","406","89","39","534","882","0","60.54","46.03"
"10","007","00","009","0908","0000","529","433","96","31","560","1143","0","48.99","37.88"
"10","007","00","009","0908","0235","529","433","96","31","560","1143","0","48.99","37.88"
"10","007","00","009","0909","0000","279","233","46","22","301","661","0","45.54","35.25"
"10","007","00","009","0909","0236","279","233","46","22","301","661","0","45.54","35.25"
"10","007","00","009","0910","0000","817","631","186","35","852","1685","0","50.56","37.45"
"10","007","00","009","0910","0237","406","323","83","3","409","838","0","48.81","38.54"
"10","007","00","009","0910","0238","411","308","103","32","443","847","0","52.3","36.36"
"10","007","00","009","0911","0000","530","435","95","62","592","987","0","59.98","44.07"
"10","007","00","009","0911","0239","530","435","95","62","592","987","0","59.98","44.07"
"10","007","00","009","0912","0000","561","416","145","69","630","1217","0","51.77","34.18"
"10","007","00","009","0912","0240","561","416","145","69","630","1217","0","51.77","34.18"
"10","007","00","009","0913","0000","374","295","79","69","443","865","0","51.21","34.1"
"10","007","00","009","0913","0241","374","295","79","69","443","865","0","51.21","34.1"
"10","007","00","009","0914","0000","480","392","88","47","527","996","0","52.91","39.36"
"10","007","00","009","0914","0242","480","392","88","47","527","996","0","52.91","39.36"
"10","007","00","009","0915","0000","298","243","55","22","320","570","0","56.14","42.63"
"10","007","00","009","0915","0227","298","243","55","22","320","570","0","56.14","42.63"
"10","007","00","010","0000","0000","54114","43129","10985","3431","57545","102028","124755","56.4","42.27"
"10","007","00","010","1001","0000","565","436","129","49","614","1063","0","57.76","41.02"
"10","007","00","010","1001","0504","565","436","129","49","614","1063","0","57.76","41.02"
"10","007","00","010","1002","0000","1535","1104","431","86","1621","2788","0","58.14","39.6"
"10","007","00","010","1002","0505","494","296","198","24","518","925","0","56.0","32.0"
"10","007","00","010","1002","0506","520","400","120","35","555","947","0","58.61","42.24"
"10","007","00","010","1002","0507","521","408","113","27","548","916","0","59.83","44.54"
"10","007","00","010","1003","0000","1686","1357","329","90","1776","3174","0","55.95","42.75"
"10","007","00","010","1003","0528","444","365","79","13","457","867","0","52.71","42.1"
"10","007","00","010","1003","0529","641","513","128","37","678","1201","0","56.45","42.71"
"10","007","00","010","1003","0530","601","479","122","40","641","1106","0","57.96","43.31"
"10","007","00","010","1004","0000","1424","1123","301","105","1529","2588","0","59.08","43.39"
"10","007","00","010","1004","0531","462","348","114","41","503","845","0","59.53","41.18"
"10","007","00","010","1004","0532","492","394","98","33","525","894","0","58.72","44.07"
"10","007","00","010","1004","0533","470","381","89","31","501","849","0","59.01","44.88"
"10","007","00","010","1005","0000","432","339","93","42","474","747","0","63.45","45.38"
"10","007","00","010","1005","0534","432","339","93","42","474","747","0","63.45","45.38"
"10","007","00","010","1006","0000","1487","1182","305","87","1574","2824","0","55.74","41.86"
"10","007","00","010","1006","0535","524","407","117","27","551","884","0","62.33","46.04"
"10","007","00","010","1006","0536","444","363","81","33","477","900","0","53.0","40.33"
"10","007","00","010","1006","0537","519","412","107","27","546","1040","0","52.5","39.62"
"10","007","00","010","1007","0000","443","325","118","19","462","831","0","55.6","39.11"
"10","007","00","010","1007","0538","443","325","118","19","462","831","0","55.6","39.11"
"10","007","00","010","1008","0000","344","270","74","35","379","591","0","64.13","45.69"
"10","007","00","010","1008","0539","344","270","74","35","379","591","0","64.13","45.69"
"10","007","00","010","1009","0000","992","786","206","49","1041","1849","0","56.3","42.51"
"10","007","00","010","1009","0508","447","364","83","31","478","862","0","55.45","42.23"
"10","007","00","010","1009","0509","545","422","123","18","563","987","0","57.04","42.76"
"10","007","00","010","1010","0000","3076","2501","575","152","3228","5677","0","56.86","44.05"
"10","007","00","010","1010","0510","554","451","103","41","595","1085","0","54.84","41.57"
"10","007","00","010","1010","0511","618","514","104","21","639","1110","0","57.57","46.31"
"10","007","00","010","1010","0512","542","437","105","17","559","1095","0","51.05","39.91"
"10","007","00","010","1010","0513","746","592","154","36","782","1278","0","61.19","46.32"
"10","007","00","010","1010","0514","616","507","109","37","653","1109","0","58.88","45.72"
"10","007","00","010","1011","0000","1238","1001","237","92","1330","2487","0","53.48","40.25"
"10","007","00","010","1011","0561","577","467","110","53","630","1131","0","55.7","41.29"
"10","007","00","010","1011","0562","661","534","127","39","700","1356","0","51.62","39.38"
"10","007","00","010","1012","0000","2326","1876","450","148","2474","4191","0","59.03","44.76"
"10","007","00","010","1012","0563","718","587","131","51","769","1370","0","56.13","42.85"
"10","007","00","010","1012","0564","592","465","127","40","632","1090","0","57.98","42.66"
"10","007","00","010","1012","0565","510","412","98","22","532","821","0","64.8","50.18"
"10","007","00","010","1012","0566","506","412","94","35","541","910","0","59.45","45.27"
"10","007","00","010","1013","0000","2746","2166","580","142","2888","4993","0","57.84","43.38"
"10","007","00","010","1013","0567","646","515","131","44","690","1203","0","57.36","42.81"
"10","007","00","010","1013","0568","730","586","144","48","778","1378","0","56.46","42.53"
"10","007","00","010","1013","0569","744","590","154","29","773","1352","0","57.17","43.64"
"10","007","00","010","1013","0570","626","475","151","21","647","1060","0","61.04","44.81"
"10","007","00","010","1014","0000","2353","1896","457","164","2517","4559","0","55.21","41.59"
"10","007","00","010","1014","0571","682","566","116","38","720","1317","0","54.67","42.98"
"10","007","00","010","1014","0572","571","443","128","40","611","1120","0","54.55","39.55"
"10","007","00","010","1014","0573","515","422","93","41","556","1025","0","54.24","41.17"
"10","007","00","010","1014","0574","585","465","120","45","630","1097","0","57.43","42.39"
"10","007","00","010","1015","0000","930","731","199","67","997","1696","0","58.79","43.1"
"10","007","00","010","1015","0575","496","387","109","34","530","859","0","61.7","45.05"
"10","007","00","010","1015","0576","434","344","90","33","467","837","0","55.79","41.1"
"10","007","00","010","1016","0000","1183","938","245","114","1297","2163","0","59.96","43.37"
"10","007","00","010","1016","0577","635","506","129","52","687","1090","0","63.03","46.42"
"10","007","00","010","1016","0578","548","432","116","62","610","1073","0","56.85","40.26"
"10","007","00","010","1017","0000","1376","1105","271","72","1448","2625","0","55.16","42.1"
"10","007","00","010","1017","0540","680","534","146","43","723","1330","0","54.36","40.15"
"10","007","00","010","1017","0541","696","571","125","29","725","1295","0","55.98","44.09"
"10","007","00","010","1018","0000","3260","2630","630","191","3451","6205","0","55.62","42.39"
"10","007","00","010","1018","0545","646","526","120","31","677","1176","0","57.57","44.73"
"10","007","00","010","1018","0546","402","334","68","10","412","867","0","47.52","38.52"
"10","007","00","010","1018","0547","578","442","136","43","621","1121","0","55.4","39.43"
"10","007","00","010","1018","0548","592","491","101","39","631","1190","0","53.03","41.26"
"10","007","00","010","1018","0549","529","419","110","36","565","945","0","59.79","44.34"
"10","007","00","010","1018","0550","513","418","95","32","545","906","0","60.15","46.14"
"10","007","00","010","1019","0000","1589","1286","303","115","1704","2876","0","59.25","44.71"
"10","007","00","010","1019","0551","551","414","137","45","596","978","0","60.94","42.33"
"10","007","00","010","1019","0552","514","433","81","42","556","949","0","58.59","45.63"
"10","007","00","010","1019","0553","524","439","85","28","552","949","0","58.17","46.26"
"10","007","00","010","1020","0000","1013","792","221","91","1104","1931","0","57.17","41.02"
"10","007","00","010","1020","0515","539","427","112","63","602","1055","0","57.06","40.47"
"10","007","00","010","1020","0516","474","365","109","28","502","876","0","57.31","41.67"
"10","007","00","010","1021","0000","1155","915","240","90","1245","2301","0","54.11","39.77"
"10","007","00","010","1021","0517","511","383","128","45","556","1115","0","49.87","34.35"
"10","007","00","010","1021","0518","644","532","112","45","689","1186","0","58.09","44.86"
"10","007","00","010","1022","0000","1694","1360","334","78","1772","3195","0","55.46","42.57"
"10","007","00","010","1022","0519","562","460","102","38","600","995","0","60.3","46.23"
"10","007","00","010","1022","0520","500","400","100","13","513","999","0","51.35","40.04"
"10","007","00","010","1022","0521","632","500","132","27","659","1201","0","54.87","41.63"
"10","007","00","010","1023","0000","1254","1018","236","55","1309","2428","0","53.91","41.93"
"10","007","00","010","1023","0522","703","574","129","29","732","1342","0","54.55","42.77"
"10","007","00","010","1023","0523","551","444","107","26","577","1086","0","53.13","40.88"
"10","007","00","010","1024","0000","2029","1634","395","99","2128","3624","0","58.72","45.09"
"10","007","00","010","1024","0524","432","337","95","27","459","854","0","53.75","39.46"
"10","007","00","010","1024","0525","562","454","108","28","590","1064","0","55.45","42.67"
"10","007","00","010","1024","0526","507","399","108","11","518","879","0","58.93","45.39"
"10","007","00","010","1024","0527","528","444","84","33","561","827","0","67.84","53.69"
"10","007","00","010","1025","0000","1206","984","222","55","1261","2440","0","51.68","40.33"
"10","007","00","010","1025","0481","539","462","77","21","560","1087","0","51.52","42.5"
"10","007","00","010","1025","0482","667","522","145","34","701","1353","0","51.81","38.58"
"10","007","00","010","1026","0000","1216","987","229","89","1305","2641","0","49.41","37.37"
"10","007","00","010","1026","0483","645","510","135","57","702","1313","0","53.47","38.84"
"10","007","00","010","1026","0484","571","477","94","32","603","1328","0","45.41","35.92"
"10","007","00","010","1027","0000","1476","1167","309","100","1576","2786","0","56.57","41.89"
"10","007","00","010","1027","0485","572","436","136","29","601","1055","0","56.97","41.33"
"10","007","00","010","1027","0486","486","401","85","38","524","959","0","54.64","41.81"
"10","007","00","010","1027","0487","418","330","88","33","451","772","0","58.42","42.75"
"10","007","00","010","1028","0000","801","642","159","52","853","1685","0","50.62","38.1"
"10","007","00","010","1028","0488","469","373","96","40","509","831","0","61.25","44.89"
"10","007","00","010","1028","0489","332","269","63","12","344","854","0","40.28","31.5"
"10","007","00","010","1029","0000","494","385","109","38","532","1190","0","44.71","32.35"
"10","007","00","010","1029","0490","494","385","109","38","532","1190","0","44.71","32.35"
"10","007","00","010","1030","0000","378","318","60","16","394","726","0","54.27","43.8"
"10","007","00","010","1030","0491","378","318","60","16","394","726","0","54.27","43.8"
"10","007","00","010","1031","0000","969","767","202","114","1083","1984","0","54.59","38.66"
"10","007","00","010","1031","0492","574","449","125","56","630","1124","0","56.05","39.95"
"10","007","00","010","1031","0493","395","318","77","58","453","860","0","52.67","36.98"
"10","007","00","010","1032","0000","1238","1004","234","80","1318","2197","0","59.99","45.7"
"10","007","00","010","1032","0494","645","533","112","36","681","1122","0","60.7","47.5"
"10","007","00","010","1032","0495","593","471","122","44","637","1075","0","59.26","43.81"
"10","007","00","010","1033","0000","965","759","206","90","1055","1960","0","53.83","38.72"
"10","007","00","010","1033","0496","486","370","116","64","550","993","0","55.39","37.26"
"10","007","00","010","1033","0497","479","389","90","26","505","967","0","52.22","40.23"
"10","007","00","010","1034","0000","936","695","241","98","1034","1812","0","57.06","38.36"
"10","007","00","010","1034","0498","524","381","143","53","577","1008","0","57.24","37.8"
"10","007","00","010","1034","0499","412","314","98","45","457","804","0","56.84","39.05"
"10","007","00","010","1035","0000","897","735","162","56","953","1752","0","54.39","41.95"
"10","007","00","010","1035","0500","455","365","90","29","484","867","0","55.82","42.1"
"10","007","00","010","1035","0501","442","370","72","27","469","885","0","52.99","41.81"
"10","007","00","010","1036","0000","1095","902","193","45","1140","2352","0","48.47","38.35"
"10","007","00","010","1036","0502","457","384","73","15","472","1097","0","43.03","35.0"
"10","007","00","010","1036","0503","638","518","120","30","668","1255","0","53.23","41.27"
"10","007","00","010","1037","0000","1550","1238","312","91","1641","2818","0","58.23","43.93"
"10","007","00","010","1037","0554","532","439","93","29","561","1006","0","55.77","43.64"
"10","007","00","010","1037","0555","487","386","101","41","528","889","0","59.39","43.42"
"10","007","00","010","1037","0556","531","413","118","21","552","923","0","59.8","44.75"
"10","007","00","010","1038","0000","1321","1041","280","75","1396","2284","0","61.12","45.58"
"10","007","00","010","1038","0557","709","563","146","37","746","1209","0","61.7","46.57"
"10","007","00","010","1038","0558","612","478","134","38","650","1075","0","60.47","44.47"
"10","007","00","010","1039","0000","1437","1158","279","76","1513","2381","0","63.54","48.64"
"10","007","00","010","1039","0559","792","650","142","33","825","1342","0","61.48","48.44"
"10","007","00","010","1039","0560","645","508","137","43","688","1039","0","66.22","48.89"
"10","007","00","010","1040","0000","805","623","182","42","847","1388","0","61.02","44.88"
"10","007","00","010","1040","0544","805","623","182","42","847","1388","0","61.02","44.88"
"10","007","00","010","1041","0000","1200","953","247","82","1282","2226","0","57.59","42.81"
"10","007","00","010","1041","0542","668","537","131","47","715","1283","0","55.73","41.86"
"10","007","00","010","1041","0543","532","416","116","35","567","943","0","60.13","44.11"
"10","007","00","011","0000","0000","24262","19566","4696","1832","26094","45147","55412","57.8","43.34"
"10","007","00","011","1101","0000","630","485","145","48","678","1221","0","55.53","39.72"
"10","007","00","011","1101","0640","630","485","145","48","678","1221","0","55.53","39.72"
"10","007","00","011","1102","0000","374","297","77","35","409","638","0","64.11","46.55"
"10","007","00","011","1102","0641","374","297","77","35","409","638","0","64.11","46.55"
"10","007","00","011","1103","0000","990","834","156","82","1072","1785","0","60.06","46.72"
"10","007","00","011","1103","0642","442","376","66","43","485","817","0","59.36","46.02"
"10","007","00","011","1103","0643","548","458","90","39","587","968","0","60.64","47.31"
"10","007","00","011","1104","0000","278","227","51","17","295","448","0","65.85","50.67"
"10","007","00","011","1104","0644","278","227","51","17","295","448","0","65.85","50.67"
"10","007","00","011","1105","0000","1817","1473","344","117","1934","3275","0","59.05","44.98"
"10","007","00","011","1105","0654","575","466","109","37","612","1072","0","57.09","43.47"
"10","007","00","011","1105","0655","620","513","107","48","668","1113","0","60.02","46.09"
"10","007","00","011","1105","0656","622","494","128","32","654","1090","0","60.0","45.32"
"10","007","00","011","1106","0000","1221","1031","190","86","1307","2145","0","60.93","48.07"
"10","007","00","011","1106","0657","678","583","95","38","716","1193","0","60.02","48.87"
"10","007","00","011","1106","0658","543","448","95","48","591","952","0","62.08","47.06"
"10","007","00","011","1107","0000","1872","1530","342","143","2015","3387","0","59.49","45.17"
"10","007","00","011","1107","0659","616","493","123","61","677","1172","0","57.76","42.06"
"10","007","00","011","1107","0660","557","458","99","35","592","1027","0","57.64","44.6"
"10","007","00","011","1107","0661","699","579","120","47","746","1188","0","62.79","48.74"
"10","007","00","011","1108","0000","703","554","149","49","752","1403","0","53.6","39.49"
"10","007","00","011","1108","0662","703","554","149","49","752","1403","0","53.6","39.49"
"10","007","00","011","1109","0000","1499","1211","288","124","1623","3033","0","53.51","39.93"
"10","007","00","011","1109","0663","642","501","141","73","715","1397","0","51.18","35.86"
"10","007","00","011","1109","0664","857","710","147","51","908","1636","0","55.5","43.4"
"10","007","00","011","1110","0000","1355","1120","235","119","1474","2512","0","58.68","44.59"
"10","007","00","011","1110","0665","702","563","139","73","775","1298","0","59.71","43.37"
"10","007","00","011","1110","0666","653","557","96","46","699","1214","0","57.58","45.88"
"10","007","00","011","1111","0000","1287","1046","241","94","1381","2265","0","60.97","46.18"
"10","007","00","011","1111","0667","731","589","142","45","776","1297","0","59.83","45.41"
"10","007","00","011","1111","0668","556","457","99","49","605","968","0","62.5","47.21"
"10","007","00","011","1112","0000","468","370","98","35","503","839","0","59.95","44.1"
"10","007","00","011","1112","0669","468","370","98","35","503","839","0","59.95","44.1"
"10","007","00","011","1113","0000","933","717","216","56","989","1805","0","54.79","39.72"
"10","007","00","011","1113","0670","512","387","125","37","549","907","0","60.53","42.67"
"10","007","00","011","1113","0671","421","330","91","19","440","898","0","49.0","36.75"
"10","007","00","011","1114","0000","1279","1032","247","104","1383","2345","0","58.98","44.01"
"10","007","00","011","1114","0649","626","503","123","51","677","1146","0","59.08","43.89"
"10","007","00","011","1114","0650","653","529","124","53","706","1199","0","58.88","44.12"
"10","007","00","011","1115","0000","474","384","90","24","498","851","0","58.52","45.12"
"10","007","00","011","1115","0653","474","384","90","24","498","851","0","58.52","45.12"
"10","007","00","011","1116","0000","791","609","182","71","862","1365","0","63.15","44.62"
"10","007","00","011","1116","0681","791","609","182","71","862","1365","0","63.15","44.62"
"10","007","00","011","1117","0000","1025","822","203","62","1087","1859","0","58.47","44.22"
"10","007","00","011","1117","0651","475","385","90","46","521","895","0","58.21","43.02"
"10","007","00","011","1117","0652","550","437","113","16","566","964","0","58.71","45.33"
"10","007","00","011","1118","0000","2420","1926","494","142","2562","4689","0","54.64","41.07"
"10","007","00","011","1118","0645","535","430","105","29","564","1123","0","50.22","38.29"
"10","007","00","011","1118","0646","613","471","142","44","657","1166","0","56.35","40.39"
"10","007","00","011","1118","0647","588","468","120","30","618","1151","0","53.69","40.66"
"10","007","00","011","1118","0648","684","557","127","39","723","1249","0","57.89","44.6"
"10","007","00","011","1119","0000","420","344","76","29","449","650","0","69.08","52.92"
"10","007","00","011","1119","0672","420","344","76","29","449","650","0","69.08","52.92"
"10","007","00","011","1120","0000","654","526","128","83","737","1279","0","57.62","41.13"
"10","007","00","011","1120","0673","654","526","128","83","737","1279","0","57.62","41.13"
"10","007","00","011","1121","0000","422","329","93","44","466","730","0","63.84","45.07"
"10","007","00","011","1121","0674","422","329","93","44","466","730","0","63.84","45.07"
"10","007","00","011","1122","0000","754","634","120","61","815","1407","0","57.92","45.06"
"10","007","00","011","1122","0675","754","634","120","61","815","1407","0","57.92","45.06"
"10","007","00","011","1123","0000","578","437","141","59","637","1273","0","50.04","34.33"
"10","007","00","011","1123","0676","578","437","141","59","637","1273","0","50.04","34.33"
"10","007","00","011","1124","0000","1070","866","204","76","1146","2201","0","52.07","39.35"
"10","007","00","011","1124","0679","480","353","127","45","525","1052","0","49.9","33.56"
"10","007","00","011","1124","0680","590","513","77","31","621","1149","0","54.05","44.65"
"10","007","00","011","1125","0000","948","762","186","72","1020","1742","0","58.55","43.74"
"10","007","00","011","1125","0677","515","414","101","24","539","988","0","54.55","41.9"
"10","007","00","011","1125","0678","433","348","85","48","481","754","0","63.79","46.15"
"10","007","00","012","0000","0000","18600","14996","3604","1687","20287","35391","41599","57.32","42.37"
"10","007","00","012","1201","0000","390","311","79","86","476","854","0","55.74","36.42"
"10","007","00","012","1201","0742","390","311","79","86","476","854","0","55.74","36.42"
"10","007","00","012","1202","0000","485","397","88","51","536","1138","0","47.1","34.89"
"10","007","00","012","1202","0743","445","369","76","46","491","963","0","50.99","38.32"
"10","007","00","012","1202","0744","40","28","12","5","45","175","0","25.71","16.0"
"10","007","00","012","1203","0000","360","292","68","34","394","739","0","53.32","39.51"
"10","007","00","012","1203","0745","360","292","68","34","394","739","0","53.32","39.51"
"10","007","00","012","1204","0000","810","648","162","74","884","1567","0","56.41","41.35"
"10","007","00","012","1204","0746","406","328","78","32","438","826","0","53.03","39.71"
"10","007","00","012","1204","0747","404","320","84","42","446","741","0","60.19","43.18"
"10","007","00","012","1205","0000","673","540","133","61","734","1507","0","48.71","35.83"
"10","007","00","012","1205","0748","206","173","33","9","215","506","0","42.49","34.19"
"10","007","00","012","1205","0749","467","367","100","52","519","1001","0","51.85","36.66"
"10","007","00","012","1206","0000","672","544","128","74","746","1281","0","58.24","42.47"
"10","007","00","012","1206","0750","672","544","128","74","746","1281","0","58.24","42.47"
"10","007","00","012","1207","0000","965","774","191","76","1041","1757","0","59.25","44.05"
"10","007","00","012","1207","0753","487","389","98","32","519","844","0","61.49","46.09"
"10","007","00","012","1207","0754","478","385","93","44","522","913","0","57.17","42.17"
"10","007","00","012","1208","0000","364","298","66","39","403","613","0","65.74","48.61"
"10","007","00","012","1208","0755","364","298","66","39","403","613","0","65.74","48.61"
"10","007","00","012","1209","0000","1951","1577","374","156","2107","3351","0","62.88","47.06"
"10","007","00","012","1209","0756","746","594","152","70","816","1382","0","59.04","42.98"
"10","007","00","012","1209","0757","629","523","106","45","674","1034","0","65.18","50.58"
"10","007","00","012","1209","0758","576","460","116","41","617","935","0","65.99","49.2"
"10","007","00","012","1210","0000","1221","1020","201","89","1310","2401","0","54.56","42.48"
"10","007","00","012","1210","0759","598","530","68","53","651","1301","0","50.04","40.74"
"10","007","00","012","1210","0760","623","490","133","36","659","1100","0","59.91","44.55"
"10","007","00","012","1211","0000","590","472","118","50","640","1071","0","59.76","44.07"
"10","007","00","012","1211","0761","590","472","118","50","640","1071","0","59.76","44.07"
"10","007","00","012","1212","0000","667","521","146","57","724","1163","0","62.25","44.8"
"10","007","00","012","1212","0762","667","521","146","57","724","1163","0","62.25","44.8"
"10","007","00","012","1213","0000","1137","1006","131","95","1232","1964","0","62.73","51.22"
"10","007","00","012","1213","0763","495","394","101","39","534","809","0","66.01","48.7"
"10","007","00","012","1213","0764","642","612","30","56","698","1155","0","60.43","52.99"
"10","007","00","012","1214","0000","1280","1004","276","94","1374","2362","0","58.17","42.51"
"10","007","00","012","1214","0751","548","439","109","46","594","1035","0","57.39","42.42"
"10","007","00","012","1214","0752","732","565","167","48","780","1327","0","58.78","42.58"
"10","007","00","012","1215","0000","848","683","165","70","918","1606","0","57.16","42.53"
"10","007","00","012","1215","0766","456","370","86","40","496","870","0","57.01","42.53"
"10","007","00","012","1215","0767","392","313","79","30","422","736","0","57.34","42.53"
"10","007","00","012","1216","0000","645","500","145","48","693","1335","0","51.91","37.45"
"10","007","00","012","1216","0768","645","500","145","48","693","1335","0","51.91","37.45"
"10","007","00","012","1217","0000","885","684","201","96","981","1774","0","55.3","38.56"
"10","007","00","012","1217","0769","447","353","94","44","491","876","0","56.05","40.3"
"10","007","00","012","1217","0770","438","331","107","52","490","898","0","54.57","36.86"
"10","007","00","012","1218","0000","2252","1793","459","150","2402","4224","0","56.87","42.45"
"10","007","00","012","1218","0771","735","592","143","19","754","1298","0","58.09","45.61"
"10","007","00","012","1218","0772","742","576","166","71","813","1451","0","56.03","39.7"
"10","007","00","012","1218","0773","775","625","150","60","835","1475","0","56.61","42.37"
"10","007","00","012","1219","0000","645","518","127","84","729","1270","0","57.4","40.79"
"10","007","00","012","1219","0765","645","518","127","84","729","1270","0","57.4","40.79"
"10","007","00","012","1220","0000","755","621","134","85","840","1576","0","53.3","39.4"
"10","007","00","012","1220","0774","355","275","80","46","401","766","0","52.35","35.9"
"10","007","00","012","1220","0775","400","346","54","39","439","810","0","54.2","42.72"
"10","007","00","012","1221","0000","512","398","114","57","569","953","0","59.71","41.76"
"10","007","00","012","1221","0776","512","398","114","57","569","953","0","59.71","41.76"
"10","007","00","012","1222","0000","493","395","98","61","554","885","0","62.6","44.63"
"10","007","00","012","1222","0777","493","395","98","61","554","885","0","62.6","44.63"
"10","007","00","013","0000","0000","17193","13893","3300","1265","18458","31492","36907","58.61","44.12"
"10","007","00","013","1301","0000","1843","1490","353","133","1976","3152","0","62.69","47.27"
"10","007","00","013","1301","0579","847","671","176","54","901","1426","0","63.18","47.05"
"10","007","00","013","1301","0580","996","819","177","79","1075","1726","0","62.28","47.45"
"10","007","00","013","1302","0000","855","677","178","63","918","1542","0","59.53","43.9"
"10","007","00","013","1302","0581","459","358","101","46","505","797","0","63.36","44.92"
"10","007","00","013","1302","0582","396","319","77","17","413","745","0","55.44","42.82"
"10","007","00","013","1303","0000","778","636","142","57","835","1426","0","58.56","44.6"
"10","007","00","013","1303","0585","778","636","142","57","835","1426","0","58.56","44.6"
"10","007","00","013","1304","0000","631","518","113","61","692","1125","0","61.51","46.04"
"10","007","00","013","1304","0583","631","518","113","61","692","1125","0","61.51","46.04"
"10","007","00","013","1305","0000","615","510","105","33","648","1161","0","55.81","43.93"
"10","007","00","013","1305","0591","615","510","105","33","648","1161","0","55.81","43.93"
"10","007","00","013","1306","0000","1535","1250","285","72","1607","2813","0","57.13","44.44"
"10","007","00","013","1306","0594","771","623","148","49","820","1412","0","58.07","44.12"
"10","007","00","013","1306","0595","764","627","137","23","787","1401","0","56.17","44.75"
"10","007","00","013","1307","0000","1668","1337","331","129","1797","3028","0","59.35","44.15"
"10","007","00","013","1307","0597","543","418","125","58","601","996","0","60.34","41.97"
"10","007","00","013","1307","0598","577","467","110","34","611","1047","0","58.36","44.6"
"10","007","00","013","1307","0599","548","452","96","37","585","985","0","59.39","45.89"
"10","007","00","013","1308","0000","1322","1102","220","101","1423","2494","0","57.06","44.19"
"10","007","00","013","1308","0604","664","550","114","48","712","1189","0","59.88","46.26"
"10","007","00","013","1308","0605","658","552","106","53","711","1305","0","54.48","42.3"
"10","007","00","013","1309","0000","769","616","153","90","859","1486","0","57.81","41.45"
"10","007","00","013","1309","0584","769","616","153","90","859","1486","0","57.81","41.45"
"10","007","00","013","1310","0000","813","660","153","68","881","1478","0","59.61","44.65"
"10","007","00","013","1310","0588","813","660","153","68","881","1478","0","59.61","44.65"
"10","007","00","013","1311","0000","775","631","144","65","840","1395","0","60.22","45.23"
"10","007","00","013","1311","0596","775","631","144","65","840","1395","0","60.22","45.23"
"10","007","00","013","1312","0000","1049","826","223","75","1124","2001","0","56.17","41.28"
"10","007","00","013","1312","0586","487","368","119","36","523","824","0","63.47","44.66"
"10","007","00","013","1312","0587","562","458","104","39","601","1177","0","51.06","38.91"
"10","007","00","013","1313","0000","854","687","167","62","916","1591","0","57.57","43.18"
"10","007","00","013","1313","0589","390","306","84","16","406","779","0","52.12","39.28"
"10","007","00","013","1313","0590","464","381","83","46","510","812","0","62.81","46.92"
"10","007","00","013","1314","0000","1312","1047","265","70","1382","2497","0","55.35","41.93"
"10","007","00","013","1314","0592","633","517","116","23","656","1238","0","52.99","41.76"
"10","007","00","013","1314","0593","679","530","149","47","726","1259","0","57.66","42.1"
"10","007","00","013","1315","0000","1291","1041","250","78","1369","2254","0","60.74","46.18"
"10","007","00","013","1315","0600","622","497","125","36","658","1054","0","62.43","47.15"
"10","007","00","013","1315","0601","669","544","125","42","711","1200","0","59.25","45.33"
"10","007","00","013","1316","0000","1083","865","218","108","1191","2049","0","58.13","42.22"
"10","007","00","013","1316","0602","550","446","104","68","618","1003","0","61.62","44.47"
"10","007","00","013","1316","0603","533","419","114","40","573","1046","0","54.78","40.06"
"10","007","00","014","0000","0000","15541","12676","2865","1323","16864","28026","32517","60.17","45.23"
"10","007","00","014","1401","0000","1013","815","198","72","1085","1712","0","63.38","47.61"
"10","007","00","014","1401","0682","551","442","109","42","593","958","0","61.9","46.14"
"10","007","00","014","1401","0683","462","373","89","30","492","754","0","65.25","49.47"
"10","007","00","014","1402","0000","944","744","200","59","1003","1563","0","64.17","47.6"
"10","007","00","014","1402","0684","474","371","103","27","501","757","0","66.18","49.01"
"10","007","00","014","1402","0685","470","373","97","32","502","806","0","62.28","46.28"
"10","007","00","014","1403","0000","710","603","107","51","761","1280","0","59.45","47.11"
"10","007","00","014","1403","0686","710","603","107","51","761","1280","0","59.45","47.11"
"10","007","00","014","1404","0000","508","421","87","40","548","928","0","59.05","45.37"
"10","007","00","014","1404","0687","508","421","87","40","548","928","0","59.05","45.37"
"10","007","00","014","1405","0000","1010","788","222","109","1119","1710","0","65.44","46.08"
"10","007","00","014","1405","0688","537","415","122","56","593","895","0","66.26","46.37"
"10","007","00","014","1405","0689","473","373","100","53","526","815","0","64.54","45.77"
"10","007","00","014","1406","0000","525","433","92","35","560","957","0","58.52","45.25"
"10","007","00","014","1406","0690","525","433","92","35","560","957","0","58.52","45.25"
"10","007","00","014","1407","0000","686","580","106","100","786","1338","0","58.74","43.35"
"10","007","00","014","1407","0691","686","580","106","100","786","1338","0","58.74","43.35"
"10","007","00","014","1408","0000","597","484","113","38","635","1106","0","57.41","43.76"
"10","007","00","014","1408","0692","597","484","113","38","635","1106","0","57.41","43.76"
"10","007","00","014","1409","0000","438","363","75","35","473","690","0","68.55","52.61"
"10","007","00","014","1409","0693","438","363","75","35","473","690","0","68.55","52.61"
"10","007","00","014","1410","0000","654","537","117","50","704","1230","0","57.24","43.66"
"10","007","00","014","1410","0694","654","537","117","50","704","1230","0","57.24","43.66"
"10","007","00","014","1411","0000","1009","835","174","39","1048","1744","0","60.09","47.88"
"10","007","00","014","1411","0695","463","387","76","23","486","847","0","57.38","45.69"
"10","007","00","014","1411","0696","546","448","98","16","562","897","0","62.65","49.94"
"10","007","00","014","1412","0000","1164","942","222","81","1245","2062","0","60.38","45.68"
"10","007","00","014","1412","0697","486","384","102","43","529","882","0","59.98","43.54"
"10","007","00","014","1412","0698","678","558","120","38","716","1180","0","60.68","47.29"
"10","007","00","014","1413","0000","631","488","143","74","705","1215","0","58.02","40.16"
"10","007","00","014","1413","0699","631","488","143","74","705","1215","0","58.02","40.16"
"10","007","00","014","1414","0000","259","236","23","22","281","422","0","66.59","55.92"
"10","007","00","014","1414","0700","259","236","23","22","281","422","0","66.59","55.92"
"10","007","00","014","1415","0000","578","509","69","42","620","1106","0","56.06","46.02"
"10","007","00","014","1415","0701","578","509","69","42","620","1106","0","56.06","46.02"
"10","007","00","014","1416","0000","503","402","101","60","563","874","0","64.42","46.0"
"10","007","00","014","1416","0702","503","402","101","60","563","874","0","64.42","46.0"
"10","007","00","014","1417","0000","779","627","152","83","862","1445","0","59.65","43.39"
"10","007","00","014","1417","0703","779","627","152","83","862","1445","0","59.65","43.39"
"10","007","00","014","1418","0000","484","393","91","60","544","875","0","62.17","44.91"
"10","007","00","014","1418","0704","484","393","91","60","544","875","0","62.17","44.91"
"10","007","00","014","1419","0000","785","656","129","74","859","1522","0","56.44","43.1"
"10","007","00","014","1419","0705","400","332","68","47","447","837","0","53.41","39.67"
"10","007","00","014","1419","0706","385","324","61","27","412","685","0","60.15","47.3"
"10","007","00","014","1420","0000","857","680","177","105","962","1531","0","62.83","44.42"
"10","007","00","014","1420","0707","434","359","75","33","467","733","0","63.71","48.98"
"10","007","00","014","1420","0708","423","321","102","72","495","798","0","62.03","40.23"
"10","007","00","014","1421","0000","743","606","137","52","795","1381","0","57.57","43.88"
"10","007","00","014","1421","0709","743","606","137","52","795","1381","0","57.57","43.88"
"10","007","00","014","1422","0000","664","534","130","42","706","1335","0","52.88","40.0"
"10","007","00","014","1422","0710","664","534","130","42","706","1335","0","52.88","40.0"
"10","007","00","015","0000","0000","16697","13153","3544","1503","18200","29642","34739","61.4","44.37"
"10","007","00","015","1501","0000","1985","1600","385","211","2196","3604","0","60.93","44.4"
"10","007","00","015","1501","0711","634","516","118","75","709","1139","0","62.25","45.3"
"10","007","00","015","1501","0712","648","520","128","76","724","1217","0","59.49","42.73"
"10","007","00","015","1501","0713","703","564","139","60","763","1248","0","61.14","45.19"
"10","007","00","015","1502","0000","724","550","174","74","798","1248","0","63.94","44.07"
"10","007","00","015","1502","0714","724","550","174","74","798","1248","0","63.94","44.07"
"10","007","00","015","1503","0000","906","698","208","69","975","1541","0","63.27","45.3"
"10","007","00","015","1503","0715","522","396","126","42","564","916","0","61.57","43.23"
"10","007","00","015","1503","0716","384","302","82","27","411","625","0","65.76","48.32"
"10","007","00","015","1504","0000","658","514","144","74","732","1271","0","57.59","40.44"
"10","007","00","015","1504","0717","658","514","144","74","732","1271","0","57.59","40.44"
"10","007","00","015","1505","0000","1018","820","198","90","1108","1740","0","63.68","47.13"
"10","007","00","015","1505","0718","351","288","63","25","376","608","0","61.84","47.37"
"10","007","00","015","1505","0719","667","532","135","65","732","1132","0","64.66","47.0"
"10","007","00","015","1506","0000","1130","887","243","98","1228","1953","0","62.88","45.42"
"10","007","00","015","1506","0720","585","456","129","53","638","1027","0","62.12","44.4"
"10","007","00","015","1506","0721","545","431","114","45","590","926","0","63.71","46.54"
"10","007","00","015","1507","0000","818","645","173","89","907","1438","0","63.07","44.85"
"10","007","00","015","1507","0722","426","335","91","56","482","778","0","61.95","43.06"
"10","007","00","015","1507","0723","392","310","82","33","425","660","0","64.39","46.97"
"10","007","00","015","1508","0000","1114","889","225","69","1183","2019","0","58.59","44.03"
"10","007","00","015","1508","0726","555","445","110","33","588","985","0","59.7","45.18"
"10","007","00","015","1508","0727","559","444","115","36","595","1034","0","57.54","42.94"
"10","007","00","015","1509","0000","1319","1053","266","79","1398","2321","0","60.23","45.37"
"10","007","00","015","1509","0724","767","620","147","53","820","1330","0","61.65","46.62"
"10","007","00","015","1509","0725","552","433","119","26","578","991","0","58.32","43.69"
"10","007","00","015","1510","0000","355","285","70","40","395","612","0","64.54","46.57"
"10","007","00","015","1510","0728","355","285","70","40","395","612","0","64.54","46.57"
"10","007","00","015","1511","0000","727","595","132","63","790","1236","0","63.92","48.14"
"10","007","00","015","1511","0729","727","595","132","63","790","1236","0","63.92","48.14"
"10","007","00","015","1512","0000","895","680","215","87","982","1513","0","64.9","44.94"
"10","007","00","015","1512","0730","440","332","108","46","486","775","0","62.71","42.84"
"10","007","00","015","1512","0731","455","348","107","41","496","738","0","67.21","47.15"
"10","007","00","015","1513","0000","601","458","143","39","640","1036","0","61.78","44.21"
"10","007","00","015","1513","0732","601","458","143","39","640","1036","0","61.78","44.21"
"10","007","00","015","1514","0000","489","375","114","69","558","975","0","57.23","38.46"
"10","007","00","015","1514","0733","489","375","114","69","558","975","0","57.23","38.46"
"10","007","00","015","1515","0000","737","605","132","63","800","1348","0","59.35","44.88"
"10","007","00","015","1515","0736","374","303","71","38","412","689","0","59.8","43.98"
"10","007","00","015","1515","0737","363","302","61","25","388","659","0","58.88","45.83"
"10","007","00","015","1516","0000","1017","756","261","96","1113","1824","0","61.02","41.45"
"10","007","00","015","1516","0734","482","352","130","42","524","885","0","59.21","39.77"
"10","007","00","015","1516","0735","535","404","131","54","589","939","0","62.73","43.02"
"10","007","00","015","1517","0000","814","613","201","78","892","1352","0","65.98","45.34"
"10","007","00","015","1517","0739","814","613","201","78","892","1352","0","65.98","45.34"
"10","007","00","015","1518","0000","459","371","88","37","496","910","0","54.51","40.77"
"10","007","00","015","1518","0738","459","371","88","37","496","910","0","54.51","40.77"
"10","007","00","015","1519","0000","409","320","89","33","442","759","0","58.23","42.16"
"10","007","00","015","1519","0740","409","320","89","33","442","759","0","58.23","42.16"
"10","007","00","015","1520","0000","522","439","83","45","567","942","0","60.19","46.6"
"10","007","00","015","1520","0741","522","439","83","45","567","942","0","60.19","46.6"
"10","007","00","016","0000","0000","17008","13632","3376","1436","18444","31239","37055","59.04","43.64"
"10","007","00","016","1601","0000","506","401","105","43","549","792","0","69.32","50.63"
"10","007","00","016","1601","0616","506","401","105","43","549","792","0","69.32","50.63"
"10","007","00","016","1602","0000","869","719","150","84","953","1516","0","62.86","47.43"
"10","007","00","016","1602","0617","400","320","80","44","444","695","0","63.88","46.04"
"10","007","00","016","1602","0618","469","399","70","40","509","821","0","62.0","48.6"
"10","007","00","016","1603","0000","1058","834","224","97","1155","1904","0","60.66","43.8"
"10","007","00","016","1603","0619","604","491","113","66","670","1064","0","62.97","46.15"
"10","007","00","016","1603","0620","454","343","111","31","485","840","0","57.74","40.83"
"10","007","00","016","1604","0000","1234","977","257","78","1312","2127","0","61.68","45.93"
"10","007","00","016","1604","0621","617","481","136","41","658","1079","0","60.98","44.58"
"10","007","00","016","1604","0622","617","496","121","37","654","1048","0","62.4","47.33"
"10","007","00","016","1605","0000","1026","829","197","63","1089","1758","0","61.95","47.16"
"10","007","00","016","1605","0623","575","473","102","35","610","960","0","63.54","49.27"
"10","007","00","016","1605","0624","451","356","95","28","479","798","0","60.03","44.61"
"10","007","00","016","1606","0000","847","669","178","62","909","1458","0","62.35","45.88"
"10","007","00","016","1606","0625","507","398","109","24","531","796","0","66.71","50.0"
"10","007","00","016","1606","0626","340","271","69","38","378","662","0","57.1","40.94"
"10","007","00","016","1607","0000","562","434","128","47","609","1040","0","58.56","41.73"
"10","007","00","016","1607","0627","562","434","128","47","609","1040","0","58.56","41.73"
"10","007","00","016","1608","0000","543","433","110","44","587","1025","0","57.27","42.24"
"10","007","00","016","1608","0628","543","433","110","44","587","1025","0","57.27","42.24"
"10","007","00","016","1609","0000","1475","1207","268","131","1606","2593","0","61.94","46.55"
"10","007","00","016","1609","0629","804","657","147","57","861","1357","0","63.45","48.42"
"10","007","00","016","1609","0630","671","550","121","74","745","1236","0","60.28","44.5"
"10","007","00","016","1610","0000","786","615","171","66","852","1393","0","61.16","44.15"
"10","007","00","016","1610","0611","381","295","86","39","420","659","0","63.73","44.76"
"10","007","00","016","1610","0612","405","320","85","27","432","734","0","58.86","43.6"
"10","007","00","016","1611","0000","594","493","101","68","662","1255","0","52.75","39.28"
"10","007","00","016","1611","0606","594","493","101","68","662","1255","0","52.75","39.28"
"10","007","00","016","1612","0000","923","735","188","79","1002","1648","0","60.8","44.6"
"10","007","00","016","1612","0609","410","326","84","40","450","724","0","62.15","45.03"
"10","007","00","016","1612","0610","513","409","104","39","552","924","0","59.74","44.26"
"10","007","00","016","1613","0000","1031","834","197","88","1119","1915","0","58.43","43.55"
"10","007","00","016","1613","0607","493","401","92","49","542","889","0","60.97","45.11"
"10","007","00","016","1613","0608","538","433","105","39","577","1026","0","56.24","42.2"
"10","007","00","016","1614","0000","837","675","162","64","901","1606","0","56.1","42.03"
"10","007","00","016","1614","0613","332","267","65","21","353","758","0","46.57","35.22"
"10","007","00","016","1614","0614","505","408","97","43","548","848","0","64.62","48.11"
"10","007","00","016","1615","0000","689","531","158","77","766","1404","0","54.56","37.82"
"10","007","00","016","1615","0615","689","531","158","77","766","1404","0","54.56","37.82"
"10","007","00","016","1616","0000","430","342","88","43","473","871","0","54.31","39.27"
"10","007","00","016","1616","0631","430","342","88","43","473","871","0","54.31","39.27"
"10","007","00","016","1617","0000","344","281","63","39","383","706","0","54.25","39.8"
"10","007","00","016","1617","0632","344","281","63","39","383","706","0","54.25","39.8"
"10","007","00","016","1618","0000","458","376","82","27","485","770","0","62.99","48.83"
"10","007","00","016","1618","0633","458","376","82","27","485","770","0","62.99","48.83"
"10","007","00","016","1619","0000","410","330","80","30","440","669","0","65.77","49.33"
"10","007","00","016","1619","0634","410","330","80","30","440","669","0","65.77","49.33"
"10","007","00","016","1620","0000","451","363","88","44","495","862","0","57.42","42.11"
"10","007","00","016","1620","0635","451","363","88","44","495","862","0","57.42","42.11"
"10","007","00","016","1621","0000","440","356","84","32","472","847","0","55.73","42.03"
"10","007","00","016","1621","0636","440","356","84","32","472","847","0","55.73","42.03"
"10","007","00","016","1622","0000","384","321","63","45","429","668","0","64.22","48.05"
"10","007","00","016","1622","0637","384","321","63","45","429","668","0","64.22","48.05"
"10","007","00","016","1623","0000","518","426","92","26","544","1073","0","50.7","39.7"
"10","007","00","016","1623","0638","518","426","92","26","544","1073","0","50.7","39.7"
"10","007","00","016","1624","0000","593","451","142","59","652","1339","0","48.69","33.68"
"10","007","00","016","1624","0639","593","451","142","59","652","1339","0","48.69","33.68"
"10","007","00","017","0000","0000","19341","15452","3889","1416","20757","36306","42917","57.17","42.56"
"10","007","00","017","1701","0000","1444","1117","327","90","1534","2765","0","55.48","40.4"
"10","007","00","017","1701","0778","425","316","109","38","463","791","0","58.53","39.95"
"10","007","00","017","1701","0779","524","415","109","36","560","984","0","56.91","42.17"
"10","007","00","017","1701","0780","495","386","109","16","511","990","0","51.62","38.99"
"10","007","00","017","1702","0000","760","586","174","54","814","1478","0","55.07","39.65"
"10","007","00","017","1702","0785","404","313","91","24","428","753","0","56.84","41.57"
"10","007","00","017","1702","0786","356","273","83","30","386","725","0","53.24","37.66"
"10","007","00","017","1703","0000","601","472","129","70","671","1165","0","57.6","40.52"
"10","007","00","017","1703","0805","601","472","129","70","671","1165","0","57.6","40.52"
"10","007","00","017","1704","0000","2502","2013","489","178","2680","4546","0","58.95","44.28"
"10","007","00","017","1704","0781","577","455","122","52","629","1016","0","61.91","44.78"
"10","007","00","017","1704","0782","628","492","136","31","659","1091","0","60.4","45.1"
"10","007","00","017","1704","0783","677","536","141","66","743","1236","0","60.11","43.37"
"10","007","00","017","1704","0784","620","530","90","29","649","1203","0","53.95","44.06"
"10","007","00","017","1705","0000","523","422","101","36","559","933","0","59.91","45.23"
"10","007","00","017","1705","0790","523","422","101","36","559","933","0","59.91","45.23"
"10","007","00","017","1706","0000","545","429","116","26","571","1092","0","52.29","39.29"
"10","007","00","017","1706","0812","545","429","116","26","571","1092","0","52.29","39.29"
"10","007","00","017","1707","0000","1464","1212","252","78","1542","2698","0","57.15","44.92"
"10","007","00","017","1707","0798","365","313","52","21","386","688","0","56.1","45.49"
"10","007","00","017","1707","0799","443","367","76","34","477","870","0","54.83","42.18"
"10","007","00","017","1707","0800","656","532","124","23","679","1140","0","59.56","46.67"
"10","007","00","017","1708","0000","1085","873","212","82","1167","2066","0","56.49","42.26"
"10","007","00","017","1708","0791","560","448","112","45","605","990","0","61.11","45.25"
"10","007","00","017","1708","0792","525","425","100","37","562","1076","0","52.23","39.5"
"10","007","00","017","1709","0000","428","333","95","30","458","724","0","63.26","45.99"
"10","007","00","017","1709","0807","428","333","95","30","458","724","0","63.26","45.99"
"10","007","00","017","1710","0000","514","399","115","38","552","937","0","58.91","42.58"
"10","007","00","017","1710","0803","514","399","115","38","552","937","0","58.91","42.58"
"10","007","00","017","1711","0000","869","677","192","67","936","1645","0","56.9","41.16"
"10","007","00","017","1711","0796","414","317","97","37","451","750","0","60.13","42.27"
"10","007","00","017","1711","0797","455","360","95","30","485","895","0","54.19","40.22"
"10","007","00","017","1712","0000","559","448","111","43","602","992","0","60.69","45.16"
"10","007","00","017","1712","0811","559","448","111","43","602","992","0","60.69","45.16"
"10","007","00","017","1713","0000","737","606","131","49","786","1266","0","62.09","47.87"
"10","007","00","017","1713","0802","737","606","131","49","786","1266","0","62.09","47.87"
"10","007","00","017","1714","0000","773","620","153","37","810","1414","0","57.28","43.85"
"10","007","00","017","1714","0793","429","341","88","19","448","742","0","60.38","45.96"
"10","007","00","017","1714","0794","344","279","65","18","362","672","0","53.87","41.52"
"10","007","00","017","1715","0000","550","471","79","40","590","1015","0","58.13","46.4"
"10","007","00","017","1715","0808","550","471","79","40","590","1015","0","58.13","46.4"
"10","007","00","017","1716","0000","549","415","134","34","583","985","0","59.19","42.13"
"10","007","00","017","1716","0801","549","415","134","34","583","985","0","59.19","42.13"
"10","007","00","017","1717","0000","591","495","96","37","628","1235","0","50.85","40.08"
"10","007","00","017","1717","0795","591","495","96","37","628","1235","0","50.85","40.08"
"10","007","00","017","1718","0000","461","367","94","44","505","828","0","60.99","44.32"
"10","007","00","017","1718","0813","461","367","94","44","505","828","0","60.99","44.32"
"10","007","00","017","1719","0000","890","699","191","66","956","1611","0","59.34","43.39"
"10","007","00","017","1719","0788","344","264","80","34","378","562","0","67.26","46.98"
"10","007","00","017","1719","0789","546","435","111","32","578","1049","0","55.1","41.47"
"10","007","00","017","1720","0000","538","428","110","46","584","986","0","59.23","43.41"
"10","007","00","017","1720","0806","538","428","110","46","584","986","0","59.23","43.41"
"10","007","00","017","1721","0000","694","563","131","75","769","1506","0","51.06","37.38"
"10","007","00","017","1721","0814","372","296","76","53","425","787","0","54.0","37.61"
"10","007","00","017","1721","0815","322","267","55","22","344","719","0","47.84","37.13"
"10","007","00","017","1722","0000","555","446","109","69","624","1023","0","61.0","43.6"
"10","007","00","017","1722","0787","555","446","109","69","624","1023","0","61.0","43.6"
"10","007","00","017","1723","0000","647","538","109","43","690","1219","0","56.6","44.13"
"10","007","00","017","1723","0804","647","538","109","43","690","1219","0","56.6","44.13"
"10","007","00","017","1724","0000","1062","823","239","84","1146","2177","0","52.64","37.8"
"10","007","00","017","1724","0809","541","423","118","31","572","1116","0","51.25","37.9"
"10","007","00","017","1724","0810","521","400","121","53","574","1061","0","54.1","37.7"
"10","007","00","018","0000","0000","7290","5683","1607","694","7984","13339","15193","59.85","42.6"
"10","007","00","018","1801","0000","424","325","99","46","470","871","0","53.96","37.31"
"10","007","00","018","1801","0818","424","325","99","46","470","871","0","53.96","37.31"
"10","007","00","018","1802","0000","509","426","83","52","561","953","0","58.87","44.7"
"10","007","00","018","1802","0819","509","426","83","52","561","953","0","58.87","44.7"
"10","007","00","018","1803","0000","291","209","82","49","340","624","0","54.49","33.49"
"10","007","00","018","1803","0820","291","209","82","49","340","624","0","54.49","33.49"
"10","007","00","018","1804","0000","387","310","77","41","428","645","0","66.36","48.06"
"10","007","00","018","1804","0821","387","310","77","41","428","645","0","66.36","48.06"
"10","007","00","018","1805","0000","556","434","122","63","619","943","0","65.64","46.02"
"10","007","00","018","1805","0823","556","434","122","63","619","943","0","65.64","46.02"
"10","007","00","018","1806","0000","609","494","115","40","649","986","0","65.82","50.1"
"10","007","00","018","1806","0822","609","494","115","40","649","986","0","65.82","50.1"
"10","007","00","018","1807","0000","518","401","117","38","556","831","0","66.91","48.26"
"10","007","00","018","1807","0825","518","401","117","38","556","831","0","66.91","48.26"
"10","007","00","018","1808","0000","261","204","57","2","263","455","0","57.8","44.84"
"10","007","00","018","1808","0824","261","204","57","2","263","455","0","57.8","44.84"
"10","007","00","018","1809","0000","530","400","130","21","551","1013","0","54.39","39.49"
"10","007","00","018","1809","0827","530","400","130","21","551","1013","0","54.39","39.49"
"10","007","00","018","1810","0000","468","380","88","33","501","831","0","60.29","45.73"
"10","007","00","018","1810","0826","468","380","88","33","501","831","0","60.29","45.73"
"10","007","00","018","1811","0000","435","312","123","70","505","796","0","63.44","39.2"
"10","007","00","018","1811","0828","435","312","123","70","505","796","0","63.44","39.2"
"10","007","00","018","1812","0000","405","319","86","50","455","781","0","58.26","40.85"
"10","007","00","018","1812","0829","405","319","86","50","455","781","0","58.26","40.85"
"10","007","00","018","1813","0000","331","258","73","18","349","692","0","50.43","37.28"
"10","007","00","018","1813","0830","331","258","73","18","349","692","0","50.43","37.28"
"10","007","00","018","1814","0000","340","271","69","30","370","635","0","58.27","42.68"
"10","007","00","018","1814","0831","340","271","69","30","370","635","0","58.27","42.68"
"10","007","00","018","1815","0000","299","223","76","28","327","566","0","57.77","39.4"
"10","007","00","018","1815","0832","299","223","76","28","327","566","0","57.77","39.4"
"10","007","00","018","1816","0000","541","410","131","66","607","1028","0","59.05","39.88"
"10","007","00","018","1816","0816","541","410","131","66","607","1028","0","59.05","39.88"
"10","007","00","018","1817","0000","386","307","79","47","433","689","0","62.84","44.56"
"10","007","00","018","1817","0817","386","307","79","47","433","689","0","62.84","44.56"
"10","007","00","019","0000","0000","14774","11915","2859","1294","16068","27593","33335","58.23","43.18"
"10","007","00","019","1901","0000","1013","835","178","67","1080","1790","0","60.34","46.65"
"10","007","00","019","1901","0844","477","394","83","34","511","833","0","61.34","47.3"
"10","007","00","019","1901","0845","536","441","95","33","569","957","0","59.46","46.08"
"10","007","00","019","1902","0000","409","332","77","30","439","783","0","56.07","42.4"
"10","007","00","019","1902","0846","409","332","77","30","439","783","0","56.07","42.4"
"10","007","00","019","1903","0000","286","228","58","28","314","573","0","54.8","39.79"
"10","007","00","019","1903","0847","286","228","58","28","314","573","0","54.8","39.79"
"10","007","00","019","1904","0000","345","271","74","38","383","672","0","56.99","40.33"
"10","007","00","019","1904","0848","345","271","74","38","383","672","0","56.99","40.33"
"10","007","00","019","1905","0000","705","556","149","74","779","1442","0","54.02","38.56"
"10","007","00","019","1905","0849","339","266","73","39","378","695","0","54.39","38.27"
"10","007","00","019","1905","0850","366","290","76","35","401","747","0","53.68","38.82"
"10","007","00","019","1906","0000","753","618","135","63","816","1305","0","62.53","47.36"
"10","007","00","019","1906","0851","387","322","65","23","410","643","0","63.76","50.08"
"10","007","00","019","1906","0852","366","296","70","40","406","662","0","61.33","44.71"
"10","007","00","019","1907","0000","1241","992","249","108","1349","2206","0","61.15","44.97"
"10","007","00","019","1907","0853","630","501","129","54","684","1085","0","63.04","46.18"
"10","007","00","019","1907","0854","611","491","120","54","665","1121","0","59.32","43.8"
"10","007","00","019","1908","0000","1605","1296","309","109","1714","3017","0","56.81","42.96"
"10","007","00","019","1908","0855","470","388","82","38","508","830","0","61.2","46.75"
"10","007","00","019","1908","0856","506","402","104","40","546","975","0","56.0","41.23"
"10","007","00","019","1908","0857","629","506","123","31","660","1212","0","54.46","41.75"
"10","007","00","019","1909","0000","710","582","128","70","780","1302","0","59.91","44.7"
"10","007","00","019","1909","0858","710","582","128","70","780","1302","0","59.91","44.7"
"10","007","00","019","1910","0000","2483","2001","482","208","2691","4597","0","58.54","43.53"
"10","007","00","019","1910","0838","622","505","117","51","673","1124","0","59.88","44.93"
"10","007","00","019","1910","0839","620","496","124","46","666","1096","0","60.77","45.26"
"10","007","00","019","1910","0840","665","530","135","42","707","1213","0","58.29","43.69"
"10","007","00","019","1910","0841","576","470","106","69","645","1164","0","55.41","40.38"
"10","007","00","019","1911","0000","849","691","158","54","903","1608","0","56.16","42.97"
"10","007","00","019","1911","0842","378","308","70","27","405","730","0","55.48","42.19"
"10","007","00","019","1911","0843","471","383","88","27","498","878","0","56.72","43.62"
"10","007","00","019","1912","0000","1431","1139","292","166","1597","2649","0","60.29","43.0"
"10","007","00","019","1912","0833","442","358","84","72","514","925","0","55.57","38.7"
"10","007","00","019","1912","0834","479","385","94","52","531","869","0","61.1","44.3"
"10","007","00","019","1912","0835","510","396","114","42","552","855","0","64.56","46.32"
"10","007","00","019","1913","0000","1068","837","231","106","1174","1893","0","62.02","44.22"
"10","007","00","019","1913","0836","627","494","133","46","673","1065","0","63.19","46.38"
"10","007","00","019","1913","0837","441","343","98","60","501","828","0","60.51","41.43"
"10","007","00","019","1914","0000","944","779","165","93","1037","1994","0","52.01","39.07"
"10","007","00","019","1914","0859","499","410","89","32","531","1077","0","49.3","38.07"
"10","007","00","019","1914","0860","445","369","76","61","506","917","0","55.18","40.24"
"10","007","00","019","1915","0000","932","758","174","80","1012","1762","0","57.43","43.02"
"10","007","00","019","1915","0861","425","342","83","32","457","825","0","55.39","41.45"
"10","007","00","019","1915","0862","507","416","91","48","555","937","0","59.23","44.4"
"10","007","00","020","0000","0000","20403","16535","3868","1952","22355","42976","50709","52.02","38.47"
"10","007","00","020","2001","0000","1135","887","248","97","1232","2148","0","57.36","41.29"
"10","007","00","020","2001","0945","479","380","99","36","515","892","0","57.74","42.6"
"10","007","00","020","2001","0946","656","507","149","61","717","1256","0","57.09","40.37"
"10","007","00","020","2002","0000","1705","1402","303","149","1854","3201","0","57.92","43.8"
"10","007","00","020","2002","0947","518","430","88","52","570","1043","0","54.65","41.23"
"10","007","00","020","2002","0948","609","495","114","40","649","1076","0","60.32","46.0"
"10","007","00","020","2002","0949","578","477","101","57","635","1082","0","58.69","44.09"
"10","007","00","020","2003","0000","701","564","137","57","758","1427","0","53.12","39.52"
"10","007","00","020","2003","0950","701","564","137","57","758","1427","0","53.12","39.52"
"10","007","00","020","2004","0000","1436","1159","277","172","1608","3040","0","52.89","38.13"
"10","007","00","020","2004","0951","459","373","86","67","526","1030","0","51.07","36.21"
"10","007","00","020","2004","0952","479","373","106","55","534","1033","0","51.69","36.11"
"10","007","00","020","2004","0953","498","413","85","50","548","977","0","56.09","42.27"
"10","007","00","020","2005","0000","794","641","153","67","861","1658","0","51.93","38.66"
"10","007","00","020","2005","0954","324","259","65","27","351","683","0","51.39","37.92"
"10","007","00","020","2005","0955","470","382","88","40","510","975","0","52.31","39.18"
"10","007","00","020","2006","0000","526","429","97","70","596","1336","0","44.61","32.11"
"10","007","00","020","2006","0956","526","429","97","70","596","1336","0","44.61","32.11"
"10","007","00","020","2007","0000","425","329","96","60","485","1019","0","47.6","32.29"
"10","007","00","020","2007","0957","425","329","96","60","485","1019","0","47.6","32.29"
"10","007","00","020","2008","0000","395","309","86","46","441","1003","0","43.97","30.81"
"10","007","00","020","2008","0958","395","309","86","46","441","1003","0","43.97","30.81"
"10","007","00","020","2009","0000","587","493","94","59","646","1151","0","56.13","42.83"
"10","007","00","020","2009","0959","587","493","94","59","646","1151","0","56.13","42.83"
"10","007","00","020","2010","0000","813","655","158","96","909","1598","0","56.88","40.99"
"10","007","00","020","2010","0960","813","655","158","96","909","1598","0","56.88","40.99"
"10","007","00","020","2011","0000","1595","1378","217","107","1702","3259","0","52.22","42.28"
"10","007","00","020","2011","0961","742","598","144","54","796","1488","0","53.49","40.19"
"10","007","00","020","2011","0962","853","780","73","53","906","1771","0","51.16","44.04"
"10","007","00","020","2012","0000","1262","1002","260","89","1351","2540","0","53.19","39.45"
"10","007","00","020","2012","0942","290","236","54","22","312","731","0","42.68","32.28"
"10","007","00","020","2012","0943","541","437","104","46","587","1025","0","57.27","42.63"
"10","007","00","020","2012","0944","431","329","102","21","452","784","0","57.65","41.96"
"10","007","00","020","2013","0000","543","428","115","43","586","1360","0","43.09","31.47"
"10","007","00","020","2013","0963","543","428","115","43","586","1360","0","43.09","31.47"
"10","007","00","020","2014","0000","691","557","134","62","753","1613","0","46.68","34.53"
"10","007","00","020","2014","0964","691","557","134","62","753","1613","0","46.68","34.53"
"10","007","00","020","2015","0000","556","455","101","78","634","1228","0","51.63","37.05"
"10","007","00","020","2015","0965","556","455","101","78","634","1228","0","51.63","37.05"
"10","007","00","020","2016","0000","416","356","60","22","438","771","0","56.81","46.17"
"10","007","00","020","2016","0966","416","356","60","22","438","771","0","56.81","46.17"
"10","007","00","020","2017","0000","755","604","151","40","795","1519","0","52.34","39.76"
"10","007","00","020","2017","0967","459","359","100","39","498","858","0","58.04","41.84"
"10","007","00","020","2017","0968","296","245","51","1","297","661","0","44.93","37.07"
"10","007","00","020","2018","0000","555","451","104","67","622","1268","0","49.05","35.57"
"10","007","00","020","2018","0969","555","451","104","67","622","1268","0","49.05","35.57"
"10","007","00","020","2019","0000","478","390","88","28","506","1081","0","46.81","36.08"
"10","007","00","020","2019","0970","478","390","88","28","506","1081","0","46.81","36.08"
"10","007","00","020","2020","0000","1687","1374","313","172","1859","3659","0","50.81","37.55"
"10","007","00","020","2020","0971","550","453","97","33","583","1213","0","48.06","37.35"
"10","007","00","020","2020","0972","674","548","126","68","742","1328","0","55.87","41.27"
"10","007","00","020","2020","0973","463","373","90","71","534","1118","0","47.76","33.36"
"10","007","00","020","2021","0000","442","348","94","46","488","972","0","50.21","35.8"
"10","007","00","020","2021","0975","442","348","94","46","488","972","0","50.21","35.8"
"10","007","00","020","2022","0000","489","389","100","45","534","1157","0","46.15","33.62"
"10","007","00","020","2022","0974","489","389","100","45","534","1157","0","46.15","33.62"
"10","007","00","020","2023","0000","442","358","84","43","485","902","0","53.77","39.69"
"10","007","00","020","2023","0976","442","358","84","43","485","902","0","53.77","39.69"
"10","007","00","020","2024","0000","695","562","133","98","793","1273","0","62.29","44.15"
"10","007","00","020","2024","0977","695","562","133","98","793","1273","0","62.29","44.15"
"10","007","00","020","2025","0000","509","414","95","39","548","1087","0","50.41","38.09"
"10","007","00","020","2025","0978","509","414","95","39","548","1087","0","50.41","38.09"
"10","007","00","020","2026","0000","502","397","105","76","578","987","0","58.56","40.22"
"10","007","00","020","2026","0979","502","397","105","76","578","987","0","58.56","40.22"
"10","007","00","020","2027","0000","269","204","65","24","293","719","0","40.75","28.37"
"10","007","00","020","2027","0980","269","204","65","24","293","719","0","40.75","28.37"
"10","007","00","021","0000","0000","12613","10126","2487","1014","13627","23179","27346","58.79","43.69"
"10","007","00","021","2101","0000","619","474","145","39","658","1284","0","51.25","36.92"
"10","007","00","021","2101","0863","619","474","145","39","658","1284","0","51.25","36.92"
"10","007","00","021","2102","0000","561","467","94","44","605","874","0","69.22","53.43"
"10","007","00","021","2102","0873","561","467","94","44","605","874","0","69.22","53.43"
"10","007","00","021","2103","0000","1490","1244","246","85","1575","2562","0","61.48","48.56"
"10","007","00","021","2103","0871","791","658","133","47","838","1376","0","60.9","47.82"
"10","007","00","021","2103","0872","699","586","113","38","737","1186","0","62.14","49.41"
"10","007","00","021","2104","0000","608","499","109","73","681","1079","0","63.11","46.25"
"10","007","00","021","2104","0882","608","499","109","73","681","1079","0","63.11","46.25"
"10","007","00","021","2105","0000","383","305","78","26","409","760","0","53.82","40.13"
"10","007","00","021","2105","0886","383","305","78","26","409","760","0","53.82","40.13"
"10","007","00","021","2106","0000","634","498","136","67","701","1084","0","64.67","45.94"
"10","007","00","021","2106","0887","634","498","136","67","701","1084","0","64.67","45.94"
"10","007","00","021","2107","0000","604","492","112","47","651","1198","0","54.34","41.07"
"10","007","00","021","2107","0884","604","492","112","47","651","1198","0","54.34","41.07"
"10","007","00","021","2108","0000","319","248","71","35","354","621","0","57.0","39.94"
"10","007","00","021","2108","0885","319","248","71","35","354","621","0","57.0","39.94"
"10","007","00","021","2109","0000","736","588","148","44","780","1336","0","58.38","44.01"
"10","007","00","021","2109","0883","736","588","148","44","780","1336","0","58.38","44.01"
"10","007","00","021","2110","0000","615","476","139","87","702","1337","0","52.51","35.6"
"10","007","00","021","2110","0870","615","476","139","87","702","1337","0","52.51","35.6"
"10","007","00","021","2111","0000","850","681","169","66","916","1555","0","58.91","43.79"
"10","007","00","021","2111","0868","341","298","43","21","362","680","0","53.24","43.82"
"10","007","00","021","2111","0869","509","383","126","45","554","875","0","63.31","43.77"
"10","007","00","021","2112","0000","665","518","147","60","725","1187","0","61.08","43.64"
"10","007","00","021","2112","0864","665","518","147","60","725","1187","0","61.08","43.64"
"10","007","00","021","2113","0000","957","767","190","78","1035","1729","0","59.86","44.36"
"10","007","00","021","2113","0865","569","445","124","40","609","1033","0","58.95","43.08"
"10","007","00","021","2113","0866","388","322","66","38","426","696","0","61.21","46.26"
"10","007","00","021","2114","0000","548","428","120","32","580","938","0","61.83","45.63"
"10","007","00","021","2114","0878","548","428","120","32","580","938","0","61.83","45.63"
"10","007","00","021","2115","0000","524","449","75","39","563","880","0","63.98","51.02"
"10","007","00","021","2115","0879","524","449","75","39","563","880","0","63.98","51.02"
"10","007","00","021","2116","0000","701","550","151","55","756","1396","0","54.15","39.4"
"10","007","00","021","2116","0880","396","312","84","34","430","804","0","53.48","38.81"
"10","007","00","021","2116","0881","305","238","67","21","326","592","0","55.07","40.2"
"10","007","00","021","2117","0000","855","674","181","69","924","1606","0","57.53","41.97"
"10","007","00","021","2117","0874","329","255","74","27","356","647","0","55.02","39.41"
"10","007","00","021","2117","0875","526","419","107","42","568","959","0","59.23","43.69"
"10","007","00","021","2118","0000","132","101","31","10","142","263","0","53.99","38.4"
"10","007","00","021","2118","0876","132","101","31","10","142","263","0","53.99","38.4"
"10","007","00","021","2119","0000","308","245","63","26","334","618","0","54.05","39.64"
"10","007","00","021","2119","0877","308","245","63","26","334","618","0","54.05","39.64"
"10","007","00","021","2120","0000","504","422","82","32","536","872","0","61.47","48.39"
"10","007","00","021","2120","0867","504","422","82","32","536","872","0","61.47","48.39"
"10","007","00","022","0000","0000","12547","9819","2728","1343","13890","25677","30536","54.1","38.24"
"10","007","00","022","2201","0000","1149","642","507","101","1250","2468","0","50.65","26.01"
"10","007","00","022","2201","0888","524","417","107","58","582","1178","0","49.41","35.4"
"10","007","00","022","2201","0889","625","225","400","43","668","1290","0","51.78","17.44"
"10","007","00","022","2202","0000","851","674","177","90","941","1756","0","53.59","38.38"
"10","007","00","022","2202","0890","469","385","84","57","526","973","0","54.06","39.57"
"10","007","00","022","2202","0891","382","289","93","33","415","783","0","53.0","36.91"
"10","007","00","022","2203","0000","824","660","164","115","939","1632","0","57.54","40.44"
"10","007","00","022","2203","0892","366","295","71","48","414","733","0","56.48","40.25"
"10","007","00","022","2203","0893","458","365","93","67","525","899","0","58.4","40.6"
"10","007","00","022","2204","0000","1158","957","201","98","1256","2321","0","54.11","41.23"
"10","007","00","022","2204","0894","498","403","95","48","546","965","0","56.58","41.76"
"10","007","00","022","2204","0895","660","554","106","50","710","1356","0","52.36","40.86"
"10","007","00","022","2205","0000","622","514","108","65","687","1265","0","54.31","40.63"
"10","007","00","022","2205","0896","622","514","108","65","687","1265","0","54.31","40.63"
"10","007","00","022","2206","0000","811","664","147","108","919","1582","0","58.09","41.97"
"10","007","00","022","2206","0897","478","390","88","59","537","877","0","61.23","44.47"
"10","007","00","022","2206","0898","333","274","59","49","382","705","0","54.18","38.87"
"10","007","00","022","2207","0000","1755","1439","316","157","1912","3285","0","58.2","43.81"
"10","007","00","022","2207","0899","597","489","108","40","637","1062","0","59.98","46.05"
"10","007","00","022","2207","0900","684","554","130","56","740","1300","0","56.92","42.62"
"10","007","00","022","2207","0901","474","396","78","61","535","923","0","57.96","42.9"
"10","007","00","022","2208","0000","1107","906","201","86","1193","2188","0","54.52","41.41"
"10","007","00","022","2208","0902","507","408","99","33","540","1085","0","49.77","37.6"
"10","007","00","022","2208","0903","600","498","102","53","653","1103","0","59.2","45.15"
"10","007","00","022","2209","0000","342","272","70","33","375","735","0","51.02","37.01"
"10","007","00","022","2209","0904","342","272","70","33","375","735","0","51.02","37.01"
"10","007","00","022","2210","0000","278","220","58","38","316","574","0","55.05","38.33"
"10","007","00","022","2210","0905","278","220","58","38","316","574","0","55.05","38.33"
"10","007","00","022","2211","0000","689","559","130","101","790","1504","0","52.53","37.17"
"10","007","00","022","2211","0906","340","288","52","43","383","767","0","49.93","37.55"
"10","007","00","022","2211","0907","349","271","78","58","407","737","0","55.22","36.77"
"10","007","00","022","2212","0000","436","318","118","54","490","1058","0","46.31","30.06"
"10","007","00","022","2212","0908","436","318","118","54","490","1058","0","46.31","30.06"
"10","007","00","022","2213","0000","360","279","81","66","426","826","0","51.57","33.78"
"10","007","00","022","2213","0909","360","279","81","66","426","826","0","51.57","33.78"
"10","007","00","022","2214","0000","475","381","94","72","547","1082","0","50.55","35.21"
"10","007","00","022","2214","0910","475","381","94","72","547","1082","0","50.55","35.21"
"10","007","00","022","2215","0000","749","610","139","70","819","1448","0","56.56","42.13"
"10","007","00","022","2215","0911","398","326","72","48","446","737","0","60.52","44.23"
"10","007","00","022","2215","0912","351","284","67","22","373","711","0","52.46","39.94"
"10","007","00","022","2216","0000","528","392","136","65","593","1043","0","56.86","37.58"
"10","007","00","022","2216","0913","528","392","136","65","593","1043","0","56.86","37.58"
"10","007","00","022","2217","0000","413","332","81","24","437","910","0","48.02","36.48"
"10","007","00","022","2217","0914","413","332","81","24","437","910","0","48.02","36.48"
"10","007","00","023","0000","0000","12549","10149","2400","1685","14234","29291","33549","48.6","34.65"
"10","007","00","023","2301","0000","279","225","54","51","330","940","0","35.11","23.94"
"10","007","00","023","2301","0998","279","225","54","51","330","940","0","35.11","23.94"
"10","007","00","023","2302","0000","129","104","25","23","152","403","0","37.72","25.81"
"10","007","00","023","2302","0999","129","104","25","23","152","403","0","37.72","25.81"
"10","007","00","023","2303","0000","337","276","61","36","373","756","0","49.34","36.51"
"10","007","00","023","2303","1000","337","276","61","36","373","756","0","49.34","36.51"
"10","007","00","023","2304","0000","152","118","34","26","178","548","0","32.48","21.53"
"10","007","00","023","2304","1001","152","118","34","26","178","548","0","32.48","21.53"
"10","007","00","023","2305","0000","461","380","81","58","519","997","0","52.06","38.11"
"10","007","00","023","2305","1002","461","380","81","58","519","997","0","52.06","38.11"
"10","007","00","023","2306","0000","905","731","174","123","1028","2159","0","47.61","33.86"
"10","007","00","023","2306","1003","516","408","108","70","586","1300","0","45.08","31.38"
"10","007","00","023","2306","1004","389","323","66","53","442","859","0","51.46","37.6"
"10","007","00","023","2307","0000","610","513","97","41","651","1370","0","47.52","37.45"
"10","007","00","023","2307","1005","331","268","63","16","347","734","0","47.28","36.51"
"10","007","00","023","2307","1006","279","245","34","25","304","636","0","47.8","38.52"
"10","007","00","023","2308","0000","158","124","34","8","166","470","0","35.32","26.38"
"10","007","00","023","2308","1022","158","124","34","8","166","470","0","35.32","26.38"
"10","007","00","023","2309","0000","253","216","37","42","295","668","0","44.16","32.34"
"10","007","00","023","2309","1008","253","216","37","42","295","668","0","44.16","32.34"
"10","007","00","023","2310","0000","348","275","73","29","377","744","0","50.67","36.96"
"10","007","00","023","2310","1009","348","275","73","29","377","744","0","50.67","36.96"
"10","007","00","023","2311","0000","399","323","76","86","485","1026","0","47.27","31.48"
"10","007","00","023","2311","1010","399","323","76","86","485","1026","0","47.27","31.48"
"10","007","00","023","2312","0000","205","168","37","9","214","586","0","36.52","28.67"
"10","007","00","023","2312","1011","205","168","37","9","214","586","0","36.52","28.67"
"10","007","00","023","2313","0000","273","222","51","40","313","593","0","52.78","37.44"
"10","007","00","023","2313","1012","273","222","51","40","313","593","0","52.78","37.44"
"10","007","00","023","2314","0000","314","251","63","65","379","808","0","46.91","31.06"
"10","007","00","023","2314","1007","314","251","63","65","379","808","0","46.91","31.06"
"10","007","00","023","2315","0000","912","719","193","227","1139","2131","0","53.45","33.74"
"10","007","00","023","2315","1013","465","356","109","113","578","1071","0","53.97","33.24"
"10","007","00","023","2315","1014","447","363","84","114","561","1060","0","52.92","34.25"
"10","007","00","023","2316","0000","291","241","50","24","315","708","0","44.49","34.04"
"10","007","00","023","2316","1015","291","241","50","24","315","708","0","44.49","34.04"
"10","007","00","023","2317","0000","293","226","67","61","354","735","0","48.16","30.75"
"10","007","00","023","2317","1016","293","226","67","61","354","735","0","48.16","30.75"
"10","007","00","023","2318","0000","284","224","60","64","348","674","0","51.63","33.23"
"10","007","00","023","2318","1019","284","224","60","64","348","674","0","51.63","33.23"
"10","007","00","023","2319","0000","549","459","90","90","639","1300","0","49.15","35.31"
"10","007","00","023","2319","1017","273","220","53","58","331","571","0","57.97","38.53"
"10","007","00","023","2319","1018","276","239","37","32","308","729","0","42.25","32.78"
"10","007","00","023","2320","0000","800","639","161","91","891","1652","0","53.93","38.68"
"10","007","00","023","2320","1020","398","313","85","40","438","846","0","51.77","37.0"
"10","007","00","023","2320","1021","402","326","76","51","453","806","0","56.2","40.45"
"10","007","00","023","2321","0000","667","576","91","99","766","1441","0","53.16","39.97"
"10","007","00","023","2321","1023","540","466","74","74","614","1124","0","54.63","41.46"
"10","007","00","023","2321","1024","127","110","17","25","152","317","0","47.95","34.7"
"10","007","00","023","2322","0000","423","341","82","54","477","1086","0","43.92","31.4"
"10","007","00","023","2322","1028","423","341","82","54","477","1086","0","43.92","31.4"
"10","007","00","023","2323","0000","847","685","162","74","921","2125","0","43.34","32.24"
"10","007","00","023","2323","1025","438","351","87","55","493","1158","0","42.57","30.31"
"10","007","00","023","2323","1026","409","334","75","19","428","967","0","44.26","34.54"
"10","007","00","023","2324","0000","353","293","60","41","394","762","0","51.71","38.45"
"10","007","00","023","2324","1027","353","293","60","41","394","762","0","51.71","38.45"
"10","007","00","023","2325","0000","583","483","100","49","632","1400","0","45.14","34.5"
"10","007","00","023","2325","1029","346","286","60","21","367","747","0","49.13","38.29"
"10","007","00","023","2325","1030","237","197","40","28","265","653","0","40.58","30.17"
"10","007","00","023","2326","0000","1724","1337","387","174","1898","3209","0","59.15","41.66"
"10","007","00","023","2326","1031","451","362","89","61","512","872","0","58.72","41.51"
"10","007","00","023","2326","1032","694","567","127","49","743","1235","0","60.16","45.91"
"10","007","00","023","2326","1033","579","408","171","64","643","1102","0","58.35","37.02"
"10","007","00","024","0000","0000","5006","4053","953","598","5604","14713","16781","38.09","27.55"
"10","007","00","024","2401","0000","351","277","74","74","425","1104","0","38.5","25.09"
"10","007","00","024","2401","0982","351","277","74","74","425","1104","0","38.5","25.09"
"10","007","00","024","2402","0000","384","314","70","46","430","1092","0","39.38","28.75"
"10","007","00","024","2402","0986","160","132","28","21","181","518","0","34.94","25.48"
"10","007","00","024","2402","0987","224","182","42","25","249","574","0","43.38","31.71"
"10","007","00","024","2403","0000","548","438","110","59","607","1312","0","46.27","33.38"
"10","007","00","024","2403","0984","548","438","110","59","607","1312","0","46.27","33.38"
"10","007","00","024","2404","0000","304","243","61","62","366","853","0","42.91","28.49"
"10","007","00","024","2404","0985","304","243","61","62","366","853","0","42.91","28.49"
"10","007","00","024","2405","0000","475","380","95","62","537","964","0","55.71","39.42"
"10","007","00","024","2405","0983","475","380","95","62","537","964","0","55.71","39.42"
"10","007","00","024","2406","0000","375","327","48","30","405","1103","0","36.72","29.65"
"10","007","00","024","2406","0993","375","327","48","30","405","1103","0","36.72","29.65"
"10","007","00","024","2407","0000","370","301","69","29","399","1288","0","30.98","23.37"
"10","007","00","024","2407","0981","370","301","69","29","399","1288","0","30.98","23.37"
"10","007","00","024","2408","0000","237","181","56","31","268","702","0","38.18","25.78"
"10","007","00","024","2408","0988","237","181","56","31","268","702","0","38.18","25.78"
"10","007","00","024","2409","0000","198","168","30","27","225","686","0","32.8","24.49"
"10","007","00","024","2409","0996","198","168","30","27","225","686","0","32.8","24.49"
"10","007","00","024","2410","0000","296","241","55","34","330","1069","0","30.87","22.54"
"10","007","00","024","2410","0989","101","78","23","15","116","376","0","30.85","20.74"
"10","007","00","024","2410","0990","195","163","32","19","214","693","0","30.88","23.52"
"10","007","00","024","2411","0000","254","209","45","20","274","899","0","30.48","23.25"
"10","007","00","024","2411","0997","254","209","45","20","274","899","0","30.48","23.25"
"10","007","00","024","2412","0000","379","305","74","30","409","1192","0","34.31","25.59"
"10","007","00","024","2412","0994","379","305","74","30","409","1192","0","34.31","25.59"
"10","007","00","024","2413","0000","333","273","60","28","361","917","0","39.37","29.77"
"10","007","00","024","2413","0995","333","273","60","28","361","917","0","39.37","29.77"
"10","007","00","024","2414","0000","336","270","66","48","384","877","0","43.79","30.79"
"10","007","00","024","2414","0991","336","270","66","48","384","877","0","43.79","30.79"
"10","007","00","024","2415","0000","166","126","40","18","184","655","0","28.09","19.24"
"10","007","00","024","2415","0992","166","126","40","18","184","655","0","28.09","19.24"
"10","007","00","025","0000","0000","6101","4837","1264","710","6811","12821","15117","53.12","37.73"
"10","007","00","025","2501","0000","596","482","114","72","668","1168","0","57.19","41.27"
"10","007","00","025","2501","1034","596","482","114","72","668","1168","0","57.19","41.27"
"10","007","00","025","2502","0000","1039","798","241","96","1135","1925","0","58.96","41.45"
"10","007","00","025","2502","1035","498","382","116","40","538","965","0","55.75","39.59"
"10","007","00","025","2502","1036","541","416","125","56","597","960","0","62.19","43.33"
"10","007","00","025","2503","0000","428","338","90","55","483","743","0","65.01","45.49"
"10","007","00","025","2503","1037","428","338","90","55","483","743","0","65.01","45.49"
"10","007","00","025","2504","0000","299","243","56","38","337","751","0","44.87","32.36"
"10","007","00","025","2504","1038","299","243","56","38","337","751","0","44.87","32.36"
"10","007","00","025","2505","0000","633","505","128","56","689","1525","0","45.18","33.11"
"10","007","00","025","2505","1039","337","271","66","43","380","792","0","47.98","34.22"
"10","007","00","025","2505","1040","296","234","62","13","309","733","0","42.16","31.92"
"10","007","00","025","2506","0000","297","242","55","50","347","657","0","52.82","36.83"
"10","007","00","025","2506","1041","297","242","55","50","347","657","0","52.82","36.83"
"10","007","00","025","2507","0000","497","416","81","31","528","1063","0","49.67","39.13"
"10","007","00","025","2507","1042","497","416","81","31","528","1063","0","49.67","39.13"
"10","007","00","025","2508","0000","558","454","104","76","634","1114","0","56.91","40.75"
"10","007","00","025","2508","1043","558","454","104","76","634","1114","0","56.91","40.75"
"10","007","00","025","2509","0000","296","218","78","46","342","506","0","67.59","43.08"
"10","007","00","025","2509","1044","296","218","78","46","342","506","0","67.59","43.08"
"10","007","00","025","2510","0000","374","294","80","45","419","823","0","50.91","35.72"
"10","007","00","025","2510","1045","374","294","80","45","419","823","0","50.91","35.72"
"10","007","00","025","2511","0000","298","225","73","31","329","654","0","50.31","34.4"
"10","007","00","025","2511","1046","298","225","73","31","329","654","0","50.31","34.4"
"10","007","00","025","2512","0000","218","178","40","26","244","577","0","42.29","30.85"
"10","007","00","025","2512","1047","218","178","40","26","244","577","0","42.29","30.85"
"10","007","00","025","2513","0000","356","278","78","51","407","772","0","52.72","36.01"
"10","007","00","025","2513","1048","356","278","78","51","407","772","0","52.72","36.01"
"10","007","00","025","2514","0000","212","166","46","37","249","543","0","45.86","30.57"
"10","007","00","025","2514","1049","212","166","46","37","249","543","0","45.86","30.57"
"10","007","00","026","0000","0000","11698","9269","2429","1177","12875","25405","29797","50.68","36.48"
"10","007","00","026","2601","0000","868","691","177","59","927","1839","0","50.41","37.57"
"10","007","00","026","2601","0915","395","327","68","36","431","778","0","55.4","42.03"
"10","007","00","026","2601","0916","473","364","109","23","496","1061","0","46.75","34.31"
"10","007","00","026","2602","0000","576","462","114","65","641","1409","0","45.49","32.79"
"10","007","00","026","2602","0925","576","462","114","65","641","1409","0","45.49","32.79"
"10","007","00","026","2603","0000","471","376","95","56","527","1157","0","45.55","32.5"
"10","007","00","026","2603","0930","471","376","95","56","527","1157","0","45.55","32.5"
"10","007","00","026","2604","0000","755","598","157","79","834","1490","0","55.97","40.13"
"10","007","00","026","2604","0941","755","598","157","79","834","1490","0","55.97","40.13"
"10","007","00","026","2605","0000","291","225","66","33","324","701","0","46.22","32.1"
"10","007","00","026","2605","0917","291","225","66","33","324","701","0","46.22","32.1"
"10","007","00","026","2606","0000","693","526","167","72","765","1506","0","50.8","34.93"
"10","007","00","026","2606","0926","357","277","80","22","379","792","0","47.85","34.97"
"10","007","00","026","2606","0927","336","249","87","50","386","714","0","54.06","34.87"
"10","007","00","026","2607","0000","373","298","75","63","436","843","0","51.72","35.35"
"10","007","00","026","2607","0936","373","298","75","63","436","843","0","51.72","35.35"
"10","007","00","026","2608","0000","477","376","101","53","530","879","0","60.3","42.78"
"10","007","00","026","2608","0918","477","376","101","53","530","879","0","60.3","42.78"
"10","007","00","026","2609","0000","863","665","198","98","961","2071","0","46.4","32.11"
"10","007","00","026","2609","0928","482","375","107","55","537","1109","0","48.42","33.81"
"10","007","00","026","2609","0929","381","290","91","43","424","962","0","44.07","30.15"
"10","007","00","026","2610","0000","233","186","47","11","244","711","0","34.32","26.16"
"10","007","00","026","2610","0937","233","186","47","11","244","711","0","34.32","26.16"
"10","007","00","026","2611","0000","844","674","170","76","920","1532","0","60.05","43.99"
"10","007","00","026","2611","0919","390","303","87","41","431","654","0","65.9","46.33"
"10","007","00","026","2611","0920","454","371","83","35","489","878","0","55.69","42.26"
"10","007","00","026","2612","0000","886","708","178","81","967","1839","0","52.58","38.5"
"10","007","00","026","2612","0931","448","368","80","42","490","952","0","51.47","38.66"
"10","007","00","026","2612","0932","438","340","98","39","477","887","0","53.78","38.33"
"10","007","00","026","2613","0000","402","313","89","65","467","851","0","54.88","36.78"
"10","007","00","026","2613","0938","402","313","89","65","467","851","0","54.88","36.78"
"10","007","00","026","2614","0000","974","782","192","75","1049","1813","0","57.86","43.13"
"10","007","00","026","2614","0921","537","423","114","43","580","942","0","61.57","44.9"
"10","007","00","026","2614","0922","437","359","78","32","469","871","0","53.85","41.22"
"10","007","00","026","2615","0000","750","597","153","111","861","1876","0","45.9","31.82"
"10","007","00","026","2615","0933","337","270","67","43","380","866","0","43.88","31.18"
"10","007","00","026","2615","0934","413","327","86","68","481","1010","0","47.62","32.38"
"10","007","00","026","2616","0000","523","420","103","50","573","1247","0","45.95","33.68"
"10","007","00","026","2616","0940","523","420","103","50","573","1247","0","45.95","33.68"
"10","007","00","026","2617","0000","946","768","178","75","1021","1905","0","53.6","40.31"
"10","007","00","026","2617","0923","493","396","97","25","518","1047","0","49.47","37.82"
"10","007","00","026","2617","0924","453","372","81","50","503","858","0","58.62","43.36"
"10","007","00","026","2618","0000","396","303","93","26","422","853","0","49.47","35.52"
"10","007","00","026","2618","0935","396","303","93","26","422","853","0","49.47","35.52"
"10","007","00","026","2619","0000","377","301","76","29","406","883","0","45.98","34.09"
"10","007","00","026","2619","0939","377","301","76","29","406","883","0","45.98","34.09"
"10","008","00","000","0000","0000","228803","187162","41641","15881","244684","427089","497876","57.29","43.82"
"10","008","00","001","0000","0000","48341","39753","8588","2677","51018","84328","99538","60.5","47.14"
"10","008","00","001","0101","0000","524","425","99","24","548","927","0","59.12","45.85"
"10","008","00","001","0101","0001","524","425","99","24","548","927","0","59.12","45.85"
"10","008","00","001","0102","0000","879","717","162","52","931","1440","0","64.65","49.79"
"10","008","00","001","0102","0002","427","340","87","27","454","667","0","68.07","50.97"
"10","008","00","001","0102","0003","452","377","75","25","477","773","0","61.71","48.77"
"10","008","00","001","0103","0000","478","383","95","35","513","818","0","62.71","46.82"
"10","008","00","001","0103","0004","478","383","95","35","513","818","0","62.71","46.82"
"10","008","00","001","0104","0000","335","272","63","21","356","525","0","67.81","51.81"
"10","008","00","001","0104","0005","335","272","63","21","356","525","0","67.81","51.81"
"10","008","00","001","0105","0000","352","275","77","29","381","575","0","66.26","47.83"
"10","008","00","001","0105","0006","352","275","77","29","381","575","0","66.26","47.83"
"10","008","00","001","0106","0000","243","191","52","10","253","368","0","68.75","51.9"
"10","008","00","001","0106","0007","243","191","52","10","253","368","0","68.75","51.9"
"10","008","00","001","0107","0000","578","466","112","54","632","956","0","66.11","48.74"
"10","008","00","001","0107","0008","578","466","112","54","632","956","0","66.11","48.74"
"10","008","00","001","0108","0000","1591","1307","284","99","1690","2632","0","64.21","49.66"
"10","008","00","001","0108","0058","822","675","147","65","887","1387","0","63.95","48.67"
"10","008","00","001","0108","0059","769","632","137","34","803","1245","0","64.5","50.76"
"10","008","00","001","0109","0000","4079","3388","691","217","4296","7018","0","61.21","48.28"
"10","008","00","001","0109","0060","663","556","107","27","690","1199","0","57.55","46.37"
"10","008","00","001","0109","0061","737","598","139","40","777","1288","0","60.33","46.43"
"10","008","00","001","0109","0062","584","480","104","40","624","1040","0","60.0","46.15"
"10","008","00","001","0109","0063","617","510","107","47","664","1070","0","62.06","47.66"
"10","008","00","001","0109","0064","789","673","116","33","822","1299","0","63.28","51.81"
"10","008","00","001","0109","0065","689","571","118","30","719","1122","0","64.08","50.89"
"10","008","00","001","0110","0000","2416","1997","419","125","2541","4543","0","55.93","43.96"
"10","008","00","001","0110","0032","749","626","123","42","791","1356","0","58.33","46.17"
"10","008","00","001","0110","0033","707","588","119","40","747","1373","0","54.41","42.83"
"10","008","00","001","0110","0034","772","621","151","34","806","1452","0","55.51","42.77"
"10","008","00","001","0110","0035","188","162","26","9","197","362","0","54.42","44.75"
"10","008","00","001","0111","0000","210","170","40","24","234","389","0","60.15","43.7"
"10","008","00","001","0111","0036","210","170","40","24","234","389","0","60.15","43.7"
"10","008","00","001","0112","0000","3433","2796","637","228","3661","5992","0","61.1","46.66"
"10","008","00","001","0112","0022","511","419","92","36","547","960","0","56.98","43.65"
"10","008","00","001","0112","0023","517","435","82","41","558","906","0","61.59","48.01"
"10","008","00","001","0112","0024","549","445","104","42","591","957","0","61.76","46.5"
"10","008","00","001","0112","0025","612","480","132","40","652","997","0","65.4","48.14"
"10","008","00","001","0112","0026","591","483","108","36","627","1008","0","62.2","47.92"
"10","008","00","001","0112","0027","653","534","119","33","686","1164","0","58.93","45.88"
"10","008","00","001","0113","0000","1098","896","202","80","1178","2045","0","57.6","43.81"
"10","008","00","001","0113","0028","336","293","43","18","354","587","0","60.31","49.91"
"10","008","00","001","0113","0029","373","284","89","29","402","734","0","54.77","38.69"
"10","008","00","001","0113","0030","389","319","70","33","422","724","0","58.29","44.06"
"10","008","00","001","0114","0000","567","482","85","29","596","1003","0","59.42","48.06"
"10","008","00","001","0114","0031","567","482","85","29","596","1003","0","59.42","48.06"
"10","008","00","001","0115","0000","3360","2855","505","131","3491","5426","0","64.34","52.62"
"10","008","00","001","0115","0009","634","522","112","22","656","1245","0","52.69","41.93"
"10","008","00","001","0115","0010","1118","996","122","22","1140","1484","0","76.82","67.12"
"10","008","00","001","0115","0011","743","622","121","36","779","1191","0","65.41","52.23"
"10","008","00","001","0115","0012","865","715","150","51","916","1506","0","60.82","47.48"
"10","008","00","001","0116","0000","1689","1363","326","97","1786","2790","0","64.01","48.85"
"10","008","00","001","0116","0013","642","502","140","33","675","1070","0","63.08","46.92"
"10","008","00","001","0116","0014","392","327","65","26","418","670","0","62.39","48.81"
"10","008","00","001","0116","0015","655","534","121","38","693","1050","0","66.0","50.86"
"10","008","00","001","0117","0000","1094","887","207","78","1172","2106","0","55.65","42.12"
"10","008","00","001","0117","0016","567","468","99","47","614","1122","0","54.72","41.71"
"10","008","00","001","0117","0017","527","419","108","31","558","984","0","56.71","42.58"
"10","008","00","001","0118","0000","2573","1905","668","134","2707","4411","0","61.37","43.19"
"10","008","00","001","0118","0018","654","552","102","22","676","1062","0","63.65","51.98"
"10","008","00","001","0118","0019","593","486","107","45","638","1053","0","60.59","46.15"
"10","008","00","001","0118","0020","672","325","347","30","702","1104","0","63.59","29.44"
"10","008","00","001","0118","0021","654","542","112","37","691","1192","0","57.97","45.47"
"10","008","00","001","0119","0000","974","818","156","63","1037","1930","0","53.73","42.38"
"10","008","00","001","0119","0083","489","408","81","41","530","950","0","55.79","42.95"
"10","008","00","001","0119","0084","485","410","75","22","507","980","0","51.73","41.84"
"10","008","00","001","0120","0000","365","280","85","32","397","790","0","50.25","35.44"
"10","008","00","001","0120","0081","365","280","85","32","397","790","0","50.25","35.44"
"10","008","00","001","0121","0000","250","210","40","24","274","647","0","42.35","32.46"
"10","008","00","001","0121","0082","250","210","40","24","274","647","0","42.35","32.46"
"10","008","00","001","0122","0000","506","398","108","88","594","1122","0","52.94","35.47"
"10","008","00","001","0122","0080","506","398","108","88","594","1122","0","52.94","35.47"
"10","008","00","001","0123","0000","2961","2451","510","132","3093","5362","0","57.68","45.71"
"10","008","00","001","0123","0066","802","664","138","40","842","1414","0","59.55","46.96"
"10","008","00","001","0123","0067","625","528","97","36","661","1121","0","58.97","47.1"
"10","008","00","001","0123","0068","793","648","145","24","817","1434","0","56.97","45.19"
"10","008","00","001","0123","0069","741","611","130","32","773","1393","0","55.49","43.86"
"10","008","00","001","0124","0000","2550","2093","457","101","2651","4907","0","54.02","42.65"
"10","008","00","001","0124","0070","577","462","115","14","591","1059","0","55.81","43.63"
"10","008","00","001","0124","0071","672","553","119","33","705","1218","0","57.88","45.4"
"10","008","00","001","0124","0072","651","543","108","17","668","1293","0","51.66","42.0"
"10","008","00","001","0124","0073","650","535","115","37","687","1337","0","51.38","40.01"
"10","008","00","001","0125","0000","1619","1279","340","83","1702","2859","0","59.53","44.74"
"10","008","00","001","0125","0074","519","412","107","27","546","876","0","62.33","47.03"
"10","008","00","001","0125","0075","537","438","99","26","563","971","0","57.98","45.11"
"10","008","00","001","0125","0076","563","429","134","30","593","1012","0","58.6","42.39"
"10","008","00","001","0126","0000","1665","1351","314","108","1773","2999","0","59.12","45.05"
"10","008","00","001","0126","0077","498","421","77","38","536","973","0","55.09","43.27"
"10","008","00","001","0126","0078","597","475","122","32","629","1002","0","62.77","47.41"
"10","008","00","001","0126","0079","570","455","115","38","608","1024","0","59.38","44.43"
"10","008","00","001","0127","0000","3708","3155","553","178","3886","5880","0","66.09","53.66"
"10","008","00","001","0127","0039","553","458","95","40","593","921","0","64.39","49.73"
"10","008","00","001","0127","0040","609","514","95","25","634","892","0","71.08","57.62"
"10","008","00","001","0127","0041","651","567","84","36","687","1050","0","65.43","54.0"
"10","008","00","001","0127","0042","664","573","91","19","683","1078","0","63.36","53.15"
"10","008","00","001","0127","0043","632","543","89","35","667","1078","0","61.87","50.37"
"10","008","00","001","0127","0044","599","500","99","23","622","861","0","72.24","58.07"
"10","008","00","001","0128","0000","1457","1186","271","79","1536","2365","0","64.95","50.15"
"10","008","00","001","0128","0037","789","643","146","42","831","1276","0","65.13","50.39"
"10","008","00","001","0128","0038","668","543","125","37","705","1089","0","64.74","49.86"
"10","008","00","001","0129","0000","3885","3275","610","187","4072","6589","0","61.8","49.7"
"10","008","00","001","0129","0045","672","565","107","55","727","1221","0","59.54","46.27"
"10","008","00","001","0129","0046","622","515","107","24","646","1105","0","58.46","46.61"
"10","008","00","001","0129","0047","724","587","137","29","753","1230","0","61.22","47.72"
"10","008","00","001","0129","0048","650","564","86","25","675","1092","0","61.81","51.65"
"10","008","00","001","0129","0049","796","686","110","25","821","1286","0","63.84","53.34"
"10","008","00","001","0129","0050","421","358","63","29","450","655","0","68.7","54.66"
"10","008","00","001","0130","0000","847","706","141","45","892","1439","0","61.99","49.06"
"10","008","00","001","0130","0051","451","366","85","24","475","719","0","66.06","50.9"
"10","008","00","001","0130","0052","396","340","56","21","417","720","0","57.92","47.22"
"10","008","00","001","0131","0000","494","439","55","17","511","848","0","60.26","51.77"
"10","008","00","001","0131","0057","494","439","55","17","511","848","0","60.26","51.77"
"10","008","00","001","0132","0000","629","546","83","27","656","1108","0","59.21","49.28"
"10","008","00","001","0132","0054","269","231","38","10","279","492","0","56.71","46.95"
"10","008","00","001","0132","0055","360","315","45","17","377","616","0","61.2","51.14"
"10","008","00","001","0133","0000","606","519","87","30","636","1010","0","62.97","51.39"
"10","008","00","001","0133","0056","606","519","87","30","636","1010","0","62.97","51.39"
"10","008","00","001","0134","0000","326","272","54","16","342","509","0","67.19","53.44"
"10","008","00","001","0134","0053","326","272","54","16","342","509","0","67.19","53.44"
"10","008","00","002","0000","0000","36804","30711","6093","2423","39227","68763","80408","57.05","44.66"
"10","008","00","002","0201","0000","1484","1229","255","111","1595","2676","0","59.6","45.93"
"10","008","00","002","0201","0085","466","393","73","35","501","828","0","60.51","47.46"
"10","008","00","002","0201","0086","446","366","80","39","485","786","0","61.7","46.56"
"10","008","00","002","0201","0087","572","470","102","37","609","1062","0","57.34","44.26"
"10","008","00","002","0202","0000","516","429","87","30","546","838","0","65.16","51.19"
"10","008","00","002","0202","0105","516","429","87","30","546","838","0","65.16","51.19"
"10","008","00","002","0203","0000","1619","1352","267","97","1716","3107","0","55.23","43.51"
"10","008","00","002","0203","0102","471","393","78","14","485","901","0","53.83","43.62"
"10","008","00","002","0203","0103","504","427","77","43","547","997","0","54.86","42.83"
"10","008","00","002","0203","0104","644","532","112","40","684","1209","0","56.58","44.0"
"10","008","00","002","0204","0000","1314","1094","220","84","1398","2489","0","56.17","43.95"
"10","008","00","002","0204","0106","571","481","90","42","613","1226","0","50.0","39.23"
"10","008","00","002","0204","0107","743","613","130","42","785","1263","0","62.15","48.54"
"10","008","00","002","0205","0000","1137","956","181","80","1217","2233","0","54.5","42.81"
"10","008","00","002","0205","0121","597","500","97","42","639","1133","0","56.4","44.13"
"10","008","00","002","0205","0122","540","456","84","38","578","1100","0","52.55","41.45"
"10","008","00","002","0206","0000","625","489","136","37","662","1023","0","64.71","47.8"
"10","008","00","002","0206","0126","625","489","136","37","662","1023","0","64.71","47.8"
"10","008","00","002","0207","0000","1903","1570","333","142","2045","3705","0","55.2","42.38"
"10","008","00","002","0207","0123","628","516","112","49","677","1155","0","58.61","44.68"
"10","008","00","002","0207","0124","631","513","118","39","670","1254","0","53.43","40.91"
"10","008","00","002","0207","0125","644","541","103","54","698","1296","0","53.86","41.74"
"10","008","00","002","0208","0000","3072","2539","533","168","3240","5777","0","56.08","43.95"
"10","008","00","002","0208","0127","446","395","51","18","464","964","0","48.13","40.98"
"10","008","00","002","0208","0128","541","457","84","28","569","986","0","57.71","46.35"
"10","008","00","002","0208","0129","594","491","103","22","616","1016","0","60.63","48.33"
"10","008","00","002","0208","0130","490","388","102","42","532","898","0","59.24","43.21"
"10","008","00","002","0208","0131","558","464","94","36","594","980","0","60.61","47.35"
"10","008","00","002","0208","0132","443","344","99","22","465","933","0","49.84","36.87"
"10","008","00","002","0209","0000","616","490","126","34","650","929","0","69.97","52.74"
"10","008","00","002","0209","0133","616","490","126","34","650","929","0","69.97","52.74"
"10","008","00","002","0210","0000","3886","3262","624","237","4123","7458","0","55.28","43.74"
"10","008","00","002","0210","0090","686","580","106","26","712","1282","0","55.54","45.24"
"10","008","00","002","0210","0091","460","394","66","38","498","859","0","57.97","45.87"
"10","008","00","002","0210","0092","687","563","124","62","749","1288","0","58.15","43.71"
"10","008","00","002","0210","0093","738","625","113","27","765","1330","0","57.52","46.99"
"10","008","00","002","0210","0094","721","609","112","45","766","1416","0","54.1","43.01"
"10","008","00","002","0210","0095","594","491","103","39","633","1283","0","49.34","38.27"
"10","008","00","002","0211","0000","2024","1763","261","158","2182","3815","0","57.2","46.21"
"10","008","00","002","0211","0096","627","600","27","71","698","1151","0","60.64","52.13"
"10","008","00","002","0211","0097","603","498","105","31","634","1193","0","53.14","41.74"
"10","008","00","002","0211","0098","794","665","129","56","850","1471","0","57.78","45.21"
"10","008","00","002","0212","0000","481","413","68","52","533","1044","0","51.05","39.56"
"10","008","00","002","0212","0099","481","413","68","52","533","1044","0","51.05","39.56"
"10","008","00","002","0213","0000","620","521","99","49","669","1122","0","59.63","46.43"
"10","008","00","002","0213","0100","620","521","99","49","669","1122","0","59.63","46.43"
"10","008","00","002","0214","0000","678","569","109","47","725","1129","0","64.22","50.4"
"10","008","00","002","0214","0101","678","569","109","47","725","1129","0","64.22","50.4"
"10","008","00","002","0215","0000","552","454","98","38","590","1032","0","57.17","43.99"
"10","008","00","002","0215","0134","552","454","98","38","590","1032","0","57.17","43.99"
"10","008","00","002","0216","0000","136","118","18","12","148","315","0","46.98","37.46"
"10","008","00","002","0216","0135","136","118","18","12","148","315","0","46.98","37.46"
"10","008","00","002","0217","0000","672","552","120","44","716","1363","0","52.53","40.5"
"10","008","00","002","0217","0136","672","552","120","44","716","1363","0","52.53","40.5"
"10","008","00","002","0218","0000","816","663","153","50","866","1430","0","60.56","46.36"
"10","008","00","002","0218","0137","409","350","59","29","438","725","0","60.41","48.28"
"10","008","00","002","0218","0138","407","313","94","21","428","705","0","60.71","44.4"
"10","008","00","002","0219","0000","963","817","146","60","1023","1683","0","60.78","48.54"
"10","008","00","002","0219","0139","460","390","70","29","489","751","0","65.11","51.93"
"10","008","00","002","0219","0140","503","427","76","31","534","932","0","57.3","45.82"
"10","008","00","002","0220","0000","635","503","132","44","679","1332","0","50.98","37.76"
"10","008","00","002","0220","0141","537","435","102","31","568","956","0","59.41","45.5"
"10","008","00","002","0220","0142","98","68","30","13","111","376","0","29.52","18.09"
"10","008","00","002","0221","0000","369","298","71","38","407","682","0","59.68","43.7"
"10","008","00","002","0221","0143","369","298","71","38","407","682","0","59.68","43.7"
"10","008","00","002","0222","0000","595","558","37","53","648","990","0","65.45","56.36"
"10","008","00","002","0222","0144","595","558","37","53","648","990","0","65.45","56.36"
"10","008","00","002","0223","0000","597","511","86","55","652","1170","0","55.73","43.68"
"10","008","00","002","0223","0147","597","511","86","55","652","1170","0","55.73","43.68"
"10","008","00","002","0224","0000","331","270","61","22","353","604","0","58.44","44.7"
"10","008","00","002","0224","0148","331","270","61","22","353","604","0","58.44","44.7"
"10","008","00","002","0225","0000","526","420","106","30","556","999","0","55.66","42.04"
"10","008","00","002","0225","0149","526","420","106","30","556","999","0","55.66","42.04"
"10","008","00","002","0226","0000","1429","1189","240","76","1505","2791","0","53.92","42.6"
"10","008","00","002","0226","0150","428","369","59","25","453","923","0","49.08","39.98"
"10","008","00","002","0226","0151","509","424","85","27","536","887","0","60.43","47.8"
"10","008","00","002","0226","0152","492","396","96","24","516","981","0","52.6","40.37"
"10","008","00","002","0227","0000","886","740","146","80","966","1630","0","59.26","45.4"
"10","008","00","002","0227","0116","375","305","70","55","430","725","0","59.31","42.07"
"10","008","00","002","0227","0117","511","435","76","25","536","905","0","59.23","48.07"
"10","008","00","002","0228","0000","1302","1058","244","99","1401","2588","0","54.13","40.88"
"10","008","00","002","0228","0118","599","498","101","41","640","1179","0","54.28","42.24"
"10","008","00","002","0228","0119","459","357","102","33","492","944","0","52.12","37.82"
"10","008","00","002","0228","0120","244","203","41","25","269","465","0","57.85","43.66"
"10","008","00","002","0229","0000","738","607","131","82","820","1622","0","50.55","37.42"
"10","008","00","002","0229","0145","605","500","105","69","674","1324","0","50.91","37.76"
"10","008","00","002","0229","0146","133","107","26","13","146","298","0","48.99","35.91"
"10","008","00","002","0230","0000","1919","1618","301","106","2025","3227","0","62.75","50.14"
"10","008","00","002","0230","0108","610","524","86","29","639","1045","0","61.15","50.14"
"10","008","00","002","0230","0109","657","566","91","37","694","1120","0","61.96","50.54"
"10","008","00","002","0230","0110","652","528","124","40","692","1062","0","65.16","49.72"
"10","008","00","002","0231","0000","1468","1213","255","71","1539","2616","0","58.83","46.37"
"10","008","00","002","0231","0088","729","608","121","39","768","1201","0","63.95","50.62"
"10","008","00","002","0231","0089","739","605","134","32","771","1415","0","54.49","42.76"
"10","008","00","002","0232","0000","1711","1428","283","88","1799","3179","0","56.59","44.92"
"10","008","00","002","0232","0111","557","474","83","28","585","1022","0","57.24","46.38"
"10","008","00","002","0232","0112","570","466","104","28","598","1051","0","56.9","44.34"
"10","008","00","002","0232","0113","584","488","96","32","616","1106","0","55.7","44.12"
"10","008","00","002","0233","0000","1184","1018","166","49","1233","2165","0","56.95","47.02"
"10","008","00","002","0233","0114","582","493","89","18","600","1098","0","54.64","44.9"
"10","008","00","002","0233","0115","602","525","77","31","633","1067","0","59.33","49.2"
"10","008","00","003","0000","0000","45159","37026","8133","2518","47677","82922","97223","57.5","44.65"
"10","008","00","003","0301","0000","1186","986","200","40","1226","2125","0","57.69","46.4"
"10","008","00","003","0301","0153","585","487","98","17","602","998","0","60.32","48.8"
"10","008","00","003","0301","0154","601","499","102","23","624","1127","0","55.37","44.28"
"10","008","00","003","0302","0000","1120","905","215","74","1194","2077","0","57.49","43.57"
"10","008","00","003","0302","0158","505","418","87","28","533","936","0","56.94","44.66"
"10","008","00","003","0302","0159","615","487","128","46","661","1141","0","57.93","42.68"
"10","008","00","003","0303","0000","647","524","123","17","664","1121","0","59.23","46.74"
"10","008","00","003","0303","0161","647","524","123","17","664","1121","0","59.23","46.74"
"10","008","00","003","0304","0000","3561","2986","575","233","3794","6455","0","58.78","46.26"
"10","008","00","003","0304","0164","655","532","123","40","695","1267","0","54.85","41.99"
"10","008","00","003","0304","0165","661","577","84","60","721","1214","0","59.39","47.53"
"10","008","00","003","0304","0166","681","553","128","65","746","1259","0","59.25","43.92"
"10","008","00","003","0304","0167","844","711","133","26","870","1442","0","60.33","49.31"
"10","008","00","003","0304","0168","720","613","107","42","762","1273","0","59.86","48.15"
"10","008","00","003","0305","0000","4230","3625","605","204","4434","7422","0","59.74","48.84"
"10","008","00","003","0305","0169","619","528","91","35","654","1145","0","57.12","46.11"
"10","008","00","003","0305","0170","687","577","110","24","711","1279","0","55.59","45.11"
"10","008","00","003","0305","0171","611","515","96","28","639","1158","0","55.18","44.47"
"10","008","00","003","0305","0172","839","727","112","46","885","1335","0","66.29","54.46"
"10","008","00","003","0305","0173","731","605","126","32","763","1178","0","64.77","51.36"
"10","008","00","003","0305","0174","743","673","70","39","782","1327","0","58.93","50.72"
"10","008","00","003","0306","0000","3451","2807","644","192","3643","6403","0","56.9","43.84"
"10","008","00","003","0306","0208","755","611","144","70","825","1466","0","56.28","41.68"
"10","008","00","003","0306","0209","639","527","112","35","674","1180","0","57.12","44.66"
"10","008","00","003","0306","0210","596","474","122","18","614","1006","0","61.03","47.12"
"10","008","00","003","0306","0211","475","397","78","31","506","1000","0","50.6","39.7"
"10","008","00","003","0306","0212","661","543","118","27","688","1128","0","60.99","48.14"
"10","008","00","003","0306","0213","325","255","70","11","336","623","0","53.93","40.93"
"10","008","00","003","0307","0000","2960","2414","546","157","3117","6046","0","51.55","39.93"
"10","008","00","003","0307","0190","638","520","118","21","659","1395","0","47.24","37.28"
"10","008","00","003","0307","0191","647","537","110","35","682","1101","0","61.94","48.77"
"10","008","00","003","0307","0192","666","547","119","35","701","1297","0","54.05","42.17"
"10","008","00","003","0307","0193","365","291","74","25","390","877","0","44.47","33.18"
"10","008","00","003","0307","0194","644","519","125","41","685","1376","0","49.78","37.72"
"10","008","00","003","0308","0000","2327","1920","407","164","2491","4066","0","61.26","47.22"
"10","008","00","003","0308","0195","611","515","96","40","651","1008","0","64.58","51.09"
"10","008","00","003","0308","0196","626","528","98","38","664","1080","0","61.48","48.89"
"10","008","00","003","0308","0197","520","418","102","43","563","1017","0","55.36","41.1"
"10","008","00","003","0308","0198","570","459","111","43","613","961","0","63.79","47.76"
"10","008","00","003","0309","0000","2255","1847","408","113","2368","4392","0","53.92","42.05"
"10","008","00","003","0309","0181","499","420","79","24","523","1048","0","49.9","40.08"
"10","008","00","003","0309","0182","527","435","92","41","568","1009","0","56.29","43.11"
"10","008","00","003","0309","0183","588","503","85","17","605","1138","0","53.16","44.2"
"10","008","00","003","0309","0184","641","489","152","31","672","1197","0","56.14","40.85"
"10","008","00","003","0310","0000","1370","1145","225","77","1447","2423","0","59.72","47.26"
"10","008","00","003","0310","0185","767","634","133","37","804","1364","0","58.94","46.48"
"10","008","00","003","0310","0186","603","511","92","40","643","1059","0","60.72","48.25"
"10","008","00","003","0311","0000","1613","1304","309","106","1719","2944","0","58.39","44.29"
"10","008","00","003","0311","0187","614","464","150","39","653","1108","0","58.94","41.88"
"10","008","00","003","0311","0188","472","398","74","29","501","879","0","57.0","45.28"
"10","008","00","003","0311","0189","527","442","85","38","565","957","0","59.04","46.19"
"10","008","00","003","0312","0000","1781","1493","288","76","1857","3143","0","59.08","47.5"
"10","008","00","003","0312","0178","605","504","101","26","631","1121","0","56.29","44.96"
"10","008","00","003","0312","0179","591","498","93","30","621","1043","0","59.54","47.75"
"10","008","00","003","0312","0180","585","491","94","20","605","979","0","61.8","50.15"
"10","008","00","003","0313","0000","1955","1608","347","99","2054","3524","0","58.29","45.63"
"10","008","00","003","0313","0199","665","549","116","44","709","1160","0","61.12","47.33"
"10","008","00","003","0313","0200","618","508","110","26","644","1121","0","57.45","45.32"
"10","008","00","003","0313","0201","672","551","121","29","701","1243","0","56.4","44.33"
"10","008","00","003","0314","0000","1566","1216","350","98","1664","2919","0","57.01","41.66"
"10","008","00","003","0314","0205","529","403","126","40","569","923","0","61.65","43.66"
"10","008","00","003","0314","0206","499","396","103","31","530","970","0","54.64","40.82"
"10","008","00","003","0314","0207","538","417","121","27","565","1026","0","55.07","40.64"
"10","008","00","003","0315","0000","735","590","145","33","768","1518","0","50.59","38.87"
"10","008","00","003","0315","0204","735","590","145","33","768","1518","0","50.59","38.87"
"10","008","00","003","0316","0000","1345","1062","283","63","1408","2255","0","62.44","47.1"
"10","008","00","003","0316","0202","529","407","122","21","550","932","0","59.01","43.67"
"10","008","00","003","0316","0203","816","655","161","42","858","1323","0","64.85","49.51"
"10","008","00","003","0317","0000","974","788","186","92","1066","1953","0","54.58","40.35"
"10","008","00","003","0317","0214","373","286","87","48","421","707","0","59.55","40.45"
"10","008","00","003","0317","0215","363","297","66","24","387","719","0","53.82","41.31"
"10","008","00","003","0317","0216","238","205","33","20","258","527","0","48.96","38.9"
"10","008","00","003","0318","0000","1153","957","196","78","1231","2052","0","59.99","46.64"
"10","008","00","003","0318","0217","656","541","115","52","708","1183","0","59.85","45.73"
"10","008","00","003","0318","0218","497","416","81","26","523","869","0","60.18","47.87"
"10","008","00","003","0319","0000","2162","1746","416","97","2259","4114","0","54.91","42.44"
"10","008","00","003","0319","0219","547","447","100","10","557","1132","0","49.2","39.49"
"10","008","00","003","0319","0220","522","422","100","44","566","949","0","59.64","44.47"
"10","008","00","003","0319","0221","563","458","105","11","574","965","0","59.48","47.46"
"10","008","00","003","0319","0222","530","419","111","32","562","1068","0","52.62","39.23"
"10","008","00","003","0320","0000","826","695","131","64","890","1659","0","53.65","41.89"
"10","008","00","003","0320","0224","325","272","53","27","352","642","0","54.83","42.37"
"10","008","00","003","0320","0225","501","423","78","37","538","1017","0","52.9","41.59"
"10","008","00","003","0321","0000","592","477","115","34","626","1024","0","61.13","46.58"
"10","008","00","003","0321","0223","592","477","115","34","626","1024","0","61.13","46.58"
"10","008","00","003","0322","0000","1208","1003","205","108","1316","2276","0","57.82","44.07"
"10","008","00","003","0322","0227","604","499","105","50","654","1170","0","55.9","42.65"
"10","008","00","003","0322","0228","604","504","100","58","662","1106","0","59.86","45.57"
"10","008","00","003","0323","0000","584","494","90","38","622","1092","0","56.96","45.24"
"10","008","00","003","0323","0226","584","494","90","38","622","1092","0","56.96","45.24"
"10","008","00","003","0324","0000","421","340","81","23","444","705","0","62.98","48.23"
"10","008","00","003","0324","0160","421","340","81","23","444","705","0","62.98","48.23"
"10","008","00","003","0325","0000","1340","1087","253","71","1411","2278","0","61.94","47.72"
"10","008","00","003","0325","0162","556","440","116","31","587","877","0","66.93","50.17"
"10","008","00","003","0325","0163","784","647","137","40","824","1401","0","58.82","46.18"
"10","008","00","003","0326","0000","2003","1512","491","99","2102","3796","0","55.37","39.83"
"10","008","00","003","0326","0155","705","500","205","24","729","1401","0","52.03","35.69"
"10","008","00","003","0326","0156","578","434","144","35","613","1110","0","55.23","39.1"
"10","008","00","003","0326","0157","720","578","142","40","760","1285","0","59.14","44.98"
"10","008","00","003","0327","0000","1794","1495","299","68","1862","3140","0","59.3","47.61"
"10","008","00","003","0327","0175","571","462","109","19","590","1000","0","59.0","46.2"
"10","008","00","003","0327","0176","684","584","100","26","710","1257","0","56.48","46.46"
"10","008","00","003","0327","0177","539","449","90","23","562","883","0","63.65","50.85"
"10","008","00","004","0000","0000","23861","18659","5202","1821","25682","47034","54689","54.6","39.67"
"10","008","00","004","0401","0000","1151","930","221","85","1236","2020","0","61.19","46.04"
"10","008","00","004","0401","0229","658","538","120","46","704","1170","0","60.17","45.98"
"10","008","00","004","0401","0230","493","392","101","39","532","850","0","62.59","46.12"
"10","008","00","004","0402","0000","313","253","60","29","342","621","0","55.07","40.74"
"10","008","00","004","0402","0231","313","253","60","29","342","621","0","55.07","40.74"
"10","008","00","004","0403","0000","2288","1899","389","184","2472","4505","0","54.87","42.15"
"10","008","00","004","0403","0232","473","390","83","25","498","905","0","55.03","43.09"
"10","008","00","004","0403","0233","509","427","82","47","556","1099","0","50.59","38.85"
"10","008","00","004","0403","0234","585","480","105","56","641","1214","0","52.8","39.54"
"10","008","00","004","0403","0235","721","602","119","56","777","1287","0","60.37","46.78"
"10","008","00","004","0404","0000","1807","1462","345","138","1945","3587","0","54.22","40.76"
"10","008","00","004","0404","0236","641","528","113","46","687","1191","0","57.68","44.33"
"10","008","00","004","0404","0237","471","363","108","66","537","1118","0","48.03","32.47"
"10","008","00","004","0404","0238","695","571","124","26","721","1278","0","56.42","44.68"
"10","008","00","004","0405","0000","916","749","167","69","985","1715","0","57.43","43.67"
"10","008","00","004","0405","0270","439","350","89","51","490","793","0","61.79","44.14"
"10","008","00","004","0405","0271","477","399","78","18","495","922","0","53.69","43.28"
"10","008","00","004","0406","0000","647","560","87","34","681","1193","0","57.08","46.94"
"10","008","00","004","0406","0244","295","254","41","26","321","511","0","62.82","49.71"
"10","008","00","004","0406","0245","352","306","46","8","360","682","0","52.79","44.87"
"10","008","00","004","0407","0000","1878","1557","321","135","2013","3710","0","54.26","41.97"
"10","008","00","004","0407","0241","674","577","97","47","721","1308","0","55.12","44.11"
"10","008","00","004","0407","0242","678","540","138","42","720","1358","0","53.02","39.76"
"10","008","00","004","0407","0243","526","440","86","46","572","1044","0","54.79","42.15"
"10","008","00","004","0408","0000","463","360","103","23","486","989","0","49.14","36.4"
"10","008","00","004","0408","0246","463","360","103","23","486","989","0","49.14","36.4"
"10","008","00","004","0409","0000","714","594","120","31","745","1378","0","54.06","43.11"
"10","008","00","004","0409","0247","714","594","120","31","745","1378","0","54.06","43.11"
"10","008","00","004","0410","0000","391","343","48","28","419","875","0","47.89","39.2"
"10","008","00","004","0410","0272","175","150","25","19","194","366","0","53.01","40.98"
"10","008","00","004","0410","0273","216","193","23","9","225","509","0","44.2","37.92"
"10","008","00","004","0411","0000","1457","1193","264","87","1544","2882","0","53.57","41.39"
"10","008","00","004","0411","0260","726","585","141","39","765","1320","0","57.95","44.32"
"10","008","00","004","0411","0261","459","374","85","30","489","967","0","50.57","38.68"
"10","008","00","004","0411","0262","272","234","38","18","290","595","0","48.74","39.33"
"10","008","00","004","0412","0000","786","622","164","63","849","1729","0","49.1","35.97"
"10","008","00","004","0412","0258","406","327","79","22","428","908","0","47.14","36.01"
"10","008","00","004","0412","0259","380","295","85","41","421","821","0","51.28","35.93"
"10","008","00","004","0413","0000","417","337","80","57","474","859","0","55.18","39.23"
"10","008","00","004","0413","0263","417","337","80","57","474","859","0","55.18","39.23"
"10","008","00","004","0414","0000","2663","1701","962","166","2829","4873","0","58.05","34.91"
"10","008","00","004","0414","0251","751","147","604","56","807","1437","0","56.16","10.23"
"10","008","00","004","0414","0252","729","585","144","42","771","1286","0","59.95","45.49"
"10","008","00","004","0414","0253","621","511","110","35","656","1080","0","60.74","47.31"
"10","008","00","004","0414","0254","562","458","104","33","595","1070","0","55.61","42.8"
"10","008","00","004","0415","0000","929","749","180","88","1017","1845","0","55.12","40.6"
"10","008","00","004","0415","0264","590","470","120","58","648","1196","0","54.18","39.3"
"10","008","00","004","0415","0265","339","279","60","30","369","649","0","56.86","42.99"
"10","008","00","004","0416","0000","693","558","135","50","743","1341","0","55.41","41.61"
"10","008","00","004","0416","0266","693","558","135","50","743","1341","0","55.41","41.61"
"10","008","00","004","0417","0000","545","442","103","66","611","1222","0","50.0","36.17"
"10","008","00","004","0417","0267","545","442","103","66","611","1222","0","50.0","36.17"
"10","008","00","004","0418","0000","321","264","57","26","347","602","0","57.64","43.85"
"10","008","00","004","0418","0268","321","264","57","26","347","602","0","57.64","43.85"
"10","008","00","004","0419","0000","184","143","41","14","198","430","0","46.05","33.26"
"10","008","00","004","0419","0250","184","143","41","14","198","430","0","46.05","33.26"
"10","008","00","004","0420","0000","317","263","54","29","346","617","0","56.08","42.63"
"10","008","00","004","0420","0269","317","263","54","29","346","617","0","56.08","42.63"
"10","008","00","004","0421","0000","327","274","53","28","355","599","0","59.27","45.74"
"10","008","00","004","0421","0274","95","83","12","9","104","193","0","53.89","43.01"
"10","008","00","004","0421","0275","232","191","41","19","251","406","0","61.82","47.04"
"10","008","00","004","0422","0000","326","273","53","32","358","802","0","44.64","34.04"
"10","008","00","004","0422","0276","229","188","41","23","252","495","0","50.91","37.98"
"10","008","00","004","0422","0277","97","85","12","9","106","307","0","34.53","27.69"
"10","008","00","004","0423","0000","274","232","42","39","313","577","0","54.25","40.21"
"10","008","00","004","0423","0279","274","232","42","39","313","577","0","54.25","40.21"
"10","008","00","004","0424","0000","215","186","29","19","234","440","0","53.18","42.27"
"10","008","00","004","0424","0278","215","186","29","19","234","440","0","53.18","42.27"
"10","008","00","004","0425","0000","311","227","84","50","361","889","0","40.61","25.53"
"10","008","00","004","0425","0280","179","124","55","34","213","486","0","43.83","25.51"
"10","008","00","004","0425","0281","132","103","29","16","148","403","0","36.72","25.56"
"10","008","00","004","0426","0000","370","299","71","29","399","696","0","57.33","42.96"
"10","008","00","004","0426","0248","107","82","25","4","111","217","0","51.15","37.79"
"10","008","00","004","0426","0249","263","217","46","25","288","479","0","60.13","45.3"
"10","008","00","004","0427","0000","1951","1610","341","105","2056","3642","0","56.45","44.21"
"10","008","00","004","0427","0255","702","595","107","44","746","1295","0","57.61","45.95"
"10","008","00","004","0427","0256","561","453","108","28","589","1047","0","56.26","43.27"
"10","008","00","004","0427","0257","688","562","126","33","721","1300","0","55.46","43.23"
"10","008","00","004","0428","0000","1207","579","628","117","1324","2396","0","55.26","24.17"
"10","008","00","004","0428","0239","625","498","127","50","675","1153","0","58.54","43.19"
"10","008","00","004","0428","0240","582","81","501","67","649","1243","0","52.21","6.52"
"10","008","00","005","0000","0000","5113","4068","1045","418","5531","9611","10871","57.55","42.33"
"10","008","00","005","0501","0000","595","509","86","49","644","1070","0","60.19","47.57"
"10","008","00","005","0501","0282","595","509","86","49","644","1070","0","60.19","47.57"
"10","008","00","005","0502","0000","538","439","99","23","561","918","0","61.11","47.82"
"10","008","00","005","0502","0283","538","439","99","23","561","918","0","61.11","47.82"
"10","008","00","005","0503","0000","322","264","58","26","348","581","0","59.9","45.44"
"10","008","00","005","0503","0284","322","264","58","26","348","581","0","59.9","45.44"
"10","008","00","005","0504","0000","676","556","120","38","714","1194","0","59.8","46.57"
"10","008","00","005","0504","0285","676","556","120","38","714","1194","0","59.8","46.57"
"10","008","00","005","0505","0000","199","157","42","21","220","488","0","45.08","32.17"
"10","008","00","005","0505","0286","199","157","42","21","220","488","0","45.08","32.17"
"10","008","00","005","0506","0000","278","233","45","35","313","504","0","62.1","46.23"
"10","008","00","005","0506","0287","278","233","45","35","313","504","0","62.1","46.23"
"10","008","00","005","0507","0000","487","390","97","76","563","910","0","61.87","42.86"
"10","008","00","005","0507","0288","487","390","97","76","563","910","0","61.87","42.86"
"10","008","00","005","0508","0000","810","658","152","77","887","1482","0","59.85","44.4"
"10","008","00","005","0508","0289","433","360","73","52","485","773","0","62.74","46.57"
"10","008","00","005","0508","0290","377","298","79","25","402","709","0","56.7","42.03"
"10","008","00","005","0509","0000","507","420","87","24","531","960","0","55.31","43.75"
"10","008","00","005","0509","0291","507","420","87","24","531","960","0","55.31","43.75"
"10","008","00","005","0510","0000","255","212","43","9","264","582","0","45.36","36.43"
"10","008","00","005","0510","0294","255","212","43","9","264","582","0","45.36","36.43"
"10","008","00","005","0511","0000","446","230","216","40","486","922","0","52.71","24.95"
"10","008","00","005","0511","0292","256","199","57","19","275","503","0","54.67","39.56"
"10","008","00","005","0511","0293","190","31","159","21","211","419","0","50.36","7.4"
"10","008","00","006","0000","0000","18333","14946","3387","1622","19955","33408","38376","59.73","44.74"
"10","008","00","006","0601","0000","679","537","142","51","730","1050","0","69.52","51.14"
"10","008","00","006","0601","0295","679","537","142","51","730","1050","0","69.52","51.14"
"10","008","00","006","0602","0000","1961","1627","334","140","2101","3405","0","61.7","47.78"
"10","008","00","006","0602","0296","511","416","95","43","554","920","0","60.22","45.22"
"10","008","00","006","0602","0297","439","361","78","35","474","727","0","65.2","49.66"
"10","008","00","006","0602","0298","521","441","80","32","553","861","0","64.23","51.22"
"10","008","00","006","0602","0299","490","409","81","30","520","897","0","57.97","45.6"
"10","008","00","006","0603","0000","1251","1024","227","95","1346","2239","0","60.12","45.73"
"10","008","00","006","0603","0300","609","493","116","39","648","1055","0","61.42","46.73"
"10","008","00","006","0603","0301","642","531","111","56","698","1184","0","58.95","44.85"
"10","008","00","006","0604","0000","860","690","170","75","935","1564","0","59.78","44.12"
"10","008","00","006","0604","0302","411","322","89","35","446","783","0","56.96","41.12"
"10","008","00","006","0604","0303","449","368","81","40","489","781","0","62.61","47.12"
"10","008","00","006","0605","0000","503","409","94","59","562","1015","0","55.37","40.3"
"10","008","00","006","0605","0305","503","409","94","59","562","1015","0","55.37","40.3"
"10","008","00","006","0606","0000","495","417","78","36","531","977","0","54.35","42.68"
"10","008","00","006","0606","0304","495","417","78","36","531","977","0","54.35","42.68"
"10","008","00","006","0607","0000","2346","1908","438","132","2478","4234","0","58.53","45.06"
"10","008","00","006","0607","0306","524","429","95","22","546","914","0","59.74","46.94"
"10","008","00","006","0607","0307","546","441","105","17","563","1028","0","54.77","42.9"
"10","008","00","006","0607","0308","582","477","105","31","613","1018","0","60.22","46.86"
"10","008","00","006","0607","0309","694","561","133","62","756","1274","0","59.34","44.03"
"10","008","00","006","0608","0000","962","769","193","84","1046","1650","0","63.39","46.61"
"10","008","00","006","0608","0310","416","329","87","38","454","755","0","60.13","43.58"
"10","008","00","006","0608","0311","546","440","106","46","592","895","0","66.15","49.16"
"10","008","00","006","0609","0000","494","402","92","57","551","951","0","57.94","42.27"
"10","008","00","006","0609","0313","494","402","92","57","551","951","0","57.94","42.27"
"10","008","00","006","0610","0000","665","535","130","59","724","1261","0","57.41","42.43"
"10","008","00","006","0610","0314","665","535","130","59","724","1261","0","57.41","42.43"
"10","008","00","006","0611","0000","1008","799","209","109","1117","1829","0","61.07","43.69"
"10","008","00","006","0611","0316","531","416","115","53","584","962","0","60.71","43.24"
"10","008","00","006","0611","0317","477","383","94","56","533","867","0","61.48","44.18"
"10","008","00","006","0612","0000","502","408","94","62","564","930","0","60.65","43.87"
"10","008","00","006","0612","0318","502","408","94","62","564","930","0","60.65","43.87"
"10","008","00","006","0613","0000","407","313","94","36","443","768","0","57.68","40.76"
"10","008","00","006","0613","0315","407","313","94","36","443","768","0","57.68","40.76"
"10","008","00","006","0614","0000","492","394","98","63","555","931","0","59.61","42.32"
"10","008","00","006","0614","0321","492","394","98","63","555","931","0","59.61","42.32"
"10","008","00","006","0615","0000","585","460","125","84","669","1171","0","57.13","39.28"
"10","008","00","006","0615","0319","331","256","75","57","388","641","0","60.53","39.94"
"10","008","00","006","0615","0320","254","204","50","27","281","530","0","53.02","38.49"
"10","008","00","006","0616","0000","880","718","162","85","965","1570","0","61.46","45.73"
"10","008","00","006","0616","0322","619","507","112","52","671","1127","0","59.54","44.99"
"10","008","00","006","0616","0323","261","211","50","33","294","443","0","66.37","47.63"
"10","008","00","006","0617","0000","827","676","151","95","922","1491","0","61.84","45.34"
"10","008","00","006","0617","0324","493","402","91","39","532","870","0","61.15","46.21"
"10","008","00","006","0617","0325","334","274","60","56","390","621","0","62.8","44.12"
"10","008","00","006","0618","0000","568","454","114","37","605","1179","0","51.31","38.51"
"10","008","00","006","0618","0326","568","454","114","37","605","1179","0","51.31","38.51"
"10","008","00","006","0619","0000","544","451","93","52","596","876","0","68.04","51.48"
"10","008","00","006","0619","0328","544","451","93","52","596","876","0","68.04","51.48"
"10","008","00","006","0620","0000","514","441","73","44","558","881","0","63.34","50.06"
"10","008","00","006","0620","0327","514","441","73","44","558","881","0","63.34","50.06"
"10","008","00","006","0621","0000","414","345","69","60","474","783","0","60.54","44.06"
"10","008","00","006","0621","0329","414","345","69","60","474","783","0","60.54","44.06"
"10","008","00","006","0622","0000","878","727","151","82","960","1761","0","54.51","41.28"
"10","008","00","006","0622","0330","380","326","54","39","419","778","0","53.86","41.9"
"10","008","00","006","0622","0331","498","401","97","43","541","983","0","55.04","40.79"
"10","008","00","006","0623","0000","498","442","56","25","523","892","0","58.63","49.55"
"10","008","00","006","0623","0312","498","442","56","25","523","892","0","58.63","49.55"
"10","008","00","007","0000","0000","7926","6543","1383","587","8513","15941","17698","53.4","41.05"
"10","008","00","007","0701","0000","943","786","157","78","1021","1874","0","54.48","41.94"
"10","008","00","007","0701","0332","447","383","64","37","484","934","0","51.82","41.01"
"10","008","00","007","0701","0333","496","403","93","41","537","940","0","57.13","42.87"
"10","008","00","007","0702","0000","653","557","96","53","706","1430","0","49.37","38.95"
"10","008","00","007","0702","0348","345","291","54","25","370","713","0","51.89","40.81"
"10","008","00","007","0702","0349","308","266","42","28","336","717","0","46.86","37.1"
"10","008","00","007","0703","0000","621","514","107","41","662","1303","0","50.81","39.45"
"10","008","00","007","0703","0334","430","347","83","25","455","852","0","53.4","40.73"
"10","008","00","007","0703","0335","191","167","24","16","207","451","0","45.9","37.03"
"10","008","00","007","0704","0000","1126","948","178","75","1201","1952","0","61.53","48.57"
"10","008","00","007","0704","0336","457","386","71","32","489","810","0","60.37","47.65"
"10","008","00","007","0704","0337","669","562","107","43","712","1142","0","62.35","49.21"
"10","008","00","007","0705","0000","536","447","89","37","573","1045","0","54.83","42.78"
"10","008","00","007","0705","0342","275","221","54","19","294","578","0","50.87","38.24"
"10","008","00","007","0705","0343","261","226","35","18","279","467","0","59.74","48.39"
"10","008","00","007","0706","0000","756","605","151","56","812","1507","0","53.88","40.15"
"10","008","00","007","0706","0345","360","294","66","21","381","740","0","51.49","39.73"
"10","008","00","007","0706","0346","396","311","85","35","431","767","0","56.19","40.55"
"10","008","00","007","0707","0000","488","401","87","42","530","909","0","58.31","44.11"
"10","008","00","007","0707","0347","488","401","87","42","530","909","0","58.31","44.11"
"10","008","00","007","0708","0000","325","283","42","21","346","622","0","55.63","45.5"
"10","008","00","007","0708","0344","325","283","42","21","346","622","0","55.63","45.5"
"10","008","00","007","0709","0000","685","540","145","50","735","1392","0","52.8","38.79"
"10","008","00","007","0709","0340","429","333","96","30","459","811","0","56.6","41.06"
"10","008","00","007","0709","0341","256","207","49","20","276","581","0","47.5","35.63"
"10","008","00","007","0710","0000","818","681","137","62","880","1650","0","53.33","41.27"
"10","008","00","007","0710","0338","342","285","57","21","363","766","0","47.39","37.21"
"10","008","00","007","0710","0339","476","396","80","41","517","884","0","58.48","44.8"
"10","008","00","007","0711","0000","369","295","74","31","400","794","0","50.38","37.15"
"10","008","00","007","0711","0350","369","295","74","31","400","794","0","50.38","37.15"
"10","008","00","007","0712","0000","321","251","70","14","335","726","0","46.14","34.57"
"10","008","00","007","0712","0351","321","251","70","14","335","726","0","46.14","34.57"
"10","008","00","007","0713","0000","285","235","50","27","312","737","0","42.33","31.89"
"10","008","00","007","0713","0352","285","235","50","27","312","737","0","42.33","31.89"
"10","008","00","008","0000","0000","6973","5701","1272","633","7606","13181","14734","57.7","43.25"
"10","008","00","008","0801","0000","459","371","88","46","505","822","0","61.44","45.13"
"10","008","00","008","0801","0353","459","371","88","46","505","822","0","61.44","45.13"
"10","008","00","008","0802","0000","234","198","36","16","250","474","0","52.74","41.77"
"10","008","00","008","0802","0354","145","123","22","10","155","253","0","61.26","48.62"
"10","008","00","008","0802","0355","89","75","14","6","95","221","0","42.99","33.94"
"10","008","00","008","0803","0000","361","294","67","31","392","780","0","50.26","37.69"
"10","008","00","008","0803","0356","154","130","24","2","156","353","0","44.19","36.83"
"10","008","00","008","0803","0357","207","164","43","29","236","427","0","55.27","38.41"
"10","008","00","008","0804","0000","368","308","60","32","400","661","0","60.51","46.6"
"10","008","00","008","0804","0360","368","308","60","32","400","661","0","60.51","46.6"
"10","008","00","008","0805","0000","362","287","75","25","387","713","0","54.28","40.25"
"10","008","00","008","0805","0358","214","172","42","13","227","406","0","55.91","42.36"
"10","008","00","008","0805","0359","148","115","33","12","160","307","0","52.12","37.46"
"10","008","00","008","0806","0000","978","789","189","49","1027","1727","0","59.47","45.69"
"10","008","00","008","0806","0362","549","437","112","23","572","973","0","58.79","44.91"
"10","008","00","008","0806","0363","429","352","77","26","455","754","0","60.34","46.68"
"10","008","00","008","0807","0000","175","143","32","18","193","290","0","66.55","49.31"
"10","008","00","008","0807","0361","175","143","32","18","193","290","0","66.55","49.31"
"10","008","00","008","0808","0000","341","277","64","27","368","662","0","55.59","41.84"
"10","008","00","008","0808","0364","341","277","64","27","368","662","0","55.59","41.84"
"10","008","00","008","0809","0000","215","185","30","14","229","490","0","46.73","37.76"
"10","008","00","008","0809","0365","215","185","30","14","229","490","0","46.73","37.76"
"10","008","00","008","0810","0000","699","602","97","51","750","1325","0","56.6","45.43"
"10","008","00","008","0810","0366","160","134","26","15","175","335","0","52.24","40.0"
"10","008","00","008","0810","0367","539","468","71","36","575","990","0","58.08","47.27"
"10","008","00","008","0811","0000","620","485","135","51","671","1075","0","62.42","45.12"
"10","008","00","008","0811","0368","273","209","64","19","292","461","0","63.34","45.34"
"10","008","00","008","0811","0369","347","276","71","32","379","614","0","61.73","44.95"
"10","008","00","008","0812","0000","452","368","84","64","516","895","0","57.65","41.12"
"10","008","00","008","0812","0370","452","368","84","64","516","895","0","57.65","41.12"
"10","008","00","008","0813","0000","353","284","69","49","402","682","0","58.94","41.64"
"10","008","00","008","0813","0372","353","284","69","49","402","682","0","58.94","41.64"
"10","008","00","008","0814","0000","351","282","69","45","396","643","0","61.59","43.86"
"10","008","00","008","0814","0374","351","282","69","45","396","643","0","61.59","43.86"
"10","008","00","008","0815","0000","244","196","48","23","267","528","0","50.57","37.12"
"10","008","00","008","0815","0376","244","196","48","23","267","528","0","50.57","37.12"
"10","008","00","008","0816","0000","234","190","44","32","266","465","0","57.2","40.86"
"10","008","00","008","0816","0371","234","190","44","32","266","465","0","57.2","40.86"
"10","008","00","008","0817","0000","266","221","45","18","284","459","0","61.87","48.15"
"10","008","00","008","0817","0375","266","221","45","18","284","459","0","61.87","48.15"
"10","008","00","008","0818","0000","261","221","40","42","303","490","0","61.84","45.1"
"10","008","00","008","0818","0373","261","221","40","42","303","490","0","61.84","45.1"
"10","008","00","009","0000","0000","7023","5746","1277","536","7559","13958","15823","54.16","41.17"
"10","008","00","009","0901","0000","833","671","162","60","893","1580","0","56.52","42.47"
"10","008","00","009","0901","0379","360","290","70","26","386","720","0","53.61","40.28"
"10","008","00","009","0901","0380","473","381","92","34","507","860","0","58.95","44.3"
"10","008","00","009","0902","0000","1078","862","216","89","1167","2020","0","57.77","42.67"
"10","008","00","009","0902","0377","482","397","85","39","521","922","0","56.51","43.06"
"10","008","00","009","0902","0378","596","465","131","50","646","1098","0","58.83","42.35"
"10","008","00","009","0903","0000","462","375","87","33","495","1017","0","48.67","36.87"
"10","008","00","009","0903","0394","255","214","41","16","271","578","0","46.89","37.02"
"10","008","00","009","0903","0395","207","161","46","17","224","439","0","51.03","36.67"
"10","008","00","009","0904","0000","693","547","146","57","750","1386","0","54.11","39.47"
"10","008","00","009","0904","0387","401","317","84","29","430","841","0","51.13","37.69"
"10","008","00","009","0904","0388","155","122","33","13","168","270","0","62.22","45.19"
"10","008","00","009","0904","0389","137","108","29","15","152","275","0","55.27","39.27"
"10","008","00","009","0905","0000","516","424","92","28","544","1088","0","50.0","38.97"
"10","008","00","009","0905","0381","240","196","44","21","261","514","0","50.78","38.13"
"10","008","00","009","0905","0382","276","228","48","7","283","574","0","49.3","39.72"
"10","008","00","009","0906","0000","629","502","127","45","674","1249","0","53.96","40.19"
"10","008","00","009","0906","0383","629","502","127","45","674","1249","0","53.96","40.19"
"10","008","00","009","0907","0000","530","423","107","42","572","992","0","57.66","42.64"
"10","008","00","009","0907","0384","176","149","27","16","192","293","0","65.53","50.85"
"10","008","00","009","0907","0385","260","207","53","18","278","513","0","54.19","40.35"
"10","008","00","009","0907","0386","94","67","27","8","102","186","0","54.84","36.02"
"10","008","00","009","0908","0000","299","245","54","18","317","674","0","47.03","36.35"
"10","008","00","009","0908","0390","120","95","25","10","130","282","0","46.1","33.69"
"10","008","00","009","0908","0391","179","150","29","8","187","392","0","47.7","38.27"
"10","008","00","009","0909","0000","363","312","51","36","399","732","0","54.51","42.62"
"10","008","00","009","0909","0392","279","241","38","24","303","556","0","54.5","43.35"
"10","008","00","009","0909","0393","84","71","13","12","96","176","0","54.55","40.34"
"10","008","00","009","0910","0000","474","407","67","26","500","844","0","59.24","48.22"
"10","008","00","009","0910","0396","474","407","67","26","500","844","0","59.24","48.22"
"10","008","00","009","0911","0000","455","370","85","39","494","942","0","52.44","39.28"
"10","008","00","009","0911","0398","171","155","16","18","189","405","0","46.67","38.27"
"10","008","00","009","0911","0399","284","215","69","21","305","537","0","56.8","40.04"
"10","008","00","009","0912","0000","261","221","40","27","288","566","0","50.88","39.05"
"10","008","00","009","0912","0400","170","142","28","14","184","335","0","54.93","42.39"
"10","008","00","009","0912","0401","91","79","12","13","104","231","0","45.02","34.2"
"10","008","00","009","0913","0000","430","387","43","36","466","868","0","53.69","44.59"
"10","008","00","009","0913","0397","430","387","43","36","466","868","0","53.69","44.59"
"10","008","00","010","0000","0000","8655","7165","1490","629","9284","16597","18699","55.94","43.17"
"10","008","00","010","1001","0000","944","779","165","72","1016","1700","0","59.76","45.82"
"10","008","00","010","1001","0402","552","457","95","48","600","964","0","62.24","47.41"
"10","008","00","010","1001","0403","392","322","70","24","416","736","0","56.52","43.75"
"10","008","00","010","1002","0000","948","806","142","54","1002","1765","0","56.77","45.67"
"10","008","00","010","1002","0404","429","362","67","44","473","801","0","59.05","45.19"
"10","008","00","010","1002","0405","519","444","75","10","529","964","0","54.88","46.06"
"10","008","00","010","1003","0000","360","302","58","26","386","686","0","56.27","44.02"
"10","008","00","010","1003","0406","360","302","58","26","386","686","0","56.27","44.02"
"10","008","00","010","1004","0000","905","706","199","60","965","1880","0","51.33","37.55"
"10","008","00","010","1004","0411","535","417","118","39","574","1012","0","56.72","41.21"
"10","008","00","010","1004","0412","370","289","81","21","391","868","0","45.05","33.29"
"10","008","00","010","1005","0000","679","570","109","64","743","1391","0","53.41","40.98"
"10","008","00","010","1005","0407","333","280","53","29","362","661","0","54.77","42.36"
"10","008","00","010","1005","0408","346","290","56","35","381","730","0","52.19","39.73"
"10","008","00","010","1006","0000","409","327","82","14","423","706","0","59.92","46.32"
"10","008","00","010","1006","0410","409","327","82","14","423","706","0","59.92","46.32"
"10","008","00","010","1007","0000","1023","885","138","65","1088","1855","0","58.65","47.71"
"10","008","00","010","1007","0413","540","478","62","21","561","918","0","61.11","52.07"
"10","008","00","010","1007","0414","483","407","76","44","527","937","0","56.24","43.44"
"10","008","00","010","1008","0000","399","327","72","52","451","815","0","55.34","40.12"
"10","008","00","010","1008","0415","399","327","72","52","451","815","0","55.34","40.12"
"10","008","00","010","1009","0000","637","528","109","43","680","1134","0","59.96","46.56"
"10","008","00","010","1009","0416","637","528","109","43","680","1134","0","59.96","46.56"
"10","008","00","010","1010","0000","791","645","146","59","850","1543","0","55.09","41.8"
"10","008","00","010","1010","0418","573","464","109","40","613","1095","0","55.98","42.37"
"10","008","00","010","1010","0419","218","181","37","19","237","448","0","52.9","40.4"
"10","008","00","010","1011","0000","811","686","125","56","867","1634","0","53.06","41.98"
"10","008","00","010","1011","0420","534","452","82","36","570","1064","0","53.57","42.48"
"10","008","00","010","1011","0421","277","234","43","20","297","570","0","52.11","41.05"
"10","008","00","010","1012","0000","362","296","66","17","379","714","0","53.08","41.46"
"10","008","00","010","1012","0417","362","296","66","17","379","714","0","53.08","41.46"
"10","008","00","010","1013","0000","387","308","79","47","434","774","0","56.07","39.79"
"10","008","00","010","1013","0409","387","308","79","47","434","774","0","56.07","39.79"
"10","008","00","011","0000","0000","7933","6511","1422","589","8522","15458","17582","55.13","42.12"
"10","008","00","011","1101","0000","390","330","60","30","420","757","0","55.48","43.59"
"10","008","00","011","1101","0422","390","330","60","30","420","757","0","55.48","43.59"
"10","008","00","011","1102","0000","273","232","41","9","282","480","0","58.75","48.33"
"10","008","00","011","1102","0427","273","232","41","9","282","480","0","58.75","48.33"
"10","008","00","011","1103","0000","824","670","154","68","892","1553","0","57.44","43.14"
"10","008","00","011","1103","0423","285","244","41","29","314","554","0","56.68","44.04"
"10","008","00","011","1103","0424","539","426","113","39","578","999","0","57.86","42.64"
"10","008","00","011","1104","0000","296","250","46","16","312","616","0","50.65","40.58"
"10","008","00","011","1104","0425","296","250","46","16","312","616","0","50.65","40.58"
"10","008","00","011","1105","0000","485","411","74","25","510","875","0","58.29","46.97"
"10","008","00","011","1105","0426","485","411","74","25","510","875","0","58.29","46.97"
"10","008","00","011","1106","0000","559","455","104","29","588","1004","0","58.57","45.32"
"10","008","00","011","1106","0430","559","455","104","29","588","1004","0","58.57","45.32"
"10","008","00","011","1107","0000","595","480","115","45","640","998","0","64.13","48.1"
"10","008","00","011","1107","0433","595","480","115","45","640","998","0","64.13","48.1"
"10","008","00","011","1108","0000","732","573","159","71","803","1389","0","57.81","41.25"
"10","008","00","011","1108","0434","389","306","83","50","439","800","0","54.88","38.25"
"10","008","00","011","1108","0435","343","267","76","21","364","589","0","61.8","45.33"
"10","008","00","011","1109","0000","586","491","95","49","635","1217","0","52.18","40.35"
"10","008","00","011","1109","0437","586","491","95","49","635","1217","0","52.18","40.35"
"10","008","00","011","1110","0000","223","184","39","23","246","450","0","54.67","40.89"
"10","008","00","011","1110","0428","223","184","39","23","246","450","0","54.67","40.89"
"10","008","00","011","1111","0000","316","265","51","38","354","643","0","55.05","41.21"
"10","008","00","011","1111","0429","316","265","51","38","354","643","0","55.05","41.21"
"10","008","00","011","1112","0000","72","61","11","0","72","205","0","35.12","29.76"
"10","008","00","011","1112","0438","72","61","11","0","72","205","0","35.12","29.76"
"10","008","00","011","1113","0000","188","160","28","21","209","330","0","63.33","48.48"
"10","008","00","011","1113","0439","188","160","28","21","209","330","0","63.33","48.48"
"10","008","00","011","1114","0000","532","434","98","28","560","1100","0","50.91","39.45"
"10","008","00","011","1114","0440","532","434","98","28","560","1100","0","50.91","39.45"
"10","008","00","011","1115","0000","422","340","82","46","468","887","0","52.76","38.33"
"10","008","00","011","1115","0436","422","340","82","46","468","887","0","52.76","38.33"
"10","008","00","011","1116","0000","124","107","17","5","129","318","0","40.57","33.65"
"10","008","00","011","1116","0442","124","107","17","5","129","318","0","40.57","33.65"
"10","008","00","011","1117","0000","398","322","76","46","444","818","0","54.28","39.36"
"10","008","00","011","1117","0443","398","322","76","46","444","818","0","54.28","39.36"
"10","008","00","011","1118","0000","88","80","8","3","91","275","0","33.09","29.09"
"10","008","00","011","1118","0441","88","80","8","3","91","275","0","33.09","29.09"
"10","008","00","011","1119","0000","830","666","164","37","867","1543","0","56.19","43.16"
"10","008","00","011","1119","0431","379","322","57","18","397","741","0","53.58","43.45"
"10","008","00","011","1119","0432","451","344","107","19","470","802","0","58.6","42.89"
"10","008","00","012","0000","0000","6505","5246","1259","961","7466","13299","16281","56.14","39.45"
"10","008","00","012","1201","0000","589","469","120","169","758","1203","0","63.01","38.99"
"10","008","00","012","1201","0459","473","377","96","162","635","929","0","68.35","40.58"
"10","008","00","012","1201","0460","116","92","24","7","123","274","0","44.89","33.58"
"10","008","00","012","1202","0000","563","472","91","66","629","900","0","69.89","52.44"
"10","008","00","012","1202","0461","563","472","91","66","629","900","0","69.89","52.44"
"10","008","00","012","1203","0000","320","247","73","27","347","560","0","61.96","44.11"
"10","008","00","012","1203","0463","320","247","73","27","347","560","0","61.96","44.11"
"10","008","00","012","1204","0000","736","604","132","111","847","1530","0","55.36","39.48"
"10","008","00","012","1204","0444","586","473","113","95","681","1201","0","56.7","39.38"
"10","008","00","012","1204","0445","150","131","19","16","166","329","0","50.46","39.82"
"10","008","00","012","1205","0000","246","181","65","18","264","516","0","51.16","35.08"
"10","008","00","012","1205","0446","246","181","65","18","264","516","0","51.16","35.08"
"10","008","00","012","1206","0000","317","266","51","26","343","745","0","46.04","35.7"
"10","008","00","012","1206","0447","171","137","34","20","191","424","0","45.05","32.31"
"10","008","00","012","1206","0448","146","129","17","6","152","321","0","47.35","40.19"
"10","008","00","012","1207","0000","321","270","51","15","336","1376","0","24.42","19.62"
"10","008","00","012","1207","0451","321","270","51","15","336","1376","0","24.42","19.62"
"10","008","00","012","1208","0000","714","569","145","97","811","1509","0","53.74","37.71"
"10","008","00","012","1208","0452","398","319","79","21","419","979","0","42.8","32.58"
"10","008","00","012","1208","0453","316","250","66","76","392","530","0","73.96","47.17"
"10","008","00","012","1209","0000","667","547","120","71","738","1425","0","51.79","38.39"
"10","008","00","012","1209","0454","432","348","84","51","483","961","0","50.26","36.21"
"10","008","00","012","1209","0455","235","199","36","20","255","464","0","54.96","42.89"
"10","008","00","012","1210","0000","354","289","65","36","390","666","0","58.56","43.39"
"10","008","00","012","1210","0456","276","228","48","27","303","517","0","58.61","44.1"
"10","008","00","012","1210","0457","78","61","17","9","87","149","0","58.39","40.94"
"10","008","00","012","1211","0000","603","468","135","148","751","1020","0","73.63","45.88"
"10","008","00","012","1211","0458","603","468","135","148","751","1020","0","73.63","45.88"
"10","008","00","012","1212","0000","397","311","86","54","451","617","0","73.1","50.41"
"10","008","00","012","1212","0462","397","311","86","54","451","617","0","73.1","50.41"
"10","008","00","012","1213","0000","330","261","69","94","424","584","0","72.6","44.69"
"10","008","00","012","1213","0450","330","261","69","94","424","584","0","72.6","44.69"
"10","008","00","012","1214","0000","348","292","56","29","377","648","0","58.18","45.06"
"10","008","00","012","1214","0449","348","292","56","29","377","648","0","58.18","45.06"
"10","008","00","013","0000","0000","6177","5087","1090","467","6644","12589","15954","52.78","40.41"
"10","008","00","013","1301","0000","287","230","57","6","293","763","0","38.4","30.14"
"10","008","00","013","1301","0484","287","230","57","6","293","763","0","38.4","30.14"
"10","008","00","013","1302","0000","528","462","66","36","564","889","0","63.44","51.97"
"10","008","00","013","1302","0485","528","462","66","36","564","889","0","63.44","51.97"
"10","008","00","013","1303","0000","644","519","125","66","710","1119","0","63.45","46.38"
"10","008","00","013","1303","0486","391","315","76","47","438","672","0","65.18","46.88"
"10","008","00","013","1303","0487","253","204","49","19","272","447","0","60.85","45.64"
"10","008","00","013","1304","0000","289","255","34","13","302","409","0","73.84","62.35"
"10","008","00","013","1304","0488","289","255","34","13","302","409","0","73.84","62.35"
"10","008","00","013","1305","0000","345","287","58","37","382","509","0","75.05","56.39"
"10","008","00","013","1305","0477","345","287","58","37","382","509","0","75.05","56.39"
"10","008","00","013","1306","0000","412","350","62","29","441","769","0","57.35","45.51"
"10","008","00","013","1306","0474","227","191","36","20","247","384","0","64.32","49.74"
"10","008","00","013","1306","0475","58","47","11","4","62","121","0","51.24","38.84"
"10","008","00","013","1306","0476","127","112","15","5","132","264","0","50.0","42.42"
"10","008","00","013","1307","0000","160","123","37","2","162","597","0","27.14","20.6"
"10","008","00","013","1307","0473","160","123","37","2","162","597","0","27.14","20.6"
"10","008","00","013","1308","0000","516","423","93","44","560","1151","0","48.65","36.75"
"10","008","00","013","1308","0480","270","229","41","23","293","613","0","47.8","37.36"
"10","008","00","013","1308","0481","174","134","40","16","190","404","0","47.03","33.17"
"10","008","00","013","1308","0482","72","60","12","5","77","134","0","57.46","44.78"
"10","008","00","013","1309","0000","845","726","119","34","879","1665","0","52.79","43.6"
"10","008","00","013","1309","0466","385","337","48","13","398","900","0","44.22","37.44"
"10","008","00","013","1309","0467","281","238","43","17","298","460","0","64.78","51.74"
"10","008","00","013","1309","0468","179","151","28","4","183","305","0","60.0","49.51"
"10","008","00","013","1310","0000","626","518","108","42","668","1269","0","52.64","40.82"
"10","008","00","013","1310","0464","489","402","87","29","518","973","0","53.24","41.32"
"10","008","00","013","1310","0465","137","116","21","13","150","296","0","50.68","39.19"
"10","008","00","013","1311","0000","357","304","53","11","368","952","0","38.66","31.93"
"10","008","00","013","1311","0470","357","304","53","11","368","952","0","38.66","31.93"
"10","008","00","013","1312","0000","233","134","99","4","237","679","0","34.9","19.73"
"10","008","00","013","1312","0471","233","134","99","4","237","679","0","34.9","19.73"
"10","008","00","013","1313","0000","329","244","85","61","390","630","0","61.9","38.73"
"10","008","00","013","1313","0483","329","244","85","61","390","630","0","61.9","38.73"
"10","008","00","013","1314","0000","18","18","0","2","20","58","0","34.48","31.03"
"10","008","00","013","1314","0469","18","18","0","2","20","58","0","34.48","31.03"
"10","008","00","013","1315","0000","271","229","42","28","299","507","0","58.97","45.17"
"10","008","00","013","1315","0478","183","147","36","24","207","338","0","61.24","43.49"
"10","008","00","013","1315","0479","88","82","6","4","92","169","0","54.44","48.52"
"10","008","00","013","1316","0000","317","265","52","52","369","623","0","59.23","42.54"
"10","008","00","013","1316","0472","317","265","52","52","369","623","0","59.23","42.54"
"10","009","00","000","0000","0000","270902","213508","57394","26295","297197","584480","687195","50.85","36.53"
"10","009","00","001","0000","0000","48235","38874","9361","2719","50954","89761","108487","56.77","43.31"
"10","009","00","001","0101","0000","808","635","173","54","862","1415","0","60.92","44.88"
"10","009","00","001","0101","0431","808","635","173","54","862","1415","0","60.92","44.88"
"10","009","00","001","0102","0000","642","491","151","35","677","1101","0","61.49","44.6"
"10","009","00","001","0102","0432","642","491","151","35","677","1101","0","61.49","44.6"
"10","009","00","001","0103","0000","329","266","63","9","338","644","0","52.48","41.3"
"10","009","00","001","0103","0411","329","266","63","9","338","644","0","52.48","41.3"
"10","009","00","001","0104","0000","320","247","73","21","341","617","0","55.27","40.03"
"10","009","00","001","0104","0412","320","247","73","21","341","617","0","55.27","40.03"
"10","009","00","001","0105","0000","471","381","90","30","501","764","0","65.58","49.87"
"10","009","00","001","0105","0413","471","381","90","30","501","764","0","65.58","49.87"
"10","009","00","001","0106","0000","458","336","122","29","487","784","0","62.12","42.86"
"10","009","00","001","0106","0414","458","336","122","29","487","784","0","62.12","42.86"
"10","009","00","001","0107","0000","409","302","107","28","437","760","0","57.5","39.74"
"10","009","00","001","0107","0415","409","302","107","28","437","760","0","57.5","39.74"
"10","009","00","001","0108","0000","2554","2123","431","115","2669","4634","0","57.6","45.81"
"10","009","00","001","0108","0422","824","686","138","21","845","1529","0","55.26","44.87"
"10","009","00","001","0108","0423","747","635","112","40","787","1335","0","58.95","47.57"
"10","009","00","001","0108","0424","983","802","181","54","1037","1770","0","58.59","45.31"
"10","009","00","001","0109","0000","1615","1311","304","63","1678","3236","0","51.85","40.51"
"10","009","00","001","0109","0433","843","668","175","31","874","1648","0","53.03","40.53"
"10","009","00","001","0109","0434","772","643","129","32","804","1588","0","50.63","40.49"
"10","009","00","001","0110","0000","1594","1281","313","92","1686","2765","0","60.98","46.33"
"10","009","00","001","0110","0427","663","524","139","43","706","1193","0","59.18","43.92"
"10","009","00","001","0110","0428","931","757","174","49","980","1572","0","62.34","48.16"
"10","009","00","001","0111","0000","1009","817","192","50","1059","1747","0","60.62","46.77"
"10","009","00","001","0111","0449","1009","817","192","50","1059","1747","0","60.62","46.77"
"10","009","00","001","0112","0000","1880","1524","356","70","1950","3513","0","55.51","43.38"
"10","009","00","001","0112","0444","581","458","123","14","595","1097","0","54.24","41.75"
"10","009","00","001","0112","0445","694","567","127","28","722","1262","0","57.21","44.93"
"10","009","00","001","0112","0446","605","499","106","28","633","1154","0","54.85","43.24"
"10","009","00","001","0113","0000","2288","1840","448","108","2396","4188","0","57.21","43.94"
"10","009","00","001","0113","0439","838","686","152","51","889","1421","0","62.56","48.28"
"10","009","00","001","0113","0440","695","554","141","25","720","1261","0","57.1","43.93"
"10","009","00","001","0113","0441","755","600","155","32","787","1506","0","52.26","39.84"
"10","009","00","001","0114","0000","1098","908","190","56","1154","2329","0","49.55","38.99"
"10","009","00","001","0114","0437","535","455","80","27","562","1187","0","47.35","38.33"
"10","009","00","001","0114","0438","563","453","110","29","592","1142","0","51.84","39.67"
"10","009","00","001","0115","0000","404","313","91","23","427","669","0","63.83","46.79"
"10","009","00","001","0115","0453","404","313","91","23","427","669","0","63.83","46.79"
"10","009","00","001","0116","0000","1132","941","191","55","1187","2202","0","53.91","42.73"
"10","009","00","001","0116","0454","398","326","72","32","430","752","0","57.18","43.35"
"10","009","00","001","0116","0455","734","615","119","23","757","1450","0","52.21","42.41"
"10","009","00","001","0117","0000","282","220","62","37","319","555","0","57.48","39.64"
"10","009","00","001","0117","0456","282","220","62","37","319","555","0","57.48","39.64"
"10","009","00","001","0118","0000","1301","1000","301","82","1383","2414","0","57.29","41.43"
"10","009","00","001","0118","0451","588","400","188","44","632","1112","0","56.83","35.97"
"10","009","00","001","0118","0452","713","600","113","38","751","1302","0","57.68","46.08"
"10","009","00","001","0119","0000","764","628","136","44","808","1418","0","56.98","44.29"
"10","009","00","001","0119","0450","764","628","136","44","808","1418","0","56.98","44.29"
"10","009","00","001","0120","0000","1253","1079","174","76","1329","2397","0","55.44","45.01"
"10","009","00","001","0120","0457","722","599","123","44","766","1470","0","52.11","40.75"
"10","009","00","001","0120","0458","531","480","51","32","563","927","0","60.73","51.78"
"10","009","00","001","0121","0000","834","677","157","72","906","1748","0","51.83","38.73"
"10","009","00","001","0121","0466","834","677","157","72","906","1748","0","51.83","38.73"
"10","009","00","001","0122","0000","2917","2292","625","124","3041","5306","0","57.31","43.2"
"10","009","00","001","0122","0462","796","647","149","45","841","1412","0","59.56","45.82"
"10","009","00","001","0122","0463","801","608","193","28","829","1354","0","61.23","44.9"
"10","009","00","001","0122","0464","667","532","135","25","692","1267","0","54.62","41.99"
"10","009","00","001","0122","0465","653","505","148","26","679","1273","0","53.34","39.67"
"10","009","00","001","0123","0000","2787","2252","535","172","2959","5374","0","55.06","41.91"
"10","009","00","001","0123","0459","1053","873","180","50","1103","1893","0","58.27","46.12"
"10","009","00","001","0123","0460","902","706","196","85","987","1708","0","57.79","41.33"
"10","009","00","001","0123","0461","832","673","159","37","869","1773","0","49.01","37.96"
"10","009","00","001","0124","0000","973","767","206","92","1065","1813","0","58.74","42.31"
"10","009","00","001","0124","0472","386","321","65","38","424","702","0","60.4","45.73"
"10","009","00","001","0124","0473","587","446","141","54","641","1111","0","57.7","40.14"
"10","009","00","001","0125","0000","503","396","107","30","533","1123","0","47.46","35.26"
"10","009","00","001","0125","0474","503","396","107","30","533","1123","0","47.46","35.26"
"10","009","00","001","0126","0000","2355","1872","483","182","2537","4406","0","57.58","42.49"
"10","009","00","001","0126","0467","662","503","159","66","728","1238","0","58.8","40.63"
"10","009","00","001","0126","0468","838","691","147","54","892","1648","0","54.13","41.93"
"10","009","00","001","0126","0469","855","678","177","62","917","1520","0","60.33","44.61"
"10","009","00","001","0127","0000","533","428","105","30","563","1087","0","51.79","39.37"
"10","009","00","001","0127","0470","533","428","105","30","563","1087","0","51.79","39.37"
"10","009","00","001","0128","0000","1015","827","188","58","1073","1904","0","56.36","43.43"
"10","009","00","001","0128","0471","1015","827","188","58","1073","1904","0","56.36","43.43"
"10","009","00","001","0129","0000","1600","1242","358","128","1728","3095","0","55.83","40.13"
"10","009","00","001","0129","0477","538","412","126","42","580","1023","0","56.7","40.27"
"10","009","00","001","0129","0478","1062","830","232","86","1148","2072","0","55.41","40.06"
"10","009","00","001","0130","0000","1446","1175","271","73","1519","2932","0","51.81","40.08"
"10","009","00","001","0130","0475","563","464","99","25","588","1146","0","51.31","40.49"
"10","009","00","001","0130","0476","883","711","172","48","931","1786","0","52.13","39.81"
"10","009","00","001","0131","0000","554","439","115","20","574","1128","0","50.89","38.92"
"10","009","00","001","0131","0479","554","439","115","20","574","1128","0","50.89","38.92"
"10","009","00","001","0132","0000","1406","1185","221","70","1476","2345","0","62.94","50.53"
"10","009","00","001","0132","0418","732","609","123","41","773","1255","0","61.59","48.53"
"10","009","00","001","0132","0419","674","576","98","29","703","1090","0","64.5","52.84"
"10","009","00","001","0133","0000","2019","1622","397","107","2126","3710","0","57.3","43.72"
"10","009","00","001","0133","0416","1075","868","207","59","1134","1881","0","60.29","46.15"
"10","009","00","001","0133","0417","944","754","190","48","992","1829","0","54.24","41.22"
"10","009","00","001","0134","0000","1595","1305","290","62","1657","2814","0","58.88","46.38"
"10","009","00","001","0134","0435","798","656","142","29","827","1392","0","59.41","47.13"
"10","009","00","001","0134","0436","797","649","148","33","830","1422","0","58.37","45.64"
"10","009","00","001","0135","0000","1247","1012","235","83","1330","2286","0","58.18","44.27"
"10","009","00","001","0135","0447","456","374","82","51","507","847","0","59.86","44.16"
"10","009","00","001","0135","0448","791","638","153","32","823","1439","0","57.19","44.34"
"10","009","00","001","0136","0000","1231","1005","226","67","1298","2204","0","58.89","45.6"
"10","009","00","001","0136","0429","527","419","108","27","554","1009","0","54.91","41.53"
"10","009","00","001","0136","0430","704","586","118","40","744","1195","0","62.26","49.04"
"10","009","00","001","0137","0000","1820","1465","355","99","1919","3479","0","55.16","42.11"
"10","009","00","001","0137","0425","715","550","165","29","744","1308","0","56.88","42.05"
"10","009","00","001","0137","0426","1105","915","190","70","1175","2171","0","54.12","42.15"
"10","009","00","001","0138","0000","1487","1198","289","96","1583","2576","0","61.45","46.51"
"10","009","00","001","0138","0442","682","556","126","32","714","1214","0","58.81","45.8"
"10","009","00","001","0138","0443","805","642","163","64","869","1362","0","63.8","47.14"
"10","009","00","001","0139","0000","1302","1072","230","77","1379","2279","0","60.51","47.04"
"10","009","00","001","0139","0420","637","521","116","37","674","1103","0","61.11","47.23"
"10","009","00","001","0139","0421","665","551","114","40","705","1176","0","59.95","46.85"
"10","009","00","002","0000","0000","19876","15804","4072","1529","21405","38138","44608","56.13","41.44"
"10","009","00","002","0201","0000","647","541","106","40","687","1166","0","58.92","46.4"
"10","009","00","002","0201","0498","647","541","106","40","687","1166","0","58.92","46.4"
"10","009","00","002","0202","0000","1230","978","252","59","1289","2110","0","61.09","46.35"
"10","009","00","002","0202","0499","658","518","140","30","688","1135","0","60.62","45.64"
"10","009","00","002","0202","0500","572","460","112","29","601","975","0","61.64","47.18"
"10","009","00","002","0203","0000","1134","931","203","99","1233","2228","0","55.34","41.79"
"10","009","00","002","0203","0503","688","565","123","49","737","1321","0","55.79","42.77"
"10","009","00","002","0203","0504","446","366","80","50","496","907","0","54.69","40.35"
"10","009","00","002","0204","0000","830","674","156","88","918","1473","0","62.32","45.76"
"10","009","00","002","0204","0505","830","674","156","88","918","1473","0","62.32","45.76"
"10","009","00","002","0205","0000","745","564","181","57","802","1277","0","62.8","44.17"
"10","009","00","002","0205","0506","745","564","181","57","802","1277","0","62.8","44.17"
"10","009","00","002","0206","0000","1403","1088","315","97","1500","2673","0","56.12","40.7"
"10","009","00","002","0206","0514","591","453","138","38","629","1042","0","60.36","43.47"
"10","009","00","002","0206","0515","812","635","177","59","871","1631","0","53.4","38.93"
"10","009","00","002","0207","0000","658","506","152","91","749","1333","0","56.19","37.96"
"10","009","00","002","0207","0507","658","506","152","91","749","1333","0","56.19","37.96"
"10","009","00","002","0208","0000","373","305","68","36","409","777","0","52.64","39.25"
"10","009","00","002","0208","0508","373","305","68","36","409","777","0","52.64","39.25"
"10","009","00","002","0209","0000","448","367","81","42","490","899","0","54.51","40.82"
"10","009","00","002","0209","0510","448","367","81","42","490","899","0","54.51","40.82"
"10","009","00","002","0210","0000","278","224","54","37","315","688","0","45.78","32.56"
"10","009","00","002","0210","0511","278","224","54","37","315","688","0","45.78","32.56"
"10","009","00","002","0211","0000","501","417","84","33","534","1147","0","46.56","36.36"
"10","009","00","002","0211","0512","501","417","84","33","534","1147","0","46.56","36.36"
"10","009","00","002","0212","0000","857","646","211","85","942","1709","0","55.12","37.8"
"10","009","00","002","0212","0513","857","646","211","85","942","1709","0","55.12","37.8"
"10","009","00","002","0213","0000","481","382","99","22","503","981","0","51.27","38.94"
"10","009","00","002","0213","0525","481","382","99","22","503","981","0","51.27","38.94"
"10","009","00","002","0214","0000","1336","1057","279","120","1456","2715","0","53.63","38.93"
"10","009","00","002","0214","0526","492","385","107","27","519","1129","0","45.97","34.1"
"10","009","00","002","0214","0527","844","672","172","93","937","1586","0","59.08","42.37"
"10","009","00","002","0215","0000","1188","940","248","26","1214","2227","0","54.51","42.21"
"10","009","00","002","0215","0528","745","591","154","8","753","1243","0","60.58","47.55"
"10","009","00","002","0215","0529","443","349","94","18","461","984","0","46.85","35.47"
"10","009","00","002","0216","0000","1798","1414","384","143","1941","3266","0","59.43","43.29"
"10","009","00","002","0216","0516","949","773","176","80","1029","1702","0","60.46","45.42"
"10","009","00","002","0216","0517","849","641","208","63","912","1564","0","58.31","40.98"
"10","009","00","002","0217","0000","363","302","61","22","385","897","0","42.92","33.67"
"10","009","00","002","0217","0520","363","302","61","22","385","897","0","42.92","33.67"
"10","009","00","002","0218","0000","394","309","85","29","423","803","0","52.68","38.48"
"10","009","00","002","0218","0521","394","309","85","29","423","803","0","52.68","38.48"
"10","009","00","002","0219","0000","454","364","90","50","504","866","0","58.2","42.03"
"10","009","00","002","0219","0522","454","364","90","50","504","866","0","58.2","42.03"
"10","009","00","002","0220","0000","786","628","158","95","881","1523","0","57.85","41.23"
"10","009","00","002","0220","0523","450","355","95","52","502","852","0","58.92","41.67"
"10","009","00","002","0220","0524","336","273","63","43","379","671","0","56.48","40.69"
"10","009","00","002","0221","0000","744","580","164","67","811","1507","0","53.82","38.49"
"10","009","00","002","0221","0530","744","580","164","67","811","1507","0","53.82","38.49"
"10","009","00","002","0222","0000","443","331","112","35","478","877","0","54.5","37.74"
"10","009","00","002","0222","0509","443","331","112","35","478","877","0","54.5","37.74"
"10","009","00","002","0223","0000","1562","1251","311","84","1646","2810","0","58.58","44.52"
"10","009","00","002","0223","0501","812","661","151","42","854","1459","0","58.53","45.31"
"10","009","00","002","0223","0502","750","590","160","42","792","1351","0","58.62","43.67"
"10","009","00","002","0224","0000","1223","1005","218","72","1295","2186","0","59.24","45.97"
"10","009","00","002","0224","0518","403","328","75","23","426","910","0","46.81","36.04"
"10","009","00","002","0224","0519","820","677","143","49","869","1276","0","68.1","53.06"
"10","009","00","003","0000","0000","28411","22521","5890","2061","30472","58167","70892","52.39","38.72"
"10","009","00","003","0301","0000","505","397","108","63","568","941","0","60.36","42.19"
"10","009","00","003","0301","0117","505","397","108","63","568","941","0","60.36","42.19"
"10","009","00","003","0302","0000","794","615","179","69","863","1675","0","51.52","36.72"
"10","009","00","003","0302","0111","398","309","89","27","425","785","0","54.14","39.36"
"10","009","00","003","0302","0112","396","306","90","42","438","890","0","49.21","34.38"
"10","009","00","003","0303","0000","1389","1092","297","94","1483","2605","0","56.93","41.92"
"10","009","00","003","0303","0109","701","559","142","43","744","1347","0","55.23","41.5"
"10","009","00","003","0303","0110","688","533","155","51","739","1258","0","58.74","42.37"
"10","009","00","003","0304","0000","1578","1257","321","98","1676","2844","0","58.93","44.2"
"10","009","00","003","0304","0113","769","606","163","47","816","1413","0","57.75","42.89"
"10","009","00","003","0304","0114","809","651","158","51","860","1431","0","60.1","45.49"
"10","009","00","003","0305","0000","1215","961","254","87","1302","2549","0","51.08","37.7"
"10","009","00","003","0305","0115","610","483","127","50","660","1224","0","53.92","39.46"
"10","009","00","003","0305","0116","605","478","127","37","642","1325","0","48.45","36.08"
"10","009","00","003","0306","0000","1620","1293","327","56","1676","3254","0","51.51","39.74"
"10","009","00","003","0306","0118","835","681","154","21","856","1613","0","53.07","42.22"
"10","009","00","003","0306","0119","785","612","173","35","820","1641","0","49.97","37.29"
"10","009","00","003","0307","0000","810","659","151","46","856","1438","0","59.53","45.83"
"10","009","00","003","0307","0123","810","659","151","46","856","1438","0","59.53","45.83"
"10","009","00","003","0308","0000","2479","1984","495","105","2584","4295","0","60.16","46.19"
"10","009","00","003","0308","0124","755","628","127","32","787","1361","0","57.83","46.14"
"10","009","00","003","0308","0125","831","648","183","37","868","1444","0","60.11","44.88"
"10","009","00","003","0308","0126","893","708","185","36","929","1490","0","62.35","47.52"
"10","009","00","003","0309","0000","1260","983","277","64","1324","2274","0","58.22","43.23"
"10","009","00","003","0309","0127","788","623","165","47","835","1307","0","63.89","47.67"
"10","009","00","003","0309","0128","472","360","112","17","489","967","0","50.57","37.23"
"10","009","00","003","0310","0000","1889","1490","399","92","1981","3745","0","52.9","39.79"
"10","009","00","003","0310","0129","916","745","171","47","963","1865","0","51.64","39.95"
"10","009","00","003","0310","0130","973","745","228","45","1018","1880","0","54.15","39.63"
"10","009","00","003","0311","0000","1001","783","218","53","1054","2000","0","52.7","39.15"
"10","009","00","003","0311","0131","529","414","115","38","567","1099","0","51.59","37.67"
"10","009","00","003","0311","0132","472","369","103","15","487","901","0","54.05","40.95"
"10","009","00","003","0312","0000","518","425","93","47","565","1120","0","50.45","37.95"
"10","009","00","003","0312","0133","518","425","93","47","565","1120","0","50.45","37.95"
"10","009","00","003","0313","0000","562","476","86","74","636","1272","0","50.0","37.42"
"10","009","00","003","0313","0154","562","476","86","74","636","1272","0","50.0","37.42"
"10","009","00","003","0314","0000","360","294","66","31","391","851","0","45.95","34.55"
"10","009","00","003","0314","0153","360","294","66","31","391","851","0","45.95","34.55"
"10","009","00","003","0315","0000","637","492","145","81","718","1549","0","46.35","31.76"
"10","009","00","003","0315","0152","637","492","145","81","718","1549","0","46.35","31.76"
"10","009","00","003","0316","0000","652","537","115","56","708","1509","0","46.92","35.59"
"10","009","00","003","0316","0150","652","537","115","56","708","1509","0","46.92","35.59"
"10","009","00","003","0317","0000","306","211","95","57","363","855","0","42.46","24.68"
"10","009","00","003","0317","0151","306","211","95","57","363","855","0","42.46","24.68"
"10","009","00","003","0318","0000","1258","1006","252","90","1348","2668","0","50.52","37.71"
"10","009","00","003","0318","0135","689","545","144","59","748","1420","0","52.68","38.38"
"10","009","00","003","0318","0136","569","461","108","31","600","1248","0","48.08","36.94"
"10","009","00","003","0319","0000","401","316","85","16","417","799","0","52.19","39.55"
"10","009","00","003","0319","0137","401","316","85","16","417","799","0","52.19","39.55"
"10","009","00","003","0320","0000","802","625","177","92","894","1760","0","50.8","35.51"
"10","009","00","003","0320","0138","398","312","86","48","446","836","0","53.35","37.32"
"10","009","00","003","0320","0139","404","313","91","44","448","924","0","48.48","33.87"
"10","009","00","003","0321","0000","667","511","156","27","694","1648","0","42.11","31.01"
"10","009","00","003","0321","0140","667","511","156","27","694","1648","0","42.11","31.01"
"10","009","00","003","0322","0000","1371","1036","335","149","1520","3162","0","48.07","32.76"
"10","009","00","003","0322","0141","673","508","165","99","772","1616","0","47.77","31.44"
"10","009","00","003","0322","0142","698","528","170","50","748","1546","0","48.38","34.15"
"10","009","00","003","0323","0000","1071","864","207","68","1139","2361","0","48.24","36.59"
"10","009","00","003","0323","0143","591","489","102","34","625","1283","0","48.71","38.11"
"10","009","00","003","0323","0144","480","375","105","34","514","1078","0","47.68","34.79"
"10","009","00","003","0324","0000","1109","874","235","84","1193","2597","0","45.94","33.65"
"10","009","00","003","0324","0145","549","442","107","50","599","1313","0","45.62","33.66"
"10","009","00","003","0324","0146","560","432","128","34","594","1284","0","46.26","33.64"
"10","009","00","003","0325","0000","647","517","130","81","728","1356","0","53.69","38.13"
"10","009","00","003","0325","0147","647","517","130","81","728","1356","0","53.69","38.13"
"10","009","00","003","0326","0000","719","585","134","79","798","1504","0","53.06","38.9"
"10","009","00","003","0326","0148","719","585","134","79","798","1504","0","53.06","38.9"
"10","009","00","003","0327","0000","234","192","42","8","242","545","0","44.4","35.23"
"10","009","00","003","0327","0134","234","192","42","8","242","545","0","44.4","35.23"
"10","009","00","003","0328","0000","2054","1648","406","158","2212","3767","0","58.72","43.75"
"10","009","00","003","0328","0120","698","570","128","45","743","1200","0","61.92","47.5"
"10","009","00","003","0328","0121","678","524","154","78","756","1294","0","58.42","40.49"
"10","009","00","003","0328","0122","678","554","124","35","713","1273","0","56.01","43.52"
"10","009","00","003","0329","0000","503","398","105","36","539","1224","0","44.04","32.52"
"10","009","00","003","0329","0149","503","398","105","36","539","1224","0","44.04","32.52"
"10","009","00","004","0000","0000","18115","14318","3797","1780","19895","38142","46135","52.16","37.54"
"10","009","00","004","0401","0000","636","566","70","60","696","1590","0","43.77","35.6"
"10","009","00","004","0401","0340","636","566","70","60","696","1590","0","43.77","35.6"
"10","009","00","004","0402","0000","899","688","211","85","984","1741","0","56.52","39.52"
"10","009","00","004","0402","0341","899","688","211","85","984","1741","0","56.52","39.52"
"10","009","00","004","0403","0000","1242","1008","234","101","1343","2120","0","63.35","47.55"
"10","009","00","004","0403","0342","644","521","123","53","697","1080","0","64.54","48.24"
"10","009","00","004","0403","0343","598","487","111","48","646","1040","0","62.12","46.83"
"10","009","00","004","0404","0000","1540","1248","292","76","1616","2971","0","54.39","42.01"
"10","009","00","004","0404","0344","712","578","134","28","740","1346","0","54.98","42.94"
"10","009","00","004","0404","0345","828","670","158","48","876","1625","0","53.91","41.23"
"10","009","00","004","0405","0000","207","165","42","11","218","354","0","61.58","46.61"
"10","009","00","004","0405","0346","207","165","42","11","218","354","0","61.58","46.61"
"10","009","00","004","0406","0000","280","220","60","38","318","580","0","54.83","37.93"
"10","009","00","004","0406","0347","280","220","60","38","318","580","0","54.83","37.93"
"10","009","00","004","0407","0000","343","267","76","30","373","591","0","63.11","45.18"
"10","009","00","004","0407","0348","343","267","76","30","373","591","0","63.11","45.18"
"10","009","00","004","0408","0000","567","438","129","52","619","1050","0","58.95","41.71"
"10","009","00","004","0408","0349","567","438","129","52","619","1050","0","58.95","41.71"
"10","009","00","004","0409","0000","1446","1135","311","122","1568","2749","0","57.04","41.29"
"10","009","00","004","0409","0350","649","496","153","57","706","1147","0","61.55","43.24"
"10","009","00","004","0409","0351","797","639","158","65","862","1602","0","53.81","39.89"
"10","009","00","004","0410","0000","2144","1693","451","152","2296","4335","0","52.96","39.05"
"10","009","00","004","0410","0352","705","558","147","50","755","1452","0","52.0","38.43"
"10","009","00","004","0410","0353","813","610","203","81","894","1578","0","56.65","38.66"
"10","009","00","004","0410","0354","626","525","101","21","647","1305","0","49.58","40.23"
"10","009","00","004","0411","0000","561","425","136","36","597","1327","0","44.99","32.03"
"10","009","00","004","0411","0355","561","425","136","36","597","1327","0","44.99","32.03"
"10","009","00","004","0412","0000","728","566","162","51","779","1516","0","51.39","37.34"
"10","009","00","004","0412","0356","728","566","162","51","779","1516","0","51.39","37.34"
"10","009","00","004","0413","0000","472","377","95","59","531","983","0","54.02","38.35"
"10","009","00","004","0413","0369","472","377","95","59","531","983","0","54.02","38.35"
"10","009","00","004","0414","0000","493","390","103","52","545","1014","0","53.75","38.46"
"10","009","00","004","0414","0370","493","390","103","52","545","1014","0","53.75","38.46"
"10","009","00","004","0415","0000","782","622","160","124","906","1805","0","50.19","34.46"
"10","009","00","004","0415","0371","396","316","80","82","478","939","0","50.91","33.65"
"10","009","00","004","0415","0372","386","306","80","42","428","866","0","49.42","35.33"
"10","009","00","004","0416","0000","624","490","134","98","722","1486","0","48.59","32.97"
"10","009","00","004","0416","0373","624","490","134","98","722","1486","0","48.59","32.97"
"10","009","00","004","0417","0000","574","454","120","41","615","1616","0","38.06","28.09"
"10","009","00","004","0417","0357","309","243","66","23","332","828","0","40.1","29.35"
"10","009","00","004","0417","0358","265","211","54","18","283","788","0","35.91","26.78"
"10","009","00","004","0418","0000","383","289","94","67","450","863","0","52.14","33.49"
"10","009","00","004","0418","0359","383","289","94","67","450","863","0","52.14","33.49"
"10","009","00","004","0419","0000","450","343","107","65","515","984","0","52.34","34.86"
"10","009","00","004","0419","0360","450","343","107","65","515","984","0","52.34","34.86"
"10","009","00","004","0420","0000","414","301","113","52","466","870","0","53.56","34.6"
"10","009","00","004","0420","0362","414","301","113","52","466","870","0","53.56","34.6"
"10","009","00","004","0421","0000","675","514","161","138","813","1514","0","53.7","33.95"
"10","009","00","004","0421","0361","675","514","161","138","813","1514","0","53.7","33.95"
"10","009","00","004","0422","0000","465","375","90","51","516","971","0","53.14","38.62"
"10","009","00","004","0422","0363","465","375","90","51","516","971","0","53.14","38.62"
"10","009","00","004","0423","0000","407","329","78","42","449","823","0","54.56","39.98"
"10","009","00","004","0423","0366","407","329","78","42","449","823","0","54.56","39.98"
"10","009","00","004","0424","0000","313","263","50","34","347","726","0","47.8","36.23"
"10","009","00","004","0424","0365","313","263","50","34","347","726","0","47.8","36.23"
"10","009","00","004","0425","0000","531","399","132","51","582","1304","0","44.63","30.6"
"10","009","00","004","0425","0364","531","399","132","51","582","1304","0","44.63","30.6"
"10","009","00","004","0426","0000","330","275","55","16","346","886","0","39.05","31.04"
"10","009","00","004","0426","0367","330","275","55","16","346","886","0","39.05","31.04"
"10","009","00","004","0427","0000","609","478","131","76","685","1373","0","49.89","34.81"
"10","009","00","004","0427","0368","609","478","131","76","685","1373","0","49.89","34.81"
"10","009","00","005","0000","0000","11356","8902","2454","1302","12658","24412","28827","51.85","36.47"
"10","009","00","005","0501","0000","455","354","101","57","512","809","0","63.29","43.76"
"10","009","00","005","0501","0080","455","354","101","57","512","809","0","63.29","43.76"
"10","009","00","005","0502","0000","477","363","114","62","539","896","0","60.16","40.51"
"10","009","00","005","0502","0081","477","363","114","62","539","896","0","60.16","40.51"
"10","009","00","005","0503","0000","800","642","158","68","868","1389","0","62.49","46.22"
"10","009","00","005","0503","0082","361","280","81","37","398","687","0","57.93","40.76"
"10","009","00","005","0503","0083","439","362","77","31","470","702","0","66.95","51.57"
"10","009","00","005","0504","0000","601","491","110","35","636","1032","0","61.63","47.58"
"10","009","00","005","0504","0084","601","491","110","35","636","1032","0","61.63","47.58"
"10","009","00","005","0505","0000","505","400","105","91","596","1124","0","53.02","35.59"
"10","009","00","005","0505","0085","314","243","71","57","371","697","0","53.23","34.86"
"10","009","00","005","0505","0086","191","157","34","34","225","427","0","52.69","36.77"
"10","009","00","005","0506","0000","660","505","155","40","700","1430","0","48.95","35.31"
"10","009","00","005","0506","0089","272","201","71","7","279","634","0","44.01","31.7"
"10","009","00","005","0506","0090","388","304","84","33","421","796","0","52.89","38.19"
"10","009","00","005","0507","0000","555","431","124","63","618","1321","0","46.78","32.63"
"10","009","00","005","0507","0091","285","231","54","45","330","745","0","44.3","31.01"
"10","009","00","005","0507","0092","270","200","70","18","288","576","0","50.0","34.72"
"10","009","00","005","0508","0000","525","418","107","67","592","1277","0","46.36","32.73"
"10","009","00","005","0508","0093","301","243","58","55","356","743","0","47.91","32.71"
"10","009","00","005","0508","0094","224","175","49","12","236","534","0","44.19","32.77"
"10","009","00","005","0509","0000","403","312","91","53","456","843","0","54.09","37.01"
"10","009","00","005","0509","0099","403","312","91","53","456","843","0","54.09","37.01"
"10","009","00","005","0510","0000","1479","1156","323","81","1560","2734","0","57.06","42.28"
"10","009","00","005","0510","0087","787","618","169","55","842","1451","0","58.03","42.59"
"10","009","00","005","0510","0088","692","538","154","26","718","1283","0","55.96","41.93"
"10","009","00","005","0511","0000","823","624","199","125","948","1864","0","50.86","33.48"
"10","009","00","005","0511","0100","410","321","89","75","485","916","0","52.95","35.04"
"10","009","00","005","0511","0101","413","303","110","50","463","948","0","48.84","31.96"
"10","009","00","005","0512","0000","829","672","157","101","930","1774","0","52.42","37.88"
"10","009","00","005","0512","0102","431","340","91","35","466","914","0","50.98","37.2"
"10","009","00","005","0512","0103","398","332","66","66","464","860","0","53.95","38.6"
"10","009","00","005","0513","0000","329","270","59","32","361","896","0","40.29","30.13"
"10","009","00","005","0513","0106","329","270","59","32","361","896","0","40.29","30.13"
"10","009","00","005","0514","0000","778","595","183","110","888","1804","0","49.22","32.98"
"10","009","00","005","0514","0104","412","312","100","59","471","929","0","50.7","33.58"
"10","009","00","005","0514","0105","366","283","83","51","417","875","0","47.66","32.34"
"10","009","00","005","0515","0000","937","724","213","148","1085","2276","0","47.67","31.81"
"10","009","00","005","0515","0095","467","367","100","79","546","1199","0","45.54","30.61"
"10","009","00","005","0515","0096","470","357","113","69","539","1077","0","50.05","33.15"
"10","009","00","005","0516","0000","627","505","122","74","701","1503","0","46.64","33.6"
"10","009","00","005","0516","0097","301","249","52","32","333","819","0","40.66","30.4"
"10","009","00","005","0516","0098","326","256","70","42","368","684","0","53.8","37.43"
"10","009","00","005","0517","0000","573","440","133","95","668","1440","0","46.39","30.56"
"10","009","00","005","0517","0107","289","226","63","52","341","757","0","45.05","29.85"
"10","009","00","005","0517","0108","284","214","70","43","327","683","0","47.88","31.33"
"10","009","00","006","0000","0000","16385","12837","3548","1884","18269","33958","39975","53.8","37.8"
"10","009","00","006","0601","0000","369","285","84","58","427","724","0","58.98","39.36"
"10","009","00","006","0601","0256","369","285","84","58","427","724","0","58.98","39.36"
"10","009","00","006","0602","0000","366","287","79","61","427","688","0","62.06","41.72"
"10","009","00","006","0602","0257","366","287","79","61","427","688","0","62.06","41.72"
"10","009","00","006","0603","0000","225","182","43","41","266","452","0","58.85","40.27"
"10","009","00","006","0603","0258","225","182","43","41","266","452","0","58.85","40.27"
"10","009","00","006","0604","0000","439","334","105","68","507","866","0","58.55","38.57"
"10","009","00","006","0604","0259","439","334","105","68","507","866","0","58.55","38.57"
"10","009","00","006","0605","0000","157","121","36","20","177","336","0","52.68","36.01"
"10","009","00","006","0605","0260","157","121","36","20","177","336","0","52.68","36.01"
"10","009","00","006","0606","0000","187","156","31","30","217","395","0","54.94","39.49"
"10","009","00","006","0606","0261","187","156","31","30","217","395","0","54.94","39.49"
"10","009","00","006","0607","0000","210","172","38","27","237","376","0","63.03","45.74"
"10","009","00","006","0607","0262","210","172","38","27","237","376","0","63.03","45.74"
"10","009","00","006","0608","0000","495","379","116","50","545","950","0","57.37","39.89"
"10","009","00","006","0608","0263","495","379","116","50","545","950","0","57.37","39.89"
"10","009","00","006","0609","0000","276","207","69","44","320","512","0","62.5","40.43"
"10","009","00","006","0609","0264","276","207","69","44","320","512","0","62.5","40.43"
"10","009","00","006","0610","0000","171","135","36","27","198","324","0","61.11","41.67"
"10","009","00","006","0610","0265","171","135","36","27","198","324","0","61.11","41.67"
"10","009","00","006","0611","0000","267","209","58","31","298","546","0","54.58","38.28"
"10","009","00","006","0611","0266","267","209","58","31","298","546","0","54.58","38.28"
"10","009","00","006","0612","0000","606","465","141","83","689","1184","0","58.19","39.27"
"10","009","00","006","0612","0267","236","188","48","22","258","433","0","59.58","43.42"
"10","009","00","006","0612","0268","370","277","93","61","431","751","0","57.39","36.88"
"10","009","00","006","0613","0000","247","196","51","26","273","442","0","61.76","44.34"
"10","009","00","006","0613","0269","247","196","51","26","273","442","0","61.76","44.34"
"10","009","00","006","0614","0000","2518","2004","514","258","2776","4912","0","56.51","40.8"
"10","009","00","006","0614","0270","603","485","118","63","666","1151","0","57.86","42.14"
"10","009","00","006","0614","0271","650","507","143","61","711","1224","0","58.09","41.42"
"10","009","00","006","0614","0272","595","477","118","50","645","1211","0","53.26","39.39"
"10","009","00","006","0614","0273","670","535","135","84","754","1326","0","56.86","40.35"
"10","009","00","006","0615","0000","996","789","207","109","1105","1721","0","64.21","45.85"
"10","009","00","006","0615","0274","431","332","99","47","478","744","0","64.25","44.62"
"10","009","00","006","0615","0275","565","457","108","62","627","977","0","64.18","46.78"
"10","009","00","006","0616","0000","3237","2545","692","283","3520","6230","0","56.5","40.85"
"10","009","00","006","0616","0278","734","591","143","52","786","1364","0","57.62","43.33"
"10","009","00","006","0616","0279","580","468","112","59","639","1123","0","56.9","41.67"
"10","009","00","006","0616","0280","753","589","164","65","818","1451","0","56.37","40.59"
"10","009","00","006","0616","0281","627","496","131","65","692","1162","0","59.55","42.69"
"10","009","00","006","0616","0282","543","401","142","42","585","1130","0","51.77","35.49"
"10","009","00","006","0617","0000","523","407","116","45","568","1149","0","49.43","35.42"
"10","009","00","006","0617","0283","523","407","116","45","568","1149","0","49.43","35.42"
"10","009","00","006","0618","0000","325","254","71","23","348","809","0","43.02","31.4"
"10","009","00","006","0618","0287","325","254","71","23","348","809","0","43.02","31.4"
"10","009","00","006","0619","0000","568","449","119","75","643","1397","0","46.03","32.14"
"10","009","00","006","0619","0288","568","449","119","75","643","1397","0","46.03","32.14"
"10","009","00","006","0620","0000","439","346","93","89","528","1145","0","46.11","30.22"
"10","009","00","006","0620","0289","439","346","93","89","528","1145","0","46.11","30.22"
"10","009","00","006","0621","0000","449","350","99","57","506","966","0","52.38","36.23"
"10","009","00","006","0621","0284","204","160","44","36","240","533","0","45.03","30.02"
"10","009","00","006","0621","0285","245","190","55","21","266","433","0","61.43","43.88"
"10","009","00","006","0622","0000","251","193","58","62","313","828","0","37.8","23.31"
"10","009","00","006","0622","0290","251","193","58","62","313","828","0","37.8","23.31"
"10","009","00","006","0623","0000","198","155","43","22","220","557","0","39.5","27.83"
"10","009","00","006","0623","0291","198","155","43","22","220","557","0","39.5","27.83"
"10","009","00","006","0624","0000","700","523","177","78","778","1637","0","47.53","31.95"
"10","009","00","006","0624","0292","451","338","113","48","499","1060","0","47.08","31.89"
"10","009","00","006","0624","0293","249","185","64","30","279","577","0","48.35","32.06"
"10","009","00","006","0625","0000","1371","1066","305","136","1507","2981","0","50.55","35.76"
"10","009","00","006","0625","0294","344","262","82","66","410","931","0","44.04","28.14"
"10","009","00","006","0625","0295","505","401","104","44","549","1018","0","53.93","39.39"
"10","009","00","006","0625","0296","522","403","119","26","548","1032","0","53.1","39.05"
"10","009","00","006","0626","0000","460","347","113","66","526","960","0","54.79","36.15"
"10","009","00","006","0626","0276","460","347","113","66","526","960","0","54.79","36.15"
"10","009","00","006","0627","0000","166","136","30","6","172","494","0","34.82","27.53"
"10","009","00","006","0627","0277","166","136","30","6","172","494","0","34.82","27.53"
"10","009","00","006","0628","0000","169","145","24","9","178","377","0","47.21","38.46"
"10","009","00","006","0628","0286","169","145","24","9","178","377","0","47.21","38.46"
"10","009","00","007","0000","0000","13078","10321","2757","1145","14223","27477","31464","51.76","37.56"
"10","009","00","007","0701","0000","578","453","125","68","646","1255","0","51.47","36.1"
"10","009","00","007","0701","0539","578","453","125","68","646","1255","0","51.47","36.1"
"10","009","00","007","0702","0000","612","468","144","40","652","1078","0","60.48","43.41"
"10","009","00","007","0702","0540","612","468","144","40","652","1078","0","60.48","43.41"
"10","009","00","007","0703","0000","601","492","109","77","678","1169","0","58.0","42.09"
"10","009","00","007","0703","0538","601","492","109","77","678","1169","0","58.0","42.09"
"10","009","00","007","0704","0000","657","510","147","81","738","1426","0","51.75","35.76"
"10","009","00","007","0704","0536","568","440","128","77","645","1122","0","57.49","39.22"
"10","009","00","007","0704","0537","89","70","19","4","93","304","0","30.59","23.03"
"10","009","00","007","0705","0000","1466","1167","299","95","1561","3074","0","50.78","37.96"
"10","009","00","007","0705","0534","652","525","127","42","694","1302","0","53.3","40.32"
"10","009","00","007","0705","0535","814","642","172","53","867","1772","0","48.93","36.23"
"10","009","00","007","0706","0000","708","538","170","48","756","1517","0","49.84","35.46"
"10","009","00","007","0706","0533","708","538","170","48","756","1517","0","49.84","35.46"
"10","009","00","007","0707","0000","1028","828","200","107","1135","2120","0","53.54","39.06"
"10","009","00","007","0707","0531","553","435","118","61","614","1126","0","54.53","38.63"
"10","009","00","007","0707","0532","475","393","82","46","521","994","0","52.41","39.54"
"10","009","00","007","0708","0000","256","204","52","10","266","734","0","36.24","27.79"
"10","009","00","007","0708","0554","256","204","52","10","266","734","0","36.24","27.79"
"10","009","00","007","0709","0000","102","77","25","4","106","285","0","37.19","27.02"
"10","009","00","007","0709","0553","102","77","25","4","106","285","0","37.19","27.02"
"10","009","00","007","0710","0000","1054","837","217","88","1142","2138","0","53.41","39.15"
"10","009","00","007","0710","0547","446","356","90","45","491","998","0","49.2","35.67"
"10","009","00","007","0710","0548","608","481","127","43","651","1140","0","57.11","42.19"
"10","009","00","007","0711","0000","549","431","118","84","633","1150","0","55.04","37.48"
"10","009","00","007","0711","0555","549","431","118","84","633","1150","0","55.04","37.48"
"10","009","00","007","0712","0000","562","372","190","17","579","1233","0","46.96","30.17"
"10","009","00","007","0712","0552","562","372","190","17","579","1233","0","46.96","30.17"
"10","009","00","007","0713","0000","211","160","51","19","230","453","0","50.77","35.32"
"10","009","00","007","0713","0556","211","160","51","19","230","453","0","50.77","35.32"
"10","009","00","007","0714","0000","246","195","51","31","277","571","0","48.51","34.15"
"10","009","00","007","0714","0557","246","195","51","31","277","571","0","48.51","34.15"
"10","009","00","007","0715","0000","1018","802","216","68","1086","2058","0","52.77","38.97"
"10","009","00","007","0715","0549","541","427","114","48","589","1102","0","53.45","38.75"
"10","009","00","007","0715","0550","477","375","102","20","497","956","0","51.99","39.23"
"10","009","00","007","0716","0000","339","258","81","25","364","695","0","52.37","37.12"
"10","009","00","007","0716","0551","339","258","81","25","364","695","0","52.37","37.12"
"10","009","00","007","0717","0000","1019","825","194","90","1109","2243","0","49.44","36.78"
"10","009","00","007","0717","0541","415","345","70","24","439","943","0","46.55","36.59"
"10","009","00","007","0717","0542","604","480","124","66","670","1300","0","51.54","36.92"
"10","009","00","007","0718","0000","1002","809","193","92","1094","2108","0","51.9","38.38"
"10","009","00","007","0718","0543","432","348","84","46","478","964","0","49.59","36.1"
"10","009","00","007","0718","0544","570","461","109","46","616","1144","0","53.85","40.3"
"10","009","00","007","0719","0000","722","601","121","64","786","1482","0","53.04","40.55"
"10","009","00","007","0719","0545","722","601","121","64","786","1482","0","53.04","40.55"
"10","009","00","007","0720","0000","348","294","54","37","385","688","0","55.96","42.73"
"10","009","00","007","0720","0546","348","294","54","37","385","688","0","55.96","42.73"
"10","009","00","008","0000","0000","7639","5988","1651","738","8377","16509","19083","50.74","36.27"
"10","009","00","008","0801","0000","369","301","68","34","403","750","0","53.73","40.13"
"10","009","00","008","0801","0480","369","301","68","34","403","750","0","53.73","40.13"
"10","009","00","008","0802","0000","1025","802","223","102","1127","2095","0","53.79","38.28"
"10","009","00","008","0802","0484","700","547","153","71","771","1495","0","51.57","36.59"
"10","009","00","008","0802","0485","325","255","70","31","356","600","0","59.33","42.5"
"10","009","00","008","0803","0000","542","422","120","47","589","1004","0","58.67","42.03"
"10","009","00","008","0803","0486","542","422","120","47","589","1004","0","58.67","42.03"
"10","009","00","008","0804","0000","343","259","84","19","362","948","0","38.19","27.32"
"10","009","00","008","0804","0487","343","259","84","19","362","948","0","38.19","27.32"
"10","009","00","008","0805","0000","826","666","160","93","919","1895","0","48.5","35.15"
"10","009","00","008","0805","0489","623","509","114","63","686","1430","0","47.97","35.59"
"10","009","00","008","0805","0490","203","157","46","30","233","465","0","50.11","33.76"
"10","009","00","008","0806","0000","811","650","161","73","884","1781","0","49.64","36.5"
"10","009","00","008","0806","0491","594","487","107","50","644","1307","0","49.27","37.26"
"10","009","00","008","0806","0492","217","163","54","23","240","474","0","50.63","34.39"
"10","009","00","008","0807","0000","772","634","138","59","831","1539","0","54.0","41.2"
"10","009","00","008","0807","0488","772","634","138","59","831","1539","0","54.0","41.2"
"10","009","00","008","0808","0000","648","492","156","81","729","1220","0","59.75","40.33"
"10","009","00","008","0808","0493","648","492","156","81","729","1220","0","59.75","40.33"
"10","009","00","008","0809","0000","325","247","78","25","350","719","0","48.68","34.35"
"10","009","00","008","0809","0481","325","247","78","25","350","719","0","48.68","34.35"
"10","009","00","008","0810","0000","292","237","55","20","312","603","0","51.74","39.3"
"10","009","00","008","0810","0482","292","237","55","20","312","603","0","51.74","39.3"
"10","009","00","008","0811","0000","463","331","132","56","519","1106","0","46.93","29.93"
"10","009","00","008","0811","0483","463","331","132","56","519","1106","0","46.93","29.93"
"10","009","00","008","0812","0000","324","257","67","19","343","733","0","46.79","35.06"
"10","009","00","008","0812","0494","324","257","67","19","343","733","0","46.79","35.06"
"10","009","00","008","0813","0000","331","268","63","34","365","681","0","53.6","39.35"
"10","009","00","008","0813","0495","331","268","63","34","365","681","0","53.6","39.35"
"10","009","00","008","0814","0000","267","211","56","29","296","712","0","41.57","29.63"
"10","009","00","008","0814","0496","267","211","56","29","296","712","0","41.57","29.63"
"10","009","00","008","0815","0000","301","211","90","47","348","723","0","48.13","29.18"
"10","009","00","008","0815","0497","301","211","90","47","348","723","0","48.13","29.18"
"10","009","00","009","0000","0000","12031","9304","2727","1428","13459","24570","28727","54.78","37.87"
"10","009","00","009","0901","0000","2105","1619","486","204","2309","4079","0","56.61","39.69"
"10","009","00","009","0901","0374","771","576","195","79","850","1507","0","56.4","38.22"
"10","009","00","009","0901","0375","654","528","126","42","696","1300","0","53.54","40.62"
"10","009","00","009","0901","0376","680","515","165","83","763","1272","0","59.98","40.49"
"10","009","00","009","0902","0000","396","294","102","62","458","861","0","53.19","34.15"
"10","009","00","009","0902","0377","396","294","102","62","458","861","0","53.19","34.15"
"10","009","00","009","0903","0000","667","521","146","65","732","1565","0","46.77","33.29"
"10","009","00","009","0903","0378","667","521","146","65","732","1565","0","46.77","33.29"
"10","009","00","009","0904","0000","514","378","136","64","578","1213","0","47.65","31.16"
"10","009","00","009","0904","0379","257","199","58","20","277","577","0","48.01","34.49"
"10","009","00","009","0904","0380","257","179","78","44","301","636","0","47.33","28.14"
"10","009","00","009","0905","0000","495","379","116","78","573","1110","0","51.62","34.14"
"10","009","00","009","0905","0381","495","379","116","78","573","1110","0","51.62","34.14"
"10","009","00","009","0906","0000","1004","772","232","132","1136","1958","0","58.02","39.43"
"10","009","00","009","0906","0382","522","400","122","65","587","973","0","60.33","41.11"
"10","009","00","009","0906","0383","482","372","110","67","549","985","0","55.74","37.77"
"10","009","00","009","0907","0000","1547","1190","357","192","1739","2991","0","58.14","39.79"
"10","009","00","009","0907","0384","907","694","213","103","1010","1707","0","59.17","40.66"
"10","009","00","009","0907","0385","640","496","144","89","729","1284","0","56.78","38.63"
"10","009","00","009","0908","0000","664","496","168","72","736","1293","0","56.92","38.36"
"10","009","00","009","0908","0386","664","496","168","72","736","1293","0","56.92","38.36"
"10","009","00","009","0909","0000","553","443","110","29","582","1165","0","49.96","38.03"
"10","009","00","009","0909","0389","553","443","110","29","582","1165","0","49.96","38.03"
"10","009","00","009","0910","0000","973","767","206","156","1129","1940","0","58.2","39.54"
"10","009","00","009","0910","0387","452","360","92","58","510","900","0","56.67","40.0"
"10","009","00","009","0910","0388","521","407","114","98","619","1040","0","59.52","39.13"
"10","009","00","009","0911","0000","921","724","197","106","1027","1756","0","58.49","41.23"
"10","009","00","009","0911","0390","435","333","102","57","492","871","0","56.49","38.23"
"10","009","00","009","0911","0391","486","391","95","49","535","885","0","60.45","44.18"
"10","009","00","009","0912","0000","659","510","149","71","730","1489","0","49.03","34.25"
"10","009","00","009","0912","0392","659","510","149","71","730","1489","0","49.03","34.25"
"10","009","00","009","0913","0000","584","467","117","92","676","1347","0","50.19","34.67"
"10","009","00","009","0913","0393","584","467","117","92","676","1347","0","50.19","34.67"
"10","009","00","009","0914","0000","949","744","205","105","1054","1803","0","58.46","41.26"
"10","009","00","009","0914","0394","603","465","138","64","667","1150","0","58.0","40.43"
"10","009","00","009","0914","0395","346","279","67","41","387","653","0","59.26","42.73"
"10","009","00","010","0000","0000","7803","6202","1601","942","8745","15551","18089","56.23","39.88"
"10","009","00","010","1001","0000","597","466","131","58","655","1036","0","63.22","44.98"
"10","009","00","010","1001","0396","597","466","131","58","655","1036","0","63.22","44.98"
"10","009","00","010","1002","0000","1766","1429","337","226","1992","3652","0","54.55","39.13"
"10","009","00","010","1002","0397","749","612","137","87","836","1490","0","56.11","41.07"
"10","009","00","010","1002","0398","720","577","143","83","803","1491","0","53.86","38.7"
"10","009","00","010","1002","0399","297","240","57","56","353","671","0","52.61","35.77"
"10","009","00","010","1003","0000","1144","919","225","161","1305","2187","0","59.67","42.02"
"10","009","00","010","1003","0400","754","606","148","109","863","1436","0","60.1","42.2"
"10","009","00","010","1003","0401","390","313","77","52","442","751","0","58.85","41.68"
"10","009","00","010","1004","0000","269","206","63","24","293","535","0","54.77","38.5"
"10","009","00","010","1004","0402","269","206","63","24","293","535","0","54.77","38.5"
"10","009","00","010","1005","0000","344","280","64","43","387","811","0","47.72","34.53"
"10","009","00","010","1005","0403","344","280","64","43","387","811","0","47.72","34.53"
"10","009","00","010","1006","0000","1305","1046","259","160","1465","2625","0","55.81","39.85"
"10","009","00","010","1006","0404","681","536","145","85","766","1339","0","57.21","40.03"
"10","009","00","010","1006","0405","624","510","114","75","699","1286","0","54.35","39.66"
"10","009","00","010","1007","0000","319","242","77","36","355","646","0","54.95","37.46"
"10","009","00","010","1007","0406","319","242","77","36","355","646","0","54.95","37.46"
"10","009","00","010","1008","0000","572","443","129","78","650","1158","0","56.13","38.26"
"10","009","00","010","1008","0407","572","443","129","78","650","1158","0","56.13","38.26"
"10","009","00","010","1009","0000","559","448","111","56","615","1090","0","56.42","41.1"
"10","009","00","010","1009","0408","559","448","111","56","615","1090","0","56.42","41.1"
"10","009","00","010","1010","0000","928","723","205","100","1028","1811","0","56.76","39.92"
"10","009","00","010","1010","0409","512","403","109","69","581","950","0","61.16","42.42"
"10","009","00","010","1010","0410","416","320","96","31","447","861","0","51.92","37.17"
"10","009","00","011","0000","0000","9684","7403","2281","1247","10931","23367","26906","46.78","31.68"
"10","009","00","011","1101","0000","607","468","139","37","644","1463","0","44.02","31.99"
"10","009","00","011","1101","0317","607","468","139","37","644","1463","0","44.02","31.99"
"10","009","00","011","1102","0000","724","549","175","52","776","1738","0","44.65","31.59"
"10","009","00","011","1102","0318","724","549","175","52","776","1738","0","44.65","31.59"
"10","009","00","011","1103","0000","677","537","140","118","795","1643","0","48.39","32.68"
"10","009","00","011","1103","0319","244","187","57","51","295","625","0","47.2","29.92"
"10","009","00","011","1103","0320","433","350","83","67","500","1018","0","49.12","34.38"
"10","009","00","011","1104","0000","511","400","111","42","553","1496","0","36.97","26.74"
"10","009","00","011","1104","0321","152","122","30","4","156","448","0","34.82","27.23"
"10","009","00","011","1104","0322","359","278","81","38","397","1048","0","37.88","26.53"
"10","009","00","011","1105","0000","558","426","132","74","632","1161","0","54.44","36.69"
"10","009","00","011","1105","0323","558","426","132","74","632","1161","0","54.44","36.69"
"10","009","00","011","1106","0000","896","680","216","108","1004","1840","0","54.57","36.96"
"10","009","00","011","1106","0324","463","349","114","43","506","991","0","51.06","35.22"
"10","009","00","011","1106","0325","433","331","102","65","498","849","0","58.66","38.99"
"10","009","00","011","1107","0000","398","306","92","52","450","890","0","50.56","34.38"
"10","009","00","011","1107","0326","398","306","92","52","450","890","0","50.56","34.38"
"10","009","00","011","1108","0000","383","291","92","32","415","891","0","46.58","32.66"
"10","009","00","011","1108","0328","383","291","92","32","415","891","0","46.58","32.66"
"10","009","00","011","1109","0000","287","220","67","28","315","757","0","41.61","29.06"
"10","009","00","011","1109","0329","287","220","67","28","315","757","0","41.61","29.06"
"10","009","00","011","1110","0000","623","472","151","103","726","1497","0","48.5","31.53"
"10","009","00","011","1110","0330","623","472","151","103","726","1497","0","48.5","31.53"
"10","009","00","011","1111","0000","836","614","222","122","958","1857","0","51.59","33.06"
"10","009","00","011","1111","0331","486","349","137","69","555","1171","0","47.4","29.8"
"10","009","00","011","1111","0332","350","265","85","53","403","686","0","58.75","38.63"
"10","009","00","011","1112","0000","294","226","68","92","386","864","0","44.68","26.16"
"10","009","00","011","1112","0333","294","226","68","92","386","864","0","44.68","26.16"
"10","009","00","011","1113","0000","800","626","174","89","889","1769","0","50.25","35.39"
"10","009","00","011","1113","0334","548","423","125","67","615","1073","0","57.32","39.42"
"10","009","00","011","1113","0335","252","203","49","22","274","696","0","39.37","29.17"
"10","009","00","011","1114","0000","391","311","80","53","444","1271","0","34.93","24.47"
"10","009","00","011","1114","0336","391","311","80","53","444","1271","0","34.93","24.47"
"10","009","00","011","1115","0000","354","261","93","53","407","912","0","44.63","28.62"
"10","009","00","011","1115","0337","354","261","93","53","407","912","0","44.63","28.62"
"10","009","00","011","1116","0000","341","243","98","35","376","861","0","43.67","28.22"
"10","009","00","011","1116","0338","341","243","98","35","376","861","0","43.67","28.22"
"10","009","00","011","1117","0000","393","291","102","59","452","1030","0","43.88","28.25"
"10","009","00","011","1117","0339","393","291","102","59","452","1030","0","43.88","28.25"
"10","009","00","011","1118","0000","611","482","129","98","709","1427","0","49.68","33.78"
"10","009","00","011","1118","0327","611","482","129","98","709","1427","0","49.68","33.78"
"10","009","00","012","0000","0000","9031","6925","2106","970","10001","21050","24427","47.51","32.9"
"10","009","00","012","1201","0000","585","456","129","69","654","1176","0","55.61","38.78"
"10","009","00","012","1201","0297","585","456","129","69","654","1176","0","55.61","38.78"
"10","009","00","012","1202","0000","650","500","150","43","693","1439","0","48.16","34.75"
"10","009","00","012","1202","0298","650","500","150","43","693","1439","0","48.16","34.75"
"10","009","00","012","1203","0000","1182","961","221","106","1288","2286","0","56.34","42.04"
"10","009","00","012","1203","0299","538","442","96","60","598","1027","0","58.23","43.04"
"10","009","00","012","1203","0300","644","519","125","46","690","1259","0","54.81","41.22"
"10","009","00","012","1204","0000","907","695","212","60","967","2056","0","47.03","33.8"
"10","009","00","012","1204","0301","489","375","114","31","520","1058","0","49.15","35.44"
"10","009","00","012","1204","0302","418","320","98","29","447","998","0","44.79","32.06"
"10","009","00","012","1205","0000","917","705","212","83","1000","2023","0","49.43","34.85"
"10","009","00","012","1205","0303","413","321","92","36","449","968","0","46.38","33.16"
"10","009","00","012","1205","0304","504","384","120","47","551","1055","0","52.23","36.4"
"10","009","00","012","1206","0000","551","401","150","69","620","1315","0","47.15","30.49"
"10","009","00","012","1206","0305","551","401","150","69","620","1315","0","47.15","30.49"
"10","009","00","012","1207","0000","800","613","187","109","909","2024","0","44.91","30.29"
"10","009","00","012","1207","0306","295","220","75","27","322","1027","0","31.35","21.42"
"10","009","00","012","1207","0307","505","393","112","82","587","997","0","58.88","39.42"
"10","009","00","012","1208","0000","389","261","128","35","424","807","0","52.54","32.34"
"10","009","00","012","1208","0308","389","261","128","35","424","807","0","52.54","32.34"
"10","009","00","012","1209","0000","583","409","174","67","650","1502","0","43.28","27.23"
"10","009","00","012","1209","0309","266","189","77","18","284","698","0","40.69","27.08"
"10","009","00","012","1209","0310","317","220","97","49","366","804","0","45.52","27.36"
"10","009","00","012","1210","0000","680","535","145","66","746","1753","0","42.56","30.52"
"10","009","00","012","1210","0311","367","274","93","40","407","867","0","46.94","31.6"
"10","009","00","012","1210","0312","313","261","52","26","339","886","0","38.26","29.46"
"10","009","00","012","1211","0000","520","399","121","91","611","1476","0","41.4","27.03"
"10","009","00","012","1211","0313","520","399","121","91","611","1476","0","41.4","27.03"
"10","009","00","012","1212","0000","331","263","68","43","374","1159","0","32.27","22.69"
"10","009","00","012","1212","0314","331","263","68","43","374","1159","0","32.27","22.69"
"10","009","00","012","1213","0000","562","432","130","98","660","1220","0","54.1","35.41"
"10","009","00","012","1213","0315","562","432","130","98","660","1220","0","54.1","35.41"
"10","009","00","012","1214","0000","374","295","79","31","405","814","0","49.75","36.24"
"10","009","00","012","1214","0316","374","295","79","31","405","814","0","49.75","36.24"
"10","009","00","013","0000","0000","16196","12437","3759","1781","17977","37119","46004","48.43","33.51"
"10","009","00","013","1301","0000","1715","1323","392","198","1913","4029","0","47.48","32.84"
"10","009","00","013","1301","0005","539","421","118","67","606","1340","0","45.22","31.42"
"10","009","00","013","1301","0006","481","364","117","70","551","1138","0","48.42","31.99"
"10","009","00","013","1301","0007","695","538","157","61","756","1551","0","48.74","34.69"
"10","009","00","013","1302","0000","3023","2304","719","272","3295","6988","0","47.15","32.97"
"10","009","00","013","1302","0001","569","438","131","68","637","1497","0","42.55","29.26"
"10","009","00","013","1302","0002","816","619","197","56","872","1738","0","50.17","35.62"
"10","009","00","013","1302","0003","873","655","218","84","957","1921","0","49.82","34.1"
"10","009","00","013","1302","0004","765","592","173","64","829","1832","0","45.25","32.31"
"10","009","00","013","1303","0000","711","515","196","90","801","1909","0","41.96","26.98"
"10","009","00","013","1303","0008","269","191","78","42","311","715","0","43.5","26.71"
"10","009","00","013","1303","0009","442","324","118","48","490","1194","0","41.04","27.14"
"10","009","00","013","1304","0000","974","755","219","102","1076","2581","0","41.69","29.25"
"10","009","00","013","1304","0010","432","326","106","57","489","1023","0","47.8","31.87"
"10","009","00","013","1304","0011","542","429","113","45","587","1558","0","37.68","27.54"
"10","009","00","013","1305","0000","1163","930","233","125","1288","2559","0","50.33","36.34"
"10","009","00","013","1305","0019","550","454","96","70","620","1230","0","50.41","36.91"
"10","009","00","013","1305","0020","613","476","137","55","668","1329","0","50.26","35.82"
"10","009","00","013","1306","0000","1260","951","309","162","1422","2959","0","48.06","32.14"
"10","009","00","013","1306","0014","592","445","147","74","666","1363","0","48.86","32.65"
"10","009","00","013","1306","0015","668","506","162","88","756","1596","0","47.37","31.7"
"10","009","00","013","1307","0000","829","592","237","66","895","2170","0","41.24","27.28"
"10","009","00","013","1307","0012","441","304","137","34","475","1187","0","40.02","25.61"
"10","009","00","013","1307","0013","388","288","100","32","420","983","0","42.73","29.3"
"10","009","00","013","1308","0000","749","592","157","99","848","2002","0","42.36","29.57"
"10","009","00","013","1308","0017","371","288","83","48","419","964","0","43.46","29.88"
"10","009","00","013","1308","0018","378","304","74","51","429","1038","0","41.33","29.29"
"10","009","00","013","1309","0000","1827","1426","401","266","2093","3841","0","54.49","37.13"
"10","009","00","013","1309","0021","515","385","130","87","602","1129","0","53.32","34.1"
"10","009","00","013","1309","0022","599","470","129","86","685","1241","0","55.2","37.87"
"10","009","00","013","1309","0023","713","571","142","93","806","1471","0","54.79","38.82"
"10","009","00","013","1310","0000","557","428","129","69","626","1107","0","56.55","38.66"
"10","009","00","013","1310","0024","557","428","129","69","626","1107","0","56.55","38.66"
"10","009","00","013","1311","0000","1603","1206","397","141","1744","3391","0","51.43","35.56"
"10","009","00","013","1311","0025","838","607","231","79","917","1636","0","56.05","37.1"
"10","009","00","013","1311","0026","765","599","166","62","827","1755","0","47.12","34.13"
"10","009","00","013","1312","0000","1032","811","221","82","1114","2114","0","52.7","38.36"
"10","009","00","013","1312","0027","557","434","123","43","600","1158","0","51.81","37.48"
"10","009","00","013","1312","0028","475","377","98","39","514","956","0","53.77","39.44"
"10","009","00","013","1313","0000","753","604","149","109","862","1469","0","58.68","41.12"
"10","009","00","013","1313","0016","753","604","149","109","862","1469","0","58.68","41.12"
"10","009","00","014","0000","0000","5723","4542","1181","742","6465","13239","14845","48.83","34.31"
"10","009","00","014","1401","0000","793","625","168","75","868","1533","0","56.62","40.77"
"10","009","00","014","1401","0055","793","625","168","75","868","1533","0","56.62","40.77"
"10","009","00","014","1402","0000","622","488","134","92","714","1203","0","59.35","40.57"
"10","009","00","014","1402","0056","622","488","134","92","714","1203","0","59.35","40.57"
"10","009","00","014","1403","0000","687","539","148","77","764","1624","0","47.04","33.19"
"10","009","00","014","1403","0053","341","259","82","30","371","896","0","41.41","28.91"
"10","009","00","014","1403","0054","346","280","66","47","393","728","0","53.98","38.46"
"10","009","00","014","1404","0000","298","247","51","28","326","540","0","60.37","45.74"
"10","009","00","014","1404","0052","298","247","51","28","326","540","0","60.37","45.74"
"10","009","00","014","1405","0000","483","384","99","53","536","1207","0","44.41","31.81"
"10","009","00","014","1405","0051","483","384","99","53","536","1207","0","44.41","31.81"
"10","009","00","014","1406","0000","291","241","50","34","325","546","0","59.52","44.14"
"10","009","00","014","1406","0058","291","241","50","34","325","546","0","59.52","44.14"
"10","009","00","014","1407","0000","334","251","83","57","391","817","0","47.86","30.72"
"10","009","00","014","1407","0057","334","251","83","57","391","817","0","47.86","30.72"
"10","009","00","014","1408","0000","294","215","79","65","359","856","0","41.94","25.12"
"10","009","00","014","1408","0060","294","215","79","65","359","856","0","41.94","25.12"
"10","009","00","014","1409","0000","368","285","83","70","438","853","0","51.35","33.41"
"10","009","00","014","1409","0059","368","285","83","70","438","853","0","51.35","33.41"
"10","009","00","014","1410","0000","828","662","166","110","938","1945","0","48.23","34.04"
"10","009","00","014","1410","0061","390","310","80","56","446","923","0","48.32","33.59"
"10","009","00","014","1410","0062","438","352","86","54","492","1022","0","48.14","34.44"
"10","009","00","014","1411","0000","367","304","63","38","405","1087","0","37.26","27.97"
"10","009","00","014","1411","0065","367","304","63","38","405","1087","0","37.26","27.97"
"10","009","00","014","1412","0000","358","301","57","43","401","1028","0","39.01","29.28"
"10","009","00","014","1412","0063","218","183","35","22","240","634","0","37.85","28.86"
"10","009","00","014","1412","0064","140","118","22","21","161","394","0","40.86","29.95"
"10","009","00","015","0000","0000","5196","4069","1127","511","5707","11381","12992","50.14","35.75"
"10","009","00","015","1501","0000","985","793","192","109","1094","1916","0","57.1","41.39"
"10","009","00","015","1501","0066","448","363","85","62","510","923","0","55.25","39.33"
"10","009","00","015","1501","0067","537","430","107","47","584","993","0","58.81","43.3"
"10","009","00","015","1502","0000","684","537","147","50","734","1450","0","50.62","37.03"
"10","009","00","015","1502","0068","361","280","81","30","391","748","0","52.27","37.43"
"10","009","00","015","1502","0069","323","257","66","20","343","702","0","48.86","36.61"
"10","009","00","015","1503","0000","710","571","139","50","760","1508","0","50.4","37.86"
"10","009","00","015","1503","0070","334","269","65","22","356","752","0","47.34","35.77"
"10","009","00","015","1503","0071","376","302","74","28","404","756","0","53.44","39.95"
"10","009","00","015","1504","0000","557","436","121","48","605","1207","0","50.12","36.12"
"10","009","00","015","1504","0074","209","170","39","22","231","470","0","49.15","36.17"
"10","009","00","015","1504","0075","348","266","82","26","374","737","0","50.75","36.09"
"10","009","00","015","1505","0000","639","493","146","46","685","1524","0","44.95","32.35"
"10","009","00","015","1505","0072","238","186","52","14","252","490","0","51.43","37.96"
"10","009","00","015","1505","0073","401","307","94","32","433","1034","0","41.88","29.69"
"10","009","00","015","1506","0000","408","326","82","31","439","878","0","50.0","37.13"
"10","009","00","015","1506","0076","408","326","82","31","439","878","0","50.0","37.13"
"10","009","00","015","1507","0000","338","261","77","52","390","778","0","50.13","33.55"
"10","009","00","015","1507","0077","338","261","77","52","390","778","0","50.13","33.55"
"10","009","00","015","1508","0000","519","400","119","63","582","1224","0","47.55","32.68"
"10","009","00","015","1508","0078","519","400","119","63","582","1224","0","47.55","32.68"
"10","009","00","015","1509","0000","356","252","104","62","418","896","0","46.65","28.13"
"10","009","00","015","1509","0079","356","252","104","62","418","896","0","46.65","28.13"
"10","009","00","016","0000","0000","8407","6679","1728","1093","9500","21125","23824","44.97","31.62"
"10","009","00","016","1601","0000","612","521","91","65","677","1238","0","54.68","42.08"
"10","009","00","016","1601","0029","612","521","91","65","677","1238","0","54.68","42.08"
"10","009","00","016","1602","0000","510","401","109","67","577","1098","0","52.55","36.52"
"10","009","00","016","1602","0031","510","401","109","67","577","1098","0","52.55","36.52"
"10","009","00","016","1603","0000","473","378","95","49","522","1091","0","47.85","34.65"
"10","009","00","016","1603","0030","473","378","95","49","522","1091","0","47.85","34.65"
"10","009","00","016","1604","0000","823","656","167","106","929","2073","0","44.81","31.64"
"10","009","00","016","1604","0032","395","309","86","42","437","1048","0","41.7","29.48"
"10","009","00","016","1604","0033","428","347","81","64","492","1025","0","48.0","33.85"
"10","009","00","016","1605","0000","556","413","143","85","641","1460","0","43.9","28.29"
"10","009","00","016","1605","0035","556","413","143","85","641","1460","0","43.9","28.29"
"10","009","00","016","1606","0000","564","439","125","108","672","1890","0","35.56","23.23"
"10","009","00","016","1606","0036","364","273","91","73","437","1180","0","37.03","23.14"
"10","009","00","016","1606","0037","200","166","34","35","235","710","0","33.1","23.38"
"10","009","00","016","1607","0000","201","160","41","11","212","620","0","34.19","25.81"
"10","009","00","016","1607","0038","201","160","41","11","212","620","0","34.19","25.81"
"10","009","00","016","1608","0000","234","184","50","43","277","687","0","40.32","26.78"
"10","009","00","016","1608","0040","234","184","50","43","277","687","0","40.32","26.78"
"10","009","00","016","1609","0000","184","150","34","29","213","449","0","47.44","33.41"
"10","009","00","016","1609","0039","184","150","34","29","213","449","0","47.44","33.41"
"10","009","00","016","1610","0000","375","304","71","57","432","850","0","50.82","35.76"
"10","009","00","016","1610","0034","375","304","71","57","432","850","0","50.82","35.76"
"10","009","00","016","1611","0000","667","526","141","78","745","1514","0","49.21","34.74"
"10","009","00","016","1611","0043","477","370","107","49","526","1042","0","50.48","35.51"
"10","009","00","016","1611","0044","190","156","34","29","219","472","0","46.4","33.05"
"10","009","00","016","1612","0000","517","416","101","27","544","1409","0","38.61","29.52"
"10","009","00","016","1612","0045","517","416","101","27","544","1409","0","38.61","29.52"
"10","009","00","016","1613","0000","1243","964","279","207","1450","3067","0","47.28","31.43"
"10","009","00","016","1613","0046","471","375","96","90","561","1061","0","52.87","35.34"
"10","009","00","016","1613","0047","359","281","78","38","397","993","0","39.98","28.3"
"10","009","00","016","1613","0048","413","308","105","79","492","1013","0","48.57","30.4"
"10","009","00","016","1614","0000","774","616","158","72","846","1849","0","45.75","33.32"
"10","009","00","016","1614","0049","534","418","116","48","582","1233","0","47.2","33.9"
"10","009","00","016","1614","0050","240","198","42","24","264","616","0","42.86","32.14"
"10","009","00","016","1615","0000","674","551","123","89","763","1830","0","41.69","30.11"
"10","009","00","016","1615","0041","490","391","99","67","557","1247","0","44.67","31.36"
"10","009","00","016","1615","0042","184","160","24","22","206","583","0","35.33","27.44"
"10","009","00","017","0000","0000","8511","6583","1928","1043","9554","22830","25784","41.85","28.83"
"10","009","00","017","1701","0000","1397","1094","303","116","1513","3349","0","45.18","32.67"
"10","009","00","017","1701","0180","403","319","84","37","440","915","0","48.09","34.86"
"10","009","00","017","1701","0181","531","409","122","34","565","1284","0","44.0","31.85"
"10","009","00","017","1701","0182","463","366","97","45","508","1150","0","44.17","31.83"
"10","009","00","017","1702","0000","611","479","132","101","712","1534","0","46.41","31.23"
"10","009","00","017","1702","0183","274","211","63","47","321","744","0","43.15","28.36"
"10","009","00","017","1702","0184","337","268","69","54","391","790","0","49.49","33.92"
"10","009","00","017","1703","0000","479","358","121","76","555","1356","0","40.93","26.4"
"10","009","00","017","1703","0185","479","358","121","76","555","1356","0","40.93","26.4"
"10","009","00","017","1704","0000","291","214","77","65","356","739","0","48.17","28.96"
"10","009","00","017","1704","0186","291","214","77","65","356","739","0","48.17","28.96"
"10","009","00","017","1705","0000","331","228","103","33","364","965","0","37.72","23.63"
"10","009","00","017","1705","0187","331","228","103","33","364","965","0","37.72","23.63"
"10","009","00","017","1706","0000","394","299","95","70","464","1080","0","42.96","27.69"
"10","009","00","017","1706","0188","394","299","95","70","464","1080","0","42.96","27.69"
"10","009","00","017","1707","0000","338","272","66","44","382","948","0","40.3","28.69"
"10","009","00","017","1707","0189","338","272","66","44","382","948","0","40.3","28.69"
"10","009","00","017","1708","0000","211","154","57","32","243","762","0","31.89","20.21"
"10","009","00","017","1708","0190","211","154","57","32","243","762","0","31.89","20.21"
"10","009","00","017","1709","0000","244","198","46","25","269","582","0","46.22","34.02"
"10","009","00","017","1709","0191","244","198","46","25","269","582","0","46.22","34.02"
"10","009","00","017","1710","0000","291","230","61","14","305","865","0","35.26","26.59"
"10","009","00","017","1710","0192","291","230","61","14","305","865","0","35.26","26.59"
"10","009","00","017","1711","0000","71","61","10","6","77","362","0","21.27","16.85"
"10","009","00","017","1711","0193","71","61","10","6","77","362","0","21.27","16.85"
"10","009","00","017","1712","0000","391","301","90","34","425","1162","0","36.57","25.9"
"10","009","00","017","1712","0194","391","301","90","34","425","1162","0","36.57","25.9"
"10","009","00","017","1713","0000","567","437","130","45","612","1527","0","40.08","28.62"
"10","009","00","017","1713","0195","567","437","130","45","612","1527","0","40.08","28.62"
"10","009","00","017","1714","0000","421","316","105","66","487","1006","0","48.41","31.41"
"10","009","00","017","1714","0196","421","316","105","66","487","1006","0","48.41","31.41"
"10","009","00","017","1715","0000","325","261","64","24","349","855","0","40.82","30.53"
"10","009","00","017","1715","0197","325","261","64","24","349","855","0","40.82","30.53"
"10","009","00","017","1716","0000","483","382","101","74","557","1181","0","47.16","32.35"
"10","009","00","017","1716","0198","483","382","101","74","557","1181","0","47.16","32.35"
"10","009","00","017","1717","0000","317","253","64","39","356","864","0","41.2","29.28"
"10","009","00","017","1717","0199","317","253","64","39","356","864","0","41.2","29.28"
"10","009","00","017","1718","0000","541","407","134","65","606","1545","0","39.22","26.34"
"10","009","00","017","1718","0200","228","169","59","36","264","667","0","39.58","25.34"
"10","009","00","017","1718","0201","313","238","75","29","342","878","0","38.95","27.11"
"10","009","00","017","1719","0000","161","137","24","11","172","610","0","28.2","22.46"
"10","009","00","017","1719","0202","161","137","24","11","172","610","0","28.2","22.46"
"10","009","00","017","1720","0000","334","253","81","64","398","837","0","47.55","30.23"
"10","009","00","017","1720","0203","334","253","81","64","398","837","0","47.55","30.23"
"10","009","00","017","1721","0000","313","249","64","39","352","701","0","50.21","35.52"
"10","009","00","017","1721","0204","313","249","64","39","352","701","0","50.21","35.52"
"10","009","00","018","0000","0000","7104","5552","1552","889","7993","20983","23317","38.09","26.46"
"10","009","00","018","1801","0000","727","570","157","114","841","1758","0","47.84","32.42"
"10","009","00","018","1801","0155","412","323","89","66","478","1082","0","44.18","29.85"
"10","009","00","018","1801","0156","315","247","68","48","363","676","0","53.7","36.54"
"10","009","00","018","1802","0000","221","168","53","13","234","650","0","36.0","25.85"
"10","009","00","018","1802","0160","221","168","53","13","234","650","0","36.0","25.85"
"10","009","00","018","1803","0000","387","300","87","16","403","969","0","41.59","30.96"
"10","009","00","018","1803","0161","387","300","87","16","403","969","0","41.59","30.96"
"10","009","00","018","1804","0000","339","248","91","33","372","925","0","40.22","26.81"
"10","009","00","018","1804","0162","339","248","91","33","372","925","0","40.22","26.81"
"10","009","00","018","1805","0000","998","806","192","69","1067","2291","0","46.57","35.18"
"10","009","00","018","1805","0157","386","319","67","19","405","862","0","46.98","37.01"
"10","009","00","018","1805","0158","140","113","27","20","160","477","0","33.54","23.69"
"10","009","00","018","1805","0159","472","374","98","30","502","952","0","52.73","39.29"
"10","009","00","018","1806","0000","399","313","86","47","446","1219","0","36.59","25.68"
"10","009","00","018","1806","0165","399","313","86","47","446","1219","0","36.59","25.68"
"10","009","00","018","1807","0000","192","151","41","49","241","759","0","31.75","19.89"
"10","009","00","018","1807","0164","192","151","41","49","241","759","0","31.75","19.89"
"10","009","00","018","1808","0000","361","301","60","18","379","914","0","41.47","32.93"
"10","009","00","018","1808","0163","361","301","60","18","379","914","0","41.47","32.93"
"10","009","00","018","1809","0000","269","205","64","28","297","876","0","33.9","23.4"
"10","009","00","018","1809","0169","269","205","64","28","297","876","0","33.9","23.4"
"10","009","00","018","1810","0000","118","102","16","21","139","360","0","38.61","28.33"
"10","009","00","018","1810","0170","118","102","16","21","139","360","0","38.61","28.33"
"10","009","00","018","1811","0000","202","165","37","15","217","773","0","28.07","21.35"
"10","009","00","018","1811","0167","202","165","37","15","217","773","0","28.07","21.35"
"10","009","00","018","1812","0000","272","224","48","47","319","937","0","34.04","23.91"
"10","009","00","018","1812","0166","272","224","48","47","319","937","0","34.04","23.91"
"10","009","00","018","1813","0000","460","369","91","89","549","1718","0","31.96","21.48"
"10","009","00","018","1813","0171","212","171","41","51","263","885","0","29.72","19.32"
"10","009","00","018","1813","0172","248","198","50","38","286","833","0","34.33","23.77"
"10","009","00","018","1814","0000","282","161","121","39","321","785","0","40.89","20.51"
"10","009","00","018","1814","0173","282","161","121","39","321","785","0","40.89","20.51"
"10","009","00","018","1815","0000","292","227","65","44","336","705","0","47.66","32.2"
"10","009","00","018","1815","0174","292","227","65","44","336","705","0","47.66","32.2"
"10","009","00","018","1816","0000","256","204","52","26","282","927","0","30.42","22.01"
"10","009","00","018","1816","0175","256","204","52","26","282","927","0","30.42","22.01"
"10","009","00","018","1817","0000","347","268","79","58","405","1071","0","37.82","25.02"
"10","009","00","018","1817","0177","347","268","79","58","405","1071","0","37.82","25.02"
"10","009","00","018","1818","0000","253","201","52","14","267","1022","0","26.13","19.67"
"10","009","00","018","1818","0178","253","201","52","14","267","1022","0","26.13","19.67"
"10","009","00","018","1819","0000","240","182","58","37","277","711","0","38.96","25.6"
"10","009","00","018","1819","0179","240","182","58","37","277","711","0","38.96","25.6"
"10","009","00","018","1820","0000","182","141","41","43","225","555","0","40.54","25.41"
"10","009","00","018","1820","0168","182","141","41","43","225","555","0","40.54","25.41"
"10","009","00","018","1821","0000","307","246","61","69","376","1058","0","35.54","23.25"
"10","009","00","018","1821","0176","307","246","61","69","376","1058","0","35.54","23.25"
"10","009","00","019","0000","0000","9728","7648","2080","1405","11133","24193","27383","46.02","31.61"
"10","009","00","019","1901","0000","569","458","111","97","666","1225","0","54.37","37.39"
"10","009","00","019","1901","0206","569","458","111","97","666","1225","0","54.37","37.39"
"10","009","00","019","1902","0000","512","388","124","63","575","1134","0","50.71","34.22"
"10","009","00","019","1902","0205","512","388","124","63","575","1134","0","50.71","34.22"
"10","009","00","019","1903","0000","233","182","51","38","271","647","0","41.89","28.13"
"10","009","00","019","1903","0207","233","182","51","38","271","647","0","41.89","28.13"
"10","009","00","019","1904","0000","356","280","76","70","426","900","0","47.33","31.11"
"10","009","00","019","1904","0209","356","280","76","70","426","900","0","47.33","31.11"
"10","009","00","019","1905","0000","312","247","65","27","339","709","0","47.81","34.84"
"10","009","00","019","1905","0208","312","247","65","27","339","709","0","47.81","34.84"
"10","009","00","019","1906","0000","430","330","100","63","493","1011","0","48.76","32.64"
"10","009","00","019","1906","0210","430","330","100","63","493","1011","0","48.76","32.64"
"10","009","00","019","1907","0000","496","401","95","24","520","1437","0","36.19","27.91"
"10","009","00","019","1907","0211","496","401","95","24","520","1437","0","36.19","27.91"
"10","009","00","019","1908","0000","651","509","142","42","693","2041","0","33.95","24.94"
"10","009","00","019","1908","0212","236","187","49","9","245","848","0","28.89","22.05"
"10","009","00","019","1908","0213","415","322","93","33","448","1193","0","37.55","26.99"
"10","009","00","019","1909","0000","543","430","113","112","655","1574","0","41.61","27.32"
"10","009","00","019","1909","0214","226","181","45","62","288","759","0","37.94","23.85"
"10","009","00","019","1909","0215","317","249","68","50","367","815","0","45.03","30.55"
"10","009","00","019","1910","0000","615","484","131","90","705","1460","0","48.29","33.15"
"10","009","00","019","1910","0216","615","484","131","90","705","1460","0","48.29","33.15"
"10","009","00","019","1911","0000","154","123","31","11","165","556","0","29.68","22.12"
"10","009","00","019","1911","0217","154","123","31","11","165","556","0","29.68","22.12"
"10","009","00","019","1912","0000","634","524","110","63","697","1532","0","45.5","34.2"
"10","009","00","019","1912","0218","634","524","110","63","697","1532","0","45.5","34.2"
"10","009","00","019","1913","0000","341","253","88","18","359","847","0","42.38","29.87"
"10","009","00","019","1913","0219","341","253","88","18","359","847","0","42.38","29.87"
"10","009","00","019","1914","0000","812","622","190","200","1012","1882","0","53.77","33.05"
"10","009","00","019","1914","0220","158","134","24","24","182","374","0","48.66","35.83"
"10","009","00","019","1914","0221","654","488","166","176","830","1508","0","55.04","32.36"
"10","009","00","019","1915","0000","452","373","79","70","522","951","0","54.89","39.22"
"10","009","00","019","1915","0222","452","373","79","70","522","951","0","54.89","39.22"
"10","009","00","019","1916","0000","334","256","78","32","366","1006","0","36.38","25.45"
"10","009","00","019","1916","0228","334","256","78","32","366","1006","0","36.38","25.45"
"10","009","00","019","1917","0000","403","326","77","54","457","952","0","48.0","34.24"
"10","009","00","019","1917","0226","403","326","77","54","457","952","0","48.0","34.24"
"10","009","00","019","1918","0000","327","251","76","61","388","720","0","53.89","34.86"
"10","009","00","019","1918","0227","327","251","76","61","388","720","0","53.89","34.86"
"10","009","00","019","1919","0000","900","690","210","132","1032","1789","0","57.69","38.57"
"10","009","00","019","1919","0223","445","323","122","80","525","910","0","57.69","35.49"
"10","009","00","019","1919","0224","455","367","88","52","507","879","0","57.68","41.75"
"10","009","00","019","1920","0000","457","360","97","129","586","1213","0","48.31","29.68"
"10","009","00","019","1920","0225","457","360","97","129","586","1213","0","48.31","29.68"
"10","009","00","019","1921","0000","197","161","36","9","206","607","0","33.94","26.52"
"10","009","00","019","1921","0229","197","161","36","9","206","607","0","33.94","26.52"
"10","009","00","020","0000","0000","8393","6599","1794","1086","9479","22508","25426","42.11","29.32"
"10","009","00","020","2001","0000","930","731","199","76","1006","2242","0","44.87","32.6"
"10","009","00","020","2001","0230","542","427","115","60","602","1355","0","44.43","31.51"
"10","009","00","020","2001","0231","388","304","84","16","404","887","0","45.55","34.27"
"10","009","00","020","2002","0000","923","752","171","81","1004","1997","0","50.28","37.66"
"10","009","00","020","2002","0232","599","486","113","59","658","1234","0","53.32","39.38"
"10","009","00","020","2002","0233","324","266","58","22","346","763","0","45.35","34.86"
"10","009","00","020","2003","0000","425","331","94","68","493","1022","0","48.24","32.39"
"10","009","00","020","2003","0253","425","331","94","68","493","1022","0","48.24","32.39"
"10","009","00","020","2004","0000","431","341","90","38","469","1191","0","39.38","28.63"
"10","009","00","020","2004","0254","431","341","90","38","469","1191","0","39.38","28.63"
"10","009","00","020","2005","0000","408","310","98","82","490","1006","0","48.71","30.82"
"10","009","00","020","2005","0240","408","310","98","82","490","1006","0","48.71","30.82"
"10","009","00","020","2006","0000","247","201","46","12","259","651","0","39.78","30.88"
"10","009","00","020","2006","0241","247","201","46","12","259","651","0","39.78","30.88"
"10","009","00","020","2007","0000","208","166","42","27","235","607","0","38.71","27.35"
"10","009","00","020","2007","0242","208","166","42","27","235","607","0","38.71","27.35"
"10","009","00","020","2008","0000","370","278","92","59","429","1033","0","41.53","26.91"
"10","009","00","020","2008","0243","370","278","92","59","429","1033","0","41.53","26.91"
"10","009","00","020","2009","0000","186","151","35","11","197","631","0","31.22","23.93"
"10","009","00","020","2009","0244","186","151","35","11","197","631","0","31.22","23.93"
"10","009","00","020","2010","0000","361","282","79","54","415","961","0","43.18","29.34"
"10","009","00","020","2010","0245","361","282","79","54","415","961","0","43.18","29.34"
"10","009","00","020","2011","0000","263","193","70","44","307","721","0","42.58","26.77"
"10","009","00","020","2011","0234","263","193","70","44","307","721","0","42.58","26.77"
"10","009","00","020","2012","0000","215","175","40","10","225","647","0","34.78","27.05"
"10","009","00","020","2012","0235","215","175","40","10","225","647","0","34.78","27.05"
"10","009","00","020","2013","0000","352","286","66","17","369","1081","0","34.14","26.46"
"10","009","00","020","2013","0238","352","286","66","17","369","1081","0","34.14","26.46"
"10","009","00","020","2014","0000","374","283","91","59","433","989","0","43.78","28.61"
"10","009","00","020","2014","0236","374","283","91","59","433","989","0","43.78","28.61"
"10","009","00","020","2015","0000","278","217","61","25","303","837","0","36.2","25.93"
"10","009","00","020","2015","0237","278","217","61","25","303","837","0","36.2","25.93"
"10","009","00","020","2016","0000","341","254","87","77","418","951","0","43.95","26.71"
"10","009","00","020","2016","0246","341","254","87","77","418","951","0","43.95","26.71"
"10","009","00","020","2017","0000","334","261","73","25","359","838","0","42.84","31.15"
"10","009","00","020","2017","0247","334","261","73","25","359","838","0","42.84","31.15"
"10","009","00","020","2018","0000","405","322","83","95","500","1055","0","47.39","30.52"
"10","009","00","020","2018","0248","405","322","83","95","500","1055","0","47.39","30.52"
"10","009","00","020","2019","0000","135","105","30","32","167","512","0","32.62","20.51"
"10","009","00","020","2019","0249","135","105","30","32","167","512","0","32.62","20.51"
"10","009","00","020","2020","0000","210","174","36","19","229","671","0","34.13","25.93"
"10","009","00","020","2020","0250","210","174","36","19","229","671","0","34.13","25.93"
"10","009","00","020","2021","0000","170","132","38","43","213","693","0","30.74","19.05"
"10","009","00","020","2021","0251","170","132","38","43","213","693","0","30.74","19.05"
"10","009","00","020","2022","0000","192","144","48","47","239","689","0","34.69","20.9"
"10","009","00","020","2022","0252","192","144","48","47","239","689","0","34.69","20.9"
"10","009","00","020","2023","0000","272","212","60","44","316","704","0","44.89","30.11"
"10","009","00","020","2023","0239","272","212","60","44","316","704","0","44.89","30.11"
"10","009","00","020","2024","0000","363","298","65","41","404","779","0","51.86","38.25"
"10","009","00","020","2024","0255","363","298","65","41","404","779","0","51.86","38.25"
"10","010","00","000","0000","0000","198005","155084","42921","21707","219712","442775","507780","49.62","35.03"
"10","010","00","001","0000","0000","14990","11773","3217","1411","16401","31568","38048","51.95","37.29"
"10","010","00","001","0101","0000","1137","914","223","117","1254","2286","0","54.86","39.98"
"10","010","00","001","0101","0001","595","481","114","82","677","1210","0","55.95","39.75"
"10","010","00","001","0101","0002","542","433","109","35","577","1076","0","53.62","40.24"
"10","010","00","001","0102","0000","205","160","45","29","234","488","0","47.95","32.79"
"10","010","00","001","0102","0003","205","160","45","29","234","488","0","47.95","32.79"
"10","010","00","001","0103","0000","646","484","162","67","713","1475","0","48.34","32.81"
"10","010","00","001","0103","0004","646","484","162","67","713","1475","0","48.34","32.81"
"10","010","00","001","0104","0000","719","584","135","76","795","1673","0","47.52","34.91"
"10","010","00","001","0104","0005","323","263","60","32","355","790","0","44.94","33.29"
"10","010","00","001","0104","0006","396","321","75","44","440","883","0","49.83","36.35"
"10","010","00","001","0105","0000","475","392","83","58","533","1147","0","46.47","34.18"
"10","010","00","001","0105","0007","331","280","51","51","382","758","0","50.4","36.94"
"10","010","00","001","0105","0008","144","112","32","7","151","389","0","38.82","28.79"
"10","010","00","001","0106","0000","453","340","113","55","508","1101","0","46.14","30.88"
"10","010","00","001","0106","0009","453","340","113","55","508","1101","0","46.14","30.88"
"10","010","00","001","0107","0000","401","322","79","10","411","853","0","48.18","37.75"
"10","010","00","001","0107","0010","401","322","79","10","411","853","0","48.18","37.75"
"10","010","00","001","0108","0000","811","655","156","42","853","1692","0","50.41","38.71"
"10","010","00","001","0108","0014","393","312","81","27","420","913","0","46.0","34.17"
"10","010","00","001","0108","0015","418","343","75","15","433","779","0","55.58","44.03"
"10","010","00","001","0109","0000","602","459","143","102","704","1278","0","55.09","35.92"
"10","010","00","001","0109","0016","602","459","143","102","704","1278","0","55.09","35.92"
"10","010","00","001","0110","0000","1086","857","229","69","1155","2392","0","48.29","35.83"
"10","010","00","001","0110","0017","356","279","77","29","385","819","0","47.01","34.07"
"10","010","00","001","0110","0018","730","578","152","40","770","1573","0","48.95","36.75"
"10","010","00","001","0111","0000","364","304","60","35","399","726","0","54.96","41.87"
"10","010","00","001","0111","0019","230","193","37","29","259","481","0","53.85","40.12"
"10","010","00","001","0111","0020","134","111","23","6","140","245","0","57.14","45.31"
"10","010","00","001","0112","0000","263","220","43","23","286","575","0","49.74","38.26"
"10","010","00","001","0112","0021","153","127","26","16","169","317","0","53.31","40.06"
"10","010","00","001","0112","0022","110","93","17","7","117","258","0","45.35","36.05"
"10","010","00","001","0113","0000","1687","1269","418","129","1816","3333","0","54.49","38.07"
"10","010","00","001","0113","0023","278","229","49","55","333","611","0","54.5","37.48"
"10","010","00","001","0113","0024","784","571","213","44","828","1526","0","54.26","37.42"
"10","010","00","001","0113","0025","625","469","156","30","655","1196","0","54.77","39.21"
"10","010","00","001","0114","0000","2233","1735","498","231","2464","4467","0","55.16","38.84"
"10","010","00","001","0114","0026","763","582","181","84","847","1536","0","55.14","37.89"
"10","010","00","001","0114","0027","741","570","171","85","826","1481","0","55.77","38.49"
"10","010","00","001","0114","0028","729","583","146","62","791","1450","0","54.55","40.21"
"10","010","00","001","0115","0000","848","644","204","43","891","1829","0","48.72","35.21"
"10","010","00","001","0115","0029","369","283","86","21","390","840","0","46.43","33.69"
"10","010","00","001","0115","0030","479","361","118","22","501","989","0","50.66","36.5"
"10","010","00","001","0116","0000","1517","1193","324","173","1690","3040","0","55.59","39.24"
"10","010","00","001","0116","0031","750","606","144","95","845","1529","0","55.26","39.63"
"10","010","00","001","0116","0032","767","587","180","78","845","1511","0","55.92","38.85"
"10","010","00","001","0117","0000","281","212","69","41","322","697","0","46.2","30.42"
"10","010","00","001","0117","0033","281","212","69","41","322","697","0","46.2","30.42"
"10","010","00","001","0118","0000","1262","1029","233","111","1373","2516","0","54.57","40.9"
"10","010","00","001","0118","0011","79","56","23","13","92","224","0","41.07","25.0"
"10","010","00","001","0118","0012","261","215","46","57","318","662","0","48.04","32.48"
"10","010","00","001","0118","0013","922","758","164","41","963","1630","0","59.08","46.5"
"10","010","00","002","0000","0000","16208","12753","3455","1714","17922","35191","42143","50.93","36.24"
"10","010","00","002","0201","0000","967","747","220","94","1061","1938","0","54.75","38.54"
"10","010","00","002","0201","0233","593","477","116","49","642","1183","0","54.27","40.32"
"10","010","00","002","0201","0234","374","270","104","45","419","755","0","55.5","35.76"
"10","010","00","002","0202","0000","1203","963","240","108","1311","2331","0","56.24","41.31"
"10","010","00","002","0202","0235","627","502","125","42","669","1253","0","53.39","40.06"
"10","010","00","002","0202","0236","576","461","115","66","642","1078","0","59.55","42.76"
"10","010","00","002","0203","0000","609","467","142","76","685","1117","0","61.32","41.81"
"10","010","00","002","0203","0237","609","467","142","76","685","1117","0","61.32","41.81"
"10","010","00","002","0204","0000","210","160","50","20","230","387","0","59.43","41.34"
"10","010","00","002","0204","0238","210","160","50","20","230","387","0","59.43","41.34"
"10","010","00","002","0205","0000","316","302","14","43","359","633","0","56.71","47.71"
"10","010","00","002","0205","0239","316","302","14","43","359","633","0","56.71","47.71"
"10","010","00","002","0206","0000","325","249","76","36","361","650","0","55.54","38.31"
"10","010","00","002","0206","0240","325","249","76","36","361","650","0","55.54","38.31"
"10","010","00","002","0207","0000","467","371","96","50","517","825","0","62.67","44.97"
"10","010","00","002","0207","0241","467","371","96","50","517","825","0","62.67","44.97"
"10","010","00","002","0208","0000","877","705","172","114","991","1750","0","56.63","40.29"
"10","010","00","002","0208","0242","392","312","80","52","444","810","0","54.81","38.52"
"10","010","00","002","0208","0243","485","393","92","62","547","940","0","58.19","41.81"
"10","010","00","002","0209","0000","1129","863","266","111","1240","2510","0","49.4","34.38"
"10","010","00","002","0209","0244","425","326","99","53","478","905","0","52.82","36.02"
"10","010","00","002","0209","0245","704","537","167","58","762","1605","0","47.48","33.46"
"10","010","00","002","0210","0000","2208","1728","480","192","2400","4193","0","57.24","41.21"
"10","010","00","002","0210","0246","784","632","152","61","845","1479","0","57.13","42.73"
"10","010","00","002","0210","0247","635","486","149","64","699","1218","0","57.39","39.9"
"10","010","00","002","0210","0248","789","610","179","67","856","1496","0","57.22","40.78"
"10","010","00","002","0211","0000","318","240","78","34","352","667","0","52.77","35.98"
"10","010","00","002","0211","0249","318","240","78","34","352","667","0","52.77","35.98"
"10","010","00","002","0212","0000","219","167","52","26","245","627","0","39.07","26.63"
"10","010","00","002","0212","0250","219","167","52","26","245","627","0","39.07","26.63"
"10","010","00","002","0213","0000","349","267","82","46","395","791","0","49.94","33.75"
"10","010","00","002","0213","0251","349","267","82","46","395","791","0","49.94","33.75"
"10","010","00","002","0214","0000","471","361","110","102","573","1034","0","55.42","34.91"
"10","010","00","002","0214","0252","471","361","110","102","573","1034","0","55.42","34.91"
"10","010","00","002","0215","0000","772","606","166","29","801","1710","0","46.84","35.44"
"10","010","00","002","0215","0253","772","606","166","29","801","1710","0","46.84","35.44"
"10","010","00","002","0216","0000","1275","1044","231","97","1372","3218","0","42.64","32.44"
"10","010","00","002","0216","0254","712","581","131","46","758","1671","0","45.36","34.77"
"10","010","00","002","0216","0255","563","463","100","51","614","1547","0","39.69","29.93"
"10","010","00","002","0217","0000","1286","1033","253","93","1379","2904","0","47.49","35.57"
"10","010","00","002","0217","0256","582","449","133","61","643","1602","0","40.14","28.03"
"10","010","00","002","0217","0257","704","584","120","32","736","1302","0","56.53","44.85"
"10","010","00","002","0218","0000","331","262","69","45","376","740","0","50.81","35.41"
"10","010","00","002","0218","0258","331","262","69","45","376","740","0","50.81","35.41"
"10","010","00","002","0219","0000","553","447","106","66","619","1054","0","58.73","42.41"
"10","010","00","002","0219","0259","553","447","106","66","619","1054","0","58.73","42.41"
"10","010","00","002","0220","0000","335","261","74","15","350","907","0","38.59","28.78"
"10","010","00","002","0220","0260","335","261","74","15","350","907","0","38.59","28.78"
"10","010","00","002","0221","0000","123","93","30","24","147","251","0","58.57","37.05"
"10","010","00","002","0221","0262","123","93","30","24","147","251","0","58.57","37.05"
"10","010","00","002","0222","0000","268","209","59","36","304","720","0","42.22","29.03"
"10","010","00","002","0222","0261","268","209","59","36","304","720","0","42.22","29.03"
"10","010","00","002","0223","0000","260","211","49","74","334","767","0","43.55","27.51"
"10","010","00","002","0223","0263","260","211","49","74","334","767","0","43.55","27.51"
"10","010","00","002","0224","0000","341","236","105","48","389","702","0","55.41","33.62"
"10","010","00","002","0224","0264","341","236","105","48","389","702","0","55.41","33.62"
"10","010","00","002","0225","0000","428","320","108","57","485","1038","0","46.72","30.83"
"10","010","00","002","0225","0265","428","320","108","57","485","1038","0","46.72","30.83"
"10","010","00","002","0226","0000","362","276","86","27","389","1228","0","31.68","22.48"
"10","010","00","002","0226","0266","362","276","86","27","389","1228","0","31.68","22.48"
"10","010","00","002","0227","0000","206","165","41","51","257","499","0","51.5","33.07"
"10","010","00","002","0227","0267","206","165","41","51","257","499","0","51.5","33.07"
"10","010","00","003","0000","0000","10079","7992","2087","1337","11416","23965","26846","47.64","33.35"
"10","010","00","003","0301","0000","259","216","43","34","293","614","0","47.72","35.18"
"10","010","00","003","0301","0325","259","216","43","34","293","614","0","47.72","35.18"
"10","010","00","003","0302","0000","148","126","22","18","166","372","0","44.62","33.87"
"10","010","00","003","0302","0326","148","126","22","18","166","372","0","44.62","33.87"
"10","010","00","003","0303","0000","946","774","172","192","1138","2112","0","53.88","36.65"
"10","010","00","003","0303","0327","407","339","68","98","505","914","0","55.25","37.09"
"10","010","00","003","0303","0328","539","435","104","94","633","1198","0","52.84","36.31"
"10","010","00","003","0304","0000","438","364","74","83","521","1113","0","46.81","32.7"
"10","010","00","003","0304","0329","438","364","74","83","521","1113","0","46.81","32.7"
"10","010","00","003","0305","0000","769","610","159","94","863","1681","0","51.34","36.29"
"10","010","00","003","0305","0330","460","362","98","78","538","992","0","54.23","36.49"
"10","010","00","003","0305","0331","309","248","61","16","325","689","0","47.17","35.99"
"10","010","00","003","0306","0000","390","303","87","68","458","882","0","51.93","34.35"
"10","010","00","003","0306","0332","390","303","87","68","458","882","0","51.93","34.35"
"10","010","00","003","0307","0000","341","269","72","38","379","731","0","51.85","36.8"
"10","010","00","003","0307","0333","341","269","72","38","379","731","0","51.85","36.8"
"10","010","00","003","0308","0000","380","308","72","34","414","779","0","53.15","39.54"
"10","010","00","003","0308","0334","380","308","72","34","414","779","0","53.15","39.54"
"10","010","00","003","0309","0000","398","316","82","53","451","953","0","47.32","33.16"
"10","010","00","003","0309","0349","398","316","82","53","451","953","0","47.32","33.16"
"10","010","00","003","0310","0000","615","479","136","77","692","1292","0","53.56","37.07"
"10","010","00","003","0310","0350","615","479","136","77","692","1292","0","53.56","37.07"
"10","010","00","003","0311","0000","1074","853","221","104","1178","2371","0","49.68","35.98"
"10","010","00","003","0311","0351","535","425","110","67","602","1127","0","53.42","37.71"
"10","010","00","003","0311","0352","539","428","111","37","576","1244","0","46.3","34.41"
"10","010","00","003","0312","0000","424","329","95","28","452","1106","0","40.87","29.75"
"10","010","00","003","0312","0353","424","329","95","28","452","1106","0","40.87","29.75"
"10","010","00","003","0313","0000","492","386","106","50","542","1145","0","47.34","33.71"
"10","010","00","003","0313","0342","492","386","106","50","542","1145","0","47.34","33.71"
"10","010","00","003","0314","0000","791","605","186","76","867","1894","0","45.78","31.94"
"10","010","00","003","0314","0343","383","285","98","31","414","936","0","44.23","30.45"
"10","010","00","003","0314","0344","408","320","88","45","453","958","0","47.29","33.4"
"10","010","00","003","0315","0000","119","95","24","15","134","298","0","44.97","31.88"
"10","010","00","003","0315","0345","119","95","24","15","134","298","0","44.97","31.88"
"10","010","00","003","0316","0000","208","168","40","35","243","428","0","56.78","39.25"
"10","010","00","003","0316","0346","208","168","40","35","243","428","0","56.78","39.25"
"10","010","00","003","0317","0000","90","76","14","9","99","295","0","33.56","25.76"
"10","010","00","003","0317","0347","46","39","7","4","50","121","0","41.32","32.23"
"10","010","00","003","0317","0348","44","37","7","5","49","174","0","28.16","21.26"
"10","010","00","003","0318","0000","298","243","55","42","340","762","0","44.62","31.89"
"10","010","00","003","0318","0335","298","243","55","42","340","762","0","44.62","31.89"
"10","010","00","003","0319","0000","470","375","95","50","520","1184","0","43.92","31.67"
"10","010","00","003","0319","0336","470","375","95","50","520","1184","0","43.92","31.67"
"10","010","00","003","0320","0000","466","366","100","65","531","1351","0","39.3","27.09"
"10","010","00","003","0320","0338","466","366","100","65","531","1351","0","39.3","27.09"
"10","010","00","003","0321","0000","489","363","126","67","556","1423","0","39.07","25.51"
"10","010","00","003","0321","0337","489","363","126","67","556","1423","0","39.07","25.51"
"10","010","00","003","0322","0000","195","147","48","21","216","518","0","41.7","28.38"
"10","010","00","003","0322","0339","100","80","20","7","107","275","0","38.91","29.09"
"10","010","00","003","0322","0340","95","67","28","14","109","243","0","44.86","27.57"
"10","010","00","003","0323","0000","279","221","58","84","363","661","0","54.92","33.43"
"10","010","00","003","0323","0341","279","221","58","84","363","661","0","54.92","33.43"
"10","010","00","004","0000","0000","12442","9837","2605","1126","13568","26922","30954","50.4","36.54"
"10","010","00","004","0401","0000","230","169","61","34","264","483","0","54.66","34.99"
"10","010","00","004","0401","0169","230","169","61","34","264","483","0","54.66","34.99"
"10","010","00","004","0402","0000","943","744","199","68","1011","1823","0","55.46","40.81"
"10","010","00","004","0402","0170","943","744","199","68","1011","1823","0","55.46","40.81"
"10","010","00","004","0403","0000","485","369","116","23","508","955","0","53.19","38.64"
"10","010","00","004","0403","0171","485","369","116","23","508","955","0","53.19","38.64"
"10","010","00","004","0404","0000","2900","2278","622","237","3137","5874","0","53.4","38.78"
"10","010","00","004","0404","0172","667","517","150","46","713","1436","0","49.65","36.0"
"10","010","00","004","0404","0173","663","535","128","57","720","1390","0","51.8","38.49"
"10","010","00","004","0404","0174","766","603","163","79","845","1512","0","55.89","39.88"
"10","010","00","004","0404","0175","804","623","181","55","859","1536","0","55.92","40.56"
"10","010","00","004","0405","0000","507","412","95","37","544","1165","0","46.7","35.36"
"10","010","00","004","0405","0176","507","412","95","37","544","1165","0","46.7","35.36"
"10","010","00","004","0406","0000","926","724","202","79","1005","1730","0","58.09","41.85"
"10","010","00","004","0406","0177","926","724","202","79","1005","1730","0","58.09","41.85"
"10","010","00","004","0407","0000","221","173","48","15","236","602","0","39.2","28.74"
"10","010","00","004","0407","0178","221","173","48","15","236","602","0","39.2","28.74"
"10","010","00","004","0408","0000","296","222","74","62","358","716","0","50.0","31.01"
"10","010","00","004","0408","0179","296","222","74","62","358","716","0","50.0","31.01"
"10","010","00","004","0409","0000","192","153","39","10","202","625","0","32.32","24.48"
"10","010","00","004","0409","0180","192","153","39","10","202","625","0","32.32","24.48"
"10","010","00","004","0410","0000","67","54","13","1","68","193","0","35.23","27.98"
"10","010","00","004","0410","0181","67","54","13","1","68","193","0","35.23","27.98"
"10","010","00","004","0411","0000","684","528","156","67","751","1642","0","45.74","32.16"
"10","010","00","004","0411","0182","684","528","156","67","751","1642","0","45.74","32.16"
"10","010","00","004","0412","0000","687","530","157","69","756","1465","0","51.6","36.18"
"10","010","00","004","0412","0183","687","530","157","69","756","1465","0","51.6","36.18"
"10","010","00","004","0413","0000","500","411","89","69","569","1289","0","44.14","31.89"
"10","010","00","004","0413","0184","364","302","62","46","410","928","0","44.18","32.54"
"10","010","00","004","0413","0185","136","109","27","23","159","361","0","44.04","30.19"
"10","010","00","004","0414","0000","331","258","73","22","353","814","0","43.37","31.7"
"10","010","00","004","0414","0186","331","258","73","22","353","814","0","43.37","31.7"
"10","010","00","004","0415","0000","684","536","148","35","719","1579","0","45.54","33.95"
"10","010","00","004","0415","0187","684","536","148","35","719","1579","0","45.54","33.95"
"10","010","00","004","0416","0000","956","804","152","92","1048","2041","0","51.35","39.39"
"10","010","00","004","0416","0188","956","804","152","92","1048","2041","0","51.35","39.39"
"10","010","00","004","0417","0000","421","329","92","54","475","931","0","51.02","35.34"
"10","010","00","004","0417","0189","421","329","92","54","475","931","0","51.02","35.34"
"10","010","00","004","0418","0000","308","260","48","37","345","675","0","51.11","38.52"
"10","010","00","004","0418","0190","308","260","48","37","345","675","0","51.11","38.52"
"10","010","00","004","0419","0000","288","237","51","28","316","655","0","48.24","36.18"
"10","010","00","004","0419","0191","288","237","51","28","316","655","0","48.24","36.18"
"10","010","00","004","0420","0000","365","303","62","38","403","833","0","48.38","36.37"
"10","010","00","004","0420","0192","365","303","62","38","403","833","0","48.38","36.37"
"10","010","00","004","0421","0000","451","343","108","49","500","832","0","60.1","41.23"
"10","010","00","004","0421","0193","451","343","108","49","500","832","0","60.1","41.23"
"10","010","00","005","0000","0000","29595","22895","6700","2904","32499","61209","71327","53.1","37.4"
"10","010","00","005","0501","0000","1163","908","255","91","1254","2297","0","54.59","39.53"
"10","010","00","005","0501","0093","673","527","146","57","730","1267","0","57.62","41.59"
"10","010","00","005","0501","0094","490","381","109","34","524","1030","0","50.87","36.99"
"10","010","00","005","0502","0000","851","664","187","88","939","1590","0","59.06","41.76"
"10","010","00","005","0502","0095","851","664","187","88","939","1590","0","59.06","41.76"
"10","010","00","005","0503","0000","1672","1311","361","117","1789","3391","0","52.76","38.66"
"10","010","00","005","0503","0096","778","628","150","37","815","1673","0","48.71","37.54"
"10","010","00","005","0503","0097","894","683","211","80","974","1718","0","56.69","39.76"
"10","010","00","005","0504","0000","1091","867","224","115","1206","2140","0","56.36","40.51"
"10","010","00","005","0504","0098","564","447","117","50","614","1040","0","59.04","42.98"
"10","010","00","005","0504","0099","527","420","107","65","592","1100","0","53.82","38.18"
"10","010","00","005","0505","0000","720","532","188","79","799","1559","0","51.25","34.12"
"10","010","00","005","0505","0100","720","532","188","79","799","1559","0","51.25","34.12"
"10","010","00","005","0506","0000","846","648","198","92","938","1862","0","50.38","34.8"
"10","010","00","005","0506","0101","846","648","198","92","938","1862","0","50.38","34.8"
"10","010","00","005","0507","0000","742","575","167","67","809","1435","0","56.38","40.07"
"10","010","00","005","0507","0102","742","575","167","67","809","1435","0","56.38","40.07"
"10","010","00","005","0508","0000","763","564","199","144","907","1751","0","51.8","32.21"
"10","010","00","005","0508","0103","763","564","199","144","907","1751","0","51.8","32.21"
"10","010","00","005","0509","0000","463","372","91","57","520","933","0","55.73","39.87"
"10","010","00","005","0509","0104","463","372","91","57","520","933","0","55.73","39.87"
"10","010","00","005","0510","0000","458","334","124","58","516","827","0","62.39","40.39"
"10","010","00","005","0510","0105","458","334","124","58","516","827","0","62.39","40.39"
"10","010","00","005","0511","0000","340","261","79","51","391","843","0","46.38","30.96"
"10","010","00","005","0511","0106","340","261","79","51","391","843","0","46.38","30.96"
"10","010","00","005","0512","0000","1029","782","247","90","1119","2159","0","51.83","36.22"
"10","010","00","005","0512","0107","866","660","206","71","937","1774","0","52.82","37.2"
"10","010","00","005","0512","0108","163","122","41","19","182","385","0","47.27","31.69"
"10","010","00","005","0513","0000","706","548","158","40","746","1306","0","57.12","41.96"
"10","010","00","005","0513","0109","706","548","158","40","746","1306","0","57.12","41.96"
"10","010","00","005","0514","0000","278","208","70","42","320","535","0","59.81","38.88"
"10","010","00","005","0514","0110","278","208","70","42","320","535","0","59.81","38.88"
"10","010","00","005","0515","0000","533","416","117","80","613","1055","0","58.1","39.43"
"10","010","00","005","0515","0111","533","416","117","80","613","1055","0","58.1","39.43"
"10","010","00","005","0516","0000","854","630","224","100","954","1875","0","50.88","33.6"
"10","010","00","005","0516","0127","854","630","224","100","954","1875","0","50.88","33.6"
"10","010","00","005","0517","0000","1342","1031","311","124","1466","2746","0","53.39","37.55"
"10","010","00","005","0517","0128","672","524","148","56","728","1305","0","55.79","40.15"
"10","010","00","005","0517","0129","670","507","163","68","738","1441","0","51.21","35.18"
"10","010","00","005","0518","0000","999","777","222","115","1114","2004","0","55.59","38.77"
"10","010","00","005","0518","0132","999","777","222","115","1114","2004","0","55.59","38.77"
"10","010","00","005","0519","0000","1287","1028","259","107","1394","2430","0","57.37","42.3"
"10","010","00","005","0519","0133","729","586","143","67","796","1354","0","58.79","43.28"
"10","010","00","005","0519","0134","558","442","116","40","598","1076","0","55.58","41.08"
"10","010","00","005","0520","0000","1694","1313","381","212","1906","3606","0","52.86","36.41"
"10","010","00","005","0520","0135","781","593","188","131","912","1629","0","55.99","36.4"
"10","010","00","005","0520","0136","913","720","193","81","994","1977","0","50.28","36.42"
"10","010","00","005","0521","0000","598","427","171","90","688","1295","0","53.13","32.97"
"10","010","00","005","0521","0137","598","427","171","90","688","1295","0","53.13","32.97"
"10","010","00","005","0522","0000","2385","1873","512","220","2605","5171","0","50.38","36.22"
"10","010","00","005","0522","0112","728","567","161","66","794","1476","0","53.79","38.41"
"10","010","00","005","0522","0113","730","580","150","64","794","1583","0","50.16","36.64"
"10","010","00","005","0522","0114","311","237","74","32","343","758","0","45.25","31.27"
"10","010","00","005","0522","0115","616","489","127","58","674","1354","0","49.78","36.12"
"10","010","00","005","0523","0000","1219","936","283","111","1330","2377","0","55.95","39.38"
"10","010","00","005","0523","0116","618","479","139","66","684","1202","0","56.91","39.85"
"10","010","00","005","0523","0117","601","457","144","45","646","1175","0","54.98","38.89"
"10","010","00","005","0524","0000","1076","868","208","120","1196","2371","0","50.44","36.61"
"10","010","00","005","0524","0122","433","361","72","57","490","1019","0","48.09","35.43"
"10","010","00","005","0524","0123","643","507","136","63","706","1352","0","52.22","37.5"
"10","010","00","005","0525","0000","1259","958","301","103","1362","2563","0","53.14","37.38"
"10","010","00","005","0525","0124","819","625","194","70","889","1620","0","54.88","38.58"
"10","010","00","005","0525","0125","440","333","107","33","473","943","0","50.16","35.31"
"10","010","00","005","0526","0000","738","544","194","55","793","1720","0","46.1","31.63"
"10","010","00","005","0526","0126","738","544","194","55","793","1720","0","46.1","31.63"
"10","010","00","005","0527","0000","1426","1101","325","150","1576","2973","0","53.01","37.03"
"10","010","00","005","0527","0130","681","522","159","71","752","1413","0","53.22","36.94"
"10","010","00","005","0527","0131","745","579","166","79","824","1560","0","52.82","37.12"
"10","010","00","005","0528","0000","3063","2419","644","186","3249","6395","0","50.81","37.83"
"10","010","00","005","0528","0118","668","519","149","57","725","1423","0","50.95","36.47"
"10","010","00","005","0528","0119","799","654","145","46","845","1612","0","52.42","40.57"
"10","010","00","005","0528","0120","881","673","208","40","921","1695","0","54.34","39.71"
"10","010","00","005","0528","0121","715","573","142","43","758","1665","0","45.53","34.41"
"10","010","00","006","0000","0000","5750","4446","1304","716","6466","13105","14670","49.34","33.93"
"10","010","00","006","0601","0000","653","513","140","95","748","1318","0","56.75","38.92"
"10","010","00","006","0601","0194","653","513","140","95","748","1318","0","56.75","38.92"
"10","010","00","006","0602","0000","339","270","69","52","391","677","0","57.75","39.88"
"10","010","00","006","0602","0195","339","270","69","52","391","677","0","57.75","39.88"
"10","010","00","006","0603","0000","314","246","68","32","346","690","0","50.14","35.65"
"10","010","00","006","0603","0196","183","142","41","16","199","417","0","47.72","34.05"
"10","010","00","006","0603","0197","131","104","27","16","147","273","0","53.85","38.1"
"10","010","00","006","0604","0000","360","274","86","35","395","1003","0","39.38","27.32"
"10","010","00","006","0604","0210","360","274","86","35","395","1003","0","39.38","27.32"
"10","010","00","006","0605","0000","257","214","43","24","281","701","0","40.09","30.53"
"10","010","00","006","0605","0209","257","214","43","24","281","701","0","40.09","30.53"
"10","010","00","006","0606","0000","386","301","85","43","429","786","0","54.58","38.3"
"10","010","00","006","0606","0203","386","301","85","43","429","786","0","54.58","38.3"
"10","010","00","006","0607","0000","335","251","84","47","382","807","0","47.34","31.1"
"10","010","00","006","0607","0204","335","251","84","47","382","807","0","47.34","31.1"
"10","010","00","006","0608","0000","415","336","79","17","432","1168","0","36.99","28.77"
"10","010","00","006","0608","0205","415","336","79","17","432","1168","0","36.99","28.77"
"10","010","00","006","0609","0000","498","364","134","87","585","1052","0","55.61","34.6"
"10","010","00","006","0609","0206","498","364","134","87","585","1052","0","55.61","34.6"
"10","010","00","006","0610","0000","417","325","92","73","490","953","0","51.42","34.1"
"10","010","00","006","0610","0207","236","174","62","49","285","565","0","50.44","30.8"
"10","010","00","006","0610","0208","181","151","30","24","205","388","0","52.84","38.92"
"10","010","00","006","0611","0000","620","463","157","69","689","1294","0","53.25","35.78"
"10","010","00","006","0611","0198","470","346","124","58","528","908","0","58.15","38.11"
"10","010","00","006","0611","0199","150","117","33","11","161","386","0","41.71","30.31"
"10","010","00","006","0612","0000","511","388","123","68","579","1039","0","55.73","37.34"
"10","010","00","006","0612","0200","511","388","123","68","579","1039","0","55.73","37.34"
"10","010","00","006","0613","0000","273","220","53","55","328","708","0","46.33","31.07"
"10","010","00","006","0613","0201","273","220","53","55","328","708","0","46.33","31.07"
"10","010","00","006","0614","0000","372","281","91","19","391","909","0","43.01","30.91"
"10","010","00","006","0614","0202","372","281","91","19","391","909","0","43.01","30.91"
"10","010","00","007","0000","0000","12785","9871","2914","1636","14421","27342","31755","52.74","36.1"
"10","010","00","007","0701","0000","1186","951","235","106","1292","2203","0","58.65","43.17"
"10","010","00","007","0701","0138","524","420","104","33","557","1087","0","51.24","38.64"
"10","010","00","007","0701","0139","662","531","131","73","735","1116","0","65.86","47.58"
"10","010","00","007","0702","0000","724","561","163","120","844","1567","0","53.86","35.8"
"10","010","00","007","0702","0140","360","284","76","48","408","740","0","55.14","38.38"
"10","010","00","007","0702","0141","364","277","87","72","436","827","0","52.72","33.49"
"10","010","00","007","0703","0000","807","609","198","97","904","1472","0","61.41","41.37"
"10","010","00","007","0703","0142","383","290","93","48","431","704","0","61.22","41.19"
"10","010","00","007","0703","0143","424","319","105","49","473","768","0","61.59","41.54"
"10","010","00","007","0704","0000","775","600","175","112","887","1611","0","55.06","37.24"
"10","010","00","007","0704","0144","410","312","98","45","455","761","0","59.79","41.0"
"10","010","00","007","0704","0145","365","288","77","67","432","850","0","50.82","33.88"
"10","010","00","007","0705","0000","616","464","152","77","693","1327","0","52.22","34.97"
"10","010","00","007","0705","0146","616","464","152","77","693","1327","0","52.22","34.97"
"10","010","00","007","0706","0000","727","598","129","150","877","1572","0","55.79","38.04"
"10","010","00","007","0706","0147","351","286","65","65","416","756","0","55.03","37.83"
"10","010","00","007","0706","0148","376","312","64","85","461","816","0","56.5","38.24"
"10","010","00","007","0707","0000","703","525","178","79","782","1609","0","48.6","32.63"
"10","010","00","007","0707","0149","270","198","72","32","302","667","0","45.28","29.69"
"10","010","00","007","0707","0150","433","327","106","47","480","942","0","50.96","34.71"
"10","010","00","007","0708","0000","374","289","85","64","438","918","0","47.71","31.48"
"10","010","00","007","0708","0151","374","289","85","64","438","918","0","47.71","31.48"
"10","010","00","007","0709","0000","210","163","47","13","223","554","0","40.25","29.42"
"10","010","00","007","0709","0152","210","163","47","13","223","554","0","40.25","29.42"
"10","010","00","007","0710","0000","392","300","92","45","437","929","0","47.04","32.29"
"10","010","00","007","0710","0153","392","300","92","45","437","929","0","47.04","32.29"
"10","010","00","007","0711","0000","171","137","34","34","205","487","0","42.09","28.13"
"10","010","00","007","0711","0154","171","137","34","34","205","487","0","42.09","28.13"
"10","010","00","007","0712","0000","231","179","52","39","270","487","0","55.44","36.76"
"10","010","00","007","0712","0155","231","179","52","39","270","487","0","55.44","36.76"
"10","010","00","007","0713","0000","744","525","219","116","860","1681","0","51.16","31.23"
"10","010","00","007","0713","0156","344","237","107","51","395","836","0","47.25","28.35"
"10","010","00","007","0713","0157","400","288","112","65","465","845","0","55.03","34.08"
"10","010","00","007","0714","0000","774","610","164","103","877","1587","0","55.26","38.44"
"10","010","00","007","0714","0158","407","322","85","45","452","834","0","54.2","38.61"
"10","010","00","007","0714","0159","367","288","79","58","425","753","0","56.44","38.25"
"10","010","00","007","0715","0000","632","475","157","66","698","1328","0","52.56","35.77"
"10","010","00","007","0715","0160","632","475","157","66","698","1328","0","52.56","35.77"
"10","010","00","007","0716","0000","772","606","166","67","839","1400","0","59.93","43.29"
"10","010","00","007","0716","0163","772","606","166","67","839","1400","0","59.93","43.29"
"10","010","00","007","0717","0000","542","422","120","74","616","1043","0","59.06","40.46"
"10","010","00","007","0717","0162","542","422","120","74","616","1043","0","59.06","40.46"
"10","010","00","007","0718","0000","493","385","108","58","551","969","0","56.86","39.73"
"10","010","00","007","0718","0161","493","385","108","58","551","969","0","56.86","39.73"
"10","010","00","007","0719","0000","312","256","56","31","343","1017","0","33.73","25.17"
"10","010","00","007","0719","0164","312","256","56","31","343","1017","0","33.73","25.17"
"10","010","00","007","0720","0000","458","344","114","49","507","1132","0","44.79","30.39"
"10","010","00","007","0720","0165","458","344","114","49","507","1132","0","44.79","30.39"
"10","010","00","007","0721","0000","470","353","117","67","537","1037","0","51.78","34.04"
"10","010","00","007","0721","0166","470","353","117","67","537","1037","0","51.78","34.04"
"10","010","00","007","0722","0000","284","214","70","49","333","563","0","59.15","38.01"
"10","010","00","007","0722","0167","284","214","70","49","333","563","0","59.15","38.01"
"10","010","00","007","0723","0000","388","305","83","20","408","849","0","48.06","35.92"
"10","010","00","007","0723","0168","388","305","83","20","408","849","0","48.06","35.92"
"10","010","00","008","0000","0000","7498","5958","1540","959","8457","20821","23049","40.62","28.62"
"10","010","00","008","0801","0000","440","348","92","38","478","1165","0","41.03","29.87"
"10","010","00","008","0801","0268","440","348","92","38","478","1165","0","41.03","29.87"
"10","010","00","008","0802","0000","243","205","38","19","262","825","0","31.76","24.85"
"10","010","00","008","0802","0269","243","205","38","19","262","825","0","31.76","24.85"
"10","010","00","008","0803","0000","326","268","58","34","360","850","0","42.35","31.53"
"10","010","00","008","0803","0270","326","268","58","34","360","850","0","42.35","31.53"
"10","010","00","008","0804","0000","113","83","30","19","132","222","0","59.46","37.39"
"10","010","00","008","0804","0271","113","83","30","19","132","222","0","59.46","37.39"
"10","010","00","008","0805","0000","525","401","124","60","585","1216","0","48.11","32.98"
"10","010","00","008","0805","0272","525","401","124","60","585","1216","0","48.11","32.98"
"10","010","00","008","0806","0000","384","309","75","51","435","1200","0","36.25","25.75"
"10","010","00","008","0806","0273","384","309","75","51","435","1200","0","36.25","25.75"
"10","010","00","008","0807","0000","348","269","79","61","409","877","0","46.64","30.67"
"10","010","00","008","0807","0274","348","269","79","61","409","877","0","46.64","30.67"
"10","010","00","008","0808","0000","230","189","41","43","273","644","0","42.39","29.35"
"10","010","00","008","0808","0275","230","189","41","43","273","644","0","42.39","29.35"
"10","010","00","008","0809","0000","224","179","45","19","243","761","0","31.93","23.52"
"10","010","00","008","0809","0276","188","147","41","17","205","594","0","34.51","24.75"
"10","010","00","008","0809","0277","36","32","4","2","38","167","0","22.75","19.16"
"10","010","00","008","0810","0000","222","184","38","47","269","714","0","37.68","25.77"
"10","010","00","008","0810","0283","222","184","38","47","269","714","0","37.68","25.77"
"10","010","00","008","0811","0000","428","351","77","57","485","1051","0","46.15","33.4"
"10","010","00","008","0811","0284","428","351","77","57","485","1051","0","46.15","33.4"
"10","010","00","008","0812","0000","420","323","97","62","482","934","0","51.61","34.58"
"10","010","00","008","0812","0285","420","323","97","62","482","934","0","51.61","34.58"
"10","010","00","008","0813","0000","448","358","90","63","511","1044","0","48.95","34.29"
"10","010","00","008","0813","0286","448","358","90","63","511","1044","0","48.95","34.29"
"10","010","00","008","0814","0000","539","422","117","42","581","1476","0","39.36","28.59"
"10","010","00","008","0814","0287","539","422","117","42","581","1476","0","39.36","28.59"
"10","010","00","008","0815","0000","193","158","35","22","215","618","0","34.79","25.57"
"10","010","00","008","0815","0288","193","158","35","22","215","618","0","34.79","25.57"
"10","010","00","008","0816","0000","112","91","21","50","162","478","0","33.89","19.04"
"10","010","00","008","0816","0289","112","91","21","50","162","478","0","33.89","19.04"
"10","010","00","008","0817","0000","189","147","42","43","232","642","0","36.14","22.9"
"10","010","00","008","0817","0290","189","147","42","43","232","642","0","36.14","22.9"
"10","010","00","008","0818","0000","249","194","55","12","261","883","0","29.56","21.97"
"10","010","00","008","0818","0291","249","194","55","12","261","883","0","29.56","21.97"
"10","010","00","008","0819","0000","538","418","120","70","608","1391","0","43.71","30.05"
"10","010","00","008","0819","0278","67","43","24","1","68","204","0","33.33","21.08"
"10","010","00","008","0819","0279","82","68","14","8","90","234","0","38.46","29.06"
"10","010","00","008","0819","0280","114","93","21","7","121","361","0","33.52","25.76"
"10","010","00","008","0819","0281","275","214","61","54","329","592","0","55.57","36.15"
"10","010","00","008","0820","0000","272","200","72","38","310","619","0","50.08","32.31"
"10","010","00","008","0820","0282","272","200","72","38","310","619","0","50.08","32.31"
"10","010","00","008","0821","0000","306","279","27","4","310","739","0","41.95","37.75"
"10","010","00","008","0821","0292","306","279","27","4","310","739","0","41.95","37.75"
"10","010","00","008","0822","0000","190","144","46","25","215","554","0","38.81","25.99"
"10","010","00","008","0822","0293","190","144","46","25","215","554","0","38.81","25.99"
"10","010","00","008","0823","0000","181","139","42","19","200","649","0","30.82","21.42"
"10","010","00","008","0823","0294","181","139","42","19","200","649","0","30.82","21.42"
"10","010","00","008","0824","0000","199","168","31","32","231","689","0","33.53","24.38"
"10","010","00","008","0824","0295","199","168","31","32","231","689","0","33.53","24.38"
"10","010","00","008","0825","0000","179","131","48","29","208","580","0","35.86","22.59"
"10","010","00","008","0825","0296","146","107","39","25","171","455","0","37.58","23.52"
"10","010","00","008","0825","0297","33","24","9","4","37","125","0","29.6","19.2"
"10","010","00","009","0000","0000","7311","5735","1576","1164","8475","21915","24658","38.67","26.17"
"10","010","00","009","0901","0000","693","545","148","105","798","1915","0","41.67","28.46"
"10","010","00","009","0901","0298","693","545","148","105","798","1915","0","41.67","28.46"
"10","010","00","009","0902","0000","307","241","66","60","367","938","0","39.13","25.69"
"10","010","00","009","0902","0299","307","241","66","60","367","938","0","39.13","25.69"
"10","010","00","009","0903","0000","339","262","77","36","375","1366","0","27.45","19.18"
"10","010","00","009","0903","0300","339","262","77","36","375","1366","0","27.45","19.18"
"10","010","00","009","0904","0000","558","428","130","8","566","1676","0","33.77","25.54"
"10","010","00","009","0904","0301","558","428","130","8","566","1676","0","33.77","25.54"
"10","010","00","009","0905","0000","374","289","85","92","466","1151","0","40.49","25.11"
"10","010","00","009","0905","0302","374","289","85","92","466","1151","0","40.49","25.11"
"10","010","00","009","0906","0000","242","189","53","79","321","716","0","44.83","26.4"
"10","010","00","009","0906","0303","242","189","53","79","321","716","0","44.83","26.4"
"10","010","00","009","0907","0000","115","94","21","9","124","387","0","32.04","24.29"
"10","010","00","009","0907","0304","115","94","21","9","124","387","0","32.04","24.29"
"10","010","00","009","0908","0000","214","178","36","12","226","864","0","26.16","20.6"
"10","010","00","009","0908","0305","214","178","36","12","226","864","0","26.16","20.6"
"10","010","00","009","0909","0000","251","195","56","15","266","910","0","29.23","21.43"
"10","010","00","009","0909","0306","251","195","56","15","266","910","0","29.23","21.43"
"10","010","00","009","0910","0000","225","177","48","15","240","760","0","31.58","23.29"
"10","010","00","009","0910","0307","225","177","48","15","240","760","0","31.58","23.29"
"10","010","00","009","0911","0000","137","103","34","25","162","378","0","42.86","27.25"
"10","010","00","009","0911","0308","74","52","22","11","85","166","0","51.2","31.33"
"10","010","00","009","0911","0309","63","51","12","14","77","212","0","36.32","24.06"
"10","010","00","009","0912","0000","281","227","54","41","322","993","0","32.43","22.86"
"10","010","00","009","0912","0310","281","227","54","41","322","993","0","32.43","22.86"
"10","010","00","009","0913","0000","447","343","104","106","553","1226","0","45.11","27.98"
"10","010","00","009","0913","0314","447","343","104","106","553","1226","0","45.11","27.98"
"10","010","00","009","0914","0000","299","233","66","62","361","843","0","42.82","27.64"
"10","010","00","009","0914","0315","299","233","66","62","361","843","0","42.82","27.64"
"10","010","00","009","0915","0000","247","198","49","31","278","693","0","40.12","28.57"
"10","010","00","009","0915","0316","247","198","49","31","278","693","0","40.12","28.57"
"10","010","00","009","0916","0000","349","285","64","63","412","839","0","49.11","33.97"
"10","010","00","009","0916","0317","349","285","64","63","412","839","0","49.11","33.97"
"10","010","00","009","0917","0000","230","193","37","23","253","684","0","36.99","28.22"
"10","010","00","009","0917","0318","131","112","19","14","145","363","0","39.94","30.85"
"10","010","00","009","0917","0319","99","81","18","9","108","321","0","33.64","25.23"
"10","010","00","009","0918","0000","496","377","119","99","595","1083","0","54.94","34.81"
"10","010","00","009","0918","0320","496","377","119","99","595","1083","0","54.94","34.81"
"10","010","00","009","0919","0000","357","272","85","54","411","901","0","45.62","30.19"
"10","010","00","009","0919","0321","357","272","85","54","411","901","0","45.62","30.19"
"10","010","00","009","0920","0000","333","274","59","32","365","1216","0","30.02","22.53"
"10","010","00","009","0920","0322","333","274","59","32","365","1216","0","30.02","22.53"
"10","010","00","009","0921","0000","350","268","82","54","404","789","0","51.2","33.97"
"10","010","00","009","0921","0323","204","148","56","45","249","418","0","59.57","35.41"
"10","010","00","009","0921","0324","146","120","26","9","155","371","0","41.78","32.35"
"10","010","00","009","0922","0000","95","76","19","14","109","306","0","35.62","24.84"
"10","010","00","009","0922","0311","95","76","19","14","109","306","0","35.62","24.84"
"10","010","00","009","0923","0000","372","288","84","129","501","1281","0","39.11","22.48"
"10","010","00","009","0923","0312","311","242","69","100","411","1046","0","39.29","23.14"
"10","010","00","009","0923","0313","61","46","15","29","90","235","0","38.3","19.57"
"10","010","00","010","0000","0000","7344","5818","1526","901","8245","16647","18297","49.53","34.95"
"10","010","00","010","1001","0000","317","263","54","44","361","705","0","51.21","37.3"
"10","010","00","010","1001","0354","203","170","33","27","230","482","0","47.72","35.27"
"10","010","00","010","1001","0355","114","93","21","17","131","223","0","58.74","41.7"
"10","010","00","010","1002","0000","732","569","163","78","810","1529","0","52.98","37.21"
"10","010","00","010","1002","0356","732","569","163","78","810","1529","0","52.98","37.21"
"10","010","00","010","1003","0000","578","465","113","74","652","1175","0","55.49","39.57"
"10","010","00","010","1003","0357","578","465","113","74","652","1175","0","55.49","39.57"
"10","010","00","010","1004","0000","493","390","103","50","543","886","0","61.29","44.02"
"10","010","00","010","1004","0358","493","390","103","50","543","886","0","61.29","44.02"
"10","010","00","010","1005","0000","297","228","69","38","335","743","0","45.09","30.69"
"10","010","00","010","1005","0359","297","228","69","38","335","743","0","45.09","30.69"
"10","010","00","010","1006","0000","584","454","130","90","674","1236","0","54.53","36.73"
"10","010","00","010","1006","0360","584","454","130","90","674","1236","0","54.53","36.73"
"10","010","00","010","1007","0000","171","146","25","23","194","377","0","51.46","38.73"
"10","010","00","010","1007","0361","171","146","25","23","194","377","0","51.46","38.73"
"10","010","00","010","1008","0000","189","155","34","22","211","440","0","47.95","35.23"
"10","010","00","010","1008","0362","132","110","22","20","152","338","0","44.97","32.54"
"10","010","00","010","1008","0363","57","45","12","2","59","102","0","57.84","44.12"
"10","010","00","010","1009","0000","301","244","57","26","327","763","0","42.86","31.98"
"10","010","00","010","1009","0364","301","244","57","26","327","763","0","42.86","31.98"
"10","010","00","010","1010","0000","210","161","49","30","240","429","0","55.94","37.53"
"10","010","00","010","1010","0365","210","161","49","30","240","429","0","55.94","37.53"
"10","010","00","010","1011","0000","188","150","38","18","206","427","0","48.24","35.13"
"10","010","00","010","1011","0366","188","150","38","18","206","427","0","48.24","35.13"
"10","010","00","010","1012","0000","275","208","67","55","330","607","0","54.37","34.27"
"10","010","00","010","1012","0367","275","208","67","55","330","607","0","54.37","34.27"
"10","010","00","010","1013","0000","617","504","113","43","660","1486","0","44.41","33.92"
"10","010","00","010","1013","0368","617","504","113","43","660","1486","0","44.41","33.92"
"10","010","00","010","1014","0000","414","316","98","60","474","835","0","56.77","37.84"
"10","010","00","010","1014","0369","414","316","98","60","474","835","0","56.77","37.84"
"10","010","00","010","1015","0000","291","231","60","62","353","816","0","43.26","28.31"
"10","010","00","010","1015","0370","291","231","60","62","353","816","0","43.26","28.31"
"10","010","00","010","1016","0000","322","242","80","59","381","833","0","45.74","29.05"
"10","010","00","010","1016","0371","322","242","80","59","381","833","0","45.74","29.05"
"10","010","00","010","1017","0000","198","156","42","13","211","433","0","48.73","36.03"
"10","010","00","010","1017","0372","198","156","42","13","211","433","0","48.73","36.03"
"10","010","00","010","1018","0000","228","188","40","8","236","558","0","42.29","33.69"
"10","010","00","010","1018","0373","228","188","40","8","236","558","0","42.29","33.69"
"10","010","00","010","1019","0000","325","251","74","36","361","742","0","48.65","33.83"
"10","010","00","010","1019","0374","275","210","65","35","310","602","0","51.5","34.88"
"10","010","00","010","1019","0375","50","41","9","1","51","140","0","36.43","29.29"
"10","010","00","010","1020","0000","149","119","30","26","175","393","0","44.53","30.28"
"10","010","00","010","1020","0376","149","119","30","26","175","393","0","44.53","30.28"
"10","010","00","010","1021","0000","258","217","41","25","283","585","0","48.38","37.09"
"10","010","00","010","1021","0377","258","217","41","25","283","585","0","48.38","37.09"
"10","010","00","010","1022","0000","207","161","46","21","228","649","0","35.13","24.81"
"10","010","00","010","1022","0378","152","123","29","9","161","526","0","30.61","23.38"
"10","010","00","010","1022","0379","55","38","17","12","67","123","0","54.47","30.89"
"10","010","00","011","0000","0000","5617","4397","1220","904","6521","13937","15422","46.79","31.55"
"10","010","00","011","1101","0000","192","141","51","48","240","522","0","45.98","27.01"
"10","010","00","011","1101","0034","192","141","51","48","240","522","0","45.98","27.01"
"10","010","00","011","1102","0000","255","200","55","44","299","563","0","53.11","35.52"
"10","010","00","011","1102","0035","255","200","55","44","299","563","0","53.11","35.52"
"10","010","00","011","1103","0000","557","424","133","81","638","1304","0","48.93","32.52"
"10","010","00","011","1103","0036","557","424","133","81","638","1304","0","48.93","32.52"
"10","010","00","011","1104","0000","592","436","156","65","657","1312","0","50.08","33.23"
"10","010","00","011","1104","0037","592","436","156","65","657","1312","0","50.08","33.23"
"10","010","00","011","1105","0000","233","189","44","5","238","738","0","32.25","25.61"
"10","010","00","011","1105","0038","127","101","26","1","128","320","0","40.0","31.56"
"10","010","00","011","1105","0039","106","88","18","4","110","418","0","26.32","21.05"
"10","010","00","011","1106","0000","376","305","71","61","437","1025","0","42.63","29.76"
"10","010","00","011","1106","0040","376","305","71","61","437","1025","0","42.63","29.76"
"10","010","00","011","1107","0000","164","129","35","21","185","451","0","41.02","28.6"
"10","010","00","011","1107","0041","164","129","35","21","185","451","0","41.02","28.6"
"10","010","00","011","1108","0000","348","278","70","95","443","830","0","53.37","33.49"
"10","010","00","011","1108","0042","348","278","70","95","443","830","0","53.37","33.49"
"10","010","00","011","1109","0000","406","315","91","83","489","1050","0","46.57","30.0"
"10","010","00","011","1109","0043","406","315","91","83","489","1050","0","46.57","30.0"
"10","010","00","011","1110","0000","343","283","60","57","400","972","0","41.15","29.12"
"10","010","00","011","1110","0044","343","283","60","57","400","972","0","41.15","29.12"
"10","010","00","011","1111","0000","372","296","76","68","440","962","0","45.74","30.77"
"10","010","00","011","1111","0045","372","296","76","68","440","962","0","45.74","30.77"
"10","010","00","011","1112","0000","428","342","86","83","511","940","0","54.36","36.38"
"10","010","00","011","1112","0046","321","256","65","55","376","678","0","55.46","37.76"
"10","010","00","011","1112","0047","107","86","21","28","135","262","0","51.53","32.82"
"10","010","00","011","1113","0000","433","348","85","61","494","1212","0","40.76","28.71"
"10","010","00","011","1113","0048","339","270","69","50","389","906","0","42.94","29.8"
"10","010","00","011","1113","0049","94","78","16","11","105","306","0","34.31","25.49"
"10","010","00","011","1114","0000","639","483","156","90","729","1435","0","50.8","33.66"
"10","010","00","011","1114","0050","466","364","102","68","534","1062","0","50.28","34.27"
"10","010","00","011","1114","0051","173","119","54","22","195","373","0","52.28","31.9"
"10","010","00","011","1115","0000","279","228","51","42","321","621","0","51.69","36.71"
"10","010","00","011","1115","0052","152","121","31","23","175","324","0","54.01","37.35"
"10","010","00","011","1115","0053","127","107","20","19","146","297","0","49.16","36.03"
"10","010","00","012","0000","0000","20852","16150","4702","2000","22852","43857","49406","52.11","36.82"
"10","010","00","012","1201","0000","1912","1488","424","143","2055","3971","0","51.75","37.47"
"10","010","00","012","1201","0054","477","377","100","26","503","1024","0","49.12","36.82"
"10","010","00","012","1201","0055","558","429","129","54","612","1015","0","60.3","42.27"
"10","010","00","012","1201","0056","877","682","195","63","940","1932","0","48.65","35.3"
"10","010","00","012","1202","0000","1318","1042","276","126","1444","2475","0","58.34","42.1"
"10","010","00","012","1202","0057","630","490","140","49","679","1170","0","58.03","41.88"
"10","010","00","012","1202","0058","688","552","136","77","765","1305","0","58.62","42.3"
"10","010","00","012","1203","0000","832","649","183","103","935","1564","0","59.78","41.5"
"10","010","00","012","1203","0066","358","285","73","48","406","626","0","64.86","45.53"
"10","010","00","012","1203","0067","304","238","66","33","337","570","0","59.12","41.75"
"10","010","00","012","1203","0068","170","126","44","22","192","368","0","52.17","34.24"
"10","010","00","012","1204","0000","949","730","219","160","1109","2102","0","52.76","34.73"
"10","010","00","012","1204","0069","442","339","103","92","534","1037","0","51.49","32.69"
"10","010","00","012","1204","0070","507","391","116","68","575","1065","0","53.99","36.71"
"10","010","00","012","1205","0000","436","332","104","72","508","802","0","63.34","41.4"
"10","010","00","012","1205","0071","436","332","104","72","508","802","0","63.34","41.4"
"10","010","00","012","1206","0000","699","533","166","77","776","1566","0","49.55","34.04"
"10","010","00","012","1206","0059","557","426","131","59","616","1242","0","49.6","34.3"
"10","010","00","012","1206","0060","142","107","35","18","160","324","0","49.38","33.02"
"10","010","00","012","1207","0000","851","681","170","111","962","1838","0","52.34","37.05"
"10","010","00","012","1207","0061","302","233","69","22","324","622","0","52.09","37.46"
"10","010","00","012","1207","0062","549","448","101","89","638","1216","0","52.47","36.84"
"10","010","00","012","1208","0000","968","772","196","70","1038","1791","0","57.96","43.1"
"10","010","00","012","1208","0063","525","420","105","33","558","1020","0","54.71","41.18"
"10","010","00","012","1208","0064","443","352","91","37","480","771","0","62.26","45.65"
"10","010","00","012","1209","0000","252","202","50","24","276","441","0","62.59","45.8"
"10","010","00","012","1209","0065","252","202","50","24","276","441","0","62.59","45.8"
"10","010","00","012","1210","0000","346","279","67","25","371","641","0","57.88","43.53"
"10","010","00","012","1210","0074","346","279","67","25","371","641","0","57.88","43.53"
"10","010","00","012","1211","0000","211","174","37","14","225","408","0","55.15","42.65"
"10","010","00","012","1211","0075","211","174","37","14","225","408","0","55.15","42.65"
"10","010","00","012","1212","0000","645","484","161","81","726","1363","0","53.26","35.51"
"10","010","00","012","1212","0076","414","309","105","43","457","794","0","57.56","38.92"
"10","010","00","012","1212","0077","231","175","56","38","269","569","0","47.28","30.76"
"10","010","00","012","1213","0000","872","670","202","40","912","1948","0","46.82","34.39"
"10","010","00","012","1213","0072","872","670","202","40","912","1948","0","46.82","34.39"
"10","010","00","012","1214","0000","460","359","101","61","521","1028","0","50.68","34.92"
"10","010","00","012","1214","0073","460","359","101","61","521","1028","0","50.68","34.92"
"10","010","00","012","1215","0000","1004","769","235","108","1112","2035","0","54.64","37.79"
"10","010","00","012","1215","0080","1004","769","235","108","1112","2035","0","54.64","37.79"
"10","010","00","012","1216","0000","919","694","225","91","1010","1987","0","50.83","34.93"
"10","010","00","012","1216","0081","919","694","225","91","1010","1987","0","50.83","34.93"
"10","010","00","012","1217","0000","921","727","194","81","1002","1766","0","56.74","41.17"
"10","010","00","012","1217","0078","412","315","97","39","451","806","0","55.96","39.08"
"10","010","00","012","1217","0079","509","412","97","42","551","960","0","57.4","42.92"
"10","010","00","012","1218","0000","1905","1459","446","139","2044","4310","0","47.42","33.85"
"10","010","00","012","1218","0083","1031","791","240","77","1108","2208","0","50.18","35.82"
"10","010","00","012","1218","0084","874","668","206","62","936","2102","0","44.53","31.78"
"10","010","00","012","1219","0000","1418","1087","331","141","1559","2980","0","52.32","36.48"
"10","010","00","012","1219","0085","591","465","126","61","652","1309","0","49.81","35.52"
"10","010","00","012","1219","0086","827","622","205","80","907","1671","0","54.28","37.22"
"10","010","00","012","1220","0000","902","673","229","87","989","1919","0","51.54","35.07"
"10","010","00","012","1220","0089","902","673","229","87","989","1919","0","51.54","35.07"
"10","010","00","012","1221","0000","781","578","203","54","835","1772","0","47.12","32.62"
"10","010","00","012","1221","0088","781","578","203","54","835","1772","0","47.12","32.62"
"10","010","00","012","1222","0000","339","267","72","27","366","912","0","40.13","29.28"
"10","010","00","012","1222","0090","339","267","72","27","366","912","0","40.13","29.28"
"10","010","00","012","1223","0000","448","365","83","23","471","992","0","47.48","36.79"
"10","010","00","012","1223","0091","448","365","83","23","471","992","0","47.48","36.79"
"10","010","00","012","1224","0000","482","354","128","81","563","1270","0","44.33","27.87"
"10","010","00","012","1224","0092","482","354","128","81","563","1270","0","44.33","27.87"
"10","010","00","012","1225","0000","580","462","118","21","601","1154","0","52.08","40.03"
"10","010","00","012","1225","0082","580","462","118","21","601","1154","0","52.08","40.03"
"10","010","00","012","1226","0000","402","320","82","40","442","822","0","53.77","38.93"
"10","010","00","012","1226","0087","402","320","82","40","442","822","0","53.77","38.93"
"10","010","00","013","0000","0000","16379","12785","3594","1538","17917","39139","44605","45.78","32.67"
"10","010","00","013","1301","0000","734","566","168","85","819","1809","0","45.27","31.29"
"10","010","00","013","1301","0392","734","566","168","85","819","1809","0","45.27","31.29"
"10","010","00","013","1302","0000","422","318","104","29","451","953","0","47.32","33.37"
"10","010","00","013","1302","0393","422","318","104","29","451","953","0","47.32","33.37"
"10","010","00","013","1303","0000","306","247","59","12","318","828","0","38.41","29.83"
"10","010","00","013","1303","0401","306","247","59","12","318","828","0","38.41","29.83"
"10","010","00","013","1304","0000","344","266","78","47","391","879","0","44.48","30.26"
"10","010","00","013","1304","0400","344","266","78","47","391","879","0","44.48","30.26"
"10","010","00","013","1305","0000","602","464","138","66","668","1441","0","46.36","32.2"
"10","010","00","013","1305","0394","602","464","138","66","668","1441","0","46.36","32.2"
"10","010","00","013","1306","0000","1135","889","246","104","1239","2834","0","43.72","31.37"
"10","010","00","013","1306","0380","389","305","84","13","402","1046","0","38.43","29.16"
"10","010","00","013","1306","0381","746","584","162","91","837","1788","0","46.81","32.66"
"10","010","00","013","1307","0000","1429","1078","351","110","1539","3311","0","46.48","32.56"
"10","010","00","013","1307","0382","720","526","194","47","767","1730","0","44.34","30.4"
"10","010","00","013","1307","0383","709","552","157","63","772","1581","0","48.83","34.91"
"10","010","00","013","1308","0000","3049","2376","673","204","3253","7060","0","46.08","33.65"
"10","010","00","013","1308","0384","635","487","148","44","679","1594","0","42.6","30.55"
"10","010","00","013","1308","0385","834","640","194","48","882","1801","0","48.97","35.54"
"10","010","00","013","1308","0386","838","678","160","79","917","1862","0","49.25","36.41"
"10","010","00","013","1308","0387","742","571","171","33","775","1803","0","42.98","31.67"
"10","010","00","013","1309","0000","2541","1976","565","236","2777","5642","0","49.22","35.02"
"10","010","00","013","1309","0388","708","557","151","60","768","1481","0","51.86","37.61"
"10","010","00","013","1309","0389","654","515","139","64","718","1366","0","52.56","37.7"
"10","010","00","013","1309","0390","635","476","159","74","709","1599","0","44.34","29.77"
"10","010","00","013","1309","0391","544","428","116","38","582","1196","0","48.66","35.79"
"10","010","00","013","1310","0000","797","627","170","68","865","1882","0","45.96","33.32"
"10","010","00","013","1310","0395","797","627","170","68","865","1882","0","45.96","33.32"
"10","010","00","013","1311","0000","478","379","99","25","503","1470","0","34.22","25.78"
"10","010","00","013","1311","0396","478","379","99","25","503","1470","0","34.22","25.78"
"10","010","00","013","1312","0000","828","686","142","95","923","2121","0","43.52","32.34"
"10","010","00","013","1312","0397","670","552","118","80","750","1699","0","44.14","32.49"
"10","010","00","013","1312","0398","158","134","24","15","173","422","0","41.0","31.75"
"10","010","00","013","1313","0000","444","338","106","70","514","1030","0","49.9","32.82"
"10","010","00","013","1313","0399","444","338","106","70","514","1030","0","49.9","32.82"
"10","010","00","013","1314","0000","574","456","118","71","645","1177","0","54.8","38.74"
"10","010","00","013","1314","0402","443","361","82","54","497","881","0","56.41","40.98"
"10","010","00","013","1314","0403","131","95","36","17","148","296","0","50.0","32.09"
"10","010","00","013","1315","0000","388","287","101","91","479","979","0","48.93","29.32"
"10","010","00","013","1315","0404","388","287","101","91","479","979","0","48.93","29.32"
"10","010","00","013","1316","0000","665","514","151","46","711","1938","0","36.69","26.52"
"10","010","00","013","1316","0405","488","377","111","35","523","1268","0","41.25","29.73"
"10","010","00","013","1316","0406","177","137","40","11","188","670","0","28.06","20.45"
"10","010","00","013","1317","0000","274","217","57","19","293","741","0","39.54","29.28"
"10","010","00","013","1317","0409","274","217","57","19","293","741","0","39.54","29.28"
"10","010","00","013","1318","0000","415","333","82","39","454","1000","0","45.4","33.3"
"10","010","00","013","1318","0410","209","181","28","4","213","518","0","41.12","34.94"
"10","010","00","013","1318","0411","206","152","54","35","241","482","0","50.0","31.54"
"10","010","00","013","1319","0000","317","257","60","39","356","648","0","54.94","39.66"
"10","010","00","013","1319","0408","317","257","60","39","356","648","0","54.94","39.66"
"10","010","00","013","1320","0000","371","293","78","60","431","754","0","57.16","38.86"
"10","010","00","013","1320","0407","371","293","78","60","431","754","0","57.16","38.86"
"10","010","00","013","1321","0000","135","112","23","8","143","348","0","41.09","32.18"
"10","010","00","013","1321","0412","135","112","23","8","143","348","0","41.09","32.18"
"10","010","00","013","1322","0000","131","106","25","14","145","294","0","49.32","36.05"
"10","010","00","013","1322","0413","131","106","25","14","145","294","0","49.32","36.05"
"10","010","00","014","0000","0000","14186","11147","3039","1393","15579","31228","35625","49.89","35.7"
"10","010","00","014","1401","0000","1195","960","235","68","1263","2522","0","50.08","38.07"
"10","010","00","014","1401","0414","599","473","126","43","642","1312","0","48.93","36.05"
"10","010","00","014","1401","0415","596","487","109","25","621","1210","0","51.32","40.25"
"10","010","00","014","1402","0000","1052","828","224","98","1150","2198","0","52.32","37.67"
"10","010","00","014","1402","0416","498","390","108","56","554","991","0","55.9","39.35"
"10","010","00","014","1402","0417","554","438","116","42","596","1207","0","49.38","36.29"
"10","010","00","014","1403","0000","287","203","84","15","302","752","0","40.16","26.99"
"10","010","00","014","1403","0418","287","203","84","15","302","752","0","40.16","26.99"
"10","010","00","014","1404","0000","426","323","103","57","483","833","0","57.98","38.78"
"10","010","00","014","1404","0419","426","323","103","57","483","833","0","57.98","38.78"
"10","010","00","014","1405","0000","608","459","149","80","688","1220","0","56.39","37.62"
"10","010","00","014","1405","0420","608","459","149","80","688","1220","0","56.39","37.62"
"10","010","00","014","1406","0000","317","258","59","18","335","616","0","54.38","41.88"
"10","010","00","014","1406","0421","317","258","59","18","335","616","0","54.38","41.88"
"10","010","00","014","1407","0000","469","356","113","59","528","1031","0","51.21","34.53"
"10","010","00","014","1407","0422","469","356","113","59","528","1031","0","51.21","34.53"
"10","010","00","014","1408","0000","2413","1908","505","223","2636","5283","0","49.9","36.12"
"10","010","00","014","1408","0423","537","423","114","129","666","1292","0","51.55","32.74"
"10","010","00","014","1408","0424","1024","813","211","69","1093","1995","0","54.79","40.75"
"10","010","00","014","1408","0425","852","672","180","25","877","1996","0","43.94","33.67"
"10","010","00","014","1409","0000","677","536","141","80","757","1449","0","52.24","36.99"
"10","010","00","014","1409","0426","677","536","141","80","757","1449","0","52.24","36.99"
"10","010","00","014","1410","0000","659","536","123","33","692","1420","0","48.73","37.75"
"10","010","00","014","1410","0427","659","536","123","33","692","1420","0","48.73","37.75"
"10","010","00","014","1411","0000","774","595","179","65","839","1590","0","52.77","37.42"
"10","010","00","014","1411","0428","774","595","179","65","839","1590","0","52.77","37.42"
"10","010","00","014","1412","0000","779","581","198","94","873","1785","0","48.91","32.55"
"10","010","00","014","1412","0429","352","274","78","39","391","771","0","50.71","35.54"
"10","010","00","014","1412","0430","427","307","120","55","482","1014","0","47.53","30.28"
"10","010","00","014","1413","0000","268","217","51","23","291","641","0","45.4","33.85"
"10","010","00","014","1413","0433","268","217","51","23","291","641","0","45.4","33.85"
"10","010","00","014","1414","0000","422","332","90","41","463","1014","0","45.66","32.74"
"10","010","00","014","1414","0431","96","72","24","11","107","327","0","32.72","22.02"
"10","010","00","014","1414","0432","326","260","66","30","356","687","0","51.82","37.85"
"10","010","00","014","1415","0000","374","321","53","36","410","857","0","47.84","37.46"
"10","010","00","014","1415","0434","217","183","34","6","223","474","0","47.05","38.61"
"10","010","00","014","1415","0435","157","138","19","30","187","383","0","48.83","36.03"
"10","010","00","014","1416","0000","319","263","56","55","374","619","0","60.42","42.49"
"10","010","00","014","1416","0436","319","263","56","55","374","619","0","60.42","42.49"
"10","010","00","014","1417","0000","802","627","175","113","915","1782","0","51.35","35.19"
"10","010","00","014","1417","0437","88","76","12","10","98","214","0","45.79","35.51"
"10","010","00","014","1417","0438","714","551","163","103","817","1568","0","52.1","35.14"
"10","010","00","014","1418","0000","254","204","50","37","291","658","0","44.22","31.0"
"10","010","00","014","1418","0439","254","204","50","37","291","658","0","44.22","31.0"
"10","010","00","014","1419","0000","223","171","52","31","254","434","0","58.53","39.4"
"10","010","00","014","1419","0440","223","171","52","31","254","434","0","58.53","39.4"
"10","010","00","014","1420","0000","860","668","192","100","960","1898","0","50.58","35.19"
"10","010","00","014","1420","0441","433","350","83","57","490","917","0","53.44","38.17"
"10","010","00","014","1420","0442","427","318","109","43","470","981","0","47.91","32.42"
"10","010","00","014","1421","0000","317","256","61","23","340","897","0","37.9","28.54"
"10","010","00","014","1421","0443","292","233","59","20","312","789","0","39.54","29.53"
"10","010","00","014","1421","0444","25","23","2","3","28","108","0","25.93","21.3"
"10","010","00","014","1422","0000","47","42","5","2","49","235","0","20.85","17.87"
"10","010","00","014","1422","0445","47","42","5","2","49","235","0","20.85","17.87"
"10","010","00","014","1423","0000","389","288","101","20","409","781","0","52.37","36.88"
"10","010","00","014","1423","0446","131","100","31","5","136","331","0","41.09","30.21"
"10","010","00","014","1423","0447","258","188","70","15","273","450","0","60.67","41.78"
"10","010","00","014","1424","0000","255","215","40","22","277","713","0","38.85","30.15"
"10","010","00","014","1424","0448","166","140","26","7","173","462","0","37.45","30.3"
"10","010","00","014","1424","0449","89","75","14","15","104","251","0","41.43","29.88"
"10","010","00","015","0000","0000","8373","6588","1785","882","9255","17083","19303","54.18","38.56"
"10","010","00","015","1501","0000","1133","866","267","115","1248","2286","0","54.59","37.88"
"10","010","00","015","1501","0211","485","379","106","31","516","1041","0","49.57","36.41"
"10","010","00","015","1501","0212","648","487","161","84","732","1245","0","58.8","39.12"
"10","010","00","015","1502","0000","511","409","102","54","565","917","0","61.61","44.6"
"10","010","00","015","1502","0213","511","409","102","54","565","917","0","61.61","44.6"
"10","010","00","015","1503","0000","304","238","66","39","343","545","0","62.94","43.67"
"10","010","00","015","1503","0217","304","238","66","39","343","545","0","62.94","43.67"
"10","010","00","015","1504","0000","2176","1730","446","190","2366","4404","0","53.72","39.28"
"10","010","00","015","1504","0214","578","450","128","52","630","1189","0","52.99","37.85"
"10","010","00","015","1504","0215","717","571","146","69","786","1388","0","56.63","41.14"
"10","010","00","015","1504","0216","881","709","172","69","950","1827","0","52.0","38.81"
"10","010","00","015","1505","0000","148","121","27","35","183","407","0","44.96","29.73"
"10","010","00","015","1505","0218","148","121","27","35","183","407","0","44.96","29.73"
"10","010","00","015","1506","0000","293","200","93","41","334","526","0","63.5","38.02"
"10","010","00","015","1506","0223","293","200","93","41","334","526","0","63.5","38.02"
"10","010","00","015","1507","0000","149","116","33","31","180","372","0","48.39","31.18"
"10","010","00","015","1507","0224","149","116","33","31","180","372","0","48.39","31.18"
"10","010","00","015","1508","0000","313","227","86","26","339","636","0","53.3","35.69"
"10","010","00","015","1508","0219","313","227","86","26","339","636","0","53.3","35.69"
"10","010","00","015","1509","0000","822","647","175","89","911","1674","0","54.42","38.65"
"10","010","00","015","1509","0221","822","647","175","89","911","1674","0","54.42","38.65"
"10","010","00","015","1510","0000","281","218","63","48","329","576","0","57.12","37.85"
"10","010","00","015","1510","0220","281","218","63","48","329","576","0","57.12","37.85"
"10","010","00","015","1511","0000","348","279","69","11","359","858","0","41.84","32.52"
"10","010","00","015","1511","0222","348","279","69","11","359","858","0","41.84","32.52"
"10","010","00","015","1512","0000","230","194","36","24","254","506","0","50.2","38.34"
"10","010","00","015","1512","0225","230","194","36","24","254","506","0","50.2","38.34"
"10","010","00","015","1513","0000","124","97","27","21","145","293","0","49.49","33.11"
"10","010","00","015","1513","0228","124","97","27","21","145","293","0","49.49","33.11"
"10","010","00","015","1514","0000","270","229","41","34","304","433","0","70.21","52.89"
"10","010","00","015","1514","0226","270","229","41","34","304","433","0","70.21","52.89"
"10","010","00","015","1515","0000","404","329","75","43","447","712","0","62.78","46.21"
"10","010","00","015","1515","0229","404","329","75","43","447","712","0","62.78","46.21"
"10","010","00","015","1516","0000","340","258","82","33","373","602","0","61.96","42.86"
"10","010","00","015","1516","0230","340","258","82","33","373","602","0","61.96","42.86"
"10","010","00","015","1517","0000","380","309","71","34","414","932","0","44.42","33.15"
"10","010","00","015","1517","0231","228","182","46","22","250","515","0","48.54","35.34"
"10","010","00","015","1517","0232","152","127","25","12","164","417","0","39.33","30.46"
"10","010","00","015","1518","0000","147","121","26","14","161","404","0","39.85","29.95"
"10","010","00","015","1518","0227","147","121","26","14","161","404","0","39.85","29.95"
"10","010","00","016","0000","0000","5057","4089","968","508","5565","10156","11470","54.8","40.26"
"10","010","00","016","1601","0000","635","499","136","71","706","1174","0","60.14","42.5"
"10","010","00","016","1601","0450","635","499","136","71","706","1174","0","60.14","42.5"
"10","010","00","016","1602","0000","244","199","45","13","257","449","0","57.24","44.32"
"10","010","00","016","1602","0451","244","199","45","13","257","449","0","57.24","44.32"
"10","010","00","016","1603","0000","631","512","119","71","702","1304","0","53.83","39.26"
"10","010","00","016","1603","0452","399","326","73","43","442","753","0","58.7","43.29"
"10","010","00","016","1603","0453","232","186","46","28","260","551","0","47.19","33.76"
"10","010","00","016","1604","0000","919","749","170","82","1001","1791","0","55.89","41.82"
"10","010","00","016","1604","0454","919","749","170","82","1001","1791","0","55.89","41.82"
"10","010","00","016","1605","0000","477","353","124","61","538","849","0","63.37","41.58"
"10","010","00","016","1605","0455","477","353","124","61","538","849","0","63.37","41.58"
"10","010","00","016","1606","0000","440","350","90","49","489","866","0","56.47","40.42"
"10","010","00","016","1606","0456","440","350","90","49","489","866","0","56.47","40.42"
"10","010","00","016","1607","0000","621","503","118","68","689","1244","0","55.39","40.43"
"10","010","00","016","1607","0457","408","348","60","31","439","800","0","54.88","43.5"
"10","010","00","016","1607","0458","213","155","58","37","250","444","0","56.31","34.91"
"10","010","00","016","1608","0000","225","182","43","19","244","635","0","38.43","28.66"
"10","010","00","016","1608","0459","225","182","43","19","244","635","0","38.43","28.66"
"10","010","00","016","1609","0000","481","422","59","39","520","961","0","54.11","43.91"
"10","010","00","016","1609","0460","131","112","19","12","143","319","0","44.83","35.11"
"10","010","00","016","1609","0461","350","310","40","27","377","642","0","58.72","48.29"
"10","010","00","016","1610","0000","202","165","37","26","228","509","0","44.79","32.42"
"10","010","00","016","1610","0462","202","165","37","26","228","509","0","44.79","32.42"
"10","010","00","016","1611","0000","182","155","27","9","191","374","0","51.07","41.44"
"10","010","00","016","1611","0463","78","68","10","0","78","162","0","48.15","41.98"
"10","010","00","016","1611","0464","104","87","17","9","113","212","0","53.3","41.04"
"10","010","00","017","0000","0000","1947","1555","392","167","2114","3999","4592","52.86","38.88"
"10","010","00","017","1701","0000","715","568","147","87","802","1468","0","54.63","38.69"
"10","010","00","017","1701","0465","715","568","147","87","802","1468","0","54.63","38.69"
"10","010","00","017","1702","0000","255","211","44","23","278","624","0","44.55","33.81"
"10","010","00","017","1702","0466","96","92","4","15","111","320","0","34.69","28.75"
"10","010","00","017","1702","0467","159","119","40","8","167","304","0","54.93","39.14"
"10","010","00","017","1703","0000","232","180","52","15","247","418","0","59.09","43.06"
"10","010","00","017","1703","0468","89","74","15","4","93","184","0","50.54","40.22"
"10","010","00","017","1703","0469","143","106","37","11","154","234","0","65.81","45.3"
"10","010","00","017","1704","0000","418","338","80","21","439","920","0","47.72","36.74"
"10","010","00","017","1704","0470","227","186","41","9","236","495","0","47.68","37.58"
"10","010","00","017","1704","0471","100","81","19","2","102","199","0","51.26","40.7"
"10","010","00","017","1704","0472","91","71","20","10","101","226","0","44.69","31.42"
"10","010","00","017","1705","0000","327","258","69","21","348","569","0","61.16","45.34"
"10","010","00","017","1705","0473","327","258","69","21","348","569","0","61.16","45.34"
"10","010","00","018","0000","0000","1592","1295","297","447","2039","4691","5610","43.47","27.61"
"10","010","00","018","1801","0000","159","130","29","8","167","371","0","45.01","35.04"
"10","010","00","018","1801","0474","159","130","29","8","167","371","0","45.01","35.04"
"10","010","00","018","1802","0000","75","65","10","9","84","197","0","42.64","32.99"
"10","010","00","018","1802","0475","75","65","10","9","84","197","0","42.64","32.99"
"10","010","00","018","1803","0000","66","61","5","3","69","152","0","45.39","40.13"
"10","010","00","018","1803","0476","66","61","5","3","69","152","0","45.39","40.13"
"10","010","00","018","1804","0000","89","75","14","6","95","303","0","31.35","24.75"
"10","010","00","018","1804","0477","69","59","10","5","74","231","0","32.03","25.54"
"10","010","00","018","1804","0478","20","16","4","1","21","72","0","29.17","22.22"
"10","010","00","018","1805","0000","150","128","22","14","164","306","0","53.59","41.83"
"10","010","00","018","1805","0480","150","128","22","14","164","306","0","53.59","41.83"
"10","010","00","018","1806","0000","110","98","12","3","113","311","0","36.33","31.51"
"10","010","00","018","1806","0479","110","98","12","3","113","311","0","36.33","31.51"
"10","010","00","018","1807","0000","93","23","70","361","454","827","0","54.9","2.78"
"10","010","00","018","1807","0482","93","23","70","361","454","827","0","54.9","2.78"
"10","010","00","018","1808","0000","404","342","62","7","411","970","0","42.37","35.26"
"10","010","00","018","1808","0481","404","342","62","7","411","970","0","42.37","35.26"
"10","010","00","018","1809","0000","112","92","20","2","114","238","0","47.9","38.66"
"10","010","00","018","1809","0483","112","92","20","2","114","238","0","47.9","38.66"
"10","010","00","018","1810","0000","110","87","23","7","117","479","0","24.43","18.16"
"10","010","00","018","1810","0484","110","87","23","7","117","479","0","24.43","18.16"
"10","010","00","018","1811","0000","89","77","12","5","94","291","0","32.3","26.46"
"10","010","00","018","1811","0485","89","77","12","5","94","291","0","32.3","26.46"
"10","010","00","018","1812","0000","135","117","18","22","157","246","0","63.82","47.56"
"10","010","00","018","1812","0486","135","117","18","22","157","246","0","63.82","47.56"
"10","013","00","000","0000","0000","330016","259443","70573","33128","363144","711720","826779","51.02","36.45"
"10","013","00","001","0000","0000","83234","66120","17114","5603","88837","170148","199807","52.21","38.86"
"10","013","00","001","0101","0000","372","281","91","25","397","713","0","55.68","39.41"
"10","013","00","001","0101","0004","372","281","91","25","397","713","0","55.68","39.41"
"10","013","00","001","0102","0000","142","123","19","1","143","249","0","57.43","49.4"
"10","013","00","001","0102","0007","142","123","19","1","143","249","0","57.43","49.4"
"10","013","00","001","0103","0000","139","100","39","26","165","294","0","56.12","34.01"
"10","013","00","001","0103","0002","139","100","39","26","165","294","0","56.12","34.01"
"10","013","00","001","0104","0000","283","206","77","12","295","582","0","50.69","35.4"
"10","013","00","001","0104","0003","283","206","77","12","295","582","0","50.69","35.4"
"10","013","00","001","0105","0000","267","210","57","13","280","455","0","61.54","46.15"
"10","013","00","001","0105","0006","267","210","57","13","280","455","0","61.54","46.15"
"10","013","00","001","0106","0000","118","82","36","10","128","237","0","54.01","34.6"
"10","013","00","001","0106","0001","118","82","36","10","128","237","0","54.01","34.6"
"10","013","00","001","0107","0000","282","213","69","33","315","572","0","55.07","37.24"
"10","013","00","001","0107","0005","282","213","69","33","315","572","0","55.07","37.24"
"10","013","00","001","0108","0000","398","312","86","40","438","713","0","61.43","43.76"
"10","013","00","001","0108","0010","398","312","86","40","438","713","0","61.43","43.76"
"10","013","00","001","0109","0000","317","248","69","48","365","573","0","63.7","43.28"
"10","013","00","001","0109","0011","317","248","69","48","365","573","0","63.7","43.28"
"10","013","00","001","0110","0000","258","202","56","23","281","409","0","68.7","49.39"
"10","013","00","001","0110","0013","258","202","56","23","281","409","0","68.7","49.39"
"10","013","00","001","0111","0000","176","128","48","23","199","297","0","67.0","43.1"
"10","013","00","001","0111","0012","176","128","48","23","199","297","0","67.0","43.1"
"10","013","00","001","0112","0000","1091","806","285","69","1160","2688","0","43.15","29.99"
"10","013","00","001","0112","0008","507","392","115","31","538","1315","0","40.91","29.81"
"10","013","00","001","0112","0009","584","414","170","38","622","1373","0","45.3","30.15"
"10","013","00","001","0113","0000","231","155","76","18","249","459","0","54.25","33.77"
"10","013","00","001","0113","0017","231","155","76","18","249","459","0","54.25","33.77"
"10","013","00","001","0114","0000","394","294","100","19","413","672","0","61.46","43.75"
"10","013","00","001","0114","0018","394","294","100","19","413","672","0","61.46","43.75"
"10","013","00","001","0115","0000","205","150","55","19","224","421","0","53.21","35.63"
"10","013","00","001","0115","0015","205","150","55","19","224","421","0","53.21","35.63"
"10","013","00","001","0116","0000","310","232","78","13","323","569","0","56.77","40.77"
"10","013","00","001","0116","0016","310","232","78","13","323","569","0","56.77","40.77"
"10","013","00","001","0117","0000","142","98","44","18","160","286","0","55.94","34.27"
"10","013","00","001","0117","0014","142","98","44","18","160","286","0","55.94","34.27"
"10","013","00","001","0118","0000","379","276","103","44","423","668","0","63.32","41.32"
"10","013","00","001","0118","0019","379","276","103","44","423","668","0","63.32","41.32"
"10","013","00","001","0119","0000","221","170","51","14","235","411","0","57.18","41.36"
"10","013","00","001","0119","0020","221","170","51","14","235","411","0","57.18","41.36"
"10","013","00","001","0120","0000","812","630","182","63","875","1554","0","56.31","40.54"
"10","013","00","001","0120","0021","405","295","110","34","439","768","0","57.16","38.41"
"10","013","00","001","0120","0022","407","335","72","29","436","786","0","55.47","42.62"
"10","013","00","001","0121","0000","484","382","102","36","520","890","0","58.43","42.92"
"10","013","00","001","0121","0023","484","382","102","36","520","890","0","58.43","42.92"
"10","013","00","001","0122","0000","1011","799","212","73","1084","1911","0","56.72","41.81"
"10","013","00","001","0122","0039","483","381","102","40","523","939","0","55.7","40.58"
"10","013","00","001","0122","0040","528","418","110","33","561","972","0","57.72","43.0"
"10","013","00","001","0123","0000","1317","989","328","103","1420","2517","0","56.42","39.29"
"10","013","00","001","0123","0034","685","527","158","51","736","1258","0","58.51","41.89"
"10","013","00","001","0123","0035","632","462","170","52","684","1259","0","54.33","36.7"
"10","013","00","001","0124","0000","1875","1491","384","115","1990","3556","0","55.96","41.93"
"10","013","00","001","0124","0036","540","432","108","41","581","1076","0","54.0","40.15"
"10","013","00","001","0124","0037","627","503","124","39","666","1162","0","57.31","43.29"
"10","013","00","001","0124","0038","708","556","152","35","743","1318","0","56.37","42.19"
"10","013","00","001","0125","0000","2025","1615","410","129","2154","4039","0","53.33","39.99"
"10","013","00","001","0125","0031","678","541","137","52","730","1297","0","56.28","41.71"
"10","013","00","001","0125","0032","681","555","126","33","714","1361","0","52.46","40.78"
"10","013","00","001","0125","0033","666","519","147","44","710","1381","0","51.41","37.58"
"10","013","00","001","0126","0000","4823","3668","1155","246","5069","9307","0","54.46","39.41"
"10","013","00","001","0126","0024","719","578","141","41","760","1353","0","56.17","42.72"
"10","013","00","001","0126","0025","689","353","336","34","723","1386","0","52.16","25.47"
"10","013","00","001","0126","0026","721","581","140","37","758","1413","0","53.64","41.12"
"10","013","00","001","0126","0027","653","530","123","36","689","1272","0","54.17","41.67"
"10","013","00","001","0126","0028","662","539","123","29","691","1287","0","53.69","41.88"
"10","013","00","001","0126","0029","712","584","128","45","757","1311","0","57.74","44.55"
"10","013","00","001","0126","0030","667","503","164","24","691","1285","0","53.77","39.14"
"10","013","00","001","0127","0000","636","496","140","104","740","1540","0","48.05","32.21"
"10","013","00","001","0127","0047","636","496","140","104","740","1540","0","48.05","32.21"
"10","013","00","001","0128","0000","536","409","127","56","592","1061","0","55.8","38.55"
"10","013","00","001","0128","0046","536","409","127","56","592","1061","0","55.8","38.55"
"10","013","00","001","0129","0000","493","380","113","18","511","1141","0","44.79","33.3"
"10","013","00","001","0129","0048","493","380","113","18","511","1141","0","44.79","33.3"
"10","013","00","001","0130","0000","3586","2878","708","192","3778","7243","0","52.16","39.73"
"10","013","00","001","0130","0041","822","648","174","39","861","1535","0","56.09","42.21"
"10","013","00","001","0130","0042","647","515","132","41","688","1419","0","48.48","36.29"
"10","013","00","001","0130","0043","650","539","111","22","672","1398","0","48.07","38.56"
"10","013","00","001","0130","0044","685","541","144","57","742","1405","0","52.81","38.51"
"10","013","00","001","0130","0045","782","635","147","33","815","1486","0","54.85","42.73"
"10","013","00","001","0131","0000","2717","2094","623","225","2942","5428","0","54.2","38.58"
"10","013","00","001","0131","0075","727","549","178","83","810","1485","0","54.55","36.97"
"10","013","00","001","0131","0076","705","554","151","64","769","1387","0","55.44","39.94"
"10","013","00","001","0131","0077","449","360","89","31","480","953","0","50.37","37.78"
"10","013","00","001","0131","0078","836","631","205","47","883","1603","0","55.08","39.36"
"10","013","00","001","0132","0000","250","193","57","34","284","535","0","53.08","36.07"
"10","013","00","001","0132","0079","250","193","57","34","284","535","0","53.08","36.07"
"10","013","00","001","0133","0000","1243","960","283","87","1330","2843","0","46.78","33.77"
"10","013","00","001","0133","0089","523","412","111","19","542","1215","0","44.61","33.91"
"10","013","00","001","0133","0090","720","548","172","68","788","1628","0","48.4","33.66"
"10","013","00","001","0134","0000","413","328","85","57","470","867","0","54.21","37.83"
"10","013","00","001","0134","0086","413","328","85","57","470","867","0","54.21","37.83"
"10","013","00","001","0135","0000","489","378","111","31","520","918","0","56.64","41.18"
"10","013","00","001","0135","0087","489","378","111","31","520","918","0","56.64","41.18"
"10","013","00","001","0136","0000","630","522","108","45","675","1209","0","55.83","43.18"
"10","013","00","001","0136","0091","630","522","108","45","675","1209","0","55.83","43.18"
"10","013","00","001","0137","0000","303","233","70","40","343","663","0","51.73","35.14"
"10","013","00","001","0137","0088","303","233","70","40","343","663","0","51.73","35.14"
"10","013","00","001","0138","0000","671","550","121","22","693","1110","0","62.43","49.55"
"10","013","00","001","0138","0092","671","550","121","22","693","1110","0","62.43","49.55"
"10","013","00","001","0139","0000","303","218","85","19","322","684","0","47.08","31.87"
"10","013","00","001","0139","0093","303","218","85","19","322","684","0","47.08","31.87"
"10","013","00","001","0140","0000","3386","2667","719","232","3618","7190","0","50.32","37.09"
"10","013","00","001","0140","0094","536","431","105","30","566","1349","0","41.96","31.95"
"10","013","00","001","0140","0095","651","525","126","63","714","1457","0","49.0","36.03"
"10","013","00","001","0140","0096","751","581","170","47","798","1447","0","55.15","40.15"
"10","013","00","001","0140","0097","628","500","128","29","657","1354","0","48.52","36.93"
"10","013","00","001","0140","0098","820","630","190","63","883","1583","0","55.78","39.8"
"10","013","00","001","0141","0000","1173","937","236","67","1240","2503","0","49.54","37.44"
"10","013","00","001","0141","0072","593","460","133","35","628","1284","0","48.91","35.83"
"10","013","00","001","0141","0073","580","477","103","32","612","1219","0","50.21","39.13"
"10","013","00","001","0142","0000","789","617","172","78","867","1544","0","56.15","39.96"
"10","013","00","001","0142","0074","789","617","172","78","867","1544","0","56.15","39.96"
"10","013","00","001","0143","0000","1082","822","260","92","1174","2266","0","51.81","36.28"
"10","013","00","001","0143","0083","571","436","135","38","609","1227","0","49.63","35.53"
"10","013","00","001","0143","0084","511","386","125","54","565","1039","0","54.38","37.15"
"10","013","00","001","0144","0000","685","539","146","100","785","1485","0","52.86","36.3"
"10","013","00","001","0144","0085","685","539","146","100","785","1485","0","52.86","36.3"
"10","013","00","001","0145","0000","536","431","105","39","575","1119","0","51.39","38.52"
"10","013","00","001","0145","0080","536","431","105","39","575","1119","0","51.39","38.52"
"10","013","00","001","0146","0000","924","723","201","90","1014","1770","0","57.29","40.85"
"10","013","00","001","0146","0081","445","359","86","27","472","847","0","55.73","42.38"
"10","013","00","001","0146","0082","479","364","115","63","542","923","0","58.72","39.44"
"10","013","00","001","0147","0000","132","108","24","3","135","391","0","34.53","27.62"
"10","013","00","001","0147","0060","132","108","24","3","135","391","0","34.53","27.62"
"10","013","00","001","0148","0000","118","103","15","3","121","231","0","52.38","44.59"
"10","013","00","001","0148","0063","118","103","15","3","121","231","0","52.38","44.59"
"10","013","00","001","0149","0000","946","747","199","103","1049","1998","0","52.5","37.39"
"10","013","00","001","0149","0064","450","366","84","49","499","945","0","52.8","38.73"
"10","013","00","001","0149","0065","496","381","115","54","550","1053","0","52.23","36.18"
"10","013","00","001","0150","0000","469","370","99","58","527","1043","0","50.53","35.47"
"10","013","00","001","0150","0066","469","370","99","58","527","1043","0","50.53","35.47"
"10","013","00","001","0151","0000","605","467","138","23","628","1205","0","52.12","38.76"
"10","013","00","001","0151","0071","605","467","138","23","628","1205","0","52.12","38.76"
"10","013","00","001","0153","0000","4138","3279","859","251","4389","8175","0","53.69","40.11"
"10","013","00","001","0153","0052","641","522","119","44","685","1253","0","54.67","41.66"
"10","013","00","001","0153","0053","663","561","102","49","712","1315","0","54.14","42.66"
"10","013","00","001","0153","0054","686","512","174","41","727","1425","0","51.02","35.93"
"10","013","00","001","0153","0055","685","546","139","21","706","1423","0","49.61","38.37"
"10","013","00","001","0153","0056","722","577","145","53","775","1400","0","55.36","41.21"
"10","013","00","001","0153","0057","741","561","180","43","784","1359","0","57.69","41.28"
"10","013","00","001","0154","0000","1311","1103","208","172","1483","2922","0","50.75","37.75"
"10","013","00","001","0154","0069","662","593","69","105","767","1468","0","52.25","40.4"
"10","013","00","001","0154","0070","649","510","139","67","716","1454","0","49.24","35.08"
"10","013","00","001","0155","0000","1963","1580","383","119","2082","3996","0","52.1","39.54"
"10","013","00","001","0155","0049","574","469","105","37","611","1247","0","49.0","37.61"
"10","013","00","001","0155","0050","692","562","130","40","732","1446","0","50.62","38.87"
"10","013","00","001","0155","0051","697","549","148","42","739","1303","0","56.72","42.13"
"10","013","00","001","0156","0000","900","694","206","108","1008","1937","0","52.04","35.83"
"10","013","00","001","0156","0067","489","388","101","69","558","1061","0","52.59","36.57"
"10","013","00","001","0156","0068","411","306","105","39","450","876","0","51.37","34.93"
"10","013","00","001","0157","0000","141","114","27","25","166","328","0","50.61","34.76"
"10","013","00","001","0157","0062","141","114","27","25","166","328","0","50.61","34.76"
"10","013","00","001","0158","0000","104","75","29","12","116","200","0","58.0","37.5"
"10","013","00","001","0158","0061","104","75","29","12","116","200","0","58.0","37.5"
"10","013","00","001","0159","0000","910","714","196","53","963","1722","0","55.92","41.46"
"10","013","00","001","0159","0122","426","338","88","33","459","853","0","53.81","39.62"
"10","013","00","001","0159","0123","484","376","108","20","504","869","0","58.0","43.27"
"10","013","00","001","0160","0000","2466","1961","505","149","2615","4870","0","53.7","40.27"
"10","013","00","001","0160","0124","625","505","120","44","669","1169","0","57.23","43.2"
"10","013","00","001","0160","0125","555","457","98","30","585","1058","0","55.29","43.19"
"10","013","00","001","0160","0126","620","483","137","51","671","1344","0","49.93","35.94"
"10","013","00","001","0160","0127","666","516","150","24","690","1299","0","53.12","39.72"
"10","013","00","001","0161","0000","398","329","69","28","426","744","0","57.26","44.22"
"10","013","00","001","0161","0143","398","329","69","28","426","744","0","57.26","44.22"
"10","013","00","001","0162","0000","339","269","70","26","365","678","0","53.83","39.68"
"10","013","00","001","0162","0144","339","269","70","26","365","678","0","53.83","39.68"
"10","013","00","001","0163","0000","364","277","87","29","393","681","0","57.71","40.68"
"10","013","00","001","0163","0145","364","277","87","29","393","681","0","57.71","40.68"
"10","013","00","001","0164","0000","2294","1796","498","124","2418","4705","0","51.39","38.17"
"10","013","00","001","0164","0140","792","592","200","50","842","1491","0","56.47","39.7"
"10","013","00","001","0164","0141","641","525","116","37","678","1411","0","48.05","37.21"
"10","013","00","001","0164","0142","861","679","182","37","898","1803","0","49.81","37.66"
"10","013","00","001","0165","0000","2365","1927","438","125","2490","5541","0","44.94","34.78"
"10","013","00","001","0165","0118","491","400","91","38","529","1683","0","31.43","23.77"
"10","013","00","001","0165","0119","717","594","123","16","733","1497","0","48.96","39.68"
"10","013","00","001","0165","0120","533","410","123","30","563","1129","0","49.87","36.32"
"10","013","00","001","0165","0121","624","523","101","41","665","1232","0","53.98","42.45"
"10","013","00","001","0166","0000","794","656","138","43","837","1920","0","43.59","34.17"
"10","013","00","001","0166","0113","362","301","61","26","388","821","0","47.26","36.66"
"10","013","00","001","0166","0114","432","355","77","17","449","1099","0","40.86","32.3"
"10","013","00","001","0167","0000","1078","875","203","73","1151","2327","0","49.46","37.6"
"10","013","00","001","0167","0128","535","440","95","33","568","1204","0","47.18","36.54"
"10","013","00","001","0167","0129","543","435","108","40","583","1123","0","51.91","38.74"
"10","013","00","001","0168","0000","1226","996","230","82","1308","2404","0","54.41","41.43"
"10","013","00","001","0168","0138","684","561","123","53","737","1289","0","57.18","43.52"
"10","013","00","001","0168","0139","542","435","107","29","571","1115","0","51.21","39.01"
"10","013","00","001","0169","0000","3006","2409","597","155","3161","6072","0","52.06","39.67"
"10","013","00","001","0169","0133","539","433","106","26","565","1215","0","46.5","35.64"
"10","013","00","001","0169","0134","685","542","143","42","727","1370","0","53.07","39.56"
"10","013","00","001","0169","0135","614","493","121","13","627","1240","0","50.56","39.76"
"10","013","00","001","0169","0136","617","486","131","49","666","1168","0","57.02","41.61"
"10","013","00","001","0169","0137","551","455","96","25","576","1079","0","53.38","42.17"
"10","013","00","001","0170","0000","1189","927","262","74","1263","2172","0","58.15","42.68"
"10","013","00","001","0170","0148","568","441","127","43","611","1018","0","60.02","43.32"
"10","013","00","001","0170","0149","621","486","135","31","652","1154","0","56.5","42.11"
"10","013","00","001","0171","0000","971","777","194","98","1069","2082","0","51.34","37.32"
"10","013","00","001","0171","0116","535","442","93","46","581","1167","0","49.79","37.87"
"10","013","00","001","0171","0117","436","335","101","52","488","915","0","53.33","36.61"
"10","013","00","001","0173","0000","5735","4751","984","224","5959","11833","0","50.36","40.15"
"10","013","00","001","0173","0099","826","693","133","24","850","1707","0","49.79","40.6"
"10","013","00","001","0173","0100","755","639","116","27","782","1637","0","47.77","39.03"
"10","013","00","001","0173","0101","694","547","147","9","703","1459","0","48.18","37.49"
"10","013","00","001","0173","0102","897","750","147","47","944","1759","0","53.67","42.64"
"10","013","00","001","0173","0103","957","801","156","42","999","1950","0","51.23","41.08"
"10","013","00","001","0173","0104","864","713","151","50","914","1729","0","52.86","41.24"
"10","013","00","001","0173","0105","742","608","134","25","767","1592","0","48.18","38.19"
"10","013","00","001","0174","0000","823","698","125","47","870","1688","0","51.54","41.35"
"10","013","00","001","0174","0115","823","698","125","47","870","1688","0","51.54","41.35"
"10","013","00","001","0175","0000","5516","4605","911","251","5767","11483","0","50.22","40.1"
"10","013","00","001","0175","0106","680","558","122","41","721","1437","0","50.17","38.83"
"10","013","00","001","0175","0107","571","488","83","29","600","1204","0","49.83","40.53"
"10","013","00","001","0175","0108","700","580","120","35","735","1340","0","54.85","43.28"
"10","013","00","001","0175","0109","685","552","133","32","717","1322","0","54.24","41.75"
"10","013","00","001","0175","0110","672","559","113","39","711","1462","0","48.63","38.24"
"10","013","00","001","0175","0111","1515","1269","246","49","1564","3241","0","48.26","39.15"
"10","013","00","001","0175","0112","693","599","94","26","719","1477","0","48.68","40.56"
"10","013","00","001","0176","0000","553","429","124","32","585","1318","0","44.39","32.55"
"10","013","00","001","0176","0130","553","429","124","32","585","1318","0","44.39","32.55"
"10","013","00","001","0177","0000","460","374","86","54","514","865","0","59.42","43.24"
"10","013","00","001","0177","0131","460","374","86","54","514","865","0","59.42","43.24"
"10","013","00","001","0178","0000","444","359","85","27","471","1100","0","42.82","32.64"
"10","013","00","001","0178","0132","444","359","85","27","471","1100","0","42.82","32.64"
"10","013","00","001","0179","0000","485","381","104","59","544","954","0","57.02","39.94"
"10","013","00","001","0179","0147","485","381","104","59","544","954","0","57.02","39.94"
"10","013","00","001","0180","0000","621","506","115","32","653","1535","0","42.54","32.96"
"10","013","00","001","0180","0146","621","506","115","32","653","1535","0","42.54","32.96"
"10","013","00","001","0181","0000","1453","1229","224","80","1533","2867","0","53.47","42.87"
"10","013","00","001","0181","0058","679","576","103","36","715","1328","0","53.84","43.37"
"10","013","00","001","0181","0059","774","653","121","44","818","1539","0","53.15","42.43"
"10","013","00","002","0000","0000","21790","17240","4550","1878","23668","46444","53924","50.96","37.12"
"10","013","00","002","0201","0000","268","198","70","37","305","504","0","60.52","39.29"
"10","013","00","002","0201","0150","268","198","70","37","305","504","0","60.52","39.29"
"10","013","00","002","0202","0000","319","223","96","57","376","603","0","62.35","36.98"
"10","013","00","002","0202","0154","319","223","96","57","376","603","0","62.35","36.98"
"10","013","00","002","0203","0000","680","517","163","47","727","1245","0","58.39","41.53"
"10","013","00","002","0203","0170","680","517","163","47","727","1245","0","58.39","41.53"
"10","013","00","002","0204","0000","490","383","107","57","547","972","0","56.28","39.4"
"10","013","00","002","0204","0169","490","383","107","57","547","972","0","56.28","39.4"
"10","013","00","002","0205","0000","2144","1711","433","106","2250","4759","0","47.28","35.95"
"10","013","00","002","0205","0151","750","600","150","50","800","1711","0","46.76","35.07"
"10","013","00","002","0205","0152","779","608","171","28","807","1634","0","49.39","37.21"
"10","013","00","002","0205","0153","615","503","112","28","643","1414","0","45.47","35.57"
"10","013","00","002","0206","0000","429","343","86","57","486","896","0","54.24","38.28"
"10","013","00","002","0206","0155","429","343","86","57","486","896","0","54.24","38.28"
"10","013","00","002","0207","0000","2530","2030","500","242","2772","5309","0","52.21","38.24"
"10","013","00","002","0207","0156","611","479","132","62","673","1285","0","52.37","37.28"
"10","013","00","002","0207","0157","816","672","144","65","881","1744","0","50.52","38.53"
"10","013","00","002","0207","0158","459","363","96","52","511","1071","0","47.71","33.89"
"10","013","00","002","0207","0159","644","516","128","63","707","1209","0","58.48","42.68"
"10","013","00","002","0208","0000","3220","2542","678","265","3485","6490","0","53.7","39.17"
"10","013","00","002","0208","0160","562","433","129","45","607","1159","0","52.37","37.36"
"10","013","00","002","0208","0161","614","496","118","60","674","1296","0","52.01","38.27"
"10","013","00","002","0208","0162","737","602","135","51","788","1466","0","53.75","41.06"
"10","013","00","002","0208","0163","583","440","143","63","646","1130","0","57.17","38.94"
"10","013","00","002","0208","0164","724","571","153","46","770","1439","0","53.51","39.68"
"10","013","00","002","0209","0000","1108","904","204","99","1207","2122","0","56.88","42.6"
"10","013","00","002","0209","0165","471","386","85","51","522","897","0","58.19","43.03"
"10","013","00","002","0209","0166","637","518","119","48","685","1225","0","55.92","42.29"
"10","013","00","002","0210","0000","685","547","138","58","743","1415","0","52.51","38.66"
"10","013","00","002","0210","0171","685","547","138","58","743","1415","0","52.51","38.66"
"10","013","00","002","0211","0000","950","759","191","40","990","2313","0","42.8","32.81"
"10","013","00","002","0211","0172","521","413","108","13","534","1255","0","42.55","32.91"
"10","013","00","002","0211","0173","429","346","83","27","456","1058","0","43.1","32.7"
"10","013","00","002","0212","0000","1112","877","235","104","1216","2270","0","53.57","38.63"
"10","013","00","002","0212","0174","573","444","129","37","610","1187","0","51.39","37.41"
"10","013","00","002","0212","0175","539","433","106","67","606","1083","0","55.96","39.98"
"10","013","00","002","0213","0000","3509","2828","681","226","3735","7022","0","53.19","40.27"
"10","013","00","002","0213","0176","707","559","148","39","746","1590","0","46.92","35.16"
"10","013","00","002","0213","0177","874","715","159","69","943","1543","0","61.11","46.34"
"10","013","00","002","0213","0178","756","595","161","51","807","1631","0","49.48","36.48"
"10","013","00","002","0213","0179","588","497","91","33","621","1159","0","53.58","42.88"
"10","013","00","002","0213","0180","584","462","122","34","618","1099","0","56.23","42.04"
"10","013","00","002","0214","0000","538","423","115","52","590","1200","0","49.17","35.25"
"10","013","00","002","0214","0181","538","423","115","52","590","1200","0","49.17","35.25"
"10","013","00","002","0215","0000","639","519","120","65","704","1391","0","50.61","37.31"
"10","013","00","002","0215","0182","639","519","120","65","704","1391","0","50.61","37.31"
"10","013","00","002","0216","0000","443","369","74","62","505","881","0","57.32","41.88"
"10","013","00","002","0216","0183","443","369","74","62","505","881","0","57.32","41.88"
"10","013","00","002","0217","0000","171","131","40","21","192","454","0","42.29","28.85"
"10","013","00","002","0217","0184","171","131","40","21","192","454","0","42.29","28.85"
"10","013","00","002","0218","0000","726","570","156","76","802","1639","0","48.93","34.78"
"10","013","00","002","0218","0167","543","434","109","42","585","1158","0","50.52","37.48"
"10","013","00","002","0218","0168","183","136","47","34","217","481","0","45.11","28.27"
"10","013","00","002","0219","0000","503","328","175","95","598","1658","0","36.07","19.78"
"10","013","00","002","0219","0185","503","328","175","95","598","1658","0","36.07","19.78"
"10","013","00","002","0220","0000","718","557","161","51","769","1770","0","43.45","31.47"
"10","013","00","002","0220","0186","344","274","70","37","381","822","0","46.35","33.33"
"10","013","00","002","0220","0187","374","283","91","14","388","948","0","40.93","29.85"
"10","013","00","002","0221","0000","608","481","127","61","669","1531","0","43.7","31.42"
"10","013","00","002","0221","0188","449","352","97","29","478","1194","0","40.03","29.48"
"10","013","00","002","0221","0189","159","129","30","32","191","337","0","56.68","38.28"
"10","013","00","003","0000","0000","18504","14549","3955","2301","20805","39495","47654","52.68","36.84"
"10","013","00","003","0301","0000","1089","841","248","127","1216","2051","0","59.29","41.0"
"10","013","00","003","0301","0190","524","410","114","63","587","981","0","59.84","41.79"
"10","013","00","003","0301","0191","565","431","134","64","629","1070","0","58.79","40.28"
"10","013","00","003","0302","0000","293","233","60","48","341","527","0","64.71","44.21"
"10","013","00","003","0302","0192","293","233","60","48","341","527","0","64.71","44.21"
"10","013","00","003","0303","0000","197","149","48","40","237","395","0","60.0","37.72"
"10","013","00","003","0303","0193","197","149","48","40","237","395","0","60.0","37.72"
"10","013","00","003","0304","0000","300","235","65","38","338","659","0","51.29","35.66"
"10","013","00","003","0304","0194","300","235","65","38","338","659","0","51.29","35.66"
"10","013","00","003","0305","0000","246","202","44","31","277","513","0","54.0","39.38"
"10","013","00","003","0305","0195","246","202","44","31","277","513","0","54.0","39.38"
"10","013","00","003","0306","0000","352","286","66","39","391","695","0","56.26","41.15"
"10","013","00","003","0306","0203","352","286","66","39","391","695","0","56.26","41.15"
"10","013","00","003","0307","0000","812","627","185","137","949","1643","0","57.76","38.16"
"10","013","00","003","0307","0204","562","437","125","98","660","1076","0","61.34","40.61"
"10","013","00","003","0307","0205","250","190","60","39","289","567","0","50.97","33.51"
"10","013","00","003","0308","0000","363","286","77","41","404","806","0","50.12","35.48"
"10","013","00","003","0308","0206","363","286","77","41","404","806","0","50.12","35.48"
"10","013","00","003","0309","0000","606","464","142","77","683","1227","0","55.66","37.82"
"10","013","00","003","0309","0207","606","464","142","77","683","1227","0","55.66","37.82"
"10","013","00","003","0310","0000","262","197","65","59","321","599","0","53.59","32.89"
"10","013","00","003","0310","0208","262","197","65","59","321","599","0","53.59","32.89"
"10","013","00","003","0311","0000","500","390","110","49","549","1354","0","40.55","28.8"
"10","013","00","003","0311","0209","500","390","110","49","549","1354","0","40.55","28.8"
"10","013","00","003","0312","0000","848","661","187","175","1023","1841","0","55.57","35.9"
"10","013","00","003","0312","0210","332","256","76","56","388","734","0","52.86","34.88"
"10","013","00","003","0312","0211","516","405","111","119","635","1107","0","57.36","36.59"
"10","013","00","003","0313","0000","1193","950","243","218","1411","2812","0","50.18","33.78"
"10","013","00","003","0313","0212","503","406","97","87","590","1198","0","49.25","33.89"
"10","013","00","003","0313","0213","690","544","146","131","821","1614","0","50.87","33.71"
"10","013","00","003","0314","0000","825","649","176","113","938","1738","0","53.97","37.34"
"10","013","00","003","0314","0214","370","289","81","50","420","826","0","50.85","34.99"
"10","013","00","003","0314","0215","455","360","95","63","518","912","0","56.8","39.47"
"10","013","00","003","0315","0000","727","559","168","178","905","1636","0","55.32","34.17"
"10","013","00","003","0315","0216","176","130","46","48","224","432","0","51.85","30.09"
"10","013","00","003","0315","0217","551","429","122","130","681","1204","0","56.56","35.63"
"10","013","00","003","0316","0000","2556","2020","536","218","2774","5318","0","52.16","37.98"
"10","013","00","003","0316","0218","671","525","146","57","728","1304","0","55.83","40.26"
"10","013","00","003","0316","0219","670","522","148","75","745","1317","0","56.57","39.64"
"10","013","00","003","0316","0220","664","530","134","42","706","1387","0","50.9","38.21"
"10","013","00","003","0316","0221","551","443","108","44","595","1310","0","45.42","33.82"
"10","013","00","003","0317","0000","858","654","204","101","959","1994","0","48.09","32.8"
"10","013","00","003","0317","0222","544","421","123","42","586","1228","0","47.72","34.28"
"10","013","00","003","0317","0223","314","233","81","59","373","766","0","48.69","30.42"
"10","013","00","003","0318","0000","654","508","146","85","739","1578","0","46.83","32.19"
"10","013","00","003","0318","0224","407","305","102","66","473","823","0","57.47","37.06"
"10","013","00","003","0318","0225","247","203","44","19","266","755","0","35.23","26.89"
"10","013","00","003","0319","0000","4345","3467","878","401","4746","8957","0","52.99","38.71"
"10","013","00","003","0319","0196","823","656","167","61","884","1732","0","51.04","37.88"
"10","013","00","003","0319","0197","893","720","173","56","949","1779","0","53.34","40.47"
"10","013","00","003","0319","0198","595","471","124","47","642","1270","0","50.55","37.09"
"10","013","00","003","0319","0199","633","486","147","64","697","1327","0","52.52","36.62"
"10","013","00","003","0319","0200","623","480","143","72","695","1242","0","55.96","38.65"
"10","013","00","003","0319","0201","778","654","124","101","879","1607","0","54.7","40.7"
"10","013","00","003","0320","0000","578","469","109","38","616","1305","0","47.2","35.94"
"10","013","00","003","0320","0202","578","469","109","38","616","1305","0","47.2","35.94"
"10","013","00","003","0321","0000","559","425","134","60","619","1094","0","56.58","38.85"
"10","013","00","003","0321","0226","559","425","134","60","619","1094","0","56.58","38.85"
"10","013","00","003","0322","0000","341","277","64","28","369","753","0","49.0","36.79"
"10","013","00","003","0322","0227","341","277","64","28","369","753","0","49.0","36.79"
"10","013","00","004","0000","0000","10964","8909","2055","842","11806","25661","30812","46.01","34.72"
"10","013","00","004","0401","0000","414","324","90","26","440","902","0","48.78","35.92"
"10","013","00","004","0401","0228","414","324","90","26","440","902","0","48.78","35.92"
"10","013","00","004","0402","0000","1085","887","198","93","1178","2249","0","52.38","39.44"
"10","013","00","004","0402","0229","508","411","97","45","553","969","0","57.07","42.41"
"10","013","00","004","0402","0230","577","476","101","48","625","1280","0","48.83","37.19"
"10","013","00","004","0403","0000","574","554","20","32","606","1133","0","53.49","48.9"
"10","013","00","004","0403","0231","574","554","20","32","606","1133","0","53.49","48.9"
"10","013","00","004","0404","0000","1801","1463","338","119","1920","4159","0","46.16","35.18"
"10","013","00","004","0404","0246","664","530","134","36","700","1505","0","46.51","35.22"
"10","013","00","004","0404","0247","465","382","83","47","512","1111","0","46.08","34.38"
"10","013","00","004","0404","0248","672","551","121","36","708","1543","0","45.88","35.71"
"10","013","00","004","0405","0000","1162","959","203","68","1230","3037","0","40.5","31.58"
"10","013","00","004","0405","0232","602","504","98","13","615","1552","0","39.63","32.47"
"10","013","00","004","0405","0233","560","455","105","55","615","1485","0","41.41","30.64"
"10","013","00","004","0406","0000","448","348","100","33","481","896","0","53.68","38.84"
"10","013","00","004","0406","0234","448","348","100","33","481","896","0","53.68","38.84"
"10","013","00","004","0407","0000","220","169","51","25","245","531","0","46.14","31.83"
"10","013","00","004","0407","0235","220","169","51","25","245","531","0","46.14","31.83"
"10","013","00","004","0408","0000","201","160","41","8","209","478","0","43.72","33.47"
"10","013","00","004","0408","0236","201","160","41","8","209","478","0","43.72","33.47"
"10","013","00","004","0409","0000","454","348","106","35","489","1020","0","47.94","34.12"
"10","013","00","004","0409","0237","454","348","106","35","489","1020","0","47.94","34.12"
"10","013","00","004","0410","0000","406","306","100","28","434","924","0","46.97","33.12"
"10","013","00","004","0410","0238","406","306","100","28","434","924","0","46.97","33.12"
"10","013","00","004","0411","0000","429","349","80","17","446","1079","0","41.33","32.34"
"10","013","00","004","0411","0239","429","349","80","17","446","1079","0","41.33","32.34"
"10","013","00","004","0412","0000","637","523","114","72","709","1588","0","44.65","32.93"
"10","013","00","004","0412","0240","254","209","45","22","276","775","0","35.61","26.97"
"10","013","00","004","0412","0241","383","314","69","50","433","813","0","53.26","38.62"
"10","013","00","004","0413","0000","919","731","188","90","1009","2214","0","45.57","33.02"
"10","013","00","004","0413","0242","474","386","88","45","519","1104","0","47.01","34.96"
"10","013","00","004","0413","0243","445","345","100","45","490","1110","0","44.14","31.08"
"10","013","00","004","0414","0000","465","373","92","71","536","1400","0","38.29","26.64"
"10","013","00","004","0414","0244","236","183","53","61","297","692","0","42.92","26.45"
"10","013","00","004","0414","0245","229","190","39","10","239","708","0","33.76","26.84"
"10","013","00","004","0415","0000","712","563","149","46","758","1672","0","45.33","33.67"
"10","013","00","004","0415","0249","300","245","55","19","319","828","0","38.53","29.59"
"10","013","00","004","0415","0250","412","318","94","27","439","844","0","52.01","37.68"
"10","013","00","004","0416","0000","558","456","102","45","603","1253","0","48.12","36.39"
"10","013","00","004","0416","0251","558","456","102","45","603","1253","0","48.12","36.39"
"10","013","00","004","0417","0000","479","396","83","34","513","1126","0","45.56","35.17"
"10","013","00","004","0417","0252","479","396","83","34","513","1126","0","45.56","35.17"
"10","013","00","005","0000","0000","20547","15892","4655","2197","22744","43478","50595","52.31","36.55"
"10","013","00","005","0501","0000","317","235","82","26","343","595","0","57.65","39.5"
"10","013","00","005","0501","0267","317","235","82","26","343","595","0","57.65","39.5"
"10","013","00","005","0502","0000","450","357","93","34","484","847","0","57.14","42.15"
"10","013","00","005","0502","0262","450","357","93","34","484","847","0","57.14","42.15"
"10","013","00","005","0503","0000","1639","1316","323","155","1794","3458","0","51.88","38.06"
"10","013","00","005","0503","0263","526","442","84","54","580","1149","0","50.48","38.47"
"10","013","00","005","0503","0264","553","433","120","53","606","1131","0","53.58","38.28"
"10","013","00","005","0503","0265","560","441","119","48","608","1178","0","51.61","37.44"
"10","013","00","005","0504","0000","386","294","92","39","425","711","0","59.77","41.35"
"10","013","00","005","0504","0266","386","294","92","39","425","711","0","59.77","41.35"
"10","013","00","005","0505","0000","745","597","148","56","801","1403","0","57.09","42.55"
"10","013","00","005","0505","0268","745","597","148","56","801","1403","0","57.09","42.55"
"10","013","00","005","0506","0000","1101","886","215","63","1164","2252","0","51.69","39.34"
"10","013","00","005","0506","0269","505","416","89","28","533","1094","0","48.72","38.03"
"10","013","00","005","0506","0270","596","470","126","35","631","1158","0","54.49","40.59"
"10","013","00","005","0507","0000","1035","782","253","110","1145","2025","0","56.54","38.62"
"10","013","00","005","0507","0271","545","403","142","54","599","963","0","62.2","41.85"
"10","013","00","005","0507","0272","490","379","111","56","546","1062","0","51.41","35.69"
"10","013","00","005","0508","0000","792","584","208","89","881","1684","0","52.32","34.68"
"10","013","00","005","0508","0273","792","584","208","89","881","1684","0","52.32","34.68"
"10","013","00","005","0509","0000","1200","937","263","138","1338","2250","0","59.47","41.64"
"10","013","00","005","0509","0290","549","430","119","73","622","1023","0","60.8","42.03"
"10","013","00","005","0509","0291","651","507","144","65","716","1227","0","58.35","41.32"
"10","013","00","005","0510","0000","457","337","120","49","506","976","0","51.84","34.53"
"10","013","00","005","0510","0275","457","337","120","49","506","976","0","51.84","34.53"
"10","013","00","005","0511","0000","838","596","242","100","938","1860","0","50.43","32.04"
"10","013","00","005","0511","0276","491","365","126","65","556","1013","0","54.89","36.03"
"10","013","00","005","0511","0277","347","231","116","35","382","847","0","45.1","27.27"
"10","013","00","005","0512","0000","782","576","206","130","912","1570","0","58.09","36.69"
"10","013","00","005","0512","0278","782","576","206","130","912","1570","0","58.09","36.69"
"10","013","00","005","0513","0000","622","481","141","70","692","1411","0","49.04","34.09"
"10","013","00","005","0513","0279","622","481","141","70","692","1411","0","49.04","34.09"
"10","013","00","005","0514","0000","383","300","83","62","445","804","0","55.35","37.31"
"10","013","00","005","0514","0282","383","300","83","62","445","804","0","55.35","37.31"
"10","013","00","005","0515","0000","612","462","150","83","695","1284","0","54.13","35.98"
"10","013","00","005","0515","0283","612","462","150","83","695","1284","0","54.13","35.98"
"10","013","00","005","0516","0000","650","513","137","50","700","1430","0","48.95","35.87"
"10","013","00","005","0516","0284","650","513","137","50","700","1430","0","48.95","35.87"
"10","013","00","005","0517","0000","534","415","119","64","598","960","0","62.29","43.23"
"10","013","00","005","0517","0285","534","415","119","64","598","960","0","62.29","43.23"
"10","013","00","005","0518","0000","999","753","246","127","1126","1944","0","57.92","38.73"
"10","013","00","005","0518","0286","428","332","96","48","476","786","0","60.56","42.24"
"10","013","00","005","0518","0287","571","421","150","79","650","1158","0","56.13","36.36"
"10","013","00","005","0519","0000","694","542","152","80","774","1666","0","46.46","32.53"
"10","013","00","005","0519","0289","694","542","152","80","774","1666","0","46.46","32.53"
"10","013","00","005","0520","0000","640","507","133","67","707","1647","0","42.93","30.78"
"10","013","00","005","0520","0288","640","507","133","67","707","1647","0","42.93","30.78"
"10","013","00","005","0521","0000","747","610","137","41","788","1702","0","46.3","35.84"
"10","013","00","005","0521","0274","747","610","137","41","788","1702","0","46.3","35.84"
"10","013","00","005","0522","0000","896","674","222","112","1008","2096","0","48.09","32.16"
"10","013","00","005","0522","0254","498","385","113","65","563","1147","0","49.08","33.57"
"10","013","00","005","0522","0255","398","289","109","47","445","949","0","46.89","30.45"
"10","013","00","005","0523","0000","571","443","128","60","631","1527","0","41.32","29.01"
"10","013","00","005","0523","0253","571","443","128","60","631","1527","0","41.32","29.01"
"10","013","00","005","0524","0000","519","404","115","78","597","1046","0","57.07","38.62"
"10","013","00","005","0524","0280","519","404","115","78","597","1046","0","57.07","38.62"
"10","013","00","005","0525","0000","844","666","178","49","893","2012","0","44.38","33.1"
"10","013","00","005","0525","0256","441","349","92","35","476","990","0","48.08","35.25"
"10","013","00","005","0525","0257","403","317","86","14","417","1022","0","40.8","31.02"
"10","013","00","005","0526","0000","602","457","145","30","632","1385","0","45.63","33.0"
"10","013","00","005","0526","0281","602","457","145","30","632","1385","0","45.63","33.0"
"10","013","00","005","0527","0000","582","459","123","85","667","1159","0","57.55","39.6"
"10","013","00","005","0527","0259","582","459","123","85","667","1159","0","57.55","39.6"
"10","013","00","005","0528","0000","417","320","97","78","495","837","0","59.14","38.23"
"10","013","00","005","0528","0260","417","320","97","78","495","837","0","59.14","38.23"
"10","013","00","005","0529","0000","309","248","61","58","367","545","0","67.34","45.5"
"10","013","00","005","0529","0258","309","248","61","58","367","545","0","67.34","45.5"
"10","013","00","005","0530","0000","184","141","43","14","198","392","0","50.51","35.97"
"10","013","00","005","0530","0261","184","141","43","14","198","392","0","50.51","35.97"
"10","013","00","006","0000","0000","12813","9969","2844","1489","14302","26256","29714","54.47","37.97"
"10","013","00","006","0601","0000","1300","1025","275","147","1447","2632","0","54.98","38.94"
"10","013","00","006","0601","0292","505","390","115","63","568","1018","0","55.8","38.31"
"10","013","00","006","0601","0293","795","635","160","84","879","1614","0","54.46","39.34"
"10","013","00","006","0602","0000","1800","1457","343","172","1972","3555","0","55.47","40.98"
"10","013","00","006","0602","0294","951","787","164","101","1052","1848","0","56.93","42.59"
"10","013","00","006","0602","0295","849","670","179","71","920","1707","0","53.9","39.25"
"10","013","00","006","0603","0000","1036","817","219","83","1119","1961","0","57.06","41.66"
"10","013","00","006","0603","0296","523","429","94","30","553","972","0","56.89","44.14"
"10","013","00","006","0603","0297","513","388","125","53","566","989","0","57.23","39.23"
"10","013","00","006","0604","0000","1225","942","283","114","1339","2548","0","52.55","36.97"
"10","013","00","006","0604","0298","399","313","86","46","445","735","0","60.54","42.59"
"10","013","00","006","0604","0299","826","629","197","68","894","1813","0","49.31","34.69"
"10","013","00","006","0605","0000","597","470","127","52","649","1073","0","60.48","43.8"
"10","013","00","006","0605","0300","597","470","127","52","649","1073","0","60.48","43.8"
"10","013","00","006","0606","0000","449","355","94","54","503","884","0","56.9","40.16"
"10","013","00","006","0606","0305","449","355","94","54","503","884","0","56.9","40.16"
"10","013","00","006","0607","0000","565","451","114","55","620","1090","0","56.88","41.38"
"10","013","00","006","0607","0306","565","451","114","55","620","1090","0","56.88","41.38"
"10","013","00","006","0608","0000","695","513","182","110","805","1492","0","53.95","34.38"
"10","013","00","006","0608","0304","695","513","182","110","805","1492","0","53.95","34.38"
"10","013","00","006","0609","0000","805","605","200","100","905","1654","0","54.72","36.58"
"10","013","00","006","0609","0301","805","605","200","100","905","1654","0","54.72","36.58"
"10","013","00","006","0610","0000","607","460","147","72","679","1205","0","56.35","38.17"
"10","013","00","006","0610","0302","607","460","147","72","679","1205","0","56.35","38.17"
"10","013","00","006","0611","0000","387","302","85","44","431","758","0","56.86","39.84"
"10","013","00","006","0611","0303","387","302","85","44","431","758","0","56.86","39.84"
"10","013","00","006","0612","0000","1010","756","254","129","1139","2401","0","47.44","31.49"
"10","013","00","006","0612","0311","585","432","153","108","693","1242","0","55.8","34.78"
"10","013","00","006","0612","0312","425","324","101","21","446","1159","0","38.48","27.96"
"10","013","00","006","0613","0000","869","652","217","125","994","1770","0","56.16","36.84"
"10","013","00","006","0613","0308","405","304","101","56","461","845","0","54.56","35.98"
"10","013","00","006","0613","0309","464","348","116","69","533","925","0","57.62","37.62"
"10","013","00","006","0614","0000","583","446","137","101","684","1422","0","48.1","31.36"
"10","013","00","006","0614","0307","583","446","137","101","684","1422","0","48.1","31.36"
"10","013","00","006","0615","0000","518","423","95","96","614","1138","0","53.95","37.17"
"10","013","00","006","0615","0310","518","423","95","96","614","1138","0","53.95","37.17"
"10","013","00","006","0616","0000","367","295","72","35","402","673","0","59.73","43.83"
"10","013","00","006","0616","0313","367","295","72","35","402","673","0","59.73","43.83"
"10","013","00","007","0000","0000","5154","4077","1077","408","5562","9970","11068","55.79","40.89"
"10","013","00","007","0701","0000","1168","916","252","61","1229","2174","0","56.53","42.13"
"10","013","00","007","0701","0314","408","314","94","37","445","788","0","56.47","39.85"
"10","013","00","007","0701","0315","760","602","158","24","784","1386","0","56.57","43.43"
"10","013","00","007","0702","0000","536","433","103","43","579","957","0","60.5","45.25"
"10","013","00","007","0702","0316","536","433","103","43","579","957","0","60.5","45.25"
"10","013","00","007","0703","0000","841","664","177","107","948","1537","0","61.68","43.2"
"10","013","00","007","0703","0317","395","315","80","49","444","731","0","60.74","43.09"
"10","013","00","007","0703","0318","446","349","97","58","504","806","0","62.53","43.3"
"10","013","00","007","0704","0000","1257","1002","255","109","1366","2547","0","53.63","39.34"
"10","013","00","007","0704","0319","536","410","126","22","558","1207","0","46.23","33.97"
"10","013","00","007","0704","0320","721","592","129","87","808","1340","0","60.3","44.18"
"10","013","00","007","0705","0000","643","498","145","60","703","1221","0","57.58","40.79"
"10","013","00","007","0705","0321","643","498","145","60","703","1221","0","57.58","40.79"
"10","013","00","007","0706","0000","398","309","89","15","413","851","0","48.53","36.31"
"10","013","00","007","0706","0322","398","309","89","15","413","851","0","48.53","36.31"
"10","013","00","007","0707","0000","311","255","56","13","324","683","0","47.44","37.34"
"10","013","00","007","0707","0323","311","255","56","13","324","683","0","47.44","37.34"
"10","013","00","008","0000","0000","9084","7108","1976","1227","10311","19132","22095","53.89","37.15"
"10","013","00","008","0801","0000","732","548","184","100","832","1491","0","55.8","36.75"
"10","013","00","008","0801","0324","732","548","184","100","832","1491","0","55.8","36.75"
"10","013","00","008","0802","0000","661","515","146","70","731","1375","0","53.16","37.45"
"10","013","00","008","0802","0325","661","515","146","70","731","1375","0","53.16","37.45"
"10","013","00","008","0803","0000","732","572","160","53","785","1678","0","46.78","34.09"
"10","013","00","008","0803","0326","732","572","160","53","785","1678","0","46.78","34.09"
"10","013","00","008","0804","0000","497","393","104","52","549","1276","0","43.03","30.8"
"10","013","00","008","0804","0328","497","393","104","52","549","1276","0","43.03","30.8"
"10","013","00","008","0805","0000","602","473","129","76","678","1166","0","58.15","40.57"
"10","013","00","008","0805","0327","602","473","129","76","678","1166","0","58.15","40.57"
"10","013","00","008","0806","0000","717","652","65","108","825","1600","0","51.56","40.75"
"10","013","00","008","0806","0334","717","652","65","108","825","1600","0","51.56","40.75"
"10","013","00","008","0807","0000","850","595","255","188","1038","1792","0","57.92","33.2"
"10","013","00","008","0807","0336","850","595","255","188","1038","1792","0","57.92","33.2"
"10","013","00","008","0808","0000","583","450","133","97","680","1248","0","54.49","36.06"
"10","013","00","008","0808","0335","583","450","133","97","680","1248","0","54.49","36.06"
"10","013","00","008","0809","0000","718","571","147","92","810","1482","0","54.66","38.53"
"10","013","00","008","0809","0337","718","571","147","92","810","1482","0","54.66","38.53"
"10","013","00","008","0810","0000","2114","1643","471","293","2407","4414","0","54.53","37.22"
"10","013","00","008","0810","0331","336","262","74","62","398","649","0","61.33","40.37"
"10","013","00","008","0810","0332","944","724","220","145","1089","1999","0","54.48","36.22"
"10","013","00","008","0810","0333","834","657","177","86","920","1766","0","52.1","37.2"
"10","013","00","008","0811","0000","878","696","182","98","976","1610","0","60.62","43.23"
"10","013","00","008","0811","0329","511","398","113","68","579","1033","0","56.05","38.53"
"10","013","00","008","0811","0330","367","298","69","30","397","577","0","68.8","51.65"
"10","013","00","009","0000","0000","10679","8226","2453","1363","12042","22128","26092","54.42","37.17"
"10","013","00","009","0901","0000","1525","1172","353","174","1699","3032","0","56.04","38.65"
"10","013","00","009","0901","0338","819","630","189","92","911","1552","0","58.7","40.59"
"10","013","00","009","0901","0339","706","542","164","82","788","1480","0","53.24","36.62"
"10","013","00","009","0902","0000","600","512","88","65","665","1127","0","59.01","45.43"
"10","013","00","009","0902","0342","600","512","88","65","665","1127","0","59.01","45.43"
"10","013","00","009","0903","0000","449","351","98","46","495","845","0","58.58","41.54"
"10","013","00","009","0903","0343","449","351","98","46","495","845","0","58.58","41.54"
"10","013","00","009","0904","0000","604","461","143","65","669","1282","0","52.18","35.96"
"10","013","00","009","0904","0344","604","461","143","65","669","1282","0","52.18","35.96"
"10","013","00","009","0905","0000","1031","805","226","130","1161","2012","0","57.7","40.01"
"10","013","00","009","0905","0345","509","391","118","57","566","981","0","57.7","39.86"
"10","013","00","009","0905","0346","522","414","108","73","595","1031","0","57.71","40.16"
"10","013","00","009","0906","0000","695","546","149","108","803","1423","0","56.43","38.37"
"10","013","00","009","0906","0347","695","546","149","108","803","1423","0","56.43","38.37"
"10","013","00","009","0907","0000","622","452","170","55","677","1534","0","44.13","29.47"
"10","013","00","009","0907","0340","622","452","170","55","677","1534","0","44.13","29.47"
"10","013","00","009","0908","0000","745","566","179","105","850","1578","0","53.87","35.87"
"10","013","00","009","0908","0341","745","566","179","105","850","1578","0","53.87","35.87"
"10","013","00","009","0909","0000","727","542","185","136","863","1566","0","55.11","34.61"
"10","013","00","009","0909","0348","143","101","42","23","166","363","0","45.73","27.82"
"10","013","00","009","0909","0349","584","441","143","113","697","1203","0","57.94","36.66"
"10","013","00","009","0910","0000","1151","879","272","132","1283","2411","0","53.21","36.46"
"10","013","00","009","0910","0350","563","449","114","73","636","1027","0","61.93","43.72"
"10","013","00","009","0910","0351","588","430","158","59","647","1384","0","46.75","31.07"
"10","013","00","009","0911","0000","969","764","205","103","1072","2034","0","52.7","37.56"
"10","013","00","009","0911","0352","684","524","160","80","764","1512","0","50.53","34.66"
"10","013","00","009","0911","0353","285","240","45","23","308","522","0","59.0","45.98"
"10","013","00","009","0912","0000","838","645","193","148","986","1829","0","53.91","35.27"
"10","013","00","009","0912","0354","399","308","91","60","459","822","0","55.84","37.47"
"10","013","00","009","0912","0355","439","337","102","88","527","1007","0","52.33","33.47"
"10","013","00","009","0913","0000","465","335","130","72","537","956","0","56.17","35.04"
"10","013","00","009","0913","0356","465","335","130","72","537","956","0","56.17","35.04"
"10","013","00","009","0914","0000","258","196","62","24","282","499","0","56.51","39.28"
"10","013","00","009","0914","0357","258","196","62","24","282","499","0","56.51","39.28"
"10","013","00","010","0000","0000","10204","8036","2168","1173","11377","22402","25740","50.79","35.87"
"10","013","00","010","1001","0000","1358","1032","326","155","1513","3148","0","48.06","32.78"
"10","013","00","010","1001","0370","644","511","133","40","684","1598","0","42.8","31.98"
"10","013","00","010","1001","0371","714","521","193","115","829","1550","0","53.48","33.61"
"10","013","00","010","1002","0000","1230","978","252","132","1362","2832","0","48.09","34.53"
"10","013","00","010","1002","0365","635","493","142","72","707","1367","0","51.72","36.06"
"10","013","00","010","1002","0366","595","485","110","60","655","1465","0","44.71","33.11"
"10","013","00","010","1003","0000","835","650","185","65","900","1850","0","48.65","35.14"
"10","013","00","010","1003","0358","442","348","94","34","476","951","0","50.05","36.59"
"10","013","00","010","1003","0359","393","302","91","31","424","899","0","47.16","33.59"
"10","013","00","010","1004","0000","1003","791","212","85","1088","2357","0","46.16","33.56"
"10","013","00","010","1004","0360","437","343","94","31","468","1116","0","41.94","30.73"
"10","013","00","010","1004","0361","566","448","118","54","620","1241","0","49.96","36.1"
"10","013","00","010","1005","0000","785","631","154","103","888","1732","0","51.27","36.43"
"10","013","00","010","1005","0362","334","268","66","54","388","770","0","50.39","34.81"
"10","013","00","010","1005","0363","451","363","88","49","500","962","0","51.98","37.73"
"10","013","00","010","1006","0000","563","426","137","67","630","1041","0","60.52","40.92"
"10","013","00","010","1006","0364","563","426","137","67","630","1041","0","60.52","40.92"
"10","013","00","010","1007","0000","756","612","144","60","816","1852","0","44.06","33.05"
"10","013","00","010","1007","0367","365","286","79","54","419","894","0","46.87","31.99"
"10","013","00","010","1007","0368","391","326","65","6","397","958","0","41.44","34.03"
"10","013","00","010","1008","0000","271","218","53","34","305","553","0","55.15","39.42"
"10","013","00","010","1008","0377","271","218","53","34","305","553","0","55.15","39.42"
"10","013","00","010","1009","0000","404","327","77","86","490","924","0","53.03","35.39"
"10","013","00","010","1009","0369","404","327","77","86","490","924","0","53.03","35.39"
"10","013","00","010","1010","0000","788","600","188","66","854","1619","0","52.75","37.06"
"10","013","00","010","1010","0376","788","600","188","66","854","1619","0","52.75","37.06"
"10","013","00","010","1011","0000","1700","1362","338","240","1940","3510","0","55.27","38.8"
"10","013","00","010","1011","0372","515","416","99","85","600","1127","0","53.24","36.91"
"10","013","00","010","1011","0373","584","476","108","84","668","1150","0","58.09","41.39"
"10","013","00","010","1011","0374","601","470","131","71","672","1233","0","54.5","38.12"
"10","013","00","010","1012","0000","511","409","102","80","591","984","0","60.06","41.57"
"10","013","00","010","1012","0375","511","409","102","80","591","984","0","60.06","41.57"
"10","013","00","011","0000","0000","9124","6898","2226","1225","10349","21697","24444","47.7","31.79"
"10","013","00","011","1101","0000","896","653","243","104","1000","2138","0","46.77","30.54"
"10","013","00","011","1101","0378","466","337","129","79","545","883","0","61.72","38.17"
"10","013","00","011","1101","0379","430","316","114","25","455","1255","0","36.25","25.18"
"10","013","00","011","1102","0000","574","433","141","37","611","1278","0","47.81","33.88"
"10","013","00","011","1102","0380","574","433","141","37","611","1278","0","47.81","33.88"
"10","013","00","011","1103","0000","290","220","70","24","314","738","0","42.55","29.81"
"10","013","00","011","1103","0381","290","220","70","24","314","738","0","42.55","29.81"
"10","013","00","011","1104","0000","234","165","69","14","248","585","0","42.39","28.21"
"10","013","00","011","1104","0382","234","165","69","14","248","585","0","42.39","28.21"
"10","013","00","011","1105","0000","455","348","107","136","591","1012","0","58.4","34.39"
"10","013","00","011","1105","0383","455","348","107","136","591","1012","0","58.4","34.39"
"10","013","00","011","1106","0000","473","369","104","90","563","1148","0","49.04","32.14"
"10","013","00","011","1106","0384","473","369","104","90","563","1148","0","49.04","32.14"
"10","013","00","011","1107","0000","256","186","70","34","290","591","0","49.07","31.47"
"10","013","00","011","1107","0385","256","186","70","34","290","591","0","49.07","31.47"
"10","013","00","011","1108","0000","302","229","73","49","351","786","0","44.66","29.13"
"10","013","00","011","1108","0386","302","229","73","49","351","786","0","44.66","29.13"
"10","013","00","011","1109","0000","243","183","60","19","262","649","0","40.37","28.2"
"10","013","00","011","1109","0387","243","183","60","19","262","649","0","40.37","28.2"
"10","013","00","011","1110","0000","426","331","95","74","500","1229","0","40.68","26.93"
"10","013","00","011","1110","0388","426","331","95","74","500","1229","0","40.68","26.93"
"10","013","00","011","1111","0000","525","403","122","55","580","1446","0","40.11","27.87"
"10","013","00","011","1111","0389","525","403","122","55","580","1446","0","40.11","27.87"
"10","013","00","011","1112","0000","748","566","182","67","815","1821","0","44.76","31.08"
"10","013","00","011","1112","0390","326","248","78","18","344","899","0","38.26","27.59"
"10","013","00","011","1112","0391","422","318","104","49","471","922","0","51.08","34.49"
"10","013","00","011","1113","0000","512","391","121","88","600","1259","0","47.66","31.06"
"10","013","00","011","1113","0392","512","391","121","88","600","1259","0","47.66","31.06"
"10","013","00","011","1114","0000","357","289","68","25","382","1056","0","36.17","27.37"
"10","013","00","011","1114","0393","357","289","68","25","382","1056","0","36.17","27.37"
"10","013","00","011","1115","0000","537","414","123","68","605","1116","0","54.21","37.1"
"10","013","00","011","1115","0394","537","414","123","68","605","1116","0","54.21","37.1"
"10","013","00","011","1116","0000","488","349","139","78","566","1020","0","55.49","34.22"
"10","013","00","011","1116","0395","488","349","139","78","566","1020","0","55.49","34.22"
"10","013","00","011","1117","0000","488","380","108","84","572","1055","0","54.22","36.02"
"10","013","00","011","1117","0396","488","380","108","84","572","1055","0","54.22","36.02"
"10","013","00","011","1118","0000","569","439","130","74","643","1231","0","52.23","35.66"
"10","013","00","011","1118","0397","380","285","95","42","422","738","0","57.18","38.62"
"10","013","00","011","1118","0398","189","154","35","32","221","493","0","44.83","31.24"
"10","013","00","011","1119","0000","751","550","201","105","856","1539","0","55.62","35.74"
"10","013","00","011","1119","0399","751","550","201","105","856","1539","0","55.62","35.74"
"10","013","00","012","0000","0000","7901","6002","1899","986","8887","17945","20585","49.52","33.45"
"10","013","00","012","1201","0000","529","410","119","40","569","1239","0","45.92","33.09"
"10","013","00","012","1201","0400","529","410","119","40","569","1239","0","45.92","33.09"
"10","013","00","012","1202","0000","364","276","88","61","425","759","0","55.99","36.36"
"10","013","00","012","1202","0401","364","276","88","61","425","759","0","55.99","36.36"
"10","013","00","012","1203","0000","865","681","184","151","1016","1701","0","59.73","40.04"
"10","013","00","012","1203","0402","465","372","93","88","553","932","0","59.33","39.91"
"10","013","00","012","1203","0403","400","309","91","63","463","769","0","60.21","40.18"
"10","013","00","012","1204","0000","429","331","98","76","505","920","0","54.89","35.98"
"10","013","00","012","1204","0404","429","331","98","76","505","920","0","54.89","35.98"
"10","013","00","012","1205","0000","289","229","60","35","324","560","0","57.86","40.89"
"10","013","00","012","1205","0405","289","229","60","35","324","560","0","57.86","40.89"
"10","013","00","012","1206","0000","477","381","96","21","498","1120","0","44.46","34.02"
"10","013","00","012","1206","0406","477","381","96","21","498","1120","0","44.46","34.02"
"10","013","00","012","1207","0000","449","337","112","31","480","1048","0","45.8","32.16"
"10","013","00","012","1207","0407","449","337","112","31","480","1048","0","45.8","32.16"
"10","013","00","012","1208","0000","573","354","219","40","613","1438","0","42.63","24.62"
"10","013","00","012","1208","0408","573","354","219","40","613","1438","0","42.63","24.62"
"10","013","00","012","1209","0000","891","696","195","115","1006","2027","0","49.63","34.34"
"10","013","00","012","1209","0411","388","317","71","43","431","1020","0","42.25","31.08"
"10","013","00","012","1209","0412","503","379","124","72","575","1007","0","57.1","37.64"
"10","013","00","012","1210","0000","711","526","185","127","838","1647","0","50.88","31.94"
"10","013","00","012","1210","0409","352","253","99","63","415","834","0","49.76","30.34"
"10","013","00","012","1210","0410","359","273","86","64","423","813","0","52.03","33.58"
"10","013","00","012","1211","0000","628","481","147","101","729","1648","0","44.24","29.19"
"10","013","00","012","1211","0413","628","481","147","101","729","1648","0","44.24","29.19"
"10","013","00","012","1212","0000","651","485","166","65","716","1437","0","49.83","33.75"
"10","013","00","012","1212","0414","651","485","166","65","716","1437","0","49.83","33.75"
"10","013","00","012","1213","0000","473","355","118","22","495","1228","0","40.31","28.91"
"10","013","00","012","1213","0415","473","355","118","22","495","1228","0","40.31","28.91"
"10","013","00","012","1214","0000","572","460","112","101","673","1173","0","57.37","39.22"
"10","013","00","012","1214","0416","308","253","55","51","359","597","0","60.13","42.38"
"10","013","00","012","1214","0417","264","207","57","50","314","576","0","54.51","35.94"
"10","013","00","013","0000","0000","20066","15808","4258","1854","21920","47558","54167","46.09","33.24"
"10","013","00","013","1301","0000","1679","1346","333","106","1785","3979","0","44.86","33.83"
"10","013","00","013","1301","0418","555","440","115","44","599","1305","0","45.9","33.72"
"10","013","00","013","1301","0419","525","422","103","44","569","1287","0","44.21","32.79"
"10","013","00","013","1301","0420","599","484","115","18","617","1387","0","44.48","34.9"
"10","013","00","013","1302","0000","1349","1050","299","105","1454","3145","0","46.23","33.39"
"10","013","00","013","1302","0421","657","507","150","53","710","1540","0","46.1","32.92"
"10","013","00","013","1302","0422","692","543","149","52","744","1605","0","46.36","33.83"
"10","013","00","013","1303","0000","590","472","118","59","649","1326","0","48.94","35.6"
"10","013","00","013","1303","0423","590","472","118","59","649","1326","0","48.94","35.6"
"10","013","00","013","1304","0000","288","221","67","46","334","591","0","56.51","37.39"
"10","013","00","013","1304","0424","288","221","67","46","334","591","0","56.51","37.39"
"10","013","00","013","1305","0000","969","779","190","66","1035","2202","0","47.0","35.38"
"10","013","00","013","1305","0425","479","378","101","47","526","1123","0","46.84","33.66"
"10","013","00","013","1305","0426","490","401","89","19","509","1079","0","47.17","37.16"
"10","013","00","013","1306","0000","1358","1096","262","108","1466","2733","0","53.64","40.1"
"10","013","00","013","1306","0427","705","562","143","64","769","1485","0","51.78","37.85"
"10","013","00","013","1306","0428","653","534","119","44","697","1248","0","55.85","42.79"
"10","013","00","013","1307","0000","1973","1505","468","130","2103","4482","0","46.92","33.58"
"10","013","00","013","1307","0429","719","567","152","55","774","1569","0","49.33","36.14"
"10","013","00","013","1307","0430","655","512","143","59","714","1493","0","47.82","34.29"
"10","013","00","013","1307","0431","599","426","173","16","615","1420","0","43.31","30.0"
"10","013","00","013","1308","0000","1269","998","271","163","1432","2853","0","50.19","34.98"
"10","013","00","013","1308","0432","610","479","131","85","695","1334","0","52.1","35.91"
"10","013","00","013","1308","0433","659","519","140","78","737","1519","0","48.52","34.17"
"10","013","00","013","1309","0000","810","648","162","114","924","1672","0","55.26","38.76"
"10","013","00","013","1309","0434","374","298","76","49","423","784","0","53.95","38.01"
"10","013","00","013","1309","0435","436","350","86","65","501","888","0","56.42","39.41"
"10","013","00","013","1310","0000","673","521","152","38","711","1915","0","37.13","27.21"
"10","013","00","013","1310","0436","244","193","51","12","256","747","0","34.27","25.84"
"10","013","00","013","1310","0437","429","328","101","26","455","1168","0","38.96","28.08"
"10","013","00","013","1311","0000","857","665","192","91","948","1824","0","51.97","36.46"
"10","013","00","013","1311","0438","279","217","62","33","312","546","0","57.14","39.74"
"10","013","00","013","1311","0439","578","448","130","58","636","1278","0","49.77","35.05"
"10","013","00","013","1312","0000","1092","835","257","134","1226","2898","0","42.31","28.81"
"10","013","00","013","1312","0440","532","410","122","47","579","1348","0","42.95","30.42"
"10","013","00","013","1312","0441","560","425","135","87","647","1550","0","41.74","27.42"
"10","013","00","013","1313","0000","497","376","121","76","573","947","0","60.51","39.7"
"10","013","00","013","1313","0442","497","376","121","76","573","947","0","60.51","39.7"
"10","013","00","013","1314","0000","482","372","110","82","564","1097","0","51.41","33.91"
"10","013","00","013","1314","0443","482","372","110","82","564","1097","0","51.41","33.91"
"10","013","00","013","1315","0000","804","613","191","75","879","2381","0","36.92","25.75"
"10","013","00","013","1315","0444","424","315","109","51","475","1128","0","42.11","27.93"
"10","013","00","013","1315","0445","380","298","82","24","404","1253","0","32.24","23.78"
"10","013","00","013","1316","0000","512","393","119","29","541","1525","0","35.48","25.77"
"10","013","00","013","1316","0446","512","393","119","29","541","1525","0","35.48","25.77"
"10","013","00","013","1317","0000","1009","815","194","117","1126","2431","0","46.32","33.53"
"10","013","00","013","1317","0447","547","445","102","89","636","1215","0","52.35","36.63"
"10","013","00","013","1317","0448","462","370","92","28","490","1216","0","40.3","30.43"
"10","013","00","013","1318","0000","998","814","184","76","1074","2379","0","45.15","34.22"
"10","013","00","013","1318","0449","550","450","100","36","586","1353","0","43.31","33.26"
"10","013","00","013","1318","0450","448","364","84","40","488","1026","0","47.56","35.48"
"10","013","00","013","1319","0000","349","285","64","29","378","862","0","43.85","33.06"
"10","013","00","013","1319","0451","349","285","64","29","378","862","0","43.85","33.06"
"10","013","00","013","1320","0000","696","546","150","56","752","1775","0","42.37","30.76"
"10","013","00","013","1320","0452","317","234","83","32","349","921","0","37.89","25.41"
"10","013","00","013","1320","0453","379","312","67","24","403","854","0","47.19","36.53"
"10","013","00","013","1321","0000","924","738","186","63","987","2434","0","40.55","30.32"
"10","013","00","013","1321","0454","480","385","95","37","517","1230","0","42.03","31.3"
"10","013","00","013","1321","0455","444","353","91","26","470","1204","0","39.04","29.32"
"10","013","00","013","1322","0000","488","393","95","45","533","1301","0","40.97","30.21"
"10","013","00","013","1322","0456","488","393","95","45","533","1301","0","40.97","30.21"
"10","013","00","013","1323","0000","400","327","73","46","446","806","0","55.33","40.57"
"10","013","00","013","1323","0457","400","327","73","46","446","806","0","55.33","40.57"
"10","013","00","014","0000","0000","7906","6113","1793","867","8773","15353","17181","57.14","39.82"
"10","013","00","014","1401","0000","756","577","179","79","835","1503","0","55.56","38.39"
"10","013","00","014","1401","0458","756","577","179","79","835","1503","0","55.56","38.39"
"10","013","00","014","1402","0000","507","383","124","44","551","899","0","61.29","42.6"
"10","013","00","014","1402","0459","507","383","124","44","551","899","0","61.29","42.6"
"10","013","00","014","1403","0000","410","332","78","40","450","716","0","62.85","46.37"
"10","013","00","014","1403","0460","410","332","78","40","450","716","0","62.85","46.37"
"10","013","00","014","1404","0000","342","257","85","40","382","581","0","65.75","44.23"
"10","013","00","014","1404","0461","342","257","85","40","382","581","0","65.75","44.23"
"10","013","00","014","1405","0000","641","487","154","102","743","1327","0","55.99","36.7"
"10","013","00","014","1405","0462","641","487","154","102","743","1327","0","55.99","36.7"
"10","013","00","014","1406","0000","536","388","148","84","620","997","0","62.19","38.92"
"10","013","00","014","1406","0463","536","388","148","84","620","997","0","62.19","38.92"
"10","013","00","014","1407","0000","317","261","56","24","341","649","0","52.54","40.22"
"10","013","00","014","1407","0464","317","261","56","24","341","649","0","52.54","40.22"
"10","013","00","014","1408","0000","320","262","58","25","345","476","0","72.48","55.04"
"10","013","00","014","1408","0465","320","262","58","25","345","476","0","72.48","55.04"
"10","013","00","014","1409","0000","1252","989","263","126","1378","2486","0","55.43","39.78"
"10","013","00","014","1409","0466","677","534","143","60","737","1259","0","58.54","42.41"
"10","013","00","014","1409","0467","575","455","120","66","641","1227","0","52.24","37.08"
"10","013","00","014","1410","0000","283","227","56","39","322","504","0","63.89","45.04"
"10","013","00","014","1410","0468","283","227","56","39","322","504","0","63.89","45.04"
"10","013","00","014","1411","0000","411","324","87","50","461","860","0","53.6","37.67"
"10","013","00","014","1411","0469","411","324","87","50","461","860","0","53.6","37.67"
"10","013","00","014","1412","0000","387","298","89","20","407","800","0","50.88","37.25"
"10","013","00","014","1412","0470","387","298","89","20","407","800","0","50.88","37.25"
"10","013","00","014","1413","0000","595","434","161","59","654","1134","0","57.67","38.27"
"10","013","00","014","1413","0471","595","434","161","59","654","1134","0","57.67","38.27"
"10","013","00","014","1414","0000","596","458","138","66","662","1229","0","53.86","37.27"
"10","013","00","014","1414","0472","596","458","138","66","662","1229","0","53.86","37.27"
"10","013","00","014","1415","0000","553","436","117","69","622","1192","0","52.18","36.58"
"10","013","00","014","1415","0473","553","436","117","69","622","1192","0","52.18","36.58"
"10","013","00","015","0000","0000","4005","3096","909","465","4470","9033","10035","49.49","34.27"
"10","013","00","015","1501","0000","876","672","204","71","947","2026","0","46.74","33.17"
"10","013","00","015","1501","0474","730","564","166","44","774","1712","0","45.21","32.94"
"10","013","00","015","1501","0475","146","108","38","27","173","314","0","55.1","34.39"
"10","013","00","015","1502","0000","530","417","113","60","590","1086","0","54.33","38.4"
"10","013","00","015","1502","0476","370","288","82","37","407","752","0","54.12","38.3"
"10","013","00","015","1502","0477","160","129","31","23","183","334","0","54.79","38.62"
"10","013","00","015","1503","0000","471","353","118","64","535","957","0","55.9","36.89"
"10","013","00","015","1503","0478","471","353","118","64","535","957","0","55.9","36.89"
"10","013","00","015","1504","0000","396","308","88","55","451","764","0","59.03","40.31"
"10","013","00","015","1504","0479","396","308","88","55","451","764","0","59.03","40.31"
"10","013","00","015","1505","0000","752","571","181","88","840","1752","0","47.95","32.59"
"10","013","00","015","1505","0480","181","130","51","32","213","373","0","57.1","34.85"
"10","013","00","015","1505","0481","280","216","64","33","313","678","0","46.17","31.86"
"10","013","00","015","1505","0482","291","225","66","23","314","701","0","44.79","32.1"
"10","013","00","015","1506","0000","500","402","98","72","572","1125","0","50.84","35.73"
"10","013","00","015","1506","0484","270","219","51","39","309","541","0","57.12","40.48"
"10","013","00","015","1506","0485","230","183","47","33","263","584","0","45.03","31.34"
"10","013","00","015","1507","0000","480","373","107","55","535","1323","0","40.44","28.19"
"10","013","00","015","1507","0483","480","373","107","55","535","1323","0","40.44","28.19"
"10","013","00","016","0000","0000","9835","7667","2168","1370","11205","21394","24413","52.37","35.84"
"10","013","00","016","1601","0000","604","481","123","75","679","1213","0","55.98","39.65"
"10","013","00","016","1601","0486","604","481","123","75","679","1213","0","55.98","39.65"
"10","013","00","016","1602","0000","443","329","114","69","512","891","0","57.46","36.92"
"10","013","00","016","1602","0487","443","329","114","69","512","891","0","57.46","36.92"
"10","013","00","016","1603","0000","400","308","92","96","496","970","0","51.13","31.75"
"10","013","00","016","1603","0488","400","308","92","96","496","970","0","51.13","31.75"
"10","013","00","016","1604","0000","302","243","59","32","334","629","0","53.1","38.63"
"10","013","00","016","1604","0489","302","243","59","32","334","629","0","53.1","38.63"
"10","013","00","016","1605","0000","829","654","175","78","907","1614","0","56.2","40.52"
"10","013","00","016","1605","0490","434","340","94","35","469","840","0","55.83","40.48"
"10","013","00","016","1605","0491","395","314","81","43","438","774","0","56.59","40.57"
"10","013","00","016","1606","0000","1942","1505","437","230","2172","4157","0","52.25","36.2"
"10","013","00","016","1606","0492","629","471","158","82","711","1379","0","51.56","34.16"
"10","013","00","016","1606","0493","739","602","137","68","807","1502","0","53.73","40.08"
"10","013","00","016","1606","0494","574","432","142","80","654","1276","0","51.25","33.86"
"10","013","00","016","1607","0000","955","748","207","164","1119","1969","0","56.83","37.99"
"10","013","00","016","1607","0495","448","347","101","67","515","964","0","53.42","36.0"
"10","013","00","016","1607","0496","507","401","106","97","604","1005","0","60.1","39.9"
"10","013","00","016","1608","0000","650","520","130","85","735","1459","0","50.38","35.64"
"10","013","00","016","1608","0497","304","250","54","23","327","734","0","44.55","34.06"
"10","013","00","016","1608","0498","346","270","76","62","408","725","0","56.28","37.24"
"10","013","00","016","1609","0000","968","756","212","148","1116","2113","0","52.82","35.78"
"10","013","00","016","1609","0499","440","339","101","73","513","1046","0","49.04","32.41"
"10","013","00","016","1609","0500","528","417","111","75","603","1067","0","56.51","39.08"
"10","013","00","016","1610","0000","214","159","55","63","277","718","0","38.58","22.14"
"10","013","00","016","1610","0501","214","159","55","63","277","718","0","38.58","22.14"
"10","013","00","016","1611","0000","377","304","73","49","426","903","0","47.18","33.67"
"10","013","00","016","1611","0502","377","304","73","49","426","903","0","47.18","33.67"
"10","013","00","016","1612","0000","349","287","62","35","384","959","0","40.04","29.93"
"10","013","00","016","1612","0506","349","287","62","35","384","959","0","40.04","29.93"
"10","013","00","016","1613","0000","208","168","40","28","236","427","0","55.27","39.34"
"10","013","00","016","1613","0507","208","168","40","28","236","427","0","55.27","39.34"
"10","013","00","016","1614","0000","1256","956","300","172","1428","2754","0","51.85","34.71"
"10","013","00","016","1614","0503","606","455","151","84","690","1387","0","49.75","32.8"
"10","013","00","016","1614","0504","650","501","149","88","738","1367","0","53.99","36.65"
"10","013","00","016","1615","0000","338","249","89","46","384","618","0","62.14","40.29"
"10","013","00","016","1615","0505","338","249","89","46","384","618","0","62.14","40.29"
"10","013","00","017","0000","0000","14024","10874","3150","1928","15952","30706","34961","51.95","35.41"
"10","013","00","017","1701","0000","875","708","167","106","981","1663","0","58.99","42.57"
"10","013","00","017","1701","0508","426","332","94","46","472","820","0","57.56","40.49"
"10","013","00","017","1701","0509","449","376","73","60","509","843","0","60.38","44.6"
"10","013","00","017","1702","0000","1269","1034","235","114","1383","2532","0","54.62","40.84"
"10","013","00","017","1702","0510","587","479","108","56","643","1242","0","51.77","38.57"
"10","013","00","017","1702","0511","682","555","127","58","740","1290","0","57.36","43.02"
"10","013","00","017","1703","0000","1074","821","253","150","1224","2161","0","56.64","37.99"
"10","013","00","017","1703","0512","512","401","111","53","565","1073","0","52.66","37.37"
"10","013","00","017","1703","0513","562","420","142","97","659","1088","0","60.57","38.6"
"10","013","00","017","1704","0000","376","294","82","44","420","845","0","49.7","34.79"
"10","013","00","017","1704","0514","376","294","82","44","420","845","0","49.7","34.79"
"10","013","00","017","1705","0000","412","317","95","52","464","862","0","53.83","36.77"
"10","013","00","017","1705","0515","412","317","95","52","464","862","0","53.83","36.77"
"10","013","00","017","1706","0000","1032","777","255","167","1199","2292","0","52.31","33.9"
"10","013","00","017","1706","0516","515","389","126","73","588","1183","0","49.7","32.88"
"10","013","00","017","1706","0517","517","388","129","94","611","1109","0","55.09","34.99"
"10","013","00","017","1707","0000","996","761","235","51","1047","2271","0","46.1","33.51"
"10","013","00","017","1707","0518","468","366","102","14","482","1119","0","43.07","32.71"
"10","013","00","017","1707","0519","528","395","133","37","565","1152","0","49.05","34.29"
"10","013","00","017","1708","0000","504","389","115","0","504","1240","0","40.65","31.37"
"10","013","00","017","1708","0522","504","389","115","0","504","1240","0","40.65","31.37"
"10","013","00","017","1709","0000","946","724","222","99","1045","2194","0","47.63","33.0"
"10","013","00","017","1709","0523","395","299","96","26","421","1120","0","37.59","26.7"
"10","013","00","017","1709","0524","551","425","126","73","624","1074","0","58.1","39.57"
"10","013","00","017","1710","0000","699","528","171","110","809","1598","0","50.63","33.04"
"10","013","00","017","1710","0525","351","275","76","46","397","849","0","46.76","32.39"
"10","013","00","017","1710","0526","348","253","95","64","412","749","0","55.01","33.78"
"10","013","00","017","1711","0000","633","481","152","83","716","1416","0","50.56","33.97"
"10","013","00","017","1711","0527","633","481","152","83","716","1416","0","50.56","33.97"
"10","013","00","017","1712","0000","1011","787","224","146","1157","2134","0","54.22","36.88"
"10","013","00","017","1712","0520","511","396","115","58","569","1030","0","55.24","38.45"
"10","013","00","017","1712","0521","500","391","109","88","588","1104","0","53.26","35.42"
"10","013","00","017","1713","0000","1326","1047","279","185","1511","2800","0","53.96","37.39"
"10","013","00","017","1713","0528","412","317","95","71","483","895","0","53.97","35.42"
"10","013","00","017","1713","0529","458","376","82","62","520","933","0","55.73","40.3"
"10","013","00","017","1713","0530","456","354","102","52","508","972","0","52.26","36.42"
"10","013","00","017","1714","0000","1849","1433","416","355","2204","4377","0","50.35","32.74"
"10","013","00","017","1714","0531","523","393","130","83","606","1454","0","41.68","27.03"
"10","013","00","017","1714","0532","803","628","175","162","965","1653","0","58.38","37.99"
"10","013","00","017","1714","0533","523","412","111","110","633","1270","0","49.84","32.44"
"10","013","00","017","1715","0000","1022","773","249","266","1288","2321","0","55.49","33.3"
"10","013","00","017","1715","0534","530","401","129","144","674","1123","0","60.02","35.71"
"10","013","00","017","1715","0535","492","372","120","122","614","1198","0","51.25","31.05"
"10","013","00","018","0000","0000","5727","4496","1231","563","6290","12270","15524","51.26","36.64"
"10","013","00","018","1801","0000","1048","859","189","102","1150","2234","0","51.48","38.45"
"10","013","00","018","1801","0536","517","428","89","45","562","1190","0","47.23","35.97"
"10","013","00","018","1801","0537","531","431","100","57","588","1044","0","56.32","41.28"
"10","013","00","018","1802","0000","974","739","235","102","1076","2032","0","52.95","36.37"
"10","013","00","018","1802","0538","404","307","97","49","453","818","0","55.38","37.53"
"10","013","00","018","1802","0539","570","432","138","53","623","1214","0","51.32","35.58"
"10","013","00","018","1803","0000","632","512","120","67","699","1253","0","55.79","40.86"
"10","013","00","018","1803","0541","632","512","120","67","699","1253","0","55.79","40.86"
"10","013","00","018","1804","0000","563","443","120","31","594","1325","0","44.83","33.43"
"10","013","00","018","1804","0540","563","443","120","31","594","1325","0","44.83","33.43"
"10","013","00","018","1805","0000","478","388","90","50","528","1039","0","50.82","37.34"
"10","013","00","018","1805","0542","478","388","90","50","528","1039","0","50.82","37.34"
"10","013","00","018","1806","0000","650","502","148","69","719","1549","0","46.42","32.41"
"10","013","00","018","1806","0543","338","261","77","49","387","813","0","47.6","32.1"
"10","013","00","018","1806","0544","312","241","71","20","332","736","0","45.11","32.74"
"10","013","00","018","1807","0000","486","368","118","40","526","934","0","56.32","39.4"
"10","013","00","018","1807","0545","486","368","118","40","526","934","0","56.32","39.4"
"10","013","00","018","1808","0000","896","685","211","102","998","1904","0","52.42","35.98"
"10","013","00","018","1808","0546","418","310","108","53","471","900","0","52.33","34.44"
"10","013","00","018","1808","0547","478","375","103","49","527","1004","0","52.49","37.35"
"10","013","00","019","0000","0000","7618","5897","1721","991","8609","15691","17842","54.87","37.58"
"10","013","00","019","1901","0000","749","579","170","121","870","1458","0","59.67","39.71"
"10","013","00","019","1901","0548","749","579","170","121","870","1458","0","59.67","39.71"
"10","013","00","019","1902","0000","843","668","175","93","936","1586","0","59.02","42.12"
"10","013","00","019","1902","0549","469","359","110","51","520","891","0","58.36","40.29"
"10","013","00","019","1902","0550","374","309","65","42","416","695","0","59.86","44.46"
"10","013","00","019","1903","0000","833","630","203","128","961","1634","0","58.81","38.56"
"10","013","00","019","1903","0555","422","309","113","68","490","841","0","58.26","36.74"
"10","013","00","019","1903","0556","411","321","90","60","471","793","0","59.39","40.48"
"10","013","00","019","1904","0000","409","293","116","50","459","725","0","63.31","40.41"
"10","013","00","019","1904","0554","409","293","116","50","459","725","0","63.31","40.41"
"10","013","00","019","1905","0000","1622","1254","368","179","1801","3189","0","56.48","39.32"
"10","013","00","019","1905","0551","531","392","139","73","604","1015","0","59.51","38.62"
"10","013","00","019","1905","0552","620","489","131","52","672","1171","0","57.39","41.76"
"10","013","00","019","1905","0553","471","373","98","54","525","1003","0","52.34","37.19"
"10","013","00","019","1906","0000","737","577","160","99","836","1816","0","46.04","31.77"
"10","013","00","019","1906","0559","326","250","76","45","371","783","0","47.38","31.93"
"10","013","00","019","1906","0560","411","327","84","54","465","1033","0","45.01","31.66"
"10","013","00","019","1907","0000","576","454","122","63","639","1283","0","49.81","35.39"
"10","013","00","019","1907","0558","576","454","122","63","639","1283","0","49.81","35.39"
"10","013","00","019","1908","0000","490","399","91","56","546","919","0","59.41","43.42"
"10","013","00","019","1908","0557","490","399","91","56","546","919","0","59.41","43.42"
"10","013","00","019","1909","0000","886","677","209","169","1055","1959","0","53.85","34.56"
"10","013","00","019","1909","0561","533","414","119","102","635","1186","0","53.54","34.91"
"10","013","00","019","1909","0562","353","263","90","67","420","773","0","54.33","34.02"
"10","013","00","019","1910","0000","473","366","107","33","506","1122","0","45.1","32.62"
"10","013","00","019","1910","0563","473","366","107","33","506","1122","0","45.1","32.62"
"10","013","00","020","0000","0000","4445","3479","966","493","4938","9479","10650","52.09","36.7"
"10","013","00","020","2001","0000","798","637","161","87","885","1666","0","53.12","38.24"
"10","013","00","020","2001","0564","404","322","82","45","449","872","0","51.49","36.93"
"10","013","00","020","2001","0565","394","315","79","42","436","794","0","54.91","39.67"
"10","013","00","020","2002","0000","500","393","107","56","556","962","0","57.8","40.85"
"10","013","00","020","2002","0566","500","393","107","56","556","962","0","57.8","40.85"
"10","013","00","020","2003","0000","249","180","69","22","271","466","0","58.15","38.63"
"10","013","00","020","2003","0569","249","180","69","22","271","466","0","58.15","38.63"
"10","013","00","020","2004","0000","365","299","66","42","407","708","0","57.49","42.23"
"10","013","00","020","2004","0570","365","299","66","42","407","708","0","57.49","42.23"
"10","013","00","020","2005","0000","516","397","119","62","578","1033","0","55.95","38.43"
"10","013","00","020","2005","0567","516","397","119","62","578","1033","0","55.95","38.43"
"10","013","00","020","2006","0000","461","358","103","50","511","1007","0","50.74","35.55"
"10","013","00","020","2006","0568","461","358","103","50","511","1007","0","50.74","35.55"
"10","013","00","020","2007","0000","524","404","120","67","591","1044","0","56.61","38.7"
"10","013","00","020","2007","0571","524","404","120","67","591","1044","0","56.61","38.7"
"10","013","00","020","2008","0000","390","306","84","39","429","1071","0","40.06","28.57"
"10","013","00","020","2008","0572","390","306","84","39","429","1071","0","40.06","28.57"
"10","013","00","020","2009","0000","400","313","87","37","437","979","0","44.64","31.97"
"10","013","00","020","2009","0573","400","313","87","37","437","979","0","44.64","31.97"
"10","013","00","020","2010","0000","242","192","50","31","273","543","0","50.28","35.36"
"10","013","00","020","2010","0574","242","192","50","31","273","543","0","50.28","35.36"
"10","013","00","021","0000","0000","7344","5700","1644","1050","8394","17063","19172","49.19","33.41"
"10","013","00","021","2101","0000","611","475","136","76","687","1472","0","46.67","32.27"
"10","013","00","021","2101","0575","611","475","136","76","687","1472","0","46.67","32.27"
"10","013","00","021","2102","0000","514","398","116","79","593","1360","0","43.6","29.26"
"10","013","00","021","2102","0576","514","398","116","79","593","1360","0","43.6","29.26"
"10","013","00","021","2103","0000","394","297","97","69","463","804","0","57.59","36.94"
"10","013","00","021","2103","0577","394","297","97","69","463","804","0","57.59","36.94"
"10","013","00","021","2104","0000","750","579","171","100","850","1780","0","47.75","32.53"
"10","013","00","021","2104","0578","405","302","103","81","486","925","0","52.54","32.65"
"10","013","00","021","2104","0579","345","277","68","19","364","855","0","42.57","32.4"
"10","013","00","021","2105","0000","854","680","174","113","967","1988","0","48.64","34.21"
"10","013","00","021","2105","0580","423","341","82","57","480","981","0","48.93","34.76"
"10","013","00","021","2105","0581","431","339","92","56","487","1007","0","48.36","33.66"
"10","013","00","021","2106","0000","937","741","196","139","1076","2127","0","50.59","34.84"
"10","013","00","021","2106","0582","442","357","85","63","505","872","0","57.91","40.94"
"10","013","00","021","2106","0583","495","384","111","76","571","1255","0","45.5","30.6"
"10","013","00","021","2107","0000","449","369","80","96","545","995","0","54.77","37.09"
"10","013","00","021","2107","0584","449","369","80","96","545","995","0","54.77","37.09"
"10","013","00","021","2108","0000","251","194","57","27","278","734","0","37.87","26.43"
"10","013","00","021","2108","0585","251","194","57","27","278","734","0","37.87","26.43"
"10","013","00","021","2109","0000","442","350","92","36","478","1178","0","40.58","29.71"
"10","013","00","021","2109","0586","442","350","92","36","478","1178","0","40.58","29.71"
"10","013","00","021","2110","0000","440","333","107","60","500","1095","0","45.66","30.41"
"10","013","00","021","2110","0587","440","333","107","60","500","1095","0","45.66","30.41"
"10","013","00","021","2111","0000","532","402","130","116","648","1097","0","59.07","36.65"
"10","013","00","021","2111","0588","532","402","130","116","648","1097","0","59.07","36.65"
"10","013","00","021","2112","0000","1170","882","288","139","1309","2433","0","53.8","36.25"
"10","013","00","021","2112","0589","593","452","141","62","655","1273","0","51.45","35.51"
"10","013","00","021","2112","0590","577","430","147","77","654","1160","0","56.38","37.07"
"10","013","00","022","0000","0000","4032","3306","726","551","4583","10706","12395","42.81","30.88"
"10","013","00","022","2201","0000","765","620","145","102","867","2083","0","41.62","29.76"
"10","013","00","022","2201","0591","396","323","73","47","443","1111","0","39.87","29.07"
"10","013","00","022","2201","0592","369","297","72","55","424","972","0","43.62","30.56"
"10","013","00","022","2202","0000","567","464","103","82","649","1278","0","50.78","36.31"
"10","013","00","022","2202","0593","567","464","103","82","649","1278","0","50.78","36.31"
"10","013","00","022","2203","0000","413","349","64","82","495","976","0","50.72","35.76"
"10","013","00","022","2203","0594","413","349","64","82","495","976","0","50.72","35.76"
"10","013","00","022","2204","0000","687","538","149","87","774","1658","0","46.68","32.45"
"10","013","00","022","2204","0595","687","538","149","87","774","1658","0","46.68","32.45"
"10","013","00","022","2205","0000","381","312","69","58","439","1146","0","38.31","27.23"
"10","013","00","022","2205","0596","381","312","69","58","439","1146","0","38.31","27.23"
"10","013","00","022","2206","0000","371","308","63","48","419","1079","0","38.83","28.54"
"10","013","00","022","2206","0597","371","308","63","48","419","1079","0","38.83","28.54"
"10","013","00","022","2207","0000","467","398","69","29","496","1613","0","30.75","24.67"
"10","013","00","022","2207","0598","467","398","69","29","496","1613","0","30.75","24.67"
"10","013","00","022","2208","0000","381","317","64","63","444","873","0","50.86","36.31"
"10","013","00","022","2208","0599","381","317","64","63","444","873","0","50.86","36.31"
"10","013","00","023","0000","0000","2747","2167","580","279","3026","7595","8619","39.84","28.53"
"10","013","00","023","2301","0000","561","444","117","53","614","1347","0","45.58","32.96"
"10","013","00","023","2301","0602","195","159","36","21","216","491","0","43.99","32.38"
"10","013","00","023","2301","0603","366","285","81","32","398","856","0","46.5","33.29"
"10","013","00","023","2302","0000","214","159","55","10","224","554","0","40.43","28.7"
"10","013","00","023","2302","0604","214","159","55","10","224","554","0","40.43","28.7"
"10","013","00","023","2303","0000","203","154","49","38","241","647","0","37.25","23.8"
"10","013","00","023","2303","0601","203","154","49","38","241","647","0","37.25","23.8"
"10","013","00","023","2304","0000","268","208","60","41","309","737","0","41.93","28.22"
"10","013","00","023","2304","0600","268","208","60","41","309","737","0","41.93","28.22"
"10","013","00","023","2305","0000","134","106","28","5","139","388","0","35.82","27.32"
"10","013","00","023","2305","0605","134","106","28","5","139","388","0","35.82","27.32"
"10","013","00","023","2306","0000","330","251","79","34","364","922","0","39.48","27.22"
"10","013","00","023","2306","0606","330","251","79","34","364","922","0","39.48","27.22"
"10","013","00","023","2307","0000","343","277","66","17","360","1220","0","29.51","22.7"
"10","013","00","023","2307","0607","174","143","31","8","182","597","0","30.49","23.95"
"10","013","00","023","2307","0608","169","134","35","9","178","623","0","28.57","21.51"
"10","013","00","023","2308","0000","165","136","29","26","191","425","0","44.94","32.0"
"10","013","00","023","2308","0609","165","136","29","26","191","425","0","44.94","32.0"
"10","013","00","023","2309","0000","194","165","29","21","215","428","0","50.23","38.55"
"10","013","00","023","2309","0610","194","165","29","21","215","428","0","50.23","38.55"
"10","013","00","023","2310","0000","153","123","30","11","164","504","0","32.54","24.4"
"10","013","00","023","2310","0611","153","123","30","11","164","504","0","32.54","24.4"
"10","013","00","023","2311","0000","182","144","38","23","205","423","0","48.46","34.04"
"10","013","00","023","2311","0612","182","144","38","23","205","423","0","48.46","34.04"
"10","013","00","024","0000","0000","2767","2211","556","240","3007","7206","8068","41.73","30.68"
"10","013","00","024","2401","0000","674","534","140","49","723","1575","0","45.9","33.9"
"10","013","00","024","2401","0613","674","534","140","49","723","1575","0","45.9","33.9"
"10","013","00","024","2402","0000","175","146","29","9","184","420","0","43.81","34.76"
"10","013","00","024","2402","0614","175","146","29","9","184","420","0","43.81","34.76"
"10","013","00","024","2403","0000","433","350","83","24","457","1302","0","35.1","26.88"
"10","013","00","024","2403","0616","433","350","83","24","457","1302","0","35.1","26.88"
"10","013","00","024","2404","0000","543","429","114","60","603","1314","0","45.89","32.65"
"10","013","00","024","2404","0617","543","429","114","60","603","1314","0","45.89","32.65"
"10","013","00","024","2405","0000","320","256","64","29","349","602","0","57.97","42.52"
"10","013","00","024","2405","0615","320","256","64","29","349","602","0","57.97","42.52"
"10","013","00","024","2406","0000","360","287","73","30","390","1308","0","29.82","21.94"
"10","013","00","024","2406","0618","360","287","73","30","390","1308","0","29.82","21.94"
"10","013","00","024","2407","0000","121","95","26","14","135","367","0","36.78","25.89"
"10","013","00","024","2407","0619","121","95","26","14","135","367","0","36.78","25.89"
"10","013","00","024","2408","0000","141","114","27","25","166","318","0","52.2","35.85"
"10","013","00","024","2408","0620","141","114","27","25","166","318","0","52.2","35.85"
"10","013","00","025","0000","0000","2173","1689","484","236","2409","4856","5547","49.61","34.78"
"10","013","00","025","2501","0000","562","445","117","64","626","1032","0","60.66","43.12"
"10","013","00","025","2501","0621","336","267","69","31","367","604","0","60.76","44.21"
"10","013","00","025","2501","0622","226","178","48","33","259","428","0","60.51","41.59"
"10","013","00","025","2502","0000","946","735","211","88","1034","1900","0","54.42","38.68"
"10","013","00","025","2502","0623","511","396","115","67","578","928","0","62.28","42.67"
"10","013","00","025","2502","0624","435","339","96","21","456","972","0","46.91","34.88"
"10","013","00","025","2503","0000","395","304","91","61","456","1041","0","43.8","29.2"
"10","013","00","025","2503","0625","395","304","91","61","456","1041","0","43.8","29.2"
"10","013","00","025","2504","0000","270","205","65","23","293","883","0","33.18","23.22"
"10","013","00","025","2504","0626","270","205","65","23","293","883","0","33.18","23.22"
"10","013","00","026","0000","0000","2901","2295","606","279","3180","6373","7694","49.9","36.01"
"10","013","00","026","2601","0000","734","575","159","59","793","1448","0","54.77","39.71"
"10","013","00","026","2601","0630","734","575","159","59","793","1448","0","54.77","39.71"
"10","013","00","026","2602","0000","126","103","23","15","141","323","0","43.65","31.89"
"10","013","00","026","2602","0629","126","103","23","15","141","323","0","43.65","31.89"
"10","013","00","026","2603","0000","289","223","66","58","347","572","0","60.66","38.99"
"10","013","00","026","2603","0628","289","223","66","58","347","572","0","60.66","38.99"
"10","013","00","026","2604","0000","241","193","48","18","259","616","0","42.05","31.33"
"10","013","00","026","2604","0627","241","193","48","18","259","616","0","42.05","31.33"
"10","013","00","026","2605","0000","206","166","40","7","213","726","0","29.34","22.87"
"10","013","00","026","2605","0631","206","166","40","7","213","726","0","29.34","22.87"
"10","013","00","026","2606","0000","260","199","61","27","287","554","0","51.81","35.92"
"10","013","00","026","2606","0632","260","199","61","27","287","554","0","51.81","35.92"
"10","013","00","026","2607","0000","165","125","40","15","180","346","0","52.02","36.13"
"10","013","00","026","2607","0633","165","125","40","15","180","346","0","52.02","36.13"
"10","013","00","026","2608","0000","155","118","37","1","156","458","0","34.06","25.76"
"10","013","00","026","2608","0634","155","118","37","1","156","458","0","34.06","25.76"
"10","013","00","026","2609","0000","346","280","66","11","357","692","0","51.59","40.46"
"10","013","00","026","2609","0635","346","280","66","11","357","692","0","51.59","40.46"
"10","013","00","026","2610","0000","379","313","66","68","447","638","0","70.06","49.06"
"10","013","00","026","2610","0636","379","313","66","68","447","638","0","70.06","49.06"
"10","013","00","027","0000","0000","1452","1151","301","109","1561","2950","3376","52.92","39.02"
"10","013","00","027","2701","0000","609","493","116","43","652","1185","0","55.02","41.6"
"10","013","00","027","2701","0637","237","191","46","29","266","346","0","76.88","55.2"
"10","013","00","027","2701","0638","323","262","61","14","337","677","0","49.78","38.7"
"10","013","00","027","2701","0639","49","40","9","0","49","162","0","30.25","24.69"
"10","013","00","027","2702","0000","175","151","24","35","210","296","0","70.95","51.01"
"10","013","00","027","2702","0641","175","151","24","35","210","296","0","70.95","51.01"
"10","013","00","027","2703","0000","86","71","15","4","90","189","0","47.62","37.57"
"10","013","00","027","2703","0640","86","71","15","4","90","189","0","47.62","37.57"
"10","013","00","027","2704","0000","194","142","52","14","208","450","0","46.22","31.56"
"10","013","00","027","2704","0644","194","142","52","14","208","450","0","46.22","31.56"
"10","013","00","027","2705","0000","132","100","32","2","134","347","0","38.62","28.82"
"10","013","00","027","2705","0643","132","100","32","2","134","347","0","38.62","28.82"
"10","013","00","027","2706","0000","256","194","62","11","267","483","0","55.28","40.17"
"10","013","00","027","2706","0642","256","194","62","11","267","483","0","55.28","40.17"
"10","013","00","028","0000","0000","3051","2394","657","223","3274","5663","6833","57.81","42.27"
"10","013","00","028","2801","0000","212","163","49","2","214","455","0","47.03","35.82"
"10","013","00","028","2801","0645","212","163","49","2","214","455","0","47.03","35.82"
"10","013","00","028","2802","0000","497","357","140","45","542","821","0","66.02","43.48"
"10","013","00","028","2802","0646","497","357","140","45","542","821","0","66.02","43.48"
"10","013","00","028","2803","0000","414","323","91","12","426","1057","0","40.3","30.56"
"10","013","00","028","2803","0650","414","323","91","12","426","1057","0","40.3","30.56"
"10","013","00","028","2804","0000","465","381","84","18","483","900","0","53.67","42.33"
"10","013","00","028","2804","0651","465","381","84","18","483","900","0","53.67","42.33"
"10","013","00","028","2805","0000","192","156","36","12","204","429","0","47.55","36.36"
"10","013","00","028","2805","0652","192","156","36","12","204","429","0","47.55","36.36"
"10","013","00","028","2806","0000","1271","1014","257","134","1405","2001","0","70.21","50.67"
"10","013","00","028","2806","0647","391","296","95","72","463","635","0","72.91","46.61"
"10","013","00","028","2806","0648","482","388","94","33","515","695","0","74.1","55.83"
"10","013","00","028","2806","0649","398","330","68","29","427","671","0","63.64","49.18"
"10","013","00","029","0000","0000","2410","1895","515","287","2697","4344","5403","62.09","43.62"
"10","013","00","029","2901","0000","429","348","81","20","449","859","0","52.27","40.51"
"10","013","00","029","2901","0653","344","286","58","12","356","669","0","53.21","42.75"
"10","013","00","029","2901","0654","85","62","23","8","93","190","0","48.95","32.63"
"10","013","00","029","2902","0000","532","406","126","75","607","922","0","65.84","44.03"
"10","013","00","029","2902","0655","532","406","126","75","607","922","0","65.84","44.03"
"10","013","00","029","2903","0000","386","292","94","57","443","598","0","74.08","48.83"
"10","013","00","029","2903","0656","386","292","94","57","443","598","0","74.08","48.83"
"10","013","00","029","2904","0000","253","188","65","49","302","414","0","72.95","45.41"
"10","013","00","029","2904","0658","253","188","65","49","302","414","0","72.95","45.41"
"10","013","00","029","2905","0000","358","275","83","35","393","780","0","50.38","35.26"
"10","013","00","029","2905","0659","358","275","83","35","393","780","0","50.38","35.26"
"10","013","00","029","2906","0000","452","386","66","51","503","771","0","65.24","50.06"
"10","013","00","029","2906","0657","452","386","66","51","503","771","0","65.24","50.06"
"10","013","00","030","0000","0000","3209","2655","554","362","3571","6257","7445","57.07","42.43"
"10","013","00","030","3001","0000","490","417","73","101","591","917","0","64.45","45.47"
"10","013","00","030","3001","0660","490","417","73","101","591","917","0","64.45","45.47"
"10","013","00","030","3002","0000","240","195","45","14","254","577","0","44.02","33.8"
"10","013","00","030","3002","0661","168","136","32","12","180","361","0","49.86","37.67"
"10","013","00","030","3002","0662","72","59","13","2","74","216","0","34.26","27.31"
"10","013","00","030","3003","0000","465","399","66","53","518","725","0","71.45","55.03"
"10","013","00","030","3003","0663","311","268","43","25","336","445","0","75.51","60.22"
"10","013","00","030","3003","0664","154","131","23","28","182","280","0","65.0","46.79"
"10","013","00","030","3004","0000","599","511","88","50","649","1097","0","59.16","46.58"
"10","013","00","030","3004","0665","599","511","88","50","649","1097","0","59.16","46.58"
"10","013","00","030","3005","0000","491","407","84","69","560","840","0","66.67","48.45"
"10","013","00","030","3005","0666","491","407","84","69","560","840","0","66.67","48.45"
"10","013","00","030","3006","0000","399","311","88","23","422","889","0","47.47","34.98"
"10","013","00","030","3006","0667","399","311","88","23","422","889","0","47.47","34.98"
"10","013","00","030","3007","0000","525","415","110","52","577","1212","0","47.61","34.24"
"10","013","00","030","3007","0668","525","415","110","52","577","1212","0","47.61","34.24"
"10","013","00","031","0000","0000","982","767","215","56","1038","3923","4903","26.46","19.55"
"10","013","00","031","3101","0000","187","147","40","6","193","909","0","21.23","16.17"
"10","013","00","031","3101","0669","187","147","40","6","193","909","0","21.23","16.17"
"10","013","00","031","3102","0000","182","126","56","18","200","663","0","30.17","19.0"
"10","013","00","031","3102","0670","182","126","56","18","200","663","0","30.17","19.0"
"10","013","00","031","3103","0000","40","34","6","0","40","304","0","13.16","11.18"
"10","013","00","031","3103","0671","40","34","6","0","40","304","0","13.16","11.18"
"10","013","00","031","3104","0000","320","262","58","19","339","928","0","36.53","28.23"
"10","013","00","031","3104","0672","320","262","58","19","339","928","0","36.53","28.23"
"10","013","00","031","3105","0000","152","120","32","10","162","641","0","25.27","18.72"
"10","013","00","031","3105","0673","152","120","32","10","162","641","0","25.27","18.72"
"10","013","00","031","3106","0000","101","78","23","3","104","478","0","21.76","16.32"
"10","013","00","031","3106","0674","101","78","23","3","104","478","0","21.76","16.32"
"10","013","00","032","0000","0000","1696","1409","287","129","1825","4230","5018","43.14","33.31"
"10","013","00","032","3201","0000","333","291","42","21","354","751","0","47.14","38.75"
"10","013","00","032","3201","0675","333","291","42","21","354","751","0","47.14","38.75"
"10","013","00","032","3202","0000","326","267","59","28","354","776","0","45.62","34.41"
"10","013","00","032","3202","0676","326","267","59","28","354","776","0","45.62","34.41"
"10","013","00","032","3203","0000","255","222","33","16","271","711","0","38.12","31.22"
"10","013","00","032","3203","0677","255","222","33","16","271","711","0","38.12","31.22"
"10","013","00","032","3204","0000","152","108","44","30","182","243","0","74.9","44.44"
"10","013","00","032","3204","0678","152","108","44","30","182","243","0","74.9","44.44"
"10","013","00","032","3205","0000","167","132","35","11","178","325","0","54.77","40.62"
"10","013","00","032","3205","0679","167","132","35","11","178","325","0","54.77","40.62"
"10","013","00","032","3206","0000","126","102","24","5","131","476","0","27.52","21.43"
"10","013","00","032","3206","0680","126","102","24","5","131","476","0","27.52","21.43"
"10","013","00","032","3207","0000","222","185","37","11","233","602","0","38.7","30.73"
"10","013","00","032","3207","0681","222","185","37","11","233","602","0","38.7","30.73"
"10","013","00","032","3208","0000","115","102","13","7","122","346","0","35.26","29.48"
"10","013","00","032","3208","0682","115","102","13","7","122","346","0","35.26","29.48"
"10","013","00","033","0000","0000","1628","1348","280","104","1732","4314","5003","40.15","31.25"
"10","013","00","033","3301","0000","743","622","121","63","806","1648","0","48.91","37.74"
"10","013","00","033","3301","0683","132","104","28","11","143","342","0","41.81","30.41"
"10","013","00","033","3301","0684","611","518","93","52","663","1306","0","50.77","39.66"
"10","013","00","033","3302","0000","161","135","26","6","167","693","0","24.1","19.48"
"10","013","00","033","3302","0685","161","135","26","6","167","693","0","24.1","19.48"
"10","013","00","033","3303","0000","151","120","31","9","160","437","0","36.61","27.46"
"10","013","00","033","3303","0686","151","120","31","9","160","437","0","36.61","27.46"
"10","013","00","033","3304","0000","185","149","36","9","194","392","0","49.49","38.01"
"10","013","00","033","3304","0687","185","149","36","9","194","392","0","49.49","38.01"
"10","013","00","033","3305","0000","264","217","47","10","274","593","0","46.21","36.59"
"10","013","00","033","3305","0688","264","217","47","10","274","593","0","46.21","36.59"
"10","013","00","033","3306","0000","124","105","19","7","131","551","0","23.77","19.06"
"10","013","00","033","3306","0689","124","105","19","7","131","551","0","23.77","19.06"
"10","002","00","000","0000","0000","195370","153113","42257","16537","211907","386089","455508","54.89","39.66"
"10","002","00","001","0000","0000","41436","32624","8812","3035","44471","79167","95747","56.17","41.21"
"10","002","00","001","0101","0000","1344","1088","256","106","1450","2598","0","55.81","41.88"
"10","002","00","001","0101","0023","357","277","80","34","391","669","0","58.45","41.41"
"10","002","00","001","0101","0024","496","407","89","31","527","923","0","57.1","44.1"
"10","002","00","001","0101","0025","491","404","87","41","532","1006","0","52.88","40.16"
"10","002","00","001","0102","0000","813","627","186","36","849","1747","0","48.6","35.89"
"10","002","00","001","0102","0021","553","439","114","25","578","1282","0","45.09","34.24"
"10","002","00","001","0102","0022","260","188","72","11","271","465","0","58.28","40.43"
"10","002","00","001","0108","0000","1113","907","206","59","1172","2122","0","55.23","42.74"
"10","002","00","001","0108","0029","605","498","107","35","640","1143","0","55.99","43.57"
"10","002","00","001","0108","0030","508","409","99","24","532","979","0","54.34","41.78"
"10","002","00","001","0109","0000","608","480","128","52","660","1214","0","54.37","39.54"
"10","002","00","001","0109","0031","608","480","128","52","660","1214","0","54.37","39.54"
"10","002","00","001","0110","0000","964","747","217","55","1019","1717","0","59.35","43.51"
"10","002","00","001","0110","0035","509","406","103","19","528","943","0","55.99","43.05"
"10","002","00","001","0110","0036","455","341","114","36","491","774","0","63.44","44.06"
"10","002","00","001","0111","0000","1064","863","201","68","1132","2036","0","55.6","42.39"
"10","002","00","001","0111","0033","512","407","105","35","547","946","0","57.82","43.02"
"10","002","00","001","0111","0034","552","456","96","33","585","1090","0","53.67","41.83"
"10","002","00","001","0112","0000","666","508","158","67","733","1283","0","57.13","39.59"
"10","002","00","001","0112","0032","666","508","158","67","733","1283","0","57.13","39.59"
"10","002","00","001","0113","0000","953","757","196","87","1040","1815","0","57.3","41.71"
"10","002","00","001","0113","0051","457","376","81","49","506","905","0","55.91","41.55"
"10","002","00","001","0113","0052","496","381","115","38","534","910","0","58.68","41.87"
"10","002","00","001","0114","0000","1202","958","244","66","1268","2214","0","57.27","43.27"
"10","002","00","001","0114","0046","601","480","121","25","626","1110","0","56.4","43.24"
"10","002","00","001","0114","0047","601","478","123","41","642","1104","0","58.15","43.3"
"10","002","00","001","0115","0000","1722","1366","356","104","1826","3262","0","55.98","41.88"
"10","002","00","001","0115","0040","562","452","110","49","611","1084","0","56.37","41.7"
"10","002","00","001","0115","0041","566","443","123","27","593","1095","0","54.16","40.46"
"10","002","00","001","0115","0042","594","471","123","28","622","1083","0","57.43","43.49"
"10","002","00","001","0116","0000","634","506","128","34","668","1434","0","46.58","35.29"
"10","002","00","001","0116","0053","634","506","128","34","668","1434","0","46.58","35.29"
"10","002","00","001","0117","0000","893","702","191","62","955","1803","0","52.97","38.94"
"10","002","00","001","0117","0059","438","338","100","27","465","909","0","51.16","37.18"
"10","002","00","001","0117","0060","455","364","91","35","490","894","0","54.81","40.72"
"10","002","00","001","0118","0000","899","707","192","95","994","1560","0","63.72","45.32"
"10","002","00","001","0118","0027","409","314","95","38","447","727","0","61.49","43.19"
"10","002","00","001","0118","0028","490","393","97","57","547","833","0","65.67","47.18"
"10","002","00","001","0119","0000","538","400","138","36","574","966","0","59.42","41.41"
"10","002","00","001","0119","0055","538","400","138","36","574","966","0","59.42","41.41"
"10","002","00","001","0121","0000","873","674","199","72","945","1595","0","59.25","42.26"
"10","002","00","001","0121","0056","378","287","91","35","413","711","0","58.09","40.37"
"10","002","00","001","0121","0057","495","387","108","37","532","884","0","60.18","43.78"
"10","002","00","001","0122","0000","712","528","184","52","764","1326","0","57.62","39.82"
"10","002","00","001","0122","0058","712","528","184","52","764","1326","0","57.62","39.82"
"10","002","00","001","0123","0000","576","454","122","61","637","1152","0","55.3","39.41"
"10","002","00","001","0123","0054","576","454","122","61","637","1152","0","55.3","39.41"
"10","002","00","001","0124","0000","1373","1080","293","124","1497","2584","0","57.93","41.8"
"10","002","00","001","0124","0064","720","550","170","86","806","1454","0","55.43","37.83"
"10","002","00","001","0124","0065","653","530","123","38","691","1130","0","61.15","46.9"
"10","002","00","001","0125","0000","1008","818","190","80","1088","2025","0","53.73","40.4"
"10","002","00","001","0125","0066","486","409","77","22","508","1087","0","46.73","37.63"
"10","002","00","001","0125","0067","522","409","113","58","580","938","0","61.83","43.6"
"10","002","00","001","0126","0000","1118","862","256","83","1201","2237","0","53.69","38.53"
"10","002","00","001","0126","0068","658","509","149","61","719","1285","0","55.95","39.61"
"10","002","00","001","0126","0069","460","353","107","22","482","952","0","50.63","37.08"
"10","002","00","001","0127","0000","1621","1238","383","168","1789","3123","0","57.28","39.64"
"10","002","00","001","0127","0070","510","380","130","61","571","948","0","60.23","40.08"
"10","002","00","001","0127","0071","562","420","142","42","604","1160","0","52.07","36.21"
"10","002","00","001","0127","0072","549","438","111","65","614","1015","0","60.49","43.15"
"10","002","00","001","0128","0000","614","435","179","65","679","1162","0","58.43","37.44"
"10","002","00","001","0128","0078","614","435","179","65","679","1162","0","58.43","37.44"
"10","002","00","001","0131","0000","463","353","110","53","516","959","0","53.81","36.81"
"10","002","00","001","0131","0075","463","353","110","53","516","959","0","53.81","36.81"
"10","002","00","001","0132","0000","951","714","237","89","1040","1699","0","61.21","42.02"
"10","002","00","001","0132","0076","474","364","110","40","514","814","0","63.14","44.72"
"10","002","00","001","0132","0077","477","350","127","49","526","885","0","59.44","39.55"
"10","002","00","001","0134","0000","761","599","162","61","822","1388","0","59.22","43.16"
"10","002","00","001","0134","0073","247","189","58","13","260","424","0","61.32","44.58"
"10","002","00","001","0134","0074","514","410","104","48","562","964","0","58.3","42.53"
"10","002","00","001","0135","0000","1502","1175","327","121","1623","2933","0","55.34","40.06"
"10","002","00","001","0135","0007","475","376","99","32","507","912","0","55.59","41.23"
"10","002","00","001","0135","0008","693","549","144","58","751","1335","0","56.25","41.12"
"10","002","00","001","0135","0009","334","250","84","31","365","686","0","53.21","36.44"
"10","002","00","001","0136","0000","1136","900","236","78","1214","2252","0","53.91","39.96"
"10","002","00","001","0136","0001","494","389","105","22","516","982","0","52.55","39.61"
"10","002","00","001","0136","0002","642","511","131","56","698","1270","0","54.96","40.24"
"10","002","00","001","0137","0000","856","668","188","45","901","1605","0","56.14","41.62"
"10","002","00","001","0137","0003","441","347","94","20","461","849","0","54.3","40.87"
"10","002","00","001","0137","0004","415","321","94","25","440","756","0","58.2","42.46"
"10","002","00","001","0138","0000","2367","1894","473","114","2481","4269","0","58.12","44.37"
"10","002","00","001","0138","0010","785","626","159","35","820","1366","0","60.03","45.83"
"10","002","00","001","0138","0011","750","596","154","28","778","1363","0","57.08","43.73"
"10","002","00","001","0138","0012","832","672","160","51","883","1540","0","57.34","43.64"
"10","002","00","001","0139","0000","1545","1206","339","117","1662","3045","0","54.58","39.61"
"10","002","00","001","0139","0015","454","353","101","53","507","900","0","56.33","39.22"
"10","002","00","001","0139","0016","476","375","101","38","514","980","0","52.45","38.27"
"10","002","00","001","0139","0017","615","478","137","26","641","1165","0","55.02","41.03"
"10","002","00","001","0140","0000","1411","1146","265","87","1498","2695","0","55.58","42.52"
"10","002","00","001","0140","0018","479","402","77","23","502","904","0","55.53","44.47"
"10","002","00","001","0140","0019","435","349","86","22","457","813","0","56.21","42.93"
"10","002","00","001","0140","0020","497","395","102","42","539","978","0","55.11","40.39"
"10","002","00","001","0141","0000","1601","1253","348","88","1689","3051","0","55.36","41.07"
"10","002","00","001","0141","0043","556","433","123","35","591","1108","0","53.34","39.08"
"10","002","00","001","0141","0044","474","367","107","20","494","848","0","58.25","43.28"
"10","002","00","001","0141","0045","571","453","118","33","604","1095","0","55.16","41.37"
"10","002","00","001","0142","0000","1691","1375","316","136","1827","3156","0","57.89","43.57"
"10","002","00","001","0142","0048","596","486","110","44","640","1134","0","56.44","42.86"
"10","002","00","001","0142","0049","616","498","118","43","659","1146","0","57.5","43.46"
"10","002","00","001","0142","0050","479","391","88","49","528","876","0","60.27","44.63"
"10","002","00","001","0143","0000","1333","1061","272","77","1410","2550","0","55.29","41.61"
"10","002","00","001","0143","0013","708","568","140","19","727","1341","0","54.21","42.36"
"10","002","00","001","0143","0014","625","493","132","58","683","1209","0","56.49","40.78"
"10","002","00","001","0144","0000","952","773","179","94","1046","2000","0","52.3","38.65"
"10","002","00","001","0144","0005","503","414","89","48","551","1107","0","49.77","37.4"
"10","002","00","001","0144","0006","449","359","90","46","495","893","0","55.43","40.2"
"10","002","00","001","0145","0000","458","343","115","41","499","762","0","65.49","45.01"
"10","002","00","001","0145","0026","458","343","115","41","499","762","0","65.49","45.01"
"10","002","00","001","0146","0000","1441","1153","288","89","1530","2915","0","52.49","39.55"
"10","002","00","001","0146","0061","604","486","118","31","635","1259","0","50.44","38.6"
"10","002","00","001","0146","0062","395","316","79","24","419","789","0","53.11","40.05"
"10","002","00","001","0146","0063","442","351","91","34","476","867","0","54.9","40.48"
"10","002","00","001","0147","0000","1660","1306","354","113","1773","2913","0","60.87","44.83"
"10","002","00","001","0147","0037","554","443","111","36","590","968","0","60.95","45.76"
"10","002","00","001","0147","0038","543","425","118","28","571","926","0","61.66","45.9"
"10","002","00","001","0147","0039","563","438","125","49","612","1019","0","60.06","42.98"
"10","002","00","002","0000","0000","30815","24091","6724","2259","33074","57686","72457","57.33","41.76"
"10","002","00","002","0204","0000","758","570","188","62","820","1475","0","55.59","38.64"
"10","002","00","002","0204","0081","758","570","188","62","820","1475","0","55.59","38.64"
"10","002","00","002","0205","0000","1792","1418","374","144","1936","3504","0","55.25","40.47"
"10","002","00","002","0205","0082","728","571","157","69","797","1466","0","54.37","38.95"
"10","002","00","002","0205","0083","565","448","117","37","602","1075","0","56.0","41.67"
"10","002","00","002","0205","0084","499","399","100","38","537","963","0","55.76","41.43"
"10","002","00","002","0206","0000","1322","1039","283","115","1437","2677","0","53.68","38.81"
"10","002","00","002","0206","0085","725","568","157","86","811","1511","0","53.67","37.59"
"10","002","00","002","0206","0086","597","471","126","29","626","1166","0","53.69","40.39"
"10","002","00","002","0207","0000","1541","1208","333","107","1648","3008","0","54.79","40.16"
"10","002","00","002","0207","0087","671","516","155","63","734","1273","0","57.66","40.53"
"10","002","00","002","0207","0088","870","692","178","44","914","1735","0","52.68","39.88"
"10","002","00","002","0208","0000","1265","996","269","78","1343","2324","0","57.79","42.86"
"10","002","00","002","0208","0089","796","629","167","45","841","1487","0","56.56","42.3"
"10","002","00","002","0208","0090","469","367","102","33","502","837","0","59.98","43.85"
"10","002","00","002","0209","0000","723","551","172","62","785","1312","0","59.83","42.0"
"10","002","00","002","0209","0091","723","551","172","62","785","1312","0","59.83","42.0"
"10","002","00","002","0210","0000","751","597","154","51","802","1502","0","53.4","39.75"
"10","002","00","002","0210","0092","751","597","154","51","802","1502","0","53.4","39.75"
"10","002","00","002","0211","0000","562","449","113","21","583","1138","0","51.23","39.46"
"10","002","00","002","0211","0093","562","449","113","21","583","1138","0","51.23","39.46"
"10","002","00","002","0216","0000","1867","1506","361","139","2006","3681","0","54.5","40.91"
"10","002","00","002","0216","0096","573","470","103","37","610","1089","0","56.01","43.16"
"10","002","00","002","0216","0097","668","551","117","39","707","1304","0","54.22","42.25"
"10","002","00","002","0216","0098","626","485","141","63","689","1288","0","53.49","37.66"
"10","002","00","002","0217","0000","1527","1194","333","128","1655","2850","0","58.07","41.89"
"10","002","00","002","0217","0102","760","565","195","75","835","1420","0","58.8","39.79"
"10","002","00","002","0217","0103","767","629","138","53","820","1430","0","57.34","43.99"
"10","002","00","002","0218","0000","1506","1169","337","112","1618","2804","0","57.7","41.69"
"10","002","00","002","0218","0104","576","437","139","52","628","1075","0","58.42","40.65"
"10","002","00","002","0218","0105","483","376","107","38","521","879","0","59.27","42.78"
"10","002","00","002","0218","0106","447","356","91","22","469","850","0","55.18","41.88"
"10","002","00","002","0219","0000","1926","1541","385","119","2045","3623","0","56.44","42.53"
"10","002","00","002","0219","0111","757","606","151","47","804","1431","0","56.18","42.35"
"10","002","00","002","0219","0112","601","482","119","31","632","1109","0","56.99","43.46"
"10","002","00","002","0219","0113","568","453","115","41","609","1083","0","56.23","41.83"
"10","002","00","002","0220","0000","1446","1101","345","104","1550","2692","0","57.58","40.9"
"10","002","00","002","0220","0114","753","585","168","58","811","1404","0","57.76","41.67"
"10","002","00","002","0220","0115","693","516","177","46","739","1288","0","57.38","40.06"
"10","002","00","002","0221","0000","498","368","130","48","546","1183","0","46.15","31.11"
"10","002","00","002","0221","0116","498","368","130","48","546","1183","0","46.15","31.11"
"10","002","00","002","0222","0000","1619","1252","367","115","1734","2865","0","60.52","43.7"
"10","002","00","002","0222","0117","625","494","131","35","660","1105","0","59.73","44.71"
"10","002","00","002","0222","0118","561","423","138","41","602","987","0","60.99","42.86"
"10","002","00","002","0222","0119","433","335","98","39","472","773","0","61.06","43.34"
"10","002","00","002","0223","0000","1553","1190","363","117","1670","2926","0","57.07","40.67"
"10","002","00","002","0223","0123","525","397","128","40","565","977","0","57.83","40.63"
"10","002","00","002","0223","0124","483","373","110","46","529","972","0","54.42","38.37"
"10","002","00","002","0223","0125","545","420","125","31","576","977","0","58.96","42.99"
"10","002","00","002","0224","0000","1948","1519","429","140","2088","3551","0","58.8","42.78"
"10","002","00","002","0224","0126","763","594","169","60","823","1398","0","58.87","42.49"
"10","002","00","002","0224","0127","549","425","124","25","574","1022","0","56.16","41.59"
"10","002","00","002","0224","0128","636","500","136","55","691","1131","0","61.1","44.21"
"10","002","00","002","0225","0000","2052","1637","415","111","2163","3431","0","63.04","47.71"
"10","002","00","002","0225","0120","817","651","166","46","863","1366","0","63.18","47.66"
"10","002","00","002","0225","0121","552","423","129","31","583","907","0","64.28","46.64"
"10","002","00","002","0225","0122","683","563","120","34","717","1158","0","61.92","48.62"
"10","002","00","002","0226","0000","2492","1923","569","150","2642","4360","0","60.6","44.11"
"10","002","00","002","0226","0107","628","493","135","33","661","1111","0","59.5","44.37"
"10","002","00","002","0226","0108","672","515","157","37","709","1139","0","62.25","45.22"
"10","002","00","002","0226","0109","658","504","154","35","693","1130","0","61.33","44.6"
"10","002","00","002","0226","0110","534","411","123","45","579","980","0","59.08","41.94"
"10","002","00","002","0227","0000","1707","1326","381","140","1847","2990","0","61.77","44.35"
"10","002","00","002","0227","0099","584","451","133","58","642","1036","0","61.97","43.53"
"10","002","00","002","0227","0100","574","452","122","40","614","969","0","63.36","46.65"
"10","002","00","002","0227","0101","549","423","126","42","591","985","0","60.0","42.94"
"10","002","00","002","0228","0000","747","587","160","59","806","1407","0","57.29","41.72"
"10","002","00","002","0228","0079","377","295","82","30","407","689","0","59.07","42.82"
"10","002","00","002","0228","0080","370","292","78","29","399","718","0","55.57","40.67"
"10","002","00","002","0229","0000","698","553","145","91","789","1373","0","57.47","40.28"
"10","002","00","002","0229","0095","698","553","145","91","789","1373","0","57.47","40.28"
"10","002","00","002","0230","0000","515","397","118","46","561","1010","0","55.54","39.31"
"10","002","00","002","0230","0094","515","397","118","46","561","1010","0","55.54","39.31"
"10","002","00","003","0000","0000","17497","13719","3778","1713","19210","34512","39785","55.66","39.75"
"10","002","00","003","0301","0000","1769","1404","365","137","1906","3364","0","56.66","41.74"
"10","002","00","003","0301","0129","618","482","136","54","672","1194","0","56.28","40.37"
"10","002","00","003","0301","0130","556","431","125","35","591","1128","0","52.39","38.21"
"10","002","00","003","0301","0131","595","491","104","48","643","1042","0","61.71","47.12"
"10","002","00","003","0302","0000","545","422","123","39","584","997","0","58.58","42.33"
"10","002","00","003","0302","0132","545","422","123","39","584","997","0","58.58","42.33"
"10","002","00","003","0303","0000","1941","1547","394","181","2122","3693","0","57.46","41.89"
"10","002","00","003","0303","0133","685","540","145","52","737","1303","0","56.56","41.44"
"10","002","00","003","0303","0134","677","535","142","70","747","1260","0","59.29","42.46"
"10","002","00","003","0303","0135","579","472","107","59","638","1130","0","56.46","41.77"
"10","002","00","003","0304","0000","435","327","108","60","495","910","0","54.4","35.93"
"10","002","00","003","0304","0136","278","220","58","37","315","559","0","56.35","39.36"
"10","002","00","003","0304","0137","157","107","50","23","180","351","0","51.28","30.48"
"10","002","00","003","0305","0000","655","497","158","77","732","1323","0","55.33","37.57"
"10","002","00","003","0305","0138","433","325","108","56","489","889","0","55.01","36.56"
"10","002","00","003","0305","0139","222","172","50","21","243","434","0","55.99","39.63"
"10","002","00","003","0307","0000","1599","1233","366","130","1729","2945","0","58.71","41.87"
"10","002","00","003","0307","0140","478","364","114","26","504","835","0","60.36","43.59"
"10","002","00","003","0307","0141","514","398","116","39","553","975","0","56.72","40.82"
"10","002","00","003","0307","0142","607","471","136","65","672","1135","0","59.21","41.5"
"10","002","00","003","0308","0000","702","532","170","59","761","1257","0","60.54","42.32"
"10","002","00","003","0308","0143","484","368","116","27","511","788","0","64.85","46.7"
"10","002","00","003","0308","0144","218","164","54","32","250","469","0","53.3","34.97"
"10","002","00","003","0309","0000","1162","957","205","92","1254","2300","0","54.52","41.61"
"10","002","00","003","0309","0148","568","471","97","34","602","1146","0","52.53","41.1"
"10","002","00","003","0309","0149","594","486","108","58","652","1154","0","56.5","42.11"
"10","002","00","003","0310","0000","1222","958","264","97","1319","2398","0","55.0","39.95"
"10","002","00","003","0310","0150","415","333","82","23","438","908","0","48.24","36.67"
"10","002","00","003","0310","0151","341","273","68","23","364","656","0","55.49","41.62"
"10","002","00","003","0310","0152","466","352","114","51","517","834","0","61.99","42.21"
"10","002","00","003","0311","0000","565","466","99","40","605","1025","0","59.02","45.46"
"10","002","00","003","0311","0153","565","466","99","40","605","1025","0","59.02","45.46"
"10","002","00","003","0312","0000","248","176","72","16","264","455","0","58.02","38.68"
"10","002","00","003","0312","0154","248","176","72","16","264","455","0","58.02","38.68"
"10","002","00","003","0313","0000","286","219","67","27","313","535","0","58.5","40.93"
"10","002","00","003","0313","0155","286","219","67","27","313","535","0","58.5","40.93"
"10","002","00","003","0314","0000","314","250","64","25","339","536","0","63.25","46.64"
"10","002","00","003","0314","0156","314","250","64","25","339","536","0","63.25","46.64"
"10","002","00","003","0315","0000","254","198","56","19","273","451","0","60.53","43.9"
"10","002","00","003","0315","0157","254","198","56","19","273","451","0","60.53","43.9"
"10","002","00","003","0316","0000","295","231","64","35","330","593","0","55.65","38.95"
"10","002","00","003","0316","0158","295","231","64","35","330","593","0","55.65","38.95"
"10","002","00","003","0317","0000","221","175","46","26","247","441","0","56.01","39.68"
"10","002","00","003","0317","0159","221","175","46","26","247","441","0","56.01","39.68"
"10","002","00","003","0318","0000","500","391","109","50","550","954","0","57.65","40.99"
"10","002","00","003","0318","0160","500","391","109","50","550","954","0","57.65","40.99"
"10","002","00","003","0319","0000","455","374","81","63","518","952","0","54.41","39.29"
"10","002","00","003","0319","0161","455","374","81","63","518","952","0","54.41","39.29"
"10","002","00","003","0320","0000","518","390","128","70","588","1125","0","52.27","34.67"
"10","002","00","003","0320","0162","518","390","128","70","588","1125","0","52.27","34.67"
"10","002","00","003","0321","0000","634","498","136","106","740","1469","0","50.37","33.9"
"10","002","00","003","0321","0163","361","288","73","67","428","763","0","56.09","37.75"
"10","002","00","003","0321","0164","273","210","63","39","312","706","0","44.19","29.75"
"10","002","00","003","0322","0000","452","349","103","64","516","1068","0","48.31","32.68"
"10","002","00","003","0322","0165","452","349","103","64","516","1068","0","48.31","32.68"
"10","002","00","003","0323","0000","590","435","155","123","713","1240","0","57.5","35.08"
"10","002","00","003","0323","0166","336","246","90","52","388","666","0","58.26","36.94"
"10","002","00","003","0323","0167","254","189","65","71","325","574","0","56.62","32.93"
"10","002","00","003","0324","0000","124","97","27","11","135","351","0","38.46","27.64"
"10","002","00","003","0324","0168","124","97","27","11","135","351","0","38.46","27.64"
"10","002","00","003","0325","0000","362","279","83","43","405","717","0","56.49","38.91"
"10","002","00","003","0325","0169","362","279","83","43","405","717","0","56.49","38.91"
"10","002","00","003","0326","0000","215","179","36","26","241","596","0","40.44","30.03"
"10","002","00","003","0326","0170","138","122","16","14","152","373","0","40.75","32.71"
"10","002","00","003","0326","0171","77","57","20","12","89","223","0","39.91","25.56"
"10","002","00","003","0327","0000","1434","1135","299","97","1531","2817","0","54.35","40.29"
"10","002","00","003","0327","0145","399","310","89","32","431","811","0","53.14","38.22"
"10","002","00","003","0327","0146","440","356","84","19","459","867","0","52.94","41.06"
"10","002","00","003","0327","0147","595","469","126","46","641","1139","0","56.28","41.18"
"10","002","00","004","0000","0000","12448","9800","2648","1309","13757","25135","29173","54.73","38.99"
"10","002","00","004","0401","0000","95","68","27","9","104","292","0","35.62","23.29"
"10","002","00","004","0401","0172","95","68","27","9","104","292","0","35.62","23.29"
"10","002","00","004","0402","0000","326","251","75","42","368","688","0","53.49","36.48"
"10","002","00","004","0402","0173","326","251","75","42","368","688","0","53.49","36.48"
"10","002","00","004","0403","0000","392","281","111","51","443","879","0","50.4","31.97"
"10","002","00","004","0403","0175","392","281","111","51","443","879","0","50.4","31.97"
"10","002","00","004","0404","0000","182","141","41","22","204","335","0","60.9","42.09"
"10","002","00","004","0404","0176","182","141","41","22","204","335","0","60.9","42.09"
"10","002","00","004","0405","0000","657","480","177","79","736","1356","0","54.28","35.4"
"10","002","00","004","0405","0177","355","254","101","38","393","624","0","62.98","40.71"
"10","002","00","004","0405","0178","302","226","76","41","343","732","0","46.86","30.87"
"10","002","00","004","0406","0000","371","286","85","48","419","892","0","46.97","32.06"
"10","002","00","004","0406","0179","371","286","85","48","419","892","0","46.97","32.06"
"10","002","00","004","0407","0000","284","217","67","29","313","690","0","45.36","31.45"
"10","002","00","004","0407","0180","284","217","67","29","313","690","0","45.36","31.45"
"10","002","00","004","0408","0000","786","639","147","76","862","1578","0","54.63","40.49"
"10","002","00","004","0408","0181","410","339","71","42","452","842","0","53.68","40.26"
"10","002","00","004","0408","0182","376","300","76","34","410","736","0","55.71","40.76"
"10","002","00","004","0409","0000","627","502","125","53","680","1348","0","50.45","37.24"
"10","002","00","004","0409","0183","363","296","67","31","394","788","0","50.0","37.56"
"10","002","00","004","0409","0184","264","206","58","22","286","560","0","51.07","36.79"
"10","002","00","004","0410","0000","391","308","83","32","423","712","0","59.41","43.26"
"10","002","00","004","0410","0185","391","308","83","32","423","712","0","59.41","43.26"
"10","002","00","004","0411","0000","283","226","57","38","321","502","0","63.94","45.02"
"10","002","00","004","0411","0186","283","226","57","38","321","502","0","63.94","45.02"
"10","002","00","004","0412","0000","327","264","63","30","357","569","0","62.74","46.4"
"10","002","00","004","0412","0187","327","264","63","30","357","569","0","62.74","46.4"
"10","002","00","004","0413","0000","318","255","63","43","361","633","0","57.03","40.28"
"10","002","00","004","0413","0188","318","255","63","43","361","633","0","57.03","40.28"
"10","002","00","004","0414","0000","907","710","197","116","1023","2167","0","47.21","32.76"
"10","002","00","004","0414","0189","454","350","104","74","528","1132","0","46.64","30.92"
"10","002","00","004","0414","0190","453","360","93","42","495","1035","0","47.83","34.78"
"10","002","00","004","0415","0000","1086","855","231","76","1162","2019","0","57.55","42.35"
"10","002","00","004","0415","0191","471","371","100","32","503","847","0","59.39","43.8"
"10","002","00","004","0415","0192","615","484","131","44","659","1172","0","56.23","41.3"
"10","002","00","004","0416","0000","1033","847","186","56","1089","1971","0","55.25","42.97"
"10","002","00","004","0416","0193","437","357","80","26","463","896","0","51.67","39.84"
"10","002","00","004","0416","0194","596","490","106","30","626","1075","0","58.23","45.58"
"10","002","00","004","0417","0000","484","369","115","62","546","931","0","58.65","39.63"
"10","002","00","004","0417","0195","484","369","115","62","546","931","0","58.65","39.63"
"10","002","00","004","0418","0000","798","633","165","111","909","1730","0","52.54","36.59"
"10","002","00","004","0418","0196","504","398","106","58","562","1021","0","55.04","38.98"
"10","002","00","004","0418","0197","294","235","59","53","347","709","0","48.94","33.15"
"10","002","00","004","0419","0000","407","324","83","35","442","689","0","64.15","47.02"
"10","002","00","004","0419","0198","407","324","83","35","442","689","0","64.15","47.02"
"10","002","00","004","0420","0000","709","577","132","90","799","1374","0","58.15","41.99"
"10","002","00","004","0420","0199","344","276","68","40","384","615","0","62.44","44.88"
"10","002","00","004","0420","0200","365","301","64","50","415","759","0","54.68","39.66"
"10","002","00","004","0421","0000","503","389","114","59","562","917","0","61.29","42.42"
"10","002","00","004","0421","0201","503","389","114","59","562","917","0","61.29","42.42"
"10","002","00","004","0422","0000","538","432","106","63","601","1045","0","57.51","41.34"
"10","002","00","004","0422","0202","538","432","106","63","601","1045","0","57.51","41.34"
"10","002","00","004","0423","0000","582","463","119","55","637","1130","0","56.37","40.97"
"10","002","00","004","0423","0203","582","463","119","55","637","1130","0","56.37","40.97"
"10","002","00","004","0424","0000","362","283","79","34","396","688","0","57.56","41.13"
"10","002","00","004","0424","0174","362","283","79","34","396","688","0","57.56","41.13"
"10","002","00","005","0000","0000","15290","11862","3428","1265","16555","31084","35668","53.26","38.16"
"10","002","00","005","0501","0000","729","576","153","66","795","1627","0","48.86","35.4"
"10","002","00","005","0501","0204","492","390","102","37","529","1122","0","47.15","34.76"
"10","002","00","005","0501","0205","237","186","51","29","266","505","0","52.67","36.83"
"10","002","00","005","0502","0000","936","726","210","85","1021","1959","0","52.12","37.06"
"10","002","00","005","0502","0206","467","348","119","42","509","988","0","51.52","35.22"
"10","002","00","005","0502","0207","469","378","91","43","512","971","0","52.73","38.93"
"10","002","00","005","0503","0000","1783","1378","405","120","1903","4033","0","47.19","34.17"
"10","002","00","005","0503","0208","567","436","131","50","617","1246","0","49.52","34.99"
"10","002","00","005","0503","0209","739","556","183","35","774","1655","0","46.77","33.6"
"10","002","00","005","0503","0210","477","386","91","35","512","1132","0","45.23","34.1"
"10","002","00","005","0504","0000","1285","1026","259","105","1390","2559","0","54.32","40.09"
"10","002","00","005","0504","0211","409","331","78","29","438","783","0","55.94","42.27"
"10","002","00","005","0504","0212","459","347","112","39","498","928","0","53.66","37.39"
"10","002","00","005","0504","0213","417","348","69","37","454","848","0","53.54","41.04"
"10","002","00","005","0505","0000","386","297","89","31","417","663","0","62.9","44.8"
"10","002","00","005","0505","0214","386","297","89","31","417","663","0","62.9","44.8"
"10","002","00","005","0506","0000","751","599","152","52","803","1441","0","55.73","41.57"
"10","002","00","005","0506","0215","323","261","62","16","339","608","0","55.76","42.93"
"10","002","00","005","0506","0216","428","338","90","36","464","833","0","55.7","40.58"
"10","002","00","005","0507","0000","539","415","124","15","554","1233","0","44.93","33.66"
"10","002","00","005","0507","0217","539","415","124","15","554","1233","0","44.93","33.66"
"10","002","00","005","0508","0000","712","541","171","66","778","1429","0","54.44","37.86"
"10","002","00","005","0508","0218","433","327","106","45","478","854","0","55.97","38.29"
"10","002","00","005","0508","0219","279","214","65","21","300","575","0","52.17","37.22"
"10","002","00","005","0509","0000","1120","856","264","89","1209","2140","0","56.5","40.0"
"10","002","00","005","0509","0220","425","320","105","41","466","835","0","55.81","38.32"
"10","002","00","005","0509","0221","695","536","159","48","743","1305","0","56.93","41.07"
"10","002","00","005","0510","0000","1201","917","284","129","1330","2402","0","55.37","38.18"
"10","002","00","005","0510","0222","421","318","103","39","460","830","0","55.42","38.31"
"10","002","00","005","0510","0223","382","285","97","45","427","649","0","65.79","43.91"
"10","002","00","005","0510","0224","398","314","84","45","443","923","0","48.0","34.02"
"10","002","00","005","0511","0000","490","389","101","40","530","1177","0","45.03","33.05"
"10","002","00","005","0511","0225","490","389","101","40","530","1177","0","45.03","33.05"
"10","002","00","005","0512","0000","421","337","84","40","461","840","0","54.88","40.12"
"10","002","00","005","0512","0226","421","337","84","40","461","840","0","54.88","40.12"
"10","002","00","005","0513","0000","546","423","123","28","574","1051","0","54.61","40.25"
"10","002","00","005","0513","0227","546","423","123","28","574","1051","0","54.61","40.25"
"10","002","00","005","0514","0000","609","469","140","46","655","1339","0","48.92","35.03"
"10","002","00","005","0514","0228","609","469","140","46","655","1339","0","48.92","35.03"
"10","002","00","005","0515","0000","1346","1050","296","128","1474","2508","0","58.77","41.87"
"10","002","00","005","0515","0229","654","533","121","48","702","1194","0","58.79","44.64"
"10","002","00","005","0515","0230","692","517","175","80","772","1314","0","58.75","39.35"
"10","002","00","005","0516","0000","1705","1329","376","150","1855","3311","0","56.03","40.14"
"10","002","00","005","0516","0231","560","413","147","27","587","1125","0","52.18","36.71"
"10","002","00","005","0516","0232","655","530","125","65","720","1207","0","59.65","43.91"
"10","002","00","005","0516","0233","490","386","104","58","548","979","0","55.98","39.43"
"10","002","00","005","0517","0000","519","386","133","65","584","954","0","61.22","40.46"
"10","002","00","005","0517","0234","519","386","133","65","584","954","0","61.22","40.46"
"10","002","00","005","0518","0000","212","148","64","10","222","418","0","53.11","35.41"
"10","002","00","005","0518","0235","212","148","64","10","222","418","0","53.11","35.41"
"10","002","00","006","0000","0000","10959","8549","2410","1263","12222","21447","24315","56.99","39.86"
"10","002","00","006","0601","0000","1334","999","335","152","1486","2484","0","59.82","40.22"
"10","002","00","006","0601","0236","765","574","191","97","862","1435","0","60.07","40.0"
"10","002","00","006","0601","0237","569","425","144","55","624","1049","0","59.49","40.51"
"10","002","00","006","0602","0000","871","686","185","136","1007","1835","0","54.88","37.38"
"10","002","00","006","0602","0239","402","324","78","96","498","868","0","57.37","37.33"
"10","002","00","006","0602","0240","469","362","107","40","509","967","0","52.64","37.44"
"10","002","00","006","0603","0000","508","398","110","67","575","940","0","61.17","42.34"
"10","002","00","006","0603","0241","508","398","110","67","575","940","0","61.17","42.34"
"10","002","00","006","0604","0000","423","338","85","31","454","975","0","46.56","34.67"
"10","002","00","006","0604","0242","423","338","85","31","454","975","0","46.56","34.67"
"10","002","00","006","0605","0000","826","655","171","128","954","1605","0","59.44","40.81"
"10","002","00","006","0605","0243","417","318","99","72","489","797","0","61.36","39.9"
"10","002","00","006","0605","0244","409","337","72","56","465","808","0","57.55","41.71"
"10","002","00","006","0606","0000","736","563","173","117","853","1523","0","56.01","36.97"
"10","002","00","006","0606","0245","456","333","123","81","537","911","0","58.95","36.55"
"10","002","00","006","0606","0246","280","230","50","36","316","612","0","51.63","37.58"
"10","002","00","006","0607","0000","451","344","107","51","502","790","0","63.54","43.54"
"10","002","00","006","0607","0247","451","344","107","51","502","790","0","63.54","43.54"
"10","002","00","006","0608","0000","1216","924","292","128","1344","2338","0","57.49","39.52"
"10","002","00","006","0608","0248","468","341","127","56","524","878","0","59.68","38.84"
"10","002","00","006","0608","0249","420","340","80","43","463","723","0","64.04","47.03"
"10","002","00","006","0608","0250","328","243","85","29","357","737","0","48.44","32.97"
"10","002","00","006","0609","0000","780","625","155","71","851","1581","0","53.83","39.53"
"10","002","00","006","0609","0251","354","267","87","59","413","686","0","60.2","38.92"
"10","002","00","006","0609","0252","426","358","68","12","438","895","0","48.94","40.0"
"10","002","00","006","0610","0000","680","549","131","74","754","1237","0","60.95","44.38"
"10","002","00","006","0610","0253","680","549","131","74","754","1237","0","60.95","44.38"
"10","002","00","006","0611","0000","1146","897","249","117","1263","2241","0","56.36","40.03"
"10","002","00","006","0611","0254","590","470","120","60","650","1134","0","57.32","41.45"
"10","002","00","006","0611","0255","556","427","129","57","613","1107","0","55.37","38.57"
"10","002","00","006","0612","0000","570","459","111","27","597","1057","0","56.48","43.42"
"10","002","00","006","0612","0256","570","459","111","27","597","1057","0","56.48","43.42"
"10","002","00","006","0613","0000","834","655","179","93","927","1773","0","52.28","36.94"
"10","002","00","006","0613","0257","484","379","105","46","530","1051","0","50.43","36.06"
"10","002","00","006","0613","0258","350","276","74","47","397","722","0","54.99","38.23"
"10","002","00","006","0614","0000","584","457","127","71","655","1068","0","61.33","42.79"
"10","002","00","006","0614","0238","584","457","127","71","655","1068","0","61.33","42.79"
"10","002","00","007","0000","0000","13542","10584","2958","1477","15019","28131","32281","53.39","37.62"
"10","002","00","007","0701","0000","2730","2185","545","199","2929","5648","0","51.86","38.69"
"10","002","00","007","0701","0259","690","540","150","25","715","1393","0","51.33","38.77"
"10","002","00","007","0701","0260","432","338","94","27","459","895","0","51.28","37.77"
"10","002","00","007","0701","0261","590","475","115","79","669","1231","0","54.35","38.59"
"10","002","00","007","0701","0262","524","429","95","34","558","1098","0","50.82","39.07"
"10","002","00","007","0701","0263","494","403","91","34","528","1031","0","51.21","39.09"
"10","002","00","007","0702","0000","987","747","240","111","1098","2198","0","49.95","33.99"
"10","002","00","007","0702","0264","484","391","93","70","554","1030","0","53.79","37.96"
"10","002","00","007","0702","0265","503","356","147","41","544","1168","0","46.58","30.48"
"10","002","00","007","0703","0000","799","633","166","107","906","1587","0","57.09","39.89"
"10","002","00","007","0703","0266","404","309","95","55","459","809","0","56.74","38.2"
"10","002","00","007","0703","0267","395","324","71","52","447","778","0","57.46","41.65"
"10","002","00","007","0704","0000","788","634","154","55","843","1465","0","57.54","43.28"
"10","002","00","007","0704","0268","788","634","154","55","843","1465","0","57.54","43.28"
"10","002","00","007","0705","0000","958","774","184","98","1056","1839","0","57.42","42.09"
"10","002","00","007","0705","0269","526","415","111","52","578","979","0","59.04","42.39"
"10","002","00","007","0705","0270","432","359","73","46","478","860","0","55.58","41.74"
"10","002","00","007","0706","0000","517","406","111","80","597","1205","0","49.54","33.69"
"10","002","00","007","0706","0271","517","406","111","80","597","1205","0","49.54","33.69"
"10","002","00","007","0707","0000","737","575","162","114","851","1494","0","56.96","38.49"
"10","002","00","007","0707","0272","525","415","110","83","608","1082","0","56.19","38.35"
"10","002","00","007","0707","0273","212","160","52","31","243","412","0","58.98","38.83"
"10","002","00","007","0708","0000","253","187","66","36","289","635","0","45.51","29.45"
"10","002","00","007","0708","0274","166","126","40","19","185","403","0","45.91","31.27"
"10","002","00","007","0708","0275","87","61","26","17","104","232","0","44.83","26.29"
"10","002","00","007","0709","0000","907","731","176","93","1000","1838","0","54.41","39.77"
"10","002","00","007","0709","0276","456","396","60","48","504","944","0","53.39","41.95"
"10","002","00","007","0709","0277","451","335","116","45","496","894","0","55.48","37.47"
"10","002","00","007","0710","0000","673","519","154","79","752","1356","0","55.46","38.27"
"10","002","00","007","0710","0278","673","519","154","79","752","1356","0","55.46","38.27"
"10","002","00","007","0711","0000","1175","847","328","166","1341","2295","0","58.43","36.91"
"10","002","00","007","0711","0279","405","299","106","48","453","780","0","58.08","38.33"
"10","002","00","007","0711","0280","505","361","144","83","588","932","0","63.09","38.73"
"10","002","00","007","0711","0281","265","187","78","35","300","583","0","51.46","32.08"
"10","002","00","007","0712","0000","1182","937","245","154","1336","2435","0","54.87","38.48"
"10","002","00","007","0712","0282","437","352","85","67","504","900","0","56.0","39.11"
"10","002","00","007","0712","0283","366","278","88","37","403","747","0","53.95","37.22"
"10","002","00","007","0712","0284","379","307","72","50","429","788","0","54.44","38.96"
"10","002","00","007","0713","0000","413","304","109","50","463","884","0","52.38","34.39"
"10","002","00","007","0713","0285","413","304","109","50","463","884","0","52.38","34.39"
"10","002","00","007","0714","0000","393","302","91","15","408","857","0","47.61","35.24"
"10","002","00","007","0714","0286","393","302","91","15","408","857","0","47.61","35.24"
"10","002","00","007","0715","0000","459","355","104","26","485","1016","0","47.74","34.94"
"10","002","00","007","0715","0287","459","355","104","26","485","1016","0","47.74","34.94"
"10","002","00","007","0716","0000","571","448","123","94","665","1379","0","48.22","32.49"
"10","002","00","007","0716","0288","265","207","58","40","305","690","0","44.2","30.0"
"10","002","00","007","0716","0289","306","241","65","54","360","689","0","52.25","34.98"
"10","002","00","008","0000","0000","22638","17752","4886","1528","24166","45405","52843","53.22","39.1"
"10","002","00","008","0801","0000","581","452","129","61","642","1217","0","52.75","37.14"
"10","002","00","008","0801","0312","581","452","129","61","642","1217","0","52.75","37.14"
"10","002","00","008","0802","0000","884","691","193","59","943","1624","0","58.07","42.55"
"10","002","00","008","0802","0290","444","347","97","42","486","807","0","60.22","43.0"
"10","002","00","008","0802","0291","440","344","96","17","457","817","0","55.94","42.11"
"10","002","00","008","0803","0000","615","504","111","43","658","1156","0","56.92","43.6"
"10","002","00","008","0803","0292","615","504","111","43","658","1156","0","56.92","43.6"
"10","002","00","008","0804","0000","436","348","88","36","472","892","0","52.91","39.01"
"10","002","00","008","0804","0293","436","348","88","36","472","892","0","52.91","39.01"
"10","002","00","008","0805","0000","497","382","115","32","529","897","0","58.97","42.59"
"10","002","00","008","0805","0294","497","382","115","32","529","897","0","58.97","42.59"
"10","002","00","008","0806","0000","776","606","170","51","827","1392","0","59.41","43.53"
"10","002","00","008","0806","0295","776","606","170","51","827","1392","0","59.41","43.53"
"10","002","00","008","0807","0000","1394","1079","315","78","1472","2906","0","50.65","37.13"
"10","002","00","008","0807","0296","792","607","185","47","839","1471","0","57.04","41.26"
"10","002","00","008","0807","0297","602","472","130","31","633","1435","0","44.11","32.89"
"10","002","00","008","0808","0000","1519","1201","318","66","1585","2975","0","53.28","40.37"
"10","002","00","008","0808","0298","732","573","159","36","768","1519","0","50.56","37.72"
"10","002","00","008","0808","0299","787","628","159","30","817","1456","0","56.11","43.13"
"10","002","00","008","0809","0000","378","305","73","27","405","694","0","58.36","43.95"
"10","002","00","008","0809","0301","378","305","73","27","405","694","0","58.36","43.95"
"10","002","00","008","0810","0000","387","295","92","41","428","711","0","60.2","41.49"
"10","002","00","008","0810","0300","387","295","92","41","428","711","0","60.2","41.49"
"10","002","00","008","0811","0000","909","689","220","46","955","1526","0","62.58","45.15"
"10","002","00","008","0811","0302","909","689","220","46","955","1526","0","62.58","45.15"
"10","002","00","008","0812","0000","449","348","101","32","481","884","0","54.41","39.37"
"10","002","00","008","0812","0303","449","348","101","32","481","884","0","54.41","39.37"
"10","002","00","008","0813","0000","651","533","118","63","714","1465","0","48.74","36.38"
"10","002","00","008","0813","0304","651","533","118","63","714","1465","0","48.74","36.38"
"10","002","00","008","0814","0000","238","187","51","38","276","488","0","56.56","38.32"
"10","002","00","008","0814","0305","238","187","51","38","276","488","0","56.56","38.32"
"10","002","00","008","0815","0000","2369","1862","507","170","2539","4993","0","50.85","37.29"
"10","002","00","008","0815","0306","593","464","129","55","648","1218","0","53.2","38.1"
"10","002","00","008","0815","0307","614","479","135","42","656","1291","0","50.81","37.1"
"10","002","00","008","0815","0308","628","491","137","35","663","1324","0","50.08","37.08"
"10","002","00","008","0815","0309","534","428","106","38","572","1160","0","49.31","36.9"
"10","002","00","008","0816","0000","1466","1134","332","80","1546","3000","0","51.53","37.8"
"10","002","00","008","0816","0310","625","484","141","46","671","1246","0","53.85","38.84"
"10","002","00","008","0816","0311","841","650","191","34","875","1754","0","49.89","37.06"
"10","002","00","008","0817","0000","2189","1715","474","174","2363","4651","0","50.81","36.87"
"10","002","00","008","0817","0313","674","535","139","46","720","1495","0","48.16","35.79"
"10","002","00","008","0817","0314","473","373","100","37","510","937","0","54.43","39.81"
"10","002","00","008","0817","0315","522","411","111","31","553","1101","0","50.23","37.33"
"10","002","00","008","0817","0316","520","396","124","60","580","1118","0","51.88","35.42"
"10","002","00","008","0818","0000","1960","1539","421","118","2078","3732","0","55.68","41.24"
"10","002","00","008","0818","0317","699","558","141","49","748","1301","0","57.49","42.89"
"10","002","00","008","0818","0318","603","487","116","25","628","1225","0","51.27","39.76"
"10","002","00","008","0818","0319","658","494","164","44","702","1206","0","58.21","40.96"
"10","002","00","008","0819","0000","1157","881","276","70","1227","2429","0","50.51","36.27"
"10","002","00","008","0819","0320","600","449","151","33","633","1278","0","49.53","35.13"
"10","002","00","008","0819","0321","557","432","125","37","594","1151","0","51.61","37.53"
"10","002","00","008","0820","0000","499","408","91","42","541","1094","0","49.45","37.29"
"10","002","00","008","0820","0322","499","408","91","42","541","1094","0","49.45","37.29"
"10","002","00","008","0821","0000","1245","967","278","88","1333","2494","0","53.45","38.77"
"10","002","00","008","0821","0323","660","512","148","46","706","1247","0","56.62","41.06"
"10","002","00","008","0821","0324","585","455","130","42","627","1247","0","50.28","36.49"
"10","002","00","008","0822","0000","905","726","179","48","953","1677","0","56.83","43.29"
"10","002","00","008","0822","0325","503","404","99","26","529","979","0","54.03","41.27"
"10","002","00","008","0822","0326","402","322","80","22","424","698","0","60.74","46.13"
"10","002","00","008","0823","0000","816","654","162","49","865","1726","0","50.12","37.89"
"10","002","00","008","0823","0327","816","654","162","49","865","1726","0","50.12","37.89"
"10","002","00","008","0824","0000","318","246","72","16","334","782","0","42.71","31.46"
"10","002","00","008","0824","0328","318","246","72","16","334","782","0","42.71","31.46"
"10","002","00","009","0000","0000","17213","13493","3720","1321","18534","34892","39577","53.12","38.67"
"10","002","00","009","0901","0000","934","728","206","80","1014","2020","0","50.2","36.04"
"10","002","00","009","0901","0329","474","384","90","57","531","1076","0","49.35","35.69"
"10","002","00","009","0901","0330","460","344","116","23","483","944","0","51.17","36.44"
"10","002","00","009","0902","0000","919","732","187","61","980","1773","0","55.27","41.29"
"10","002","00","009","0902","0331","430","351","79","20","450","836","0","53.83","41.99"
"10","002","00","009","0902","0332","489","381","108","41","530","937","0","56.56","40.66"
"10","002","00","009","0903","0000","1236","935","301","101","1337","2525","0","52.95","37.03"
"10","002","00","009","0903","0333","618","481","137","34","652","1255","0","51.95","38.33"
"10","002","00","009","0903","0334","618","454","164","67","685","1270","0","53.94","35.75"
"10","002","00","009","0904","0000","753","617","136","57","810","1603","0","50.53","38.49"
"10","002","00","009","0904","0335","369","297","72","24","393","801","0","49.06","37.08"
"10","002","00","009","0904","0336","384","320","64","33","417","802","0","52.0","39.9"
"10","002","00","009","0905","0000","617","493","124","33","650","1306","0","49.77","37.75"
"10","002","00","009","0905","0337","617","493","124","33","650","1306","0","49.77","37.75"
"10","002","00","009","0906","0000","1221","965","256","71","1292","2506","0","51.56","38.51"
"10","002","00","009","0906","0338","580","450","130","46","626","1190","0","52.61","37.82"
"10","002","00","009","0906","0339","641","515","126","25","666","1316","0","50.61","39.13"
"10","002","00","009","0907","0000","893","720","173","61","954","1779","0","53.63","40.47"
"10","002","00","009","0907","0340","489","400","89","30","519","965","0","53.78","41.45"
"10","002","00","009","0907","0341","404","320","84","31","435","814","0","53.44","39.31"
"10","002","00","009","0908","0000","1829","1437","392","138","1967","3637","0","54.08","39.51"
"10","002","00","009","0908","0342","590","459","131","50","640","1254","0","51.04","36.6"
"10","002","00","009","0908","0343","552","444","108","52","604","1060","0","56.98","41.89"
"10","002","00","009","0908","0344","687","534","153","36","723","1323","0","54.65","40.36"
"10","002","00","009","0909","0000","1909","1534","375","124","2033","3591","0","56.61","42.72"
"10","002","00","009","0909","0348","515","413","102","21","536","924","0","58.01","44.7"
"10","002","00","009","0909","0349","519","414","105","42","561","933","0","60.13","44.37"
"10","002","00","009","0909","0350","504","421","83","24","528","986","0","53.55","42.7"
"10","002","00","009","0909","0351","371","286","85","37","408","748","0","54.55","38.24"
"10","002","00","009","0910","0000","1653","1298","355","108","1761","3233","0","54.47","40.15"
"10","002","00","009","0910","0345","598","468","130","43","641","1120","0","57.23","41.79"
"10","002","00","009","0910","0346","451","370","81","24","475","893","0","53.19","41.43"
"10","002","00","009","0910","0347","604","460","144","41","645","1220","0","52.87","37.7"
"10","002","00","009","0911","0000","750","572","178","82","832","1550","0","53.68","36.9"
"10","002","00","009","0911","0352","750","572","178","82","832","1550","0","53.68","36.9"
"10","002","00","009","0912","0000","736","586","150","60","796","1435","0","55.47","40.84"
"10","002","00","009","0912","0353","328","257","71","27","355","629","0","56.44","40.86"
"10","002","00","009","0912","0354","408","329","79","33","441","806","0","54.71","40.82"
"10","002","00","009","0913","0000","975","730","245","84","1059","2022","0","52.37","36.1"
"10","002","00","009","0913","0355","452","326","126","44","496","956","0","51.88","34.1"
"10","002","00","009","0913","0356","523","404","119","40","563","1066","0","52.81","37.9"
"10","002","00","009","0914","0000","1468","1127","341","106","1574","3079","0","51.12","36.6"
"10","002","00","009","0914","0357","685","544","141","64","749","1513","0","49.5","35.96"
"10","002","00","009","0914","0358","783","583","200","42","825","1566","0","52.68","37.23"
"10","002","00","009","0915","0000","1320","1019","301","155","1475","2833","0","52.06","35.97"
"10","002","00","009","0915","0359","443","349","94","55","498","894","0","55.7","39.04"
"10","002","00","009","0915","0360","520","389","131","61","581","1235","0","47.04","31.5"
"10","002","00","009","0915","0361","357","281","76","39","396","704","0","56.25","39.91"
"10","002","00","010","0000","0000","9009","6988","2021","924","9933","19051","21391","52.14","36.68"
"10","002","00","010","1001","0000","100","79","21","14","114","215","0","53.02","36.74"
"10","002","00","010","1001","0362","100","79","21","14","114","215","0","53.02","36.74"
"10","002","00","010","1002","0000","207","159","48","34","241","523","0","46.08","30.4"
"10","002","00","010","1002","0363","207","159","48","34","241","523","0","46.08","30.4"
"10","002","00","010","1003","0000","333","236","97","57","390","745","0","52.35","31.68"
"10","002","00","010","1003","0364","333","236","97","57","390","745","0","52.35","31.68"
"10","002","00","010","1004","0000","279","227","52","45","324","583","0","55.57","38.94"
"10","002","00","010","1004","0368","279","227","52","45","324","583","0","55.57","38.94"
"10","002","00","010","1005","0000","205","170","35","29","234","436","0","53.67","38.99"
"10","002","00","010","1005","0369","205","170","35","29","234","436","0","53.67","38.99"
"10","002","00","010","1006","0000","578","464","114","60","638","1224","0","52.12","37.91"
"10","002","00","010","1006","0370","578","464","114","60","638","1224","0","52.12","37.91"
"10","002","00","010","1007","0000","505","400","105","39","544","1151","0","47.26","34.75"
"10","002","00","010","1007","0371","505","400","105","39","544","1151","0","47.26","34.75"
"10","002","00","010","1008","0000","438","350","88","38","476","870","0","54.71","40.23"
"10","002","00","010","1008","0372","438","350","88","38","476","870","0","54.71","40.23"
"10","002","00","010","1009","0000","489","380","109","43","532","1284","0","41.43","29.6"
"10","002","00","010","1009","0373","489","380","109","43","532","1284","0","41.43","29.6"
"10","002","00","010","1010","0000","2100","1648","452","139","2239","4286","0","52.24","38.45"
"10","002","00","010","1010","0375","724","588","136","49","773","1439","0","53.72","40.86"
"10","002","00","010","1010","0376","683","530","153","53","736","1445","0","50.93","36.68"
"10","002","00","010","1010","0377","693","530","163","37","730","1402","0","52.07","37.8"
"10","002","00","010","1011","0000","481","358","123","49","530","897","0","59.09","39.91"
"10","002","00","010","1011","0374","481","358","123","49","530","897","0","59.09","39.91"
"10","002","00","010","1012","0000","267","210","57","36","303","617","0","49.11","34.04"
"10","002","00","010","1012","0365","267","210","57","36","303","617","0","49.11","34.04"
"10","002","00","010","1013","0000","225","162","63","38","263","497","0","52.92","32.6"
"10","002","00","010","1013","0366","225","162","63","38","263","497","0","52.92","32.6"
"10","002","00","010","1014","0000","353","258","95","58","411","735","0","55.92","35.1"
"10","002","00","010","1014","0367","353","258","95","58","411","735","0","55.92","35.1"
"10","002","00","010","1015","0000","591","427","164","49","640","1230","0","52.03","34.72"
"10","002","00","010","1015","0378","591","427","164","49","640","1230","0","52.03","34.72"
"10","002","00","010","1016","0000","380","303","77","52","432","774","0","55.81","39.15"
"10","002","00","010","1016","0379","380","303","77","52","432","774","0","55.81","39.15"
"10","002","00","010","1017","0000","787","605","182","81","868","1563","0","55.53","38.71"
"10","002","00","010","1017","0380","427","332","95","50","477","827","0","57.68","40.15"
"10","002","00","010","1017","0381","360","273","87","31","391","736","0","53.13","37.09"
"10","002","00","010","1018","0000","691","552","139","63","754","1421","0","53.06","38.85"
"10","002","00","010","1018","0382","691","552","139","63","754","1421","0","53.06","38.85"
"10","002","00","011","0000","0000","2087","1644","443","240","2327","4935","6247","47.15","33.31"
"10","002","00","011","1101","0000","311","235","76","47","358","893","0","40.09","26.32"
"10","002","00","011","1101","0383","311","235","76","47","358","893","0","40.09","26.32"
"10","002","00","011","1102","0000","414","332","82","45","459","632","0","72.63","52.53"
"10","002","00","011","1102","0384","414","332","82","45","459","632","0","72.63","52.53"
"10","002","00","011","1103","0000","276","232","44","18","294","684","0","42.98","33.92"
"10","002","00","011","1103","0385","276","232","44","18","294","684","0","42.98","33.92"
"10","002","00","011","1104","0000","149","123","26","26","175","264","0","66.29","46.59"
"10","002","00","011","1104","0386","149","123","26","26","175","264","0","66.29","46.59"
"10","002","00","011","1105","0000","111","99","12","4","115","337","0","34.12","29.38"
"10","002","00","011","1105","0387","111","99","12","4","115","337","0","34.12","29.38"
"10","002","00","011","1106","0000","132","107","25","7","139","404","0","34.41","26.49"
"10","002","00","011","1106","0388","132","107","25","7","139","404","0","34.41","26.49"
"10","002","00","011","1107","0000","21","17","4","5","26","55","0","47.27","30.91"
"10","002","00","011","1107","0389","21","17","4","5","26","55","0","47.27","30.91"
"10","002","00","011","1108","0000","231","177","54","17","248","787","0","31.51","22.49"
"10","002","00","011","1108","0391","231","177","54","17","248","787","0","31.51","22.49"
"10","002","00","011","1109","0000","310","236","74","50","360","680","0","52.94","34.71"
"10","002","00","011","1109","0392","310","236","74","50","360","680","0","52.94","34.71"
"10","002","00","011","1110","0000","132","86","46","21","153","199","0","76.88","43.22"
"10","002","00","011","1110","0390","132","86","46","21","153","199","0","76.88","43.22"
"10","002","00","012","0000","0000","2436","2007","429","203","2639","4644","6024","56.83","43.22"
"10","002","00","012","1201","0000","570","484","86","23","593","1210","0","49.01","40.0"
"10","002","00","012","1201","0394","570","484","86","23","593","1210","0","49.01","40.0"
"10","002","00","012","1202","0000","511","426","85","73","584","962","0","60.71","44.28"
"10","002","00","012","1202","0395","511","426","85","73","584","962","0","60.71","44.28"
"10","002","00","012","1203","0000","216","176","40","9","225","444","0","50.68","39.64"
"10","002","00","012","1203","0393","216","176","40","9","225","444","0","50.68","39.64"
"10","002","00","012","1204","0000","146","123","23","4","150","411","0","36.5","29.93"
"10","002","00","012","1204","0396","146","123","23","4","150","411","0","36.5","29.93"
"10","002","00","012","1205","0000","291","240","51","17","308","447","0","68.9","53.69"
"10","002","00","012","1205","0397","291","240","51","17","308","447","0","68.9","53.69"
"10","002","00","012","1206","0000","333","254","79","35","368","475","0","77.47","53.47"
"10","002","00","012","1206","0398","333","254","79","35","368","475","0","77.47","53.47"
"10","002","00","012","1207","0000","369","304","65","42","411","695","0","59.14","43.74"
"10","002","00","012","1207","0399","369","304","65","42","411","695","0","59.14","43.74"
"10","015","00","000","0000","0000","134107","108373","25734","10391","144498","278059","328331","51.97","38.97"
"10","015","00","001","0000","0000","42999","35174","7825","2424","45423","84807","103798","53.56","41.48"
"10","015","00","001","0101","0000","689","559","130","26","715","1512","0","47.29","36.97"
"10","015","00","001","0101","0019","689","559","130","26","715","1512","0","47.29","36.97"
"10","015","00","001","0102","0000","1032","833","199","107","1139","1996","0","57.06","41.73"
"10","015","00","001","0102","0014","541","440","101","71","612","1071","0","57.14","41.08"
"10","015","00","001","0102","0015","491","393","98","36","527","925","0","56.97","42.49"
"10","015","00","001","0103","0000","229","189","40","17","246","442","0","55.66","42.76"
"10","015","00","001","0103","0023","229","189","40","17","246","442","0","55.66","42.76"
"10","015","00","001","0104","0000","283","227","56","26","309","566","0","54.59","40.11"
"10","015","00","001","0104","0029","283","227","56","26","309","566","0","54.59","40.11"
"10","015","00","001","0105","0000","305","254","51","18","323","565","0","57.17","44.96"
"10","015","00","001","0105","0031","305","254","51","18","323","565","0","57.17","44.96"
"10","015","00","001","0106","0000","1509","1250","259","119","1628","2983","0","54.58","41.9"
"10","015","00","001","0106","0033","435","357","78","41","476","911","0","52.25","39.19"
"10","015","00","001","0106","0034","497","413","84","40","537","1029","0","52.19","40.14"
"10","015","00","001","0106","0035","577","480","97","38","615","1043","0","58.96","46.02"
"10","015","00","001","0107","0000","755","613","142","44","799","1840","0","43.42","33.32"
"10","015","00","001","0107","0052","467","376","91","32","499","1339","0","37.27","28.08"
"10","015","00","001","0107","0053","288","237","51","12","300","501","0","59.88","47.31"
"10","015","00","001","0108","0000","1789","1479","310","100","1889","3241","0","58.28","45.63"
"10","015","00","001","0108","0049","608","519","89","34","642","1022","0","62.82","50.78"
"10","015","00","001","0108","0050","601","476","125","36","637","1135","0","56.12","41.94"
"10","015","00","001","0108","0051","580","484","96","30","610","1084","0","56.27","44.65"
"10","015","00","001","0109","0000","828","669","159","33","861","1522","0","56.57","43.96"
"10","015","00","001","0109","0001","828","669","159","33","861","1522","0","56.57","43.96"
"10","015","00","001","0110","0000","915","776","139","54","969","2029","0","47.76","38.25"
"10","015","00","001","0110","0005","220","179","41","18","238","470","0","50.64","38.09"
"10","015","00","001","0110","0006","406","347","59","25","431","838","0","51.43","41.41"
"10","015","00","001","0110","0007","289","250","39","11","300","721","0","41.61","34.67"
"10","015","00","001","0112","0000","239","201","38","7","246","469","0","52.45","42.86"
"10","015","00","001","0112","0030","239","201","38","7","246","469","0","52.45","42.86"
"10","015","00","001","0113","0000","290","240","50","20","310","538","0","57.62","44.61"
"10","015","00","001","0113","0028","290","240","50","20","310","538","0","57.62","44.61"
"10","015","00","001","0114","0000","1882","1530","352","105","1987","3514","0","56.55","43.54"
"10","015","00","001","0114","0038","706","567","139","45","751","1331","0","56.42","42.6"
"10","015","00","001","0114","0039","662","546","116","30","692","1228","0","56.35","44.46"
"10","015","00","001","0114","0040","514","417","97","30","544","955","0","56.96","43.66"
"10","015","00","001","0115","0000","476","395","81","21","497","904","0","54.98","43.69"
"10","015","00","001","0115","0054","476","395","81","21","497","904","0","54.98","43.69"
"10","015","00","001","0116","0000","2568","2094","474","122","2690","5074","0","53.02","41.27"
"10","015","00","001","0116","0069","663","529","134","35","698","1410","0","49.5","37.52"
"10","015","00","001","0116","0070","671","551","120","13","684","1303","0","52.49","42.29"
"10","015","00","001","0116","0071","640","537","103","32","672","1256","0","53.5","42.75"
"10","015","00","001","0116","0072","594","477","117","42","636","1105","0","57.56","43.17"
"10","015","00","001","0117","0000","1937","1591","346","108","2045","3583","0","57.08","44.4"
"10","015","00","001","0117","0016","667","530","137","43","710","1141","0","62.23","46.45"
"10","015","00","001","0117","0017","569","471","98","26","595","1163","0","51.16","40.5"
"10","015","00","001","0117","0018","701","590","111","39","740","1279","0","57.86","46.13"
"10","015","00","001","0118","0000","1695","1388","307","69","1764","3181","0","55.45","43.63"
"10","015","00","001","0118","0002","625","511","114","26","651","1114","0","58.44","45.87"
"10","015","00","001","0118","0003","357","283","74","19","376","670","0","56.12","42.24"
"10","015","00","001","0118","0004","713","594","119","24","737","1397","0","52.76","42.52"
"10","015","00","001","0119","0000","532","438","94","29","561","1114","0","50.36","39.32"
"10","015","00","001","0119","0024","532","438","94","29","561","1114","0","50.36","39.32"
"10","015","00","001","0120","0000","333","255","78","18","351","577","0","60.83","44.19"
"10","015","00","001","0120","0026","333","255","78","18","351","577","0","60.83","44.19"
"10","015","00","001","0121","0000","988","786","202","46","1034","1835","0","56.35","42.83"
"10","015","00","001","0121","0036","472","390","82","16","488","856","0","57.01","45.56"
"10","015","00","001","0121","0037","516","396","120","30","546","979","0","55.77","40.45"
"10","015","00","001","0122","0000","540","441","99","25","565","1192","0","47.4","37.0"
"10","015","00","001","0122","0056","540","441","99","25","565","1192","0","47.4","37.0"
"10","015","00","001","0123","0000","1300","1039","261","65","1365","2766","0","49.35","37.56"
"10","015","00","001","0123","0062","603","486","117","15","618","1311","0","47.14","37.07"
"10","015","00","001","0123","0063","697","553","144","50","747","1455","0","51.34","38.01"
"10","015","00","001","0124","0000","910","748","162","57","967","1715","0","56.38","43.62"
"10","015","00","001","0124","0067","391","327","64","23","414","715","0","57.9","45.73"
"10","015","00","001","0124","0068","519","421","98","34","553","1000","0","55.3","42.1"
"10","015","00","001","0125","0000","494","409","85","34","528","918","0","57.52","44.55"
"10","015","00","001","0125","0008","494","409","85","34","528","918","0","57.52","44.55"
"10","015","00","001","0126","0000","313","251","62","20","333","615","0","54.15","40.81"
"10","015","00","001","0126","0020","313","251","62","20","333","615","0","54.15","40.81"
"10","015","00","001","0127","0000","264","218","46","14","278","559","0","49.73","39.0"
"10","015","00","001","0127","0022","264","218","46","14","278","559","0","49.73","39.0"
"10","015","00","001","0128","0000","468","383","85","26","494","810","0","60.99","47.28"
"10","015","00","001","0128","0027","468","383","85","26","494","810","0","60.99","47.28"
"10","015","00","001","0129","0000","1348","1105","243","90","1438","2674","0","53.78","41.32"
"10","015","00","001","0129","0047","606","497","109","50","656","1184","0","55.41","41.98"
"10","015","00","001","0129","0048","742","608","134","40","782","1490","0","52.48","40.81"
"10","015","00","001","0130","0000","289","228","61","15","304","490","0","62.04","46.53"
"10","015","00","001","0130","0055","289","228","61","15","304","490","0","62.04","46.53"
"10","015","00","001","0131","0000","1019","844","175","73","1092","1975","0","55.29","42.73"
"10","015","00","001","0131","0060","514","438","76","26","540","993","0","54.38","44.11"
"10","015","00","001","0131","0061","505","406","99","47","552","982","0","56.21","41.34"
"10","015","00","001","0132","0000","576","472","104","34","610","1068","0","57.12","44.19"
"10","015","00","001","0132","0077","576","472","104","34","610","1068","0","57.12","44.19"
"10","015","00","001","0133","0000","1460","1202","258","93","1553","2942","0","52.79","40.86"
"10","015","00","001","0133","0009","773","625","148","35","808","1539","0","52.5","40.61"
"10","015","00","001","0133","0010","687","577","110","58","745","1403","0","53.1","41.13"
"10","015","00","001","0134","0000","336","246","90","12","348","606","0","57.43","40.59"
"10","015","00","001","0134","0021","336","246","90","12","348","606","0","57.43","40.59"
"10","015","00","001","0135","0000","212","177","35","23","235","416","0","56.49","42.55"
"10","015","00","001","0135","0025","212","177","35","23","235","416","0","56.49","42.55"
"10","015","00","001","0136","0000","367","310","57","33","400","816","0","49.02","37.99"
"10","015","00","001","0136","0032","367","310","57","33","400","816","0","49.02","37.99"
"10","015","00","001","0137","0000","2629","2159","470","155","2784","5217","0","53.36","41.38"
"10","015","00","001","0137","0043","722","603","119","49","771","1369","0","56.32","44.05"
"10","015","00","001","0137","0044","609","502","107","29","638","1435","0","44.46","34.98"
"10","015","00","001","0137","0045","608","488","120","32","640","1164","0","54.98","41.92"
"10","015","00","001","0137","0046","690","566","124","45","735","1249","0","58.85","45.32"
"10","015","00","001","0138","0000","1148","962","186","78","1226","2226","0","55.08","43.22"
"10","015","00","001","0138","0058","637","547","90","37","674","1267","0","53.2","43.17"
"10","015","00","001","0138","0059","511","415","96","41","552","959","0","57.56","43.27"
"10","015","00","001","0139","0000","415","335","80","20","435","869","0","50.06","38.55"
"10","015","00","001","0139","0057","415","335","80","20","435","869","0","50.06","38.55"
"10","015","00","001","0140","0000","630","488","142","44","674","1482","0","45.48","32.93"
"10","015","00","001","0140","0081","630","488","142","44","674","1482","0","45.48","32.93"
"10","015","00","001","0141","0000","2147","1785","362","91","2238","4183","0","53.5","42.67"
"10","015","00","001","0141","0073","536","424","112","21","557","1089","0","51.15","38.93"
"10","015","00","001","0141","0074","494","403","91","18","512","1043","0","49.09","38.64"
"10","015","00","001","0141","0075","595","515","80","25","620","1080","0","57.41","47.69"
"10","015","00","001","0141","0076","522","443","79","27","549","971","0","56.54","45.62"
"10","015","00","001","0142","0000","1228","994","234","57","1285","2498","0","51.44","39.79"
"10","015","00","001","0142","0041","612","505","107","28","640","1268","0","50.47","39.83"
"10","015","00","001","0142","0042","616","489","127","29","645","1230","0","52.44","39.76"
"10","015","00","001","0143","0000","1714","1390","324","76","1790","3727","0","48.03","37.3"
"10","015","00","001","0143","0064","518","417","101","18","536","1151","0","46.57","36.23"
"10","015","00","001","0143","0065","589","473","116","21","610","1237","0","49.31","38.24"
"10","015","00","001","0143","0066","607","500","107","37","644","1339","0","48.1","37.34"
"10","015","00","001","0144","0000","2061","1687","374","102","2163","4064","0","53.22","41.51"
"10","015","00","001","0144","0078","666","552","114","24","690","1379","0","50.04","40.03"
"10","015","00","001","0144","0079","672","539","133","45","717","1362","0","52.64","39.57"
"10","015","00","001","0144","0080","723","596","127","33","756","1323","0","57.14","45.05"
"10","015","00","001","0145","0000","1857","1534","323","98","1955","3494","0","55.95","43.9"
"10","015","00","001","0145","0011","540","441","99","24","564","1068","0","52.81","41.29"
"10","015","00","001","0145","0012","620","515","105","23","643","1167","0","55.1","44.13"
"10","015","00","001","0145","0013","697","578","119","51","748","1259","0","59.41","45.91"
"10","015","00","002","0000","0000","4806","3909","897","493","5299","9676","10902","54.76","40.4"
"10","015","00","002","0201","0000","676","559","117","62","738","1192","0","61.91","46.9"
"10","015","00","002","0201","0195","676","559","117","62","738","1192","0","61.91","46.9"
"10","015","00","002","0202","0000","305","247","58","20","325","639","0","50.86","38.65"
"10","015","00","002","0202","0196","305","247","58","20","325","639","0","50.86","38.65"
"10","015","00","002","0203","0000","358","290","68","42","400","601","0","66.56","48.25"
"10","015","00","002","0203","0197","358","290","68","42","400","601","0","66.56","48.25"
"10","015","00","002","0204","0000","680","558","122","46","726","1137","0","63.85","49.08"
"10","015","00","002","0204","0198","680","558","122","46","726","1137","0","63.85","49.08"
"10","015","00","002","0205","0000","690","567","123","76","766","1352","0","56.66","41.94"
"10","015","00","002","0205","0199","368","290","78","49","417","742","0","56.2","39.08"
"10","015","00","002","0205","0200","322","277","45","27","349","610","0","57.21","45.41"
"10","015","00","002","0206","0000","218","166","52","40","258","513","0","50.29","32.36"
"10","015","00","002","0206","0201","154","112","42","38","192","295","0","65.08","37.97"
"10","015","00","002","0206","0202","64","54","10","2","66","218","0","30.28","24.77"
"10","015","00","002","0207","0000","541","426","115","45","586","1248","0","46.96","34.13"
"10","015","00","002","0207","0203","279","226","53","22","301","720","0","41.81","31.39"
"10","015","00","002","0207","0204","262","200","62","23","285","528","0","53.98","37.88"
"10","015","00","002","0208","0000","271","210","61","18","289","560","0","51.61","37.5"
"10","015","00","002","0208","0205","271","210","61","18","289","560","0","51.61","37.5"
"10","015","00","002","0209","0000","240","208","32","51","291","541","0","53.79","38.45"
"10","015","00","002","0209","0206","240","208","32","51","291","541","0","53.79","38.45"
"10","015","00","002","0210","0000","410","333","77","54","464","818","0","56.72","40.71"
"10","015","00","002","0210","0207","410","333","77","54","464","818","0","56.72","40.71"
"10","015","00","002","0211","0000","377","311","66","30","407","984","0","41.36","31.61"
"10","015","00","002","0211","0208","377","311","66","30","407","984","0","41.36","31.61"
"10","015","00","002","0212","0000","40","34","6","9","49","91","0","53.85","37.36"
"10","015","00","002","0212","0209","40","34","6","9","49","91","0","53.85","37.36"
"10","015","00","003","0000","0000","8614","6862","1752","1061","9675","20650","24066","46.85","33.23"
"10","015","00","003","0301","0000","2588","2156","432","215","2803","5111","0","54.84","42.18"
"10","015","00","003","0301","0254","513","423","90","35","548","1008","0","54.37","41.96"
"10","015","00","003","0301","0255","522","439","83","34","556","939","0","59.21","46.75"
"10","015","00","003","0301","0256","587","505","82","71","658","1256","0","52.39","40.21"
"10","015","00","003","0301","0257","464","375","89","42","506","929","0","54.47","40.37"
"10","015","00","003","0301","0258","502","414","88","33","535","979","0","54.65","42.29"
"10","015","00","003","0302","0000","710","557","153","86","796","1619","0","49.17","34.4"
"10","015","00","003","0302","0260","377","295","82","39","416","847","0","49.11","34.83"
"10","015","00","003","0302","0261","333","262","71","47","380","772","0","49.22","33.94"
"10","015","00","003","0303","0000","537","438","99","58","595","1286","0","46.27","34.06"
"10","015","00","003","0303","0264","537","438","99","58","595","1286","0","46.27","34.06"
"10","015","00","003","0304","0000","496","403","93","42","538","1358","0","39.62","29.68"
"10","015","00","003","0304","0262","255","209","46","22","277","558","0","49.64","37.46"
"10","015","00","003","0304","0263","241","194","47","20","261","800","0","32.63","24.25"
"10","015","00","003","0305","0000","691","566","125","39","730","1244","0","58.68","45.5"
"10","015","00","003","0305","0259","691","566","125","39","730","1244","0","58.68","45.5"
"10","015","00","003","0306","0000","523","407","116","76","599","1246","0","48.07","32.66"
"10","015","00","003","0306","0265","523","407","116","76","599","1246","0","48.07","32.66"
"10","015","00","003","0307","0000","290","201","89","56","346","647","0","53.48","31.07"
"10","015","00","003","0307","0266","290","201","89","56","346","647","0","53.48","31.07"
"10","015","00","003","0308","0000","202","171","31","16","218","990","0","22.02","17.27"
"10","015","00","003","0308","0267","202","171","31","16","218","990","0","22.02","17.27"
"10","015","00","003","0309","0000","206","155","51","57","263","530","0","49.62","29.25"
"10","015","00","003","0309","0268","206","155","51","57","263","530","0","49.62","29.25"
"10","015","00","003","0310","0000","544","407","137","133","677","1536","0","44.08","26.5"
"10","015","00","003","0310","0269","316","232","84","41","357","979","0","36.47","23.7"
"10","015","00","003","0310","0270","228","175","53","92","320","557","0","57.45","31.42"
"10","015","00","003","0311","0000","441","330","111","77","518","1499","0","34.56","22.01"
"10","015","00","003","0311","0271","142","116","26","15","157","434","0","36.18","26.73"
"10","015","00","003","0311","0272","299","214","85","62","361","1065","0","33.9","20.09"
"10","015","00","003","0312","0000","369","274","95","92","461","866","0","53.23","31.64"
"10","015","00","003","0312","0273","369","274","95","92","461","866","0","53.23","31.64"
"10","015","00","003","0313","0000","277","209","68","38","315","769","0","40.96","27.18"
"10","015","00","003","0313","0274","277","209","68","38","315","769","0","40.96","27.18"
"10","015","00","003","0314","0000","338","266","72","32","370","869","0","42.58","30.61"
"10","015","00","003","0314","0275","338","266","72","32","370","869","0","42.58","30.61"
"10","015","00","003","0315","0000","402","322","80","44","446","1080","0","41.3","29.81"
"10","015","00","003","0315","0276","402","322","80","44","446","1080","0","41.3","29.81"
"10","015","00","004","0000","0000","8538","6963","1575","621","9159","17029","20112","53.78","40.89"
"10","015","00","004","0401","0000","627","517","110","26","653","1296","0","50.39","39.89"
"10","015","00","004","0401","0082","197","160","37","17","214","367","0","58.31","43.6"
"10","015","00","004","0401","0083","430","357","73","9","439","929","0","47.26","38.43"
"10","015","00","004","0402","0000","458","342","116","69","527","897","0","58.75","38.13"
"10","015","00","004","0402","0084","306","231","75","48","354","590","0","60.0","39.15"
"10","015","00","004","0402","0085","152","111","41","21","173","307","0","56.35","36.16"
"10","015","00","004","0403","0000","1224","1018","206","96","1320","2428","0","54.37","41.93"
"10","015","00","004","0403","0086","140","117","23","20","160","260","0","61.54","45.0"
"10","015","00","004","0403","0087","663","544","119","57","720","1283","0","56.12","42.4"
"10","015","00","004","0403","0088","421","357","64","19","440","885","0","49.72","40.34"
"10","015","00","004","0404","0000","1935","1564","371","131","2066","3962","0","52.15","39.48"
"10","015","00","004","0404","0092","548","433","115","43","591","1163","0","50.82","37.23"
"10","015","00","004","0404","0093","793","639","154","45","838","1605","0","52.21","39.81"
"10","015","00","004","0404","0094","594","492","102","43","637","1194","0","53.35","41.21"
"10","015","00","004","0405","0000","509","429","80","43","552","979","0","56.38","43.82"
"10","015","00","004","0405","0095","509","429","80","43","552","979","0","56.38","43.82"
"10","015","00","004","0406","0000","1920","1582","338","94","2014","3719","0","54.15","42.54"
"10","015","00","004","0406","0096","788","648","140","33","821","1485","0","55.29","43.64"
"10","015","00","004","0406","0097","524","437","87","35","559","1070","0","52.24","40.84"
"10","015","00","004","0406","0098","608","497","111","26","634","1164","0","54.47","42.7"
"10","015","00","004","0407","0000","587","477","110","69","656","1249","0","52.52","38.19"
"10","015","00","004","0407","0099","416","340","76","51","467","880","0","53.07","38.64"
"10","015","00","004","0407","0100","171","137","34","18","189","369","0","51.22","37.13"
"10","015","00","004","0408","0000","1278","1034","244","93","1371","2499","0","54.86","41.38"
"10","015","00","004","0408","0089","412","331","81","26","438","770","0","56.88","42.99"
"10","015","00","004","0408","0090","683","558","125","58","741","1363","0","54.37","40.94"
"10","015","00","004","0408","0091","183","145","38","9","192","366","0","52.46","39.62"
"10","015","00","005","0000","0000","35790","29187","6603","2064","37854","72116","83262","52.49","40.47"
"10","015","00","005","0501","0000","3707","3069","638","183","3890","7071","0","55.01","43.4"
"10","015","00","005","0501","0147","578","473","105","31","609","1135","0","53.66","41.67"
"10","015","00","005","0501","0148","669","567","102","26","695","1223","0","56.83","46.36"
"10","015","00","005","0501","0149","658","543","115","40","698","1274","0","54.79","42.62"
"10","015","00","005","0501","0150","554","456","98","37","591","1124","0","52.58","40.57"
"10","015","00","005","0501","0151","628","521","107","24","652","1158","0","56.3","44.99"
"10","015","00","005","0501","0152","620","509","111","25","645","1157","0","55.75","43.99"
"10","015","00","005","0502","0000","2568","2095","473","80","2648","4926","0","53.76","42.53"
"10","015","00","005","0502","0153","662","550","112","24","686","1258","0","54.53","43.72"
"10","015","00","005","0502","0154","639","515","124","28","667","1257","0","53.06","40.97"
"10","015","00","005","0502","0155","628","518","110","21","649","1245","0","52.13","41.61"
"10","015","00","005","0502","0156","639","512","127","7","646","1166","0","55.4","43.91"
"10","015","00","005","0503","0000","1707","1350","357","117","1824","3739","0","48.78","36.11"
"10","015","00","005","0503","0119","541","439","102","33","574","1107","0","51.85","39.66"
"10","015","00","005","0503","0120","557","430","127","30","587","1179","0","49.79","36.47"
"10","015","00","005","0503","0121","609","481","128","54","663","1453","0","45.63","33.1"
"10","015","00","005","0504","0000","2101","1735","366","124","2225","4178","0","53.26","41.53"
"10","015","00","005","0504","0115","520","420","100","34","554","1059","0","52.31","39.66"
"10","015","00","005","0504","0116","516","436","80","29","545","983","0","55.44","44.35"
"10","015","00","005","0504","0117","528","452","76","34","562","1031","0","54.51","43.84"
"10","015","00","005","0504","0118","537","427","110","27","564","1105","0","51.04","38.64"
"10","015","00","005","0505","0000","3532","2932","600","174","3706","6870","0","53.94","42.68"
"10","015","00","005","0505","0122","796","666","130","44","840","1432","0","58.66","46.51"
"10","015","00","005","0505","0123","700","575","125","27","727","1320","0","55.08","43.56"
"10","015","00","005","0505","0124","658","538","120","23","681","1356","0","50.22","39.68"
"10","015","00","005","0505","0125","631","533","98","30","661","1295","0","51.04","41.16"
"10","015","00","005","0505","0126","747","620","127","50","797","1467","0","54.33","42.26"
"10","015","00","005","0506","0000","2639","2180","459","111","2750","5242","0","52.46","41.59"
"10","015","00","005","0506","0127","755","609","146","29","784","1515","0","51.75","40.2"
"10","015","00","005","0506","0128","595","492","103","35","630","1063","0","59.27","46.28"
"10","015","00","005","0506","0129","546","458","88","17","563","1284","0","43.85","35.67"
"10","015","00","005","0506","0130","743","621","122","30","773","1380","0","56.01","45.0"
"10","015","00","005","0507","0000","1462","1152","310","111","1573","2959","0","53.16","38.93"
"10","015","00","005","0507","0131","684","535","149","47","731","1297","0","56.36","41.25"
"10","015","00","005","0507","0132","778","617","161","64","842","1662","0","50.66","37.12"
"10","015","00","005","0508","0000","677","503","174","71","748","1563","0","47.86","32.18"
"10","015","00","005","0508","0133","677","503","174","71","748","1563","0","47.86","32.18"
"10","015","00","005","0509","0000","577","473","104","43","620","1288","0","48.14","36.72"
"10","015","00","005","0509","0134","577","473","104","43","620","1288","0","48.14","36.72"
"10","015","00","005","0510","0000","1426","1131","295","75","1501","2845","0","52.76","39.75"
"10","015","00","005","0510","0135","472","371","101","30","502","907","0","55.35","40.9"
"10","015","00","005","0510","0136","451","360","91","22","473","917","0","51.58","39.26"
"10","015","00","005","0510","0137","503","400","103","23","526","1021","0","51.52","39.18"
"10","015","00","005","0511","0000","1660","1376","284","128","1788","3187","0","56.1","43.18"
"10","015","00","005","0511","0138","578","472","106","36","614","1033","0","59.44","45.69"
"10","015","00","005","0511","0139","508","420","88","42","550","966","0","56.94","43.48"
"10","015","00","005","0511","0140","574","484","90","50","624","1188","0","52.53","40.74"
"10","015","00","005","0512","0000","1943","1625","318","87","2030","4066","0","49.93","39.97"
"10","015","00","005","0512","0141","738","624","114","25","763","1480","0","51.55","42.16"
"10","015","00","005","0512","0142","643","536","107","32","675","1393","0","48.46","38.48"
"10","015","00","005","0512","0143","562","465","97","30","592","1193","0","49.62","38.98"
"10","015","00","005","0513","0000","1952","1571","381","147","2099","3961","0","52.99","39.66"
"10","015","00","005","0513","0144","661","539","122","32","693","1445","0","47.96","37.3"
"10","015","00","005","0513","0145","646","513","133","67","713","1301","0","54.8","39.43"
"10","015","00","005","0513","0146","645","519","126","48","693","1215","0","57.04","42.72"
"10","015","00","005","0514","0000","3053","2493","560","192","3245","6041","0","53.72","41.27"
"10","015","00","005","0514","0157","661","539","122","48","709","1358","0","52.21","39.69"
"10","015","00","005","0514","0158","598","508","90","32","630","1214","0","51.89","41.85"
"10","015","00","005","0514","0159","558","449","109","51","609","1151","0","52.91","39.01"
"10","015","00","005","0514","0160","614","484","130","27","641","1157","0","55.4","41.83"
"10","015","00","005","0514","0161","622","513","109","34","656","1161","0","56.5","44.19"
"10","015","00","005","0515","0000","2630","2129","501","148","2778","5491","0","50.59","38.77"
"10","015","00","005","0515","0162","700","567","133","36","736","1304","0","56.44","43.48"
"10","015","00","005","0515","0163","673","536","137","44","717","1367","0","52.45","39.21"
"10","015","00","005","0515","0164","625","490","135","40","665","1411","0","47.13","34.73"
"10","015","00","005","0515","0165","632","536","96","28","660","1409","0","46.84","38.04"
"10","015","00","005","0516","0000","1100","877","223","103","1203","2338","0","51.45","37.51"
"10","015","00","005","0516","0166","496","399","97","37","533","1125","0","47.38","35.47"
"10","015","00","005","0516","0167","604","478","126","66","670","1213","0","55.23","39.41"
"10","015","00","005","0517","0000","2060","1684","376","123","2183","4415","0","49.45","38.14"
"10","015","00","005","0517","0168","592","478","114","32","624","1141","0","54.69","41.89"
"10","015","00","005","0517","0169","514","436","78","16","530","1156","0","45.85","37.72"
"10","015","00","005","0517","0170","521","442","79","44","565","1092","0","51.74","40.48"
"10","015","00","005","0517","0171","433","328","105","31","464","1026","0","45.22","31.97"
"10","015","00","005","0518","0000","996","812","184","47","1043","1936","0","53.87","41.94"
"10","015","00","005","0518","0172","405","337","68","13","418","804","0","51.99","41.92"
"10","015","00","005","0518","0173","591","475","116","34","625","1132","0","55.21","41.96"
"10","015","00","006","0000","0000","7986","6262","1724","746","8732","15847","18006","55.1","39.52"
"10","015","00","006","0601","0000","196","159","37","22","218","357","0","61.06","44.54"
"10","015","00","006","0601","0175","196","159","37","22","218","357","0","61.06","44.54"
"10","015","00","006","0602","0000","467","365","102","36","503","1052","0","47.81","34.7"
"10","015","00","006","0602","0174","467","365","102","36","503","1052","0","47.81","34.7"
"10","015","00","006","0603","0000","978","772","206","85","1063","1897","0","56.04","40.7"
"10","015","00","006","0603","0176","472","381","91","44","516","1022","0","50.49","37.28"
"10","015","00","006","0603","0177","506","391","115","41","547","875","0","62.51","44.69"
"10","015","00","006","0604","0000","686","526","160","60","746","1399","0","53.32","37.6"
"10","015","00","006","0604","0178","384","291","93","39","423","691","0","61.22","42.11"
"10","015","00","006","0604","0179","302","235","67","21","323","708","0","45.62","33.19"
"10","015","00","006","0605","0000","430","331","99","43","473","894","0","52.91","37.02"
"10","015","00","006","0605","0180","430","331","99","43","473","894","0","52.91","37.02"
"10","015","00","006","0606","0000","395","338","57","36","431","695","0","62.01","48.63"
"10","015","00","006","0606","0183","395","338","57","36","431","695","0","62.01","48.63"
"10","015","00","006","0607","0000","814","648","166","68","882","1627","0","54.21","39.83"
"10","015","00","006","0607","0181","379","304","75","31","410","746","0","54.96","40.75"
"10","015","00","006","0607","0182","435","344","91","37","472","881","0","53.58","39.05"
"10","015","00","006","0608","0000","439","319","120","72","511","816","0","62.62","39.09"
"10","015","00","006","0608","0184","439","319","120","72","511","816","0","62.62","39.09"
"10","015","00","006","0609","0000","347","277","70","48","395","773","0","51.1","35.83"
"10","015","00","006","0609","0185","347","277","70","48","395","773","0","51.1","35.83"
"10","015","00","006","0610","0000","757","594","163","80","837","1436","0","58.29","41.36"
"10","015","00","006","0610","0186","526","404","122","54","580","1029","0","56.37","39.26"
"10","015","00","006","0610","0187","231","190","41","26","257","407","0","63.14","46.68"
"10","015","00","006","0611","0000","1319","1021","298","90","1409","2549","0","55.28","40.05"
"10","015","00","006","0611","0188","603","485","118","45","648","1139","0","56.89","42.58"
"10","015","00","006","0611","0189","540","400","140","34","574","996","0","57.63","40.16"
"10","015","00","006","0611","0190","176","136","40","11","187","414","0","45.17","32.85"
"10","015","00","006","0612","0000","151","116","35","6","157","270","0","58.15","42.96"
"10","015","00","006","0612","0191","151","116","35","6","157","270","0","58.15","42.96"
"10","015","00","006","0613","0000","446","363","83","40","486","836","0","58.13","43.42"
"10","015","00","006","0613","0192","446","363","83","40","486","836","0","58.13","43.42"
"10","015","00","006","0614","0000","276","216","60","39","315","739","0","42.63","29.23"
"10","015","00","006","0614","0194","276","216","60","39","315","739","0","42.63","29.23"
"10","015","00","006","0615","0000","285","217","68","21","306","507","0","60.36","42.8"
"10","015","00","006","0615","0193","285","217","68","21","306","507","0","60.36","42.8"
"10","015","00","007","0000","0000","5156","4079","1077","659","5815","11417","12847","50.93","35.73"
"10","015","00","007","0701","0000","462","373","89","35","497","859","0","57.86","43.42"
"10","015","00","007","0701","0211","462","373","89","35","497","859","0","57.86","43.42"
"10","015","00","007","0702","0000","654","522","132","65","719","1295","0","55.52","40.31"
"10","015","00","007","0702","0210","654","522","132","65","719","1295","0","55.52","40.31"
"10","015","00","007","0703","0000","448","352","96","122","570","958","0","59.5","36.74"
"10","015","00","007","0703","0212","448","352","96","122","570","958","0","59.5","36.74"
"10","015","00","007","0704","0000","497","370","127","93","590","1011","0","58.36","36.6"
"10","015","00","007","0704","0213","497","370","127","93","590","1011","0","58.36","36.6"
"10","015","00","007","0705","0000","542","439","103","61","603","1041","0","57.93","42.17"
"10","015","00","007","0705","0214","542","439","103","61","603","1041","0","57.93","42.17"
"10","015","00","007","0706","0000","250","212","38","18","268","471","0","56.9","45.01"
"10","015","00","007","0706","0221","250","212","38","18","268","471","0","56.9","45.01"
"10","015","00","007","0707","0000","354","286","68","49","403","756","0","53.31","37.83"
"10","015","00","007","0707","0222","312","251","61","46","358","640","0","55.94","39.22"
"10","015","00","007","0707","0223","42","35","7","3","45","116","0","38.79","30.17"
"10","015","00","007","0708","0000","135","116","19","10","145","496","0","29.23","23.39"
"10","015","00","007","0708","0224","135","116","19","10","145","496","0","29.23","23.39"
"10","015","00","007","0709","0000","136","106","30","10","146","324","0","45.06","32.72"
"10","015","00","007","0709","0225","136","106","30","10","146","324","0","45.06","32.72"
"10","015","00","007","0710","0000","158","126","32","18","176","454","0","38.77","27.75"
"10","015","00","007","0710","0226","158","126","32","18","176","454","0","38.77","27.75"
"10","015","00","007","0711","0000","415","320","95","68","483","1009","0","47.87","31.71"
"10","015","00","007","0711","0215","381","292","89","67","448","821","0","54.57","35.57"
"10","015","00","007","0711","0216","34","28","6","1","35","188","0","18.62","14.89"
"10","015","00","007","0712","0000","400","311","89","40","440","960","0","45.83","32.4"
"10","015","00","007","0712","0217","254","208","46","28","282","514","0","54.86","40.47"
"10","015","00","007","0712","0218","146","103","43","12","158","446","0","35.43","23.09"
"10","015","00","007","0713","0000","386","303","83","45","431","851","0","50.65","35.61"
"10","015","00","007","0713","0219","386","303","83","45","431","851","0","50.65","35.61"
"10","015","00","007","0714","0000","319","243","76","25","344","932","0","36.91","26.07"
"10","015","00","007","0714","0220","319","243","76","25","344","932","0","36.91","26.07"
"10","015","00","008","0000","0000","1622","1236","386","276","1898","4395","4811","43.19","28.12"
"10","015","00","008","0801","0000","631","503","128","73","704","1779","0","39.57","28.27"
"10","015","00","008","0801","0229","239","176","63","48","287","613","0","46.82","28.71"
"10","015","00","008","0801","0230","339","283","56","23","362","809","0","44.75","34.98"
"10","015","00","008","0801","0231","53","44","9","2","55","357","0","15.41","12.32"
"10","015","00","008","0802","0000","278","207","71","62","340","669","0","50.82","30.94"
"10","015","00","008","0802","0232","278","207","71","62","340","669","0","50.82","30.94"
"10","015","00","008","0803","0000","196","162","34","12","208","479","0","43.42","33.82"
"10","015","00","008","0803","0233","196","162","34","12","208","479","0","43.42","33.82"
"10","015","00","008","0804","0000","257","170","87","47","304","751","0","40.48","22.64"
"10","015","00","008","0804","0228","257","170","87","47","304","751","0","40.48","22.64"
"10","015","00","008","0805","0000","260","194","66","82","342","717","0","47.7","27.06"
"10","015","00","008","0805","0227","260","194","66","82","342","717","0","47.7","27.06"
"10","015","00","009","0000","0000","4526","3616","910","493","5019","10279","11716","48.83","35.18"
"10","015","00","009","0901","0000","976","805","171","102","1078","1904","0","56.62","42.28"
"10","015","00","009","0901","0241","430","357","73","39","469","813","0","57.69","43.91"
"10","015","00","009","0901","0242","546","448","98","63","609","1091","0","55.82","41.06"
"10","015","00","009","0902","0000","949","776","173","84","1033","1814","0","56.95","42.78"
"10","015","00","009","0902","0243","443","371","72","33","476","839","0","56.73","44.22"
"10","015","00","009","0902","0244","506","405","101","51","557","975","0","57.13","41.54"
"10","015","00","009","0903","0000","234","180","54","20","254","546","0","46.52","32.97"
"10","015","00","009","0903","0245","234","180","54","20","254","546","0","46.52","32.97"
"10","015","00","009","0904","0000","511","413","98","59","570","1002","0","56.89","41.22"
"10","015","00","009","0904","0246","511","413","98","59","570","1002","0","56.89","41.22"
"10","015","00","009","0905","0000","238","177","61","38","276","593","0","46.54","29.85"
"10","015","00","009","0905","0247","238","177","61","38","276","593","0","46.54","29.85"
"10","015","00","009","0906","0000","479","362","117","73","552","965","0","57.2","37.51"
"10","015","00","009","0906","0248","479","362","117","73","552","965","0","57.2","37.51"
"10","015","00","009","0907","0000","424","316","108","52","476","863","0","55.16","36.62"
"10","015","00","009","0907","0249","424","316","108","52","476","863","0","55.16","36.62"
"10","015","00","009","0908","0000","72","58","14","5","77","340","0","22.65","17.06"
"10","015","00","009","0908","0250","72","58","14","5","77","340","0","22.65","17.06"
"10","015","00","009","0909","0000","322","250","72","32","354","764","0","46.34","32.72"
"10","015","00","009","0909","0251","322","250","72","32","354","764","0","46.34","32.72"
"10","015","00","009","0910","0000","155","139","16","15","170","868","0","19.59","16.01"
"10","015","00","009","0910","0252","155","139","16","15","170","868","0","19.59","16.01"
"10","015","00","009","0911","0000","166","140","26","13","179","620","0","28.87","22.58"
"10","015","00","009","0911","0253","166","140","26","13","179","620","0","28.87","22.58"
"10","015","00","010","0000","0000","3645","2909","736","470","4115","9065","10331","45.39","32.09"
"10","015","00","010","1001","0000","180","144","36","18","198","467","0","42.4","30.84"
"10","015","00","010","1001","0277","180","144","36","18","198","467","0","42.4","30.84"
"10","015","00","010","1002","0000","358","286","72","49","407","1032","0","39.44","27.71"
"10","015","00","010","1002","0278","358","286","72","49","407","1032","0","39.44","27.71"
"10","015","00","010","1003","0000","241","206","35","35","276","638","0","43.26","32.29"
"10","015","00","010","1003","0279","241","206","35","35","276","638","0","43.26","32.29"
"10","015","00","010","1004","0000","250","204","46","72","322","591","0","54.48","34.52"
"10","015","00","010","1004","0280","250","204","46","72","322","591","0","54.48","34.52"
"10","015","00","010","1005","0000","535","435","100","56","591","1087","0","54.37","40.02"
"10","015","00","010","1005","0281","535","435","100","56","591","1087","0","54.37","40.02"
"10","015","00","010","1006","0000","204","159","45","20","224","431","0","51.97","36.89"
"10","015","00","010","1006","0282","204","159","45","20","224","431","0","51.97","36.89"
"10","015","00","010","1007","0000","388","323","65","46","434","893","0","48.6","36.17"
"10","015","00","010","1007","0283","388","323","65","46","434","893","0","48.6","36.17"
"10","015","00","010","1008","0000","130","100","30","19","149","361","0","41.27","27.7"
"10","015","00","010","1008","0284","130","100","30","19","149","361","0","41.27","27.7"
"10","015","00","010","1009","0000","493","386","107","47","540","1362","0","39.65","28.34"
"10","015","00","010","1009","0285","493","386","107","47","540","1362","0","39.65","28.34"
"10","015","00","010","1010","0000","217","171","46","21","238","458","0","51.97","37.34"
"10","015","00","010","1010","0286","217","171","46","21","238","458","0","51.97","37.34"
"10","015","00","010","1011","0000","161","125","36","34","195","621","0","31.4","20.13"
"10","015","00","010","1011","0287","161","125","36","34","195","621","0","31.4","20.13"
"10","015","00","010","1012","0000","220","163","57","23","243","493","0","49.29","33.06"
"10","015","00","010","1012","0288","220","163","57","23","243","493","0","49.29","33.06"
"10","015","00","010","1013","0000","268","207","61","30","298","631","0","47.23","32.81"
"10","015","00","010","1013","0289","268","207","61","30","298","631","0","47.23","32.81"
"10","015","00","011","0000","0000","5524","4415","1109","477","6001","12562","15937","47.77","35.15"
"10","015","00","011","1101","0000","466","353","113","50","516","1373","0","37.58","25.71"
"10","015","00","011","1101","0103","466","353","113","50","516","1373","0","37.58","25.71"
"10","015","00","011","1102","0000","712","589","123","81","793","1806","0","43.91","32.61"
"10","015","00","011","1102","0104","632","520","112","72","704","1644","0","42.82","31.63"
"10","015","00","011","1102","0105","80","69","11","9","89","162","0","54.94","42.59"
"10","015","00","011","1103","0000","703","564","139","64","767","1766","0","43.43","31.94"
"10","015","00","011","1103","0106","168","119","49","25","193","384","0","50.26","30.99"
"10","015","00","011","1103","0107","535","445","90","39","574","1382","0","41.53","32.2"
"10","015","00","011","1104","0000","609","485","124","90","699","1139","0","61.37","42.58"
"10","015","00","011","1104","0111","609","485","124","90","699","1139","0","61.37","42.58"
"10","015","00","011","1105","0000","565","471","94","8","573","1213","0","47.24","38.83"
"10","015","00","011","1105","0112","565","471","94","8","573","1213","0","47.24","38.83"
"10","015","00","011","1106","0000","487","393","94","41","528","1084","0","48.71","36.25"
"10","015","00","011","1106","0113","358","285","73","28","386","754","0","51.19","37.8"
"10","015","00","011","1106","0114","129","108","21","13","142","330","0","43.03","32.73"
"10","015","00","011","1107","0000","756","599","157","37","793","1752","0","45.26","34.19"
"10","015","00","011","1107","0108","482","383","99","26","508","1125","0","45.16","34.04"
"10","015","00","011","1107","0109","274","216","58","11","285","627","0","45.45","34.45"
"10","015","00","011","1108","0000","549","443","106","52","601","987","0","60.89","44.88"
"10","015","00","011","1108","0110","549","443","106","52","601","987","0","60.89","44.88"
"10","015","00","011","1109","0000","677","518","159","54","731","1442","0","50.69","35.92"
"10","015","00","011","1109","0101","410","322","88","30","440","867","0","50.75","37.14"
"10","015","00","011","1109","0102","267","196","71","24","291","575","0","50.61","34.09"
"10","015","00","012","0000","0000","2497","1872","625","331","2828","5269","6439","53.67","35.53"
"10","015","00","012","1201","0000","522","398","124","72","594","1072","0","55.41","37.13"
"10","015","00","012","1201","0234","522","398","124","72","594","1072","0","55.41","37.13"
"10","015","00","012","1202","0000","205","163","42","13","218","560","0","38.93","29.11"
"10","015","00","012","1202","0235","205","163","42","13","218","560","0","38.93","29.11"
"10","015","00","012","1203","0000","428","337","91","30","458","773","0","59.25","43.6"
"10","015","00","012","1203","0236","428","337","91","30","458","773","0","59.25","43.6"
"10","015","00","012","1204","0000","239","179","60","12","251","661","0","37.97","27.08"
"10","015","00","012","1204","0237","239","179","60","12","251","661","0","37.97","27.08"
"10","015","00","012","1205","0000","485","361","124","85","570","1117","0","51.03","32.32"
"10","015","00","012","1205","0238","204","161","43","19","223","442","0","50.45","36.43"
"10","015","00","012","1205","0239","281","200","81","66","347","675","0","51.41","29.63"
"10","015","00","012","1206","0000","618","434","184","119","737","1086","0","67.86","39.96"
"10","015","00","012","1206","0240","618","434","184","119","737","1086","0","67.86","39.96"
"10","015","00","013","0000","0000","2404","1889","515","276","2680","4947","6104","54.17","38.18"
"10","015","00","013","1301","0000","266","208","58","16","282","533","0","52.91","39.02"
"10","015","00","013","1301","0290","266","208","58","16","282","533","0","52.91","39.02"
"10","015","00","013","1302","0000","453","341","112","54","507","1015","0","49.95","33.6"
"10","015","00","013","1302","0291","289","214","75","37","326","522","0","62.45","41.0"
"10","015","00","013","1302","0292","164","127","37","17","181","493","0","36.71","25.76"
"10","015","00","013","1303","0000","400","316","84","38","438","701","0","62.48","45.08"
"10","015","00","013","1303","0293","400","316","84","38","438","701","0","62.48","45.08"
"10","015","00","013","1304","0000","392","323","69","51","443","746","0","59.38","43.3"
"10","015","00","013","1304","0294","392","323","69","51","443","746","0","59.38","43.3"
"10","015","00","013","1305","0000","441","318","123","74","515","1021","0","50.44","31.15"
"10","015","00","013","1305","0295","328","222","106","58","386","616","0","62.66","36.04"
"10","015","00","013","1305","0296","113","96","17","16","129","405","0","31.85","23.7"
"10","015","00","013","1306","0000","452","383","69","43","495","931","0","53.17","41.14"
"10","015","00","013","1306","0297","163","131","32","16","179","329","0","54.41","39.82"
"10","015","00","013","1306","0298","201","174","27","17","218","428","0","50.93","40.65"
"10","015","00","013","1306","0299","88","78","10","10","98","174","0","56.32","44.83"
"10","014","00","000","0000","0000","85299","67881","17418","8509","93808","185996","219268","50.44","36.5"
"10","014","00","001","0000","0000","44054","35634","8420","3184","47238","87803","105587","53.8","40.58"
"10","014","00","001","0101","0000","663","501","162","108","771","1505","0","51.23","33.29"
"10","014","00","001","0101","0052","663","501","162","108","771","1505","0","51.23","33.29"
"10","014","00","001","0102","0000","347","269","78","57","404","836","0","48.33","32.18"
"10","014","00","001","0102","0053","347","269","78","57","404","836","0","48.33","32.18"
"10","014","00","001","0103","0000","1126","940","186","70","1196","2162","0","55.32","43.48"
"10","014","00","001","0103","0056","1126","940","186","70","1196","2162","0","55.32","43.48"
"10","014","00","001","0104","0000","1336","1069","267","101","1437","2688","0","53.46","39.77"
"10","014","00","001","0104","0059","653","537","116","45","698","1359","0","51.36","39.51"
"10","014","00","001","0104","0060","683","532","151","56","739","1329","0","55.61","40.03"
"10","014","00","001","0105","0000","1535","1246","289","89","1624","2767","0","58.69","45.03"
"10","014","00","001","0105","0057","928","758","170","35","963","1627","0","59.19","46.59"
"10","014","00","001","0105","0058","607","488","119","54","661","1140","0","57.98","42.81"
"10","014","00","001","0106","0000","1350","1082","268","103","1453","2644","0","54.95","40.92"
"10","014","00","001","0106","0054","684","556","128","48","732","1294","0","56.57","42.97"
"10","014","00","001","0106","0055","666","526","140","55","721","1350","0","53.41","38.96"
"10","014","00","001","0107","0000","3484","2866","618","201","3685","6543","0","56.32","43.8"
"10","014","00","001","0107","0026","906","725","181","45","951","1638","0","58.06","44.26"
"10","014","00","001","0107","0027","822","670","152","49","871","1576","0","55.27","42.51"
"10","014","00","001","0107","0028","837","704","133","59","896","1595","0","56.18","44.14"
"10","014","00","001","0107","0029","919","767","152","48","967","1734","0","55.77","44.23"
"10","014","00","001","0108","0000","1720","1375","345","96","1816","3141","0","57.82","43.78"
"10","014","00","001","0108","0006","848","682","166","43","891","1651","0","53.97","41.31"
"10","014","00","001","0108","0007","872","693","179","53","925","1490","0","62.08","46.51"
"10","014","00","001","0109","0000","416","347","69","29","445","859","0","51.8","40.4"
"10","014","00","001","0109","0008","416","347","69","29","445","859","0","51.8","40.4"
"10","014","00","001","0110","0000","1518","1263","255","85","1603","2651","0","60.47","47.64"
"10","014","00","001","0110","0032","740","611","129","47","787","1313","0","59.94","46.53"
"10","014","00","001","0110","0033","778","652","126","38","816","1338","0","60.99","48.73"
"10","014","00","001","0111","0000","1670","1369","301","99","1769","3021","0","58.56","45.32"
"10","014","00","001","0111","0030","791","646","145","52","843","1476","0","57.11","43.77"
"10","014","00","001","0111","0031","879","723","156","47","926","1545","0","59.94","46.8"
"10","014","00","001","0112","0000","2185","1752","433","114","2299","4021","0","57.17","43.57"
"10","014","00","001","0112","0003","665","523","142","30","695","1259","0","55.2","41.54"
"10","014","00","001","0112","0004","725","564","161","39","764","1399","0","54.61","40.31"
"10","014","00","001","0112","0005","795","665","130","45","840","1363","0","61.63","48.79"
"10","014","00","001","0113","0000","836","688","148","68","904","1469","0","61.54","46.83"
"10","014","00","001","0113","0002","836","688","148","68","904","1469","0","61.54","46.83"
"10","014","00","001","0114","0000","341","263","78","35","376","651","0","57.76","40.4"
"10","014","00","001","0114","0010","341","263","78","35","376","651","0","57.76","40.4"
"10","014","00","001","0115","0000","766","582","184","57","823","1650","0","49.88","35.27"
"10","014","00","001","0115","0011","766","582","184","57","823","1650","0","49.88","35.27"
"10","014","00","001","0116","0000","353","286","67","28","381","632","0","60.28","45.25"
"10","014","00","001","0116","0013","353","286","67","28","381","632","0","60.28","45.25"
"10","014","00","001","0117","0000","633","488","145","87","720","1299","0","55.43","37.57"
"10","014","00","001","0117","0016","633","488","145","87","720","1299","0","55.43","37.57"
"10","014","00","001","0118","0000","508","422","86","28","536","890","0","60.22","47.42"
"10","014","00","001","0118","0009","508","422","86","28","536","890","0","60.22","47.42"
"10","014","00","001","0119","0000","417","318","99","33","450","724","0","62.15","43.92"
"10","014","00","001","0119","0012","417","318","99","33","450","724","0","62.15","43.92"
"10","014","00","001","0120","0000","455","366","89","32","487","811","0","60.05","45.13"
"10","014","00","001","0120","0017","455","366","89","32","487","811","0","60.05","45.13"
"10","014","00","001","0121","0000","425","346","79","37","462","771","0","59.92","44.88"
"10","014","00","001","0121","0014","425","346","79","37","462","771","0","59.92","44.88"
"10","014","00","001","0122","0000","380","297","83","27","407","798","0","51.0","37.22"
"10","014","00","001","0122","0015","380","297","83","27","407","798","0","51.0","37.22"
"10","014","00","001","0123","0000","404","332","72","24","428","874","0","48.97","37.99"
"10","014","00","001","0123","0001","404","332","72","24","428","874","0","48.97","37.99"
"10","014","00","001","0124","0000","451","366","85","38","489","764","0","64.01","47.91"
"10","014","00","001","0124","0018","451","366","85","38","489","764","0","64.01","47.91"
"10","014","00","001","0125","0000","276","227","49","20","296","601","0","49.25","37.77"
"10","014","00","001","0125","0023","276","227","49","20","296","601","0","49.25","37.77"
"10","014","00","001","0126","0000","375","300","75","18","393","784","0","50.13","38.27"
"10","014","00","001","0126","0019","375","300","75","18","393","784","0","50.13","38.27"
"10","014","00","001","0127","0000","195","164","31","8","203","417","0","48.68","39.33"
"10","014","00","001","0127","0024","195","164","31","8","203","417","0","48.68","39.33"
"10","014","00","001","0128","0000","192","159","33","15","207","427","0","48.48","37.24"
"10","014","00","001","0128","0020","192","159","33","15","207","427","0","48.48","37.24"
"10","014","00","001","0129","0000","758","594","164","76","834","1597","0","52.22","37.19"
"10","014","00","001","0129","0063","758","594","164","76","834","1597","0","52.22","37.19"
"10","014","00","001","0130","0000","1005","801","204","95","1100","2028","0","54.24","39.5"
"10","014","00","001","0130","0061","478","381","97","37","515","990","0","52.02","38.48"
"10","014","00","001","0130","0062","527","420","107","58","585","1038","0","56.36","40.46"
"10","014","00","001","0131","0000","1331","1060","271","103","1434","2959","0","48.46","35.82"
"10","014","00","001","0131","0036","614","464","150","63","677","1407","0","48.12","32.98"
"10","014","00","001","0131","0037","717","596","121","40","757","1552","0","48.78","38.4"
"10","014","00","001","0132","0000","1354","1110","244","76","1430","2577","0","55.49","43.07"
"10","014","00","001","0132","0034","676","572","104","30","706","1312","0","53.81","43.6"
"10","014","00","001","0132","0035","678","538","140","46","724","1265","0","57.23","42.53"
"10","014","00","001","0133","0000","739","610","129","72","811","1445","0","56.12","42.21"
"10","014","00","001","0133","0038","739","610","129","72","811","1445","0","56.12","42.21"
"10","014","00","001","0134","0000","1127","921","206","62","1189","2098","0","56.67","43.9"
"10","014","00","001","0134","0039","1127","921","206","62","1189","2098","0","56.67","43.9"
"10","014","00","001","0135","0000","704","567","137","79","783","1324","0","59.14","42.82"
"10","014","00","001","0135","0040","704","567","137","79","783","1324","0","59.14","42.82"
"10","014","00","001","0136","0000","1416","1158","258","57","1473","2793","0","52.74","41.46"
"10","014","00","001","0136","0021","602","487","115","36","638","1292","0","49.38","37.69"
"10","014","00","001","0136","0022","814","671","143","21","835","1501","0","55.63","44.7"
"10","014","00","001","0137","0000","513","431","82","42","555","1001","0","55.44","43.06"
"10","014","00","001","0137","0025","513","431","82","42","555","1001","0","55.44","43.06"
"10","014","00","001","0138","0000","3894","3218","676","255","4149","8002","0","51.85","40.21"
"10","014","00","001","0138","0041","803","688","115","38","841","1598","0","52.63","43.05"
"10","014","00","001","0138","0042","745","623","122","29","774","1513","0","51.16","41.18"
"10","014","00","001","0138","0043","775","654","121","69","844","1679","0","50.27","38.95"
"10","014","00","001","0138","0044","673","518","155","65","738","1414","0","52.19","36.63"
"10","014","00","001","0138","0045","898","735","163","54","952","1798","0","52.95","40.88"
"10","014","00","001","0139","0000","2354","1920","434","206","2560","5087","0","50.32","37.74"
"10","014","00","001","0139","0046","735","579","156","63","798","1749","0","45.63","33.1"
"10","014","00","001","0139","0047","848","693","155","90","938","1709","0","54.89","40.55"
"10","014","00","001","0139","0048","771","648","123","53","824","1629","0","50.58","39.78"
"10","014","00","001","0140","0000","1039","824","215","91","1130","2375","0","47.58","34.69"
"10","014","00","001","0140","0049","527","411","116","63","590","1116","0","52.87","36.83"
"10","014","00","001","0140","0050","512","413","99","28","540","1259","0","42.89","32.8"
"10","014","00","001","0141","0000","512","408","104","36","548","1232","0","44.48","33.12"
"10","014","00","001","0141","0051","512","408","104","36","548","1232","0","44.48","33.12"
"10","014","00","001","0142","0000","665","533","132","80","745","1385","0","53.79","38.48"
"10","014","00","001","0142","0064","665","533","132","80","745","1385","0","53.79","38.48"
"10","014","00","001","0143","0000","391","308","83","17","408","939","0","43.45","32.8"
"10","014","00","001","0143","0065","391","308","83","17","408","939","0","43.45","32.8"
"10","014","00","001","0144","0000","486","382","104","62","548","1258","0","43.56","30.37"
"10","014","00","001","0144","0066","486","382","104","62","548","1258","0","43.56","30.37"
"10","014","00","001","0145","0000","625","478","147","11","636","1350","0","47.11","35.41"
"10","014","00","001","0145","0067","625","478","147","11","636","1350","0","47.11","35.41"
"10","014","00","001","0146","0000","784","628","156","57","841","1953","0","43.06","32.16"
"10","014","00","001","0146","0068","448","370","78","27","475","1058","0","44.9","34.97"
"10","014","00","001","0146","0069","336","258","78","30","366","895","0","40.89","28.83"
"10","014","00","002","0000","0000","5263","4157","1106","802","6065","12426","14105","48.81","33.45"
"10","014","00","002","0201","0000","195","148","47","25","220","637","0","34.54","23.23"
"10","014","00","002","0201","0085","73","58","15","2","75","373","0","20.11","15.55"
"10","014","00","002","0201","0086","122","90","32","23","145","264","0","54.92","34.09"
"10","014","00","002","0202","0000","327","243","84","85","412","969","0","42.52","25.08"
"10","014","00","002","0202","0083","173","127","46","44","217","488","0","44.47","26.02"
"10","014","00","002","0202","0084","154","116","38","41","195","481","0","40.54","24.12"
"10","014","00","002","0203","0000","494","378","116","144","638","1403","0","45.47","26.94"
"10","014","00","002","0203","0081","201","153","48","62","263","516","0","50.97","29.65"
"10","014","00","002","0203","0082","293","225","68","82","375","887","0","42.28","25.37"
"10","014","00","002","0204","0000","1230","1014","216","182","1412","2731","0","51.7","37.13"
"10","014","00","002","0204","0079","587","489","98","104","691","1365","0","50.62","35.82"
"10","014","00","002","0204","0080","643","525","118","78","721","1366","0","52.78","38.43"
"10","014","00","002","0205","0000","905","756","149","78","983","1901","0","51.71","39.77"
"10","014","00","002","0205","0077","462","386","76","45","507","931","0","54.46","41.46"
"10","014","00","002","0205","0078","443","370","73","33","476","970","0","49.07","38.14"
"10","014","00","002","0206","0000","986","775","211","108","1094","2197","0","49.8","35.28"
"10","014","00","002","0206","0074","133","102","31","26","159","339","0","46.9","30.09"
"10","014","00","002","0206","0075","422","340","82","29","451","995","0","45.33","34.17"
"10","014","00","002","0206","0076","431","333","98","53","484","863","0","56.08","38.59"
"10","014","00","002","0207","0000","287","218","69","58","345","747","0","46.18","29.18"
"10","014","00","002","0207","0073","287","218","69","58","345","747","0","46.18","29.18"
"10","014","00","002","0208","0000","839","625","214","122","961","1841","0","52.2","33.95"
"10","014","00","002","0208","0070","216","173","43","43","259","516","0","50.19","33.53"
"10","014","00","002","0208","0071","520","366","154","64","584","960","0","60.83","38.13"
"10","014","00","002","0208","0072","103","86","17","15","118","365","0","32.33","23.56"
"10","014","00","003","0000","0000","3447","2816","631","232","3679","7509","8727","48.99","37.5"
"10","014","00","003","0301","0000","712","576","136","55","767","1691","0","45.36","34.06"
"10","014","00","003","0301","0093","433","343","90","35","468","912","0","51.32","37.61"
"10","014","00","003","0301","0094","279","233","46","20","299","779","0","38.38","29.91"
"10","014","00","003","0302","0000","591","495","96","26","617","1137","0","54.27","43.54"
"10","014","00","003","0302","0091","591","495","96","26","617","1137","0","54.27","43.54"
"10","014","00","003","0303","0000","346","270","76","23","369","887","0","41.6","30.44"
"10","014","00","003","0303","0090","346","270","76","23","369","887","0","41.6","30.44"
"10","014","00","003","0304","0000","464","379","85","36","500","828","0","60.39","45.77"
"10","014","00","003","0304","0089","464","379","85","36","500","828","0","60.39","45.77"
"10","014","00","003","0305","0000","828","680","148","45","873","1699","0","51.38","40.02"
"10","014","00","003","0305","0087","511","415","96","25","536","909","0","58.97","45.65"
"10","014","00","003","0305","0088","317","265","52","20","337","790","0","42.66","33.54"
"10","014","00","003","0306","0000","188","164","24","15","203","535","0","37.94","30.65"
"10","014","00","003","0306","0095","188","164","24","15","203","535","0","37.94","30.65"
"10","014","00","003","0307","0000","318","252","66","32","350","732","0","47.81","34.43"
"10","014","00","003","0307","0092","318","252","66","32","350","732","0","47.81","34.43"
"10","014","00","004","0000","0000","6971","5493","1478","819","7790","14976","17314","52.02","36.68"
"10","014","00","004","0401","0000","188","118","70","23","211","476","0","44.33","24.79"
"10","014","00","004","0401","0105","85","49","36","11","96","261","0","36.78","18.77"
"10","014","00","004","0401","0106","103","69","34","12","115","215","0","53.49","32.09"
"10","014","00","004","0402","0000","203","170","33","23","226","436","0","51.83","38.99"
"10","014","00","004","0402","0117","203","170","33","23","226","436","0","51.83","38.99"
"10","014","00","004","0403","0000","200","163","37","19","219","488","0","44.88","33.4"
"10","014","00","004","0403","0115","200","163","37","19","219","488","0","44.88","33.4"
"10","014","00","004","0404","0000","186","150","36","18","204","347","0","58.79","43.23"
"10","014","00","004","0404","0116","186","150","36","18","204","347","0","58.79","43.23"
"10","014","00","004","0405","0000","503","390","113","72","575","1163","0","49.44","33.53"
"10","014","00","004","0405","0103","307","233","74","39","346","727","0","47.59","32.05"
"10","014","00","004","0405","0104","196","157","39","33","229","436","0","52.52","36.01"
"10","014","00","004","0406","0000","539","440","99","61","600","1270","0","47.24","34.65"
"10","014","00","004","0406","0101","305","248","57","25","330","767","0","43.02","32.33"
"10","014","00","004","0406","0102","234","192","42","36","270","503","0","53.68","38.17"
"10","014","00","004","0407","0000","401","320","81","64","465","1066","0","43.62","30.02"
"10","014","00","004","0407","0098","76","56","20","20","96","219","0","43.84","25.57"
"10","014","00","004","0407","0099","185","152","33","29","214","460","0","46.52","33.04"
"10","014","00","004","0407","0100","140","112","28","15","155","387","0","40.05","28.94"
"10","014","00","004","0408","0000","1069","853","216","98","1167","2206","0","52.9","38.67"
"10","014","00","004","0408","0096","542","413","129","58","600","1041","0","57.64","39.67"
"10","014","00","004","0408","0097","527","440","87","40","567","1165","0","48.67","37.77"
"10","014","00","004","0409","0000","524","399","125","72","596","1110","0","53.69","35.95"
"10","014","00","004","0409","0110","524","399","125","72","596","1110","0","53.69","35.95"
"10","014","00","004","0410","0000","1514","1214","300","130","1644","3015","0","54.53","40.27"
"10","014","00","004","0410","0107","743","609","134","60","803","1442","0","55.69","42.23"
"10","014","00","004","0410","0108","250","208","42","12","262","527","0","49.72","39.47"
"10","014","00","004","0410","0109","521","397","124","58","579","1046","0","55.35","37.95"
"10","014","00","004","0411","0000","572","462","110","56","628","1105","0","56.83","41.81"
"10","014","00","004","0411","0111","572","462","110","56","628","1105","0","56.83","41.81"
"10","014","00","004","0412","0000","599","467","132","129","728","1167","0","62.38","40.02"
"10","014","00","004","0412","0112","599","467","132","129","728","1167","0","62.38","40.02"
"10","014","00","004","0413","0000","473","347","126","54","527","1127","0","46.76","30.79"
"10","014","00","004","0413","0113","418","305","113","52","470","968","0","48.55","31.51"
"10","014","00","004","0413","0114","55","42","13","2","57","159","0","35.85","26.42"
"10","014","00","005","0000","0000","2788","2114","674","299","3087","6936","7891","44.51","30.48"
"10","014","00","005","0501","0000","243","174","69","45","288","675","0","42.67","25.78"
"10","014","00","005","0501","0125","243","174","69","45","288","675","0","42.67","25.78"
"10","014","00","005","0502","0000","353","255","98","40","393","905","0","43.43","28.18"
"10","014","00","005","0502","0126","196","146","50","17","213","435","0","48.97","33.56"
"10","014","00","005","0502","0127","157","109","48","23","180","470","0","38.3","23.19"
"10","014","00","005","0503","0000","361","267","94","48","409","864","0","47.34","30.9"
"10","014","00","005","0503","0124","361","267","94","48","409","864","0","47.34","30.9"
"10","014","00","005","0504","0000","617","488","129","51","668","1446","0","46.2","33.75"
"10","014","00","005","0504","0121","477","373","104","37","514","1104","0","46.56","33.79"
"10","014","00","005","0504","0122","140","115","25","14","154","342","0","45.03","33.63"
"10","014","00","005","0505","0000","375","283","92","44","419","895","0","46.82","31.62"
"10","014","00","005","0505","0123","375","283","92","44","419","895","0","46.82","31.62"
"10","014","00","005","0506","0000","463","359","104","33","496","1096","0","45.26","32.76"
"10","014","00","005","0506","0118","181","146","35","8","189","522","0","36.21","27.97"
"10","014","00","005","0506","0119","282","213","69","25","307","574","0","53.48","37.11"
"10","014","00","005","0507","0000","376","288","88","38","414","1055","0","39.24","27.3"
"10","014","00","005","0507","0120","376","288","88","38","414","1055","0","39.24","27.3"
"10","014","00","006","0000","0000","2938","2353","585","311","3249","7162","8207","45.36","32.85"
"10","014","00","006","0601","0000","459","348","111","57","516","1137","0","45.38","30.61"
"10","014","00","006","0601","0130","186","145","41","24","210","434","0","48.39","33.41"
"10","014","00","006","0601","0131","273","203","70","33","306","703","0","43.53","28.88"
"10","014","00","006","0602","0000","241","201","40","20","261","654","0","39.91","30.73"
"10","014","00","006","0602","0132","241","201","40","20","261","654","0","39.91","30.73"
"10","014","00","006","0603","0000","113","86","27","15","128","324","0","39.51","26.54"
"10","014","00","006","0603","0133","113","86","27","15","128","324","0","39.51","26.54"
"10","014","00","006","0604","0000","322","245","77","36","358","794","0","45.09","30.86"
"10","014","00","006","0604","0134","322","245","77","36","358","794","0","45.09","30.86"
"10","014","00","006","0605","0000","896","740","156","75","971","1921","0","50.55","38.52"
"10","014","00","006","0605","0128","433","355","78","28","461","992","0","46.47","35.79"
"10","014","00","006","0605","0129","463","385","78","47","510","929","0","54.9","41.44"
"10","014","00","006","0606","0000","128","106","22","13","141","344","0","40.99","30.81"
"10","014","00","006","0606","0136","128","106","22","13","141","344","0","40.99","30.81"
"10","014","00","006","0607","0000","374","314","60","40","414","856","0","48.36","36.68"
"10","014","00","006","0607","0135","374","314","60","40","414","856","0","48.36","36.68"
"10","014","00","006","0608","0000","152","128","24","19","171","311","0","54.98","41.16"
"10","014","00","006","0608","0137","152","128","24","19","171","311","0","54.98","41.16"
"10","014","00","006","0609","0000","118","82","36","18","136","386","0","35.23","21.24"
"10","014","00","006","0609","0138","118","82","36","18","136","386","0","35.23","21.24"
"10","014","00","006","0610","0000","135","103","32","18","153","435","0","35.17","23.68"
"10","014","00","006","0610","0139","135","103","32","18","153","435","0","35.17","23.68"
"10","014","00","007","0000","0000","2785","2149","636","421","3206","7635","8518","41.99","28.15"
"10","014","00","007","0701","0000","457","351","106","68","525","1620","0","32.41","21.67"
"10","014","00","007","0701","0147","180","143","37","29","209","867","0","24.11","16.49"
"10","014","00","007","0701","0148","129","99","30","19","148","345","0","42.9","28.7"
"10","014","00","007","0701","0149","148","109","39","20","168","408","0","41.18","26.72"
"10","014","00","007","0702","0000","279","219","60","13","292","1197","0","24.39","18.3"
"10","014","00","007","0702","0146","279","219","60","13","292","1197","0","24.39","18.3"
"10","014","00","007","0703","0000","363","276","87","30","393","977","0","40.23","28.25"
"10","014","00","007","0703","0145","363","276","87","30","393","977","0","40.23","28.25"
"10","014","00","007","0704","0000","105","85","20","9","114","262","0","43.51","32.44"
"10","014","00","007","0704","0150","105","85","20","9","114","262","0","43.51","32.44"
"10","014","00","007","0705","0000","213","174","39","44","257","555","0","46.31","31.35"
"10","014","00","007","0705","0144","213","174","39","44","257","555","0","46.31","31.35"
"10","014","00","007","0706","0000","336","255","81","92","428","918","0","46.62","27.78"
"10","014","00","007","0706","0143","336","255","81","92","428","918","0","46.62","27.78"
"10","014","00","007","0707","0000","1032","789","243","165","1197","2106","0","56.84","37.46"
"10","014","00","007","0707","0140","99","79","20","23","122","290","0","42.07","27.24"
"10","014","00","007","0707","0141","298","241","57","38","336","620","0","54.19","38.87"
"10","014","00","007","0707","0142","635","469","166","104","739","1196","0","61.79","39.21"
"10","014","00","008","0000","0000","2182","1686","496","409","2591","6484","7196","39.96","26.0"
"10","014","00","008","0801","0000","201","158","43","62","263","630","0","41.75","25.08"
"10","014","00","008","0801","0160","11","10","1","2","13","25","0","52.0","40.0"
"10","014","00","008","0801","0161","190","148","42","60","250","605","0","41.32","24.46"
"10","014","00","008","0802","0000","329","261","68","79","408","1191","0","34.26","21.91"
"10","014","00","008","0802","0157","218","165","53","61","279","660","0","42.27","25.0"
"10","014","00","008","0802","0158","61","53","8","4","65","336","0","19.35","15.77"
"10","014","00","008","0802","0159","50","43","7","14","64","195","0","32.82","22.05"
"10","014","00","008","0803","0000","127","100","27","6","133","532","0","25.0","18.8"
"10","014","00","008","0803","0156","127","100","27","6","133","532","0","25.0","18.8"
"10","014","00","008","0804","0000","678","530","148","82","760","1993","0","38.13","26.59"
"10","014","00","008","0804","0154","401","336","65","24","425","1268","0","33.52","26.5"
"10","014","00","008","0804","0155","277","194","83","58","335","725","0","46.21","26.76"
"10","014","00","008","0805","0000","396","291","105","103","499","913","0","54.65","31.87"
"10","014","00","008","0805","0153","396","291","105","103","499","913","0","54.65","31.87"
"10","014","00","008","0806","0000","451","346","105","77","528","1225","0","43.1","28.24"
"10","014","00","008","0806","0151","260","189","71","49","309","536","0","57.65","35.26"
"10","014","00","008","0806","0152","191","157","34","28","219","689","0","31.79","22.79"
"10","014","00","009","0000","0000","4027","3129","898","521","4548","9666","11186","47.05","32.37"
"10","014","00","009","0901","0000","604","481","123","69","673","1297","0","51.89","37.09"
"10","014","00","009","0901","0162","336","272","64","48","384","722","0","53.19","37.67"
"10","014","00","009","0901","0163","268","209","59","21","289","575","0","50.26","36.35"
"10","014","00","009","0902","0000","278","210","68","32","310","623","0","49.76","33.71"
"10","014","00","009","0902","0164","278","210","68","32","310","623","0","49.76","33.71"
"10","014","00","009","0903","0000","243","187","56","51","294","622","0","47.27","30.06"
"10","014","00","009","0903","0165","243","187","56","51","294","622","0","47.27","30.06"
"10","014","00","009","0904","0000","194","159","35","13","207","560","0","36.96","28.39"
"10","014","00","009","0904","0166","194","159","35","13","207","560","0","36.96","28.39"
"10","014","00","009","0905","0000","701","555","146","92","793","1410","0","56.24","39.36"
"10","014","00","009","0905","0169","371","290","81","43","414","673","0","61.52","43.09"
"10","014","00","009","0905","0170","330","265","65","49","379","737","0","51.42","35.96"
"10","014","00","009","0906","0000","746","562","184","136","882","1766","0","49.94","31.82"
"10","014","00","009","0906","0167","425","336","89","100","525","957","0","54.86","35.11"
"10","014","00","009","0906","0168","321","226","95","36","357","809","0","44.13","27.94"
"10","014","00","009","0907","0000","363","255","108","54","417","798","0","52.26","31.95"
"10","014","00","009","0907","0171","206","151","55","32","238","424","0","56.13","35.61"
"10","014","00","009","0907","0172","157","104","53","22","179","374","0","47.86","27.81"
"10","014","00","009","0908","0000","520","414","106","26","546","1698","0","32.16","24.38"
"10","014","00","009","0908","0173","257","202","55","20","277","829","0","33.41","24.37"
"10","014","00","009","0908","0174","263","212","51","6","269","869","0","30.96","24.4"
"10","014","00","009","0909","0000","378","306","72","48","426","892","0","47.76","34.3"
"10","014","00","009","0909","0175","60","47","13","4","64","223","0","28.7","21.08"
"10","014","00","009","0909","0176","318","259","59","44","362","669","0","54.11","38.71"
"10","014","00","010","0000","0000","2143","1658","485","528","2671","5266","6100","50.72","31.48"
"10","014","00","010","1001","0000","289","219","70","91","380","763","0","49.8","28.7"
"10","014","00","010","1001","0181","152","118","34","61","213","386","0","55.18","30.57"
"10","014","00","010","1001","0182","137","101","36","30","167","377","0","44.3","26.79"
"10","014","00","010","1002","0000","423","319","104","110","533","1134","0","47.0","28.13"
"10","014","00","010","1002","0180","423","319","104","110","533","1134","0","47.0","28.13"
"10","014","00","010","1003","0000","596","466","130","110","706","1327","0","53.2","35.12"
"10","014","00","010","1003","0179","596","466","130","110","706","1327","0","53.2","35.12"
"10","014","00","010","1004","0000","569","445","124","151","720","1474","0","48.85","30.19"
"10","014","00","010","1004","0178","569","445","124","151","720","1474","0","48.85","30.19"
"10","014","00","010","1005","0000","266","209","57","66","332","568","0","58.45","36.8"
"10","014","00","010","1005","0177","266","209","57","66","332","568","0","58.45","36.8"
"10","014","00","011","0000","0000","1459","1183","276","90","1549","3579","4097","43.28","33.05"
"10","014","00","011","1101","0000","451","352","99","26","477","1023","0","46.63","34.41"
"10","014","00","011","1101","0185","358","282","76","23","381","813","0","46.86","34.69"
"10","014","00","011","1101","0186","93","70","23","3","96","210","0","45.71","33.33"
"10","014","00","011","1102","0000","439","361","78","34","473","1082","0","43.72","33.36"
"10","014","00","011","1102","0184","439","361","78","34","473","1082","0","43.72","33.36"
"10","014","00","011","1103","0000","569","470","99","30","599","1474","0","40.64","31.89"
"10","014","00","011","1103","0183","569","470","99","30","599","1474","0","40.64","31.89"
"10","014","00","012","0000","0000","1534","1151","383","197","1731","3278","4207","52.81","35.11"
"10","014","00","012","1201","0000","353","270","83","40","393","728","0","53.98","37.09"
"10","014","00","012","1201","0190","353","270","83","40","393","728","0","53.98","37.09"
"10","014","00","012","1202","0000","124","91","33","16","140","259","0","54.05","35.14"
"10","014","00","012","1202","0191","124","91","33","16","140","259","0","54.05","35.14"
"10","014","00","012","1203","0000","114","81","33","12","126","254","0","49.61","31.89"
"10","014","00","012","1203","0192","114","81","33","12","126","254","0","49.61","31.89"
"10","014","00","012","1204","0000","421","318","103","58","479","971","0","49.33","32.75"
"10","014","00","012","1204","0189","421","318","103","58","479","971","0","49.33","32.75"
"10","014","00","012","1205","0000","295","222","73","35","330","569","0","58.0","39.02"
"10","014","00","012","1205","0188","295","222","73","35","330","569","0","58.0","39.02"
"10","014","00","012","1206","0000","227","169","58","36","263","497","0","52.92","34.0"
"10","014","00","012","1206","0187","227","169","58","36","263","497","0","52.92","34.0"
"10","014","00","013","0000","0000","1319","1008","311","190","1509","2930","3656","51.5","34.4"
"10","014","00","013","1301","0000","215","160","55","15","230","579","0","39.72","27.63"
"10","014","00","013","1301","0196","215","160","55","15","230","579","0","39.72","27.63"
"10","014","00","013","1302","0000","183","148","35","24","207","315","0","65.71","46.98"
"10","014","00","013","1302","0195","183","148","35","24","207","315","0","65.71","46.98"
"10","014","00","013","1303","0000","230","169","61","66","296","426","0","69.48","39.67"
"10","014","00","013","1303","0194","230","169","61","66","296","426","0","69.48","39.67"
"10","014","00","013","1304","0000","248","189","59","26","274","596","0","45.97","31.71"
"10","014","00","013","1304","0197","248","189","59","26","274","596","0","45.97","31.71"
"10","014","00","013","1305","0000","443","342","101","59","502","1014","0","49.51","33.73"
"10","014","00","013","1305","0193","443","342","101","59","502","1014","0","49.51","33.73"
"10","014","00","014","0000","0000","1408","1090","318","205","1613","3028","3748","53.27","36.0"
"10","014","00","014","1401","0000","341","266","75","52","393","520","0","75.58","51.15"
"10","014","00","014","1401","0200","341","266","75","52","393","520","0","75.58","51.15"
"10","014","00","014","1402","0000","310","251","59","34","344","601","0","57.24","41.76"
"10","014","00","014","1402","0199","310","251","59","34","344","601","0","57.24","41.76"
"10","014","00","014","1403","0000","473","355","118","62","535","1241","0","43.11","28.61"
"10","014","00","014","1403","0198","473","355","118","62","535","1241","0","43.11","28.61"
"10","014","00","014","1404","0000","162","127","35","27","189","336","0","56.25","37.8"
"10","014","00","014","1404","0201","162","127","35","27","189","336","0","56.25","37.8"
"10","014","00","014","1405","0000","122","91","31","30","152","330","0","46.06","27.58"
"10","014","00","014","1405","0202","122","91","31","30","152","330","0","46.06","27.58"
"10","014","00","015","0000","0000","1577","1240","337","188","1765","3137","3615","56.26","39.53"
"10","014","00","015","1501","0000","234","167","67","23","257","628","0","40.92","26.59"
"10","014","00","015","1501","0208","234","167","67","23","257","628","0","40.92","26.59"
"10","014","00","015","1502","0000","416","324","92","50","466","867","0","53.75","37.37"
"10","014","00","015","1502","0209","416","324","92","50","466","867","0","53.75","37.37"
"10","014","00","015","1503","0000","184","144","40","27","211","331","0","63.75","43.5"
"10","014","00","015","1503","0207","184","144","40","27","211","331","0","63.75","43.5"
"10","014","00","015","1504","0000","335","279","56","37","372","586","0","63.48","47.61"
"10","014","00","015","1504","0203","128","101","27","26","154","246","0","62.6","41.06"
"10","014","00","015","1504","0204","207","178","29","11","218","340","0","64.12","52.35"
"10","014","00","015","1505","0000","227","188","39","37","264","429","0","61.54","43.82"
"10","014","00","015","1505","0206","227","188","39","37","264","429","0","61.54","43.82"
"10","014","00","015","1506","0000","181","138","43","14","195","296","0","65.88","46.62"
"10","014","00","015","1506","0205","181","138","43","14","195","296","0","65.88","46.62"
"10","014","00","016","0000","0000","1404","1020","384","113","1517","4181","5114","36.28","24.4"
"10","014","00","016","1601","0000","340","223","117","21","361","1240","0","29.11","17.98"
"10","014","00","016","1601","0212","340","223","117","21","361","1240","0","29.11","17.98"
"10","014","00","016","1602","0000","239","173","66","40","279","760","0","36.71","22.76"
"10","014","00","016","1602","0213","239","173","66","40","279","760","0","36.71","22.76"
"10","014","00","016","1603","0000","486","372","114","23","509","1238","0","41.11","30.05"
"10","014","00","016","1603","0211","486","372","114","23","509","1238","0","41.11","30.05"
"10","014","00","016","1604","0000","339","252","87","29","368","943","0","39.02","26.72"
"10","014","00","016","1604","0210","339","252","87","29","368","943","0","39.02","26.72"
"10","016","00","000","0000","0000","36625","29508","7117","3289","39914","90405","104400","44.15","32.64"
"10","016","00","001","0000","0000","24016","19408","4608","1799","25815","53655","62523","48.11","36.17"
"10","016","00","001","0102","0000","211","161","50","13","224","481","0","46.57","33.47"
"10","016","00","001","0102","0001","211","161","50","13","224","481","0","46.57","33.47"
"10","016","00","001","0103","0000","263","219","44","19","282","558","0","50.54","39.25"
"10","016","00","001","0103","0002","263","219","44","19","282","558","0","50.54","39.25"
"10","016","00","001","0104","0000","218","175","43","45","263","533","0","49.34","32.83"
"10","016","00","001","0104","0003","218","175","43","45","263","533","0","49.34","32.83"
"10","016","00","001","0105","0000","416","318","98","31","447","922","0","48.48","34.49"
"10","016","00","001","0105","0004","416","318","98","31","447","922","0","48.48","34.49"
"10","016","00","001","0106","0000","499","392","107","37","536","1021","0","52.5","38.39"
"10","016","00","001","0106","0005","499","392","107","37","536","1021","0","52.5","38.39"
"10","016","00","001","0107","0000","370","289","81","32","402","793","0","50.69","36.44"
"10","016","00","001","0107","0006","370","289","81","32","402","793","0","50.69","36.44"
"10","016","00","001","0108","0000","921","699","222","77","998","1955","0","51.05","35.75"
"10","016","00","001","0108","0007","461","371","90","47","508","954","0","53.25","38.89"
"10","016","00","001","0108","0008","460","328","132","30","490","1001","0","48.95","32.77"
"10","016","00","001","0109","0000","1930","1588","342","106","2036","4130","0","49.3","38.45"
"10","016","00","001","0109","0010","615","502","113","41","656","1402","0","46.79","35.81"
"10","016","00","001","0109","0011","665","563","102","27","692","1389","0","49.82","40.53"
"10","016","00","001","0109","0012","650","523","127","38","688","1339","0","51.38","39.06"
"10","016","00","001","0110","0000","490","393","97","38","528","1192","0","44.3","32.97"
"10","016","00","001","0110","0009","490","393","97","38","528","1192","0","44.3","32.97"
"10","016","00","001","0111","0000","2411","1915","496","188","2599","5281","0","49.21","36.26"
"10","016","00","001","0111","0013","537","422","115","44","581","1254","0","46.33","33.65"
"10","016","00","001","0111","0014","548","439","109","51","599","1194","0","50.17","36.77"
"10","016","00","001","0111","0015","620","484","136","52","672","1393","0","48.24","34.75"
"10","016","00","001","0111","0016","706","570","136","41","747","1440","0","51.88","39.58"
"10","016","00","001","0112","0000","1114","916","198","107","1221","2499","0","48.86","36.65"
"10","016","00","001","0112","0017","534","423","111","56","590","1215","0","48.56","34.81"
"10","016","00","001","0112","0018","580","493","87","51","631","1284","0","49.14","38.4"
"10","016","00","001","0113","0000","700","562","138","51","751","1512","0","49.67","37.17"
"10","016","00","001","0113","0019","700","562","138","51","751","1512","0","49.67","37.17"
"10","016","00","001","0114","0000","2722","2163","559","167","2889","6044","0","47.8","35.79"
"10","016","00","001","0114","0020","507","413","94","64","571","1181","0","48.35","34.97"
"10","016","00","001","0114","0021","623","506","117","44","667","1348","0","49.48","37.54"
"10","016","00","001","0114","0022","684","557","127","29","713","1391","0","51.26","40.04"
"10","016","00","001","0114","0023","908","687","221","30","938","2124","0","44.16","32.34"
"10","016","00","001","0115","0000","1413","1177","236","101","1514","3082","0","49.12","38.19"
"10","016","00","001","0115","0024","673","555","118","66","739","1500","0","49.27","37.0"
"10","016","00","001","0115","0025","740","622","118","35","775","1582","0","48.99","39.32"
"10","016","00","001","0116","0000","1520","1229","291","82","1602","3192","0","50.19","38.5"
"10","016","00","001","0116","0026","761","615","146","35","796","1638","0","48.6","37.55"
"10","016","00","001","0116","0027","759","614","145","47","806","1554","0","51.87","39.51"
"10","016","00","001","0117","0000","765","625","140","55","820","1872","0","43.8","33.39"
"10","016","00","001","0117","0028","349","290","59","26","375","980","0","38.27","29.59"
"10","016","00","001","0117","0029","416","335","81","29","445","892","0","49.89","37.56"
"10","016","00","001","0118","0000","307","263","44","14","321","778","0","41.26","33.8"
"10","016","00","001","0118","0030","307","263","44","14","321","778","0","41.26","33.8"
"10","016","00","001","0119","0000","434","364","70","35","469","930","0","50.43","39.14"
"10","016","00","001","0119","0031","434","364","70","35","469","930","0","50.43","39.14"
"10","016","00","001","0120","0000","1388","1172","216","58","1446","2609","0","55.42","44.92"
"10","016","00","001","0120","0032","813","676","137","42","855","1481","0","57.73","45.64"
"10","016","00","001","0120","0033","575","496","79","16","591","1128","0","52.39","43.97"
"10","016","00","001","0121","0000","193","159","34","23","216","415","0","52.05","38.31"
"10","016","00","001","0121","0034","193","159","34","23","216","415","0","52.05","38.31"
"10","016","00","001","0122","0000","1009","847","162","62","1071","2070","0","51.74","40.92"
"10","016","00","001","0122","0035","517","441","76","40","557","1120","0","49.73","39.38"
"10","016","00","001","0122","0036","492","406","86","22","514","950","0","54.11","42.74"
"10","016","00","001","0123","0000","255","210","45","25","280","627","0","44.66","33.49"
"10","016","00","001","0123","0037","255","210","45","25","280","627","0","44.66","33.49"
"10","016","00","001","0124","0000","474","389","85","40","514","989","0","51.97","39.33"
"10","016","00","001","0124","0039","474","389","85","40","514","989","0","51.97","39.33"
"10","016","00","001","0125","0000","487","400","87","24","511","1055","0","48.44","37.91"
"10","016","00","001","0125","0038","487","400","87","24","511","1055","0","48.44","37.91"
"10","016","00","001","0126","0000","297","237","60","32","329","591","0","55.67","40.1"
"10","016","00","001","0126","0040","297","237","60","32","329","591","0","55.67","40.1"
"10","016","00","001","0127","0000","713","593","120","63","776","1700","0","45.65","34.88"
"10","016","00","001","0127","0043","356","292","64","41","397","797","0","49.81","36.64"
"10","016","00","001","0127","0044","357","301","56","22","379","903","0","41.97","33.33"
"10","016","00","001","0128","0000","1015","780","235","114","1129","2466","0","45.78","31.63"
"10","016","00","001","0128","0041","595","457","138","62","657","1387","0","47.37","32.95"
"10","016","00","001","0128","0042","420","323","97","52","472","1079","0","43.74","29.94"
"10","016","00","001","0129","0000","152","120","32","22","174","376","0","46.28","31.91"
"10","016","00","001","0129","0045","152","120","32","22","174","376","0","46.28","31.91"
"10","016","00","001","0130","0000","174","137","37","20","194","371","0","52.29","36.93"
"10","016","00","001","0130","0046","174","137","37","20","194","371","0","52.29","36.93"
"10","016","00","001","0131","0000","423","346","77","17","440","1173","0","37.51","29.5"
"10","016","00","001","0131","0047","423","346","77","17","440","1173","0","37.51","29.5"
"10","016","00","001","0132","0000","420","331","89","24","444","1389","0","31.97","23.83"
"10","016","00","001","0132","0048","420","331","89","24","444","1389","0","31.97","23.83"
"10","016","00","001","0133","0000","158","117","41","55","213","761","0","27.99","15.37"
"10","016","00","001","0133","0049","158","117","41","55","213","761","0","27.99","15.37"
"10","016","00","001","0134","0000","154","122","32","22","176","288","0","61.11","42.36"
"10","016","00","001","0134","0050","154","122","32","22","176","288","0","61.11","42.36"
"10","016","00","002","0000","0000","4886","3956","930","459","5345","12741","14533","41.95","31.05"
"10","016","00","002","0201","0000","514","441","73","58","572","1120","0","51.07","39.38"
"10","016","00","002","0201","0051","514","441","73","58","572","1120","0","51.07","39.38"
"10","016","00","002","0202","0000","128","94","34","12","140","332","0","42.17","28.31"
"10","016","00","002","0202","0052","128","94","34","12","140","332","0","42.17","28.31"
"10","016","00","002","0203","0000","84","66","18","4","88","242","0","36.36","27.27"
"10","016","00","002","0203","0053","84","66","18","4","88","242","0","36.36","27.27"
"10","016","00","002","0204","0000","92","71","21","7","99","293","0","33.79","24.23"
"10","016","00","002","0204","0054","92","71","21","7","99","293","0","33.79","24.23"
"10","016","00","002","0205","0000","226","181","45","48","274","666","0","41.14","27.18"
"10","016","00","002","0205","0055","226","181","45","48","274","666","0","41.14","27.18"
"10","016","00","002","0206","0000","137","114","23","25","162","326","0","49.69","34.97"
"10","016","00","002","0206","0056","137","114","23","25","162","326","0","49.69","34.97"
"10","016","00","002","0207","0000","249","211","38","16","265","732","0","36.2","28.83"
"10","016","00","002","0207","0057","249","211","38","16","265","732","0","36.2","28.83"
"10","016","00","002","0208","0000","274","233","41","23","297","651","0","45.62","35.79"
"10","016","00","002","0208","0058","274","233","41","23","297","651","0","45.62","35.79"
"10","016","00","002","0209","0000","294","241","53","13","307","744","0","41.26","32.39"
"10","016","00","002","0209","0059","294","241","53","13","307","744","0","41.26","32.39"
"10","016","00","002","0210","0000","70","53","17","4","74","134","0","55.22","39.55"
"10","016","00","002","0210","0060","70","53","17","4","74","134","0","55.22","39.55"
"10","016","00","002","0211","0000","77","67","10","2","79","216","0","36.57","31.02"
"10","016","00","002","0211","0062","77","67","10","2","79","216","0","36.57","31.02"
"10","016","00","002","0212","0000","124","103","21","6","130","279","0","46.59","36.92"
"10","016","00","002","0212","0064","124","103","21","6","130","279","0","46.59","36.92"
"10","016","00","002","0213","0000","186","145","41","7","193","664","0","29.07","21.84"
"10","016","00","002","0213","0063","186","145","41","7","193","664","0","29.07","21.84"
"10","016","00","002","0214","0000","138","119","19","7","145","296","0","48.99","40.2"
"10","016","00","002","0214","0065","138","119","19","7","145","296","0","48.99","40.2"
"10","016","00","002","0215","0000","240","204","36","18","258","794","0","32.49","25.69"
"10","016","00","002","0215","0061","240","204","36","18","258","794","0","32.49","25.69"
"10","016","00","002","0216","0000","114","102","12","4","118","257","0","45.91","39.69"
"10","016","00","002","0216","0066","114","102","12","4","118","257","0","45.91","39.69"
"10","016","00","002","0217","0000","26","20","6","1","27","89","0","30.34","22.47"
"10","016","00","002","0217","0067","26","20","6","1","27","89","0","30.34","22.47"
"10","016","00","002","0218","0000","354","266","88","28","382","815","0","46.87","32.64"
"10","016","00","002","0218","0068","354","266","88","28","382","815","0","46.87","32.64"
"10","016","00","002","0219","0000","358","303","55","20","378","975","0","38.77","31.08"
"10","016","00","002","0219","0069","358","303","55","20","378","975","0","38.77","31.08"
"10","016","00","002","0220","0000","280","209","71","34","314","648","0","48.46","32.25"
"10","016","00","002","0220","0070","280","209","71","34","314","648","0","48.46","32.25"
"10","016","00","002","0221","0000","684","525","159","109","793","1739","0","45.6","30.19"
"10","016","00","002","0221","0071","328","257","71","27","355","893","0","39.75","28.78"
"10","016","00","002","0221","0072","356","268","88","82","438","846","0","51.77","31.68"
"10","016","00","002","0222","0000","237","188","49","13","250","729","0","34.29","25.79"
"10","016","00","002","0222","0073","237","188","49","13","250","729","0","34.29","25.79"
"10","016","00","003","0000","0000","3223","2535","688","366","3589","8625","9856","41.61","29.39"
"10","016","00","003","0301","0000","238","174","64","17","255","514","0","49.61","33.85"
"10","016","00","003","0301","0074","238","174","64","17","255","514","0","49.61","33.85"
"10","016","00","003","0302","0000","305","254","51","22","327","657","0","49.77","38.66"
"10","016","00","003","0302","0075","305","254","51","22","327","657","0","49.77","38.66"
"10","016","00","003","0303","0000","68","60","8","4","72","109","0","66.06","55.05"
"10","016","00","003","0303","0076","68","60","8","4","72","109","0","66.06","55.05"
"10","016","00","003","0304","0000","60","51","9","5","65","156","0","41.67","32.69"
"10","016","00","003","0304","0077","60","51","9","5","65","156","0","41.67","32.69"
"10","016","00","003","0305","0000","113","86","27","7","120","293","0","40.96","29.35"
"10","016","00","003","0305","0078","113","86","27","7","120","293","0","40.96","29.35"
"10","016","00","003","0306","0000","67","53","14","1","68","231","0","29.44","22.94"
"10","016","00","003","0306","0079","67","53","14","1","68","231","0","29.44","22.94"
"10","016","00","003","0307","0000","76","57","19","10","86","161","0","53.42","35.4"
"10","016","00","003","0307","0080","76","57","19","10","86","161","0","53.42","35.4"
"10","016","00","003","0308","0000","726","568","158","56","782","1705","0","45.87","33.31"
"10","016","00","003","0308","0081","726","568","158","56","782","1705","0","45.87","33.31"
"10","016","00","003","0309","0000","111","89","22","10","121","285","0","42.46","31.23"
"10","016","00","003","0309","0082","111","89","22","10","121","285","0","42.46","31.23"
"10","016","00","003","0310","0000","203","156","47","8","211","723","0","29.18","21.58"
"10","016","00","003","0310","0083","203","156","47","8","211","723","0","29.18","21.58"
"10","016","00","003","0311","0000","255","201","54","30","285","774","0","36.82","25.97"
"10","016","00","003","0311","0084","255","201","54","30","285","774","0","36.82","25.97"
"10","016","00","003","0312","0000","378","276","102","108","486","1429","0","34.01","19.31"
"10","016","00","003","0312","0085","378","276","102","108","486","1429","0","34.01","19.31"
"10","016","00","003","0313","0000","431","360","71","67","498","1084","0","45.94","33.21"
"10","016","00","003","0313","0086","431","360","71","67","498","1084","0","45.94","33.21"
"10","016","00","003","0314","0000","120","100","20","5","125","251","0","49.8","39.84"
"10","016","00","003","0314","0087","120","100","20","5","125","251","0","49.8","39.84"
"10","016","00","003","0315","0000","72","50","22","16","88","253","0","34.78","19.76"
"10","016","00","003","0315","0088","72","50","22","16","88","253","0","34.78","19.76"
"10","016","00","004","0000","0000","2050","1641","409","367","2417","7382","8396","32.74","22.23"
"10","016","00","004","0401","0000","40","32","8","1","41","283","0","14.49","11.31"
"10","016","00","004","0401","0089","40","32","8","1","41","283","0","14.49","11.31"
"10","016","00","004","0402","0000","102","86","16","19","121","424","0","28.54","20.28"
"10","016","00","004","0402","0090","102","86","16","19","121","424","0","28.54","20.28"
"10","016","00","004","0403","0000","94","73","21","9","103","282","0","36.52","25.89"
"10","016","00","004","0403","0092","94","73","21","9","103","282","0","36.52","25.89"
"10","016","00","004","0404","0000","228","178","50","56","284","826","0","34.38","21.55"
"10","016","00","004","0404","0091","228","178","50","56","284","826","0","34.38","21.55"
"10","016","00","004","0405","0000","205","163","42","47","252","661","0","38.12","24.66"
"10","016","00","004","0405","0093","205","163","42","47","252","661","0","38.12","24.66"
"10","016","00","004","0406","0000","22","14","8","5","27","141","0","19.15","9.93"
"10","016","00","004","0406","0094","22","14","8","5","27","141","0","19.15","9.93"
"10","016","00","004","0407","0000","166","142","24","8","174","635","0","27.4","22.36"
"10","016","00","004","0407","0095","166","142","24","8","174","635","0","27.4","22.36"
"10","016","00","004","0408","0000","61","46","15","5","66","216","0","30.56","21.3"
"10","016","00","004","0408","0096","61","46","15","5","66","216","0","30.56","21.3"
"10","016","00","004","0409","0000","106","83","23","23","129","572","0","22.55","14.51"
"10","016","00","004","0409","0097","106","83","23","23","129","572","0","22.55","14.51"
"10","016","00","004","0410","0000","402","322","80","94","496","1267","0","39.15","25.41"
"10","016","00","004","0410","0098","402","322","80","94","496","1267","0","39.15","25.41"
"10","016","00","004","0411","0000","624","502","122","100","724","2075","0","34.89","24.19"
"10","016","00","004","0411","0099","268","228","40","28","296","942","0","31.42","24.2"
"10","016","00","004","0411","0100","356","274","82","72","428","1133","0","37.78","24.18"
"10","016","00","005","0000","0000","1558","1256","302","196","1754","4628","5237","37.9","27.14"
"10","016","00","005","0501","0000","298","248","50","29","327","734","0","44.55","33.79"
"10","016","00","005","0501","0101","298","248","50","29","327","734","0","44.55","33.79"
"10","016","00","005","0502","0000","166","144","22","24","190","454","0","41.85","31.72"
"10","016","00","005","0502","0102","166","144","22","24","190","454","0","41.85","31.72"
"10","016","00","005","0503","0000","81","62","19","11","92","300","0","30.67","20.67"
"10","016","00","005","0503","0103","81","62","19","11","92","300","0","30.67","20.67"
"10","016","00","005","0504","0000","200","164","36","37","237","471","0","50.32","34.82"
"10","016","00","005","0504","0104","200","164","36","37","237","471","0","50.32","34.82"
"10","016","00","005","0505","0000","436","340","96","64","500","1414","0","35.36","24.05"
"10","016","00","005","0505","0105","183","158","25","19","202","672","0","30.06","23.51"
"10","016","00","005","0505","0106","253","182","71","45","298","742","0","40.16","24.53"
"10","016","00","005","0506","0000","162","130","32","7","169","476","0","35.5","27.31"
"10","016","00","005","0506","0108","162","130","32","7","169","476","0","35.5","27.31"
"10","016","00","005","0507","0000","36","25","11","4","40","208","0","19.23","12.02"
"10","016","00","005","0507","0109","36","25","11","4","40","208","0","19.23","12.02"
"10","016","00","005","0508","0000","93","77","16","15","108","264","0","40.91","29.17"
"10","016","00","005","0508","0107","93","77","16","15","108","264","0","40.91","29.17"
"10","016","00","005","0509","0000","86","66","20","5","91","307","0","29.64","21.5"
"10","016","00","005","0509","0110","86","66","20","5","91","307","0","29.64","21.5"
"10","016","00","006","0000","0000","892","712","180","102","994","3374","3855","29.46","21.1"
"10","016","00","006","0601","0000","62","48","14","5","67","248","0","27.02","19.35"
"10","016","00","006","0601","0111","62","48","14","5","67","248","0","27.02","19.35"
"10","016","00","006","0602","0000","172","143","29","32","204","581","0","35.11","24.61"
"10","016","00","006","0602","0112","172","143","29","32","204","581","0","35.11","24.61"
"10","016","00","006","0603","0000","193","142","51","30","223","641","0","34.79","22.15"
"10","016","00","006","0603","0113","193","142","51","30","223","641","0","34.79","22.15"
"10","016","00","006","0604","0000","111","85","26","2","113","382","0","29.58","22.25"
"10","016","00","006","0604","0114","111","85","26","2","113","382","0","29.58","22.25"
"10","016","00","006","0605","0000","66","55","11","6","72","351","0","20.51","15.67"
"10","016","00","006","0605","0115","66","55","11","6","72","351","0","20.51","15.67"
"10","016","00","006","0606","0000","288","239","49","27","315","1171","0","26.9","20.41"
"10","016","00","006","0606","0116","288","239","49","27","315","1171","0","26.9","20.41"
"10","017","00","000","0000","0000","153577","121863","31714","9450","163027","320030","370269","50.94","38.08"
"10","017","00","001","0000","0000","19823","15640","4183","1380","21203","45545","51716","46.55","34.34"
"10","017","00","001","0101","0000","405","301","104","34","439","709","0","61.92","42.45"
"10","017","00","001","0101","0035","405","301","104","34","439","709","0","61.92","42.45"
"10","017","00","001","0102","0000","582","462","120","52","634","1219","0","52.01","37.9"
"10","017","00","001","0102","0033","582","462","120","52","634","1219","0","52.01","37.9"
"10","017","00","001","0103","0000","417","318","99","17","434","904","0","48.01","35.18"
"10","017","00","001","0103","0034","417","318","99","17","434","904","0","48.01","35.18"
"10","017","00","001","0104","0000","486","358","128","53","539","1037","0","51.98","34.52"
"10","017","00","001","0104","0032","486","358","128","53","539","1037","0","51.98","34.52"
"10","017","00","001","0105","0000","626","504","122","51","677","1210","0","55.95","41.65"
"10","017","00","001","0105","0031","626","504","122","51","677","1210","0","55.95","41.65"
"10","017","00","001","0106","0000","558","429","129","61","619","1175","0","52.68","36.51"
"10","017","00","001","0106","0030","558","429","129","61","619","1175","0","52.68","36.51"
"10","017","00","001","0107","0000","569","442","127","48","617","1267","0","48.7","34.89"
"10","017","00","001","0107","0029","569","442","127","48","617","1267","0","48.7","34.89"
"10","017","00","001","0108","0000","387","299","88","40","427","802","0","53.24","37.28"
"10","017","00","001","0108","0028","387","299","88","40","427","802","0","53.24","37.28"
"10","017","00","001","0109","0000","588","469","119","62","650","1594","0","40.78","29.42"
"10","017","00","001","0109","0027","588","469","119","62","650","1594","0","40.78","29.42"
"10","017","00","001","0110","0000","1061","850","211","71","1132","2316","0","48.88","36.7"
"10","017","00","001","0110","0025","424","340","84","46","470","859","0","54.71","39.58"
"10","017","00","001","0110","0026","637","510","127","25","662","1457","0","45.44","35.0"
"10","017","00","001","0111","0000","671","538","133","61","732","1341","0","54.59","40.12"
"10","017","00","001","0111","0024","671","538","133","61","732","1341","0","54.59","40.12"
"10","017","00","001","0112","0000","928","741","187","80","1008","2000","0","50.4","37.05"
"10","017","00","001","0112","0022","533","426","107","38","571","1138","0","50.18","37.43"
"10","017","00","001","0112","0023","395","315","80","42","437","862","0","50.7","36.54"
"10","017","00","001","0113","0000","974","777","197","41","1015","1960","0","51.79","39.64"
"10","017","00","001","0113","0020","545","438","107","23","568","1090","0","52.11","40.18"
"10","017","00","001","0113","0021","429","339","90","18","447","870","0","51.38","38.97"
"10","017","00","001","0114","0000","602","465","137","30","632","1270","0","49.76","36.61"
"10","017","00","001","0114","0019","602","465","137","30","632","1270","0","49.76","36.61"
"10","017","00","001","0115","0000","477","395","82","28","505","1166","0","43.31","33.88"
"10","017","00","001","0115","0016","477","395","82","28","505","1166","0","43.31","33.88"
"10","017","00","001","0116","0000","800","595","205","71","871","1753","0","49.69","33.94"
"10","017","00","001","0116","0014","800","595","205","71","871","1753","0","49.69","33.94"
"10","017","00","001","0117","0000","404","308","96","38","442","984","0","44.92","31.3"
"10","017","00","001","0117","0015","404","308","96","38","442","984","0","44.92","31.3"
"10","017","00","001","0118","0000","523","400","123","67","590","1261","0","46.79","31.72"
"10","017","00","001","0118","0013","523","400","123","67","590","1261","0","46.79","31.72"
"10","017","00","001","0119","0000","582","430","152","46","628","1474","0","42.61","29.17"
"10","017","00","001","0119","0005","582","430","152","46","628","1474","0","42.61","29.17"
"10","017","00","001","0120","0000","491","390","101","59","550","1271","0","43.27","30.68"
"10","017","00","001","0120","0006","491","390","101","59","550","1271","0","43.27","30.68"
"10","017","00","001","0121","0000","230","180","50","16","246","466","0","52.79","38.63"
"10","017","00","001","0121","0001","230","180","50","16","246","466","0","52.79","38.63"
"10","017","00","001","0122","0000","2020","1601","419","110","2130","5256","0","40.53","30.46"
"10","017","00","001","0122","0002","503","390","113","19","522","1262","0","41.36","30.9"
"10","017","00","001","0122","0003","492","364","128","63","555","1171","0","47.4","31.08"
"10","017","00","001","0122","0004","1025","847","178","28","1053","2823","0","37.3","30.0"
"10","017","00","001","0123","0000","593","460","133","22","615","1694","0","36.3","27.15"
"10","017","00","001","0123","0018","593","460","133","22","615","1694","0","36.3","27.15"
"10","017","00","001","0124","0000","436","338","98","31","467","973","0","48.0","34.74"
"10","017","00","001","0124","0017","436","338","98","31","467","973","0","48.0","34.74"
"10","017","00","001","0125","0000","2356","1935","421","67","2423","5430","0","44.62","35.64"
"10","017","00","001","0125","0010","628","509","119","13","641","1352","0","47.41","37.65"
"10","017","00","001","0125","0011","626","523","103","13","639","1413","0","45.22","37.01"
"10","017","00","001","0125","0012","1102","903","199","41","1143","2665","0","42.89","33.88"
"10","017","00","001","0126","0000","2057","1655","402","124","2181","5013","0","43.51","33.01"
"10","017","00","001","0126","0007","1090","862","228","70","1160","2707","0","42.85","31.84"
"10","017","00","001","0126","0008","711","570","141","39","750","1545","0","48.54","36.89"
"10","017","00","001","0126","0009","256","223","33","15","271","761","0","35.61","29.3"
"10","017","00","002","0000","0000","22678","17808","4870","1506","24184","46256","53819","52.28","38.5"
"10","017","00","002","0201","0000","1932","1516","416","118","2050","3754","0","54.61","40.38"
"10","017","00","002","0201","0219","661","504","157","60","721","1258","0","57.31","40.06"
"10","017","00","002","0201","0220","644","501","143","41","685","1237","0","55.38","40.5"
"10","017","00","002","0201","0221","627","511","116","17","644","1259","0","51.15","40.59"
"10","017","00","002","0202","0000","1094","859","235","100","1194","2464","0","48.46","34.86"
"10","017","00","002","0202","0222","509","390","119","46","555","1120","0","49.55","34.82"
"10","017","00","002","0202","0223","585","469","116","54","639","1344","0","47.54","34.9"
"10","017","00","002","0203","0000","1882","1479","403","121","2003","3568","0","56.14","41.45"
"10","017","00","002","0203","0226","909","723","186","61","970","1735","0","55.91","41.67"
"10","017","00","002","0203","0227","973","756","217","60","1033","1833","0","56.36","41.24"
"10","017","00","002","0204","0000","984","773","211","76","1060","1900","0","55.79","40.68"
"10","017","00","002","0204","0228","462","356","106","26","488","938","0","52.03","37.95"
"10","017","00","002","0204","0229","522","417","105","50","572","962","0","59.46","43.35"
"10","017","00","002","0205","0000","1130","923","207","87","1217","2190","0","55.57","42.15"
"10","017","00","002","0205","0230","615","511","104","39","654","1191","0","54.91","42.91"
"10","017","00","002","0205","0231","515","412","103","48","563","999","0","56.36","41.24"
"10","017","00","002","0206","0000","719","572","147","60","779","1525","0","51.08","37.51"
"10","017","00","002","0206","0232","130","110","20","7","137","282","0","48.58","39.01"
"10","017","00","002","0206","0233","589","462","127","53","642","1243","0","51.65","37.17"
"10","017","00","002","0207","0000","517","402","115","42","559","1092","0","51.19","36.81"
"10","017","00","002","0207","0234","517","402","115","42","559","1092","0","51.19","36.81"
"10","017","00","002","0208","0000","1082","855","227","44","1126","2260","0","49.82","37.83"
"10","017","00","002","0208","0238","437","348","89","18","455","975","0","46.67","35.69"
"10","017","00","002","0208","0239","645","507","138","26","671","1285","0","52.22","39.46"
"10","017","00","002","0209","0000","2097","1635","462","119","2216","4286","0","51.7","38.15"
"10","017","00","002","0209","0235","629","481","148","40","669","1246","0","53.69","38.6"
"10","017","00","002","0209","0236","823","637","186","41","864","1722","0","50.17","36.99"
"10","017","00","002","0209","0237","645","517","128","38","683","1318","0","51.82","39.23"
"10","017","00","002","0210","0000","1711","1339","372","126","1837","3463","0","53.05","38.67"
"10","017","00","002","0210","0244","879","692","187","67","946","1774","0","53.33","39.01"
"10","017","00","002","0210","0245","832","647","185","59","891","1689","0","52.75","38.31"
"10","017","00","002","0211","0000","907","702","205","78","985","2066","0","47.68","33.98"
"10","017","00","002","0211","0240","469","369","100","48","517","1077","0","48.0","34.26"
"10","017","00","002","0211","0241","438","333","105","30","468","989","0","47.32","33.67"
"10","017","00","002","0212","0000","209","163","46","9","218","428","0","50.93","38.08"
"10","017","00","002","0212","0253","209","163","46","9","218","428","0","50.93","38.08"
"10","017","00","002","0213","0000","172","132","40","24","196","326","0","60.12","40.49"
"10","017","00","002","0213","0254","172","132","40","24","196","326","0","60.12","40.49"
"10","017","00","002","0214","0000","231","193","38","16","247","351","0","70.37","54.99"
"10","017","00","002","0214","0255","231","193","38","16","247","351","0","70.37","54.99"
"10","017","00","002","0215","0000","842","688","154","33","875","1871","0","46.77","36.77"
"10","017","00","002","0215","0256","842","688","154","33","875","1871","0","46.77","36.77"
"10","017","00","002","0216","0000","191","148","43","6","197","448","0","43.97","33.04"
"10","017","00","002","0216","0257","191","148","43","6","197","448","0","43.97","33.04"
"10","017","00","002","0217","0000","1016","783","233","61","1077","1936","0","55.63","40.44"
"10","017","00","002","0217","0224","576","451","125","41","617","1011","0","61.03","44.61"
"10","017","00","002","0217","0225","440","332","108","20","460","925","0","49.73","35.89"
"10","017","00","002","0218","0000","2815","2222","593","171","2986","6059","0","49.28","36.67"
"10","017","00","002","0218","0246","631","506","125","61","692","1355","0","51.07","37.34"
"10","017","00","002","0218","0247","709","547","162","54","763","1512","0","50.46","36.18"
"10","017","00","002","0218","0248","670","513","157","25","695","1486","0","46.77","34.52"
"10","017","00","002","0218","0249","805","656","149","31","836","1706","0","49.0","38.45"
"10","017","00","002","0219","0000","1975","1540","435","132","2107","3803","0","55.4","40.49"
"10","017","00","002","0219","0250","698","557","141","53","751","1384","0","54.26","40.25"
"10","017","00","002","0219","0251","583","443","140","42","625","1045","0","59.81","42.39"
"10","017","00","002","0219","0252","694","540","154","37","731","1374","0","53.2","39.3"
"10","017","00","002","0220","0000","1172","884","288","83","1255","2466","0","50.89","35.85"
"10","017","00","002","0220","0242","554","430","124","38","592","1193","0","49.62","36.04"
"10","017","00","002","0220","0243","618","454","164","45","663","1273","0","52.08","35.66"
"10","017","00","003","0000","0000","16300","13090","3210","842","17142","33225","38606","51.59","39.4"
"10","017","00","003","0301","0000","648","515","133","53","701","1431","0","48.99","35.99"
"10","017","00","003","0301","0191","648","515","133","53","701","1431","0","48.99","35.99"
"10","017","00","003","0302","0000","324","246","78","28","352","637","0","55.26","38.62"
"10","017","00","003","0302","0193","324","246","78","28","352","637","0","55.26","38.62"
"10","017","00","003","0303","0000","395","307","88","25","420","735","0","57.14","41.77"
"10","017","00","003","0303","0194","395","307","88","25","420","735","0","57.14","41.77"
"10","017","00","003","0304","0000","1707","1349","358","111","1818","3641","0","49.93","37.05"
"10","017","00","003","0304","0195","479","386","93","27","506","1078","0","46.94","35.81"
"10","017","00","003","0304","0196","590","458","132","43","633","1238","0","51.13","37.0"
"10","017","00","003","0304","0197","638","505","133","41","679","1325","0","51.25","38.11"
"10","017","00","003","0305","0000","1358","1094","264","74","1432","2626","0","54.53","41.66"
"10","017","00","003","0305","0206","677","535","142","41","718","1267","0","56.67","42.23"
"10","017","00","003","0305","0207","681","559","122","33","714","1359","0","52.54","41.13"
"10","017","00","003","0306","0000","1477","1218","259","65","1542","2916","0","52.88","41.77"
"10","017","00","003","0306","0208","540","446","94","19","559","970","0","57.63","45.98"
"10","017","00","003","0306","0209","493","426","67","22","515","1002","0","51.4","42.51"
"10","017","00","003","0306","0210","444","346","98","24","468","944","0","49.58","36.65"
"10","017","00","003","0307","0000","1227","1002","225","67","1294","2553","0","50.69","39.25"
"10","017","00","003","0307","0200","606","500","106","40","646","1110","0","58.2","45.05"
"10","017","00","003","0307","0201","621","502","119","27","648","1443","0","44.91","34.79"
"10","017","00","003","0308","0000","1223","967","256","75","1298","2654","0","48.91","36.44"
"10","017","00","003","0308","0198","728","574","154","42","770","1475","0","52.2","38.92"
"10","017","00","003","0308","0199","495","393","102","33","528","1179","0","44.78","33.33"
"10","017","00","003","0309","0000","203","149","54","19","222","415","0","53.49","35.9"
"10","017","00","003","0309","0202","203","149","54","19","222","415","0","53.49","35.9"
"10","017","00","003","0310","0000","2306","1829","477","91","2397","4551","0","52.67","40.19"
"10","017","00","003","0310","0203","635","523","112","21","656","1378","0","47.61","37.95"
"10","017","00","003","0310","0204","782","603","179","26","808","1570","0","51.46","38.41"
"10","017","00","003","0310","0205","889","703","186","44","933","1603","0","58.2","43.86"
"10","017","00","003","0311","0000","194","152","42","6","200","456","0","43.86","33.33"
"10","017","00","003","0311","0192","194","152","42","6","200","456","0","43.86","33.33"
"10","017","00","003","0312","0000","2511","2065","446","111","2622","4893","0","53.59","42.2"
"10","017","00","003","0312","0215","690","561","129","31","721","1328","0","54.29","42.24"
"10","017","00","003","0312","0216","566","463","103","20","586","1173","0","49.96","39.47"
"10","017","00","003","0312","0217","562","469","93","36","598","1019","0","58.68","46.03"
"10","017","00","003","0312","0218","693","572","121","24","717","1373","0","52.22","41.66"
"10","017","00","003","0313","0000","2727","2197","530","117","2844","5717","0","49.75","38.43"
"10","017","00","003","0313","0211","798","633","165","43","841","1500","0","56.07","42.2"
"10","017","00","003","0313","0212","549","455","94","28","577","1442","0","40.01","31.55"
"10","017","00","003","0313","0213","598","487","111","25","623","1165","0","53.48","41.8"
"10","017","00","003","0313","0214","782","622","160","21","803","1610","0","49.88","38.63"
"10","017","00","004","0000","0000","17995","14062","3933","1508","19503","36738","43950","53.09","38.28"
"10","017","00","004","0401","0000","726","572","154","94","820","1782","0","46.02","32.1"
"10","017","00","004","0401","0072","726","572","154","94","820","1782","0","46.02","32.1"
"10","017","00","004","0402","0000","551","435","116","46","597","1055","0","56.59","41.23"
"10","017","00","004","0402","0073","551","435","116","46","597","1055","0","56.59","41.23"
"10","017","00","004","0403","0000","683","534","149","37","720","1558","0","46.21","34.27"
"10","017","00","004","0403","0074","683","534","149","37","720","1558","0","46.21","34.27"
"10","017","00","004","0404","0000","843","675","168","41","884","1736","0","50.92","38.88"
"10","017","00","004","0404","0075","843","675","168","41","884","1736","0","50.92","38.88"
"10","017","00","004","0405","0000","1276","983","293","83","1359","2352","0","57.78","41.79"
"10","017","00","004","0405","0076","691","526","165","42","733","1243","0","58.97","42.32"
"10","017","00","004","0405","0077","585","457","128","41","626","1109","0","56.45","41.21"
"10","017","00","004","0406","0000","932","782","150","39","971","1684","0","57.66","46.44"
"10","017","00","004","0406","0078","932","782","150","39","971","1684","0","57.66","46.44"
"10","017","00","004","0407","0000","457","353","104","41","498","919","0","54.19","38.41"
"10","017","00","004","0407","0079","457","353","104","41","498","919","0","54.19","38.41"
"10","017","00","004","0408","0000","470","353","117","20","490","991","0","49.45","35.62"
"10","017","00","004","0408","0080","470","353","117","20","490","991","0","49.45","35.62"
"10","017","00","004","0409","0000","441","346","95","18","459","876","0","52.4","39.5"
"10","017","00","004","0409","0081","441","346","95","18","459","876","0","52.4","39.5"
"10","017","00","004","0410","0000","800","639","161","67","867","1480","0","58.58","43.18"
"10","017","00","004","0410","0082","558","443","115","46","604","1046","0","57.74","42.35"
"10","017","00","004","0410","0083","242","196","46","21","263","434","0","60.6","45.16"
"10","017","00","004","0411","0000","387","307","80","59","446","764","0","58.38","40.18"
"10","017","00","004","0411","0084","387","307","80","59","446","764","0","58.38","40.18"
"10","017","00","004","0412","0000","475","359","116","21","496","968","0","51.24","37.09"
"10","017","00","004","0412","0085","475","359","116","21","496","968","0","51.24","37.09"
"10","017","00","004","0413","0000","1110","860","250","109","1219","2641","0","46.16","32.56"
"10","017","00","004","0413","0086","603","456","147","75","678","1326","0","51.13","34.39"
"10","017","00","004","0413","0087","507","404","103","34","541","1315","0","41.14","30.72"
"10","017","00","004","0414","0000","408","304","104","39","447","775","0","57.68","39.23"
"10","017","00","004","0414","0088","408","304","104","39","447","775","0","57.68","39.23"
"10","017","00","004","0415","0000","672","517","155","77","749","1326","0","56.49","38.99"
"10","017","00","004","0415","0089","323","242","81","50","373","652","0","57.21","37.12"
"10","017","00","004","0415","0090","349","275","74","27","376","674","0","55.79","40.8"
"10","017","00","004","0416","0000","373","287","86","36","409","789","0","51.84","36.38"
"10","017","00","004","0416","0091","373","287","86","36","409","789","0","51.84","36.38"
"10","017","00","004","0417","0000","835","642","193","66","901","1715","0","52.54","37.43"
"10","017","00","004","0417","0092","835","642","193","66","901","1715","0","52.54","37.43"
"10","017","00","004","0418","0000","411","306","105","41","452","849","0","53.24","36.04"
"10","017","00","004","0418","0093","411","306","105","41","452","849","0","53.24","36.04"
"10","017","00","004","0419","0000","444","362","82","25","469","875","0","53.6","41.37"
"10","017","00","004","0419","0094","444","362","82","25","469","875","0","53.6","41.37"
"10","017","00","004","0420","0000","392","312","80","41","433","851","0","50.88","36.66"
"10","017","00","004","0420","0095","392","312","80","41","433","851","0","50.88","36.66"
"10","017","00","004","0421","0000","400","325","75","26","426","735","0","57.96","44.22"
"10","017","00","004","0421","0096","400","325","75","26","426","735","0","57.96","44.22"
"10","017","00","004","0422","0000","469","360","109","65","534","1009","0","52.92","35.68"
"10","017","00","004","0422","0097","469","360","109","65","534","1009","0","52.92","35.68"
"10","017","00","004","0423","0000","490","374","116","38","528","1082","0","48.8","34.57"
"10","017","00","004","0423","0098","490","374","116","38","528","1082","0","48.8","34.57"
"10","017","00","004","0424","0000","1420","1166","254","117","1537","2797","0","54.95","41.69"
"10","017","00","004","0424","0099","593","465","128","69","662","1278","0","51.8","36.38"
"10","017","00","004","0424","0100","827","701","126","48","875","1519","0","57.6","46.15"
"10","017","00","004","0425","0000","339","247","92","43","382","708","0","53.95","34.89"
"10","017","00","004","0425","0103","339","247","92","43","382","708","0","53.95","34.89"
"10","017","00","004","0426","0000","328","247","81","26","354","567","0","62.43","43.56"
"10","017","00","004","0426","0104","328","247","81","26","354","567","0","62.43","43.56"
"10","017","00","004","0427","0000","352","246","106","58","410","751","0","54.59","32.76"
"10","017","00","004","0427","0105","352","246","106","58","410","751","0","54.59","32.76"
"10","017","00","004","0428","0000","324","244","80","29","353","589","0","59.93","41.43"
"10","017","00","004","0428","0106","324","244","80","29","353","589","0","59.93","41.43"
"10","017","00","004","0429","0000","1187","925","262","106","1293","2514","0","51.43","36.79"
"10","017","00","004","0429","0101","550","432","118","44","594","1336","0","44.46","32.34"
"10","017","00","004","0429","0102","637","493","144","62","699","1178","0","59.34","41.85"
"10","017","00","005","0000","0000","19724","15400","4324","1228","20952","41856","47428","50.06","36.79"
"10","017","00","005","0501","0000","376","303","73","21","397","796","0","49.87","38.07"
"10","017","00","005","0501","0107","376","303","73","21","397","796","0","49.87","38.07"
"10","017","00","005","0502","0000","593","478","115","44","637","1036","0","61.49","46.14"
"10","017","00","005","0502","0108","593","478","115","44","637","1036","0","61.49","46.14"
"10","017","00","005","0503","0000","391","287","104","41","432","756","0","57.14","37.96"
"10","017","00","005","0503","0109","391","287","104","41","432","756","0","57.14","37.96"
"10","017","00","005","0504","0000","387","282","105","19","406","957","0","42.42","29.47"
"10","017","00","005","0504","0110","387","282","105","19","406","957","0","42.42","29.47"
"10","017","00","005","0505","0000","395","308","87","10","405","802","0","50.5","38.4"
"10","017","00","005","0505","0111","395","308","87","10","405","802","0","50.5","38.4"
"10","017","00","005","0506","0000","632","507","125","44","676","1263","0","53.52","40.14"
"10","017","00","005","0506","0112","632","507","125","44","676","1263","0","53.52","40.14"
"10","017","00","005","0507","0000","419","342","77","23","442","778","0","56.81","43.96"
"10","017","00","005","0507","0113","419","342","77","23","442","778","0","56.81","43.96"
"10","017","00","005","0508","0000","577","443","134","81","658","1180","0","55.76","37.54"
"10","017","00","005","0508","0114","577","443","134","81","658","1180","0","55.76","37.54"
"10","017","00","005","0509","0000","433","343","90","29","462","990","0","46.67","34.65"
"10","017","00","005","0509","0115","433","343","90","29","462","990","0","46.67","34.65"
"10","017","00","005","0510","0000","505","404","101","36","541","1332","0","40.62","30.33"
"10","017","00","005","0510","0116","505","404","101","36","541","1332","0","40.62","30.33"
"10","017","00","005","0511","0000","784","621","163","35","819","1770","0","46.27","35.08"
"10","017","00","005","0511","0117","370","292","78","22","392","848","0","46.23","34.43"
"10","017","00","005","0511","0118","414","329","85","13","427","922","0","46.31","35.68"
"10","017","00","005","0512","0000","671","496","175","38","709","1584","0","44.76","31.31"
"10","017","00","005","0512","0122","671","496","175","38","709","1584","0","44.76","31.31"
"10","017","00","005","0513","0000","447","358","89","34","481","1319","0","36.47","27.14"
"10","017","00","005","0513","0123","447","358","89","34","481","1319","0","36.47","27.14"
"10","017","00","005","0514","0000","252","196","56","27","279","574","0","48.61","34.15"
"10","017","00","005","0514","0120","252","196","56","27","279","574","0","48.61","34.15"
"10","017","00","005","0515","0000","417","336","81","37","454","877","0","51.77","38.31"
"10","017","00","005","0515","0121","417","336","81","37","454","877","0","51.77","38.31"
"10","017","00","005","0516","0000","379","274","105","49","428","715","0","59.86","38.32"
"10","017","00","005","0516","0141","379","274","105","49","428","715","0","59.86","38.32"
"10","017","00","005","0517","0000","470","365","105","43","513","849","0","60.42","42.99"
"10","017","00","005","0517","0140","470","365","105","43","513","849","0","60.42","42.99"
"10","017","00","005","0518","0000","411","331","80","19","430","932","0","46.14","35.52"
"10","017","00","005","0518","0139","411","331","80","19","430","932","0","46.14","35.52"
"10","017","00","005","0519","0000","684","534","150","79","763","1642","0","46.47","32.52"
"10","017","00","005","0519","0138","684","534","150","79","763","1642","0","46.47","32.52"
"10","017","00","005","0520","0000","2763","2185","578","127","2890","5387","0","53.65","40.56"
"10","017","00","005","0520","0126","1068","854","214","37","1105","2088","0","52.92","40.9"
"10","017","00","005","0520","0127","984","774","210","38","1022","1946","0","52.52","39.77"
"10","017","00","005","0520","0128","711","557","154","52","763","1353","0","56.39","41.17"
"10","017","00","005","0521","0000","2792","2191","601","142","2934","5560","0","52.77","39.41"
"10","017","00","005","0521","0129","627","496","131","45","672","1317","0","51.03","37.66"
"10","017","00","005","0521","0130","463","337","126","33","496","870","0","57.01","38.74"
"10","017","00","005","0521","0131","694","582","112","26","720","1322","0","54.46","44.02"
"10","017","00","005","0521","0132","567","438","129","20","587","1295","0","45.33","33.82"
"10","017","00","005","0521","0133","441","338","103","18","459","756","0","60.71","44.71"
"10","017","00","005","0522","0000","1779","1370","409","106","1885","3815","0","49.41","35.91"
"10","017","00","005","0522","0124","929","715","214","57","986","1938","0","50.88","36.89"
"10","017","00","005","0522","0125","850","655","195","49","899","1877","0","47.9","34.9"
"10","017","00","005","0523","0000","260","193","67","11","271","459","0","59.04","42.05"
"10","017","00","005","0523","0119","260","193","67","11","271","459","0","59.04","42.05"
"10","017","00","005","0524","0000","2907","2253","654","133","3040","6483","0","46.89","34.75"
"10","017","00","005","0524","0134","681","526","155","28","709","1602","0","44.26","32.83"
"10","017","00","005","0524","0135","703","552","151","42","745","1568","0","47.51","35.2"
"10","017","00","005","0524","0136","699","520","179","37","736","1404","0","52.42","37.04"
"10","017","00","005","0524","0137","824","655","169","26","850","1909","0","44.53","34.31"
"10","017","00","006","0000","0000","34397","27453","6944","1844","36241","70396","82263","51.48","39.0"
"10","017","00","006","0601","0000","543","430","113","35","578","1213","0","47.65","35.45"
"10","017","00","006","0601","0143","543","430","113","35","578","1213","0","47.65","35.45"
"10","017","00","006","0602","0000","418","334","84","34","452","1026","0","44.05","32.55"
"10","017","00","006","0602","0144","418","334","84","34","452","1026","0","44.05","32.55"
"10","017","00","006","0603","0000","601","471","130","61","662","1361","0","48.64","34.61"
"10","017","00","006","0603","0142","601","471","130","61","662","1361","0","48.64","34.61"
"10","017","00","006","0604","0000","544","434","110","82","626","1038","0","60.31","41.81"
"10","017","00","006","0604","0145","544","434","110","82","626","1038","0","60.31","41.81"
"10","017","00","006","0605","0000","458","335","123","58","516","897","0","57.53","37.35"
"10","017","00","006","0605","0146","458","335","123","58","516","897","0","57.53","37.35"
"10","017","00","006","0606","0000","887","691","196","66","953","2042","0","46.67","33.84"
"10","017","00","006","0606","0147","683","535","148","57","740","1401","0","52.82","38.19"
"10","017","00","006","0606","0148","204","156","48","9","213","641","0","33.23","24.34"
"10","017","00","006","0607","0000","921","696","225","75","996","1944","0","51.23","35.8"
"10","017","00","006","0607","0149","686","510","176","50","736","1472","0","50.0","34.65"
"10","017","00","006","0607","0150","235","186","49","25","260","472","0","55.08","39.41"
"10","017","00","006","0608","0000","1494","1135","359","82","1576","3250","0","48.49","34.92"
"10","017","00","006","0608","0153","841","659","182","40","881","1901","0","46.34","34.67"
"10","017","00","006","0608","0154","653","476","177","42","695","1349","0","51.52","35.29"
"10","017","00","006","0609","0000","463","352","111","28","491","841","0","58.38","41.85"
"10","017","00","006","0609","0151","463","352","111","28","491","841","0","58.38","41.85"
"10","017","00","006","0610","0000","276","212","64","27","303","571","0","53.06","37.13"
"10","017","00","006","0610","0152","276","212","64","27","303","571","0","53.06","37.13"
"10","017","00","006","0611","0000","1909","1510","399","117","2026","3922","0","51.66","38.5"
"10","017","00","006","0611","0179","990","769","221","56","1046","1960","0","53.37","39.23"
"10","017","00","006","0611","0180","919","741","178","61","980","1962","0","49.95","37.77"
"10","017","00","006","0612","0000","796","725","71","51","847","1641","0","51.61","44.18"
"10","017","00","006","0612","0186","796","725","71","51","847","1641","0","51.61","44.18"
"10","017","00","006","0613","0000","2622","2110","512","130","2752","5289","0","52.03","39.89"
"10","017","00","006","0613","0187","624","482","142","36","660","1279","0","51.6","37.69"
"10","017","00","006","0613","0188","674","556","118","22","696","1360","0","51.18","40.88"
"10","017","00","006","0613","0189","717","571","146","43","760","1399","0","54.32","40.81"
"10","017","00","006","0613","0190","607","501","106","29","636","1251","0","50.84","40.05"
"10","017","00","006","0614","0000","1885","1510","375","81","1966","3946","0","49.82","38.27"
"10","017","00","006","0614","0181","1040","818","222","55","1095","2117","0","51.72","38.64"
"10","017","00","006","0614","0182","845","692","153","26","871","1829","0","47.62","37.83"
"10","017","00","006","0615","0000","1283","1000","283","81","1364","2576","0","52.95","38.82"
"10","017","00","006","0615","0155","581","453","128","41","622","1225","0","50.78","36.98"
"10","017","00","006","0615","0156","702","547","155","40","742","1351","0","54.92","40.49"
"10","017","00","006","0616","0000","2529","2013","516","120","2649","4768","0","55.56","42.22"
"10","017","00","006","0616","0159","827","667","160","45","872","1613","0","54.06","41.35"
"10","017","00","006","0616","0160","890","723","167","46","936","1731","0","54.07","41.77"
"10","017","00","006","0616","0161","812","623","189","29","841","1424","0","59.06","43.75"
"10","017","00","006","0617","0000","1736","1376","360","112","1848","3485","0","53.03","39.48"
"10","017","00","006","0617","0162","858","681","177","49","907","1806","0","50.22","37.71"
"10","017","00","006","0617","0163","878","695","183","63","941","1679","0","56.05","41.39"
"10","017","00","006","0618","0000","1953","1546","407","81","2034","3942","0","51.6","39.22"
"10","017","00","006","0618","0164","963","751","212","43","1006","1902","0","52.89","39.48"
"10","017","00","006","0618","0165","990","795","195","38","1028","2040","0","50.39","38.97"
"10","017","00","006","0619","0000","1256","969","287","65","1321","2556","0","51.68","37.91"
"10","017","00","006","0619","0166","669","526","143","45","714","1313","0","54.38","40.06"
"10","017","00","006","0619","0167","587","443","144","20","607","1243","0","48.83","35.64"
"10","017","00","006","0620","0000","1313","1011","302","53","1366","2968","0","46.02","34.06"
"10","017","00","006","0620","0171","631","490","141","26","657","1557","0","42.2","31.47"
"10","017","00","006","0620","0172","682","521","161","27","709","1411","0","50.25","36.92"
"10","017","00","006","0621","0000","2220","1847","373","80","2300","4538","0","50.68","40.7"
"10","017","00","006","0621","0183","707","595","112","29","736","1529","0","48.14","38.91"
"10","017","00","006","0621","0184","909","733","176","36","945","1869","0","50.56","39.22"
"10","017","00","006","0621","0185","604","519","85","15","619","1140","0","54.3","45.53"
"10","017","00","006","0622","0000","1795","1442","353","79","1874","3319","0","56.46","43.45"
"10","017","00","006","0622","0168","858","706","152","30","888","1759","0","50.48","40.14"
"10","017","00","006","0622","0169","413","324","89","24","437","694","0","62.97","46.69"
"10","017","00","006","0622","0170","524","412","112","25","549","866","0","63.39","47.58"
"10","017","00","006","0623","0000","2062","1674","388","93","2155","4650","0","46.34","36.0"
"10","017","00","006","0623","0176","764","627","137","26","790","1673","0","47.22","37.48"
"10","017","00","006","0623","0177","520","412","108","38","558","1054","0","52.94","39.09"
"10","017","00","006","0623","0178","778","635","143","29","807","1923","0","41.97","33.02"
"10","017","00","006","0624","0000","2316","1901","415","69","2385","4499","0","53.01","42.25"
"10","017","00","006","0624","0173","864","699","165","25","889","1568","0","56.7","44.58"
"10","017","00","006","0624","0174","693","564","129","32","725","1400","0","51.79","40.29"
"10","017","00","006","0624","0175","759","638","121","12","771","1531","0","50.36","41.67"
"10","017","00","006","0625","0000","2117","1729","388","84","2201","4114","0","53.5","42.03"
"10","017","00","006","0625","0157","871","701","170","41","912","1601","0","56.96","43.79"
"10","017","00","006","0625","0158","1246","1028","218","43","1289","2513","0","51.29","40.91"
"10","017","00","007","0000","0000","22660","18410","4250","1142","23802","46014","52487","51.73","40.01"
"10","017","00","007","0701","0000","552","431","121","36","588","1096","0","53.65","39.32"
"10","017","00","007","0701","0036","552","431","121","36","588","1096","0","53.65","39.32"
"10","017","00","007","0702","0000","703","560","143","34","737","1232","0","59.82","45.45"
"10","017","00","007","0702","0037","703","560","143","34","737","1232","0","59.82","45.45"
"10","017","00","007","0703","0000","609","483","126","22","631","1184","0","53.29","40.79"
"10","017","00","007","0703","0038","609","483","126","22","631","1184","0","53.29","40.79"
"10","017","00","007","0704","0000","1218","988","230","101","1319","2321","0","56.83","42.57"
"10","017","00","007","0704","0039","600","492","108","63","663","1133","0","58.52","43.42"
"10","017","00","007","0704","0040","618","496","122","38","656","1188","0","55.22","41.75"
"10","017","00","007","0705","0000","391","307","84","30","421","725","0","58.07","42.34"
"10","017","00","007","0705","0041","391","307","84","30","421","725","0","58.07","42.34"
"10","017","00","007","0706","0000","678","522","156","42","720","1524","0","47.24","34.25"
"10","017","00","007","0706","0042","678","522","156","42","720","1524","0","47.24","34.25"
"10","017","00","007","0707","0000","365","298","67","34","399","736","0","54.21","40.49"
"10","017","00","007","0707","0043","365","298","67","34","399","736","0","54.21","40.49"
"10","017","00","007","0708","0000","702","554","148","34","736","1562","0","47.12","35.47"
"10","017","00","007","0708","0044","293","235","58","18","311","611","0","50.9","38.46"
"10","017","00","007","0708","0045","409","319","90","16","425","951","0","44.69","33.54"
"10","017","00","007","0709","0000","801","645","156","32","833","1616","0","51.55","39.91"
"10","017","00","007","0709","0046","801","645","156","32","833","1616","0","51.55","39.91"
"10","017","00","007","0710","0000","783","640","143","32","815","1516","0","53.76","42.22"
"10","017","00","007","0710","0047","783","640","143","32","815","1516","0","53.76","42.22"
"10","017","00","007","0711","0000","1031","820","211","57","1088","2118","0","51.37","38.72"
"10","017","00","007","0711","0048","507","404","103","29","536","1049","0","51.1","38.51"
"10","017","00","007","0711","0049","524","416","108","28","552","1069","0","51.64","38.91"
"10","017","00","007","0712","0000","848","711","137","35","883","1763","0","50.09","40.33"
"10","017","00","007","0712","0054","483","407","76","20","503","999","0","50.35","40.74"
"10","017","00","007","0712","0055","365","304","61","15","380","764","0","49.74","39.79"
"10","017","00","007","0713","0000","1644","1348","296","68","1712","3570","0","47.96","37.76"
"10","017","00","007","0713","0056","708","570","138","38","746","1555","0","47.97","36.66"
"10","017","00","007","0713","0057","936","778","158","30","966","2015","0","47.94","38.61"
"10","017","00","007","0714","0000","1462","1172","290","81","1543","2837","0","54.39","41.31"
"10","017","00","007","0714","0058","674","547","127","42","716","1268","0","56.47","43.14"
"10","017","00","007","0714","0059","788","625","163","39","827","1569","0","52.71","39.83"
"10","017","00","007","0715","0000","658","529","129","37","695","1295","0","53.67","40.85"
"10","017","00","007","0715","0071","658","529","129","37","695","1295","0","53.67","40.85"
"10","017","00","007","0716","0000","2282","1839","443","120","2402","4113","0","58.4","44.71"
"10","017","00","007","0716","0050","397","317","80","23","420","727","0","57.77","43.6"
"10","017","00","007","0716","0051","518","435","83","23","541","929","0","58.23","46.82"
"10","017","00","007","0716","0052","656","514","142","34","690","1118","0","61.72","45.97"
"10","017","00","007","0716","0053","711","573","138","40","751","1339","0","56.09","42.79"
"10","017","00","007","0717","0000","1506","1249","257","81","1587","3780","0","41.98","33.04"
"10","017","00","007","0717","0069","817","679","138","47","864","2016","0","42.86","33.68"
"10","017","00","007","0717","0070","689","570","119","34","723","1764","0","40.99","32.31"
"10","017","00","007","0718","0000","1672","1374","298","82","1754","3461","0","50.68","39.7"
"10","017","00","007","0718","0060","895","723","172","58","953","1985","0","48.01","36.42"
"10","017","00","007","0718","0061","777","651","126","24","801","1476","0","54.27","44.11"
"10","017","00","007","0719","0000","1117","914","203","62","1179","2494","0","47.27","36.65"
"10","017","00","007","0719","0067","642","519","123","37","679","1485","0","45.72","34.95"
"10","017","00","007","0719","0068","475","395","80","25","500","1009","0","49.55","39.15"
"10","017","00","007","0720","0000","3638","3026","612","122","3760","7071","0","53.17","42.79"
"10","017","00","007","0720","0062","811","674","137","31","842","1493","0","56.4","45.14"
"10","017","00","007","0720","0063","725","600","125","26","751","1249","0","60.13","48.04"
"10","017","00","007","0720","0064","762","618","144","25","787","1559","0","50.48","39.64"
"10","017","00","007","0720","0065","542","450","92","14","556","1168","0","47.6","38.53"
"10","017","00","007","0720","0066","798","684","114","26","824","1602","0","51.44","42.7"
"10","018","00","000","0000","0000","186829","147391","39438","9769","196598","351775","444775","55.89","41.9"
"10","018","00","001","0000","0000","88100","69070","19030","4123","92223","163757","215079","56.32","42.18"
"10","018","00","001","0101","0000","386","294","92","33","419","714","0","58.68","41.18"
"10","018","00","001","0101","0101","386","294","92","33","419","714","0","58.68","41.18"
"10","018","00","001","0102","0000","749","597","152","43","792","1396","0","56.73","42.77"
"10","018","00","001","0102","0103","749","597","152","43","792","1396","0","56.73","42.77"
"10","018","00","001","0103","0000","462","338","124","51","513","875","0","58.63","38.63"
"10","018","00","001","0103","0102","462","338","124","51","513","875","0","58.63","38.63"
"10","018","00","001","0104","0000","255","199","56","14","269","507","0","53.06","39.25"
"10","018","00","001","0104","0100","255","199","56","14","269","507","0","53.06","39.25"
"10","018","00","001","0105","0000","328","244","84","24","352","566","0","62.19","43.11"
"10","018","00","001","0105","0004","328","244","84","24","352","566","0","62.19","43.11"
"10","018","00","001","0106","0000","152","109","43","19","171","305","0","56.07","35.74"
"10","018","00","001","0106","0006","152","109","43","19","171","305","0","56.07","35.74"
"10","018","00","001","0107","0000","348","258","90","19","367","640","0","57.34","40.31"
"10","018","00","001","0107","0005","348","258","90","19","367","640","0","57.34","40.31"
"10","018","00","001","0108","0000","282","226","56","18","300","475","0","63.16","47.58"
"10","018","00","001","0108","0113","282","226","56","18","300","475","0","63.16","47.58"
"10","018","00","001","0109","0000","405","299","106","48","453","752","0","60.24","39.76"
"10","018","00","001","0109","0112","405","299","106","48","453","752","0","60.24","39.76"
"10","018","00","001","0110","0000","368","273","95","33","401","710","0","56.48","38.45"
"10","018","00","001","0110","0111","368","273","95","33","401","710","0","56.48","38.45"
"10","018","00","001","0111","0000","478","377","101","15","493","1512","0","32.61","24.93"
"10","018","00","001","0111","0001","478","377","101","15","493","1512","0","32.61","24.93"
"10","018","00","001","0112","0000","323","231","92","15","338","563","0","60.04","41.03"
"10","018","00","001","0112","0007","323","231","92","15","338","563","0","60.04","41.03"
"10","018","00","001","0113","0000","1677","1327","350","81","1758","3123","0","56.29","42.49"
"10","018","00","001","0113","0027","829","649","180","41","870","1573","0","55.31","41.26"
"10","018","00","001","0113","0028","848","678","170","40","888","1550","0","57.29","43.74"
"10","018","00","001","0114","0000","1534","1198","336","106","1640","2928","0","56.01","40.92"
"10","018","00","001","0114","0114","428","329","99","36","464","880","0","52.73","37.39"
"10","018","00","001","0114","0115","531","413","118","33","564","989","0","57.03","41.76"
"10","018","00","001","0114","0116","575","456","119","37","612","1059","0","57.79","43.06"
"10","018","00","001","0115","0000","773","573","200","70","843","1422","0","59.28","40.3"
"10","018","00","001","0115","0117","328","232","96","41","369","607","0","60.79","38.22"
"10","018","00","001","0115","0118","445","341","104","29","474","815","0","58.16","41.84"
"10","018","00","001","0116","0000","2647","2087","560","139","2786","5524","0","50.43","37.78"
"10","018","00","001","0116","0104","613","470","143","37","650","1232","0","52.76","38.15"
"10","018","00","001","0116","0105","677","515","162","40","717","1323","0","54.2","38.93"
"10","018","00","001","0116","0106","654","533","121","18","672","1516","0","44.33","35.16"
"10","018","00","001","0116","0107","703","569","134","44","747","1453","0","51.41","39.16"
"10","018","00","001","0117","0000","955","757","198","48","1003","1682","0","59.63","45.01"
"10","018","00","001","0117","0002","558","441","117","25","583","953","0","61.18","46.27"
"10","018","00","001","0117","0003","397","316","81","23","420","729","0","57.61","43.35"
"10","018","00","001","0118","0000","2403","1921","482","76","2479","4456","0","55.63","43.11"
"10","018","00","001","0118","0010","838","677","161","23","861","1615","0","53.31","41.92"
"10","018","00","001","0118","0011","704","566","138","36","740","1287","0","57.5","43.98"
"10","018","00","001","0118","0012","861","678","183","17","878","1554","0","56.5","43.63"
"10","018","00","001","0119","0000","2290","1797","493","95","2385","4162","0","57.3","43.18"
"10","018","00","001","0119","0013","787","633","154","15","802","1388","0","57.78","45.61"
"10","018","00","001","0119","0014","800","617","183","30","830","1419","0","58.49","43.48"
"10","018","00","001","0119","0015","703","547","156","50","753","1355","0","55.57","40.37"
"10","018","00","001","0120","0000","2604","2056","548","141","2745","4714","0","58.23","43.61"
"10","018","00","001","0120","0019","582","468","114","29","611","1062","0","57.53","44.07"
"10","018","00","001","0120","0020","711","558","153","40","751","1315","0","57.11","42.43"
"10","018","00","001","0120","0021","557","441","116","37","594","1000","0","59.4","44.1"
"10","018","00","001","0120","0022","754","589","165","35","789","1337","0","59.01","44.05"
"10","018","00","001","0121","0000","2972","2349","623","116","3088","5333","0","57.9","44.05"
"10","018","00","001","0121","0023","905","743","162","29","934","1747","0","53.46","42.53"
"10","018","00","001","0121","0024","922","716","206","34","956","1600","0","59.75","44.75"
"10","018","00","001","0121","0025","629","500","129","27","656","1158","0","56.65","43.18"
"10","018","00","001","0121","0026","516","390","126","26","542","828","0","65.46","47.1"
"10","018","00","001","0122","0000","1315","1036","279","97","1412","2283","0","61.85","45.38"
"10","018","00","001","0122","0039","689","520","169","72","761","1271","0","59.87","40.91"
"10","018","00","001","0122","0040","626","516","110","25","651","1012","0","64.33","50.99"
"10","018","00","001","0123","0000","1341","1037","304","101","1442","2604","0","55.38","39.82"
"10","018","00","001","0123","0041","534","418","116","54","588","1001","0","58.74","41.76"
"10","018","00","001","0123","0042","807","619","188","47","854","1603","0","53.28","38.62"
"10","018","00","001","0124","0000","2404","1857","547","127","2531","4297","0","58.9","43.22"
"10","018","00","001","0124","0050","672","500","172","34","706","1195","0","59.08","41.84"
"10","018","00","001","0124","0051","813","620","193","54","867","1569","0","55.26","39.52"
"10","018","00","001","0124","0052","919","737","182","39","958","1533","0","62.49","48.08"
"10","018","00","001","0125","0000","2295","1917","378","114","2409","3992","0","60.35","48.02"
"10","018","00","001","0125","0053","767","633","134","45","812","1336","0","60.78","47.38"
"10","018","00","001","0125","0054","773","663","110","38","811","1367","0","59.33","48.5"
"10","018","00","001","0125","0055","755","621","134","31","786","1289","0","60.98","48.18"
"10","018","00","001","0126","0000","3521","2780","741","171","3692","6055","0","60.97","45.91"
"10","018","00","001","0126","0034","709","571","138","49","758","1262","0","60.06","45.25"
"10","018","00","001","0126","0035","658","516","142","20","678","1199","0","56.55","43.04"
"10","018","00","001","0126","0036","720","563","157","30","750","1226","0","61.17","45.92"
"10","018","00","001","0126","0037","829","655","174","47","876","1377","0","63.62","47.57"
"10","018","00","001","0126","0038","605","475","130","25","630","991","0","63.57","47.93"
"10","018","00","001","0127","0000","1755","1405","350","73","1828","3142","0","58.18","44.72"
"10","018","00","001","0127","0031","524","416","108","17","541","935","0","57.86","44.49"
"10","018","00","001","0127","0032","574","456","118","21","595","1074","0","55.4","42.46"
"10","018","00","001","0127","0033","657","533","124","35","692","1133","0","61.08","47.04"
"10","018","00","001","0128","0000","1758","1403","355","74","1832","3440","0","53.26","40.78"
"10","018","00","001","0128","0122","519","404","115","35","554","1062","0","52.17","38.04"
"10","018","00","001","0128","0123","574","453","121","23","597","1046","0","57.07","43.31"
"10","018","00","001","0128","0124","665","546","119","16","681","1332","0","51.13","40.99"
"10","018","00","001","0129","0000","1578","1222","356","96","1674","2999","0","55.82","40.75"
"10","018","00","001","0129","0108","478","348","130","39","517","880","0","58.75","39.55"
"10","018","00","001","0129","0109","533","448","85","27","560","1058","0","52.93","42.34"
"10","018","00","001","0129","0110","567","426","141","30","597","1061","0","56.27","40.15"
"10","018","00","001","0130","0000","2760","2157","603","110","2870","5036","0","56.99","42.83"
"10","018","00","001","0130","0132","642","503","139","44","686","1315","0","52.17","38.25"
"10","018","00","001","0130","0133","769","604","165","23","792","1413","0","56.05","42.75"
"10","018","00","001","0130","0134","591","473","118","20","611","1064","0","57.42","44.45"
"10","018","00","001","0130","0135","758","577","181","23","781","1244","0","62.78","46.38"
"10","018","00","001","0131","0000","2921","2277","644","132","3053","5678","0","53.77","40.1"
"10","018","00","001","0131","0125","730","560","170","46","776","1350","0","57.48","41.48"
"10","018","00","001","0131","0126","707","553","154","17","724","1438","0","50.35","38.46"
"10","018","00","001","0131","0127","676","520","156","42","718","1414","0","50.78","36.78"
"10","018","00","001","0131","0128","808","644","164","27","835","1476","0","56.57","43.63"
"10","018","00","001","0132","0000","679","547","132","18","697","1233","0","56.53","44.36"
"10","018","00","001","0132","0099","679","547","132","18","697","1233","0","56.53","44.36"
"10","018","00","001","0133","0000","1649","1285","364","96","1745","3003","0","58.11","42.79"
"10","018","00","001","0133","0063","637","508","129","37","674","1132","0","59.54","44.88"
"10","018","00","001","0133","0064","136","94","42","12","148","251","0","58.96","37.45"
"10","018","00","001","0133","0065","876","683","193","47","923","1620","0","56.98","42.16"
"10","018","00","001","0135","0000","483","410","73","30","513","915","0","56.07","44.81"
"10","018","00","001","0135","0059","483","410","73","30","513","915","0","56.07","44.81"
"10","018","00","001","0136","0000","1546","1204","342","84","1630","2751","0","59.25","43.77"
"10","018","00","001","0136","0056","504","392","112","23","527","960","0","54.9","40.83"
"10","018","00","001","0136","0057","513","396","117","21","534","843","0","63.35","46.98"
"10","018","00","001","0136","0058","529","416","113","40","569","948","0","60.02","43.88"
"10","018","00","001","0137","0000","1990","1663","327","67","2057","3556","0","57.85","46.77"
"10","018","00","001","0137","0060","998","845","153","33","1031","1801","0","57.25","46.92"
"10","018","00","001","0137","0061","590","478","112","23","613","1079","0","56.81","44.3"
"10","018","00","001","0137","0062","402","340","62","11","413","676","0","61.09","50.3"
"10","018","00","001","0138","0000","1344","1028","316","77","1421","2768","0","51.34","37.14"
"10","018","00","001","0138","0043","641","468","173","41","682","1236","0","55.18","37.86"
"10","018","00","001","0138","0044","703","560","143","36","739","1532","0","48.24","36.55"
"10","018","00","001","0139","0000","1750","1380","370","111","1861","3331","0","55.87","41.43"
"10","018","00","001","0139","0045","677","540","137","39","716","1306","0","54.82","41.35"
"10","018","00","001","0139","0046","571","456","115","59","630","1073","0","58.71","42.5"
"10","018","00","001","0139","0047","502","384","118","13","515","952","0","54.1","40.34"
"10","018","00","001","0140","0000","976","777","199","40","1016","2076","0","48.94","37.43"
"10","018","00","001","0140","0048","579","447","132","26","605","1298","0","46.61","34.44"
"10","018","00","001","0140","0049","397","330","67","14","411","778","0","52.83","42.42"
"10","018","00","001","0141","0000","2361","1802","559","84","2445","4669","0","52.37","38.59"
"10","018","00","001","0141","0077","597","467","130","20","617","1215","0","50.78","38.44"
"10","018","00","001","0141","0078","501","389","112","31","532","1067","0","49.86","36.46"
"10","018","00","001","0141","0079","641","464","177","15","656","1194","0","54.94","38.86"
"10","018","00","001","0141","0080","622","482","140","18","640","1193","0","53.65","40.4"
"10","018","00","001","0142","0000","4247","3145","1102","150","4397","7900","0","55.66","39.81"
"10","018","00","001","0142","0066","767","591","176","31","798","1479","0","53.96","39.96"
"10","018","00","001","0142","0067","724","549","175","30","754","1402","0","53.78","39.16"
"10","018","00","001","0142","0068","689","531","158","40","729","1280","0","56.95","41.48"
"10","018","00","001","0142","0069","704","535","169","21","725","1228","0","59.04","43.57"
"10","018","00","001","0142","0070","614","437","177","9","623","1157","0","53.85","37.77"
"10","018","00","001","0142","0071","749","502","247","19","768","1354","0","56.72","37.08"
"10","018","00","001","0143","0000","2864","2274","590","144","3008","5242","0","57.38","43.38"
"10","018","00","001","0143","0081","746","581","165","59","805","1388","0","58.0","41.86"
"10","018","00","001","0143","0082","705","550","155","28","733","1267","0","57.85","43.41"
"10","018","00","001","0143","0083","705","583","122","25","730","1299","0","56.2","44.88"
"10","018","00","001","0143","0084","708","560","148","32","740","1288","0","57.45","43.48"
"10","018","00","001","0144","0000","2402","1897","505","93","2495","4240","0","58.84","44.74"
"10","018","00","001","0144","0096","823","665","158","35","858","1400","0","61.29","47.5"
"10","018","00","001","0144","0097","845","645","200","21","866","1473","0","58.79","43.79"
"10","018","00","001","0144","0098","734","587","147","37","771","1367","0","56.4","42.94"
"10","018","00","001","0145","0000","2561","2037","524","105","2666","5042","0","52.88","40.4"
"10","018","00","001","0145","0092","677","537","140","34","711","1323","0","53.74","40.59"
"10","018","00","001","0145","0093","610","506","104","20","630","1207","0","52.2","41.92"
"10","018","00","001","0145","0094","592","448","144","28","620","1264","0","49.05","35.44"
"10","018","00","001","0145","0095","682","546","136","23","705","1248","0","56.49","43.75"
"10","018","00","001","0146","0000","2406","1950","456","113","2519","4634","0","54.36","42.08"
"10","018","00","001","0146","0088","572","473","99","34","606","1135","0","53.39","41.67"
"10","018","00","001","0146","0089","567","464","103","18","585","1165","0","50.21","39.83"
"10","018","00","001","0146","0090","598","474","124","18","616","1124","0","54.8","42.17"
"10","018","00","001","0146","0091","669","539","130","43","712","1210","0","58.84","44.55"
"10","018","00","001","0147","0000","3729","2921","808","136","3865","6262","0","61.72","46.65"
"10","018","00","001","0147","0072","838","629","209","28","866","1334","0","64.92","47.15"
"10","018","00","001","0147","0073","695","566","129","25","720","1234","0","58.35","45.87"
"10","018","00","001","0147","0074","837","668","169","30","867","1398","0","62.02","47.78"
"10","018","00","001","0147","0075","537","383","154","30","567","928","0","61.1","41.27"
"10","018","00","001","0147","0076","822","675","147","23","845","1368","0","61.77","49.34"
"10","018","00","001","0148","0000","1301","959","342","63","1364","2357","0","57.87","40.69"
"10","018","00","001","0148","0029","697","523","174","24","721","1317","0","54.75","39.71"
"10","018","00","001","0148","0030","604","436","168","39","643","1040","0","61.83","41.92"
"10","018","00","001","0149","0000","1730","1369","361","101","1831","3392","0","53.98","40.36"
"10","018","00","001","0149","0119","446","361","85","34","480","777","0","61.78","46.46"
"10","018","00","001","0149","0120","645","516","129","30","675","1399","0","48.25","36.88"
"10","018","00","001","0149","0121","639","492","147","37","676","1216","0","55.59","40.46"
"10","018","00","001","0150","0000","2576","2041","535","96","2672","4777","0","55.93","42.73"
"10","018","00","001","0150","0016","790","621","169","30","820","1490","0","55.03","41.68"
"10","018","00","001","0150","0017","877","708","169","22","899","1615","0","55.67","43.84"
"10","018","00","001","0150","0018","909","712","197","44","953","1672","0","57.0","42.58"
"10","018","00","001","0151","0000","970","759","211","23","993","1782","0","55.72","42.59"
"10","018","00","001","0151","0008","392","307","85","13","405","741","0","54.66","41.43"
"10","018","00","001","0151","0009","578","452","126","10","588","1041","0","56.48","43.42"
"10","018","00","001","0152","0000","2025","1571","454","74","2099","3526","0","59.53","44.55"
"10","018","00","001","0152","0129","775","604","171","41","816","1326","0","61.54","45.55"
"10","018","00","001","0152","0130","562","442","120","13","575","927","0","62.03","47.68"
"10","018","00","001","0152","0131","688","525","163","20","708","1273","0","55.62","41.24"
"10","018","00","001","0153","0000","2309","1830","479","66","2375","4816","0","49.31","38.0"
"10","018","00","001","0153","0136","579","466","113","8","587","1160","0","50.6","40.17"
"10","018","00","001","0153","0137","663","525","138","17","680","1398","0","48.64","37.55"
"10","018","00","001","0153","0138","555","439","116","14","569","1384","0","41.11","31.72"
"10","018","00","001","0153","0139","512","400","112","27","539","874","0","61.67","45.77"
"10","018","00","001","0154","0000","2163","1620","543","53","2216","3600","0","61.56","45.0"
"10","018","00","001","0154","0085","725","537","188","19","744","1228","0","60.59","43.73"
"10","018","00","001","0154","0086","677","516","161","11","688","1135","0","60.62","45.46"
"10","018","00","001","0154","0087","761","567","194","23","784","1237","0","63.38","45.84"
"10","018","00","002","0000","0000","64430","50916","13514","3673","68103","123122","151391","55.31","41.35"
"10","018","00","002","0201","0000","299","226","73","22","321","535","0","60.0","42.24"
"10","018","00","002","0201","0141","299","226","73","22","321","535","0","60.0","42.24"
"10","018","00","002","0202","0000","413","328","85","29","442","711","0","62.17","46.13"
"10","018","00","002","0202","0144","413","328","85","29","442","711","0","62.17","46.13"
"10","018","00","002","0203","0000","392","269","123","52","444","746","0","59.52","36.06"
"10","018","00","002","0203","0142","392","269","123","52","444","746","0","59.52","36.06"
"10","018","00","002","0204","0000","225","166","59","10","235","477","0","49.27","34.8"
"10","018","00","002","0204","0140","225","166","59","10","235","477","0","49.27","34.8"
"10","018","00","002","0205","0000","532","404","128","34","566","1143","0","49.52","35.35"
"10","018","00","002","0205","0145","532","404","128","34","566","1143","0","49.52","35.35"
"10","018","00","002","0206","0000","264","211","53","15","279","546","0","51.1","38.64"
"10","018","00","002","0206","0143","264","211","53","15","279","546","0","51.1","38.64"
"10","018","00","002","0207","0000","674","522","152","39","713","1370","0","52.04","38.1"
"10","018","00","002","0207","0146","674","522","152","39","713","1370","0","52.04","38.1"
"10","018","00","002","0208","0000","500","397","103","33","533","957","0","55.69","41.48"
"10","018","00","002","0208","0172","500","397","103","33","533","957","0","55.69","41.48"
"10","018","00","002","0209","0000","325","265","60","34","359","561","0","63.99","47.24"
"10","018","00","002","0209","0169","325","265","60","34","359","561","0","63.99","47.24"
"10","018","00","002","0210","0000","440","347","93","26","466","761","0","61.24","45.6"
"10","018","00","002","0210","0167","440","347","93","26","466","761","0","61.24","45.6"
"10","018","00","002","0211","0000","436","323","113","32","468","788","0","59.39","40.99"
"10","018","00","002","0211","0168","436","323","113","32","468","788","0","59.39","40.99"
"10","018","00","002","0212","0000","647","503","144","27","674","1398","0","48.21","35.98"
"10","018","00","002","0212","0171","647","503","144","27","674","1398","0","48.21","35.98"
"10","018","00","002","0213","0000","740","587","153","84","824","1558","0","52.89","37.68"
"10","018","00","002","0213","0170","740","587","153","84","824","1558","0","52.89","37.68"
"10","018","00","002","0214","0000","2422","1891","531","145","2567","4800","0","53.48","39.4"
"10","018","00","002","0214","0173","640","523","117","43","683","1195","0","57.15","43.77"
"10","018","00","002","0214","0174","578","443","135","31","609","1236","0","49.27","35.84"
"10","018","00","002","0214","0175","604","458","146","48","652","1255","0","51.95","36.49"
"10","018","00","002","0214","0176","600","467","133","23","623","1114","0","55.92","41.92"
"10","018","00","002","0215","0000","1491","1163","328","87","1578","2949","0","53.51","39.44"
"10","018","00","002","0215","0188","717","585","132","31","748","1457","0","51.34","40.15"
"10","018","00","002","0215","0189","774","578","196","56","830","1492","0","55.63","38.74"
"10","018","00","002","0216","0000","1973","1545","428","104","2077","3906","0","53.17","39.55"
"10","018","00","002","0216","0185","574","454","120","16","590","1272","0","46.38","35.69"
"10","018","00","002","0216","0186","695","531","164","47","742","1306","0","56.81","40.66"
"10","018","00","002","0216","0187","704","560","144","41","745","1328","0","56.1","42.17"
"10","018","00","002","0217","0000","1185","914","271","89","1274","2131","0","59.78","42.89"
"10","018","00","002","0217","0190","654","515","139","49","703","1160","0","60.6","44.4"
"10","018","00","002","0217","0191","531","399","132","40","571","971","0","58.81","41.09"
"10","018","00","002","0218","0000","870","672","198","52","922","1651","0","55.84","40.7"
"10","018","00","002","0218","0228","479","366","113","21","500","946","0","52.85","38.69"
"10","018","00","002","0218","0229","391","306","85","31","422","705","0","59.86","43.4"
"10","018","00","002","0219","0000","2032","1589","443","97","2129","3852","0","55.27","41.25"
"10","018","00","002","0219","0221","634","489","145","30","664","1175","0","56.51","41.62"
"10","018","00","002","0219","0222","727","571","156","24","751","1371","0","54.78","41.65"
"10","018","00","002","0219","0223","671","529","142","43","714","1306","0","54.67","40.51"
"10","018","00","002","0220","0000","455","340","115","50","505","848","0","59.55","40.09"
"10","018","00","002","0220","0230","455","340","115","50","505","848","0","59.55","40.09"
"10","018","00","002","0221","0000","1464","1133","331","60","1524","2712","0","56.19","41.78"
"10","018","00","002","0221","0199","756","593","163","41","797","1442","0","55.27","41.12"
"10","018","00","002","0221","0200","708","540","168","19","727","1270","0","57.24","42.52"
"10","018","00","002","0222","0000","3337","2632","705","182","3519","5949","0","59.15","44.24"
"10","018","00","002","0222","0208","590","474","116","23","613","1106","0","55.42","42.86"
"10","018","00","002","0222","0209","605","484","121","22","627","1044","0","60.06","46.36"
"10","018","00","002","0222","0210","593","454","139","34","627","1061","0","59.1","42.79"
"10","018","00","002","0222","0211","830","659","171","64","894","1518","0","58.89","43.41"
"10","018","00","002","0222","0212","719","561","158","39","758","1220","0","62.13","45.98"
"10","018","00","002","0223","0000","2701","2310","391","101","2802","4623","0","60.61","49.97"
"10","018","00","002","0223","0217","588","504","84","14","602","1059","0","56.85","47.59"
"10","018","00","002","0223","0218","651","558","93","34","685","1130","0","60.62","49.38"
"10","018","00","002","0223","0219","724","614","110","28","752","1208","0","62.25","50.83"
"10","018","00","002","0223","0220","738","634","104","25","763","1226","0","62.23","51.71"
"10","018","00","002","0224","0000","2697","2179","518","148","2845","5718","0","49.76","38.11"
"10","018","00","002","0224","0231","659","537","122","26","685","1295","0","52.9","41.47"
"10","018","00","002","0224","0232","697","578","119","42","739","1467","0","50.37","39.4"
"10","018","00","002","0224","0233","710","574","136","37","747","1659","0","45.03","34.6"
"10","018","00","002","0224","0234","631","490","141","43","674","1297","0","51.97","37.78"
"10","018","00","002","0225","0000","311","247","64","35","346","594","0","58.25","41.58"
"10","018","00","002","0225","0244","311","247","64","35","346","594","0","58.25","41.58"
"10","018","00","002","0226","0000","1497","1175","322","135","1632","2831","0","57.65","41.5"
"10","018","00","002","0226","0235","720","549","171","69","789","1374","0","57.42","39.96"
"10","018","00","002","0226","0236","777","626","151","66","843","1457","0","57.86","42.96"
"10","018","00","002","0227","0000","769","583","186","70","839","1609","0","52.14","36.23"
"10","018","00","002","0227","0243","769","583","186","70","839","1609","0","52.14","36.23"
"10","018","00","002","0228","0000","1851","1500","351","108","1959","3393","0","57.74","44.21"
"10","018","00","002","0228","0237","606","512","94","26","632","1072","0","58.96","47.76"
"10","018","00","002","0228","0238","675","541","134","50","725","1350","0","53.7","40.07"
"10","018","00","002","0228","0239","570","447","123","32","602","971","0","62.0","46.04"
"10","018","00","002","0229","0000","1981","1595","386","131","2112","3723","0","56.73","42.84"
"10","018","00","002","0229","0240","782","610","172","68","850","1450","0","58.62","42.07"
"10","018","00","002","0229","0241","475","386","89","31","506","895","0","56.54","43.13"
"10","018","00","002","0229","0242","724","599","125","32","756","1378","0","54.86","43.47"
"10","018","00","002","0230","0000","934","735","199","39","973","1766","0","55.1","41.62"
"10","018","00","002","0230","0158","602","472","130","24","626","1128","0","55.5","41.84"
"10","018","00","002","0230","0159","332","263","69","15","347","638","0","54.39","41.22"
"10","018","00","002","0231","0000","1882","1464","418","75","1957","3589","0","54.53","40.79"
"10","018","00","002","0231","0147","718","547","171","39","757","1390","0","54.46","39.35"
"10","018","00","002","0231","0148","513","409","104","22","535","962","0","55.61","42.52"
"10","018","00","002","0231","0149","651","508","143","14","665","1237","0","53.76","41.07"
"10","018","00","002","0232","0000","2505","2016","489","131","2636","5156","0","51.12","39.1"
"10","018","00","002","0232","0151","349","274","75","12","361","758","0","47.63","36.15"
"10","018","00","002","0232","0152","635","525","110","29","664","1320","0","50.3","39.77"
"10","018","00","002","0232","0153","715","576","139","48","763","1519","0","50.23","37.92"
"10","018","00","002","0232","0154","128","92","36","5","133","347","0","38.33","26.51"
"10","018","00","002","0232","0155","678","549","129","37","715","1212","0","58.99","45.3"
"10","018","00","002","0233","0000","1445","1107","338","95","1540","2912","0","52.88","38.02"
"10","018","00","002","0233","0156","723","565","158","45","768","1484","0","51.75","38.07"
"10","018","00","002","0233","0157","722","542","180","50","772","1428","0","54.06","37.96"
"10","018","00","002","0234","0000","2082","1638","444","138","2220","4121","0","53.87","39.75"
"10","018","00","002","0234","0163","702","562","140","45","747","1394","0","53.59","40.32"
"10","018","00","002","0234","0164","734","575","159","34","768","1568","0","48.98","36.67"
"10","018","00","002","0234","0165","646","501","145","59","705","1159","0","60.83","43.23"
"10","018","00","002","0235","0000","102","87","15","3","105","252","0","41.67","34.52"
"10","018","00","002","0235","0166","102","87","15","3","105","252","0","41.67","34.52"
"10","018","00","002","0236","0000","2556","2011","545","159","2715","4656","0","58.31","43.19"
"10","018","00","002","0236","0224","671","521","150","23","694","1340","0","51.79","38.88"
"10","018","00","002","0236","0225","627","473","154","57","684","1111","0","61.57","42.57"
"10","018","00","002","0236","0226","719","562","157","44","763","1197","0","63.74","46.95"
"10","018","00","002","0236","0227","539","455","84","35","574","1008","0","56.94","45.14"
"10","018","00","002","0237","0000","2742","2165","577","156","2898","5296","0","54.72","40.88"
"10","018","00","002","0237","0177","724","566","158","26","750","1396","0","53.72","40.54"
"10","018","00","002","0237","0178","775","585","190","61","836","1456","0","57.42","40.18"
"10","018","00","002","0237","0179","709","575","134","30","739","1374","0","53.78","41.85"
"10","018","00","002","0237","0180","534","439","95","39","573","1070","0","53.55","41.03"
"10","018","00","002","0238","0000","2366","1874","492","176","2542","4524","0","56.19","41.42"
"10","018","00","002","0238","0181","579","455","124","60","639","1142","0","55.95","39.84"
"10","018","00","002","0238","0182","532","431","101","23","555","1103","0","50.32","39.08"
"10","018","00","002","0238","0183","610","453","157","67","677","1190","0","56.89","38.07"
"10","018","00","002","0238","0184","645","535","110","26","671","1089","0","61.62","49.13"
"10","018","00","002","0239","0000","1886","1492","394","109","1995","4112","0","48.52","36.28"
"10","018","00","002","0239","0192","414","324","90","22","436","1401","0","31.12","23.13"
"10","018","00","002","0239","0193","730","566","164","34","764","1340","0","57.01","42.24"
"10","018","00","002","0239","0194","742","602","140","53","795","1371","0","57.99","43.91"
"10","018","00","002","0240","0000","2613","2036","577","94","2707","4793","0","56.48","42.48"
"10","018","00","002","0240","0195","660","516","144","17","677","1267","0","53.43","40.73"
"10","018","00","002","0240","0196","637","500","137","27","664","1073","0","61.88","46.6"
"10","018","00","002","0240","0197","643","487","156","34","677","1159","0","58.41","42.02"
"10","018","00","002","0240","0198","673","533","140","16","689","1294","0","53.25","41.19"
"10","018","00","002","0241","0000","3120","2475","645","109","3229","5721","0","56.44","43.26"
"10","018","00","002","0241","0213","821","642","179","18","839","1475","0","56.88","43.53"
"10","018","00","002","0241","0214","703","554","149","42","745","1373","0","54.26","40.35"
"10","018","00","002","0241","0215","799","630","169","19","818","1450","0","56.41","43.45"
"10","018","00","002","0241","0216","797","649","148","30","827","1423","0","58.12","45.61"
"10","018","00","002","0242","0000","3483","2747","736","161","3644","6417","0","56.79","42.81"
"10","018","00","002","0242","0203","635","488","147","34","669","1163","0","57.52","41.96"
"10","018","00","002","0242","0204","690","556","134","21","711","1334","0","53.3","41.68"
"10","018","00","002","0242","0205","754","589","165","39","793","1415","0","56.04","41.63"
"10","018","00","002","0242","0206","753","577","176","36","789","1305","0","60.46","44.21"
"10","018","00","002","0242","0207","651","537","114","31","682","1200","0","56.83","44.75"
"10","018","00","002","0243","0000","1249","969","280","69","1318","2128","0","61.94","45.54"
"10","018","00","002","0243","0201","686","520","166","36","722","1179","0","61.24","44.11"
"10","018","00","002","0243","0202","563","449","114","33","596","949","0","62.8","47.31"
"10","018","00","002","0244","0000","746","591","155","42","788","1604","0","49.13","36.85"
"10","018","00","002","0244","0150","746","591","155","42","788","1604","0","49.13","36.85"
"10","018","00","002","0245","0000","1796","1493","303","86","1882","3235","0","58.18","46.15"
"10","018","00","002","0245","0160","664","579","85","42","706","1222","0","57.77","47.38"
"10","018","00","002","0245","0161","557","459","98","22","579","1076","0","53.81","42.66"
"10","018","00","002","0245","0162","575","455","120","22","597","937","0","63.71","48.56"
"10","018","00","003","0000","0000","34299","27405","6894","1973","36272","64896","78305","55.89","42.23"
"10","018","00","003","0301","0000","1372","1092","280","136","1508","2513","0","60.01","43.45"
"10","018","00","003","0301","0271","591","466","125","68","659","1182","0","55.75","39.42"
"10","018","00","003","0301","0272","781","626","155","68","849","1331","0","63.79","47.03"
"10","018","00","003","0302","0000","2743","2136","607","156","2899","5255","0","55.17","40.65"
"10","018","00","003","0302","0266","564","428","136","42","606","1088","0","55.7","39.34"
"10","018","00","003","0302","0267","407","339","68","22","429","903","0","47.51","37.54"
"10","018","00","003","0302","0268","553","405","148","34","587","1012","0","58.0","40.02"
"10","018","00","003","0302","0269","543","430","113","34","577","1014","0","56.9","42.41"
"10","018","00","003","0302","0270","676","534","142","24","700","1238","0","56.54","43.13"
"10","018","00","003","0303","0000","1222","962","260","68","1290","2288","0","56.38","42.05"
"10","018","00","003","0303","0264","519","416","103","23","542","970","0","55.88","42.89"
"10","018","00","003","0303","0265","703","546","157","45","748","1318","0","56.75","41.43"
"10","018","00","003","0304","0000","1353","1095","258","125","1478","2371","0","62.34","46.18"
"10","018","00","003","0304","0262","727","586","141","70","797","1348","0","59.12","43.47"
"10","018","00","003","0304","0263","626","509","117","55","681","1023","0","66.57","49.76"
"10","018","00","003","0305","0000","1239","964","275","97","1336","2095","0","63.77","46.01"
"10","018","00","003","0305","0260","644","488","156","45","689","1138","0","60.54","42.88"
"10","018","00","003","0305","0261","595","476","119","52","647","957","0","67.61","49.74"
"10","018","00","003","0306","0000","1750","1355","395","101","1851","3128","0","59.18","43.32"
"10","018","00","003","0306","0257","567","440","127","19","586","1067","0","54.92","41.24"
"10","018","00","003","0306","0258","501","397","104","28","529","863","0","61.3","46.0"
"10","018","00","003","0306","0259","682","518","164","54","736","1198","0","61.44","43.24"
"10","018","00","003","0307","0000","1586","1263","323","56","1642","2881","0","56.99","43.84"
"10","018","00","003","0307","0252","817","644","173","37","854","1473","0","57.98","43.72"
"10","018","00","003","0307","0253","769","619","150","19","788","1408","0","55.97","43.96"
"10","018","00","003","0308","0000","2340","1903","437","83","2423","4517","0","53.64","42.13"
"10","018","00","003","0308","0254","597","483","114","19","616","1318","0","46.74","36.65"
"10","018","00","003","0308","0255","717","564","153","34","751","1337","0","56.17","42.18"
"10","018","00","003","0308","0256","1026","856","170","30","1056","1862","0","56.71","45.97"
"10","018","00","003","0309","0000","2573","2101","472","129","2702","4959","0","54.49","42.37"
"10","018","00","003","0309","0245","721","578","143","56","777","1443","0","53.85","40.06"
"10","018","00","003","0309","0246","645","512","133","40","685","1241","0","55.2","41.26"
"10","018","00","003","0309","0247","621","536","85","22","643","1194","0","53.85","44.89"
"10","018","00","003","0309","0248","586","475","111","11","597","1081","0","55.23","43.94"
"10","018","00","003","0310","0000","2190","1749","441","103","2293","3917","0","58.54","44.65"
"10","018","00","003","0310","0273","594","474","120","23","617","976","0","63.22","48.57"
"10","018","00","003","0310","0274","432","358","74","15","447","834","0","53.6","42.93"
"10","018","00","003","0310","0275","498","406","92","31","529","919","0","57.56","44.18"
"10","018","00","003","0310","0276","666","511","155","34","700","1188","0","58.92","43.01"
"10","018","00","003","0311","0000","1877","1532","345","121","1998","3342","0","59.78","45.84"
"10","018","00","003","0311","0277","584","480","104","41","625","1086","0","57.55","44.2"
"10","018","00","003","0311","0278","669","536","133","47","716","1144","0","62.59","46.85"
"10","018","00","003","0311","0279","624","516","108","33","657","1112","0","59.08","46.4"
"10","018","00","003","0312","0000","2364","1899","465","109","2473","4231","0","58.45","44.88"
"10","018","00","003","0312","0280","808","653","155","43","851","1476","0","57.66","44.24"
"10","018","00","003","0312","0281","690","550","140","27","717","1291","0","55.54","42.6"
"10","018","00","003","0312","0282","866","696","170","39","905","1464","0","61.82","47.54"
"10","018","00","003","0313","0000","1456","1174","282","108","1564","2763","0","56.61","42.49"
"10","018","00","003","0313","0283","742","607","135","81","823","1427","0","57.67","42.54"
"10","018","00","003","0313","0284","714","567","147","27","741","1336","0","55.46","42.44"
"10","018","00","003","0314","0000","524","387","137","35","559","1131","0","49.43","34.22"
"10","018","00","003","0314","0285","524","387","137","35","559","1131","0","49.43","34.22"
"10","018","00","003","0315","0000","1145","912","233","121","1266","2076","0","60.98","43.93"
"10","018","00","003","0315","0286","586","464","122","63","649","1070","0","60.65","43.36"
"10","018","00","003","0315","0287","559","448","111","58","617","1006","0","61.33","44.53"
"10","018","00","003","0316","0000","1121","914","207","46","1167","2342","0","49.83","39.03"
"10","018","00","003","0316","0288","540","442","98","21","561","1223","0","45.87","36.14"
"10","018","00","003","0316","0289","581","472","109","25","606","1119","0","54.16","42.18"
"10","018","00","003","0317","0000","428","339","89","19","447","896","0","49.89","37.83"
"10","018","00","003","0317","0299","428","339","89","19","447","896","0","49.89","37.83"
"10","018","00","003","0318","0000","480","382","98","33","513","890","0","57.64","42.92"
"10","018","00","003","0318","0298","480","382","98","33","513","890","0","57.64","42.92"
"10","018","00","003","0319","0000","399","331","68","29","428","776","0","55.15","42.65"
"10","018","00","003","0319","0297","399","331","68","29","428","776","0","55.15","42.65"
"10","018","00","003","0320","0000","862","684","178","38","900","1784","0","50.45","38.34"
"10","018","00","003","0320","0295","379","301","78","21","400","719","0","55.63","41.86"
"10","018","00","003","0320","0296","483","383","100","17","500","1065","0","46.95","35.96"
"10","018","00","003","0321","0000","2002","1606","396","108","2110","4325","0","48.79","37.13"
"10","018","00","003","0321","0291","721","579","142","30","751","1627","0","46.16","35.59"
"10","018","00","003","0321","0292","609","489","120","35","644","1289","0","49.96","37.94"
"10","018","00","003","0321","0293","672","538","134","43","715","1409","0","50.75","38.18"
"10","018","00","003","0322","0000","653","517","136","31","684","1400","0","48.86","36.93"
"10","018","00","003","0322","0290","653","517","136","31","684","1400","0","48.86","36.93"
"10","018","00","003","0323","0000","395","301","94","20","415","814","0","50.98","36.98"
"10","018","00","003","0323","0294","395","301","94","20","415","814","0","50.98","36.98"
"10","018","00","003","0324","0000","2225","1807","418","101","2326","4202","0","55.35","43.0"
"10","018","00","003","0324","0249","436","364","72","21","457","807","0","56.63","45.11"
"10","018","00","003","0324","0250","905","722","183","49","954","1760","0","54.2","41.02"
"10","018","00","003","0324","0251","884","721","163","31","915","1635","0","55.96","44.1"
"10","020","00","000","0000","0000","110481","86276","24205","7639","118120","221553","268741","53.31","38.94"
"10","020","00","001","0000","0000","50417","39258","11159","3338","53755","100647","121279","53.41","39.01"
"10","020","00","001","0101","0000","2178","1725","453","148","2326","4386","0","53.03","39.33"
"10","020","00","001","0101","0079","582","436","146","59","641","1282","0","50.0","34.01"
"10","020","00","001","0101","0080","870","718","152","58","928","1571","0","59.07","45.7"
"10","020","00","001","0101","0081","726","571","155","31","757","1533","0","49.38","37.25"
"10","020","00","001","0102","0000","1413","1092","321","90","1503","3393","0","44.3","32.18"
"10","020","00","001","0102","0077","696","545","151","51","747","1823","0","40.98","29.9"
"10","020","00","001","0102","0078","717","547","170","39","756","1570","0","48.15","34.84"
"10","020","00","001","0103","0000","1324","1044","280","68","1392","2832","0","49.15","36.86"
"10","020","00","001","0103","0075","589","451","138","25","614","1404","0","43.73","32.12"
"10","020","00","001","0103","0076","735","593","142","43","778","1428","0","54.48","41.53"
"10","020","00","001","0104","0000","1591","1310","281","142","1733","3249","0","53.34","40.32"
"10","020","00","001","0104","0069","800","624","176","76","876","1682","0","52.08","37.1"
"10","020","00","001","0104","0070","791","686","105","66","857","1567","0","54.69","43.78"
"10","020","00","001","0105","0000","1152","945","207","41","1193","2188","0","54.52","43.19"
"10","020","00","001","0105","0071","616","510","106","21","637","1207","0","52.78","42.25"
"10","020","00","001","0105","0072","536","435","101","20","556","981","0","56.68","44.34"
"10","020","00","001","0134","0000","2192","1748","444","135","2327","4205","0","55.34","41.57"
"10","020","00","001","0134","0021","607","475","132","48","655","1199","0","54.63","39.62"
"10","020","00","001","0134","0022","646","523","123","27","673","1236","0","54.45","42.31"
"10","020","00","001","0134","0023","443","353","90","22","465","890","0","52.25","39.66"
"10","020","00","001","0134","0024","496","397","99","38","534","880","0","60.68","45.11"
"10","020","00","001","0135","0000","2259","1706","553","148","2407","4172","0","57.69","40.89"
"10","020","00","001","0135","0018","859","637","222","48","907","1552","0","58.44","41.04"
"10","020","00","001","0135","0019","822","631","191","63","885","1558","0","56.8","40.5"
"10","020","00","001","0135","0020","578","438","140","37","615","1062","0","57.91","41.24"
"10","020","00","001","0136","0000","1932","1530","402","102","2034","3967","0","51.27","38.57"
"10","020","00","001","0136","0015","651","497","154","47","698","1453","0","48.04","34.21"
"10","020","00","001","0136","0016","534","432","102","19","553","1094","0","50.55","39.49"
"10","020","00","001","0136","0017","747","601","146","36","783","1420","0","55.14","42.32"
"10","020","00","001","0137","0000","1236","947","289","54","1290","2334","0","55.27","40.57"
"10","020","00","001","0137","0011","665","514","151","28","693","1221","0","56.76","42.1"
"10","020","00","001","0137","0012","571","433","138","26","597","1113","0","53.64","38.9"
"10","020","00","001","0138","0000","946","749","197","60","1006","1794","0","56.08","41.75"
"10","020","00","001","0138","0005","397","308","89","34","431","702","0","61.4","43.87"
"10","020","00","001","0138","0006","549","441","108","26","575","1092","0","52.66","40.38"
"10","020","00","001","0139","0000","2244","1735","509","110","2354","4239","0","55.53","40.93"
"10","020","00","001","0139","0027","737","594","143","44","781","1435","0","54.43","41.39"
"10","020","00","001","0139","0028","776","596","180","37","813","1349","0","60.27","44.18"
"10","020","00","001","0139","0029","731","545","186","29","760","1455","0","52.23","37.46"
"10","020","00","001","0141","0000","868","696","172","67","935","1816","0","51.49","38.33"
"10","020","00","001","0141","0008","868","696","172","67","935","1816","0","51.49","38.33"
"10","020","00","001","0142","0000","436","339","97","14","450","1023","0","43.99","33.14"
"10","020","00","001","0142","0007","436","339","97","14","450","1023","0","43.99","33.14"
"10","020","00","001","0143","0000","1584","1309","275","85","1669","2847","0","58.62","45.98"
"10","020","00","001","0143","0013","778","593","185","43","821","1452","0","56.54","40.84"
"10","020","00","001","0143","0014","806","716","90","42","848","1395","0","60.79","51.33"
"10","020","00","001","0144","0000","1172","915","257","57","1229","2301","0","53.41","39.77"
"10","020","00","001","0144","0001","540","419","121","31","571","1025","0","55.71","40.88"
"10","020","00","001","0144","0002","632","496","136","26","658","1276","0","51.57","38.87"
"10","020","00","001","0145","0000","999","761","238","48","1047","1987","0","52.69","38.3"
"10","020","00","001","0145","0042","463","356","107","19","482","938","0","51.39","37.95"
"10","020","00","001","0145","0043","536","405","131","29","565","1049","0","53.86","38.61"
"10","020","00","001","0146","0000","629","483","146","75","704","1360","0","51.76","35.51"
"10","020","00","001","0146","0044","629","483","146","75","704","1360","0","51.76","35.51"
"10","020","00","001","0147","0000","693","501","192","95","788","1615","0","48.79","31.02"
"10","020","00","001","0147","0045","693","501","192","95","788","1615","0","48.79","31.02"
"10","020","00","001","0148","0000","619","452","167","53","672","1267","0","53.04","35.67"
"10","020","00","001","0148","0046","619","452","167","53","672","1267","0","53.04","35.67"
"10","020","00","001","0149","0000","1549","1201","348","145","1694","3410","0","49.68","35.22"
"10","020","00","001","0149","0047","682","522","160","71","753","1579","0","47.69","33.06"
"10","020","00","001","0149","0048","867","679","188","74","941","1831","0","51.39","37.08"
"10","020","00","001","0150","0000","1073","813","260","69","1142","2146","0","53.22","37.88"
"10","020","00","001","0150","0049","518","418","100","35","553","977","0","56.6","42.78"
"10","020","00","001","0150","0050","555","395","160","34","589","1169","0","50.38","33.79"
"10","020","00","001","0151","0000","1309","1036","273","107","1416","2504","0","56.55","41.37"
"10","020","00","001","0151","0051","652","506","146","85","737","1238","0","59.53","40.87"
"10","020","00","001","0151","0052","657","530","127","22","679","1266","0","53.63","41.86"
"10","020","00","001","0152","0000","1290","1045","245","65","1355","2717","0","49.87","38.46"
"10","020","00","001","0152","0053","618","505","113","42","660","1429","0","46.19","35.34"
"10","020","00","001","0152","0054","672","540","132","23","695","1288","0","53.96","41.93"
"10","020","00","001","0153","0000","1228","948","280","115","1343","2347","0","57.22","40.39"
"10","020","00","001","0153","0060","556","441","115","50","606","1170","0","51.79","37.69"
"10","020","00","001","0153","0061","672","507","165","65","737","1177","0","62.62","43.08"
"10","020","00","001","0154","0000","2017","1613","404","122","2139","3893","0","54.94","41.43"
"10","020","00","001","0154","0057","608","479","129","54","662","1133","0","58.43","42.28"
"10","020","00","001","0154","0058","645","522","123","47","692","1235","0","56.03","42.27"
"10","020","00","001","0154","0059","764","612","152","21","785","1525","0","51.48","40.13"
"10","020","00","001","0155","0000","1891","1466","425","175","2066","3667","0","56.34","39.98"
"10","020","00","001","0155","0062","618","494","124","55","673","1207","0","55.76","40.93"
"10","020","00","001","0155","0063","673","528","145","50","723","1272","0","56.84","41.51"
"10","020","00","001","0155","0064","600","444","156","70","670","1188","0","56.4","37.37"
"10","020","00","001","0156","0000","1122","857","265","134","1256","2101","0","59.78","40.79"
"10","020","00","001","0156","0040","558","440","118","54","612","1023","0","59.82","43.01"
"10","020","00","001","0156","0041","564","417","147","80","644","1078","0","59.74","38.68"
"10","020","00","001","0157","0000","838","648","190","81","919","1824","0","50.38","35.53"
"10","020","00","001","0157","0038","512","402","110","53","565","961","0","58.79","41.83"
"10","020","00","001","0157","0039","326","246","80","28","354","863","0","41.02","28.51"
"10","020","00","001","0158","0000","939","696","243","58","997","2058","0","48.45","33.82"
"10","020","00","001","0158","0036","428","322","106","25","453","967","0","46.85","33.3"
"10","020","00","001","0158","0037","511","374","137","33","544","1091","0","49.86","34.28"
"10","020","00","001","0159","0000","1003","745","258","68","1071","2021","0","52.99","36.86"
"10","020","00","001","0159","0032","481","354","127","45","526","941","0","55.9","37.62"
"10","020","00","001","0159","0033","522","391","131","23","545","1080","0","50.46","36.2"
"10","020","00","001","0160","0000","964","719","245","69","1033","1867","0","55.33","38.51"
"10","020","00","001","0160","0030","485","371","114","39","524","915","0","57.27","40.55"
"10","020","00","001","0160","0031","479","348","131","30","509","952","0","53.47","36.55"
"10","020","00","001","0161","0000","974","745","229","32","1006","1858","0","54.14","40.1"
"10","020","00","001","0161","0025","611","474","137","19","630","1189","0","52.99","39.87"
"10","020","00","001","0161","0026","363","271","92","13","376","669","0","56.2","40.51"
"10","020","00","001","0162","0000","1089","831","258","47","1136","2210","0","51.4","37.6"
"10","020","00","001","0162","0034","513","395","118","24","537","1157","0","46.41","34.14"
"10","020","00","001","0162","0035","576","436","140","23","599","1053","0","56.89","41.41"
"10","020","00","001","0163","0000","1285","981","304","94","1379","2343","0","58.86","41.87"
"10","020","00","001","0163","0067","704","554","150","55","759","1332","0","56.98","41.59"
"10","020","00","001","0163","0068","581","427","154","39","620","1011","0","61.33","42.24"
"10","020","00","001","0164","0000","1104","839","265","67","1171","2192","0","53.42","38.28"
"10","020","00","001","0164","0065","547","423","124","29","576","1172","0","49.15","36.09"
"10","020","00","001","0164","0066","557","416","141","38","595","1020","0","58.33","40.78"
"10","020","00","001","0165","0000","1123","870","253","90","1213","2149","0","56.44","40.48"
"10","020","00","001","0165","0003","452","348","104","43","495","974","0","50.82","35.73"
"10","020","00","001","0165","0004","671","522","149","47","718","1175","0","61.11","44.43"
"10","020","00","001","0166","0000","1900","1486","414","90","1990","3634","0","54.76","40.89"
"10","020","00","001","0166","0009","996","782","214","64","1060","1936","0","54.75","40.39"
"10","020","00","001","0166","0010","904","704","200","26","930","1698","0","54.77","41.46"
"10","020","00","001","0167","0000","946","728","218","56","1002","1902","0","52.68","38.28"
"10","020","00","001","0167","0055","504","384","120","34","538","980","0","54.9","39.18"
"10","020","00","001","0167","0056","442","344","98","22","464","922","0","50.33","37.31"
"10","020","00","001","0168","0000","1306","1004","302","62","1368","2829","0","48.36","35.49"
"10","020","00","001","0168","0073","677","539","138","48","725","1395","0","51.97","38.64"
"10","020","00","001","0168","0074","629","465","164","14","643","1434","0","44.84","32.43"
"10","020","00","002","0000","0000","60064","47018","13046","4301","64365","120906","147462","53.24","38.89"
"10","020","00","002","0201","0000","387","291","96","60","447","770","0","58.05","37.79"
"10","020","00","002","0201","0152","387","291","96","60","447","770","0","58.05","37.79"
"10","020","00","002","0202","0000","984","753","231","67","1051","2071","0","50.75","36.36"
"10","020","00","002","0202","0157","461","358","103","35","496","997","0","49.75","35.91"
"10","020","00","002","0202","0158","523","395","128","32","555","1074","0","51.68","36.78"
"10","020","00","002","0203","0000","1180","919","261","109","1289","2257","0","57.11","40.72"
"10","020","00","002","0203","0148","596","479","117","77","673","1146","0","58.73","41.8"
"10","020","00","002","0203","0149","584","440","144","32","616","1111","0","55.45","39.6"
"10","020","00","002","0205","0000","824","628","196","112","936","1970","0","47.51","31.88"
"10","020","00","002","0205","0153","455","346","109","26","481","1135","0","42.38","30.48"
"10","020","00","002","0205","0154","369","282","87","86","455","835","0","54.49","33.77"
"10","020","00","002","0209","0000","1995","1530","465","108","2103","4311","0","48.78","35.49"
"10","020","00","002","0209","0159","599","450","149","24","623","1460","0","42.67","30.82"
"10","020","00","002","0209","0160","644","508","136","33","677","1352","0","50.07","37.57"
"10","020","00","002","0209","0161","752","572","180","51","803","1499","0","53.57","38.16"
"10","020","00","002","0210","0000","2120","1633","487","246","2366","4132","0","57.26","39.52"
"10","020","00","002","0210","0168","747","555","192","105","852","1467","0","58.08","37.83"
"10","020","00","002","0210","0169","677","520","157","67","744","1431","0","51.99","36.34"
"10","020","00","002","0210","0170","696","558","138","74","770","1234","0","62.4","45.22"
"10","020","00","002","0211","0000","1484","1202","282","64","1548","3214","0","48.16","37.4"
"10","020","00","002","0211","0165","751","622","129","34","785","1674","0","46.89","37.16"
"10","020","00","002","0211","0166","733","580","153","30","763","1540","0","49.55","37.66"
"10","020","00","002","0212","0000","1415","1069","346","154","1569","2868","0","54.71","37.27"
"10","020","00","002","0212","0175","795","587","208","124","919","1546","0","59.44","37.97"
"10","020","00","002","0212","0176","620","482","138","30","650","1322","0","49.17","36.46"
"10","020","00","002","0213","0000","796","619","177","89","885","1549","0","57.13","39.96"
"10","020","00","002","0213","0177","796","619","177","89","885","1549","0","57.13","39.96"
"10","020","00","002","0214","0000","503","384","119","21","524","1155","0","45.37","33.25"
"10","020","00","002","0214","0174","503","384","119","21","524","1155","0","45.37","33.25"
"10","020","00","002","0215","0000","1110","874","236","85","1195","2120","0","56.37","41.23"
"10","020","00","002","0215","0093","580","439","141","61","641","1053","0","60.87","41.69"
"10","020","00","002","0215","0094","530","435","95","24","554","1067","0","51.92","40.77"
"10","020","00","002","0216","0000","1920","1546","374","135","2055","4105","0","50.06","37.66"
"10","020","00","002","0216","0097","544","446","98","45","589","1196","0","49.25","37.29"
"10","020","00","002","0216","0098","567","449","118","24","591","1280","0","46.17","35.08"
"10","020","00","002","0216","0099","809","651","158","66","875","1629","0","53.71","39.96"
"10","020","00","002","0217","0000","1561","1242","319","133","1694","3195","0","53.02","38.87"
"10","020","00","002","0217","0110","655","509","146","65","720","1396","0","51.58","36.46"
"10","020","00","002","0217","0111","906","733","173","68","974","1799","0","54.14","40.74"
"10","020","00","002","0218","0000","1589","1220","369","78","1667","3440","0","48.46","35.47"
"10","020","00","002","0218","0095","668","514","154","31","699","1575","0","44.38","32.63"
"10","020","00","002","0218","0096","921","706","215","47","968","1865","0","51.9","37.86"
"10","020","00","002","0219","0000","1857","1454","403","90","1947","3351","0","58.1","43.39"
"10","020","00","002","0219","0105","566","451","115","31","597","1000","0","59.7","45.1"
"10","020","00","002","0219","0106","600","469","131","24","624","1095","0","56.99","42.83"
"10","020","00","002","0219","0107","691","534","157","35","726","1256","0","57.8","42.52"
"10","020","00","002","0220","0000","1020","791","229","72","1092","1827","0","59.77","43.3"
"10","020","00","002","0220","0108","507","407","100","52","559","962","0","58.11","42.31"
"10","020","00","002","0220","0109","513","384","129","20","533","865","0","61.62","44.39"
"10","020","00","002","0221","0000","3081","2461","620","136","3217","6594","0","48.79","37.32"
"10","020","00","002","0221","0112","689","544","145","37","726","1505","0","48.24","36.15"
"10","020","00","002","0221","0113","819","657","162","65","884","1698","0","52.06","38.69"
"10","020","00","002","0221","0114","922","738","184","20","942","1854","0","50.81","39.81"
"10","020","00","002","0221","0115","651","522","129","14","665","1537","0","43.27","33.96"
"10","020","00","002","0222","0000","996","768","228","86","1082","2024","0","53.46","37.94"
"10","020","00","002","0222","0103","445","343","102","80","525","841","0","62.43","40.78"
"10","020","00","002","0222","0104","551","425","126","6","557","1183","0","47.08","35.93"
"10","020","00","002","0231","0000","979","767","212","75","1054","1994","0","52.86","38.47"
"10","020","00","002","0231","0082","433","334","99","18","451","885","0","50.96","37.74"
"10","020","00","002","0231","0083","546","433","113","57","603","1109","0","54.37","39.04"
"10","020","00","002","0245","0000","899","735","164","47","946","1625","0","58.22","45.23"
"10","020","00","002","0245","0140","442","338","104","32","474","756","0","62.7","44.71"
"10","020","00","002","0245","0141","457","397","60","15","472","869","0","54.32","45.68"
"10","020","00","002","0246","0000","891","711","180","43","934","1904","0","49.05","37.34"
"10","020","00","002","0246","0138","329","271","58","24","353","736","0","47.96","36.82"
"10","020","00","002","0246","0139","562","440","122","19","581","1168","0","49.74","37.67"
"10","020","00","002","0247","0000","2984","2389","595","217","3201","5706","0","56.1","41.87"
"10","020","00","002","0247","0134","795","638","157","73","868","1548","0","56.07","41.21"
"10","020","00","002","0247","0135","646","523","123","37","683","1295","0","52.74","40.39"
"10","020","00","002","0247","0136","749","594","155","48","797","1318","0","60.47","45.07"
"10","020","00","002","0247","0137","794","634","160","59","853","1545","0","55.21","41.04"
"10","020","00","002","0248","0000","2828","2209","619","182","3010","5397","0","55.77","40.93"
"10","020","00","002","0248","0130","714","576","138","35","749","1185","0","63.21","48.61"
"10","020","00","002","0248","0131","705","519","186","60","765","1278","0","59.86","40.61"
"10","020","00","002","0248","0132","592","464","128","28","620","1394","0","44.48","33.29"
"10","020","00","002","0248","0133","817","650","167","59","876","1540","0","56.88","42.21"
"10","020","00","002","0249","0000","2223","1732","491","159","2382","4343","0","54.85","39.88"
"10","020","00","002","0249","0120","690","536","154","50","740","1362","0","54.33","39.35"
"10","020","00","002","0249","0121","658","515","143","39","697","1279","0","54.5","40.27"
"10","020","00","002","0249","0122","875","681","194","70","945","1702","0","55.52","40.01"
"10","020","00","002","0250","0000","1998","1578","420","196","2194","3715","0","59.06","42.48"
"10","020","00","002","0250","0117","533","431","102","61","594","944","0","62.92","45.66"
"10","020","00","002","0250","0118","844","657","187","83","927","1627","0","56.98","40.38"
"10","020","00","002","0250","0119","621","490","131","52","673","1144","0","58.83","42.83"
"10","020","00","002","0251","0000","954","748","206","93","1047","1811","0","57.81","41.3"
"10","020","00","002","0251","0142","530","412","118","48","578","983","0","58.8","41.91"
"10","020","00","002","0251","0143","424","336","88","45","469","828","0","56.64","40.58"
"10","020","00","002","0252","0000","938","797","141","40","978","1775","0","55.1","44.9"
"10","020","00","002","0252","0144","938","797","141","40","978","1775","0","55.1","44.9"
"10","020","00","002","0253","0000","2593","2087","506","146","2739","4992","0","54.87","41.81"
"10","020","00","002","0253","0126","716","576","140","43","759","1280","0","59.3","45.0"
"10","020","00","002","0253","0127","555","435","120","30","585","1220","0","47.95","35.66"
"10","020","00","002","0253","0128","636","513","123","28","664","1172","0","56.66","43.77"
"10","020","00","002","0253","0129","686","563","123","45","731","1320","0","55.38","42.65"
"10","020","00","002","0254","0000","722","607","115","41","763","1419","0","53.77","42.78"
"10","020","00","002","0254","0145","722","607","115","41","763","1419","0","53.77","42.78"
"10","020","00","002","0255","0000","732","629","103","89","821","1604","0","51.18","39.21"
"10","020","00","002","0255","0116","732","629","103","89","821","1604","0","51.18","39.21"
"10","020","00","002","0256","0000","981","757","224","86","1067","1945","0","54.86","38.92"
"10","020","00","002","0256","0084","448","320","128","42","490","1020","0","48.04","31.37"
"10","020","00","002","0256","0085","533","437","96","44","577","925","0","62.38","47.24"
"10","020","00","002","0257","0000","676","486","190","34","710","1671","0","42.49","29.08"
"10","020","00","002","0257","0086","676","486","190","34","710","1671","0","42.49","29.08"
"10","020","00","002","0258","0000","1113","850","263","51","1164","2251","0","51.71","37.76"
"10","020","00","002","0258","0087","614","471","143","29","643","1215","0","52.92","38.77"
"10","020","00","002","0258","0088","499","379","120","22","521","1036","0","50.29","36.58"
"10","020","00","002","0259","0000","1065","786","279","60","1125","2256","0","49.87","34.84"
"10","020","00","002","0259","0089","526","389","137","32","558","1129","0","49.42","34.46"
"10","020","00","002","0259","0090","539","397","142","28","567","1127","0","50.31","35.23"
"10","020","00","002","0260","0000","653","501","152","26","679","1366","0","49.71","36.68"
"10","020","00","002","0260","0092","653","501","152","26","679","1366","0","49.71","36.68"
"10","020","00","002","0261","0000","695","507","188","42","737","1415","0","52.08","35.83"
"10","020","00","002","0261","0091","695","507","188","42","737","1415","0","52.08","35.83"
"10","020","00","002","0262","0000","769","602","167","30","799","1634","0","48.9","36.84"
"10","020","00","002","0262","0146","378","288","90","13","391","779","0","50.19","36.97"
"10","020","00","002","0262","0147","391","314","77","17","408","855","0","47.72","36.73"
"10","020","00","002","0263","0000","802","627","175","74","876","1584","0","55.3","39.58"
"10","020","00","002","0263","0150","444","342","102","48","492","767","0","64.15","44.59"
"10","020","00","002","0263","0151","358","285","73","26","384","817","0","47.0","34.88"
"10","020","00","002","0264","0000","913","690","223","82","995","2126","0","46.8","32.46"
"10","020","00","002","0264","0155","514","406","108","43","557","1182","0","47.12","34.35"
"10","020","00","002","0264","0156","399","284","115","39","438","944","0","46.4","30.08"
"10","020","00","002","0265","0000","2079","1614","465","146","2225","4164","0","53.43","38.76"
"10","020","00","002","0265","0100","728","558","170","75","803","1393","0","57.65","40.06"
"10","020","00","002","0265","0101","590","452","138","35","625","1077","0","58.03","41.97"
"10","020","00","002","0265","0102","761","604","157","36","797","1694","0","47.05","35.66"
"10","020","00","002","0266","0000","1507","1190","317","120","1627","2718","0","59.86","43.78"
"10","020","00","002","0266","0123","742","589","153","54","796","1358","0","58.62","43.37"
"10","020","00","002","0266","0124","765","601","164","66","831","1360","0","61.1","44.19"
"10","020","00","002","0267","0000","832","637","195","64","896","1589","0","56.39","40.09"
"10","020","00","002","0267","0125","832","637","195","64","896","1589","0","56.39","40.09"
"10","020","00","002","0268","0000","1845","1434","411","92","1937","3598","0","53.84","39.86"
"10","020","00","002","0268","0171","608","475","133","33","641","1266","0","50.63","37.52"
"10","020","00","002","0268","0172","627","490","137","34","661","1211","0","54.58","40.46"
"10","020","00","002","0268","0173","610","469","141","25","635","1121","0","56.65","41.84"
"10","020","00","002","0269","0000","2002","1517","485","194","2196","4295","0","51.13","35.32"
"10","020","00","002","0269","0162","596","451","145","103","699","1262","0","55.39","35.74"
"10","020","00","002","0269","0163","633","483","150","30","663","1299","0","51.04","37.18"
"10","020","00","002","0269","0164","773","583","190","61","834","1734","0","48.1","33.62"
"10","020","00","002","0270","0000","569","447","122","27","596","1056","0","56.44","42.33"
"10","020","00","002","0270","0167","569","447","122","27","596","1056","0","56.44","42.33"
"09","020","00","000","0000","0000","41481","35436","6045","2336","43817","122695","138845","35.71","28.88"
"09","020","00","001","0000","0000","12549","10725","1824","634","13183","37815","43315","34.86","28.36"
"09","020","00","001","0101","0000","1735","1465","270","90","1825","4977","0","36.67","29.44"
"09","020","00","001","0101","0001","475","406","69","17","492","1396","0","35.24","29.08"
"09","020","00","001","0101","0002","657","552","105","34","691","1831","0","37.74","30.15"
"09","020","00","001","0101","0003","603","507","96","39","642","1750","0","36.69","28.97"
"09","020","00","001","0102","0000","3431","2931","500","156","3587","9882","0","36.3","29.66"
"09","020","00","001","0102","0007","508","409","99","48","556","1610","0","34.53","25.4"
"09","020","00","001","0102","0008","576","487","89","26","602","1687","0","35.68","28.87"
"09","020","00","001","0102","0009","560","481","79","20","580","1594","0","36.39","30.18"
"09","020","00","001","0102","0010","585","520","65","13","598","1726","0","34.65","30.13"
"09","020","00","001","0102","0011","608","530","78","21","629","1733","0","36.3","30.58"
"09","020","00","001","0102","0012","594","504","90","28","622","1532","0","40.6","32.9"
"09","020","00","001","0103","0000","1932","1642","290","101","2033","5465","0","37.2","30.05"
"09","020","00","001","0103","0004","680","581","99","37","717","1889","0","37.96","30.76"
"09","020","00","001","0103","0005","507","423","84","29","536","1675","0","32.0","25.25"
"09","020","00","001","0103","0006","745","638","107","35","780","1901","0","41.03","33.56"
"09","020","00","001","0104","0000","1287","1110","177","80","1367","4112","0","33.24","26.99"
"09","020","00","001","0104","0013","671","569","102","46","717","2079","0","34.49","27.37"
"09","020","00","001","0104","0014","616","541","75","34","650","2033","0","31.97","26.61"
"09","020","00","001","0105","0000","990","836","154","63","1053","3788","0","27.8","22.07"
"09","020","00","001","0105","0018","677","583","94","31","708","2435","0","29.08","23.94"
"09","020","00","001","0105","0019","313","253","60","32","345","1353","0","25.5","18.7"
"09","020","00","001","0106","0000","704","598","106","31","735","2140","0","34.35","27.94"
"09","020","00","001","0106","0017","704","598","106","31","735","2140","0","34.35","27.94"
"09","020","00","001","0107","0000","940","818","122","35","975","2851","0","34.2","28.69"
"09","020","00","001","0107","0020","479","422","57","18","497","1574","0","31.58","26.81"
"09","020","00","001","0107","0021","461","396","65","17","478","1277","0","37.43","31.01"
"09","020","00","001","0108","0000","1530","1325","205","78","1608","4600","0","34.96","28.8"
"09","020","00","001","0108","0015","836","731","105","46","882","2517","0","35.04","29.04"
"09","020","00","001","0108","0016","694","594","100","32","726","2083","0","34.85","28.52"
"09","020","00","002","0000","0000","6129","5261","868","431","6560","18560","20751","35.34","28.35"
"09","020","00","002","0201","0000","1687","1434","253","136","1823","5106","0","35.7","28.08"
"09","020","00","002","0201","0066","600","491","109","54","654","1909","0","34.26","25.72"
"09","020","00","002","0201","0067","586","511","75","39","625","1524","0","41.01","33.53"
"09","020","00","002","0201","0068","501","432","69","43","544","1673","0","32.52","25.82"
"09","020","00","002","0202","0000","667","595","72","34","701","1895","0","36.99","31.4"
"09","020","00","002","0202","0075","667","595","72","34","701","1895","0","36.99","31.4"
"09","020","00","002","0203","0000","436","360","76","27","463","1135","0","40.79","31.72"
"09","020","00","002","0203","0076","436","360","76","27","463","1135","0","40.79","31.72"
"09","020","00","002","0204","0000","848","750","98","49","897","2377","0","37.74","31.55"
"09","020","00","002","0204","0077","404","349","55","31","435","1252","0","34.74","27.88"
"09","020","00","002","0204","0078","444","401","43","18","462","1125","0","41.07","35.64"
"09","020","00","002","0205","0000","612","532","80","48","660","2003","0","32.95","26.56"
"09","020","00","002","0205","0069","612","532","80","48","660","2003","0","32.95","26.56"
"09","020","00","002","0206","0000","452","391","61","27","479","1540","0","31.1","25.39"
"09","020","00","002","0206","0072","452","391","61","27","479","1540","0","31.1","25.39"
"09","020","00","002","0207","0000","580","488","92","54","634","2166","0","29.27","22.53"
"09","020","00","002","0207","0073","337","283","54","39","376","1216","0","30.92","23.27"
"09","020","00","002","0207","0074","243","205","38","15","258","950","0","27.16","21.58"
"09","020","00","002","0208","0000","847","711","136","56","903","2338","0","38.62","30.41"
"09","020","00","002","0208","0070","468","399","69","25","493","1212","0","40.68","32.92"
"09","020","00","002","0208","0071","379","312","67","31","410","1126","0","36.41","27.71"
"09","020","00","003","0000","0000","8939","7615","1324","545","9484","25915","29658","36.6","29.38"
"09","020","00","003","0301","0000","1507","1276","231","123","1630","4137","0","39.4","30.84"
"09","020","00","003","0301","0049","507","415","92","33","540","1348","0","40.06","30.79"
"09","020","00","003","0301","0050","433","364","69","53","486","1386","0","35.06","26.26"
"09","020","00","003","0301","0051","567","497","70","37","604","1403","0","43.05","35.42"
"09","020","00","003","0302","0000","1164","971","193","67","1231","3264","0","37.71","29.75"
"09","020","00","003","0302","0052","645","553","92","28","673","1771","0","38.0","31.23"
"09","020","00","003","0302","0053","519","418","101","39","558","1493","0","37.37","28.0"
"09","020","00","003","0303","0000","820","693","127","64","884","2618","0","33.77","26.47"
"09","020","00","003","0303","0062","383","327","56","29","412","1236","0","33.33","26.46"
"09","020","00","003","0303","0063","437","366","71","35","472","1382","0","34.15","26.48"
"09","020","00","003","0304","0000","625","540","85","45","670","2006","0","33.4","26.92"
"09","020","00","003","0304","0056","625","540","85","45","670","2006","0","33.4","26.92"
"09","020","00","003","0305","0000","1001","851","150","54","1055","3145","0","33.55","27.06"
"09","020","00","003","0305","0064","540","459","81","20","560","1631","0","34.33","28.14"
"09","020","00","003","0305","0065","461","392","69","34","495","1514","0","32.69","25.89"
"09","020","00","003","0306","0000","2747","2331","416","120","2867","7628","0","37.59","30.56"
"09","020","00","003","0306","0057","618","516","102","23","641","1780","0","36.01","28.99"
"09","020","00","003","0306","0058","614","533","81","21","635","1739","0","36.52","30.65"
"09","020","00","003","0306","0059","453","386","67","25","478","1384","0","34.54","27.89"
"09","020","00","003","0306","0060","499","428","71","29","528","1400","0","37.71","30.57"
"09","020","00","003","0306","0061","563","468","95","22","585","1325","0","44.15","35.32"
"09","020","00","003","0307","0000","501","444","57","34","535","1510","0","35.43","29.4"
"09","020","00","003","0307","0054","501","444","57","34","535","1510","0","35.43","29.4"
"09","020","00","003","0308","0000","574","509","65","38","612","1607","0","38.08","31.67"
"09","020","00","003","0308","0055","574","509","65","38","612","1607","0","38.08","31.67"
"09","020","00","004","0000","0000","9658","8151","1507","503","10161","28162","31588","36.08","28.94"
"09","020","00","004","0401","0000","950","791","159","75","1025","3272","0","31.33","24.17"
"09","020","00","004","0401","0022","495","417","78","46","541","1735","0","31.18","24.03"
"09","020","00","004","0401","0023","455","374","81","29","484","1537","0","31.49","24.33"
"09","020","00","004","0402","0000","1485","1251","234","95","1580","4507","0","35.06","27.76"
"09","020","00","004","0402","0024","552","454","98","39","591","1766","0","33.47","25.71"
"09","020","00","004","0402","0025","367","311","56","8","375","1015","0","36.95","30.64"
"09","020","00","004","0402","0026","566","486","80","48","614","1726","0","35.57","28.16"
"09","020","00","004","0403","0000","479","410","69","26","505","1537","0","32.86","26.68"
"09","020","00","004","0403","0038","479","410","69","26","505","1537","0","32.86","26.68"
"09","020","00","004","0404","0000","2661","2234","427","105","2766","7318","0","37.8","30.53"
"09","020","00","004","0404","0027","499","417","82","34","533","1691","0","31.52","24.66"
"09","020","00","004","0404","0028","828","637","191","37","865","2044","0","42.32","31.16"
"09","020","00","004","0404","0029","730","653","77","34","764","1848","0","41.34","35.34"
"09","020","00","004","0404","0030","604","527","77","0","604","1735","0","34.81","30.37"
"09","020","00","004","0405","0000","1622","1396","226","97","1719","5157","0","33.33","27.07"
"09","020","00","004","0405","0031","596","510","86","31","627","1795","0","34.93","28.41"
"09","020","00","004","0405","0032","540","467","73","42","582","1834","0","31.73","25.46"
"09","020","00","004","0405","0033","486","419","67","24","510","1528","0","33.38","27.42"
"09","020","00","004","0406","0000","2461","2069","392","105","2566","6371","0","40.28","32.48"
"09","020","00","004","0406","0034","545","483","62","23","568","1473","0","38.56","32.79"
"09","020","00","004","0406","0035","562","490","72","38","600","1679","0","35.74","29.18"
"09","020","00","004","0406","0036","903","707","196","28","931","1921","0","48.46","36.8"
"09","020","00","004","0406","0037","451","389","62","16","467","1298","0","35.98","29.97"
"09","020","00","005","0000","0000","4052","3546","506","212","4264","11676","12847","36.52","30.37"
"09","020","00","005","0501","0000","983","857","126","47","1030","2841","0","36.25","30.17"
"09","020","00","005","0501","0045","498","425","73","27","525","1412","0","37.18","30.1"
"09","020","00","005","0501","0046","485","432","53","20","505","1429","0","35.34","30.23"
"09","020","00","005","0502","0000","474","409","65","22","496","1425","0","34.81","28.7"
"09","020","00","005","0502","0044","474","409","65","22","496","1425","0","34.81","28.7"
"09","020","00","005","0503","0000","749","639","110","46","795","2395","0","33.19","26.68"
"09","020","00","005","0503","0042","416","355","61","24","440","1296","0","33.95","27.39"
"09","020","00","005","0503","0043","333","284","49","22","355","1099","0","32.3","25.84"
"09","020","00","005","0504","0000","1275","1141","134","64","1339","3380","0","39.62","33.76"
"09","020","00","005","0504","0039","692","630","62","30","722","1647","0","43.84","38.25"
"09","020","00","005","0504","0040","583","511","72","34","617","1733","0","35.6","29.49"
"09","020","00","005","0505","0000","571","500","71","33","604","1635","0","36.94","30.58"
"09","020","00","005","0505","0041","571","500","71","33","604","1635","0","36.94","30.58"
"09","020","00","006","0000","0000","154","138","16","11","165","567","686","29.1","24.34"
"09","020","00","006","0601","0000","75","68","7","3","78","275","0","28.36","24.73"
"09","020","00","006","0601","0047","75","68","7","3","78","275","0","28.36","24.73"
"09","020","00","006","0602","0000","79","70","9","8","87","292","0","29.79","23.97"
"09","020","00","006","0602","0048","79","70","9","8","87","292","0","29.79","23.97"
"09","007","00","000","0000","0000","5498","4843","655","235","5733","11205","13062","51.16","43.22"
"09","007","00","001","0000","0000","3140","2773","367","133","3273","6461","7657","50.66","42.92"
"09","007","00","001","0101","0000","974","859","115","39","1013","1967","0","51.5","43.67"
"09","007","00","001","0101","0001","974","859","115","39","1013","1967","0","51.5","43.67"
"09","007","00","001","01x2","0000","828","723","105","50","878","1837","0","47.8","39.36"
"09","007","00","001","01x2","0002","828","723","105","50","878","1837","0","47.8","39.36"
"09","007","00","001","01x4","0000","568","491","77","20","588","1114","0","52.78","44.08"
"09","007","00","001","01x4","0003","568","491","77","20","588","1114","0","52.78","44.08"
"09","007","00","001","01x5","0000","770","700","70","24","794","1543","0","51.46","45.37"
"09","007","00","001","01x5","0004","770","700","70","24","794","1543","0","51.46","45.37"
"09","007","00","002","0000","0000","1055","914","141","47","1102","2125","2430","51.86","43.01"
"09","007","00","002","02x1","0000","777","664","113","37","814","1515","0","53.73","43.83"
"09","007","00","002","02x1","0005","777","664","113","37","814","1515","0","53.73","43.83"
"09","007","00","002","02x4","0000","278","250","28","10","288","610","0","47.21","40.98"
"09","007","00","002","02x4","0006","278","250","28","10","288","610","0","47.21","40.98"
"09","007","00","003","0000","0000","739","644","95","40","779","1481","1627","52.6","43.48"
"09","007","00","003","03x1","0000","317","279","38","18","335","698","0","47.99","39.97"
"09","007","00","003","03x1","0007","317","279","38","18","335","698","0","47.99","39.97"
"09","007","00","003","03x4","0000","422","365","57","22","444","783","0","56.7","46.62"
"09","007","00","003","03x4","0008","422","365","57","22","444","783","0","56.7","46.62"
"09","007","00","004","0000","0000","564","512","52","15","579","1138","1348","50.88","44.99"
"09","007","00","004","04x1","0000","564","512","52","15","579","1138","0","50.88","44.99"
"09","007","00","004","04x1","0009","564","512","52","15","579","1138","0","50.88","44.99"
