"prv_code","city_code","area_code","dept_code","li_code","tbox_no","valid_ticket","agree_ticket","disagree_ticket","invalid_ticket","vote_ticket","votable_population","population","vote_to_votable","agree_to_votable"
"00","000","00","000","0000","0000","10537642","4763086","5774556","505153","11042795","19757067","23580833","55.89","24.11"
"63","000","00","000","0000","0000","1251684","549973","701711","49738","1301422","2228430","2669874","58.4","24.68"
"63","000","00","001","0000","0000","97363","40881","56482","3680","101043","169278","205826","59.69","24.15"
"63","000","00","001","0102","0000","2620","1115","1505","123","2743","4660","0","58.86","23.93"
"63","000","00","001","0102","0527","927","400","527","35","962","1583","0","60.77","25.27"
"63","000","00","001","0102","0528","934","426","508","53","987","1691","0","58.37","25.19"
"63","000","00","001","0102","0529","759","289","470","35","794","1386","0","57.29","20.85"
"63","000","00","001","0103","0000","4119","1869","2250","160","4279","6767","0","63.23","27.62"
"63","000","00","001","0103","0530","790","348","442","38","828","1362","0","60.79","25.55"
"63","000","00","001","0103","0531","817","340","477","29","846","1399","0","60.47","24.3"
"63","000","00","001","0103","0532","884","450","434","34","918","1324","0","69.34","33.99"
"63","000","00","001","0103","0533","789","359","430","39","828","1296","0","63.89","27.7"
"63","000","00","001","0103","0534","839","372","467","20","859","1386","0","61.98","26.84"
"63","000","00","001","0104","0000","3428","1415","2013","131","3559","5950","0","59.82","23.78"
"63","000","00","001","0104","0535","933","403","530","38","971","1529","0","63.51","26.36"
"63","000","00","001","0104","0536","800","303","497","30","830","1416","0","58.62","21.4"
"63","000","00","001","0104","0537","884","344","540","31","915","1619","0","56.52","21.25"
"63","000","00","001","0104","0538","811","365","446","32","843","1386","0","60.82","26.33"
"63","000","00","001","0105","0000","2481","1091","1390","84","2565","4033","0","63.6","27.05"
"63","000","00","001","0105","0539","878","371","507","24","902","1380","0","65.36","26.88"
"63","000","00","001","0105","0540","810","380","430","31","841","1357","0","61.97","28.0"
"63","000","00","001","0105","0541","793","340","453","29","822","1296","0","63.43","26.23"
"63","000","00","001","0106","0000","2589","1071","1518","95","2684","4450","0","60.31","24.07"
"63","000","00","001","0106","0542","943","353","590","43","986","1632","0","60.42","21.63"
"63","000","00","001","0106","0543","804","354","450","29","833","1414","0","58.91","25.04"
"63","000","00","001","0106","0544","842","364","478","23","865","1404","0","61.61","25.93"
"63","000","00","001","0107","0000","2527","1124","1403","112","2639","4279","0","61.67","26.27"
"63","000","00","001","0107","0545","814","357","457","45","859","1365","0","62.93","26.15"
"63","000","00","001","0107","0546","839","379","460","31","870","1431","0","60.8","26.48"
"63","000","00","001","0107","0547","874","388","486","36","910","1483","0","61.36","26.16"
"63","000","00","001","0108","0000","2354","919","1435","87","2441","4010","0","60.87","22.92"
"63","000","00","001","0108","0548","791","341","450","33","824","1293","0","63.73","26.37"
"63","000","00","001","0108","0549","793","295","498","24","817","1410","0","57.94","20.92"
"63","000","00","001","0108","0550","770","283","487","30","800","1307","0","61.21","21.65"
"63","000","00","001","0109","0000","2279","988","1291","87","2366","3710","0","63.77","26.63"
"63","000","00","001","0109","0551","765","356","409","31","796","1242","0","64.09","28.66"
"63","000","00","001","0109","0552","738","303","435","21","759","1192","0","63.67","25.42"
"63","000","00","001","0109","0553","776","329","447","35","811","1276","0","63.56","25.78"
"63","000","00","001","0110","0000","2176","893","1283","60","2236","3676","0","60.83","24.29"
"63","000","00","001","0110","0554","689","291","398","18","707","1201","0","58.87","24.23"
"63","000","00","001","0110","0555","776","303","473","25","801","1318","0","60.77","22.99"
"63","000","00","001","0110","0556","711","299","412","17","728","1157","0","62.92","25.84"
"63","000","00","001","0111","0000","3614","1515","2099","116","3730","6311","0","59.1","24.01"
"63","000","00","001","0111","0557","666","278","388","9","675","1157","0","58.34","24.03"
"63","000","00","001","0111","0558","809","344","465","26","835","1357","0","61.53","25.35"
"63","000","00","001","0111","0559","646","292","354","32","678","1215","0","55.8","24.03"
"63","000","00","001","0111","0560","763","284","479","26","789","1345","0","58.66","21.12"
"63","000","00","001","0111","0561","730","317","413","23","753","1237","0","60.87","25.63"
"63","000","00","001","0112","0000","5008","1607","3401","204","5212","8478","0","61.48","18.95"
"63","000","00","001","0112","0562","841","223","618","34","875","1393","0","62.81","16.01"
"63","000","00","001","0112","0563","819","386","433","43","862","1331","0","64.76","29.0"
"63","000","00","001","0112","0564","944","364","580","26","970","1550","0","62.58","23.48"
"63","000","00","001","0112","0565","718","145","573","29","747","1308","0","57.11","11.09"
"63","000","00","001","0112","0566","823","187","636","42","865","1490","0","58.05","12.55"
"63","000","00","001","0112","0567","863","302","561","30","893","1406","0","63.51","21.48"
"63","000","00","001","0113","0000","1410","643","767","38","1448","2286","0","63.34","28.13"
"63","000","00","001","0113","0568","751","351","400","21","772","1191","0","64.82","29.47"
"63","000","00","001","0113","0569","659","292","367","17","676","1095","0","61.74","26.67"
"63","000","00","001","0114","0000","2109","972","1137","83","2192","3688","0","59.44","26.36"
"63","000","00","001","0114","0570","689","312","377","28","717","1198","0","59.85","26.04"
"63","000","00","001","0114","0571","722","333","389","29","751","1265","0","59.37","26.32"
"63","000","00","001","0114","0572","698","327","371","26","724","1225","0","59.1","26.69"
"63","000","00","001","0115","0000","3056","1238","1818","118","3174","5271","0","60.22","23.49"
"63","000","00","001","0115","0573","1013","401","612","47","1060","1698","0","62.43","23.62"
"63","000","00","001","0115","0574","1010","362","648","41","1051","1819","0","57.78","19.9"
"63","000","00","001","0115","0575","1033","475","558","30","1063","1754","0","60.6","27.08"
"63","000","00","001","0116","0000","4583","2078","2505","148","4731","7675","0","61.64","27.07"
"63","000","00","001","0116","0576","835","403","432","18","853","1361","0","62.67","29.61"
"63","000","00","001","0116","0577","734","308","426","18","752","1189","0","63.25","25.9"
"63","000","00","001","0116","0578","719","316","403","30","749","1214","0","61.7","26.03"
"63","000","00","001","0116","0579","748","335","413","28","776","1284","0","60.44","26.09"
"63","000","00","001","0116","0580","779","353","426","33","812","1297","0","62.61","27.22"
"63","000","00","001","0116","0581","768","363","405","21","789","1330","0","59.32","27.29"
"63","000","00","001","0117","0000","3315","1305","2010","130","3445","5685","0","60.6","22.96"
"63","000","00","001","0117","0582","817","306","511","44","861","1396","0","61.68","21.92"
"63","000","00","001","0117","0583","848","298","550","19","867","1480","0","58.58","20.14"
"63","000","00","001","0117","0584","836","337","499","31","867","1419","0","61.1","23.75"
"63","000","00","001","0117","0585","814","364","450","36","850","1390","0","61.15","26.19"
"63","000","00","001","0118","0000","3249","1583","1666","135","3384","7127","0","47.48","22.21"
"63","000","00","001","0118","0588","883","427","456","24","907","2677","0","33.88","15.95"
"63","000","00","001","0118","0589","751","368","383","32","783","1281","0","61.12","28.73"
"63","000","00","001","0118","0590","695","352","343","29","724","1469","0","49.29","23.96"
"63","000","00","001","0118","0591","920","436","484","50","970","1700","0","57.06","25.65"
"63","000","00","001","0119","0000","4172","1865","2307","185","4357","7443","0","58.54","25.06"
"63","000","00","001","0119","0592","823","365","458","22","845","1503","0","56.22","24.28"
"63","000","00","001","0119","0593","735","323","412","38","773","1309","0","59.05","24.68"
"63","000","00","001","0119","0594","788","338","450","52","840","1376","0","61.05","24.56"
"63","000","00","001","0119","0595","941","409","532","38","979","1654","0","59.19","24.73"
"63","000","00","001","0119","0596","885","430","455","35","920","1601","0","57.46","26.86"
"63","000","00","001","0120","0000","2845","1087","1758","122","2967","4845","0","61.24","22.44"
"63","000","00","001","0120","0597","860","259","601","27","887","1496","0","59.29","17.31"
"63","000","00","001","0120","0598","966","413","553","50","1016","1598","0","63.58","25.84"
"63","000","00","001","0120","0599","1019","415","604","45","1064","1751","0","60.77","23.7"
"63","000","00","001","0121","0000","5121","1468","3653","201","5322","8544","0","62.29","17.18"
"63","000","00","001","0121","0600","936","258","678","38","974","1557","0","62.56","16.57"
"63","000","00","001","0121","0601","1077","317","760","42","1119","1686","0","66.37","18.8"
"63","000","00","001","0121","0602","1003","193","810","50","1053","1707","0","61.69","11.31"
"63","000","00","001","0121","0603","1160","365","795","36","1196","1854","0","64.51","19.69"
"63","000","00","001","0121","0604","945","335","610","35","980","1740","0","56.32","19.25"
"63","000","00","001","0122","0000","4277","1792","2485","165","4442","7404","0","59.99","24.2"
"63","000","00","001","0122","0605","847","376","471","43","890","1494","0","59.57","25.17"
"63","000","00","001","0122","0606","848","330","518","33","881","1453","0","60.63","22.71"
"63","000","00","001","0122","0607","851","345","506","27","878","1458","0","60.22","23.66"
"63","000","00","001","0122","0608","863","365","498","37","900","1536","0","58.59","23.76"
"63","000","00","001","0122","0609","868","376","492","25","893","1463","0","61.04","25.7"
"63","000","00","001","0124","0000","3738","1706","2032","122","3860","7047","0","54.78","24.21"
"63","000","00","001","0124","0610","929","416","513","22","951","1790","0","53.13","23.24"
"63","000","00","001","0124","0611","973","460","513","27","1000","1679","0","59.56","27.4"
"63","000","00","001","0124","0612","892","392","500","41","933","1785","0","52.27","21.96"
"63","000","00","001","0124","0613","944","438","506","32","976","1793","0","54.43","24.43"
"63","000","00","001","0125","0000","3261","1331","1930","146","3407","5573","0","61.13","23.88"
"63","000","00","001","0125","0614","786","313","473","40","826","1381","0","59.81","22.66"
"63","000","00","001","0125","0615","745","298","447","30","775","1279","0","60.59","23.3"
"63","000","00","001","0125","0616","972","400","572","50","1022","1681","0","60.8","23.8"
"63","000","00","001","0125","0617","758","320","438","26","784","1232","0","63.64","25.97"
"63","000","00","001","0126","0000","4409","1996","2413","145","4554","7803","0","58.36","25.58"
"63","000","00","001","0126","0618","867","385","482","26","893","1533","0","58.25","25.11"
"63","000","00","001","0126","0619","920","427","493","38","958","1540","0","62.21","27.73"
"63","000","00","001","0126","0620","954","427","527","35","989","1716","0","57.63","24.88"
"63","000","00","001","0126","0621","906","427","479","27","933","1664","0","56.07","25.66"
"63","000","00","001","0126","0622","762","330","432","19","781","1350","0","57.85","24.44"
"63","000","00","001","0127","0000","1820","790","1030","89","1909","3395","0","56.23","23.27"
"63","000","00","001","0127","0623","1018","434","584","35","1053","1837","0","57.32","23.63"
"63","000","00","001","0127","0624","802","356","446","54","856","1558","0","54.94","22.85"
"63","000","00","001","0128","0000","1695","785","910","54","1749","2894","0","60.44","27.13"
"63","000","00","001","0128","0625","861","413","448","27","888","1420","0","62.54","29.08"
"63","000","00","001","0128","0626","834","372","462","27","861","1474","0","58.41","25.24"
"63","000","00","001","0129","0000","1866","796","1070","71","1937","3317","0","58.4","24.0"
"63","000","00","001","0129","0627","881","405","476","37","918","1591","0","57.7","25.46"
"63","000","00","001","0129","0628","985","391","594","34","1019","1726","0","59.04","22.65"
"63","000","00","001","0130","0000","3295","1471","1824","114","3409","5792","0","58.86","25.4"
"63","000","00","001","0130","0629","820","352","468","31","851","1452","0","58.61","24.24"
"63","000","00","001","0130","0630","820","380","440","32","852","1482","0","57.49","25.64"
"63","000","00","001","0130","0631","861","369","492","23","884","1460","0","60.55","25.27"
"63","000","00","001","0130","0632","794","370","424","28","822","1398","0","58.8","26.47"
"63","000","00","001","0131","0000","1578","653","925","52","1630","2649","0","61.53","24.65"
"63","000","00","001","0131","0633","849","351","498","29","878","1423","0","61.7","24.67"
"63","000","00","001","0131","0634","729","302","427","23","752","1226","0","61.34","24.63"
"63","000","00","001","0132","0000","2195","822","1373","73","2268","3761","0","60.3","21.86"
"63","000","00","001","0132","0635","671","256","415","32","703","1158","0","60.71","22.11"
"63","000","00","001","0132","0636","805","310","495","20","825","1426","0","57.85","21.74"
"63","000","00","001","0132","0637","719","256","463","21","740","1177","0","62.87","21.75"
"63","000","00","001","0133","0000","3094","1457","1637","118","3212","5355","0","59.98","27.21"
"63","000","00","001","0133","0638","786","390","396","20","806","1363","0","59.13","28.61"
"63","000","00","001","0133","0639","740","343","397","34","774","1240","0","62.42","27.66"
"63","000","00","001","0133","0640","759","356","403","39","798","1375","0","58.04","25.89"
"63","000","00","001","0133","0641","809","368","441","25","834","1377","0","60.57","26.72"
"63","000","00","001","0134","0000","1297","575","722","47","1344","2242","0","59.95","25.65"
"63","000","00","001","0134","0642","671","293","378","20","691","1225","0","56.41","23.92"
"63","000","00","001","0134","0643","626","282","344","27","653","1017","0","64.21","27.73"
"63","000","00","001","0135","0000","1783","861","922","65","1848","3158","0","58.52","27.26"
"63","000","00","001","0135","0586","888","429","459","33","921","1525","0","60.39","28.13"
"63","000","00","001","0135","0587","895","432","463","32","927","1633","0","56.77","26.45"
"63","000","00","002","0000","0000","107483","45488","61995","4139","111622","190444","223594","58.61","23.89"
"63","000","00","002","0201","0000","2433","759","1674","83","2516","5151","0","48.84","14.74"
"63","000","00","002","0201","0644","794","247","547","24","818","2476","0","33.04","9.98"
"63","000","00","002","0201","0645","859","257","602","21","880","1381","0","63.72","18.61"
"63","000","00","002","0201","0646","780","255","525","38","818","1294","0","63.21","19.71"
"63","000","00","002","0202","0000","2318","905","1413","80","2398","3949","0","60.72","22.92"
"63","000","00","002","0202","0647","775","312","463","23","798","1351","0","59.07","23.09"
"63","000","00","002","0202","0648","752","289","463","29","781","1296","0","60.26","22.3"
"63","000","00","002","0202","0649","791","304","487","28","819","1302","0","62.9","23.35"
"63","000","00","002","0203","0000","1307","529","778","73","1380","2446","0","56.42","21.63"
"63","000","00","002","0203","0650","542","223","319","51","593","1025","0","57.85","21.76"
"63","000","00","002","0203","0651","765","306","459","22","787","1421","0","55.38","21.53"
"63","000","00","002","0204","0000","1648","659","989","51","1699","3076","0","55.23","21.42"
"63","000","00","002","0204","0652","834","329","505","26","860","1501","0","57.3","21.92"
"63","000","00","002","0204","0653","814","330","484","25","839","1575","0","53.27","20.95"
"63","000","00","002","0205","0000","1692","613","1079","51","1743","2898","0","60.14","21.15"
"63","000","00","002","0205","0654","876","296","580","21","897","1516","0","59.17","19.53"
"63","000","00","002","0205","0655","816","317","499","30","846","1382","0","61.22","22.94"
"63","000","00","002","0206","0000","2891","1271","1620","117","3008","5054","0","59.52","25.15"
"63","000","00","002","0206","0656","623","238","385","36","659","1128","0","58.42","21.1"
"63","000","00","002","0206","0657","766","346","420","37","803","1397","0","57.48","24.77"
"63","000","00","002","0206","0658","713","342","371","20","733","1161","0","63.14","29.46"
"63","000","00","002","0206","0659","789","345","444","24","813","1368","0","59.43","25.22"
"63","000","00","002","0207","0000","2725","1172","1553","105","2830","4589","0","61.67","25.54"
"63","000","00","002","0207","0660","625","256","369","17","642","1049","0","61.2","24.4"
"63","000","00","002","0207","0661","753","310","443","32","785","1308","0","60.02","23.7"
"63","000","00","002","0207","0662","695","306","389","36","731","1154","0","63.34","26.52"
"63","000","00","002","0207","0663","652","300","352","20","672","1078","0","62.34","27.83"
"63","000","00","002","0208","0000","3848","1548","2300","121","3969","6667","0","59.53","23.22"
"63","000","00","002","0208","0664","775","321","454","35","810","1375","0","58.91","23.35"
"63","000","00","002","0208","0665","847","336","511","27","874","1448","0","60.36","23.2"
"63","000","00","002","0208","0666","759","295","464","15","774","1250","0","61.92","23.6"
"63","000","00","002","0208","0667","814","360","454","16","830","1381","0","60.1","26.07"
"63","000","00","002","0208","0668","653","236","417","28","681","1213","0","56.14","19.46"
"63","000","00","002","0209","0000","5020","2015","3005","176","5196","8706","0","59.68","23.14"
"63","000","00","002","0209","0669","862","390","472","22","884","1373","0","64.38","28.4"
"63","000","00","002","0209","0670","713","285","428","23","736","1226","0","60.03","23.25"
"63","000","00","002","0209","0671","668","269","399","18","686","1117","0","61.41","24.08"
"63","000","00","002","0209","0672","670","254","416","43","713","1123","0","63.49","22.62"
"63","000","00","002","0209","0673","700","277","423","28","728","1200","0","60.67","23.08"
"63","000","00","002","0209","0674","692","267","425","19","711","1335","0","53.26","20.0"
"63","000","00","002","0209","0675","715","273","442","23","738","1332","0","55.41","20.5"
"63","000","00","002","0210","0000","1802","775","1027","90","1892","3190","0","59.31","24.29"
"63","000","00","002","0210","0676","945","399","546","47","992","1648","0","60.19","24.21"
"63","000","00","002","0210","0677","857","376","481","43","900","1542","0","58.37","24.38"
"63","000","00","002","0211","0000","2484","1144","1340","109","2593","4362","0","59.45","26.23"
"63","000","00","002","0211","0678","691","350","341","46","737","1228","0","60.02","28.5"
"63","000","00","002","0211","0679","973","404","569","33","1006","1731","0","58.12","23.34"
"63","000","00","002","0211","0680","820","390","430","30","850","1403","0","60.58","27.8"
"63","000","00","002","0212","0000","1811","794","1017","66","1877","3229","0","58.13","24.59"
"63","000","00","002","0212","0681","1038","439","599","37","1075","1929","0","55.73","22.76"
"63","000","00","002","0212","0682","773","355","418","29","802","1300","0","61.69","27.31"
"63","000","00","002","0213","0000","2393","1184","1209","94","2487","4405","0","56.46","26.88"
"63","000","00","002","0213","0683","797","394","403","23","820","1486","0","55.18","26.51"
"63","000","00","002","0213","0684","761","391","370","34","795","1532","0","51.89","25.52"
"63","000","00","002","0213","0685","835","399","436","37","872","1387","0","62.87","28.77"
"63","000","00","002","0214","0000","1927","996","931","78","2005","3536","0","56.7","28.17"
"63","000","00","002","0214","0686","644","324","320","19","663","1195","0","55.48","27.11"
"63","000","00","002","0214","0687","591","305","286","31","622","1068","0","58.24","28.56"
"63","000","00","002","0214","0688","692","367","325","28","720","1273","0","56.56","28.83"
"63","000","00","002","0215","0000","2221","1089","1132","88","2309","3898","0","59.24","27.94"
"63","000","00","002","0215","0689","816","416","400","31","847","1329","0","63.73","31.3"
"63","000","00","002","0215","0690","737","353","384","21","758","1311","0","57.82","26.93"
"63","000","00","002","0215","0691","668","320","348","36","704","1258","0","55.96","25.44"
"63","000","00","002","0216","0000","2989","1455","1534","140","3129","5022","0","62.31","28.97"
"63","000","00","002","0216","0692","731","366","365","43","774","1277","0","60.61","28.66"
"63","000","00","002","0216","0693","790","343","447","30","820","1285","0","63.81","26.69"
"63","000","00","002","0216","0694","725","351","374","26","751","1161","0","64.69","30.23"
"63","000","00","002","0216","0695","743","395","348","41","784","1299","0","60.35","30.41"
"63","000","00","002","0217","0000","2760","1204","1556","102","2862","4811","0","59.49","25.03"
"63","000","00","002","0217","0696","692","279","413","18","710","1243","0","57.12","22.45"
"63","000","00","002","0217","0697","678","290","388","22","700","1197","0","58.48","24.23"
"63","000","00","002","0217","0698","759","351","408","28","787","1224","0","64.3","28.68"
"63","000","00","002","0217","0699","631","284","347","34","665","1147","0","57.98","24.76"
"63","000","00","002","0218","0000","2542","1160","1382","118","2660","4373","0","60.83","26.53"
"63","000","00","002","0218","0700","625","281","344","24","649","1045","0","62.11","26.89"
"63","000","00","002","0218","0701","662","285","377","36","698","1096","0","63.69","26.0"
"63","000","00","002","0218","0702","646","302","344","17","663","1115","0","59.46","27.09"
"63","000","00","002","0218","0703","609","292","317","41","650","1117","0","58.19","26.14"
"63","000","00","002","0219","0000","2068","776","1292","80","2148","3770","0","56.98","20.58"
"63","000","00","002","0219","0704","517","206","311","22","539","1019","0","52.89","20.22"
"63","000","00","002","0219","0705","772","284","488","31","803","1346","0","59.66","21.1"
"63","000","00","002","0219","0706","779","286","493","27","806","1405","0","57.37","20.36"
"63","000","00","002","0220","0000","3849","1564","2285","130","3979","6448","0","61.71","24.26"
"63","000","00","002","0220","0707","777","307","470","26","803","1356","0","59.22","22.64"
"63","000","00","002","0220","0708","795","327","468","17","812","1250","0","64.96","26.16"
"63","000","00","002","0220","0709","747","285","462","28","775","1254","0","61.8","22.73"
"63","000","00","002","0220","0710","763","331","432","18","781","1317","0","59.3","25.13"
"63","000","00","002","0220","0711","767","314","453","41","808","1271","0","63.57","24.7"
"63","000","00","002","0221","0000","1109","493","616","37","1146","2004","0","57.19","24.6"
"63","000","00","002","0221","0712","552","244","308","19","571","979","0","58.32","24.92"
"63","000","00","002","0221","0713","557","249","308","18","575","1025","0","56.1","24.29"
"63","000","00","002","0222","0000","3265","1397","1868","108","3373","5741","0","58.75","24.33"
"63","000","00","002","0222","0714","747","329","418","28","775","1512","0","51.26","21.76"
"63","000","00","002","0222","0715","872","361","511","28","900","1483","0","60.69","24.34"
"63","000","00","002","0222","0716","818","368","450","25","843","1359","0","62.03","27.08"
"63","000","00","002","0222","0717","828","339","489","27","855","1387","0","61.64","24.44"
"63","000","00","002","0223","0000","2531","1168","1363","70","2601","4448","0","58.48","26.26"
"63","000","00","002","0223","0718","803","381","422","16","819","1455","0","56.29","26.19"
"63","000","00","002","0223","0719","839","379","460","23","862","1461","0","59.0","25.94"
"63","000","00","002","0223","0720","889","408","481","31","920","1532","0","60.05","26.63"
"63","000","00","002","0224","0000","2353","1097","1256","115","2468","3964","0","62.26","27.67"
"63","000","00","002","0224","0721","646","298","348","33","679","1043","0","65.1","28.57"
"63","000","00","002","0224","0722","540","277","263","19","559","875","0","63.89","31.66"
"63","000","00","002","0224","0723","521","232","289","18","539","927","0","58.14","25.03"
"63","000","00","002","0224","0724","646","290","356","45","691","1119","0","61.75","25.92"
"63","000","00","002","0225","0000","4071","1863","2208","161","4232","7061","0","59.93","26.38"
"63","000","00","002","0225","0725","832","402","430","35","867","1463","0","59.26","27.48"
"63","000","00","002","0225","0726","797","372","425","45","842","1293","0","65.12","28.77"
"63","000","00","002","0225","0727","862","379","483","29","891","1553","0","57.37","24.4"
"63","000","00","002","0225","0728","778","379","399","24","802","1360","0","58.97","27.87"
"63","000","00","002","0225","0729","802","331","471","28","830","1392","0","59.63","23.78"
"63","000","00","002","0226","0000","3086","1376","1710","121","3207","5430","0","59.06","25.34"
"63","000","00","002","0226","0730","793","362","431","21","814","1377","0","59.11","26.29"
"63","000","00","002","0226","0731","816","355","461","20","836","1377","0","60.71","25.78"
"63","000","00","002","0226","0732","683","309","374","24","707","1269","0","55.71","24.35"
"63","000","00","002","0226","0733","794","350","444","56","850","1407","0","60.41","24.88"
"63","000","00","002","0227","0000","2061","904","1157","94","2155","3609","0","59.71","25.05"
"63","000","00","002","0227","0734","652","285","367","34","686","1172","0","58.53","24.32"
"63","000","00","002","0227","0735","690","299","391","19","709","1182","0","59.98","25.3"
"63","000","00","002","0227","0736","719","320","399","41","760","1255","0","60.56","25.5"
"63","000","00","002","0228","0000","2408","1063","1345","68","2476","4437","0","55.8","23.96"
"63","000","00","002","0228","0737","895","524","371","22","917","1689","0","54.29","31.02"
"63","000","00","002","0228","0738","887","358","529","22","909","1605","0","56.64","22.31"
"63","000","00","002","0228","0739","626","181","445","24","650","1143","0","56.87","15.84"
"63","000","00","002","0229","0000","3249","1250","1999","145","3394","5898","0","57.54","21.19"
"63","000","00","002","0229","0740","756","296","460","27","783","1440","0","54.38","20.56"
"63","000","00","002","0229","0741","828","295","533","38","866","1495","0","57.93","19.73"
"63","000","00","002","0229","0742","883","345","538","41","924","1514","0","61.03","22.79"
"63","000","00","002","0229","0743","782","314","468","39","821","1449","0","56.66","21.67"
"63","000","00","002","0230","0000","4560","1789","2771","139","4699","7867","0","59.73","22.74"
"63","000","00","002","0230","0744","840","369","471","23","863","1401","0","61.6","26.34"
"63","000","00","002","0230","0745","645","280","365","20","665","1181","0","56.31","23.71"
"63","000","00","002","0230","0746","849","313","536","26","875","1376","0","63.59","22.75"
"63","000","00","002","0230","0747","844","316","528","31","875","1422","0","61.53","22.22"
"63","000","00","002","0230","0748","723","222","501","22","745","1267","0","58.8","17.52"
"63","000","00","002","0230","0749","659","289","370","17","676","1220","0","55.41","23.69"
"63","000","00","002","0231","0000","2476","989","1487","89","2565","4622","0","55.5","21.4"
"63","000","00","002","0231","0750","811","307","504","31","842","1562","0","53.91","19.65"
"63","000","00","002","0231","0751","807","320","487","24","831","1455","0","57.11","21.99"
"63","000","00","002","0231","0752","858","362","496","34","892","1605","0","55.58","22.55"
"63","000","00","002","0232","0000","3387","1276","2111","100","3487","6070","0","57.45","21.02"
"63","000","00","002","0232","0753","975","334","641","26","1001","1626","0","61.56","20.54"
"63","000","00","002","0232","0754","912","350","562","30","942","1561","0","60.35","22.42"
"63","000","00","002","0232","0755","743","308","435","26","769","1547","0","49.71","19.91"
"63","000","00","002","0232","0756","757","284","473","18","775","1336","0","58.01","21.26"
"63","000","00","002","0233","0000","3729","1518","2211","182","3911","6899","0","56.69","22.0"
"63","000","00","002","0233","0757","697","307","390","35","732","1314","0","55.71","23.36"
"63","000","00","002","0233","0758","697","275","422","36","733","1297","0","56.52","21.2"
"63","000","00","002","0233","0759","727","298","429","42","769","1366","0","56.3","21.82"
"63","000","00","002","0233","0760","808","343","465","31","839","1472","0","57.0","23.3"
"63","000","00","002","0233","0761","800","295","505","38","838","1450","0","57.79","20.34"
"63","000","00","002","0234","0000","2385","1142","1243","100","2485","4100","0","60.61","27.85"
"63","000","00","002","0234","0762","751","343","408","29","780","1328","0","58.73","25.83"
"63","000","00","002","0234","0763","825","331","494","30","855","1399","0","61.12","23.66"
"63","000","00","002","0234","0764","809","468","341","41","850","1373","0","61.91","34.09"
"63","000","00","002","0235","0000","1963","833","1130","64","2027","3592","0","56.43","23.19"
"63","000","00","002","0235","0765","616","260","356","11","627","1099","0","57.05","23.66"
"63","000","00","002","0235","0766","676","317","359","30","706","1226","0","57.59","25.86"
"63","000","00","002","0235","0767","671","256","415","23","694","1267","0","54.78","20.21"
"63","000","00","002","0236","0000","3551","1405","2146","146","3697","6247","0","59.18","22.49"
"63","000","00","002","0236","0768","876","338","538","35","911","1531","0","59.5","22.08"
"63","000","00","002","0236","0769","840","330","510","41","881","1438","0","61.27","22.95"
"63","000","00","002","0236","0770","900","354","546","31","931","1657","0","56.19","21.36"
"63","000","00","002","0236","0771","935","383","552","39","974","1621","0","60.09","23.63"
"63","000","00","002","0237","0000","1708","744","964","39","1747","2842","0","61.47","26.18"
"63","000","00","002","0237","0772","911","400","511","17","928","1508","0","61.54","26.53"
"63","000","00","002","0237","0773","797","344","453","22","819","1334","0","61.39","25.79"
"63","000","00","002","0238","0000","2051","815","1236","65","2116","3662","0","57.78","22.26"
"63","000","00","002","0238","0774","580","250","330","27","607","1246","0","48.72","20.06"
"63","000","00","002","0238","0775","743","297","446","26","769","1196","0","64.3","24.83"
"63","000","00","002","0238","0776","728","268","460","12","740","1220","0","60.66","21.97"
"63","000","00","002","0239","0000","3395","1354","2041","166","3561","6210","0","57.34","21.8"
"63","000","00","002","0239","0777","843","325","518","27","870","1538","0","56.57","21.13"
"63","000","00","002","0239","0778","912","370","542","43","955","1565","0","61.02","23.64"
"63","000","00","002","0239","0779","841","345","496","46","887","1621","0","54.72","21.28"
"63","000","00","002","0239","0780","799","314","485","50","849","1486","0","57.13","21.13"
"63","000","00","002","0240","0000","2431","1036","1395","109","2540","4310","0","58.93","24.04"
"63","000","00","002","0240","0781","807","348","459","26","833","1507","0","55.28","23.09"
"63","000","00","002","0240","0782","863","361","502","42","905","1516","0","59.7","23.81"
"63","000","00","002","0240","0783","761","327","434","41","802","1287","0","62.32","25.41"
"63","000","00","002","0241","0000","986","364","622","69","1055","1851","0","57.0","19.67"
"63","000","00","002","0241","0784","523","209","314","42","565","1050","0","53.81","19.9"
"63","000","00","002","0241","0785","463","155","308","27","490","801","0","61.17","19.35"
"63","000","00","003","0000","0000","142129","58256","83873","4959","147088","252645","308835","58.22","23.06"
"63","000","00","003","0301","0000","2702","1035","1667","96","2798","4848","0","57.71","21.35"
"63","000","00","003","0301","1214","636","270","366","30","666","1184","0","56.25","22.8"
"63","000","00","003","0301","1215","638","261","377","25","663","1197","0","55.39","21.8"
"63","000","00","003","0301","1216","707","264","443","12","719","1221","0","58.89","21.62"
"63","000","00","003","0301","1217","721","240","481","29","750","1246","0","60.19","19.26"
"63","000","00","003","0302","0000","2542","1098","1444","94","2636","4386","0","60.1","25.03"
"63","000","00","003","0302","1218","881","378","503","29","910","1478","0","61.57","25.58"
"63","000","00","003","0302","1219","734","341","393","29","763","1314","0","58.07","25.95"
"63","000","00","003","0302","1220","927","379","548","36","963","1594","0","60.41","23.78"
"63","000","00","003","0303","0000","3346","1274","2072","128","3474","5767","0","60.24","22.09"
"63","000","00","003","0303","1221","817","319","498","42","859","1429","0","60.11","22.32"
"63","000","00","003","0303","1222","858","316","542","33","891","1452","0","61.36","21.76"
"63","000","00","003","0303","1223","888","356","532","19","907","1551","0","58.48","22.95"
"63","000","00","003","0303","1224","783","283","500","34","817","1335","0","61.2","21.2"
"63","000","00","003","0304","0000","3839","1763","2076","115","3954","6795","0","58.19","25.95"
"63","000","00","003","0304","1225","663","305","358","18","681","1196","0","56.94","25.5"
"63","000","00","003","0304","1226","734","353","381","16","750","1339","0","56.01","26.36"
"63","000","00","003","0304","1227","849","429","420","18","867","1448","0","59.88","29.63"
"63","000","00","003","0304","1228","782","322","460","25","807","1373","0","58.78","23.45"
"63","000","00","003","0304","1229","811","354","457","38","849","1439","0","59.0","24.6"
"63","000","00","003","0305","0000","2322","965","1357","56","2378","4461","0","53.31","21.63"
"63","000","00","003","0305","1230","632","272","360","9","641","1174","0","54.6","23.17"
"63","000","00","003","0305","1231","612","283","329","9","621","1144","0","54.28","24.74"
"63","000","00","003","0305","1232","592","203","389","16","608","1119","0","54.33","18.14"
"63","000","00","003","0305","1233","486","207","279","22","508","1024","0","49.61","20.21"
"63","000","00","003","0306","0000","2961","1027","1934","106","3067","5067","0","60.53","20.27"
"63","000","00","003","0306","1234","608","176","432","22","630","1032","0","61.05","17.05"
"63","000","00","003","0306","1235","766","185","581","26","792","1319","0","60.05","14.03"
"63","000","00","003","0306","1236","807","288","519","36","843","1369","0","61.58","21.04"
"63","000","00","003","0306","1237","780","378","402","22","802","1347","0","59.54","28.06"
"63","000","00","003","0307","0000","3114","1453","1661","100","3214","5988","0","53.67","24.27"
"63","000","00","003","0307","1238","843","399","444","27","870","1655","0","52.57","24.11"
"63","000","00","003","0307","1239","792","421","371","25","817","1595","0","51.22","26.39"
"63","000","00","003","0307","1240","778","331","447","26","804","1429","0","56.26","23.16"
"63","000","00","003","0307","1241","701","302","399","22","723","1309","0","55.23","23.07"
"63","000","00","003","0308","0000","1538","708","830","50","1588","2818","0","56.35","25.12"
"63","000","00","003","0308","1242","823","381","442","21","844","1508","0","55.97","25.27"
"63","000","00","003","0308","1243","715","327","388","29","744","1310","0","56.79","24.96"
"63","000","00","003","0309","0000","1938","868","1070","60","1998","3667","0","54.49","23.67"
"63","000","00","003","0309","1244","661","299","362","13","674","1233","0","54.66","24.25"
"63","000","00","003","0309","1245","664","285","379","29","693","1287","0","53.85","22.14"
"63","000","00","003","0309","1246","613","284","329","18","631","1147","0","55.01","24.76"
"63","000","00","003","0310","0000","3448","1471","1977","111","3559","6508","0","54.69","22.6"
"63","000","00","003","0310","1247","659","256","403","23","682","1260","0","54.13","20.32"
"63","000","00","003","0310","1248","747","320","427","25","772","1377","0","56.06","23.24"
"63","000","00","003","0310","1249","688","305","383","32","720","1284","0","56.07","23.75"
"63","000","00","003","0310","1250","682","301","381","15","697","1314","0","53.04","22.91"
"63","000","00","003","0310","1251","672","289","383","16","688","1273","0","54.05","22.7"
"63","000","00","003","0311","0000","2849","1206","1643","107","2956","4829","0","61.21","24.97"
"63","000","00","003","0311","1252","661","303","358","15","676","1146","0","58.99","26.44"
"63","000","00","003","0311","1253","745","327","418","28","773","1285","0","60.16","25.45"
"63","000","00","003","0311","1254","773","349","424","29","802","1297","0","61.84","26.91"
"63","000","00","003","0311","1255","670","227","443","35","705","1101","0","64.03","20.62"
"63","000","00","003","0312","0000","2322","981","1341","86","2408","4047","0","59.5","24.24"
"63","000","00","003","0312","1256","733","257","476","31","764","1310","0","58.32","19.62"
"63","000","00","003","0312","1257","813","366","447","30","843","1365","0","61.76","26.81"
"63","000","00","003","0312","1258","776","358","418","25","801","1372","0","58.38","26.09"
"63","000","00","003","0313","0000","2161","954","1207","63","2224","3596","0","61.85","26.53"
"63","000","00","003","0313","1259","725","326","399","16","741","1189","0","62.32","27.42"
"63","000","00","003","0313","1260","743","321","422","32","775","1256","0","61.7","25.56"
"63","000","00","003","0313","1261","693","307","386","15","708","1151","0","61.51","26.67"
"63","000","00","003","0314","0000","3672","1553","2119","122","3794","6129","0","61.9","25.34"
"63","000","00","003","0314","1262","907","373","534","30","937","1501","0","62.43","24.85"
"63","000","00","003","0314","1263","900","360","540","29","929","1520","0","61.12","23.68"
"63","000","00","003","0314","1264","921","402","519","37","958","1529","0","62.66","26.29"
"63","000","00","003","0314","1265","944","418","526","26","970","1579","0","61.43","26.47"
"63","000","00","003","0315","0000","3080","1330","1750","84","3164","6705","0","47.19","19.84"
"63","000","00","003","0315","1266","639","277","362","30","669","2619","0","25.54","10.58"
"63","000","00","003","0315","1267","744","350","394","17","761","1290","0","58.99","27.13"
"63","000","00","003","0315","1268","820","371","449","14","834","1307","0","63.81","28.39"
"63","000","00","003","0315","1269","877","332","545","23","900","1489","0","60.44","22.3"
"63","000","00","003","0316","0000","2845","1221","1624","76","2921","4884","0","59.81","25.0"
"63","000","00","003","0316","1270","663","261","402","21","684","1097","0","62.35","23.79"
"63","000","00","003","0316","1271","763","314","449","19","782","1328","0","58.89","23.64"
"63","000","00","003","0316","1272","673","295","378","15","688","1189","0","57.86","24.81"
"63","000","00","003","0316","1273","746","351","395","21","767","1270","0","60.39","27.64"
"63","000","00","003","0317","0000","2968","1259","1709","95","3063","5155","0","59.42","24.42"
"63","000","00","003","0317","1274","761","334","427","22","783","1349","0","58.04","24.76"
"63","000","00","003","0317","1275","712","297","415","23","735","1292","0","56.89","22.99"
"63","000","00","003","0317","1276","790","315","475","29","819","1314","0","62.33","23.97"
"63","000","00","003","0317","1277","705","313","392","21","726","1200","0","60.5","26.08"
"63","000","00","003","0318","0000","1735","719","1016","75","1810","3119","0","58.03","23.05"
"63","000","00","003","0318","1278","864","363","501","43","907","1558","0","58.22","23.3"
"63","000","00","003","0318","1279","871","356","515","32","903","1561","0","57.85","22.81"
"63","000","00","003","0319","0000","1719","701","1018","52","1771","2945","0","60.14","23.8"
"63","000","00","003","0319","1280","842","323","519","25","867","1446","0","59.96","22.34"
"63","000","00","003","0319","1281","877","378","499","27","904","1499","0","60.31","25.22"
"63","000","00","003","0320","0000","1663","645","1018","55","1718","2978","0","57.69","21.66"
"63","000","00","003","0320","1282","843","320","523","26","869","1467","0","59.24","21.81"
"63","000","00","003","0320","1283","820","325","495","29","849","1511","0","56.19","21.51"
"63","000","00","003","0321","0000","2737","1087","1650","87","2824","4640","0","60.86","23.43"
"63","000","00","003","0321","1284","929","354","575","40","969","1600","0","60.56","22.13"
"63","000","00","003","0321","1285","916","379","537","26","942","1573","0","59.89","24.09"
"63","000","00","003","0321","1286","892","354","538","21","913","1467","0","62.24","24.13"
"63","000","00","003","0322","0000","3323","1300","2023","120","3443","5891","0","58.45","22.07"
"63","000","00","003","0322","1287","767","284","483","35","802","1358","0","59.06","20.91"
"63","000","00","003","0322","1288","876","351","525","33","909","1568","0","57.97","22.39"
"63","000","00","003","0322","1289","821","327","494","30","851","1411","0","60.31","23.18"
"63","000","00","003","0322","1290","859","338","521","22","881","1554","0","56.69","21.75"
"63","000","00","003","0323","0000","3429","1113","2316","101","3530","5712","0","61.8","19.49"
"63","000","00","003","0323","1291","809","297","512","27","836","1345","0","62.16","22.08"
"63","000","00","003","0323","1292","821","271","550","23","844","1435","0","58.82","18.89"
"63","000","00","003","0323","1293","899","270","629","29","928","1481","0","62.66","18.23"
"63","000","00","003","0323","1294","900","275","625","22","922","1451","0","63.54","18.95"
"63","000","00","003","0326","0000","1783","743","1040","65","1848","3091","0","59.79","24.04"
"63","000","00","003","0326","1295","907","384","523","34","941","1566","0","60.09","24.52"
"63","000","00","003","0326","1296","876","359","517","31","907","1525","0","59.48","23.54"
"63","000","00","003","0327","0000","2350","927","1423","90","2440","4215","0","57.89","21.99"
"63","000","00","003","0327","1297","748","301","447","31","779","1336","0","58.31","22.53"
"63","000","00","003","0327","1298","866","351","515","38","904","1483","0","60.96","23.67"
"63","000","00","003","0327","1299","736","275","461","21","757","1396","0","54.23","19.7"
"63","000","00","003","0328","0000","3270","1272","1998","113","3383","5535","0","61.12","22.98"
"63","000","00","003","0328","1300","885","366","519","38","923","1406","0","65.65","26.03"
"63","000","00","003","0328","1301","824","327","497","37","861","1434","0","60.04","22.8"
"63","000","00","003","0328","1302","744","277","467","16","760","1288","0","59.01","21.51"
"63","000","00","003","0328","1303","817","302","515","22","839","1407","0","59.63","21.46"
"63","000","00","003","0329","0000","2423","947","1476","100","2523","4554","0","55.4","20.79"
"63","000","00","003","0329","1304","820","350","470","24","844","1514","0","55.75","23.12"
"63","000","00","003","0329","1305","740","278","462","40","780","1550","0","50.32","17.94"
"63","000","00","003","0329","1306","863","319","544","36","899","1490","0","60.34","21.41"
"63","000","00","003","0330","0000","2631","1024","1607","95","2726","4663","0","58.46","21.96"
"63","000","00","003","0330","1307","704","288","416","23","727","1284","0","56.62","22.43"
"63","000","00","003","0330","1308","658","254","404","23","681","1129","0","60.32","22.5"
"63","000","00","003","0330","1309","690","276","414","25","715","1193","0","59.93","23.13"
"63","000","00","003","0330","1310","579","206","373","24","603","1057","0","57.05","19.49"
"63","000","00","003","0331","0000","2889","1369","1520","131","3020","5453","0","55.38","25.11"
"63","000","00","003","0331","1311","765","367","398","29","794","1361","0","58.34","26.97"
"63","000","00","003","0331","1312","763","328","435","41","804","1412","0","56.94","23.23"
"63","000","00","003","0331","1313","661","335","326","23","684","1423","0","48.07","23.54"
"63","000","00","003","0331","1314","700","339","361","38","738","1257","0","58.71","26.97"
"63","000","00","003","0332","0000","2805","1181","1624","131","2936","4829","0","60.8","24.46"
"63","000","00","003","0332","1315","677","252","425","28","705","1133","0","62.22","22.24"
"63","000","00","003","0332","1316","613","302","311","27","640","1077","0","59.42","28.04"
"63","000","00","003","0332","1317","760","332","428","26","786","1300","0","60.46","25.54"
"63","000","00","003","0332","1318","755","295","460","50","805","1319","0","61.03","22.37"
"63","000","00","003","0333","0000","2065","882","1183","93","2158","3633","0","59.4","24.28"
"63","000","00","003","0333","1319","722","318","404","42","764","1265","0","60.4","25.14"
"63","000","00","003","0333","1320","679","290","389","26","705","1265","0","55.73","22.92"
"63","000","00","003","0333","1321","664","274","390","25","689","1103","0","62.47","24.84"
"63","000","00","003","0334","0000","2322","861","1461","65","2387","3958","0","60.31","21.75"
"63","000","00","003","0334","1322","791","270","521","26","817","1341","0","60.92","20.13"
"63","000","00","003","0334","1323","810","289","521","15","825","1357","0","60.8","21.3"
"63","000","00","003","0334","1324","721","302","419","24","745","1260","0","59.13","23.97"
"63","000","00","003","0335","0000","2153","854","1299","65","2218","3844","0","57.7","22.22"
"63","000","00","003","0335","1325","759","281","478","21","780","1295","0","60.23","21.7"
"63","000","00","003","0335","1326","752","306","446","19","771","1399","0","55.11","21.87"
"63","000","00","003","0335","1327","642","267","375","25","667","1150","0","58.0","23.22"
"63","000","00","003","0336","0000","2815","1087","1728","96","2911","5149","0","56.54","21.11"
"63","000","00","003","0336","1328","693","271","422","24","717","1351","0","53.07","20.06"
"63","000","00","003","0336","1329","763","318","445","36","799","1341","0","59.58","23.71"
"63","000","00","003","0336","1330","612","214","398","18","630","1129","0","55.8","18.95"
"63","000","00","003","0336","1331","747","284","463","18","765","1328","0","57.61","21.39"
"63","000","00","003","0337","0000","3439","995","2444","122","3561","6080","0","58.57","16.37"
"63","000","00","003","0337","1332","957","242","715","29","986","1557","0","63.33","15.54"
"63","000","00","003","0337","1333","881","283","598","36","917","1461","0","62.77","19.37"
"63","000","00","003","0337","1334","797","247","550","27","824","1589","0","51.86","15.54"
"63","000","00","003","0337","1335","804","223","581","30","834","1473","0","56.62","15.14"
"63","000","00","003","0338","0000","1873","933","940","79","1952","3311","0","58.95","28.18"
"63","000","00","003","0338","1336","813","509","304","33","846","1479","0","57.2","34.42"
"63","000","00","003","0338","1337","507","197","310","18","525","833","0","63.03","23.65"
"63","000","00","003","0338","1338","553","227","326","28","581","999","0","58.16","22.72"
"63","000","00","003","0339","0000","1017","400","617","30","1047","1757","0","59.59","22.77"
"63","000","00","003","0339","1339","1017","400","617","30","1047","1757","0","59.59","22.77"
"63","000","00","003","0340","0000","4496","1814","2682","177","4673","7674","0","60.89","23.64"
"63","000","00","003","0340","1340","918","343","575","27","945","1573","0","60.08","21.81"
"63","000","00","003","0340","1341","945","368","577","43","988","1587","0","62.26","23.19"
"63","000","00","003","0340","1342","872","369","503","40","912","1496","0","60.96","24.67"
"63","000","00","003","0340","1343","839","353","486","29","868","1440","0","60.28","24.51"
"63","000","00","003","0340","1344","922","381","541","38","960","1578","0","60.84","24.14"
"63","000","00","003","0341","0000","2126","921","1205","68","2194","3594","0","61.05","25.63"
"63","000","00","003","0341","1345","714","331","383","28","742","1223","0","60.67","27.06"
"63","000","00","003","0341","1346","657","293","364","17","674","1119","0","60.23","26.18"
"63","000","00","003","0341","1347","755","297","458","23","778","1252","0","62.14","23.72"
"63","000","00","003","0343","0000","4132","1742","2390","128","4260","7232","0","58.9","24.09"
"63","000","00","003","0343","1348","919","388","531","28","947","1576","0","60.09","24.62"
"63","000","00","003","0343","1349","807","356","451","26","833","1425","0","58.46","24.98"
"63","000","00","003","0343","1350","774","324","450","26","800","1450","0","55.17","22.34"
"63","000","00","003","0343","1351","800","307","493","24","824","1444","0","57.06","21.26"
"63","000","00","003","0343","1352","832","367","465","24","856","1337","0","64.02","27.45"
"63","000","00","003","0344","0000","2873","1189","1684","132","3005","5100","0","58.92","23.31"
"63","000","00","003","0344","1353","773","335","438","22","795","1417","0","56.1","23.64"
"63","000","00","003","0344","1354","704","295","409","37","741","1250","0","59.28","23.6"
"63","000","00","003","0344","1355","649","266","383","37","686","1176","0","58.33","22.62"
"63","000","00","003","0344","1356","747","293","454","36","783","1257","0","62.29","23.31"
"63","000","00","003","0346","0000","2789","1193","1596","104","2893","4851","0","59.64","24.59"
"63","000","00","003","0346","1357","725","294","431","27","752","1257","0","59.82","23.39"
"63","000","00","003","0346","1358","678","298","380","25","703","1148","0","61.24","25.96"
"63","000","00","003","0346","1359","803","354","449","31","834","1418","0","58.82","24.96"
"63","000","00","003","0346","1360","583","247","336","21","604","1028","0","58.75","24.03"
"63","000","00","003","0347","0000","3886","1707","2179","157","4043","6796","0","59.49","25.12"
"63","000","00","003","0347","1361","854","388","466","24","878","1445","0","60.76","26.85"
"63","000","00","003","0347","1362","772","283","489","40","812","1361","0","59.66","20.79"
"63","000","00","003","0347","1363","797","426","371","33","830","1343","0","61.8","31.72"
"63","000","00","003","0347","1364","728","319","409","35","763","1267","0","60.22","25.18"
"63","000","00","003","0347","1365","735","291","444","25","760","1380","0","55.07","21.09"
"63","000","00","003","0348","0000","2374","898","1476","107","2481","4312","0","57.54","20.83"
"63","000","00","003","0348","1366","838","335","503","36","874","1524","0","57.35","21.98"
"63","000","00","003","0348","1367","854","322","532","32","886","1470","0","60.27","21.9"
"63","000","00","003","0348","1368","682","241","441","39","721","1318","0","54.7","18.29"
"63","000","00","003","0349","0000","2275","922","1353","78","2353","4254","0","55.31","21.67"
"63","000","00","003","0349","1369","743","319","424","30","773","1430","0","54.06","22.31"
"63","000","00","003","0349","1370","772","314","458","33","805","1386","0","58.08","22.66"
"63","000","00","003","0349","1371","760","289","471","15","775","1438","0","53.89","20.1"
"63","000","00","003","0350","0000","2845","1144","1701","95","2940","5267","0","55.82","21.72"
"63","000","00","003","0350","1372","660","260","400","15","675","1270","0","53.15","20.47"
"63","000","00","003","0350","1373","757","317","440","26","783","1395","0","56.13","22.72"
"63","000","00","003","0350","1374","717","267","450","34","751","1292","0","58.13","20.67"
"63","000","00","003","0350","1375","711","300","411","20","731","1310","0","55.8","22.9"
"63","000","00","003","0351","0000","2974","1293","1681","75","3049","5321","0","57.3","24.3"
"63","000","00","003","0351","1376","735","328","407","20","755","1319","0","57.24","24.87"
"63","000","00","003","0351","1377","790","359","431","21","811","1355","0","59.85","26.49"
"63","000","00","003","0351","1378","695","283","412","17","712","1312","0","54.27","21.57"
"63","000","00","003","0351","1379","754","323","431","17","771","1335","0","57.75","24.19"
"63","000","00","003","0352","0000","2221","846","1375","66","2287","4124","0","55.46","20.51"
"63","000","00","003","0352","1380","772","284","488","23","795","1489","0","53.39","19.07"
"63","000","00","003","0352","1381","756","286","470","24","780","1307","0","59.68","21.88"
"63","000","00","003","0352","1382","693","276","417","19","712","1328","0","53.61","20.78"
"63","000","00","003","0353","0000","2932","1235","1697","88","3020","5169","0","58.43","23.89"
"63","000","00","003","0353","1383","711","285","426","7","718","1277","0","56.23","22.32"
"63","000","00","003","0353","1384","733","301","432","30","763","1314","0","58.07","22.91"
"63","000","00","003","0353","1385","750","332","418","25","775","1270","0","61.02","26.14"
"63","000","00","003","0353","1386","738","317","421","26","764","1308","0","58.41","24.24"
"63","000","00","003","0354","0000","2066","834","1232","67","2133","3647","0","58.49","22.87"
"63","000","00","003","0354","1387","669","276","393","18","687","1138","0","60.37","24.25"
"63","000","00","003","0354","1388","722","273","449","24","746","1333","0","55.96","20.48"
"63","000","00","003","0354","1389","675","285","390","25","700","1176","0","59.52","24.23"
"63","000","00","003","0355","0000","2988","1238","1750","118","3106","5436","0","57.14","22.77"
"63","000","00","003","0355","1390","709","323","386","34","743","1311","0","56.67","24.64"
"63","000","00","003","0355","1391","699","277","422","29","728","1295","0","56.22","21.39"
"63","000","00","003","0355","1392","811","310","501","29","840","1421","0","59.11","21.82"
"63","000","00","003","0355","1393","769","328","441","26","795","1409","0","56.42","23.28"
"63","000","00","003","0356","0000","3747","1561","2186","107","3854","6534","0","58.98","23.89"
"63","000","00","003","0356","1394","824","307","517","22","846","1434","0","59.0","21.41"
"63","000","00","003","0356","1395","754","337","417","28","782","1449","0","53.97","23.26"
"63","000","00","003","0356","1396","744","337","407","17","761","1284","0","59.27","26.25"
"63","000","00","003","0356","1397","709","276","433","17","726","1248","0","58.17","22.12"
"63","000","00","003","0356","1398","716","304","412","23","739","1119","0","66.04","27.17"
"63","000","00","003","0357","0000","1317","513","804","78","1395","2327","0","59.95","22.05"
"63","000","00","003","0357","1399","507","175","332","29","536","883","0","60.7","19.82"
"63","000","00","003","0357","1400","343","137","206","27","370","630","0","58.73","21.75"
"63","000","00","003","0357","1401","467","201","266","22","489","814","0","60.07","24.69"
"63","000","00","004","0000","0000","108252","50424","57828","4297","112549","195148","229680","57.67","25.84"
"63","000","00","004","0401","0000","1595","752","843","52","1647","2854","0","57.71","26.35"
"63","000","00","004","0401","0786","850","380","470","33","883","1522","0","58.02","24.97"
"63","000","00","004","0401","0787","745","372","373","19","764","1332","0","57.36","27.93"
"63","000","00","004","0402","0000","2341","1089","1252","108","2449","4755","0","51.5","22.9"
"63","000","00","004","0402","0788","809","368","441","31","840","1656","0","50.72","22.22"
"63","000","00","004","0402","0789","660","305","355","52","712","1367","0","52.08","22.31"
"63","000","00","004","0402","0790","872","416","456","25","897","1732","0","51.79","24.02"
"63","000","00","004","0403","0000","1770","815","955","71","1841","3284","0","56.06","24.82"
"63","000","00","004","0403","0791","901","417","484","38","939","1634","0","57.47","25.52"
"63","000","00","004","0403","0792","869","398","471","33","902","1650","0","54.67","24.12"
"63","000","00","004","0404","0000","2395","1235","1160","74","2469","4046","0","61.02","30.52"
"63","000","00","004","0404","0793","820","426","394","18","838","1392","0","60.2","30.6"
"63","000","00","004","0404","0794","713","372","341","18","731","1177","0","62.11","31.61"
"63","000","00","004","0404","0795","862","437","425","38","900","1477","0","60.93","29.59"
"63","000","00","004","0405","0000","1241","582","659","59","1300","2359","0","55.11","24.67"
"63","000","00","004","0405","0796","549","267","282","32","581","1063","0","54.66","25.12"
"63","000","00","004","0405","0797","692","315","377","27","719","1296","0","55.48","24.31"
"63","000","00","004","0406","0000","3129","1568","1561","115","3244","6065","0","53.49","25.85"
"63","000","00","004","0406","0798","694","333","361","25","719","1330","0","54.06","25.04"
"63","000","00","004","0406","0799","781","420","361","30","811","1483","0","54.69","28.32"
"63","000","00","004","0406","0800","810","373","437","25","835","1542","0","54.15","24.19"
"63","000","00","004","0406","0801","844","442","402","35","879","1710","0","51.4","25.85"
"63","000","00","004","0407","0000","1979","911","1068","85","2064","3822","0","54.0","23.84"
"63","000","00","004","0407","0802","658","303","355","25","683","1315","0","51.94","23.04"
"63","000","00","004","0407","0803","659","320","339","37","696","1245","0","55.9","25.7"
"63","000","00","004","0407","0804","662","288","374","23","685","1262","0","54.28","22.82"
"63","000","00","004","0408","0000","3360","1701","1659","137","3497","6149","0","56.87","27.66"
"63","000","00","004","0408","0805","869","482","387","33","902","1518","0","59.42","31.75"
"63","000","00","004","0408","0806","848","411","437","40","888","1522","0","58.34","27.0"
"63","000","00","004","0408","0807","799","407","392","39","838","1580","0","53.04","25.76"
"63","000","00","004","0408","0808","844","401","443","25","869","1529","0","56.83","26.23"
"63","000","00","004","0409","0000","1943","947","996","74","2017","3581","0","56.33","26.45"
"63","000","00","004","0409","0809","667","305","362","31","698","1221","0","57.17","24.98"
"63","000","00","004","0409","0810","705","358","347","26","731","1221","0","59.87","29.32"
"63","000","00","004","0409","0811","571","284","287","17","588","1139","0","51.62","24.93"
"63","000","00","004","0410","0000","2256","1069","1187","98","2354","4306","0","54.67","24.83"
"63","000","00","004","0410","0812","772","394","378","40","812","1407","0","57.71","28.0"
"63","000","00","004","0410","0813","737","353","384","26","763","1321","0","57.76","26.72"
"63","000","00","004","0410","0814","747","322","425","32","779","1578","0","49.37","20.41"
"63","000","00","004","0411","0000","2501","1140","1361","110","2611","4917","0","53.1","23.18"
"63","000","00","004","0411","0815","874","385","489","36","910","1739","0","52.33","22.14"
"63","000","00","004","0411","0816","821","362","459","36","857","1637","0","52.35","22.11"
"63","000","00","004","0411","0817","806","393","413","38","844","1541","0","54.77","25.5"
"63","000","00","004","0412","0000","2037","948","1089","93","2130","3765","0","56.57","25.18"
"63","000","00","004","0412","0818","685","343","342","34","719","1210","0","59.42","28.35"
"63","000","00","004","0412","0819","720","363","357","28","748","1331","0","56.2","27.27"
"63","000","00","004","0412","0820","632","242","390","31","663","1224","0","54.17","19.77"
"63","000","00","004","0413","0000","1793","366","1427","74","1867","3209","0","58.18","11.41"
"63","000","00","004","0413","0824","992","172","820","42","1034","1805","0","57.29","9.53"
"63","000","00","004","0413","0825","801","194","607","32","833","1404","0","59.33","13.82"
"63","000","00","004","0414","0000","4638","1988","2650","171","4809","7819","0","61.5","25.43"
"63","000","00","004","0414","0826","1044","462","582","30","1074","1708","0","62.88","27.05"
"63","000","00","004","0414","0827","880","353","527","39","919","1451","0","63.34","24.33"
"63","000","00","004","0414","0828","1000","452","548","43","1043","1684","0","61.94","26.84"
"63","000","00","004","0414","0829","908","346","562","21","929","1585","0","58.61","21.83"
"63","000","00","004","0414","0830","806","375","431","38","844","1391","0","60.68","26.96"
"63","000","00","004","0415","0000","3261","1374","1887","113","3374","5575","0","60.52","24.65"
"63","000","00","004","0415","0831","876","399","477","43","919","1375","0","66.84","29.02"
"63","000","00","004","0415","0832","875","389","486","20","895","1472","0","60.8","26.43"
"63","000","00","004","0415","0833","718","294","424","22","740","1327","0","55.76","22.16"
"63","000","00","004","0415","0834","792","292","500","28","820","1401","0","58.53","20.84"
"63","000","00","004","0416","0000","4592","1997","2595","159","4751","7980","0","59.54","25.03"
"63","000","00","004","0416","0835","808","344","464","42","850","1423","0","59.73","24.17"
"63","000","00","004","0416","0836","913","379","534","26","939","1569","0","59.85","24.16"
"63","000","00","004","0416","0837","953","393","560","24","977","1651","0","59.18","23.8"
"63","000","00","004","0416","0838","902","423","479","24","926","1624","0","57.02","26.05"
"63","000","00","004","0416","0839","1016","458","558","43","1059","1713","0","61.82","26.74"
"63","000","00","004","0417","0000","523","275","248","30","553","944","0","58.58","29.13"
"63","000","00","004","0417","0862","523","275","248","30","553","944","0","58.58","29.13"
"63","000","00","004","0418","0000","2573","1286","1287","115","2688","4693","0","57.28","27.4"
"63","000","00","004","0418","0846","810","426","384","33","843","1472","0","57.27","28.94"
"63","000","00","004","0418","0847","795","419","376","41","836","1517","0","55.11","27.62"
"63","000","00","004","0418","0848","968","441","527","41","1009","1704","0","59.21","25.88"
"63","000","00","004","0419","0000","2608","1265","1343","110","2718","4476","0","60.72","28.26"
"63","000","00","004","0419","0821","885","392","493","35","920","1585","0","58.04","24.73"
"63","000","00","004","0419","0822","910","467","443","40","950","1523","0","62.38","30.66"
"63","000","00","004","0419","0823","813","406","407","35","848","1368","0","61.99","29.68"
"63","000","00","004","0420","0000","2532","1341","1191","129","2661","4535","0","58.68","29.57"
"63","000","00","004","0420","0849","931","508","423","38","969","1603","0","60.45","31.69"
"63","000","00","004","0420","0850","751","375","376","48","799","1432","0","55.8","26.19"
"63","000","00","004","0420","0851","850","458","392","43","893","1500","0","59.53","30.53"
"63","000","00","004","0421","0000","3313","1605","1708","121","3434","5635","0","60.94","28.48"
"63","000","00","004","0421","0852","804","412","392","34","838","1332","0","62.91","30.93"
"63","000","00","004","0421","0853","870","420","450","26","896","1450","0","61.79","28.97"
"63","000","00","004","0421","0854","850","410","440","35","885","1434","0","61.72","28.59"
"63","000","00","004","0421","0855","789","363","426","26","815","1419","0","57.43","25.58"
"63","000","00","004","0422","0000","2306","1186","1120","87","2393","4400","0","54.39","26.95"
"63","000","00","004","0422","0856","711","359","352","28","739","1292","0","57.2","27.79"
"63","000","00","004","0422","0857","826","427","399","31","857","1526","0","56.16","27.98"
"63","000","00","004","0422","0858","769","400","369","28","797","1582","0","50.38","25.28"
"63","000","00","004","0423","0000","2430","1238","1192","98","2528","4584","0","55.15","27.01"
"63","000","00","004","0423","0859","826","432","394","27","853","1588","0","53.72","27.2"
"63","000","00","004","0423","0860","818","403","415","33","851","1463","0","58.17","27.55"
"63","000","00","004","0423","0861","786","403","383","38","824","1533","0","53.75","26.29"
"63","000","00","004","0424","0000","2696","1313","1383","107","2803","6843","0","40.96","19.19"
"63","000","00","004","0424","0863","1073","545","528","31","1104","1745","0","63.27","31.23"
"63","000","00","004","0424","0864","826","416","410","31","857","1679","0","51.04","24.78"
"63","000","00","004","0424","0865","797","352","445","45","842","3419","0","24.63","10.3"
"63","000","00","004","0425","0000","4032","2053","1979","196","4228","7203","0","58.7","28.5"
"63","000","00","004","0425","0866","817","407","410","30","847","1387","0","61.07","29.34"
"63","000","00","004","0425","0867","959","492","467","41","1000","1672","0","59.81","29.43"
"63","000","00","004","0425","0868","732","359","373","49","781","1319","0","59.21","27.22"
"63","000","00","004","0425","0869","752","387","365","29","781","1364","0","57.26","28.37"
"63","000","00","004","0425","0870","772","408","364","47","819","1461","0","56.06","27.93"
"63","000","00","004","0426","0000","2029","1043","986","100","2129","3654","0","58.26","28.54"
"63","000","00","004","0426","0871","680","361","319","31","711","1173","0","60.61","30.78"
"63","000","00","004","0426","0872","625","301","324","33","658","1171","0","56.19","25.7"
"63","000","00","004","0426","0873","724","381","343","36","760","1310","0","58.02","29.08"
"63","000","00","004","0427","0000","4015","1889","2126","136","4151","6655","0","62.37","28.38"
"63","000","00","004","0427","0874","867","378","489","29","896","1373","0","65.26","27.53"
"63","000","00","004","0427","0875","780","358","422","26","806","1290","0","62.48","27.75"
"63","000","00","004","0427","0876","799","388","411","33","832","1346","0","61.81","28.83"
"63","000","00","004","0427","0877","875","429","446","27","902","1468","0","61.44","29.22"
"63","000","00","004","0427","0878","694","336","358","21","715","1178","0","60.7","28.52"
"63","000","00","004","0428","0000","3431","1619","1812","135","3566","6102","0","58.44","26.53"
"63","000","00","004","0428","0879","956","436","520","35","991","1654","0","59.92","26.36"
"63","000","00","004","0428","0880","831","363","468","33","864","1464","0","59.02","24.8"
"63","000","00","004","0428","0881","799","417","382","26","825","1450","0","56.9","28.76"
"63","000","00","004","0428","0882","845","403","442","41","886","1534","0","57.76","26.27"
"63","000","00","004","0429","0000","3705","1896","1809","138","3843","6660","0","57.7","28.47"
"63","000","00","004","0429","0883","876","482","394","29","905","1703","0","53.14","28.3"
"63","000","00","004","0429","0884","930","483","447","39","969","1610","0","60.19","30.0"
"63","000","00","004","0429","0885","894","437","457","32","926","1653","0","56.02","26.44"
"63","000","00","004","0429","0886","1005","494","511","38","1043","1694","0","61.57","29.16"
"63","000","00","004","0430","0000","2705","1288","1417","85","2790","4824","0","57.84","26.7"
"63","000","00","004","0430","0887","898","467","431","25","923","1623","0","56.87","28.77"
"63","000","00","004","0430","0888","922","503","419","32","954","1618","0","58.96","31.09"
"63","000","00","004","0430","0889","885","318","567","28","913","1583","0","57.68","20.09"
"63","000","00","004","0431","0000","2777","1382","1395","102","2879","4529","0","63.57","30.51"
"63","000","00","004","0431","0890","957","483","474","29","986","1605","0","61.43","30.09"
"63","000","00","004","0431","0891","868","428","440","35","903","1398","0","64.59","30.62"
"63","000","00","004","0431","0892","952","471","481","38","990","1526","0","64.88","30.87"
"63","000","00","004","0432","0000","2648","1278","1370","110","2758","4739","0","58.2","26.97"
"63","000","00","004","0432","0893","881","420","461","30","911","1555","0","58.59","27.01"
"63","000","00","004","0432","0894","875","403","472","28","903","1597","0","56.54","25.23"
"63","000","00","004","0432","0895","892","455","437","52","944","1587","0","59.48","28.67"
"63","000","00","004","0433","0000","1844","869","975","67","1911","3133","0","61.0","27.74"
"63","000","00","004","0433","0896","929","397","532","31","960","1587","0","60.49","25.02"
"63","000","00","004","0433","0897","915","472","443","36","951","1546","0","61.51","30.53"
"63","000","00","004","0434","0000","2856","1241","1615","117","2973","5094","0","58.36","24.36"
"63","000","00","004","0434","0898","735","312","423","34","769","1322","0","58.17","23.6"
"63","000","00","004","0434","0899","716","300","416","31","747","1267","0","58.96","23.68"
"63","000","00","004","0434","0900","680","315","365","23","703","1210","0","58.1","26.03"
"63","000","00","004","0434","0901","725","314","411","29","754","1295","0","58.22","24.25"
"63","000","00","004","0435","0000","2701","860","1841","129","2830","4474","0","63.25","19.22"
"63","000","00","004","0435","0902","833","300","533","41","874","1467","0","59.58","20.45"
"63","000","00","004","0435","0903","930","263","667","41","971","1491","0","65.12","17.64"
"63","000","00","004","0435","0904","938","297","641","47","985","1516","0","64.97","19.59"
"63","000","00","004","0436","0000","2249","1113","1136","78","2327","4035","0","57.67","27.58"
"63","000","00","004","0436","0905","738","370","368","26","764","1384","0","55.2","26.73"
"63","000","00","004","0436","0906","705","350","355","26","731","1138","0","64.24","30.76"
"63","000","00","004","0436","0907","806","393","413","26","832","1513","0","54.99","25.97"
"63","000","00","004","0437","0000","1754","799","955","81","1835","2988","0","61.41","26.74"
"63","000","00","004","0437","0908","890","388","502","48","938","1559","0","60.17","24.89"
"63","000","00","004","0437","0909","864","411","453","33","897","1429","0","62.77","28.76"
"63","000","00","004","0438","0000","1475","678","797","70","1545","2459","0","62.83","27.57"
"63","000","00","004","0438","0910","738","337","401","35","773","1245","0","62.09","27.07"
"63","000","00","004","0438","0911","737","341","396","35","772","1214","0","63.59","28.09"
"63","000","00","004","0439","0000","2999","1430","1569","102","3101","5339","0","58.08","26.78"
"63","000","00","004","0439","0912","813","403","410","22","835","1394","0","59.9","28.91"
"63","000","00","004","0439","0913","721","347","374","16","737","1336","0","55.16","25.97"
"63","000","00","004","0439","0914","676","318","358","32","708","1227","0","57.7","25.92"
"63","000","00","004","0439","0915","789","362","427","32","821","1382","0","59.41","26.19"
"63","000","00","004","0440","0000","2231","951","1280","79","2310","4100","0","56.34","23.2"
"63","000","00","004","0440","0916","794","336","458","36","830","1436","0","57.8","23.4"
"63","000","00","004","0440","0917","723","348","375","21","744","1405","0","52.95","24.77"
"63","000","00","004","0440","0918","714","267","447","22","736","1259","0","58.46","21.21"
"63","000","00","004","0441","0000","3613","1515","2098","133","3746","6297","0","59.49","24.06"
"63","000","00","004","0441","0840","946","403","543","42","988","1647","0","59.99","24.47"
"63","000","00","004","0441","0841","935","384","551","23","958","1762","0","54.37","21.79"
"63","000","00","004","0441","0842","834","321","513","34","868","1399","0","62.04","22.94"
"63","000","00","004","0441","0843","898","407","491","34","932","1489","0","62.59","27.33"
"63","000","00","004","0442","0000","1376","529","847","49","1425","2267","0","62.86","23.33"
"63","000","00","004","0442","0844","768","289","479","26","794","1269","0","62.57","22.77"
"63","000","00","004","0442","0845","608","240","368","23","631","998","0","63.23","24.05"
"63","000","00","005","0000","0000","72877","31050","41827","2631","75508","128292","159026","58.86","24.2"
"63","000","00","005","0501","0000","1467","665","802","72","1539","2625","0","58.63","25.33"
"63","000","00","005","0501","1001","765","329","436","28","793","1308","0","60.63","25.15"
"63","000","00","005","0501","1002","702","336","366","44","746","1317","0","56.64","25.51"
"63","000","00","005","0502","0000","1242","469","773","59","1301","2197","0","59.22","21.35"
"63","000","00","005","0502","1003","635","218","417","28","663","1069","0","62.02","20.39"
"63","000","00","005","0502","1004","607","251","356","31","638","1128","0","56.56","22.25"
"63","000","00","005","0503","0000","1237","548","689","43","1280","2101","0","60.92","26.08"
"63","000","00","005","0503","1005","622","277","345","33","655","1053","0","62.2","26.31"
"63","000","00","005","0503","1006","615","271","344","10","625","1048","0","59.64","25.86"
"63","000","00","005","0504","0000","2350","917","1433","88","2438","3990","0","61.1","22.98"
"63","000","00","005","0504","1007","702","251","451","41","743","1297","0","57.29","19.35"
"63","000","00","005","0504","1008","702","285","417","19","721","1193","0","60.44","23.89"
"63","000","00","005","0504","1009","946","381","565","28","974","1500","0","64.93","25.4"
"63","000","00","005","0505","0000","2276","940","1336","69","2345","4079","0","57.49","23.04"
"63","000","00","005","0505","1010","736","293","443","30","766","1346","0","56.91","21.77"
"63","000","00","005","0505","1011","734","302","432","12","746","1283","0","58.14","23.54"
"63","000","00","005","0505","1012","806","345","461","27","833","1450","0","57.45","23.79"
"63","000","00","005","0506","0000","3181","1388","1793","105","3286","5329","0","61.66","26.05"
"63","000","00","005","0506","1013","814","335","479","33","847","1433","0","59.11","23.38"
"63","000","00","005","0506","1014","839","393","446","27","866","1309","0","66.16","30.02"
"63","000","00","005","0506","1015","824","345","479","18","842","1386","0","60.75","24.89"
"63","000","00","005","0506","1016","704","315","389","27","731","1201","0","60.87","26.23"
"63","000","00","005","0507","0000","3098","1406","1692","110","3208","5107","0","62.82","27.53"
"63","000","00","005","0507","1017","807","312","495","24","831","1336","0","62.2","23.35"
"63","000","00","005","0507","1018","818","368","450","31","849","1358","0","62.52","27.1"
"63","000","00","005","0507","1019","699","407","292","28","727","1177","0","61.77","34.58"
"63","000","00","005","0507","1020","774","319","455","27","801","1236","0","64.81","25.81"
"63","000","00","005","0508","0000","1697","705","992","64","1761","2952","0","59.65","23.88"
"63","000","00","005","0508","1021","835","368","467","38","873","1478","0","59.07","24.9"
"63","000","00","005","0508","1022","862","337","525","26","888","1474","0","60.24","22.86"
"63","000","00","005","0509","0000","2818","1152","1666","127","2945","4914","0","59.93","23.44"
"63","000","00","005","0509","1023","665","262","403","29","694","1172","0","59.22","22.35"
"63","000","00","005","0509","1024","741","308","433","39","780","1310","0","59.54","23.51"
"63","000","00","005","0509","1025","733","280","453","33","766","1263","0","60.65","22.17"
"63","000","00","005","0509","1026","679","302","377","26","705","1169","0","60.31","25.83"
"63","000","00","005","0510","0000","2240","947","1293","65","2305","3916","0","58.86","24.18"
"63","000","00","005","0510","1027","790","310","480","19","809","1391","0","58.16","22.29"
"63","000","00","005","0510","1028","688","316","372","19","707","1201","0","58.87","26.31"
"63","000","00","005","0510","1029","762","321","441","27","789","1324","0","59.59","24.24"
"63","000","00","005","0511","0000","2999","1407","1592","132","3131","5279","0","59.31","26.65"
"63","000","00","005","0511","1030","680","318","362","32","712","1216","0","58.55","26.15"
"63","000","00","005","0511","1031","665","320","345","27","692","1183","0","58.5","27.05"
"63","000","00","005","0511","1032","857","403","454","41","898","1469","0","61.13","27.43"
"63","000","00","005","0511","1033","797","366","431","32","829","1411","0","58.75","25.94"
"63","000","00","005","0512","0000","2462","1055","1407","155","2617","4497","0","58.19","23.46"
"63","000","00","005","0512","1034","784","346","438","65","849","1398","0","60.73","24.75"
"63","000","00","005","0512","1035","798","338","460","52","850","1479","0","57.47","22.85"
"63","000","00","005","0512","1036","880","371","509","38","918","1620","0","56.67","22.9"
"63","000","00","005","0513","0000","1868","858","1010","59","1927","3160","0","60.98","27.15"
"63","000","00","005","0513","1037","595","268","327","19","614","1041","0","58.98","25.74"
"63","000","00","005","0513","1038","602","286","316","17","619","1056","0","58.62","27.08"
"63","000","00","005","0513","1039","671","304","367","23","694","1063","0","65.29","28.6"
"63","000","00","005","0514","0000","2844","1191","1653","165","3009","5865","0","51.3","20.31"
"63","000","00","005","0514","1040","709","290","419","38","747","1591","0","46.95","18.23"
"63","000","00","005","0514","1041","675","269","406","43","718","1502","0","47.8","17.91"
"63","000","00","005","0514","1042","679","276","403","41","720","1331","0","54.09","20.74"
"63","000","00","005","0514","1043","781","356","425","43","824","1441","0","57.18","24.71"
"63","000","00","005","0515","0000","2105","925","1180","94","2199","3562","0","61.73","25.97"
"63","000","00","005","0515","1044","759","328","431","32","791","1273","0","62.14","25.77"
"63","000","00","005","0515","1045","677","312","365","29","706","1133","0","62.31","27.54"
"63","000","00","005","0515","1046","669","285","384","33","702","1156","0","60.73","24.65"
"63","000","00","005","0516","0000","1439","495","944","73","1512","2643","0","57.21","18.73"
"63","000","00","005","0516","1047","680","254","426","39","719","1377","0","52.21","18.45"
"63","000","00","005","0516","1048","759","241","518","34","793","1266","0","62.64","19.04"
"63","000","00","005","0517","0000","1347","538","809","43","1390","2235","0","62.19","24.07"
"63","000","00","005","0517","1049","688","257","431","30","718","1111","0","64.63","23.13"
"63","000","00","005","0517","1050","659","281","378","13","672","1124","0","59.79","25.0"
"63","000","00","005","0518","0000","1642","661","981","47","1689","2724","0","62.0","24.27"
"63","000","00","005","0518","1051","821","343","478","27","848","1373","0","61.76","24.98"
"63","000","00","005","0518","1052","821","318","503","20","841","1351","0","62.25","23.54"
"63","000","00","005","0519","0000","4965","2095","2870","140","5105","8679","0","58.82","24.14"
"63","000","00","005","0519","1053","872","349","523","22","894","1495","0","59.8","23.34"
"63","000","00","005","0519","1054","893","422","471","32","925","1436","0","64.42","29.39"
"63","000","00","005","0519","1055","854","324","530","20","874","1516","0","57.65","21.37"
"63","000","00","005","0519","1056","790","316","474","24","814","1374","0","59.24","23.0"
"63","000","00","005","0519","1057","875","382","493","18","893","1522","0","58.67","25.1"
"63","000","00","005","0519","1058","681","302","379","24","705","1336","0","52.77","22.6"
"63","000","00","005","0520","0000","2687","1164","1523","84","2771","4648","0","59.62","25.04"
"63","000","00","005","0520","1059","891","381","510","28","919","1551","0","59.25","24.56"
"63","000","00","005","0520","1060","930","404","526","34","964","1594","0","60.48","25.35"
"63","000","00","005","0520","1061","866","379","487","22","888","1503","0","59.08","25.22"
"63","000","00","005","0521","0000","4265","1648","2617","114","4379","7237","0","60.51","22.77"
"63","000","00","005","0521","1062","843","339","504","20","863","1455","0","59.31","23.3"
"63","000","00","005","0521","1063","847","317","530","14","861","1439","0","59.83","22.03"
"63","000","00","005","0521","1064","851","363","488","27","878","1469","0","59.77","24.71"
"63","000","00","005","0521","1065","857","311","546","26","883","1430","0","61.75","21.75"
"63","000","00","005","0521","1066","867","318","549","27","894","1444","0","61.91","22.02"
"63","000","00","005","0522","0000","725","298","427","13","738","1254","0","58.85","23.76"
"63","000","00","005","0522","1067","725","298","427","13","738","1254","0","58.85","23.76"
"63","000","00","005","0523","0000","1862","852","1010","84","1946","3213","0","60.57","26.52"
"63","000","00","005","0523","1068","547","252","295","28","575","932","0","61.7","27.04"
"63","000","00","005","0523","1069","619","301","318","27","646","1055","0","61.23","28.53"
"63","000","00","005","0523","1070","696","299","397","29","725","1226","0","59.14","24.39"
"63","000","00","005","0524","0000","1491","639","852","65","1556","2726","0","57.08","23.44"
"63","000","00","005","0524","1071","704","308","396","40","744","1390","0","53.53","22.16"
"63","000","00","005","0524","1072","787","331","456","25","812","1336","0","60.78","24.78"
"63","000","00","005","0525","0000","1569","742","827","55","1624","2780","0","58.42","26.69"
"63","000","00","005","0525","1073","741","320","421","25","766","1419","0","53.98","22.55"
"63","000","00","005","0525","1074","828","422","406","30","858","1361","0","63.04","31.01"
"63","000","00","005","0526","0000","2270","961","1309","55","2325","5016","0","46.35","19.16"
"63","000","00","005","0526","1075","879","351","528","33","912","2520","0","36.19","13.93"
"63","000","00","005","0526","1076","715","279","436","17","732","1224","0","59.8","22.79"
"63","000","00","005","0526","1077","676","331","345","5","681","1272","0","53.54","26.02"
"63","000","00","005","0527","0000","2284","1032","1252","66","2350","3951","0","59.48","26.12"
"63","000","00","005","0527","1078","800","401","399","21","821","1400","0","58.64","28.64"
"63","000","00","005","0527","1079","738","319","419","15","753","1319","0","57.09","24.18"
"63","000","00","005","0527","1080","746","312","434","30","776","1232","0","62.99","25.32"
"63","000","00","005","0528","0000","2012","801","1211","45","2057","3274","0","62.83","24.47"
"63","000","00","005","0528","1081","804","318","486","13","817","1265","0","64.58","25.14"
"63","000","00","005","0528","1082","649","260","389","20","669","1055","0","63.41","24.64"
"63","000","00","005","0528","1083","559","223","336","12","571","954","0","59.85","23.38"
"63","000","00","005","0529","0000","2655","1177","1478","106","2761","4703","0","58.71","25.03"
"63","000","00","005","0529","1084","607","234","373","26","633","1018","0","62.18","22.99"
"63","000","00","005","0529","1085","795","359","436","31","826","1431","0","57.72","25.09"
"63","000","00","005","0529","1086","661","313","348","23","684","1271","0","53.82","24.63"
"63","000","00","005","0529","1087","592","271","321","26","618","983","0","62.87","27.57"
"63","000","00","005","0530","0000","3641","1543","2098","96","3737","6409","0","58.31","24.08"
"63","000","00","005","0530","1088","904","381","523","19","923","1594","0","57.9","23.9"
"63","000","00","005","0530","1089","925","396","529","24","949","1565","0","60.64","25.3"
"63","000","00","005","0530","1090","933","384","549","28","961","1650","0","58.24","23.27"
"63","000","00","005","0530","1091","879","382","497","25","904","1600","0","56.5","23.88"
"63","000","00","005","0531","0000","4139","1831","2308","138","4277","7227","0","59.18","25.34"
"63","000","00","005","0531","1092","794","360","434","20","814","1391","0","58.52","25.88"
"63","000","00","005","0531","1093","977","414","563","25","1002","1769","0","56.64","23.4"
"63","000","00","005","0531","1094","850","408","442","38","888","1487","0","59.72","27.44"
"63","000","00","005","0531","1095","762","317","445","23","785","1291","0","60.81","24.55"
"63","000","00","005","0531","1096","756","332","424","32","788","1289","0","61.13","25.76"
"63","000","00","006","0000","0000","60751","31712","29039","2688","63439","107557","127833","58.98","29.48"
"63","000","00","006","0601","0000","1513","788","725","91","1604","2613","0","61.39","30.16"
"63","000","00","006","0601","0919","719","372","347","44","763","1261","0","60.51","29.5"
"63","000","00","006","0601","0920","794","416","378","47","841","1352","0","62.2","30.77"
"63","000","00","006","0602","0000","1665","862","803","71","1736","2972","0","58.41","29.0"
"63","000","00","006","0602","0921","831","409","422","26","857","1462","0","58.62","27.98"
"63","000","00","006","0602","0922","834","453","381","45","879","1510","0","58.21","30.0"
"63","000","00","006","0603","0000","2240","1174","1066","117","2357","4132","0","57.04","28.41"
"63","000","00","006","0603","0923","793","401","392","31","824","1496","0","55.08","26.8"
"63","000","00","006","0603","0924","720","359","361","37","757","1329","0","56.96","27.01"
"63","000","00","006","0603","0925","727","414","313","49","776","1307","0","59.37","31.68"
"63","000","00","006","0604","0000","1881","1031","850","84","1965","3197","0","61.46","32.25"
"63","000","00","006","0604","0926","612","352","260","22","634","1065","0","59.53","33.05"
"63","000","00","006","0604","0927","634","337","297","23","657","1085","0","60.55","31.06"
"63","000","00","006","0604","0928","635","342","293","39","674","1047","0","64.37","32.66"
"63","000","00","006","0605","0000","2751","1528","1223","106","2857","4703","0","60.75","32.49"
"63","000","00","006","0605","0929","659","336","323","19","678","1215","0","55.8","27.65"
"63","000","00","006","0605","0930","676","397","279","28","704","1117","0","63.03","35.54"
"63","000","00","006","0605","0931","716","394","322","21","737","1186","0","62.14","33.22"
"63","000","00","006","0605","0932","700","401","299","38","738","1185","0","62.28","33.84"
"63","000","00","006","0606","0000","2280","1216","1064","73","2353","3923","0","59.98","31.0"
"63","000","00","006","0606","0933","773","430","343","24","797","1359","0","58.65","31.64"
"63","000","00","006","0606","0934","730","347","383","17","747","1273","0","58.68","27.26"
"63","000","00","006","0606","0935","777","439","338","32","809","1291","0","62.66","34.0"
"63","000","00","006","0607","0000","2965","1445","1520","111","3076","5142","0","59.82","28.1"
"63","000","00","006","0607","0936","698","348","350","26","724","1288","0","56.21","27.02"
"63","000","00","006","0607","0937","755","357","398","34","789","1245","0","63.37","28.67"
"63","000","00","006","0607","0938","765","371","394","30","795","1261","0","63.05","29.42"
"63","000","00","006","0607","0939","747","369","378","21","768","1348","0","56.97","27.37"
"63","000","00","006","0608","0000","2493","1277","1216","134","2627","4303","0","61.05","29.68"
"63","000","00","006","0608","0940","964","524","440","42","1006","1676","0","60.02","31.26"
"63","000","00","006","0608","0941","775","355","420","36","811","1311","0","61.86","27.08"
"63","000","00","006","0608","0942","754","398","356","56","810","1316","0","61.55","30.24"
"63","000","00","006","0609","0000","2470","1346","1124","109","2579","4253","0","60.64","31.65"
"63","000","00","006","0609","0943","787","404","383","46","833","1409","0","59.12","28.67"
"63","000","00","006","0609","0944","855","470","385","28","883","1436","0","61.49","32.73"
"63","000","00","006","0609","0945","828","472","356","35","863","1408","0","61.29","33.52"
"63","000","00","006","0610","0000","2147","1028","1119","62","2209","3710","0","59.54","27.71"
"63","000","00","006","0610","0946","711","361","350","30","741","1276","0","58.07","28.29"
"63","000","00","006","0610","0947","652","301","351","13","665","1110","0","59.91","27.12"
"63","000","00","006","0610","0948","784","366","418","19","803","1324","0","60.65","27.64"
"63","000","00","006","0611","0000","4678","2366","2312","204","4882","7949","0","61.42","29.76"
"63","000","00","006","0611","0949","577","311","266","23","600","1016","0","59.06","30.61"
"63","000","00","006","0611","0950","629","301","328","28","657","1028","0","63.91","29.28"
"63","000","00","006","0611","0951","672","318","354","36","708","1158","0","61.14","27.46"
"63","000","00","006","0611","0952","677","354","323","29","706","1138","0","62.04","31.11"
"63","000","00","006","0611","0953","699","326","373","31","730","1214","0","60.13","26.85"
"63","000","00","006","0611","0954","625","340","285","19","644","1090","0","59.08","31.19"
"63","000","00","006","0611","0955","799","416","383","38","837","1305","0","64.14","31.88"
"63","000","00","006","0612","0000","2014","1048","966","69","2083","3518","0","59.21","29.79"
"63","000","00","006","0612","0956","640","310","330","20","660","1167","0","56.56","26.56"
"63","000","00","006","0612","0957","649","331","318","30","679","1148","0","59.15","28.83"
"63","000","00","006","0612","0958","725","407","318","19","744","1203","0","61.85","33.83"
"63","000","00","006","0613","0000","3126","1574","1552","115","3241","5427","0","59.72","29.0"
"63","000","00","006","0613","0959","792","408","384","29","821","1441","0","56.97","28.31"
"63","000","00","006","0613","0960","783","401","382","38","821","1315","0","62.43","30.49"
"63","000","00","006","0613","0961","781","382","399","30","811","1393","0","58.22","27.42"
"63","000","00","006","0613","0962","770","383","387","18","788","1278","0","61.66","29.97"
"63","000","00","006","0614","0000","1313","733","580","64","1377","2388","0","57.66","30.7"
"63","000","00","006","0614","0963","681","402","279","22","703","1246","0","56.42","32.26"
"63","000","00","006","0614","0964","632","331","301","42","674","1142","0","59.02","28.98"
"63","000","00","006","0615","0000","1611","852","759","67","1678","2699","0","62.17","31.57"
"63","000","00","006","0615","0965","801","431","370","34","835","1336","0","62.5","32.26"
"63","000","00","006","0615","0966","810","421","389","33","843","1363","0","61.85","30.89"
"63","000","00","006","0616","0000","2506","1263","1243","79","2585","4354","0","59.37","29.01"
"63","000","00","006","0616","0967","864","426","438","25","889","1476","0","60.23","28.86"
"63","000","00","006","0616","0968","823","416","407","26","849","1418","0","59.87","29.34"
"63","000","00","006","0616","0969","819","421","398","28","847","1460","0","58.01","28.84"
"63","000","00","006","0617","0000","1238","700","538","69","1307","2468","0","52.96","28.36"
"63","000","00","006","0617","0970","618","342","276","28","646","1222","0","52.86","27.99"
"63","000","00","006","0617","0971","620","358","262","41","661","1246","0","53.05","28.73"
"63","000","00","006","0618","0000","2209","1132","1077","101","2310","3885","0","59.46","29.14"
"63","000","00","006","0618","0972","734","380","354","36","770","1256","0","61.31","30.25"
"63","000","00","006","0618","0973","727","370","357","38","765","1289","0","59.35","28.7"
"63","000","00","006","0618","0974","748","382","366","27","775","1340","0","57.84","28.51"
"63","000","00","006","0619","0000","1612","846","766","82","1694","4014","0","42.2","21.08"
"63","000","00","006","0619","0975","809","425","384","35","844","1555","0","54.28","27.33"
"63","000","00","006","0619","0976","803","421","382","47","850","2459","0","34.57","17.12"
"63","000","00","006","0620","0000","2452","1373","1079","150","2602","4466","0","58.26","30.74"
"63","000","00","006","0620","0977","504","296","208","45","549","1108","0","49.55","26.71"
"63","000","00","006","0620","0978","462","246","216","32","494","867","0","56.98","28.37"
"63","000","00","006","0620","0979","820","452","368","38","858","1329","0","64.56","34.01"
"63","000","00","006","0620","0980","666","379","287","35","701","1162","0","60.33","32.62"
"63","000","00","006","0621","0000","3136","1647","1489","114","3250","5823","0","55.81","28.28"
"63","000","00","006","0621","0981","774","430","344","30","804","1434","0","56.07","29.99"
"63","000","00","006","0621","0982","768","366","402","37","805","1351","0","59.59","27.09"
"63","000","00","006","0621","0983","819","453","366","22","841","1531","0","54.93","29.59"
"63","000","00","006","0621","0984","775","398","377","25","800","1507","0","53.09","26.41"
"63","000","00","006","0622","0000","4059","2119","1940","190","4249","7142","0","59.49","29.67"
"63","000","00","006","0622","0985","823","465","358","31","854","1488","0","57.39","31.25"
"63","000","00","006","0622","0986","801","419","382","54","855","1384","0","61.78","30.27"
"63","000","00","006","0622","0987","811","411","400","47","858","1460","0","58.77","28.15"
"63","000","00","006","0622","0988","822","391","431","34","856","1371","0","62.44","28.52"
"63","000","00","006","0622","0989","802","433","369","24","826","1439","0","57.4","30.09"
"63","000","00","006","0624","0000","2998","1702","1296","154","3152","5195","0","60.67","32.76"
"63","000","00","006","0624","0990","808","524","284","32","840","1376","0","61.05","38.08"
"63","000","00","006","0624","0991","748","419","329","39","787","1366","0","57.61","30.67"
"63","000","00","006","0624","0992","753","403","350","38","791","1218","0","64.94","33.09"
"63","000","00","006","0624","0993","689","356","333","45","734","1235","0","59.43","28.83"
"63","000","00","006","0625","0000","3249","1500","1749","155","3404","5651","0","60.24","26.54"
"63","000","00","006","0625","0994","731","338","393","26","757","1364","0","55.5","24.78"
"63","000","00","006","0625","0995","862","405","457","39","901","1408","0","63.99","28.76"
"63","000","00","006","0625","0996","818","374","444","33","851","1450","0","58.69","25.79"
"63","000","00","006","0625","0997","838","383","455","57","895","1429","0","62.63","26.8"
"63","000","00","006","0626","0000","2145","1162","983","117","2262","3630","0","62.31","32.01"
"63","000","00","006","0626","0998","689","369","320","32","721","1170","0","61.62","31.54"
"63","000","00","006","0626","0999","702","379","323","40","742","1245","0","59.6","30.44"
"63","000","00","006","0626","1000","754","414","340","45","799","1215","0","65.76","34.07"
"63","000","00","007","0000","0000","88287","41906","46381","4181","92468","164020","189875","56.38","25.55"
"63","000","00","007","0701","0000","2570","1155","1415","127","2697","4833","0","55.8","23.9"
"63","000","00","007","0701","1097","753","327","426","37","790","1305","0","60.54","25.06"
"63","000","00","007","0701","1098","559","245","314","45","604","1183","0","51.06","20.71"
"63","000","00","007","0701","1099","642","293","349","25","667","1176","0","56.72","24.91"
"63","000","00","007","0701","1100","616","290","326","20","636","1169","0","54.41","24.81"
"63","000","00","007","0702","0000","1416","672","744","88","1504","3020","0","49.8","22.25"
"63","000","00","007","0702","1101","735","365","370","19","754","1457","0","51.75","25.05"
"63","000","00","007","0702","1102","681","307","374","69","750","1563","0","47.98","19.64"
"63","000","00","007","0703","0000","1618","734","884","60","1678","3386","0","49.56","21.68"
"63","000","00","007","0703","1103","813","346","467","22","835","1771","0","47.15","19.54"
"63","000","00","007","0703","1104","805","388","417","38","843","1615","0","52.2","24.02"
"63","000","00","007","0704","0000","3066","1435","1631","128","3194","5794","0","55.13","24.77"
"63","000","00","007","0704","1105","801","434","367","35","836","1478","0","56.56","29.36"
"63","000","00","007","0704","1106","792","337","455","24","816","1462","0","55.81","23.05"
"63","000","00","007","0704","1107","704","309","395","34","738","1507","0","48.97","20.5"
"63","000","00","007","0704","1108","769","355","414","35","804","1347","0","59.69","26.35"
"63","000","00","007","0705","0000","3068","1577","1491","118","3186","5489","0","58.04","28.73"
"63","000","00","007","0705","1109","696","292","404","35","731","1367","0","53.47","21.36"
"63","000","00","007","0705","1110","766","406","360","26","792","1277","0","62.02","31.79"
"63","000","00","007","0705","1111","836","468","368","28","864","1395","0","61.94","33.55"
"63","000","00","007","0705","1112","770","411","359","29","799","1450","0","55.1","28.34"
"63","000","00","007","0706","0000","2700","1458","1242","121","2821","5192","0","54.33","28.08"
"63","000","00","007","0706","1113","675","364","311","26","701","1340","0","52.31","27.16"
"63","000","00","007","0706","1114","648","330","318","28","676","1242","0","54.43","26.57"
"63","000","00","007","0706","1115","677","362","315","35","712","1286","0","55.37","28.15"
"63","000","00","007","0706","1116","700","402","298","32","732","1324","0","55.29","30.36"
"63","000","00","007","0707","0000","2241","1191","1050","109","2350","4411","0","53.28","27.0"
"63","000","00","007","0707","1117","821","432","389","41","862","1619","0","53.24","26.68"
"63","000","00","007","0707","1118","654","351","303","29","683","1352","0","50.52","25.96"
"63","000","00","007","0707","1119","766","408","358","39","805","1440","0","55.9","28.33"
"63","000","00","007","0708","0000","2004","1019","985","107","2111","3514","0","60.07","29.0"
"63","000","00","007","0708","1120","691","336","355","33","724","1194","0","60.64","28.14"
"63","000","00","007","0708","1121","659","325","334","37","696","1083","0","64.27","30.01"
"63","000","00","007","0708","1122","654","358","296","37","691","1237","0","55.86","28.94"
"63","000","00","007","0709","0000","2408","1173","1235","96","2504","4301","0","58.22","27.27"
"63","000","00","007","0709","1123","856","428","428","35","891","1625","0","54.83","26.34"
"63","000","00","007","0709","1124","769","361","408","36","805","1324","0","60.8","27.27"
"63","000","00","007","0709","1125","783","384","399","25","808","1352","0","59.76","28.4"
"63","000","00","007","0710","0000","2380","1208","1172","101","2481","5559","0","44.63","21.73"
"63","000","00","007","0710","1126","715","377","338","36","751","2630","0","28.56","14.33"
"63","000","00","007","0710","1127","887","432","455","31","918","1504","0","61.04","28.72"
"63","000","00","007","0710","1128","778","399","379","34","812","1425","0","56.98","28.0"
"63","000","00","007","0711","0000","3416","1821","1595","155","3571","6398","0","55.81","28.46"
"63","000","00","007","0711","1144","566","323","243","26","592","1052","0","56.27","30.7"
"63","000","00","007","0711","1145","628","340","288","17","645","1135","0","56.83","29.96"
"63","000","00","007","0711","1146","662","355","307","41","703","1225","0","57.39","28.98"
"63","000","00","007","0711","1147","801","394","407","38","839","1583","0","53.0","24.89"
"63","000","00","007","0711","1148","759","409","350","33","792","1403","0","56.45","29.15"
"63","000","00","007","0712","0000","2267","1128","1139","96","2363","3995","0","59.15","28.24"
"63","000","00","007","0712","1149","784","404","380","37","821","1406","0","58.39","28.73"
"63","000","00","007","0712","1150","792","380","412","30","822","1401","0","58.67","27.12"
"63","000","00","007","0712","1151","691","344","347","29","720","1188","0","60.61","28.96"
"63","000","00","007","0713","0000","1718","505","1213","74","1792","3076","0","58.26","16.42"
"63","000","00","007","0713","1198","772","279","493","43","815","1485","0","54.88","18.79"
"63","000","00","007","0713","1199","946","226","720","31","977","1591","0","61.41","14.2"
"63","000","00","007","0714","0000","4491","1400","3091","180","4671","7544","0","61.92","18.56"
"63","000","00","007","0714","1200","876","250","626","34","910","1394","0","65.28","17.93"
"63","000","00","007","0714","1201","857","277","580","32","889","1522","0","58.41","18.2"
"63","000","00","007","0714","1202","972","268","704","36","1008","1661","0","60.69","16.13"
"63","000","00","007","0714","1203","923","306","617","36","959","1561","0","61.43","19.6"
"63","000","00","007","0714","1204","863","299","564","42","905","1406","0","64.37","21.27"
"63","000","00","007","0715","0000","2744","1390","1354","126","2870","4891","0","58.68","28.42"
"63","000","00","007","0715","1137","654","345","309","26","680","1228","0","55.37","28.09"
"63","000","00","007","0715","1138","691","340","351","40","731","1268","0","57.65","26.81"
"63","000","00","007","0715","1139","707","351","356","37","744","1207","0","61.64","29.08"
"63","000","00","007","0715","1140","692","354","338","23","715","1188","0","60.19","29.8"
"63","000","00","007","0716","0000","3206","1737","1469","154","3360","6228","0","53.95","27.89"
"63","000","00","007","0716","1152","833","512","321","50","883","1597","0","55.29","32.06"
"63","000","00","007","0716","1153","757","407","350","42","799","1290","0","61.94","31.55"
"63","000","00","007","0716","1154","877","447","430","26","903","1746","0","51.72","25.6"
"63","000","00","007","0716","1155","739","371","368","36","775","1595","0","48.59","23.26"
"63","000","00","007","0717","0000","1863","930","933","69","1932","3860","0","50.05","24.09"
"63","000","00","007","0717","1141","775","406","369","23","798","1474","0","54.14","27.54"
"63","000","00","007","0717","1142","622","269","353","26","648","1304","0","49.69","20.63"
"63","000","00","007","0717","1143","466","255","211","20","486","1082","0","44.92","23.57"
"63","000","00","007","0718","0000","4193","2014","2179","182","4375","7643","0","57.24","26.35"
"63","000","00","007","0718","1132","779","377","402","40","819","1447","0","56.6","26.05"
"63","000","00","007","0718","1133","844","403","441","28","872","1491","0","58.48","27.03"
"63","000","00","007","0718","1134","855","436","419","32","887","1500","0","59.13","29.07"
"63","000","00","007","0718","1135","895","426","469","44","939","1582","0","59.36","26.93"
"63","000","00","007","0718","1136","820","372","448","38","858","1623","0","52.87","22.92"
"63","000","00","007","0719","0000","2379","1292","1087","148","2527","4677","0","54.03","27.62"
"63","000","00","007","0719","1129","804","451","353","50","854","1591","0","53.68","28.35"
"63","000","00","007","0719","1130","769","425","344","48","817","1474","0","55.43","28.83"
"63","000","00","007","0719","1131","806","416","390","50","856","1612","0","53.1","25.81"
"63","000","00","007","0720","0000","1936","970","966","90","2026","3212","0","63.08","30.2"
"63","000","00","007","0720","1163","628","330","298","23","651","1036","0","62.84","31.85"
"63","000","00","007","0720","1164","631","337","294","34","665","1035","0","64.25","32.56"
"63","000","00","007","0720","1165","677","303","374","33","710","1141","0","62.23","26.56"
"63","000","00","007","0721","0000","2785","1242","1543","158","2943","5522","0","53.3","22.49"
"63","000","00","007","0721","1205","698","321","377","27","725","1498","0","48.4","21.43"
"63","000","00","007","0721","1206","668","310","358","45","713","1478","0","48.24","20.97"
"63","000","00","007","0721","1207","617","254","363","43","660","1170","0","56.41","21.71"
"63","000","00","007","0721","1208","802","357","445","43","845","1376","0","61.41","25.94"
"63","000","00","007","0722","0000","2258","1124","1134","102","2360","3885","0","60.75","28.93"
"63","000","00","007","0722","1166","745","354","391","26","771","1271","0","60.66","27.85"
"63","000","00","007","0722","1167","771","386","385","53","824","1328","0","62.05","29.07"
"63","000","00","007","0722","1168","742","384","358","23","765","1286","0","59.49","29.86"
"63","000","00","007","0723","0000","1627","843","784","64","1691","2903","0","58.25","29.04"
"63","000","00","007","0723","1172","939","491","448","32","971","1623","0","59.83","30.25"
"63","000","00","007","0723","1173","688","352","336","32","720","1280","0","56.25","27.5"
"63","000","00","007","0724","0000","3072","1498","1574","212","3284","6128","0","53.59","24.45"
"63","000","00","007","0724","1156","897","475","422","54","951","1701","0","55.91","27.92"
"63","000","00","007","0724","1157","616","269","347","51","667","1339","0","49.81","20.09"
"63","000","00","007","0724","1158","699","348","351","55","754","1484","0","50.81","23.45"
"63","000","00","007","0724","1159","860","406","454","52","912","1604","0","56.86","25.31"
"63","000","00","007","0725","0000","2606","1360","1246","136","2742","4923","0","55.7","27.63"
"63","000","00","007","0725","1169","933","491","442","59","992","1679","0","59.08","29.24"
"63","000","00","007","0725","1170","872","449","423","48","920","1619","0","56.83","27.73"
"63","000","00","007","0725","1171","801","420","381","29","830","1625","0","51.08","25.85"
"63","000","00","007","0726","0000","2130","1065","1065","120","2250","3767","0","59.73","28.27"
"63","000","00","007","0726","1160","685","360","325","35","720","1197","0","60.15","30.08"
"63","000","00","007","0726","1161","693","383","310","51","744","1347","0","55.23","28.43"
"63","000","00","007","0726","1162","752","322","430","34","786","1223","0","64.27","26.33"
"63","000","00","007","0727","0000","1688","814","874","85","1773","2911","0","60.91","27.96"
"63","000","00","007","0727","1180","787","391","396","46","833","1342","0","62.07","29.14"
"63","000","00","007","0727","1181","901","423","478","39","940","1569","0","59.91","26.96"
"63","000","00","007","0728","0000","2272","1114","1158","104","2376","4194","0","56.65","26.56"
"63","000","00","007","0728","1177","774","415","359","31","805","1373","0","58.63","30.23"
"63","000","00","007","0728","1178","736","337","399","52","788","1394","0","56.53","24.18"
"63","000","00","007","0728","1179","762","362","400","21","783","1427","0","54.87","25.37"
"63","000","00","007","0729","0000","1596","811","785","57","1653","3234","0","51.11","25.08"
"63","000","00","007","0729","1182","753","389","364","31","784","1514","0","51.78","25.69"
"63","000","00","007","0729","1183","843","422","421","26","869","1720","0","50.52","24.53"
"63","000","00","007","0730","0000","2550","1206","1344","137","2687","4533","0","59.28","26.6"
"63","000","00","007","0730","1174","861","409","452","48","909","1608","0","56.53","25.44"
"63","000","00","007","0730","1175","804","388","416","51","855","1453","0","58.84","26.7"
"63","000","00","007","0730","1176","885","409","476","38","923","1472","0","62.7","27.79"
"63","000","00","007","0731","0000","2212","1081","1131","113","2325","4154","0","55.97","26.02"
"63","000","00","007","0731","1188","684","321","363","35","719","1307","0","55.01","24.56"
"63","000","00","007","0731","1189","784","366","418","52","836","1420","0","58.87","25.77"
"63","000","00","007","0731","1190","744","394","350","26","770","1427","0","53.96","27.61"
"63","000","00","007","0732","0000","3191","1628","1563","138","3329","5505","0","60.47","29.57"
"63","000","00","007","0732","1184","869","456","413","51","920","1461","0","62.97","31.21"
"63","000","00","007","0732","1185","695","356","339","25","720","1264","0","56.96","28.16"
"63","000","00","007","0732","1186","796","404","392","37","833","1334","0","62.44","30.28"
"63","000","00","007","0732","1187","831","412","419","25","856","1446","0","59.2","28.49"
"63","000","00","007","0733","0000","2720","1027","1693","136","2856","4900","0","58.29","20.96"
"63","000","00","007","0733","1191","518","213","305","25","543","956","0","56.8","22.28"
"63","000","00","007","0733","1192","738","299","439","53","791","1352","0","58.51","22.12"
"63","000","00","007","0733","1193","760","313","447","29","789","1370","0","57.59","22.85"
"63","000","00","007","0733","1194","704","202","502","29","733","1222","0","59.98","16.53"
"63","000","00","007","0734","0000","2354","849","1505","127","2481","4365","0","56.84","19.45"
"63","000","00","007","0734","1195","753","240","513","47","800","1375","0","58.18","17.45"
"63","000","00","007","0734","1196","818","261","557","43","861","1463","0","58.85","17.84"
"63","000","00","007","0734","1197","783","348","435","37","820","1527","0","53.7","22.79"
"63","000","00","007","0735","0000","1921","799","1122","104","2025","3296","0","61.44","24.24"
"63","000","00","007","0735","1209","610","238","372","17","627","1093","0","57.37","21.77"
"63","000","00","007","0735","1210","647","285","362","42","689","1084","0","63.56","26.29"
"63","000","00","007","0735","1211","664","276","388","45","709","1119","0","63.36","24.66"
"63","000","00","007","0736","0000","1621","636","985","59","1680","2777","0","60.5","22.9"
"63","000","00","007","0736","1212","829","315","514","31","860","1381","0","62.27","22.81"
"63","000","00","007","0736","1213","792","321","471","28","820","1396","0","58.74","22.99"
"63","000","00","008","0000","0000","131523","50746","80777","5573","137096","227211","273883","60.34","22.33"
"63","000","00","008","0801","0000","3490","1509","1981","139","3629","6228","0","58.27","24.23"
"63","000","00","008","0801","1402","843","373","470","26","869","1539","0","56.47","24.24"
"63","000","00","008","0801","1403","815","345","470","30","845","1548","0","54.59","22.29"
"63","000","00","008","0801","1404","870","365","505","42","912","1493","0","61.09","24.45"
"63","000","00","008","0801","1405","962","426","536","41","1003","1648","0","60.86","25.85"
"63","000","00","008","0802","0000","3499","1453","2046","154","3653","6155","0","59.35","23.61"
"63","000","00","008","0802","1406","859","344","515","43","902","1544","0","58.42","22.28"
"63","000","00","008","0802","1407","876","431","445","33","909","1557","0","58.38","27.68"
"63","000","00","008","0802","1408","814","285","529","39","853","1514","0","56.34","18.82"
"63","000","00","008","0802","1409","950","393","557","39","989","1540","0","64.22","25.52"
"63","000","00","008","0803","0000","2588","1038","1550","111","2699","4365","0","61.83","23.78"
"63","000","00","008","0803","1410","879","353","526","34","913","1466","0","62.28","24.08"
"63","000","00","008","0803","1411","870","340","530","29","899","1444","0","62.26","23.55"
"63","000","00","008","0803","1412","839","345","494","48","887","1455","0","60.96","23.71"
"63","000","00","008","0804","0000","3264","1397","1867","146","3410","5676","0","60.08","24.61"
"63","000","00","008","0804","1413","773","295","478","39","812","1440","0","56.39","20.49"
"63","000","00","008","0804","1414","829","344","485","38","867","1398","0","62.02","24.61"
"63","000","00","008","0804","1415","866","404","462","24","890","1412","0","63.03","28.61"
"63","000","00","008","0804","1416","796","354","442","45","841","1426","0","58.98","24.82"
"63","000","00","008","0805","0000","2478","932","1546","108","2586","4345","0","59.52","21.45"
"63","000","00","008","0805","1417","813","325","488","45","858","1437","0","59.71","22.62"
"63","000","00","008","0805","1418","769","280","489","40","809","1340","0","60.37","20.9"
"63","000","00","008","0805","1419","896","327","569","23","919","1568","0","58.61","20.85"
"63","000","00","008","0806","0000","2883","1112","1771","108","2991","5016","0","59.63","22.17"
"63","000","00","008","0806","1420","792","282","510","20","812","1372","0","59.18","20.55"
"63","000","00","008","0806","1421","597","238","359","26","623","1046","0","59.56","22.75"
"63","000","00","008","0806","1422","735","290","445","36","771","1274","0","60.52","22.76"
"63","000","00","008","0806","1423","759","302","457","26","785","1324","0","59.29","22.81"
"63","000","00","008","0807","0000","2823","1076","1747","100","2923","4829","0","60.53","22.28"
"63","000","00","008","0807","1424","967","404","563","29","996","1722","0","57.84","23.46"
"63","000","00","008","0807","1425","1006","368","638","50","1056","1737","0","60.79","21.19"
"63","000","00","008","0807","1426","850","304","546","21","871","1370","0","63.58","22.19"
"63","000","00","008","0808","0000","2333","953","1380","86","2419","3961","0","61.07","24.06"
"63","000","00","008","0808","1427","858","348","510","30","888","1495","0","59.4","23.28"
"63","000","00","008","0808","1428","779","311","468","34","813","1328","0","61.22","23.42"
"63","000","00","008","0808","1429","696","294","402","22","718","1138","0","63.09","25.83"
"63","000","00","008","0809","0000","3795","1446","2349","154","3949","6217","0","63.52","23.26"
"63","000","00","008","0809","1430","904","323","581","28","932","1471","0","63.36","21.96"
"63","000","00","008","0809","1431","694","262","432","19","713","1144","0","62.33","22.9"
"63","000","00","008","0809","1432","716","262","454","39","755","1176","0","64.2","22.28"
"63","000","00","008","0809","1433","741","312","429","37","778","1212","0","64.19","25.74"
"63","000","00","008","0809","1434","740","287","453","31","771","1214","0","63.51","23.64"
"63","000","00","008","0810","0000","2763","1178","1585","133","2896","4778","0","60.61","24.65"
"63","000","00","008","0810","1435","648","311","337","28","676","1170","0","57.78","26.58"
"63","000","00","008","0810","1436","773","332","441","38","811","1308","0","62.0","25.38"
"63","000","00","008","0810","1437","703","303","400","34","737","1190","0","61.93","25.46"
"63","000","00","008","0810","1438","639","232","407","33","672","1110","0","60.54","20.9"
"63","000","00","008","0811","0000","1695","530","1165","75","1770","2899","0","61.06","18.28"
"63","000","00","008","0811","1439","880","313","567","26","906","1512","0","59.92","20.7"
"63","000","00","008","0811","1440","815","217","598","49","864","1387","0","62.29","15.65"
"63","000","00","008","0812","0000","2419","943","1476","120","2539","4209","0","60.32","22.4"
"63","000","00","008","0812","1441","779","306","473","38","817","1355","0","60.3","22.58"
"63","000","00","008","0812","1442","789","330","459","43","832","1370","0","60.73","24.09"
"63","000","00","008","0812","1443","851","307","544","39","890","1484","0","59.97","20.69"
"63","000","00","008","0813","0000","2497","940","1557","118","2615","4240","0","61.67","22.17"
"63","000","00","008","0813","1444","1012","411","601","45","1057","1786","0","59.18","23.01"
"63","000","00","008","0813","1445","726","228","498","45","771","1260","0","61.19","18.1"
"63","000","00","008","0813","1446","759","301","458","28","787","1194","0","65.91","25.21"
"63","000","00","008","0814","0000","1696","661","1035","75","1771","2936","0","60.32","22.51"
"63","000","00","008","0814","1450","814","373","441","42","856","1450","0","59.03","25.72"
"63","000","00","008","0814","1451","882","288","594","33","915","1486","0","61.57","19.38"
"63","000","00","008","0815","0000","4201","1718","2483","134","4335","6643","0","65.26","25.86"
"63","000","00","008","0815","1452","756","272","484","23","779","1259","0","61.87","21.6"
"63","000","00","008","0815","1453","795","300","495","14","809","1317","0","61.43","22.78"
"63","000","00","008","0815","1454","1097","629","468","34","1131","1321","0","85.62","47.62"
"63","000","00","008","0815","1455","836","266","570","36","872","1475","0","59.12","18.03"
"63","000","00","008","0815","1456","717","251","466","27","744","1271","0","58.54","19.75"
"63","000","00","008","0816","0000","2934","1134","1800","128","3062","5159","0","59.35","21.98"
"63","000","00","008","0816","1457","928","385","543","42","970","1609","0","60.29","23.93"
"63","000","00","008","0816","1458","823","294","529","29","852","1501","0","56.76","19.59"
"63","000","00","008","0816","1459","528","198","330","25","553","997","0","55.47","19.86"
"63","000","00","008","0816","1460","655","257","398","32","687","1052","0","65.3","24.43"
"63","000","00","008","0817","0000","2867","1104","1763","137","3004","4847","0","61.98","22.78"
"63","000","00","008","0817","1461","734","245","489","34","768","1247","0","61.59","19.65"
"63","000","00","008","0817","1462","681","338","343","43","724","1167","0","62.04","28.96"
"63","000","00","008","0817","1463","762","279","483","29","791","1280","0","61.8","21.8"
"63","000","00","008","0817","1464","690","242","448","31","721","1153","0","62.53","20.99"
"63","000","00","008","0818","0000","3490","1205","2285","134","3624","5817","0","62.3","20.72"
"63","000","00","008","0818","1465","914","320","594","41","955","1557","0","61.34","20.55"
"63","000","00","008","0818","1466","833","273","560","31","864","1444","0","59.83","18.91"
"63","000","00","008","0818","1467","912","323","589","33","945","1459","0","64.77","22.14"
"63","000","00","008","0818","1468","831","289","542","29","860","1357","0","63.38","21.3"
"63","000","00","008","0819","0000","3022","1244","1778","125","3147","4847","0","64.93","25.67"
"63","000","00","008","0819","1469","768","314","454","33","801","1194","0","67.09","26.3"
"63","000","00","008","0819","1470","729","321","408","35","764","1184","0","64.53","27.11"
"63","000","00","008","0819","1471","696","286","410","26","722","1119","0","64.52","25.56"
"63","000","00","008","0819","1472","829","323","506","31","860","1350","0","63.7","23.93"
"63","000","00","008","0820","0000","4312","1676","2636","160","4472","7265","0","61.56","23.07"
"63","000","00","008","0820","1473","828","286","542","35","863","1502","0","57.46","19.04"
"63","000","00","008","0820","1474","881","295","586","37","918","1511","0","60.75","19.52"
"63","000","00","008","0820","1475","912","322","590","28","940","1481","0","63.47","21.74"
"63","000","00","008","0820","1476","915","507","408","27","942","1477","0","63.78","34.33"
"63","000","00","008","0820","1477","776","266","510","33","809","1294","0","62.52","20.56"
"63","000","00","008","0821","0000","2181","855","1326","88","2269","3516","0","64.53","24.32"
"63","000","00","008","0821","1478","690","247","443","22","712","1040","0","68.46","23.75"
"63","000","00","008","0821","1479","808","348","460","32","840","1323","0","63.49","26.3"
"63","000","00","008","0821","1480","683","260","423","34","717","1153","0","62.19","22.55"
"63","000","00","008","0822","0000","3432","1317","2115","170","3602","5896","0","61.09","22.34"
"63","000","00","008","0822","1481","873","299","574","28","901","1525","0","59.08","19.61"
"63","000","00","008","0822","1482","770","300","470","69","839","1412","0","59.42","21.25"
"63","000","00","008","0822","1483","899","349","550","40","939","1473","0","63.75","23.69"
"63","000","00","008","0822","1484","890","369","521","33","923","1486","0","62.11","24.83"
"63","000","00","008","0823","0000","3628","1246","2382","154","3782","6013","0","62.9","20.72"
"63","000","00","008","0823","1485","969","295","674","46","1015","1616","0","62.81","18.25"
"63","000","00","008","0823","1486","911","318","593","40","951","1489","0","63.87","21.36"
"63","000","00","008","0823","1487","818","295","523","32","850","1414","0","60.11","20.86"
"63","000","00","008","0823","1488","930","338","592","36","966","1494","0","64.66","22.62"
"63","000","00","008","0824","0000","4701","1816","2885","189","4890","7764","0","62.98","23.39"
"63","000","00","008","0824","1489","919","333","586","42","961","1547","0","62.12","21.53"
"63","000","00","008","0824","1490","924","368","556","47","971","1587","0","61.18","23.19"
"63","000","00","008","0824","1491","946","348","598","27","973","1515","0","64.22","22.97"
"63","000","00","008","0824","1492","949","365","584","41","990","1573","0","62.94","23.2"
"63","000","00","008","0824","1493","963","402","561","32","995","1542","0","64.53","26.07"
"63","000","00","008","0825","0000","1765","731","1034","107","1872","3536","0","52.94","20.67"
"63","000","00","008","0825","1494","769","310","459","41","810","1465","0","55.29","21.16"
"63","000","00","008","0825","1495","320","156","164","27","347","699","0","49.64","22.32"
"63","000","00","008","0825","1496","676","265","411","39","715","1372","0","52.11","19.31"
"63","000","00","008","0826","0000","3382","1300","2082","144","3526","6057","0","58.21","21.46"
"63","000","00","008","0826","1497","713","298","415","40","753","1448","0","52.0","20.58"
"63","000","00","008","0826","1498","872","332","540","44","916","1548","0","59.17","21.45"
"63","000","00","008","0826","1499","867","322","545","34","901","1501","0","60.03","21.45"
"63","000","00","008","0826","1500","930","348","582","26","956","1560","0","61.28","22.31"
"63","000","00","008","0827","0000","4492","1459","3033","176","4668","7736","0","60.34","18.86"
"63","000","00","008","0827","1501","900","269","631","30","930","1567","0","59.35","17.17"
"63","000","00","008","0827","1502","887","321","566","34","921","1554","0","59.27","20.66"
"63","000","00","008","0827","1503","875","309","566","42","917","1544","0","59.39","20.01"
"63","000","00","008","0827","1504","899","283","616","36","935","1528","0","61.19","18.52"
"63","000","00","008","0827","1505","931","277","654","34","965","1543","0","62.54","17.95"
"63","000","00","008","0828","0000","4303","1787","2516","196","4499","9127","0","49.29","19.58"
"63","000","00","008","0828","1506","934","401","533","32","966","2754","0","35.08","14.56"
"63","000","00","008","0828","1507","847","357","490","45","892","1709","0","52.19","20.89"
"63","000","00","008","0828","1508","824","343","481","46","870","1515","0","57.43","22.64"
"63","000","00","008","0828","1509","813","306","507","40","853","1571","0","54.3","19.48"
"63","000","00","008","0828","1510","885","380","505","33","918","1578","0","58.17","24.08"
"63","000","00","008","0829","0000","3794","1485","2309","192","3986","6503","0","61.29","22.84"
"63","000","00","008","0829","1511","786","317","469","39","825","1454","0","56.74","21.8"
"63","000","00","008","0829","1512","879","311","568","46","925","1436","0","64.42","21.66"
"63","000","00","008","0829","1513","849","349","500","33","882","1402","0","62.91","24.89"
"63","000","00","008","0829","1514","670","293","377","32","702","1117","0","62.85","26.23"
"63","000","00","008","0829","1515","610","215","395","42","652","1094","0","59.6","19.65"
"63","000","00","008","0830","0000","4225","1599","2626","201","4426","7402","0","59.79","21.6"
"63","000","00","008","0830","1519","660","279","381","37","697","1385","0","50.32","20.14"
"63","000","00","008","0830","1520","839","310","529","40","879","1416","0","62.08","21.89"
"63","000","00","008","0830","1521","865","324","541","41","906","1412","0","64.16","22.95"
"63","000","00","008","0830","1522","851","342","509","43","894","1535","0","58.24","22.28"
"63","000","00","008","0830","1523","1010","344","666","40","1050","1654","0","63.48","20.8"
"63","000","00","008","0831","0000","2910","1099","1811","98","3008","4781","0","62.92","22.99"
"63","000","00","008","0831","1524","717","283","434","16","733","1156","0","63.41","24.48"
"63","000","00","008","0831","1525","751","277","474","32","783","1231","0","63.61","22.5"
"63","000","00","008","0831","1526","703","277","426","29","732","1218","0","60.1","22.74"
"63","000","00","008","0831","1527","739","262","477","21","760","1176","0","64.63","22.28"
"63","000","00","008","0832","0000","2800","1080","1720","131","2931","4889","0","59.95","22.09"
"63","000","00","008","0832","1532","899","354","545","48","947","1613","0","58.71","21.95"
"63","000","00","008","0832","1533","999","399","600","36","1035","1697","0","60.99","23.51"
"63","000","00","008","0832","1534","902","327","575","47","949","1579","0","60.1","20.71"
"63","000","00","008","0833","0000","4021","1510","2511","183","4204","6932","0","60.65","21.78"
"63","000","00","008","0833","1538","954","380","574","38","992","1646","0","60.27","23.09"
"63","000","00","008","0833","1539","756","268","488","31","787","1286","0","61.2","20.84"
"63","000","00","008","0833","1540","718","253","465","35","753","1219","0","61.77","20.75"
"63","000","00","008","0833","1541","780","291","489","34","814","1292","0","63.0","22.52"
"63","000","00","008","0833","1542","813","318","495","45","858","1489","0","57.62","21.36"
"63","000","00","008","0834","0000","2864","1083","1781","105","2969","5133","0","57.84","21.1"
"63","000","00","008","0834","1547","886","367","519","33","919","1816","0","50.61","20.21"
"63","000","00","008","0834","1548","546","231","315","23","569","985","0","57.77","23.45"
"63","000","00","008","0834","1549","792","248","544","21","813","1314","0","61.87","18.87"
"63","000","00","008","0834","1550","640","237","403","28","668","1018","0","65.62","23.28"
"63","000","00","008","0835","0000","4156","1603","2553","173","4329","7131","0","60.71","22.48"
"63","000","00","008","0835","1551","920","337","583","55","975","1578","0","61.79","21.36"
"63","000","00","008","0835","1552","833","310","523","25","858","1457","0","58.89","21.28"
"63","000","00","008","0835","1553","797","299","498","31","828","1326","0","62.44","22.55"
"63","000","00","008","0835","1554","832","323","509","34","866","1393","0","62.17","23.19"
"63","000","00","008","0835","1555","774","334","440","28","802","1377","0","58.24","24.26"
"63","000","00","008","0836","0000","1881","827","1054","116","1997","3454","0","57.82","23.94"
"63","000","00","008","0836","1560","763","309","454","33","796","1288","0","61.8","23.99"
"63","000","00","008","0836","1561","676","269","407","45","721","1301","0","55.42","20.68"
"63","000","00","008","0836","1562","442","249","193","38","480","865","0","55.49","28.79"
"63","000","00","008","0837","0000","426","225","201","23","449","789","0","56.91","28.52"
"63","000","00","008","0837","1563","426","225","201","23","449","789","0","56.91","28.52"
"63","000","00","008","0838","0000","2232","744","1488","106","2338","3615","0","64.67","20.58"
"63","000","00","008","0838","1516","643","208","435","45","688","1070","0","64.3","19.44"
"63","000","00","008","0838","1517","827","281","546","27","854","1319","0","64.75","21.3"
"63","000","00","008","0838","1518","762","255","507","34","796","1226","0","64.93","20.8"
"63","000","00","008","0839","0000","3563","1354","2209","145","3708","6498","0","57.06","20.84"
"63","000","00","008","0839","1543","952","373","579","38","990","1611","0","61.45","23.15"
"63","000","00","008","0839","1544","785","300","485","33","818","1549","0","52.81","19.37"
"63","000","00","008","0839","1545","903","319","584","43","946","1678","0","56.38","19.01"
"63","000","00","008","0839","1546","923","362","561","31","954","1660","0","57.47","21.81"
"63","000","00","008","0840","0000","3681","1405","2276","129","3810","6091","0","62.55","23.07"
"63","000","00","008","0840","1556","844","344","500","29","873","1448","0","60.29","23.76"
"63","000","00","008","0840","1557","894","319","575","26","920","1447","0","63.58","22.05"
"63","000","00","008","0840","1558","1088","427","661","47","1135","1739","0","65.27","24.55"
"63","000","00","008","0840","1559","855","315","540","27","882","1457","0","60.54","21.62"
"63","000","00","008","0841","0000","3002","1153","1849","120","3122","5308","0","58.82","21.72"
"63","000","00","008","0841","1528","844","321","523","10","854","1392","0","61.35","23.06"
"63","000","00","008","0841","1529","647","221","426","42","689","1323","0","52.08","16.7"
"63","000","00","008","0841","1530","725","295","430","36","761","1297","0","58.67","22.74"
"63","000","00","008","0841","1531","786","316","470","32","818","1296","0","63.12","24.38"
"63","000","00","008","0842","0000","2572","837","1735","103","2675","4385","0","61.0","19.09"
"63","000","00","008","0842","1447","842","316","526","35","877","1444","0","60.73","21.88"
"63","000","00","008","0842","1448","874","281","593","34","908","1495","0","60.74","18.8"
"63","000","00","008","0842","1449","856","240","616","34","890","1446","0","61.55","16.6"
"63","000","00","008","0843","0000","2463","982","1481","79","2542","4223","0","60.19","23.25"
"63","000","00","008","0843","1535","812","336","476","36","848","1320","0","64.24","25.45"
"63","000","00","008","0843","1536","849","323","526","24","873","1438","0","60.71","22.46"
"63","000","00","008","0843","1537","802","323","479","19","821","1465","0","56.04","22.05"
"63","000","00","009","0000","0000","57618","25347","32271","2196","59814","101907","121769","58.69","24.87"
"63","000","00","009","0901","0000","2979","1374","1605","101","3080","5655","0","54.47","24.3"
"63","000","00","009","0901","0455","692","352","340","15","707","1280","0","55.23","27.5"
"63","000","00","009","0901","0456","773","349","424","21","794","1351","0","58.77","25.83"
"63","000","00","009","0901","0457","779","330","449","34","813","1345","0","60.45","24.54"
"63","000","00","009","0901","0458","735","343","392","31","766","1679","0","45.62","20.43"
"63","000","00","009","0902","0000","1701","796","905","68","1769","3315","0","53.36","24.01"
"63","000","00","009","0902","0459","877","417","460","31","908","1680","0","54.05","24.82"
"63","000","00","009","0902","0460","824","379","445","37","861","1635","0","52.66","23.18"
"63","000","00","009","0903","0000","2124","1043","1081","92","2216","3486","0","63.57","29.92"
"63","000","00","009","0903","0465","682","318","364","24","706","1086","0","65.01","29.28"
"63","000","00","009","0903","0466","741","371","370","41","782","1202","0","65.06","30.87"
"63","000","00","009","0903","0467","701","354","347","27","728","1198","0","60.77","29.55"
"63","000","00","009","0904","0000","3439","1463","1976","118","3557","6330","0","56.19","23.11"
"63","000","00","009","0904","0461","797","410","387","29","826","1459","0","56.61","28.1"
"63","000","00","009","0904","0462","973","402","571","28","1001","1706","0","58.68","23.56"
"63","000","00","009","0904","0463","851","355","496","43","894","1674","0","53.41","21.21"
"63","000","00","009","0904","0464","818","296","522","18","836","1491","0","56.07","19.85"
"63","000","00","009","0905","0000","3469","1543","1926","139","3608","6336","0","56.94","24.35"
"63","000","00","009","0905","0483","766","329","437","41","807","1518","0","53.16","21.67"
"63","000","00","009","0905","0484","918","420","498","34","952","1552","0","61.34","27.06"
"63","000","00","009","0905","0485","874","379","495","28","902","1658","0","54.4","22.86"
"63","000","00","009","0905","0486","911","415","496","36","947","1608","0","58.89","25.81"
"63","000","00","009","0906","0000","1794","744","1050","49","1843","3337","0","55.23","22.3"
"63","000","00","009","0906","0504","825","341","484","23","848","1649","0","51.43","20.68"
"63","000","00","009","0906","0505","969","403","566","26","995","1688","0","58.95","23.87"
"63","000","00","009","0907","0000","2376","1015","1361","96","2472","4093","0","60.4","24.8"
"63","000","00","009","0907","0490","789","350","439","35","824","1397","0","58.98","25.05"
"63","000","00","009","0907","0491","800","333","467","33","833","1352","0","61.61","24.63"
"63","000","00","009","0907","0492","787","332","455","28","815","1344","0","60.64","24.7"
"63","000","00","009","0908","0000","2296","1151","1145","76","2372","4165","0","56.95","27.64"
"63","000","00","009","0908","0493","746","370","376","25","771","1385","0","55.67","26.71"
"63","000","00","009","0908","0494","797","393","404","22","819","1399","0","58.54","28.09"
"63","000","00","009","0908","0495","753","388","365","29","782","1381","0","56.63","28.1"
"63","000","00","009","0909","0000","2342","1147","1195","91","2433","4228","0","57.54","27.13"
"63","000","00","009","0909","0496","821","395","426","42","863","1548","0","55.75","25.52"
"63","000","00","009","0909","0497","652","320","332","24","676","1190","0","56.81","26.89"
"63","000","00","009","0909","0498","869","432","437","25","894","1490","0","60.0","28.99"
"63","000","00","009","0910","0000","3560","1595","1965","119","3679","5983","0","61.49","26.66"
"63","000","00","009","0910","0499","679","312","367","22","701","1096","0","63.96","28.47"
"63","000","00","009","0910","0500","750","337","413","26","776","1238","0","62.68","27.22"
"63","000","00","009","0910","0501","778","316","462","26","804","1271","0","63.26","24.86"
"63","000","00","009","0910","0502","648","296","352","24","672","1146","0","58.64","25.83"
"63","000","00","009","0910","0503","705","334","371","21","726","1232","0","58.93","27.11"
"63","000","00","009","0911","0000","4023","1638","2385","161","4184","6741","0","62.07","24.3"
"63","000","00","009","0911","0518","753","306","447","26","779","1225","0","63.59","24.98"
"63","000","00","009","0911","0519","766","379","387","37","803","1264","0","63.53","29.98"
"63","000","00","009","0911","0520","968","386","582","52","1020","1649","0","61.86","23.41"
"63","000","00","009","0911","0521","762","283","479","20","782","1267","0","61.72","22.34"
"63","000","00","009","0911","0522","774","284","490","26","800","1336","0","59.88","21.26"
"63","000","00","009","0912","0000","2205","925","1280","109","2314","3805","0","60.81","24.31"
"63","000","00","009","0912","0509","702","279","423","47","749","1195","0","62.68","23.35"
"63","000","00","009","0912","0510","736","369","367","18","754","1254","0","60.13","29.43"
"63","000","00","009","0912","0511","767","277","490","44","811","1356","0","59.81","20.43"
"63","000","00","009","0913","0000","2384","1061","1323","100","2484","4011","0","61.93","26.45"
"63","000","00","009","0913","0512","811","381","430","39","850","1363","0","62.36","27.95"
"63","000","00","009","0913","0513","796","330","466","39","835","1317","0","63.4","25.06"
"63","000","00","009","0913","0514","777","350","427","22","799","1331","0","60.03","26.3"
"63","000","00","009","0914","0000","2671","1179","1492","96","2767","4733","0","58.46","24.91"
"63","000","00","009","0914","0515","904","380","524","41","945","1610","0","58.7","23.6"
"63","000","00","009","0914","0516","859","383","476","22","881","1542","0","57.13","24.84"
"63","000","00","009","0914","0517","908","416","492","33","941","1581","0","59.52","26.31"
"63","000","00","009","0915","0000","2587","1100","1487","89","2676","4508","0","59.36","24.4"
"63","000","00","009","0915","0506","887","347","540","41","928","1503","0","61.74","23.09"
"63","000","00","009","0915","0507","858","390","468","21","879","1542","0","57.0","25.29"
"63","000","00","009","0915","0508","842","363","479","27","869","1463","0","59.4","24.81"
"63","000","00","009","0916","0000","4058","1835","2223","186","4244","7922","0","53.57","23.16"
"63","000","00","009","0916","0478","797","342","455","41","838","1529","0","54.81","22.37"
"63","000","00","009","0916","0479","835","408","427","39","874","1618","0","54.02","25.22"
"63","000","00","009","0916","0480","735","356","379","34","769","1545","0","49.77","23.04"
"63","000","00","009","0916","0481","860","355","505","42","902","1569","0","57.49","22.63"
"63","000","00","009","0916","0482","831","374","457","30","861","1661","0","51.84","22.52"
"63","000","00","009","0917","0000","4722","2138","2584","178","4900","8171","0","59.97","26.17"
"63","000","00","009","0917","0468","777","366","411","20","797","1430","0","55.73","25.59"
"63","000","00","009","0917","0469","753","353","400","38","791","1275","0","62.04","27.69"
"63","000","00","009","0917","0470","835","408","427","38","873","1344","0","64.96","30.36"
"63","000","00","009","0917","0471","818","338","480","27","845","1391","0","60.75","24.3"
"63","000","00","009","0917","0472","806","327","479","20","826","1342","0","61.55","24.37"
"63","000","00","009","0917","0473","733","346","387","35","768","1389","0","55.29","24.91"
"63","000","00","009","0918","0000","3227","1293","1934","108","3335","5592","0","59.64","23.12"
"63","000","00","009","0918","0474","833","391","442","34","867","1426","0","60.8","27.42"
"63","000","00","009","0918","0475","794","223","571","15","809","1359","0","59.53","16.41"
"63","000","00","009","0918","0476","754","365","389","38","792","1366","0","57.98","26.72"
"63","000","00","009","0918","0477","846","314","532","21","867","1441","0","60.17","21.79"
"63","000","00","009","0919","0000","2958","1165","1793","113","3071","4916","0","62.47","23.7"
"63","000","00","009","0919","0523","696","260","436","26","722","1162","0","62.13","22.38"
"63","000","00","009","0919","0524","621","258","363","16","637","1045","0","60.96","24.69"
"63","000","00","009","0919","0525","875","354","521","36","911","1351","0","67.43","26.2"
"63","000","00","009","0919","0526","766","293","473","35","801","1358","0","58.98","21.58"
"63","000","00","009","0920","0000","2703","1142","1561","107","2810","4580","0","61.35","24.93"
"63","000","00","009","0920","0487","801","348","453","30","831","1475","0","56.34","23.59"
"63","000","00","009","0920","0488","1020","437","583","44","1064","1722","0","61.79","25.38"
"63","000","00","009","0920","0489","882","357","525","33","915","1383","0","66.16","25.81"
"63","000","00","010","0000","0000","134705","57038","77667","4713","139418","236824","287227","58.87","24.08"
"63","000","00","010","1001","0000","3640","1676","1964","132","3772","6500","0","58.03","25.78"
"63","000","00","010","1001","0305","869","410","459","14","883","1661","0","53.16","24.68"
"63","000","00","010","1001","0306","861","404","457","44","905","1602","0","56.49","25.22"
"63","000","00","010","1001","0307","976","436","540","37","1013","1655","0","61.21","26.34"
"63","000","00","010","1001","0308","934","426","508","37","971","1582","0","61.38","26.93"
"63","000","00","010","1002","0000","4699","1863","2836","184","4883","8357","0","58.43","22.29"
"63","000","00","010","1002","0309","913","364","549","31","944","1688","0","55.92","21.56"
"63","000","00","010","1002","0310","968","409","559","35","1003","1737","0","57.74","23.55"
"63","000","00","010","1002","0311","1036","392","644","33","1069","1809","0","59.09","21.67"
"63","000","00","010","1002","0312","765","335","430","27","792","1376","0","57.56","24.35"
"63","000","00","010","1002","0313","1017","363","654","58","1075","1747","0","61.53","20.78"
"63","000","00","010","1003","0000","3615","1578","2037","125","3740","5914","0","63.24","26.68"
"63","000","00","010","1003","0314","841","357","484","24","865","1389","0","62.28","25.7"
"63","000","00","010","1003","0315","880","380","500","27","907","1454","0","62.38","26.13"
"63","000","00","010","1003","0316","914","414","500","37","951","1468","0","64.78","28.2"
"63","000","00","010","1003","0317","980","427","553","37","1017","1603","0","63.44","26.64"
"63","000","00","010","1005","0000","3048","1311","1737","118","3166","5276","0","60.01","24.85"
"63","000","00","010","1005","0318","987","420","567","36","1023","1795","0","56.99","23.4"
"63","000","00","010","1005","0319","1048","434","614","46","1094","1737","0","62.98","24.99"
"63","000","00","010","1005","0320","1013","457","556","36","1049","1744","0","60.15","26.2"
"63","000","00","010","1006","0000","2780","1192","1588","82","2862","4732","0","60.48","25.19"
"63","000","00","010","1006","0321","944","405","539","36","980","1661","0","59.0","24.38"
"63","000","00","010","1006","0322","917","402","515","28","945","1577","0","59.92","25.49"
"63","000","00","010","1006","0323","919","385","534","18","937","1494","0","62.72","25.77"
"63","000","00","010","1007","0000","4753","2038","2715","195","4948","8285","0","59.72","24.6"
"63","000","00","010","1007","0324","925","415","510","40","965","1626","0","59.35","25.52"
"63","000","00","010","1007","0325","919","364","555","58","977","1641","0","59.54","22.18"
"63","000","00","010","1007","0326","901","381","520","26","927","1554","0","59.65","24.52"
"63","000","00","010","1007","0327","1024","466","558","34","1058","1728","0","61.23","26.97"
"63","000","00","010","1007","0328","984","412","572","37","1021","1736","0","58.81","23.73"
"63","000","00","010","1008","0000","4485","1971","2514","138","4623","7740","0","59.73","25.47"
"63","000","00","010","1008","0329","905","374","531","33","938","1461","0","64.2","25.6"
"63","000","00","010","1008","0330","879","386","493","30","909","1509","0","60.24","25.58"
"63","000","00","010","1008","0331","772","333","439","16","788","1358","0","58.03","24.52"
"63","000","00","010","1008","0332","979","456","523","34","1013","1761","0","57.52","25.89"
"63","000","00","010","1008","0333","950","422","528","25","975","1651","0","59.06","25.56"
"63","000","00","010","1009","0000","3089","1306","1783","113","3202","5472","0","58.52","23.87"
"63","000","00","010","1009","0334","1044","447","597","45","1089","1809","0","60.2","24.71"
"63","000","00","010","1009","0335","1009","438","571","34","1043","1773","0","58.83","24.7"
"63","000","00","010","1009","0336","1036","421","615","34","1070","1890","0","56.61","22.28"
"63","000","00","010","1010","0000","4356","1637","2719","133","4489","7310","0","61.41","22.39"
"63","000","00","010","1010","0337","1095","445","650","43","1138","1760","0","64.66","25.28"
"63","000","00","010","1010","0338","962","345","617","22","984","1645","0","59.82","20.97"
"63","000","00","010","1010","0339","815","329","486","25","840","1324","0","63.44","24.85"
"63","000","00","010","1010","0340","639","208","431","29","668","1072","0","62.31","19.4"
"63","000","00","010","1010","0341","845","310","535","14","859","1509","0","56.93","20.54"
"63","000","00","010","1011","0000","4123","1831","2292","135","4258","7069","0","60.23","25.9"
"63","000","00","010","1011","0342","978","468","510","33","1011","1715","0","58.95","27.29"
"63","000","00","010","1011","0343","1025","457","568","30","1055","1774","0","59.47","25.76"
"63","000","00","010","1011","0344","1110","457","653","42","1152","1796","0","64.14","25.45"
"63","000","00","010","1011","0345","1010","449","561","30","1040","1784","0","58.3","25.17"
"63","000","00","010","1012","0000","2859","1231","1628","83","2942","4835","0","60.85","25.46"
"63","000","00","010","1012","0346","844","382","462","28","872","1417","0","61.54","26.96"
"63","000","00","010","1012","0347","957","397","560","24","981","1699","0","57.74","23.37"
"63","000","00","010","1012","0348","1058","452","606","31","1089","1719","0","63.35","26.29"
"63","000","00","010","1013","0000","2628","1158","1470","83","2711","4784","0","56.67","24.21"
"63","000","00","010","1013","0349","999","419","580","24","1023","1715","0","59.65","24.43"
"63","000","00","010","1013","0350","849","370","479","22","871","1634","0","53.3","22.64"
"63","000","00","010","1013","0351","780","369","411","37","817","1435","0","56.93","25.71"
"63","000","00","010","1014","0000","3307","1497","1810","126","3433","5804","0","59.15","25.79"
"63","000","00","010","1014","0352","822","386","436","22","844","1440","0","58.61","26.81"
"63","000","00","010","1014","0353","865","353","512","26","891","1446","0","61.62","24.41"
"63","000","00","010","1014","0354","874","414","460","36","910","1657","0","54.92","24.98"
"63","000","00","010","1014","0355","746","344","402","42","788","1261","0","62.49","27.28"
"63","000","00","010","1015","0000","3647","1659","1988","145","3792","6183","0","61.33","26.83"
"63","000","00","010","1015","0356","223","138","85","16","239","456","0","52.41","30.26"
"63","000","00","010","1015","0357","918","439","479","30","948","1433","0","66.15","30.64"
"63","000","00","010","1015","0358","866","373","493","25","891","1485","0","60.0","25.12"
"63","000","00","010","1015","0359","890","393","497","29","919","1590","0","57.8","24.72"
"63","000","00","010","1015","0360","750","316","434","45","795","1219","0","65.22","25.92"
"63","000","00","010","1016","0000","2880","1118","1762","96","2976","5096","0","58.4","21.94"
"63","000","00","010","1016","0361","948","402","546","32","980","1732","0","56.58","23.21"
"63","000","00","010","1016","0362","995","330","665","25","1020","1727","0","59.06","19.11"
"63","000","00","010","1016","0363","937","386","551","39","976","1637","0","59.62","23.58"
"63","000","00","010","1017","0000","4332","1793","2539","127","4459","7433","0","59.99","24.12"
"63","000","00","010","1017","0364","803","303","500","33","836","1453","0","57.54","20.85"
"63","000","00","010","1017","0365","909","354","555","17","926","1617","0","57.27","21.89"
"63","000","00","010","1017","0366","913","349","564","33","946","1604","0","58.98","21.76"
"63","000","00","010","1017","0367","891","384","507","19","910","1406","0","64.72","27.31"
"63","000","00","010","1017","0368","816","403","413","25","841","1353","0","62.16","29.79"
"63","000","00","010","1018","0000","3553","1386","2167","108","3661","6052","0","60.49","22.9"
"63","000","00","010","1018","0369","1026","386","640","31","1057","1724","0","61.31","22.39"
"63","000","00","010","1018","0370","814","337","477","32","846","1378","0","61.39","24.46"
"63","000","00","010","1018","0371","855","336","519","17","872","1403","0","62.15","23.95"
"63","000","00","010","1018","0372","858","327","531","28","886","1547","0","57.27","21.14"
"63","000","00","010","1019","0000","4230","1874","2356","147","4377","7177","0","60.99","26.11"
"63","000","00","010","1019","0373","1029","474","555","31","1060","1718","0","61.7","27.59"
"63","000","00","010","1019","0374","1013","464","549","34","1047","1813","0","57.75","25.59"
"63","000","00","010","1019","0375","1094","467","627","34","1128","1791","0","62.98","26.07"
"63","000","00","010","1019","0376","1094","469","625","48","1142","1855","0","61.56","25.28"
"63","000","00","010","1020","0000","3930","1255","2675","156","4086","6880","0","59.39","18.24"
"63","000","00","010","1020","0377","981","306","675","35","1016","1731","0","58.69","17.68"
"63","000","00","010","1020","0378","1005","468","537","28","1033","1593","0","64.85","29.38"
"63","000","00","010","1020","0379","972","116","856","48","1020","1869","0","54.57","6.21"
"63","000","00","010","1020","0380","972","365","607","45","1017","1687","0","60.28","21.64"
"63","000","00","010","1021","0000","2495","976","1519","90","2585","4144","0","62.38","23.55"
"63","000","00","010","1021","0381","910","390","520","21","931","1530","0","60.85","25.49"
"63","000","00","010","1021","0382","773","309","464","35","808","1300","0","62.15","23.77"
"63","000","00","010","1021","0383","812","277","535","34","846","1314","0","64.38","21.08"
"63","000","00","010","1022","0000","4882","2146","2736","161","5043","8925","0","56.5","24.04"
"63","000","00","010","1022","0384","744","324","420","21","765","1433","0","53.38","22.61"
"63","000","00","010","1022","0385","770","313","457","26","796","1450","0","54.9","21.59"
"63","000","00","010","1022","0386","894","382","512","33","927","1608","0","57.65","23.76"
"63","000","00","010","1022","0387","813","370","443","28","841","1414","0","59.48","26.17"
"63","000","00","010","1022","0388","855","351","504","25","880","1492","0","58.98","23.53"
"63","000","00","010","1022","0389","806","406","400","28","834","1528","0","54.58","26.57"
"63","000","00","010","1023","0000","3673","1640","2033","133","3806","6634","0","57.37","24.72"
"63","000","00","010","1023","0390","943","407","536","41","984","1692","0","58.16","24.05"
"63","000","00","010","1023","0391","881","398","483","38","919","1556","0","59.06","25.58"
"63","000","00","010","1023","0392","895","404","491","23","918","1637","0","56.08","24.68"
"63","000","00","010","1023","0393","954","431","523","31","985","1749","0","56.32","24.64"
"63","000","00","010","1024","0000","4081","1822","2259","160","4241","7348","0","57.72","24.8"
"63","000","00","010","1024","0394","662","271","391","25","687","1220","0","56.31","22.21"
"63","000","00","010","1024","0395","895","411","484","31","926","1600","0","57.88","25.69"
"63","000","00","010","1024","0396","819","389","430","37","856","1473","0","58.11","26.41"
"63","000","00","010","1024","0397","826","356","470","37","863","1498","0","57.61","23.77"
"63","000","00","010","1024","0398","879","395","484","30","909","1557","0","58.38","25.37"
"63","000","00","010","1025","0000","2296","995","1301","72","2368","4190","0","56.52","23.75"
"63","000","00","010","1025","0399","873","351","522","31","904","1674","0","54.0","20.97"
"63","000","00","010","1025","0400","1028","418","610","25","1053","1728","0","60.94","24.19"
"63","000","00","010","1025","0401","395","226","169","16","411","788","0","52.16","28.68"
"63","000","00","010","1026","0000","3834","1761","2073","135","3969","7138","0","55.6","24.67"
"63","000","00","010","1026","0402","833","437","396","37","870","1542","0","56.42","28.34"
"63","000","00","010","1026","0403","815","392","423","36","851","1676","0","50.78","23.39"
"63","000","00","010","1026","0404","706","391","315","22","728","1360","0","53.53","28.75"
"63","000","00","010","1026","0405","767","293","474","28","795","1259","0","63.15","23.27"
"63","000","00","010","1026","0406","713","248","465","12","725","1301","0","55.73","19.06"
"63","000","00","010","1027","0000","3237","1471","1766","127","3364","5998","0","56.09","24.52"
"63","000","00","010","1027","0407","621","336","285","30","651","1251","0","52.04","26.86"
"63","000","00","010","1027","0408","835","390","445","35","870","1502","0","57.92","25.97"
"63","000","00","010","1027","0409","874","352","522","29","903","1596","0","56.58","22.06"
"63","000","00","010","1027","0410","907","393","514","33","940","1649","0","57.0","23.83"
"63","000","00","010","1028","0000","1886","767","1119","60","1946","3520","0","55.28","21.79"
"63","000","00","010","1028","0411","940","362","578","39","979","1774","0","55.19","20.41"
"63","000","00","010","1028","0412","946","405","541","21","967","1746","0","55.38","23.2"
"63","000","00","010","1029","0000","3543","1600","1943","117","3660","7676","0","47.68","20.84"
"63","000","00","010","1029","0413","814","341","473","22","836","1473","0","56.75","23.15"
"63","000","00","010","1029","0414","939","418","521","36","975","2824","0","34.53","14.8"
"63","000","00","010","1029","0415","950","442","508","28","978","1849","0","52.89","23.9"
"63","000","00","010","1029","0416","840","399","441","31","871","1530","0","56.93","26.08"
"63","000","00","010","1030","0000","2790","1251","1539","85","2875","4808","0","59.8","26.02"
"63","000","00","010","1030","0417","942","439","503","29","971","1656","0","58.64","26.51"
"63","000","00","010","1030","0418","849","404","445","27","876","1457","0","60.12","27.73"
"63","000","00","010","1030","0419","999","408","591","29","1028","1695","0","60.65","24.07"
"63","000","00","010","1031","0000","3761","1628","2133","151","3912","6644","0","58.88","24.5"
"63","000","00","010","1031","0420","946","403","543","35","981","1663","0","58.99","24.23"
"63","000","00","010","1031","0421","909","394","515","40","949","1654","0","57.38","23.82"
"63","000","00","010","1031","0422","946","404","542","45","991","1642","0","60.35","24.6"
"63","000","00","010","1031","0423","960","427","533","31","991","1685","0","58.81","25.34"
"63","000","00","010","1032","0000","3235","1245","1990","96","3331","5552","0","60.0","22.42"
"63","000","00","010","1032","0424","1010","421","589","41","1051","1862","0","56.44","22.61"
"63","000","00","010","1032","0425","1114","445","669","22","1136","1900","0","59.79","23.42"
"63","000","00","010","1032","0426","1111","379","732","33","1144","1790","0","63.91","21.17"
"63","000","00","010","1033","0000","2568","1092","1476","142","2710","4787","0","56.61","22.81"
"63","000","00","010","1033","0427","769","351","418","48","817","1417","0","57.66","24.77"
"63","000","00","010","1033","0428","921","388","533","50","971","1694","0","57.32","22.9"
"63","000","00","010","1033","0429","878","353","525","44","922","1676","0","55.01","21.06"
"63","000","00","010","1034","0000","4684","1795","2889","139","4823","8109","0","59.48","22.14"
"63","000","00","010","1034","0430","915","389","526","22","937","1643","0","57.03","23.68"
"63","000","00","010","1034","0431","904","323","581","36","940","1588","0","59.19","20.34"
"63","000","00","010","1034","0432","936","380","556","31","967","1603","0","60.32","23.71"
"63","000","00","010","1034","0433","935","345","590","20","955","1629","0","58.62","21.18"
"63","000","00","010","1034","0434","994","358","636","30","1024","1646","0","62.21","21.75"
"63","000","00","010","1035","0000","4168","1662","2506","163","4331","7457","0","58.08","22.29"
"63","000","00","010","1035","0435","1007","369","638","36","1043","1883","0","55.39","19.6"
"63","000","00","010","1035","0436","805","340","465","27","832","1434","0","58.02","23.71"
"63","000","00","010","1035","0437","781","316","465","24","805","1418","0","56.77","22.28"
"63","000","00","010","1035","0438","789","329","460","40","829","1373","0","60.38","23.96"
"63","000","00","010","1035","0439","786","308","478","36","822","1349","0","60.93","22.83"
"63","000","00","010","1036","0000","2704","1148","1556","100","2804","4624","0","60.64","24.83"
"63","000","00","010","1036","0440","895","381","514","40","935","1511","0","61.88","25.22"
"63","000","00","010","1036","0441","945","405","540","28","973","1563","0","62.25","25.91"
"63","000","00","010","1036","0442","864","362","502","32","896","1550","0","57.81","23.35"
"63","000","00","010","1037","0000","629","317","312","30","659","1157","0","56.96","27.4"
"63","000","00","010","1037","0443","629","317","312","30","659","1157","0","56.96","27.4"
"63","000","00","010","1038","0000","2980","1396","1584","105","3085","5175","0","59.61","26.98"
"63","000","00","010","1038","0444","1032","507","525","36","1068","1768","0","60.41","28.68"
"63","000","00","010","1038","0445","956","436","520","29","985","1664","0","59.19","26.2"
"63","000","00","010","1038","0446","992","453","539","40","1032","1743","0","59.21","25.99"
"63","000","00","010","1039","0000","4466","1874","2592","108","4574","7392","0","61.88","25.35"
"63","000","00","010","1039","0447","871","336","535","19","890","1480","0","60.14","22.7"
"63","000","00","010","1039","0448","948","402","546","34","982","1589","0","61.8","25.3"
"63","000","00","010","1039","0449","787","325","462","14","801","1371","0","58.42","23.71"
"63","000","00","010","1039","0450","1059","499","560","25","1084","1575","0","68.83","31.68"
"63","000","00","010","1039","0451","801","312","489","16","817","1377","0","59.33","22.66"
"63","000","00","010","1040","0000","2839","1078","1761","113","2952","4647","0","63.52","23.2"
"63","000","00","010","1040","0452","926","342","584","48","974","1469","0","66.3","23.28"
"63","000","00","010","1040","0453","946","357","589","26","972","1529","0","63.57","23.35"
"63","000","00","010","1040","0454","967","379","588","39","1006","1649","0","61.01","22.98"
"63","000","00","011","0000","0000","134141","63841","70300","5829","139970","241854","286695","57.87","26.4"
"63","000","00","011","1101","0000","1916","994","922","110","2026","3415","0","59.33","29.11"
"63","000","00","011","1101","0142","937","518","419","55","992","1695","0","58.53","30.56"
"63","000","00","011","1101","0143","979","476","503","55","1034","1720","0","60.12","27.67"
"63","000","00","011","1102","0000","1557","711","846","86","1643","2834","0","57.97","25.09"
"63","000","00","011","1102","0144","697","321","376","54","751","1288","0","58.31","24.92"
"63","000","00","011","1102","0145","860","390","470","32","892","1546","0","57.7","25.23"
"63","000","00","011","1103","0000","1562","723","839","64","1626","2659","0","61.15","27.19"
"63","000","00","011","1103","0146","396","157","239","17","413","652","0","63.34","24.08"
"63","000","00","011","1103","0147","473","207","266","22","495","870","0","56.9","23.79"
"63","000","00","011","1103","0148","693","359","334","25","718","1137","0","63.15","31.57"
"63","000","00","011","1104","0000","2374","1100","1274","131","2505","5331","0","46.99","20.63"
"63","000","00","011","1104","0149","622","307","315","47","669","1050","0","63.71","29.24"
"63","000","00","011","1104","0150","613","278","335","35","648","1031","0","62.85","26.96"
"63","000","00","011","1104","0151","633","263","370","22","655","1075","0","60.93","24.47"
"63","000","00","011","1104","0152","506","252","254","27","533","2175","0","24.51","11.59"
"63","000","00","011","1105","0000","3796","1645","2151","184","3980","6757","0","58.9","24.35"
"63","000","00","011","1105","0153","900","350","550","56","956","1775","0","53.86","19.72"
"63","000","00","011","1105","0154","933","351","582","45","978","1669","0","58.6","21.03"
"63","000","00","011","1105","0155","976","478","498","39","1015","1665","0","60.96","28.71"
"63","000","00","011","1105","0156","987","466","521","44","1031","1648","0","62.56","28.28"
"63","000","00","011","1106","0000","3192","1514","1678","145","3337","5565","0","59.96","27.21"
"63","000","00","011","1106","0157","712","302","410","26","738","1246","0","59.23","24.24"
"63","000","00","011","1106","0158","790","402","388","35","825","1419","0","58.14","28.33"
"63","000","00","011","1106","0159","735","351","384","49","784","1327","0","59.08","26.45"
"63","000","00","011","1106","0160","955","459","496","35","990","1573","0","62.94","29.18"
"63","000","00","011","1107","0000","3842","1853","1989","151","3993","6779","0","58.9","27.33"
"63","000","00","011","1107","0161","822","380","442","53","875","1470","0","59.52","25.85"
"63","000","00","011","1107","0162","1007","545","462","22","1029","1775","0","57.97","30.7"
"63","000","00","011","1107","0163","966","426","540","40","1006","1692","0","59.46","25.18"
"63","000","00","011","1107","0164","1047","502","545","36","1083","1842","0","58.79","27.25"
"63","000","00","011","1108","0000","4074","2021","2053","210","4284","7204","0","59.47","28.05"
"63","000","00","011","1108","0165","687","348","339","34","721","1166","0","61.84","29.85"
"63","000","00","011","1108","0166","848","426","422","40","888","1687","0","52.64","25.25"
"63","000","00","011","1108","0167","898","435","463","40","938","1624","0","57.76","26.79"
"63","000","00","011","1108","0168","894","449","445","60","954","1477","0","64.59","30.4"
"63","000","00","011","1108","0169","747","363","384","36","783","1250","0","62.64","29.04"
"63","000","00","011","1109","0000","3465","1703","1762","182","3647","5934","0","61.46","28.7"
"63","000","00","011","1109","0170","810","407","403","56","866","1434","0","60.39","28.38"
"63","000","00","011","1109","0171","821","417","404","52","873","1452","0","60.12","28.72"
"63","000","00","011","1109","0172","936","442","494","36","972","1533","0","63.41","28.83"
"63","000","00","011","1109","0173","898","437","461","38","936","1515","0","61.78","28.84"
"63","000","00","011","1110","0000","2299","1133","1166","105","2404","3942","0","60.98","28.74"
"63","000","00","011","1110","0174","700","340","360","36","736","1203","0","61.18","28.26"
"63","000","00","011","1110","0175","878","427","451","54","932","1487","0","62.68","28.72"
"63","000","00","011","1110","0176","721","366","355","15","736","1252","0","58.79","29.23"
"63","000","00","011","1111","0000","3589","1887","1702","155","3744","6175","0","60.63","30.56"
"63","000","00","011","1111","0177","868","427","441","32","900","1536","0","58.59","27.8"
"63","000","00","011","1111","0178","899","441","458","53","952","1556","0","61.18","28.34"
"63","000","00","011","1111","0179","879","459","420","38","917","1511","0","60.69","30.38"
"63","000","00","011","1111","0180","943","560","383","32","975","1572","0","62.02","35.62"
"63","000","00","011","1112","0000","2693","1186","1507","143","2836","4921","0","57.63","24.1"
"63","000","00","011","1112","0181","916","408","508","46","962","1668","0","57.67","24.46"
"63","000","00","011","1112","0182","927","440","487","53","980","1685","0","58.16","26.11"
"63","000","00","011","1112","0183","850","338","512","44","894","1568","0","57.02","21.56"
"63","000","00","011","1113","0000","3031","1459","1572","162","3193","5632","0","56.69","25.91"
"63","000","00","011","1113","0184","701","306","395","37","738","1327","0","55.61","23.06"
"63","000","00","011","1113","0185","715","358","357","45","760","1338","0","56.8","26.76"
"63","000","00","011","1113","0186","772","369","403","38","810","1515","0","53.47","24.36"
"63","000","00","011","1113","0187","843","426","417","42","885","1452","0","60.95","29.34"
"63","000","00","011","1114","0000","2561","1246","1315","95","2656","4430","0","59.95","28.13"
"63","000","00","011","1114","0188","823","382","441","28","851","1448","0","58.77","26.38"
"63","000","00","011","1114","0189","910","436","474","29","939","1521","0","61.74","28.67"
"63","000","00","011","1114","0190","828","428","400","38","866","1461","0","59.27","29.3"
"63","000","00","011","1115","0000","2430","1330","1100","101","2531","4747","0","53.32","28.02"
"63","000","00","011","1115","0191","813","442","371","37","850","1541","0","55.16","28.68"
"63","000","00","011","1115","0192","735","411","324","29","764","1611","0","47.42","25.51"
"63","000","00","011","1115","0193","882","477","405","35","917","1595","0","57.49","29.91"
"63","000","00","011","1116","0000","2707","1374","1333","139","2846","5188","0","54.86","26.48"
"63","000","00","011","1116","0194","854","445","409","41","895","1685","0","53.12","26.41"
"63","000","00","011","1116","0195","941","466","475","47","988","1816","0","54.41","25.66"
"63","000","00","011","1116","0196","912","463","449","51","963","1687","0","57.08","27.45"
"63","000","00","011","1117","0000","3651","1704","1947","152","3803","6631","0","57.35","25.7"
"63","000","00","011","1117","0197","892","472","420","36","928","1646","0","56.38","28.68"
"63","000","00","011","1117","0198","869","388","481","35","904","1643","0","55.02","23.62"
"63","000","00","011","1117","0199","941","366","575","41","982","1687","0","58.21","21.7"
"63","000","00","011","1117","0200","949","478","471","40","989","1655","0","59.76","28.88"
"63","000","00","011","1118","0000","1993","1068","925","68","2061","3634","0","56.71","29.39"
"63","000","00","011","1118","0201","944","500","444","18","962","1779","0","54.08","28.11"
"63","000","00","011","1118","0202","1049","568","481","50","1099","1855","0","59.25","30.62"
"63","000","00","011","1119","0000","2825","1409","1416","152","2977","5700","0","52.23","24.72"
"63","000","00","011","1119","0203","758","393","365","39","797","1350","0","59.04","29.11"
"63","000","00","011","1119","0204","757","278","479","25","782","1455","0","53.75","19.11"
"63","000","00","011","1119","0205","668","397","271","57","725","1497","0","48.43","26.52"
"63","000","00","011","1119","0206","642","341","301","31","673","1398","0","48.14","24.39"
"63","000","00","011","1120","0000","4327","2357","1970","210","4537","8041","0","56.42","29.31"
"63","000","00","011","1120","0207","1007","536","471","40","1047","1747","0","59.93","30.68"
"63","000","00","011","1120","0208","785","434","351","45","830","1465","0","56.66","29.62"
"63","000","00","011","1120","0209","807","463","344","36","843","1530","0","55.1","30.26"
"63","000","00","011","1120","0210","928","487","441","52","980","1855","0","52.83","26.25"
"63","000","00","011","1120","0211","800","437","363","37","837","1444","0","57.96","30.26"
"63","000","00","011","1121","0000","3432","1906","1526","172","3604","6387","0","56.43","29.84"
"63","000","00","011","1121","0212","793","438","355","48","841","1563","0","53.81","28.02"
"63","000","00","011","1121","0213","824","454","370","40","864","1482","0","58.3","30.63"
"63","000","00","011","1121","0214","838","504","334","45","883","1552","0","56.89","32.47"
"63","000","00","011","1121","0215","977","510","467","39","1016","1790","0","56.76","28.49"
"63","000","00","011","1122","0000","3321","1725","1596","190","3511","6383","0","55.01","27.02"
"63","000","00","011","1122","0216","809","418","391","56","865","1628","0","53.13","25.68"
"63","000","00","011","1122","0217","709","378","331","39","748","1337","0","55.95","28.27"
"63","000","00","011","1122","0218","950","482","468","49","999","1750","0","57.09","27.54"
"63","000","00","011","1122","0219","853","447","406","46","899","1668","0","53.9","26.8"
"63","000","00","011","1123","0000","2069","1252","817","82","2151","4342","0","49.54","28.83"
"63","000","00","011","1123","0220","634","383","251","44","678","1403","0","48.33","27.3"
"63","000","00","011","1123","0221","688","416","272","20","708","1468","0","48.23","28.34"
"63","000","00","011","1123","0222","747","453","294","18","765","1471","0","52.01","30.8"
"63","000","00","011","1124","0000","2570","1591","979","114","2684","5240","0","51.22","30.36"
"63","000","00","011","1124","0223","843","592","251","43","886","1666","0","53.18","35.53"
"63","000","00","011","1124","0224","813","508","305","23","836","1587","0","52.68","32.01"
"63","000","00","011","1124","0225","914","491","423","48","962","1987","0","48.41","24.71"
"63","000","00","011","1125","0000","1637","618","1019","73","1710","2999","0","57.02","20.61"
"63","000","00","011","1125","0226","637","200","437","24","661","1271","0","52.01","15.74"
"63","000","00","011","1125","0227","1000","418","582","49","1049","1728","0","60.71","24.19"
"63","000","00","011","1126","0000","3661","1613","2048","131","3792","6297","0","60.22","25.62"
"63","000","00","011","1126","0228","961","419","542","23","984","1630","0","60.37","25.71"
"63","000","00","011","1126","0229","939","400","539","29","968","1619","0","59.79","24.71"
"63","000","00","011","1126","0230","812","343","469","30","842","1425","0","59.09","24.07"
"63","000","00","011","1126","0231","949","451","498","49","998","1623","0","61.49","27.79"
"63","000","00","011","1127","0000","2320","1153","1167","96","2416","3862","0","62.56","29.85"
"63","000","00","011","1127","0242","799","397","402","33","832","1273","0","65.36","31.19"
"63","000","00","011","1127","0243","771","400","371","27","798","1273","0","62.69","31.42"
"63","000","00","011","1127","0244","750","356","394","36","786","1316","0","59.73","27.05"
"63","000","00","011","1128","0000","2773","1360","1413","94","2867","4960","0","57.8","27.42"
"63","000","00","011","1128","0245","941","474","467","30","971","1659","0","58.53","28.57"
"63","000","00","011","1128","0246","972","461","511","30","1002","1749","0","57.29","26.36"
"63","000","00","011","1128","0247","860","425","435","34","894","1552","0","57.6","27.38"
"63","000","00","011","1129","0000","2695","1084","1611","90","2785","4457","0","62.49","24.32"
"63","000","00","011","1129","0232","895","397","498","35","930","1564","0","59.46","25.38"
"63","000","00","011","1129","0233","882","400","482","31","913","1376","0","66.35","29.07"
"63","000","00","011","1129","0234","918","287","631","24","942","1517","0","62.1","18.92"
"63","000","00","011","1130","0000","2763","976","1787","102","2865","4952","0","57.86","19.71"
"63","000","00","011","1130","0248","875","318","557","41","916","1529","0","59.91","20.8"
"63","000","00","011","1130","0249","896","263","633","33","929","1644","0","56.51","16.0"
"63","000","00","011","1130","0250","992","395","597","28","1020","1779","0","57.34","22.2"
"63","000","00","011","1131","0000","3752","1664","2088","123","3875","6584","0","58.85","25.27"
"63","000","00","011","1131","0235","894","409","485","33","927","1729","0","53.61","23.66"
"63","000","00","011","1131","0236","898","379","519","35","933","1511","0","61.75","25.08"
"63","000","00","011","1131","0237","1071","469","602","26","1097","1811","0","60.57","25.9"
"63","000","00","011","1131","0238","889","407","482","29","918","1533","0","59.88","26.55"
"63","000","00","011","1132","0000","2654","1075","1579","110","2764","4558","0","60.64","23.58"
"63","000","00","011","1132","0239","1041","452","589","39","1080","1657","0","65.18","27.28"
"63","000","00","011","1132","0240","854","370","484","21","875","1499","0","58.37","24.68"
"63","000","00","011","1132","0241","759","253","506","50","809","1402","0","57.7","18.05"
"63","000","00","011","1133","0000","2842","1280","1562","123","2965","5127","0","57.83","24.97"
"63","000","00","011","1133","0260","1008","432","576","41","1049","1826","0","57.45","23.66"
"63","000","00","011","1133","0261","916","428","488","43","959","1647","0","58.23","25.99"
"63","000","00","011","1133","0262","918","420","498","39","957","1654","0","57.86","25.39"
"63","000","00","011","1134","0000","4335","1980","2355","142","4477","7652","0","58.51","25.88"
"63","000","00","011","1134","0251","897","402","495","35","932","1597","0","58.36","25.17"
"63","000","00","011","1134","0252","808","377","431","39","847","1454","0","58.25","25.93"
"63","000","00","011","1134","0253","949","455","494","24","973","1582","0","61.5","28.76"
"63","000","00","011","1134","0254","886","392","494","26","912","1518","0","60.08","25.82"
"63","000","00","011","1134","0255","795","354","441","18","813","1501","0","54.16","23.58"
"63","000","00","011","1135","0000","3365","1588","1777","138","3503","5690","0","61.56","27.91"
"63","000","00","011","1135","0256","822","365","457","38","860","1420","0","60.56","25.7"
"63","000","00","011","1135","0257","852","407","445","26","878","1494","0","58.77","27.24"
"63","000","00","011","1135","0258","948","447","501","44","992","1568","0","63.27","28.51"
"63","000","00","011","1135","0259","743","369","374","30","773","1208","0","63.99","30.55"
"63","000","00","011","1136","0000","3244","1458","1786","115","3359","5497","0","61.11","26.52"
"63","000","00","011","1136","0263","903","401","502","30","933","1550","0","60.19","25.87"
"63","000","00","011","1136","0264","798","379","419","28","826","1298","0","63.64","29.2"
"63","000","00","011","1136","0265","800","334","466","31","831","1297","0","64.07","25.75"
"63","000","00","011","1136","0266","743","344","399","26","769","1352","0","56.88","25.44"
"63","000","00","011","1137","0000","2583","1294","1289","111","2694","4565","0","59.01","28.35"
"63","000","00","011","1137","0267","856","412","444","31","887","1522","0","58.28","27.07"
"63","000","00","011","1137","0268","878","446","432","52","930","1602","0","58.05","27.84"
"63","000","00","011","1137","0269","849","436","413","28","877","1441","0","60.86","30.26"
"63","000","00","011","1138","0000","2434","1106","1328","77","2511","4410","0","56.94","25.08"
"63","000","00","011","1138","0270","713","328","385","17","730","1325","0","55.09","24.75"
"63","000","00","011","1138","0271","878","403","475","35","913","1567","0","58.26","25.72"
"63","000","00","011","1138","0272","843","375","468","25","868","1518","0","57.18","24.7"
"63","000","00","011","1139","0000","3779","1701","2078","115","3894","6605","0","58.96","25.75"
"63","000","00","011","1139","0273","914","431","483","34","948","1549","0","61.2","27.82"
"63","000","00","011","1139","0274","932","415","517","26","958","1652","0","57.99","25.12"
"63","000","00","011","1139","0275","1027","472","555","32","1059","1766","0","59.97","26.73"
"63","000","00","011","1139","0276","906","383","523","23","929","1638","0","56.72","23.38"
"63","000","00","011","1140","0000","3439","1474","1965","117","3556","6105","0","58.25","24.14"
"63","000","00","011","1140","0277","877","361","516","28","905","1491","0","60.7","24.21"
"63","000","00","011","1140","0278","862","398","464","26","888","1521","0","58.38","26.17"
"63","000","00","011","1140","0279","786","314","472","38","824","1351","0","60.99","23.24"
"63","000","00","011","1140","0280","914","401","513","25","939","1742","0","53.9","23.02"
"63","000","00","011","1141","0000","4311","1851","2460","145","4456","7594","0","58.68","24.37"
"63","000","00","011","1141","0281","889","414","475","35","924","1585","0","58.3","26.12"
"63","000","00","011","1141","0282","873","351","522","32","905","1521","0","59.5","23.08"
"63","000","00","011","1141","0283","857","382","475","19","876","1543","0","56.77","24.76"
"63","000","00","011","1141","0284","819","342","477","24","843","1404","0","60.04","24.36"
"63","000","00","011","1141","0285","873","362","511","35","908","1541","0","58.92","23.49"
"63","000","00","011","1142","0000","3178","1357","1821","115","3293","5828","0","56.5","23.28"
"63","000","00","011","1142","0286","842","316","526","38","880","1584","0","55.56","19.95"
"63","000","00","011","1142","0287","874","390","484","37","911","1519","0","59.97","25.67"
"63","000","00","011","1142","0288","777","327","450","12","789","1482","0","53.24","22.06"
"63","000","00","011","1142","0289","685","324","361","28","713","1243","0","57.36","26.07"
"63","000","00","011","1143","0000","634","322","312","32","666","1156","0","57.61","27.85"
"63","000","00","011","1143","0290","634","322","312","32","666","1156","0","57.61","27.85"
"63","000","00","011","1144","0000","673","399","274","28","701","1262","0","55.55","31.62"
"63","000","00","011","1144","0291","673","399","274","28","701","1262","0","55.55","31.62"
"63","000","00","011","1145","0000","1016","521","495","60","1076","1747","0","61.59","29.82"
"63","000","00","011","1145","0292","502","250","252","31","533","889","0","59.96","28.12"
"63","000","00","011","1145","0293","514","271","243","29","543","858","0","63.29","31.59"
"63","000","00","011","1146","0000","1469","702","767","102","1571","2781","0","56.49","25.24"
"63","000","00","011","1146","0294","509","286","223","27","536","945","0","56.72","30.26"
"63","000","00","011","1146","0295","497","223","274","40","537","960","0","55.94","23.23"
"63","000","00","011","1146","0296","463","193","270","35","498","876","0","56.85","22.03"
"63","000","00","011","1147","0000","880","417","463","66","946","1475","0","64.14","28.27"
"63","000","00","011","1147","0297","343","169","174","25","368","556","0","66.19","30.4"
"63","000","00","011","1147","0298","537","248","289","41","578","919","0","62.89","26.99"
"63","000","00","011","1148","0000","831","465","366","70","901","1360","0","66.25","34.19"
"63","000","00","011","1148","0299","831","465","366","70","901","1360","0","66.25","34.19"
"63","000","00","011","1149","0000","784","400","384","58","842","1355","0","62.14","29.52"
"63","000","00","011","1149","0300","784","400","384","58","842","1355","0","62.14","29.52"
"63","000","00","011","1150","0000","1439","478","961","50","1489","2434","0","61.18","19.64"
"63","000","00","011","1150","0301","720","259","461","24","744","1252","0","59.42","20.69"
"63","000","00","011","1150","0302","719","219","500","26","745","1182","0","63.03","18.53"
"63","000","00","011","1151","0000","1374","614","760","43","1417","2671","0","53.05","22.99"
"63","000","00","011","1151","0303","694","303","391","26","720","1431","0","50.31","21.17"
"63","000","00","011","1151","0304","680","311","369","17","697","1240","0","56.21","25.08"
"63","000","00","012","0000","0000","116555","53284","63271","4852","121407","213250","255631","56.93","24.99"
"63","000","00","012","1201","0000","2257","1160","1097","105","2362","3797","0","62.21","30.55"
"63","000","00","012","1201","0001","770","369","401","42","812","1313","0","61.84","28.1"
"63","000","00","012","1201","0002","837","454","383","40","877","1403","0","62.51","32.36"
"63","000","00","012","1201","0003","650","337","313","23","673","1081","0","62.26","31.17"
"63","000","00","012","1202","0000","2221","1068","1153","93","2314","3798","0","60.93","28.12"
"63","000","00","012","1202","0004","708","340","368","32","740","1209","0","61.21","28.12"
"63","000","00","012","1202","0005","763","369","394","28","791","1326","0","59.65","27.83"
"63","000","00","012","1202","0006","750","359","391","33","783","1263","0","62.0","28.42"
"63","000","00","012","1203","0000","2702","1327","1375","103","2805","4640","0","60.45","28.6"
"63","000","00","012","1203","0007","939","472","467","35","974","1580","0","61.65","29.87"
"63","000","00","012","1203","0008","909","441","468","23","932","1577","0","59.1","27.96"
"63","000","00","012","1203","0009","854","414","440","45","899","1483","0","60.62","27.92"
"63","000","00","012","1204","0000","3371","1505","1866","117","3488","6090","0","57.27","24.71"
"63","000","00","012","1204","0010","830","357","473","11","841","1461","0","57.56","24.44"
"63","000","00","012","1204","0011","792","382","410","43","835","1466","0","56.96","26.06"
"63","000","00","012","1204","0012","938","421","517","35","973","1620","0","60.06","25.99"
"63","000","00","012","1204","0013","811","345","466","28","839","1543","0","54.37","22.36"
"63","000","00","012","1205","0000","3488","1588","1900","145","3633","6230","0","58.31","25.49"
"63","000","00","012","1205","0014","793","378","415","38","831","1513","0","54.92","24.98"
"63","000","00","012","1205","0015","878","407","471","29","907","1534","0","59.13","26.53"
"63","000","00","012","1205","0016","944","433","511","47","991","1650","0","60.06","26.24"
"63","000","00","012","1205","0017","873","370","503","31","904","1533","0","58.97","24.14"
"63","000","00","012","1206","0000","3645","1656","1989","160","3805","6528","0","58.29","25.37"
"63","000","00","012","1206","0018","908","407","501","42","950","1702","0","55.82","23.91"
"63","000","00","012","1206","0019","948","438","510","33","981","1721","0","57.0","25.45"
"63","000","00","012","1206","0020","930","434","496","39","969","1575","0","61.52","27.56"
"63","000","00","012","1206","0021","859","377","482","46","905","1530","0","59.15","24.64"
"63","000","00","012","1207","0000","3651","1576","2075","121","3772","6810","0","55.39","23.14"
"63","000","00","012","1207","0022","986","409","577","31","1017","1728","0","58.85","23.67"
"63","000","00","012","1207","0023","957","412","545","30","987","1702","0","57.99","24.21"
"63","000","00","012","1207","0024","931","434","497","40","971","1696","0","57.25","25.59"
"63","000","00","012","1207","0025","777","321","456","20","797","1684","0","47.33","19.06"
"63","000","00","012","1208","0000","3835","1714","2121","144","3979","6642","0","59.91","25.81"
"63","000","00","012","1208","0026","1004","447","557","39","1043","1717","0","60.75","26.03"
"63","000","00","012","1208","0027","922","420","502","28","950","1605","0","59.19","26.17"
"63","000","00","012","1208","0028","954","408","546","46","1000","1723","0","58.04","23.68"
"63","000","00","012","1208","0029","955","439","516","31","986","1597","0","61.74","27.49"
"63","000","00","012","1209","0000","4348","1976","2372","144","4492","7993","0","56.2","24.72"
"63","000","00","012","1209","0030","945","414","531","41","986","1700","0","58.0","24.35"
"63","000","00","012","1209","0031","794","386","408","23","817","1544","0","52.91","25.0"
"63","000","00","012","1209","0032","823","375","448","33","856","1635","0","52.35","22.94"
"63","000","00","012","1209","0033","869","382","487","17","886","1495","0","59.26","25.55"
"63","000","00","012","1209","0034","917","419","498","30","947","1619","0","58.49","25.88"
"63","000","00","012","1210","0000","3559","1562","1997","100","3659","6869","0","53.27","22.74"
"63","000","00","012","1210","0035","916","426","490","41","957","1683","0","56.86","25.31"
"63","000","00","012","1210","0036","876","347","529","25","901","1662","0","54.21","20.88"
"63","000","00","012","1210","0037","911","394","517","15","926","1850","0","50.05","21.3"
"63","000","00","012","1210","0038","856","395","461","19","875","1674","0","52.27","23.6"
"63","000","00","012","1211","0000","2436","1052","1384","93","2529","4183","0","60.46","25.15"
"63","000","00","012","1211","0039","877","344","533","45","922","1511","0","61.02","22.77"
"63","000","00","012","1211","0040","782","358","424","18","800","1393","0","57.43","25.7"
"63","000","00","012","1211","0041","777","350","427","30","807","1279","0","63.1","27.37"
"63","000","00","012","1212","0000","2363","954","1409","104","2467","3837","0","64.3","24.86"
"63","000","00","012","1212","0042","655","240","415","25","680","1122","0","60.61","21.39"
"63","000","00","012","1212","0043","828","330","498","39","867","1238","0","70.03","26.66"
"63","000","00","012","1212","0044","880","384","496","40","920","1477","0","62.29","26.0"
"63","000","00","012","1213","0000","3418","1429","1989","159","3577","5857","0","61.07","24.4"
"63","000","00","012","1213","0045","869","366","503","48","917","1495","0","61.34","24.48"
"63","000","00","012","1213","0046","900","382","518","39","939","1469","0","63.92","26.0"
"63","000","00","012","1213","0047","834","357","477","32","866","1462","0","59.23","24.42"
"63","000","00","012","1213","0048","815","324","491","40","855","1431","0","59.75","22.64"
"63","000","00","012","1214","0000","2540","1257","1283","87","2627","4391","0","59.83","28.63"
"63","000","00","012","1214","0049","846","439","407","30","876","1486","0","58.95","29.54"
"63","000","00","012","1214","0050","851","426","425","34","885","1449","0","61.08","29.4"
"63","000","00","012","1214","0051","843","392","451","23","866","1456","0","59.48","26.92"
"63","000","00","012","1215","0000","2222","1017","1205","88","2310","4005","0","57.68","25.39"
"63","000","00","012","1215","0052","744","350","394","26","770","1311","0","58.73","26.7"
"63","000","00","012","1215","0053","689","280","409","40","729","1356","0","53.76","20.65"
"63","000","00","012","1215","0054","789","387","402","22","811","1338","0","60.61","28.92"
"63","000","00","012","1216","0000","2556","1215","1341","72","2628","4644","0","56.59","26.16"
"63","000","00","012","1216","0055","865","387","478","32","897","1525","0","58.82","25.38"
"63","000","00","012","1216","0056","881","421","460","26","907","1620","0","55.99","25.99"
"63","000","00","012","1216","0057","810","407","403","14","824","1499","0","54.97","27.15"
"63","000","00","012","1217","0000","4295","1969","2326","202","4497","7724","0","58.22","25.49"
"63","000","00","012","1217","0058","880","358","522","32","912","1497","0","60.92","23.91"
"63","000","00","012","1217","0059","903","396","507","37","940","1624","0","57.88","24.38"
"63","000","00","012","1217","0060","803","400","403","47","850","1536","0","55.34","26.04"
"63","000","00","012","1217","0061","852","423","429","50","902","1469","0","61.4","28.8"
"63","000","00","012","1217","0062","857","392","465","36","893","1598","0","55.88","24.53"
"63","000","00","012","1218","0000","2681","1273","1408","125","2806","4923","0","57.0","25.86"
"63","000","00","012","1218","0063","921","440","481","27","948","1690","0","56.09","26.04"
"63","000","00","012","1218","0064","857","433","424","60","917","1599","0","57.35","27.08"
"63","000","00","012","1218","0065","903","400","503","38","941","1634","0","57.59","24.48"
"63","000","00","012","1219","0000","859","482","377","28","887","1660","0","53.43","29.04"
"63","000","00","012","1219","0066","859","482","377","28","887","1660","0","53.43","29.04"
"63","000","00","012","1220","0000","5018","2295","2723","179","5197","9045","0","57.46","25.37"
"63","000","00","012","1220","0067","974","442","532","37","1011","1900","0","53.21","23.26"
"63","000","00","012","1220","0068","1007","473","534","34","1041","1797","0","57.93","26.32"
"63","000","00","012","1220","0069","1026","459","567","44","1070","1832","0","58.41","25.05"
"63","000","00","012","1220","0070","1019","462","557","39","1058","1784","0","59.3","25.9"
"63","000","00","012","1220","0071","992","459","533","25","1017","1732","0","58.72","26.5"
"63","000","00","012","1221","0000","4014","1912","2102","237","4251","8470","0","50.19","22.57"
"63","000","00","012","1221","0072","531","265","266","33","564","2035","0","27.71","13.02"
"63","000","00","012","1221","0073","814","421","393","45","859","1504","0","57.11","27.99"
"63","000","00","012","1221","0074","942","417","525","56","998","1683","0","59.3","24.78"
"63","000","00","012","1221","0075","851","405","446","61","912","1635","0","55.78","24.77"
"63","000","00","012","1221","0076","876","404","472","42","918","1613","0","56.91","25.05"
"63","000","00","012","1222","0000","3970","1907","2063","201","4171","7542","0","55.3","25.29"
"63","000","00","012","1222","0077","767","357","410","23","790","1483","0","53.27","24.07"
"63","000","00","012","1222","0078","819","365","454","34","853","1500","0","56.87","24.33"
"63","000","00","012","1222","0079","843","398","445","34","877","1483","0","59.14","26.84"
"63","000","00","012","1222","0080","825","427","398","48","873","1544","0","56.54","27.66"
"63","000","00","012","1222","0081","716","360","356","62","778","1532","0","50.78","23.5"
"63","000","00","012","1223","0000","2877","1388","1489","97","2974","5554","0","53.55","24.99"
"63","000","00","012","1223","0082","998","471","527","37","1035","1819","0","56.9","25.89"
"63","000","00","012","1223","0083","932","466","466","40","972","1863","0","52.17","25.01"
"63","000","00","012","1223","0084","947","451","496","20","967","1872","0","51.66","24.09"
"63","000","00","012","1224","0000","2776","1369","1407","96","2872","5164","0","55.62","26.51"
"63","000","00","012","1224","0085","885","424","461","32","917","1627","0","56.36","26.06"
"63","000","00","012","1224","0086","904","457","447","23","927","1696","0","54.66","26.95"
"63","000","00","012","1224","0087","987","488","499","41","1028","1841","0","55.84","26.51"
"63","000","00","012","1225","0000","3299","1567","1732","117","3416","5954","0","57.37","26.32"
"63","000","00","012","1225","0088","737","376","361","32","769","1324","0","58.08","28.4"
"63","000","00","012","1225","0089","807","401","406","17","824","1504","0","54.79","26.66"
"63","000","00","012","1225","0090","827","365","462","34","861","1511","0","56.98","24.16"
"63","000","00","012","1225","0091","928","425","503","34","962","1615","0","59.57","26.32"
"63","000","00","012","1226","0000","1399","642","757","46","1445","2762","0","52.32","23.24"
"63","000","00","012","1226","0092","661","273","388","19","680","1270","0","53.54","21.5"
"63","000","00","012","1226","0093","738","369","369","27","765","1492","0","51.27","24.73"
"63","000","00","012","1227","0000","3064","1427","1637","100","3164","5832","0","54.25","24.47"
"63","000","00","012","1227","0094","742","358","384","26","768","1429","0","53.74","25.05"
"63","000","00","012","1227","0095","816","359","457","20","836","1567","0","53.35","22.91"
"63","000","00","012","1227","0096","756","345","411","34","790","1388","0","56.92","24.86"
"63","000","00","012","1227","0097","750","365","385","20","770","1448","0","53.18","25.21"
"63","000","00","012","1228","0000","2067","955","1112","127","2194","3829","0","57.3","24.94"
"63","000","00","012","1228","0098","687","316","371","48","735","1356","0","54.2","23.3"
"63","000","00","012","1228","0099","696","312","384","41","737","1308","0","56.35","23.85"
"63","000","00","012","1228","0100","684","327","357","38","722","1165","0","61.97","28.07"
"63","000","00","012","1229","0000","3338","1402","1936","143","3481","5889","0","59.11","23.81"
"63","000","00","012","1229","0101","824","360","464","40","864","1429","0","60.46","25.19"
"63","000","00","012","1229","0102","795","299","496","21","816","1472","0","55.43","20.31"
"63","000","00","012","1229","0103","915","396","519","38","953","1508","0","63.2","26.26"
"63","000","00","012","1229","0104","804","347","457","44","848","1480","0","57.3","23.45"
"63","000","00","012","1230","0000","2377","1058","1319","118","2495","4365","0","57.16","24.24"
"63","000","00","012","1230","0105","620","286","334","26","646","1142","0","56.57","25.04"
"63","000","00","012","1230","0106","817","366","451","26","843","1554","0","54.25","23.55"
"63","000","00","012","1230","0107","940","406","534","66","1006","1669","0","60.28","24.33"
"63","000","00","012","1231","0000","2844","1181","1663","143","2987","5333","0","56.01","22.15"
"63","000","00","012","1231","0108","1025","403","622","43","1068","1823","0","58.58","22.11"
"63","000","00","012","1231","0109","909","371","538","54","963","1739","0","55.38","21.33"
"63","000","00","012","1231","0110","910","407","503","46","956","1771","0","53.98","22.98"
"63","000","00","012","1232","0000","1534","659","875","69","1603","2937","0","54.58","22.44"
"63","000","00","012","1232","0111","733","303","430","46","779","1468","0","53.07","20.64"
"63","000","00","012","1232","0112","801","356","445","23","824","1469","0","56.09","24.23"
"63","000","00","012","1233","0000","2178","738","1440","96","2274","3617","0","62.87","20.4"
"63","000","00","012","1233","0113","684","262","422","24","708","1094","0","64.72","23.95"
"63","000","00","012","1233","0114","664","190","474","40","704","1101","0","63.94","17.26"
"63","000","00","012","1233","0115","830","286","544","32","862","1422","0","60.62","20.11"
"63","000","00","012","1234","0000","2214","1001","1213","129","2343","3912","0","59.89","25.59"
"63","000","00","012","1234","0116","738","318","420","46","784","1390","0","56.4","22.88"
"63","000","00","012","1234","0117","745","345","400","40","785","1307","0","60.06","26.4"
"63","000","00","012","1234","0118","731","338","393","43","774","1215","0","63.7","27.82"
"63","000","00","012","1235","0000","2562","1090","1472","116","2678","4886","0","54.81","22.31"
"63","000","00","012","1235","0119","869","353","516","33","902","1642","0","54.93","21.5"
"63","000","00","012","1235","0120","837","364","473","37","874","1623","0","53.85","22.43"
"63","000","00","012","1235","0121","856","373","483","46","902","1621","0","55.64","23.01"
"63","000","00","012","1236","0000","2959","1382","1577","112","3071","5397","0","56.9","25.61"
"63","000","00","012","1236","0122","763","370","393","15","778","1367","0","56.91","27.07"
"63","000","00","012","1236","0123","685","356","329","42","727","1309","0","55.54","27.2"
"63","000","00","012","1236","0124","774","315","459","23","797","1356","0","58.78","23.23"
"63","000","00","012","1236","0125","737","341","396","32","769","1365","0","56.34","24.98"
"63","000","00","012","1237","0000","3448","1666","1782","154","3602","6487","0","55.53","25.68"
"63","000","00","012","1237","0126","867","455","412","26","893","1613","0","55.36","28.21"
"63","000","00","012","1237","0127","772","375","397","29","801","1590","0","50.38","23.58"
"63","000","00","012","1237","0128","925","440","485","46","971","1662","0","58.42","26.47"
"63","000","00","012","1237","0129","884","396","488","53","937","1622","0","57.77","24.41"
"63","000","00","012","1238","0000","5259","2417","2842","227","5486","10006","0","54.83","24.16"
"63","000","00","012","1238","0130","973","459","514","32","1005","1820","0","55.22","25.22"
"63","000","00","012","1238","0131","908","386","522","43","951","1615","0","58.89","23.9"
"63","000","00","012","1238","0132","697","323","374","55","752","1612","0","46.65","20.04"
"63","000","00","012","1238","0133","880","423","457","43","923","1652","0","55.87","25.61"
"63","000","00","012","1238","0134","928","413","515","21","949","1666","0","56.96","24.79"
"63","000","00","012","1238","0135","873","413","460","33","906","1641","0","55.21","25.17"
"63","000","00","012","1239","0000","1055","548","507","55","1110","2170","0","51.15","25.25"
"63","000","00","012","1239","0136","308","155","153","12","320","528","0","60.61","29.36"
"63","000","00","012","1239","0137","747","393","354","43","790","1642","0","48.11","23.93"
"63","000","00","012","1240","0000","825","378","447","33","858","1519","0","56.48","24.88"
"63","000","00","012","1240","0138","455","226","229","15","470","829","0","56.69","27.26"
"63","000","00","012","1240","0139","370","152","218","18","388","690","0","56.23","22.03"
"63","000","00","012","1241","0000","556","287","269","35","591","1067","0","55.39","26.9"
"63","000","00","012","1241","0140","556","287","269","35","591","1067","0","55.39","26.9"
"63","000","00","012","1242","0000","475","235","240","32","507","892","0","56.84","26.35"
"63","000","00","012","1242","0141","475","235","240","32","507","892","0","56.84","26.35"
"65","000","00","000","0000","0000","1793277","807514","985763","87193","1880470","3375513","3992291","55.71","23.92"
"65","000","00","001","0000","0000","251513","119330","132183","12943","264456","463411","554357","57.07","25.75"
"65","000","00","001","0101","0000","734","344","390","49","783","1388","0","56.41","24.78"
"65","000","00","001","0101","0894","734","344","390","49","783","1388","0","56.41","24.78"
"65","000","00","001","0102","0000","716","337","379","50","766","1294","0","59.2","26.04"
"65","000","00","001","0102","0895","716","337","379","50","766","1294","0","59.2","26.04"
"65","000","00","001","0103","0000","395","214","181","19","414","667","0","62.07","32.08"
"65","000","00","001","0103","0896","395","214","181","19","414","667","0","62.07","32.08"
"65","000","00","001","0104","0000","469","248","221","32","501","898","0","55.79","27.62"
"65","000","00","001","0104","0897","469","248","221","32","501","898","0","55.79","27.62"
"65","000","00","001","0105","0000","911","374","537","59","970","1568","0","61.86","23.85"
"65","000","00","001","0105","0898","479","206","273","29","508","829","0","61.28","24.85"
"65","000","00","001","0105","0899","432","168","264","30","462","739","0","62.52","22.73"
"65","000","00","001","0106","0000","2394","1153","1241","116","2510","4718","0","53.2","24.44"
"65","000","00","001","0106","0900","600","297","303","32","632","1035","0","61.06","28.7"
"65","000","00","001","0106","0901","777","372","405","18","795","1713","0","46.41","21.72"
"65","000","00","001","0106","0902","326","148","178","15","341","658","0","51.82","22.49"
"65","000","00","001","0106","0903","691","336","355","51","742","1312","0","56.55","25.61"
"65","000","00","001","0107","0000","1432","679","753","80","1512","2885","0","52.41","23.54"
"65","000","00","001","0107","0904","750","356","394","35","785","1492","0","52.61","23.86"
"65","000","00","001","0107","0905","682","323","359","45","727","1393","0","52.19","23.19"
"65","000","00","001","0108","0000","2892","1361","1531","147","3039","8490","0","35.8","16.03"
"65","000","00","001","0108","0906","854","387","467","33","887","4742","0","18.71","8.16"
"65","000","00","001","0108","0907","747","341","406","45","792","1439","0","55.04","23.7"
"65","000","00","001","0108","0908","683","345","338","38","721","1187","0","60.74","29.06"
"65","000","00","001","0108","0909","608","288","320","31","639","1122","0","56.95","25.67"
"65","000","00","001","0109","0000","2152","1091","1061","102","2254","3787","0","59.52","28.81"
"65","000","00","001","0109","0910","780","396","384","30","810","1363","0","59.43","29.05"
"65","000","00","001","0109","0911","611","316","295","38","649","1093","0","59.38","28.91"
"65","000","00","001","0109","0912","761","379","382","34","795","1331","0","59.73","28.47"
"65","000","00","001","0110","0000","2010","1022","988","124","2134","3777","0","56.5","27.06"
"65","000","00","001","0110","0915","637","343","294","52","689","1268","0","54.34","27.05"
"65","000","00","001","0110","0916","671","354","317","37","708","1313","0","53.92","26.96"
"65","000","00","001","0110","0917","702","325","377","35","737","1196","0","61.62","27.17"
"65","000","00","001","0111","0000","2836","1180","1656","130","2966","4565","0","64.97","25.85"
"65","000","00","001","0111","0918","749","299","450","30","779","1137","0","68.51","26.3"
"65","000","00","001","0111","0919","783","359","424","30","813","1269","0","64.07","28.29"
"65","000","00","001","0111","0920","672","270","402","37","709","1117","0","63.47","24.17"
"65","000","00","001","0111","0921","632","252","380","33","665","1042","0","63.82","24.18"
"65","000","00","001","0112","0000","1404","731","673","92","1496","2473","0","60.49","29.56"
"65","000","00","001","0112","0922","717","372","345","50","767","1257","0","61.02","29.59"
"65","000","00","001","0112","0923","687","359","328","42","729","1216","0","59.95","29.52"
"65","000","00","001","0113","0000","1401","616","785","96","1497","2416","0","61.96","25.5"
"65","000","00","001","0113","0924","606","298","308","55","661","1126","0","58.7","26.47"
"65","000","00","001","0113","0925","795","318","477","41","836","1290","0","64.81","24.65"
"65","000","00","001","0114","0000","1994","654","1340","90","2084","3372","0","61.8","19.4"
"65","000","00","001","0114","0928","808","239","569","37","845","1329","0","63.58","17.98"
"65","000","00","001","0114","0929","581","147","434","23","604","996","0","60.64","14.76"
"65","000","00","001","0114","0930","605","268","337","30","635","1047","0","60.65","25.6"
"65","000","00","001","0115","0000","1445","617","828","91","1536","2524","0","60.86","24.45"
"65","000","00","001","0115","0931","715","322","393","53","768","1272","0","60.38","25.31"
"65","000","00","001","0115","0932","730","295","435","38","768","1252","0","61.34","23.56"
"65","000","00","001","0116","0000","1920","958","962","128","2048","3509","0","58.36","27.3"
"65","000","00","001","0116","0936","568","273","295","39","607","1093","0","55.54","24.98"
"65","000","00","001","0116","0937","610","307","303","52","662","1148","0","57.67","26.74"
"65","000","00","001","0116","0938","742","378","364","37","779","1268","0","61.44","29.81"
"65","000","00","001","0117","0000","2403","1221","1182","154","2557","4250","0","60.16","28.73"
"65","000","00","001","0117","0939","681","374","307","37","718","1230","0","58.37","30.41"
"65","000","00","001","0117","0940","552","246","306","32","584","1012","0","57.71","24.31"
"65","000","00","001","0117","0941","458","260","198","34","492","811","0","60.67","32.06"
"65","000","00","001","0117","0942","712","341","371","51","763","1197","0","63.74","28.49"
"65","000","00","001","0118","0000","1208","564","644","55","1263","2364","0","53.43","23.86"
"65","000","00","001","0118","0943","625","273","352","23","648","1142","0","56.74","23.91"
"65","000","00","001","0118","0944","583","291","292","32","615","1222","0","50.33","23.81"
"65","000","00","001","0119","0000","1835","932","903","102","1937","3208","0","60.38","29.05"
"65","000","00","001","0119","0947","569","284","285","24","593","1011","0","58.65","28.09"
"65","000","00","001","0119","0948","654","340","314","48","702","1157","0","60.67","29.39"
"65","000","00","001","0119","0949","612","308","304","30","642","1040","0","61.73","29.62"
"65","000","00","001","0120","0000","2089","941","1148","71","2160","3621","0","59.65","25.99"
"65","000","00","001","0120","0950","688","288","400","27","715","1173","0","60.95","24.55"
"65","000","00","001","0120","0951","654","320","334","24","678","1193","0","56.83","26.82"
"65","000","00","001","0120","0952","747","333","414","20","767","1255","0","61.12","26.53"
"65","000","00","001","0121","0000","1922","1004","918","84","2006","3298","0","60.82","30.44"
"65","000","00","001","0121","0953","750","378","372","37","787","1306","0","60.26","28.94"
"65","000","00","001","0121","0954","623","319","304","18","641","1050","0","61.05","30.38"
"65","000","00","001","0121","0955","549","307","242","29","578","942","0","61.36","32.59"
"65","000","00","001","0122","0000","2154","977","1177","92","2246","3677","0","61.08","26.57"
"65","000","00","001","0122","0956","683","316","367","34","717","1133","0","63.28","27.89"
"65","000","00","001","0122","0957","710","328","382","26","736","1251","0","58.83","26.22"
"65","000","00","001","0122","0958","761","333","428","32","793","1293","0","61.33","25.75"
"65","000","00","001","0123","0000","1886","984","902","112","1998","3492","0","57.22","28.18"
"65","000","00","001","0123","0959","620","325","295","46","666","1208","0","55.13","26.9"
"65","000","00","001","0123","0960","690","360","330","37","727","1223","0","59.44","29.44"
"65","000","00","001","0123","0961","576","299","277","29","605","1061","0","57.02","28.18"
"65","000","00","001","0124","0000","2172","675","1497","79","2251","3596","0","62.6","18.77"
"65","000","00","001","0124","0964","698","242","456","28","726","1120","0","64.82","21.61"
"65","000","00","001","0124","0965","665","259","406","28","693","1091","0","63.52","23.74"
"65","000","00","001","0124","0966","809","174","635","23","832","1385","0","60.07","12.56"
"65","000","00","001","0125","0000","1377","653","724","72","1449","2269","0","63.86","28.78"
"65","000","00","001","0125","0969","723","328","395","35","758","1191","0","63.64","27.54"
"65","000","00","001","0125","0970","654","325","329","37","691","1078","0","64.1","30.15"
"65","000","00","001","0126","0000","1507","680","827","85","1592","2673","0","59.56","25.44"
"65","000","00","001","0126","0971","752","349","403","53","805","1351","0","59.59","25.83"
"65","000","00","001","0126","0972","755","331","424","32","787","1322","0","59.53","25.04"
"65","000","00","001","0127","0000","1139","541","598","83","1222","1897","0","64.42","28.52"
"65","000","00","001","0127","0973","496","241","255","35","531","868","0","61.18","27.76"
"65","000","00","001","0127","0974","643","300","343","48","691","1029","0","67.15","29.15"
"65","000","00","001","0128","0000","3451","1670","1781","154","3605","6157","0","58.55","27.12"
"65","000","00","001","0128","0975","933","494","439","25","958","1602","0","59.8","30.84"
"65","000","00","001","0128","0976","788","401","387","37","825","1362","0","60.57","29.44"
"65","000","00","001","0128","0977","908","434","474","60","968","1698","0","57.01","25.56"
"65","000","00","001","0128","0978","822","341","481","32","854","1495","0","57.12","22.81"
"65","000","00","001","0129","0000","2234","1109","1125","152","2386","4360","0","54.72","25.44"
"65","000","00","001","0129","0979","802","411","391","54","856","1522","0","56.24","27.0"
"65","000","00","001","0129","0980","712","361","351","46","758","1279","0","59.27","28.23"
"65","000","00","001","0129","0981","720","337","383","52","772","1559","0","49.52","21.62"
"65","000","00","001","0130","0000","2438","1199","1239","137","2575","4788","0","53.78","25.04"
"65","000","00","001","0130","0982","780","378","402","56","836","1537","0","54.39","24.59"
"65","000","00","001","0130","0983","745","389","356","54","799","1531","0","52.19","25.41"
"65","000","00","001","0130","0984","913","432","481","27","940","1720","0","54.65","25.12"
"65","000","00","001","0131","0000","2904","1437","1467","125","3029","5277","0","57.4","27.23"
"65","000","00","001","0131","0985","625","299","326","21","646","1165","0","55.45","25.67"
"65","000","00","001","0131","0986","1026","462","564","55","1081","1857","0","58.21","24.88"
"65","000","00","001","0131","0987","589","324","265","33","622","1078","0","57.7","30.06"
"65","000","00","001","0131","0988","664","352","312","16","680","1177","0","57.77","29.91"
"65","000","00","001","0132","0000","1829","817","1012","97","1926","3253","0","59.21","25.12"
"65","000","00","001","0132","0989","1005","405","600","37","1042","1798","0","57.95","22.53"
"65","000","00","001","0132","0990","824","412","412","60","884","1455","0","60.76","28.32"
"65","000","00","001","0133","0000","2301","1079","1222","103","2404","4295","0","55.97","25.12"
"65","000","00","001","0133","0993","896","366","530","26","922","1600","0","57.63","22.88"
"65","000","00","001","0133","0994","705","368","337","34","739","1409","0","52.45","26.12"
"65","000","00","001","0133","0995","700","345","355","43","743","1286","0","57.78","26.83"
"65","000","00","001","0134","0000","1204","616","588","104","1308","2547","0","51.35","24.19"
"65","000","00","001","0134","0996","615","311","304","58","673","1359","0","49.52","22.88"
"65","000","00","001","0134","0997","589","305","284","46","635","1188","0","53.45","25.67"
"65","000","00","001","0135","0000","3739","1826","1913","174","3913","6884","0","56.84","26.53"
"65","000","00","001","0135","0998","874","496","378","35","909","1627","0","55.87","30.49"
"65","000","00","001","0135","0999","851","438","413","29","880","1633","0","53.89","26.82"
"65","000","00","001","0135","1000","1020","441","579","64","1084","1814","0","59.76","24.31"
"65","000","00","001","0135","1001","994","451","543","46","1040","1810","0","57.46","24.92"
"65","000","00","001","0136","0000","1825","1028","797","113","1938","3315","0","58.46","31.01"
"65","000","00","001","0136","1005","593","345","248","52","645","1130","0","57.08","30.53"
"65","000","00","001","0136","1006","626","332","294","35","661","1056","0","62.59","31.44"
"65","000","00","001","0136","1007","606","351","255","26","632","1129","0","55.98","31.09"
"65","000","00","001","0137","0000","3584","1631","1953","187","3771","6233","0","60.5","26.17"
"65","000","00","001","0137","1008","927","440","487","52","979","1713","0","57.15","25.69"
"65","000","00","001","0137","1009","917","431","486","55","972","1622","0","59.93","26.57"
"65","000","00","001","0137","1010","847","365","482","56","903","1427","0","63.28","25.58"
"65","000","00","001","0137","1011","893","395","498","24","917","1471","0","62.34","26.85"
"65","000","00","001","0138","0000","1503","842","661","99","1602","2637","0","60.75","31.93"
"65","000","00","001","0138","1015","435","237","198","36","471","828","0","56.88","28.62"
"65","000","00","001","0138","1016","478","269","209","41","519","820","0","63.29","32.8"
"65","000","00","001","0138","1017","590","336","254","22","612","989","0","61.88","33.97"
"65","000","00","001","0139","0000","2351","1184","1167","161","2512","4257","0","59.01","27.81"
"65","000","00","001","0139","1018","543","272","271","54","597","1023","0","58.36","26.59"
"65","000","00","001","0139","1019","563","289","274","28","591","1044","0","56.61","27.68"
"65","000","00","001","0139","1020","528","262","266","52","580","968","0","59.92","27.07"
"65","000","00","001","0139","1021","717","361","356","27","744","1222","0","60.88","29.54"
"65","000","00","001","0140","0000","1600","818","782","74","1674","2970","0","56.36","27.54"
"65","000","00","001","0140","1022","761","409","352","30","791","1385","0","57.11","29.53"
"65","000","00","001","0140","1023","839","409","430","44","883","1585","0","55.71","25.8"
"65","000","00","001","0141","0000","2037","902","1135","116","2153","3646","0","59.05","24.74"
"65","000","00","001","0141","1024","974","456","518","54","1028","1840","0","55.87","24.78"
"65","000","00","001","0141","1025","1063","446","617","62","1125","1806","0","62.29","24.7"
"65","000","00","001","0142","0000","2398","1203","1195","160","2558","4482","0","57.07","26.84"
"65","000","00","001","0142","1026","807","433","374","54","861","1506","0","57.17","28.75"
"65","000","00","001","0142","1027","755","385","370","56","811","1476","0","54.95","26.08"
"65","000","00","001","0142","1028","836","385","451","50","886","1500","0","59.07","25.67"
"65","000","00","001","0143","0000","1783","885","898","82","1865","3108","0","60.01","28.47"
"65","000","00","001","0143","1031","883","448","435","40","923","1601","0","57.65","27.98"
"65","000","00","001","0143","1032","900","437","463","42","942","1507","0","62.51","29.0"
"65","000","00","001","0144","0000","5053","2225","2828","221","5274","8859","0","59.53","25.12"
"65","000","00","001","0144","1035","1051","493","558","56","1107","1822","0","60.76","27.06"
"65","000","00","001","0144","1036","950","458","492","54","1004","1605","0","62.55","28.54"
"65","000","00","001","0144","1037","888","359","529","29","917","1549","0","59.2","23.18"
"65","000","00","001","0144","1038","1122","485","637","38","1160","1948","0","59.55","24.9"
"65","000","00","001","0144","1039","1042","430","612","44","1086","1935","0","56.12","22.22"
"65","000","00","001","0145","0000","1153","618","535","68","1221","2192","0","55.7","28.19"
"65","000","00","001","0145","1040","576","318","258","31","607","1097","0","55.33","28.99"
"65","000","00","001","0145","1041","577","300","277","37","614","1095","0","56.07","27.4"
"65","000","00","001","0146","0000","2024","992","1032","109","2133","3603","0","59.2","27.53"
"65","000","00","001","0146","1044","612","284","328","51","663","1187","0","55.86","23.93"
"65","000","00","001","0146","1045","664","305","359","30","694","1154","0","60.14","26.43"
"65","000","00","001","0146","1046","748","403","345","28","776","1262","0","61.49","31.93"
"65","000","00","001","0147","0000","1442","720","722","100","1542","2681","0","57.52","26.86"
"65","000","00","001","0147","1047","689","325","364","41","730","1271","0","57.44","25.57"
"65","000","00","001","0147","1048","753","395","358","59","812","1410","0","57.59","28.01"
"65","000","00","001","0148","0000","2839","1417","1422","197","3036","5365","0","56.59","26.41"
"65","000","00","001","0148","1049","868","427","441","62","930","1745","0","53.3","24.47"
"65","000","00","001","0148","1050","984","522","462","75","1059","1867","0","56.72","27.96"
"65","000","00","001","0148","1051","987","468","519","60","1047","1753","0","59.73","26.7"
"65","000","00","001","0149","0000","691","337","354","32","723","1204","0","60.05","27.99"
"65","000","00","001","0149","1052","691","337","354","32","723","1204","0","60.05","27.99"
"65","000","00","001","0150","0000","3023","1534","1489","170","3193","5455","0","58.53","28.12"
"65","000","00","001","0150","1053","833","386","447","63","896","1614","0","55.51","23.92"
"65","000","00","001","0150","1054","716","371","345","32","748","1237","0","60.47","29.99"
"65","000","00","001","0150","1055","758","401","357","52","810","1361","0","59.52","29.46"
"65","000","00","001","0150","1056","716","376","340","23","739","1243","0","59.45","30.25"
"65","000","00","001","0151","0000","2184","1073","1111","111","2295","3979","0","57.68","26.97"
"65","000","00","001","0151","1057","769","358","411","28","797","1515","0","52.61","23.63"
"65","000","00","001","0151","1058","864","441","423","50","914","1515","0","60.33","29.11"
"65","000","00","001","0151","1059","551","274","277","33","584","949","0","61.54","28.87"
"65","000","00","001","0152","0000","1924","983","941","100","2024","3768","0","53.72","26.09"
"65","000","00","001","0152","1060","845","384","461","46","891","1629","0","54.7","23.57"
"65","000","00","001","0152","1061","697","380","317","38","735","1238","0","59.37","30.69"
"65","000","00","001","0152","1062","382","219","163","16","398","901","0","44.17","24.31"
"65","000","00","001","0153","0000","1604","808","796","104","1708","2956","0","57.78","27.33"
"65","000","00","001","0153","1063","814","388","426","58","872","1475","0","59.12","26.31"
"65","000","00","001","0153","1064","790","420","370","46","836","1481","0","56.45","28.36"
"65","000","00","001","0154","0000","3045","1482","1563","142","3187","5602","0","56.89","26.45"
"65","000","00","001","0154","1065","905","401","504","54","959","1800","0","53.28","22.28"
"65","000","00","001","0154","1066","880","459","421","35","915","1630","0","56.13","28.16"
"65","000","00","001","0154","1067","755","349","406","27","782","1298","0","60.25","26.89"
"65","000","00","001","0154","1068","505","273","232","26","531","874","0","60.76","31.24"
"65","000","00","001","0155","0000","1498","760","738","84","1582","2581","0","61.29","29.45"
"65","000","00","001","0155","1071","823","413","410","50","873","1451","0","60.17","28.46"
"65","000","00","001","0155","1072","675","347","328","34","709","1130","0","62.74","30.71"
"65","000","00","001","0156","0000","1658","718","940","100","1758","2971","0","59.17","24.17"
"65","000","00","001","0156","1073","815","339","476","35","850","1440","0","59.03","23.54"
"65","000","00","001","0156","1074","843","379","464","65","908","1531","0","59.31","24.76"
"65","000","00","001","0157","0000","3722","1685","2037","156","3878","6492","0","59.74","25.96"
"65","000","00","001","0157","1077","644","296","348","26","670","1174","0","57.07","25.21"
"65","000","00","001","0157","1078","665","319","346","47","712","1228","0","57.98","25.98"
"65","000","00","001","0157","1079","713","377","336","15","728","1187","0","61.33","31.76"
"65","000","00","001","0157","1080","507","247","260","34","541","870","0","62.18","28.39"
"65","000","00","001","0157","1081","1193","446","747","34","1227","2033","0","60.35","21.94"
"65","000","00","001","0158","0000","1326","680","646","72","1398","2493","0","56.08","27.28"
"65","000","00","001","0158","1082","730","375","355","42","772","1418","0","54.44","26.45"
"65","000","00","001","0158","1083","596","305","291","30","626","1075","0","58.23","28.37"
"65","000","00","001","0159","0000","2406","1154","1252","116","2522","4561","0","55.29","25.3"
"65","000","00","001","0159","1086","1024","472","552","32","1056","1893","0","55.78","24.93"
"65","000","00","001","0159","1087","680","325","355","51","731","1302","0","56.14","24.96"
"65","000","00","001","0159","1088","702","357","345","33","735","1366","0","53.81","26.13"
"65","000","00","001","0160","0000","1453","695","758","69","1522","2518","0","60.44","27.6"
"65","000","00","001","0160","1089","776","358","418","49","825","1318","0","62.59","27.16"
"65","000","00","001","0160","1090","677","337","340","20","697","1200","0","58.08","28.08"
"65","000","00","001","0161","0000","2075","1135","940","99","2174","3774","0","57.6","30.07"
"65","000","00","001","0161","1091","1109","524","585","38","1147","2028","0","56.56","25.84"
"65","000","00","001","0161","1092","966","611","355","61","1027","1746","0","58.82","34.99"
"65","000","00","001","0162","0000","1696","888","808","93","1789","2981","0","60.01","29.79"
"65","000","00","001","0162","1095","772","395","377","41","813","1418","0","57.33","27.86"
"65","000","00","001","0162","1096","924","493","431","52","976","1563","0","62.44","31.54"
"65","000","00","001","0163","0000","1853","914","939","81","1934","3487","0","55.46","26.21"
"65","000","00","001","0163","1097","925","468","457","52","977","1780","0","54.89","26.29"
"65","000","00","001","0163","1098","928","446","482","29","957","1707","0","56.06","26.13"
"65","000","00","001","0164","0000","1552","766","786","82","1634","3051","0","53.56","25.11"
"65","000","00","001","0164","1099","359","171","188","18","377","906","0","41.61","18.87"
"65","000","00","001","0164","1100","553","265","288","42","595","1030","0","57.77","25.73"
"65","000","00","001","0164","1101","640","330","310","22","662","1115","0","59.37","29.6"
"65","000","00","001","0165","0000","3909","1699","2210","144","4053","7165","0","56.57","23.71"
"65","000","00","001","0165","1102","975","415","560","30","1005","1836","0","54.74","22.6"
"65","000","00","001","0165","1103","1005","473","532","51","1056","1881","0","56.14","25.15"
"65","000","00","001","0165","1104","917","408","509","33","950","1688","0","56.28","24.17"
"65","000","00","001","0165","1105","1012","403","609","30","1042","1760","0","59.2","22.9"
"65","000","00","001","0166","0000","1912","892","1020","105","2017","3186","0","63.31","28.0"
"65","000","00","001","0166","1106","621","296","325","40","661","1044","0","63.31","28.35"
"65","000","00","001","0166","1107","631","296","335","32","663","1043","0","63.57","28.38"
"65","000","00","001","0166","1108","660","300","360","33","693","1099","0","63.06","27.3"
"65","000","00","001","0167","0000","1361","638","723","70","1431","2391","0","59.85","26.68"
"65","000","00","001","0167","1109","734","351","383","36","770","1260","0","61.11","27.86"
"65","000","00","001","0167","1110","627","287","340","34","661","1131","0","58.44","25.38"
"65","000","00","001","0168","0000","2256","1157","1099","119","2375","3947","0","60.17","29.31"
"65","000","00","001","0168","1111","687","364","323","39","726","1225","0","59.27","29.71"
"65","000","00","001","0168","1112","888","419","469","28","916","1455","0","62.96","28.8"
"65","000","00","001","0168","1113","681","374","307","52","733","1267","0","57.85","29.52"
"65","000","00","001","0169","0000","2189","1054","1135","116","2305","3832","0","60.15","27.51"
"65","000","00","001","0169","1116","642","321","321","23","665","1111","0","59.86","28.89"
"65","000","00","001","0169","1117","737","372","365","45","782","1177","0","66.44","31.61"
"65","000","00","001","0169","1118","810","361","449","48","858","1544","0","55.57","23.38"
"65","000","00","001","0170","0000","2231","913","1318","70","2301","4087","0","56.3","22.34"
"65","000","00","001","0170","1121","799","345","454","31","830","1504","0","55.19","22.94"
"65","000","00","001","0170","1122","730","283","447","20","750","1373","0","54.62","20.61"
"65","000","00","001","0170","1123","702","285","417","19","721","1210","0","59.59","23.55"
"65","000","00","001","0171","0000","1790","758","1032","102","1892","3360","0","56.31","22.56"
"65","000","00","001","0171","1124","921","398","523","50","971","1809","0","53.68","22.0"
"65","000","00","001","0171","1125","869","360","509","52","921","1551","0","59.38","23.21"
"65","000","00","001","0172","0000","2244","1021","1223","82","2326","3795","0","61.29","26.9"
"65","000","00","001","0172","1126","818","346","472","21","839","1408","0","59.59","24.57"
"65","000","00","001","0172","1127","749","334","415","26","775","1285","0","60.31","25.99"
"65","000","00","001","0172","1128","677","341","336","35","712","1102","0","64.61","30.94"
"65","000","00","001","0173","0000","1640","721","919","80","1720","3091","0","55.65","23.33"
"65","000","00","001","0173","1129","705","301","404","31","736","1399","0","52.61","21.52"
"65","000","00","001","0173","1130","935","420","515","49","984","1692","0","58.16","24.82"
"65","000","00","001","0174","0000","2532","1174","1358","114","2646","4478","0","59.09","26.22"
"65","000","00","001","0174","1133","711","338","373","25","736","1246","0","59.07","27.13"
"65","000","00","001","0174","1134","847","416","431","30","877","1471","0","59.62","28.28"
"65","000","00","001","0174","1135","974","420","554","59","1033","1761","0","58.66","23.85"
"65","000","00","001","0175","0000","1280","426","854","91","1371","3027","0","45.29","14.07"
"65","000","00","001","0175","1136","513","83","430","53","566","1499","0","37.76","5.54"
"65","000","00","001","0175","1137","767","343","424","38","805","1528","0","52.68","22.45"
"65","000","00","001","0176","0000","1791","853","938","69","1860","3086","0","60.27","27.64"
"65","000","00","001","0176","1138","894","432","462","40","934","1536","0","60.81","28.13"
"65","000","00","001","0176","1139","897","421","476","29","926","1550","0","59.74","27.16"
"65","000","00","001","0177","0000","1876","887","989","88","1964","3350","0","58.63","26.48"
"65","000","00","001","0177","1140","1133","526","607","50","1183","2050","0","57.71","25.66"
"65","000","00","001","0177","1141","743","361","382","38","781","1300","0","60.08","27.77"
"65","000","00","001","0178","0000","3193","1474","1719","119","3312","5917","0","55.97","24.91"
"65","000","00","001","0178","1142","855","351","504","36","891","1537","0","57.97","22.84"
"65","000","00","001","0178","1143","680","350","330","25","705","1341","0","52.57","26.1"
"65","000","00","001","0178","1144","906","387","519","25","931","1606","0","57.97","24.1"
"65","000","00","001","0178","1145","752","386","366","33","785","1433","0","54.78","26.94"
"65","000","00","001","0179","0000","2234","1027","1207","112","2346","4105","0","57.15","25.02"
"65","000","00","001","0179","1146","874","410","464","31","905","1685","0","53.71","24.33"
"65","000","00","001","0179","1147","735","338","397","46","781","1248","0","62.58","27.08"
"65","000","00","001","0179","1148","625","279","346","35","660","1172","0","56.31","23.81"
"65","000","00","001","0180","0000","4055","1729","2326","181","4236","7527","0","56.28","22.97"
"65","000","00","001","0180","1149","815","406","409","23","838","1640","0","51.1","24.76"
"65","000","00","001","0180","1150","775","277","498","37","812","1428","0","56.86","19.4"
"65","000","00","001","0180","1151","819","369","450","62","881","1527","0","57.69","24.17"
"65","000","00","001","0180","1152","772","323","449","24","796","1350","0","58.96","23.93"
"65","000","00","001","0180","1153","874","354","520","35","909","1582","0","57.46","22.38"
"65","000","00","001","0181","0000","1692","682","1010","84","1776","2823","0","62.91","24.16"
"65","000","00","001","0181","1154","565","209","356","37","602","919","0","65.51","22.74"
"65","000","00","001","0181","1155","523","226","297","23","546","930","0","58.71","24.3"
"65","000","00","001","0181","1156","604","247","357","24","628","974","0","64.48","25.36"
"65","000","00","001","0182","0000","1732","696","1036","84","1816","3170","0","57.29","21.96"
"65","000","00","001","0182","1157","959","362","597","40","999","1732","0","57.68","20.9"
"65","000","00","001","0182","1158","773","334","439","44","817","1438","0","56.82","23.23"
"65","000","00","001","0183","0000","1737","814","923","127","1864","3541","0","52.64","22.99"
"65","000","00","001","0183","1159","906","448","458","71","977","1777","0","54.98","25.21"
"65","000","00","001","0183","1160","831","366","465","56","887","1764","0","50.28","20.75"
"65","000","00","001","0184","0000","1996","924","1072","101","2097","3712","0","56.49","24.89"
"65","000","00","001","0184","1164","961","464","497","52","1013","1870","0","54.17","24.81"
"65","000","00","001","0184","1165","1035","460","575","49","1084","1842","0","58.85","24.97"
"65","000","00","001","0185","0000","1234","555","679","89","1323","2322","0","56.98","23.9"
"65","000","00","001","0185","1166","601","259","342","43","644","1094","0","58.87","23.67"
"65","000","00","001","0185","1167","633","296","337","46","679","1228","0","55.29","24.1"
"65","000","00","001","0186","0000","3267","1463","1804","173","3440","6224","0","55.27","23.51"
"65","000","00","001","0186","1170","817","402","415","40","857","1622","0","52.84","24.78"
"65","000","00","001","0186","1171","677","355","322","50","727","1205","0","60.33","29.46"
"65","000","00","001","0186","1172","881","364","517","50","931","1787","0","52.1","20.37"
"65","000","00","001","0186","1173","892","342","550","33","925","1610","0","57.45","21.24"
"65","000","00","001","0187","0000","3569","1501","2068","158","3727","6600","0","56.47","22.74"
"65","000","00","001","0187","1174","1270","543","727","42","1312","2216","0","59.21","24.5"
"65","000","00","001","0187","1175","1231","516","715","50","1281","2294","0","55.84","22.49"
"65","000","00","001","0187","1176","1068","442","626","66","1134","2090","0","54.26","21.15"
"65","000","00","001","0188","0000","1980","924","1056","107","2087","3742","0","55.77","24.69"
"65","000","00","001","0188","1177","662","277","385","27","689","1356","0","50.81","20.43"
"65","000","00","001","0188","1178","596","273","323","41","637","1067","0","59.7","25.59"
"65","000","00","001","0188","1179","722","374","348","39","761","1319","0","57.7","28.35"
"65","000","00","001","0189","0000","1770","905","865","120","1890","3368","0","56.12","26.87"
"65","000","00","001","0189","1180","676","328","348","50","726","1316","0","55.17","24.92"
"65","000","00","001","0189","1181","612","323","289","43","655","1195","0","54.81","27.03"
"65","000","00","001","0189","1182","482","254","228","27","509","857","0","59.39","29.64"
"65","000","00","001","0190","0000","2533","1391","1142","169","2702","4724","0","57.2","29.45"
"65","000","00","001","0190","1183","709","350","359","59","768","1417","0","54.2","24.7"
"65","000","00","001","0190","1184","848","424","424","64","912","1560","0","58.46","27.18"
"65","000","00","001","0190","1185","976","617","359","46","1022","1747","0","58.5","35.32"
"65","000","00","001","0191","0000","2185","1132","1053","93","2278","3735","0","60.99","30.31"
"65","000","00","001","0191","1186","718","379","339","36","754","1176","0","64.12","32.23"
"65","000","00","001","0191","1187","627","327","300","32","659","1101","0","59.85","29.7"
"65","000","00","001","0191","1188","840","426","414","25","865","1458","0","59.33","29.22"
"65","000","00","001","0192","0000","3182","1460","1722","166","3348","5591","0","59.88","26.11"
"65","000","00","001","0192","1192","629","318","311","24","653","1120","0","58.3","28.39"
"65","000","00","001","0192","1193","615","286","329","49","664","1022","0","64.97","27.98"
"65","000","00","001","0192","1194","592","301","291","52","644","1049","0","61.39","28.69"
"65","000","00","001","0192","1195","576","232","344","18","594","1007","0","58.99","23.04"
"65","000","00","001","0192","1196","770","323","447","23","793","1393","0","56.93","23.19"
"65","000","00","001","0193","0000","446","227","219","58","504","974","0","51.75","23.31"
"65","000","00","001","0193","1197","170","80","90","32","202","474","0","42.62","16.88"
"65","000","00","001","0193","1198","276","147","129","26","302","500","0","60.4","29.4"
"65","000","00","001","0194","0000","1953","914","1039","108","2061","3502","0","58.85","26.1"
"65","000","00","001","0194","1199","650","313","337","30","680","1177","0","57.77","26.59"
"65","000","00","001","0194","1200","648","272","376","29","677","1186","0","57.08","22.93"
"65","000","00","001","0194","1201","655","329","326","49","704","1139","0","61.81","28.88"
"65","000","00","001","0195","0000","2116","927","1189","60","2176","5201","0","41.84","17.82"
"65","000","00","001","0195","1202","934","422","512","36","970","1750","0","55.43","24.11"
"65","000","00","001","0195","1203","1182","505","677","24","1206","3451","0","34.95","14.63"
"65","000","00","001","0196","0000","2428","1255","1173","123","2551","4730","0","53.93","26.53"
"65","000","00","001","0196","1204","806","415","391","62","868","1620","0","53.58","25.62"
"65","000","00","001","0196","1205","437","228","209","22","459","903","0","50.83","25.25"
"65","000","00","001","0196","1206","700","348","352","21","721","1232","0","58.52","28.25"
"65","000","00","001","0196","1207","485","264","221","18","503","975","0","51.59","27.08"
"65","000","00","001","0197","0000","1373","692","681","56","1429","2515","0","56.82","27.51"
"65","000","00","001","0197","1208","653","353","300","27","680","1224","0","55.56","28.84"
"65","000","00","001","0197","1209","720","339","381","29","749","1291","0","58.02","26.26"
"65","000","00","001","0198","0000","4288","1982","2306","181","4469","8555","0","52.24","23.17"
"65","000","00","001","0198","1210","896","419","477","33","929","1828","0","50.82","22.92"
"65","000","00","001","0198","1211","850","423","427","44","894","1725","0","51.83","24.52"
"65","000","00","001","0198","1212","531","224","307","23","554","1085","0","51.06","20.65"
"65","000","00","001","0198","1213","1188","542","646","50","1238","2357","0","52.52","23.0"
"65","000","00","001","0198","1214","823","374","449","31","854","1560","0","54.74","23.97"
"65","000","00","001","0199","0000","2640","1313","1327","113","2753","5152","0","53.44","25.49"
"65","000","00","001","0199","1218","917","449","468","43","960","1763","0","54.45","25.47"
"65","000","00","001","0199","1219","871","441","430","28","899","1744","0","51.55","25.29"
"65","000","00","001","0199","1220","852","423","429","42","894","1645","0","54.35","25.71"
"65","000","00","001","01A0","0000","1730","869","861","114","1844","3118","0","59.14","27.87"
"65","000","00","001","01A0","1228","826","412","414","64","890","1566","0","56.83","26.31"
"65","000","00","001","01A0","1229","904","457","447","50","954","1552","0","61.47","29.45"
"65","000","00","001","01A1","0000","1289","598","691","84","1373","2270","0","60.48","26.34"
"65","000","00","001","01A1","0913","600","293","307","43","643","1026","0","62.67","28.56"
"65","000","00","001","01A1","0914","689","305","384","41","730","1244","0","58.68","24.52"
"65","000","00","001","01A2","0000","2239","1109","1130","133","2372","3821","0","62.08","29.02"
"65","000","00","001","01A2","0933","694","338","356","40","734","1238","0","59.29","27.3"
"65","000","00","001","01A2","0934","835","417","418","50","885","1389","0","63.71","30.02"
"65","000","00","001","01A2","0935","710","354","356","43","753","1194","0","63.07","29.65"
"65","000","00","001","01A3","0000","1550","715","835","82","1632","2740","0","59.56","26.09"
"65","000","00","001","01A3","0962","841","404","437","35","876","1515","0","57.82","26.67"
"65","000","00","001","01A3","0963","709","311","398","47","756","1225","0","61.71","25.39"
"65","000","00","001","01A4","0000","1603","795","808","113","1716","2949","0","58.19","26.96"
"65","000","00","001","01A4","0991","718","364","354","51","769","1245","0","61.77","29.24"
"65","000","00","001","01A4","0992","885","431","454","62","947","1704","0","55.58","25.29"
"65","000","00","001","01A5","0000","1742","915","827","65","1807","3134","0","57.66","29.2"
"65","000","00","001","01A5","1012","586","343","243","19","605","1076","0","56.23","31.88"
"65","000","00","001","01A5","1013","496","259","237","20","516","979","0","52.71","26.46"
"65","000","00","001","01A5","1014","660","313","347","26","686","1079","0","63.58","29.01"
"65","000","00","001","01A6","0000","1426","715","711","75","1501","2493","0","60.21","28.68"
"65","000","00","001","01A6","1033","781","394","387","47","828","1315","0","62.97","29.96"
"65","000","00","001","01A6","1034","645","321","324","28","673","1178","0","57.13","27.25"
"65","000","00","001","01A7","0000","1216","604","612","44","1260","2026","0","62.19","29.81"
"65","000","00","001","01A7","1069","569","308","261","14","583","992","0","58.77","31.05"
"65","000","00","001","01A7","1070","647","296","351","30","677","1034","0","65.47","28.63"
"65","000","00","001","01A8","0000","1542","755","787","65","1607","2697","0","59.58","27.99"
"65","000","00","001","01A8","1084","805","386","419","29","834","1515","0","55.05","25.48"
"65","000","00","001","01A8","1085","737","369","368","36","773","1182","0","65.4","31.22"
"65","000","00","001","01A9","0000","1152","608","544","65","1217","1966","0","61.9","30.93"
"65","000","00","001","01A9","1114","562","323","239","37","599","972","0","61.63","33.23"
"65","000","00","001","01A9","1115","590","285","305","28","618","994","0","62.17","28.67"
"65","000","00","001","01B0","0000","1917","842","1075","81","1998","3337","0","59.87","25.23"
"65","000","00","001","01B0","1131","959","402","557","29","988","1625","0","60.8","24.74"
"65","000","00","001","01B0","1132","958","440","518","52","1010","1712","0","59.0","25.7"
"65","000","00","001","01B1","0000","1170","569","601","63","1233","1860","0","66.29","30.59"
"65","000","00","001","01B1","1168","626","293","333","34","660","998","0","66.13","29.36"
"65","000","00","001","01B1","1169","544","276","268","29","573","862","0","66.47","32.02"
"65","000","00","001","01B2","0000","1960","968","992","62","2022","3778","0","53.52","25.62"
"65","000","00","001","01B2","1230","977","485","492","26","1003","1885","0","53.21","25.73"
"65","000","00","001","01B2","1231","983","483","500","36","1019","1893","0","53.83","25.52"
"65","000","00","001","01B3","0000","2629","1181","1448","108","2737","5613","0","48.76","21.04"
"65","000","00","001","01B3","1215","991","459","532","27","1018","2201","0","46.25","20.85"
"65","000","00","001","01B3","1216","851","407","444","44","895","1626","0","55.04","25.03"
"65","000","00","001","01B3","1217","787","315","472","37","824","1786","0","46.14","17.64"
"65","000","00","001","01B4","0000","1207","540","667","51","1258","2314","0","54.36","23.34"
"65","000","00","001","01B4","0926","628","276","352","23","651","1215","0","53.58","22.72"
"65","000","00","001","01B4","0927","579","264","315","28","607","1099","0","55.23","24.02"
"65","000","00","001","01B5","0000","1099","489","610","70","1169","1793","0","65.2","27.27"
"65","000","00","001","01B5","0945","487","208","279","35","522","796","0","65.58","26.13"
"65","000","00","001","01B5","0946","612","281","331","35","647","997","0","64.89","28.18"
"65","000","00","001","01B6","0000","1428","720","708","79","1507","2487","0","60.6","28.95"
"65","000","00","001","01B6","0967","747","353","394","32","779","1283","0","60.72","27.51"
"65","000","00","001","01B6","0968","681","367","314","47","728","1204","0","60.47","30.48"
"65","000","00","001","01B7","0000","1719","895","824","111","1830","3024","0","60.52","29.6"
"65","000","00","001","01B7","1002","618","313","305","48","666","1133","0","58.78","27.63"
"65","000","00","001","01B7","1003","470","265","205","30","500","841","0","59.45","31.51"
"65","000","00","001","01B7","1004","631","317","314","33","664","1050","0","63.24","30.19"
"65","000","00","001","01B8","0000","1229","590","639","66","1295","2059","0","62.89","28.65"
"65","000","00","001","01B8","1029","664","313","351","27","691","1096","0","63.05","28.56"
"65","000","00","001","01B8","1030","565","277","288","39","604","963","0","62.72","28.76"
"65","000","00","001","01B9","0000","1791","884","907","120","1911","3428","0","55.75","25.79"
"65","000","00","001","01B9","1042","879","431","448","66","945","1678","0","56.32","25.69"
"65","000","00","001","01B9","1043","912","453","459","54","966","1750","0","55.2","25.89"
"65","000","00","001","01C0","0000","1660","822","838","80","1740","2942","0","59.14","27.94"
"65","000","00","001","01C0","1075","821","384","437","42","863","1349","0","63.97","28.47"
"65","000","00","001","01C0","1076","839","438","401","38","877","1593","0","55.05","27.5"
"65","000","00","001","01C1","0000","1769","779","990","67","1836","3428","0","53.56","22.72"
"65","000","00","001","01C1","1093","969","425","544","33","1002","1954","0","51.28","21.75"
"65","000","00","001","01C1","1094","800","354","446","34","834","1474","0","56.58","24.02"
"65","000","00","001","01C2","0000","1106","533","573","97","1203","2061","0","58.37","25.86"
"65","000","00","001","01C2","1119","546","263","283","52","598","1021","0","58.57","25.76"
"65","000","00","001","01C2","1120","560","270","290","45","605","1040","0","58.17","25.96"
"65","000","00","001","01C3","0000","2081","1106","975","81","2162","3645","0","59.31","30.34"
"65","000","00","001","01C3","1161","706","409","297","21","727","1289","0","56.4","31.73"
"65","000","00","001","01C3","1162","700","359","341","27","727","1182","0","61.51","30.37"
"65","000","00","001","01C3","1163","675","338","337","33","708","1174","0","60.31","28.79"
"65","000","00","001","01C4","0000","6181","2815","3366","282","6463","12065","0","53.57","23.33"
"65","000","00","001","01C4","1221","892","337","555","33","925","1861","0","49.7","18.11"
"65","000","00","001","01C4","1222","781","370","411","30","811","1596","0","50.81","23.18"
"65","000","00","001","01C4","1223","960","446","514","55","1015","1871","0","54.25","23.84"
"65","000","00","001","01C4","1224","1025","442","583","49","1074","1938","0","55.42","22.81"
"65","000","00","001","01C4","1225","976","434","542","41","1017","1827","0","55.67","23.75"
"65","000","00","001","01C4","1226","697","293","404","26","723","1359","0","53.2","21.56"
"65","000","00","001","01C4","1227","850","493","357","48","898","1613","0","55.67","30.56"
"65","000","00","001","01C5","0000","1659","832","827","82","1741","3241","0","53.72","25.67"
"65","000","00","001","01C5","1189","809","405","404","29","838","1630","0","51.41","24.85"
"65","000","00","001","01C5","1190","850","427","423","53","903","1611","0","56.05","26.51"
"65","000","00","001","01C6","0000","606","321","285","33","639","1139","0","56.1","28.18"
"65","000","00","001","01C6","1191","606","321","285","33","639","1139","0","56.1","28.18"
"65","000","00","002","0000","0000","176027","89027","87000","9721","185748","329846","386077","56.31","26.99"
"65","000","00","002","0201","0000","2580","1307","1273","119","2699","4753","0","56.79","27.5"
"65","000","00","002","0201","0659","767","372","395","46","813","1509","0","53.88","24.65"
"65","000","00","002","0201","0660","881","451","430","39","920","1591","0","57.83","28.35"
"65","000","00","002","0201","0661","932","484","448","34","966","1653","0","58.44","29.28"
"65","000","00","002","0202","0000","808","387","421","36","844","1459","0","57.85","26.53"
"65","000","00","002","0202","0665","808","387","421","36","844","1459","0","57.85","26.53"
"65","000","00","002","0203","0000","1189","665","524","83","1272","2090","0","60.86","31.82"
"65","000","00","002","0203","0666","591","340","251","38","629","1024","0","61.43","33.2"
"65","000","00","002","0203","0667","598","325","273","45","643","1066","0","60.32","30.49"
"65","000","00","002","0204","0000","529","285","244","42","571","856","0","66.71","33.29"
"65","000","00","002","0204","0668","529","285","244","42","571","856","0","66.71","33.29"
"65","000","00","002","0205","0000","1796","986","810","67","1863","3533","0","52.73","27.91"
"65","000","00","002","0205","0671","948","499","449","43","991","1887","0","52.52","26.44"
"65","000","00","002","0205","0672","848","487","361","24","872","1646","0","52.98","29.59"
"65","000","00","002","0206","0000","228","139","89","10","238","358","0","66.48","38.83"
"65","000","00","002","0206","0673","228","139","89","10","238","358","0","66.48","38.83"
"65","000","00","002","0207","0000","3083","1427","1656","91","3174","5443","0","58.31","26.22"
"65","000","00","002","0207","0674","617","310","307","17","634","1039","0","61.02","29.84"
"65","000","00","002","0207","0675","665","336","329","19","684","1114","0","61.4","30.16"
"65","000","00","002","0207","0676","919","411","508","27","946","1588","0","59.57","25.88"
"65","000","00","002","0207","0677","882","370","512","28","910","1702","0","53.47","21.74"
"65","000","00","002","0208","0000","2591","1303","1288","121","2712","4778","0","56.76","27.27"
"65","000","00","002","0208","0678","758","364","394","36","794","1288","0","61.65","28.26"
"65","000","00","002","0208","0679","831","467","364","35","866","1629","0","53.16","28.67"
"65","000","00","002","0208","0680","1002","472","530","50","1052","1861","0","56.53","25.36"
"65","000","00","002","0209","0000","1708","862","846","94","1802","3108","0","57.98","27.73"
"65","000","00","002","0209","0683","866","436","430","48","914","1595","0","57.3","27.34"
"65","000","00","002","0209","0684","842","426","416","46","888","1513","0","58.69","28.16"
"65","000","00","002","0210","0000","3141","1476","1665","128","3269","8503","0","38.45","17.36"
"65","000","00","002","0210","0685","786","412","374","41","827","4433","0","18.66","9.29"
"65","000","00","002","0210","0686","720","339","381","33","753","1283","0","58.69","26.42"
"65","000","00","002","0210","0687","840","385","455","34","874","1430","0","61.12","26.92"
"65","000","00","002","0210","0688","795","340","455","20","815","1357","0","60.06","25.06"
"65","000","00","002","0211","0000","1054","552","502","52","1106","1846","0","59.91","29.9"
"65","000","00","002","0211","0689","552","290","262","23","575","963","0","59.71","30.11"
"65","000","00","002","0211","0690","502","262","240","29","531","883","0","60.14","29.67"
"65","000","00","002","0212","0000","1699","804","895","116","1815","3110","0","58.36","25.85"
"65","000","00","002","0212","0691","806","382","424","58","864","1494","0","57.83","25.57"
"65","000","00","002","0212","0692","893","422","471","58","951","1616","0","58.85","26.11"
"65","000","00","002","0213","0000","2251","1105","1146","145","2396","3998","0","59.93","27.64"
"65","000","00","002","0213","0693","706","374","332","54","760","1329","0","57.19","28.14"
"65","000","00","002","0213","0694","767","354","413","45","812","1289","0","62.99","27.46"
"65","000","00","002","0213","0695","778","377","401","46","824","1380","0","59.71","27.32"
"65","000","00","002","0214","0000","3241","1567","1674","159","3400","5679","0","59.87","27.59"
"65","000","00","002","0214","0696","934","447","487","31","965","1668","0","57.85","26.8"
"65","000","00","002","0214","0697","730","342","388","42","772","1226","0","62.97","27.9"
"65","000","00","002","0214","0698","820","422","398","40","860","1421","0","60.52","29.7"
"65","000","00","002","0214","0699","757","356","401","46","803","1364","0","58.87","26.1"
"65","000","00","002","0215","0000","2149","1082","1067","134","2283","3736","0","61.11","28.96"
"65","000","00","002","0215","0700","710","352","358","34","744","1232","0","60.39","28.57"
"65","000","00","002","0215","0701","732","371","361","50","782","1248","0","62.66","29.73"
"65","000","00","002","0215","0702","707","359","348","50","757","1256","0","60.27","28.58"
"65","000","00","002","0216","0000","1819","947","872","101","1920","3175","0","60.47","29.83"
"65","000","00","002","0216","0703","884","476","408","49","933","1506","0","61.95","31.61"
"65","000","00","002","0216","0704","935","471","464","52","987","1669","0","59.14","28.22"
"65","000","00","002","0217","0000","3104","1626","1478","215","3319","5489","0","60.47","29.62"
"65","000","00","002","0217","0705","716","363","353","55","771","1308","0","58.94","27.75"
"65","000","00","002","0217","0706","790","405","385","43","833","1263","0","65.95","32.07"
"65","000","00","002","0217","0707","788","424","364","50","838","1471","0","56.97","28.82"
"65","000","00","002","0217","0708","810","434","376","67","877","1447","0","60.61","29.99"
"65","000","00","002","0218","0000","2774","1367","1407","120","2894","5520","0","52.43","24.76"
"65","000","00","002","0218","0709","809","429","380","30","839","1693","0","49.56","25.34"
"65","000","00","002","0218","0710","1057","516","541","43","1100","2015","0","54.59","25.61"
"65","000","00","002","0218","0711","908","422","486","47","955","1812","0","52.7","23.29"
"65","000","00","002","0219","0000","1586","797","789","79","1665","2948","0","56.48","27.04"
"65","000","00","002","0219","0712","789","399","390","31","820","1509","0","54.34","26.44"
"65","000","00","002","0219","0713","797","398","399","48","845","1439","0","58.72","27.66"
"65","000","00","002","0220","0000","3597","1794","1803","155","3752","6530","0","57.46","27.47"
"65","000","00","002","0220","0714","790","399","391","42","832","1437","0","57.9","27.77"
"65","000","00","002","0220","0715","862","388","474","57","919","1697","0","54.15","22.86"
"65","000","00","002","0220","0716","998","541","457","31","1029","1793","0","57.39","30.17"
"65","000","00","002","0220","0717","947","466","481","25","972","1603","0","60.64","29.07"
"65","000","00","002","0221","0000","1260","593","667","49","1309","2292","0","57.11","25.87"
"65","000","00","002","0221","0718","616","305","311","26","642","1166","0","55.06","26.16"
"65","000","00","002","0221","0719","644","288","356","23","667","1126","0","59.24","25.58"
"65","000","00","002","0222","0000","621","307","314","34","655","1291","0","50.74","23.78"
"65","000","00","002","0222","0720","621","307","314","34","655","1291","0","50.74","23.78"
"65","000","00","002","0223","0000","851","402","449","56","907","1597","0","56.79","25.17"
"65","000","00","002","0223","0721","851","402","449","56","907","1597","0","56.79","25.17"
"65","000","00","002","0224","0000","1180","540","640","75","1255","1992","0","63.0","27.11"
"65","000","00","002","0224","0722","624","300","324","41","665","1081","0","61.52","27.75"
"65","000","00","002","0224","0723","556","240","316","34","590","911","0","64.76","26.34"
"65","000","00","002","0225","0000","830","395","435","33","863","1719","0","50.2","22.98"
"65","000","00","002","0225","0724","830","395","435","33","863","1719","0","50.2","22.98"
"65","000","00","002","0226","0000","682","351","331","46","728","1289","0","56.48","27.23"
"65","000","00","002","0226","0725","682","351","331","46","728","1289","0","56.48","27.23"
"65","000","00","002","0227","0000","749","383","366","54","803","1318","0","60.93","29.06"
"65","000","00","002","0227","0726","749","383","366","54","803","1318","0","60.93","29.06"
"65","000","00","002","0228","0000","919","446","473","45","964","1822","0","52.91","24.48"
"65","000","00","002","0228","0727","919","446","473","45","964","1822","0","52.91","24.48"
"65","000","00","002","0229","0000","630","310","320","65","695","1185","0","58.65","26.16"
"65","000","00","002","0229","0728","630","310","320","65","695","1185","0","58.65","26.16"
"65","000","00","002","0230","0000","663","341","322","59","722","1369","0","52.74","24.91"
"65","000","00","002","0230","0729","663","341","322","59","722","1369","0","52.74","24.91"
"65","000","00","002","0231","0000","811","402","409","54","865","1507","0","57.4","26.68"
"65","000","00","002","0231","0730","811","402","409","54","865","1507","0","57.4","26.68"
"65","000","00","002","0232","0000","1027","555","472","59","1086","1876","0","57.89","29.58"
"65","000","00","002","0232","0731","519","263","256","39","558","926","0","60.26","28.4"
"65","000","00","002","0232","0732","508","292","216","20","528","950","0","55.58","30.74"
"65","000","00","002","0233","0000","830","419","411","58","888","1678","0","52.92","24.97"
"65","000","00","002","0233","0733","830","419","411","58","888","1678","0","52.92","24.97"
"65","000","00","002","0234","0000","580","312","268","58","638","1117","0","57.12","27.93"
"65","000","00","002","0234","0734","580","312","268","58","638","1117","0","57.12","27.93"
"65","000","00","002","0235","0000","651","314","337","53","704","1318","0","53.41","23.82"
"65","000","00","002","0235","0735","651","314","337","53","704","1318","0","53.41","23.82"
"65","000","00","002","0236","0000","767","397","370","31","798","1388","0","57.49","28.6"
"65","000","00","002","0236","0736","767","397","370","31","798","1388","0","57.49","28.6"
"65","000","00","002","0237","0000","561","282","279","42","603","1026","0","58.77","27.49"
"65","000","00","002","0237","0737","561","282","279","42","603","1026","0","58.77","27.49"
"65","000","00","002","0238","0000","1194","554","640","62","1256","2063","0","60.88","26.85"
"65","000","00","002","0238","0738","649","305","344","36","685","1096","0","62.5","27.83"
"65","000","00","002","0238","0739","545","249","296","26","571","967","0","59.05","25.75"
"65","000","00","002","0239","0000","1846","894","952","89","1935","3534","0","54.75","25.3"
"65","000","00","002","0239","0740","953","474","479","40","993","1871","0","53.07","25.33"
"65","000","00","002","0239","0741","893","420","473","49","942","1663","0","56.64","25.26"
"65","000","00","002","0240","0000","652","317","335","26","678","1208","0","56.13","26.24"
"65","000","00","002","0240","0742","652","317","335","26","678","1208","0","56.13","26.24"
"65","000","00","002","0241","0000","1295","644","651","45","1340","2476","0","54.12","26.01"
"65","000","00","002","0241","0743","720","356","364","29","749","1398","0","53.58","25.46"
"65","000","00","002","0241","0744","575","288","287","16","591","1078","0","54.82","26.72"
"65","000","00","002","0242","0000","1291","657","634","86","1377","2495","0","55.19","26.33"
"65","000","00","002","0242","0745","563","280","283","45","608","1102","0","55.17","25.41"
"65","000","00","002","0242","0746","728","377","351","41","769","1393","0","55.2","27.06"
"65","000","00","002","0243","0000","1438","708","730","93","1531","2485","0","61.61","28.49"
"65","000","00","002","0243","0747","693","331","362","49","742","1251","0","59.31","26.46"
"65","000","00","002","0243","0748","745","377","368","44","789","1234","0","63.94","30.55"
"65","000","00","002","0244","0000","1775","907","868","99","1874","3251","0","57.64","27.9"
"65","000","00","002","0244","0749","907","476","431","55","962","1661","0","57.92","28.66"
"65","000","00","002","0244","0750","868","431","437","44","912","1590","0","57.36","27.11"
"65","000","00","002","0245","0000","2163","1168","995","118","2281","3773","0","60.46","30.96"
"65","000","00","002","0245","0751","662","366","296","42","704","1182","0","59.56","30.96"
"65","000","00","002","0245","0752","782","416","366","36","818","1369","0","59.75","30.39"
"65","000","00","002","0245","0753","719","386","333","40","759","1222","0","62.11","31.59"
"65","000","00","002","0246","0000","677","373","304","66","743","1304","0","56.98","28.6"
"65","000","00","002","0246","0754","677","373","304","66","743","1304","0","56.98","28.6"
"65","000","00","002","0247","0000","528","259","269","35","563","1054","0","53.42","24.57"
"65","000","00","002","0247","0755","528","259","269","35","563","1054","0","53.42","24.57"
"65","000","00","002","0248","0000","867","430","437","53","920","1635","0","56.27","26.3"
"65","000","00","002","0248","0756","867","430","437","53","920","1635","0","56.27","26.3"
"65","000","00","002","0249","0000","884","418","466","58","942","1779","0","52.95","23.5"
"65","000","00","002","0249","0757","884","418","466","58","942","1779","0","52.95","23.5"
"65","000","00","002","0250","0000","874","441","433","62","936","1633","0","57.32","27.01"
"65","000","00","002","0250","0758","874","441","433","62","936","1633","0","57.32","27.01"
"65","000","00","002","0251","0000","1247","665","582","68","1315","2128","0","61.8","31.25"
"65","000","00","002","0251","0759","608","321","287","34","642","1107","0","57.99","29.0"
"65","000","00","002","0251","0760","639","344","295","34","673","1021","0","65.92","33.69"
"65","000","00","002","0252","0000","794","411","383","56","850","1649","0","51.55","24.92"
"65","000","00","002","0252","0761","794","411","383","56","850","1649","0","51.55","24.92"
"65","000","00","002","0253","0000","484","253","231","26","510","874","0","58.35","28.95"
"65","000","00","002","0253","0762","484","253","231","26","510","874","0","58.35","28.95"
"65","000","00","002","0254","0000","779","411","368","53","832","1402","0","59.34","29.32"
"65","000","00","002","0254","0763","779","411","368","53","832","1402","0","59.34","29.32"
"65","000","00","002","0255","0000","821","412","409","54","875","1713","0","51.08","24.05"
"65","000","00","002","0255","0764","821","412","409","54","875","1713","0","51.08","24.05"
"65","000","00","002","0256","0000","1044","574","470","69","1113","2011","0","55.35","28.54"
"65","000","00","002","0256","0765","457","254","203","35","492","973","0","50.57","26.1"
"65","000","00","002","0256","0766","587","320","267","34","621","1038","0","59.83","30.83"
"65","000","00","002","0257","0000","891","439","452","54","945","1833","0","51.55","23.95"
"65","000","00","002","0257","0767","891","439","452","54","945","1833","0","51.55","23.95"
"65","000","00","002","0258","0000","442","237","205","30","472","817","0","57.77","29.01"
"65","000","00","002","0258","0768","442","237","205","30","472","817","0","57.77","29.01"
"65","000","00","002","0259","0000","781","381","400","47","828","1387","0","59.7","27.47"
"65","000","00","002","0259","0769","781","381","400","47","828","1387","0","59.7","27.47"
"65","000","00","002","0260","0000","465","240","225","15","480","784","0","61.22","30.61"
"65","000","00","002","0260","0770","465","240","225","15","480","784","0","61.22","30.61"
"65","000","00","002","0261","0000","1236","649","587","65","1301","2259","0","57.59","28.73"
"65","000","00","002","0261","0771","589","319","270","23","612","1096","0","55.84","29.11"
"65","000","00","002","0261","0772","647","330","317","42","689","1163","0","59.24","28.37"
"65","000","00","002","0262","0000","950","472","478","35","985","1868","0","52.73","25.27"
"65","000","00","002","0262","0773","950","472","478","35","985","1868","0","52.73","25.27"
"65","000","00","002","0263","0000","1035","516","519","79","1114","2051","0","54.31","25.16"
"65","000","00","002","0263","0774","564","287","277","51","615","1117","0","55.06","25.69"
"65","000","00","002","0263","0775","471","229","242","28","499","934","0","53.43","24.52"
"65","000","00","002","0264","0000","712","362","350","41","753","1412","0","53.33","25.64"
"65","000","00","002","0264","0776","712","362","350","41","753","1412","0","53.33","25.64"
"65","000","00","002","0265","0000","642","321","321","41","683","1062","0","64.31","30.23"
"65","000","00","002","0265","0777","642","321","321","41","683","1062","0","64.31","30.23"
"65","000","00","002","0266","0000","1033","485","548","126","1159","1827","0","63.44","26.55"
"65","000","00","002","0266","0778","460","219","241","53","513","891","0","57.58","24.58"
"65","000","00","002","0266","0779","573","266","307","73","646","936","0","69.02","28.42"
"65","000","00","002","0267","0000","1100","586","514","50","1150","2150","0","53.49","27.26"
"65","000","00","002","0267","0780","567","301","266","32","599","1085","0","55.21","27.74"
"65","000","00","002","0267","0781","533","285","248","18","551","1065","0","51.74","26.76"
"65","000","00","002","0268","0000","1612","794","818","88","1700","2948","0","57.67","26.93"
"65","000","00","002","0268","0782","764","397","367","47","811","1398","0","58.01","28.4"
"65","000","00","002","0268","0783","848","397","451","41","889","1550","0","57.35","25.61"
"65","000","00","002","0269","0000","853","421","432","62","915","1674","0","54.66","25.15"
"65","000","00","002","0269","0784","853","421","432","62","915","1674","0","54.66","25.15"
"65","000","00","002","0270","0000","666","323","343","49","715","1215","0","58.85","26.58"
"65","000","00","002","0270","0785","666","323","343","49","715","1215","0","58.85","26.58"
"65","000","00","002","0271","0000","857","459","398","32","889","1606","0","55.35","28.58"
"65","000","00","002","0271","0786","857","459","398","32","889","1606","0","55.35","28.58"
"65","000","00","002","0272","0000","1329","658","671","73","1402","2420","0","57.93","27.19"
"65","000","00","002","0272","0787","645","314","331","28","673","1182","0","56.94","26.57"
"65","000","00","002","0272","0788","684","344","340","45","729","1238","0","58.89","27.79"
"65","000","00","002","0273","0000","1537","793","744","96","1633","2750","0","59.38","28.84"
"65","000","00","002","0273","0789","762","402","360","45","807","1342","0","60.13","29.96"
"65","000","00","002","0273","0790","775","391","384","51","826","1408","0","58.66","27.77"
"65","000","00","002","0274","0000","937","460","477","63","1000","1770","0","56.5","25.99"
"65","000","00","002","0274","0791","937","460","477","63","1000","1770","0","56.5","25.99"
"65","000","00","002","0275","0000","1049","583","466","52","1101","1915","0","57.49","30.44"
"65","000","00","002","0275","0792","523","317","206","32","555","940","0","59.04","33.72"
"65","000","00","002","0275","0793","526","266","260","20","546","975","0","56.0","27.28"
"65","000","00","002","0276","0000","2212","1173","1039","125","2337","4183","0","55.87","28.04"
"65","000","00","002","0276","0794","767","404","363","39","806","1507","0","53.48","26.81"
"65","000","00","002","0276","0795","766","410","356","47","813","1419","0","57.29","28.89"
"65","000","00","002","0276","0796","679","359","320","39","718","1257","0","57.12","28.56"
"65","000","00","002","0277","0000","1802","898","904","98","1900","3364","0","56.48","26.69"
"65","000","00","002","0277","0797","883","435","448","39","922","1619","0","56.95","26.87"
"65","000","00","002","0277","0798","919","463","456","59","978","1745","0","56.05","26.53"
"65","000","00","002","0278","0000","2622","1389","1233","136","2758","4898","0","56.31","28.36"
"65","000","00","002","0278","0799","818","454","364","45","863","1519","0","56.81","29.89"
"65","000","00","002","0278","0800","849","430","419","40","889","1682","0","52.85","25.56"
"65","000","00","002","0278","0801","955","505","450","51","1006","1697","0","59.28","29.76"
"65","000","00","002","0279","0000","1031","530","501","70","1101","1997","0","55.13","26.54"
"65","000","00","002","0279","0802","549","287","262","40","589","1073","0","54.89","26.75"
"65","000","00","002","0279","0803","482","243","239","30","512","924","0","55.41","26.3"
"65","000","00","002","0280","0000","781","383","398","32","813","1613","0","50.4","23.74"
"65","000","00","002","0280","0804","781","383","398","32","813","1613","0","50.4","23.74"
"65","000","00","002","0281","0000","1046","544","502","86","1132","2152","0","52.6","25.28"
"65","000","00","002","0281","0805","433","233","200","41","474","1034","0","45.84","22.53"
"65","000","00","002","0281","0806","613","311","302","45","658","1118","0","58.86","27.82"
"65","000","00","002","0282","0000","1928","1048","880","123","2051","3595","0","57.05","29.15"
"65","000","00","002","0282","0807","687","385","302","43","730","1269","0","57.53","30.34"
"65","000","00","002","0282","0808","528","265","263","28","556","990","0","56.16","26.77"
"65","000","00","002","0282","0809","713","398","315","52","765","1336","0","57.26","29.79"
"65","000","00","002","0283","0000","1794","849","945","74","1868","3182","0","58.71","26.68"
"65","000","00","002","0283","0810","867","403","464","37","904","1601","0","56.46","25.17"
"65","000","00","002","0283","0811","927","446","481","37","964","1581","0","60.97","28.21"
"65","000","00","002","0284","0000","1457","772","685","80","1537","2571","0","59.78","30.03"
"65","000","00","002","0284","0812","747","434","313","30","777","1345","0","57.77","32.27"
"65","000","00","002","0284","0813","710","338","372","50","760","1226","0","61.99","27.57"
"65","000","00","002","0285","0000","1423","679","744","101","1524","2790","0","54.62","24.34"
"65","000","00","002","0285","0814","808","388","420","60","868","1650","0","52.61","23.52"
"65","000","00","002","0285","0815","615","291","324","41","656","1140","0","57.54","25.53"
"65","000","00","002","0286","0000","1733","873","860","76","1809","3338","0","54.19","26.15"
"65","000","00","002","0286","0816","819","418","401","30","849","1639","0","51.8","25.5"
"65","000","00","002","0286","0817","914","455","459","46","960","1699","0","56.5","26.78"
"65","000","00","002","0287","0000","2276","1152","1124","123","2399","4355","0","55.09","26.45"
"65","000","00","002","0287","0820","804","388","416","46","850","1540","0","55.19","25.19"
"65","000","00","002","0287","0821","681","360","321","37","718","1276","0","56.27","28.21"
"65","000","00","002","0287","0822","791","404","387","40","831","1539","0","54.0","26.25"
"65","000","00","002","0288","0000","1567","817","750","70","1637","2898","0","56.49","28.19"
"65","000","00","002","0288","0828","765","390","375","36","801","1407","0","56.93","27.72"
"65","000","00","002","0288","0829","802","427","375","34","836","1491","0","56.07","28.64"
"65","000","00","002","0289","0000","2571","1390","1181","124","2695","4718","0","57.12","29.46"
"65","000","00","002","0289","0837","784","444","340","42","826","1398","0","59.08","31.76"
"65","000","00","002","0289","0838","895","503","392","37","932","1706","0","54.63","29.48"
"65","000","00","002","0289","0839","892","443","449","45","937","1614","0","58.05","27.45"
"65","000","00","002","0290","0000","2545","1410","1135","174","2719","4723","0","57.57","29.85"
"65","000","00","002","0290","0840","864","472","392","58","922","1591","0","57.95","29.67"
"65","000","00","002","0290","0841","864","500","364","58","922","1627","0","56.67","30.73"
"65","000","00","002","0290","0842","817","438","379","58","875","1505","0","58.14","29.1"
"65","000","00","002","0291","0000","1890","926","964","31","1921","3577","0","53.7","25.89"
"65","000","00","002","0291","0832","996","463","533","1","997","1938","0","51.44","23.89"
"65","000","00","002","0291","0833","894","463","431","30","924","1639","0","56.38","28.25"
"65","000","00","002","0292","0000","1273","714","559","72","1345","2290","0","58.73","31.18"
"65","000","00","002","0292","0823","671","375","296","34","705","1170","0","60.26","32.05"
"65","000","00","002","0292","0824","602","339","263","38","640","1120","0","57.14","30.27"
"65","000","00","002","0293","0000","3675","1802","1873","171","3846","7372","0","52.17","24.44"
"65","000","00","002","0293","0846","965","496","469","65","1030","1800","0","57.22","27.56"
"65","000","00","002","0293","0847","812","393","419","30","842","1703","0","49.44","23.08"
"65","000","00","002","0293","0848","948","454","494","38","986","1975","0","49.92","22.99"
"65","000","00","002","0293","0849","950","459","491","38","988","1894","0","52.16","24.23"
"65","000","00","002","0294","0000","2208","1052","1156","108","2316","3957","0","58.53","26.59"
"65","000","00","002","0294","0850","786","388","398","41","827","1405","0","58.86","27.62"
"65","000","00","002","0294","0851","729","364","365","26","755","1293","0","58.39","28.15"
"65","000","00","002","0294","0852","693","300","393","41","734","1259","0","58.3","23.83"
"65","000","00","002","0295","0000","2123","1120","1003","114","2237","3711","0","60.28","30.18"
"65","000","00","002","0295","0853","672","366","306","40","712","1144","0","62.24","31.99"
"65","000","00","002","0295","0854","723","388","335","46","769","1254","0","61.32","30.94"
"65","000","00","002","0295","0855","728","366","362","28","756","1313","0","57.58","27.88"
"65","000","00","002","0296","0000","1767","914","853","89","1856","3369","0","55.09","27.13"
"65","000","00","002","0296","0856","809","440","369","61","870","1594","0","54.58","27.6"
"65","000","00","002","0296","0857","958","474","484","28","986","1775","0","55.55","26.7"
"65","000","00","002","0297","0000","1662","925","737","125","1787","2831","0","63.12","32.67"
"65","000","00","002","0297","0858","802","422","380","58","860","1516","0","56.73","27.84"
"65","000","00","002","0297","0859","860","503","357","67","927","1315","0","70.49","38.25"
"65","000","00","002","0298","0000","1048","563","485","83","1131","2003","0","56.47","28.11"
"65","000","00","002","0298","0860","480","267","213","40","520","843","0","61.68","31.67"
"65","000","00","002","0298","0861","568","296","272","43","611","1160","0","52.67","25.52"
"65","000","00","002","0299","0000","1196","642","554","93","1289","2106","0","61.21","30.48"
"65","000","00","002","0299","0862","572","287","285","50","622","1052","0","59.13","27.28"
"65","000","00","002","0299","0863","624","355","269","43","667","1054","0","63.28","33.68"
"65","000","00","002","02A0","0000","1022","574","448","80","1102","1933","0","57.01","29.69"
"65","000","00","002","02A0","0864","538","299","239","53","591","997","0","59.28","29.99"
"65","000","00","002","02A0","0865","484","275","209","27","511","936","0","54.59","29.38"
"65","000","00","002","02A1","0000","1630","851","779","96","1726","3154","0","54.72","26.98"
"65","000","00","002","02A1","0866","859","450","409","49","908","1658","0","54.76","27.14"
"65","000","00","002","02A1","0867","771","401","370","47","818","1496","0","54.68","26.8"
"65","000","00","002","02A2","0000","1290","668","622","75","1365","2216","0","61.6","30.14"
"65","000","00","002","02A2","0868","625","331","294","36","661","1064","0","62.12","31.11"
"65","000","00","002","02A2","0869","665","337","328","39","704","1152","0","61.11","29.25"
"65","000","00","002","02A3","0000","2158","1077","1081","112","2270","4173","0","54.4","25.81"
"65","000","00","002","02A3","0870","787","361","426","37","824","1532","0","53.79","23.56"
"65","000","00","002","02A3","0871","644","335","309","35","679","1338","0","50.75","25.04"
"65","000","00","002","02A3","0872","727","381","346","40","767","1303","0","58.86","29.24"
"65","000","00","002","02A4","0000","2309","1155","1154","116","2425","4610","0","52.6","25.05"
"65","000","00","002","02A4","0880","717","346","371","30","747","1381","0","54.09","25.05"
"65","000","00","002","02A4","0881","797","404","393","62","859","1681","0","51.1","24.03"
"65","000","00","002","02A4","0882","795","405","390","24","819","1548","0","52.91","26.16"
"65","000","00","002","02A5","0000","2817","1321","1496","158","2975","5569","0","53.42","23.72"
"65","000","00","002","02A5","0875","869","436","433","79","948","1821","0","52.06","23.94"
"65","000","00","002","02A5","0876","935","403","532","38","973","1906","0","51.05","21.14"
"65","000","00","002","02A5","0877","1013","482","531","41","1054","1842","0","57.22","26.17"
"65","000","00","002","02A6","0000","1558","747","811","112","1670","2860","0","58.39","26.12"
"65","000","00","002","02A6","0873","762","358","404","60","822","1369","0","60.04","26.15"
"65","000","00","002","02A6","0874","796","389","407","52","848","1491","0","56.87","26.09"
"65","000","00","002","02A7","0000","1039","545","494","62","1101","1841","0","59.8","29.6"
"65","000","00","002","02A7","0878","457","231","226","26","483","878","0","55.01","26.31"
"65","000","00","002","02A7","0879","582","314","268","36","618","963","0","64.17","32.61"
"65","000","00","002","02A8","0000","3632","1657","1975","137","3769","6784","0","55.56","24.43"
"65","000","00","002","02A8","0883","852","445","407","42","894","1542","0","57.98","28.86"
"65","000","00","002","02A8","0884","822","397","425","44","866","1557","0","55.62","25.5"
"65","000","00","002","02A8","0885","872","364","508","31","903","1661","0","54.36","21.91"
"65","000","00","002","02A8","0886","1086","451","635","20","1106","2024","0","54.64","22.28"
"65","000","00","002","02A9","0000","926","495","431","39","965","1585","0","60.88","31.23"
"65","000","00","002","02A9","0669","427","226","201","15","442","764","0","57.85","29.58"
"65","000","00","002","02A9","0670","499","269","230","24","523","821","0","63.7","32.76"
"65","000","00","002","02B0","0000","2320","1167","1153","170","2490","4172","0","59.68","27.97"
"65","000","00","002","02B0","0662","768","418","350","58","826","1392","0","59.34","30.03"
"65","000","00","002","02B0","0663","820","344","476","59","879","1451","0","60.58","23.71"
"65","000","00","002","02B0","0664","732","405","327","53","785","1329","0","59.07","30.47"
"65","000","00","002","02B1","0000","1890","895","995","59","1949","3540","0","55.06","25.28"
"65","000","00","002","02B1","0681","890","405","485","33","923","1727","0","53.45","23.45"
"65","000","00","002","02B1","0682","1000","490","510","26","1026","1813","0","56.59","27.03"
"65","000","00","002","02B2","0000","1463","751","712","77","1540","2603","0","59.16","28.85"
"65","000","00","002","02B2","0830","788","397","391","33","821","1381","0","59.45","28.75"
"65","000","00","002","02B2","0831","675","354","321","44","719","1222","0","58.84","28.97"
"65","000","00","002","02B3","0000","2711","1396","1315","148","2859","5130","0","55.73","27.21"
"65","000","00","002","02B3","0825","964","478","486","56","1020","1789","0","57.02","26.72"
"65","000","00","002","02B3","0826","769","396","373","51","820","1520","0","53.95","26.05"
"65","000","00","002","02B3","0827","978","522","456","41","1019","1821","0","55.96","28.67"
"65","000","00","002","02B4","0000","2378","1247","1131","90","2468","4507","0","54.76","27.67"
"65","000","00","002","02B4","0843","746","424","322","35","781","1331","0","58.68","31.86"
"65","000","00","002","02B4","0844","805","389","416","33","838","1678","0","49.94","23.18"
"65","000","00","002","02B4","0845","827","434","393","22","849","1498","0","56.68","28.97"
"65","000","00","002","02B5","0000","2630","1303","1327","142","2772","5076","0","54.61","25.67"
"65","000","00","002","02B5","0834","864","434","430","51","915","1614","0","56.69","26.89"
"65","000","00","002","02B5","0835","889","434","455","50","939","1709","0","54.94","25.39"
"65","000","00","002","02B5","0836","877","435","442","41","918","1753","0","52.37","24.81"
"65","000","00","002","02B6","0000","1787","907","880","80","1867","3039","0","61.43","29.85"
"65","000","00","002","02B6","0818","945","474","471","49","994","1501","0","66.22","31.58"
"65","000","00","002","02B6","0819","842","433","409","31","873","1538","0","56.76","28.15"
"65","000","00","002","02B7","0000","1635","834","801","108","1743","3294","0","52.91","25.32"
"65","000","00","002","02B7","0887","761","391","370","42","803","1588","0","50.57","24.62"
"65","000","00","002","02B7","0888","874","443","431","66","940","1706","0","55.1","25.97"
"65","000","00","002","02B8","0000","2023","1034","989","116","2139","3705","0","57.73","27.91"
"65","000","00","002","02B8","0889","759","379","380","30","789","1341","0","58.84","28.26"
"65","000","00","002","02B8","0890","550","309","241","34","584","1025","0","56.98","30.15"
"65","000","00","002","02B8","0891","714","346","368","52","766","1339","0","57.21","25.84"
"65","000","00","002","02B9","0000","1860","936","924","112","1972","3551","0","55.53","26.36"
"65","000","00","002","02B9","0892","911","457","454","58","969","1725","0","56.17","26.49"
"65","000","00","002","02B9","0893","949","479","470","54","1003","1826","0","54.93","26.23"
"65","000","00","003","0000","0000","190949","78167","112782","8680","199629","355978","412545","56.08","21.96"
"65","000","00","003","0301","0000","2703","1205","1498","99","2802","5249","0","53.38","22.96"
"65","000","00","003","0301","1232","819","388","431","32","851","1630","0","52.21","23.8"
"65","000","00","003","0301","1233","959","433","526","39","998","1775","0","56.23","24.39"
"65","000","00","003","0301","1234","925","384","541","28","953","1844","0","51.68","20.82"
"65","000","00","003","0302","0000","4416","1747","2669","197","4613","8034","0","57.42","21.75"
"65","000","00","003","0302","1282","913","415","498","51","964","1788","0","53.91","23.21"
"65","000","00","003","0302","1283","974","401","573","39","1013","1793","0","56.5","22.36"
"65","000","00","003","0302","1284","739","293","446","45","784","1352","0","57.99","21.67"
"65","000","00","003","0302","1285","993","361","632","37","1030","1813","0","56.81","19.91"
"65","000","00","003","0302","1286","797","277","520","25","822","1288","0","63.82","21.51"
"65","000","00","003","0303","0000","2041","953","1088","100","2141","3829","0","55.92","24.89"
"65","000","00","003","0303","1287","652","288","364","33","685","1186","0","57.76","24.28"
"65","000","00","003","0303","1288","639","315","324","10","649","1237","0","52.47","25.46"
"65","000","00","003","0303","1289","750","350","400","57","807","1406","0","57.4","24.89"
"65","000","00","003","0304","0000","2144","955","1189","112","2256","3774","0","59.78","25.3"
"65","000","00","003","0304","1290","772","318","454","39","811","1442","0","56.24","22.05"
"65","000","00","003","0304","1291","630","307","323","27","657","1040","0","63.17","29.52"
"65","000","00","003","0304","1292","742","330","412","46","788","1292","0","60.99","25.54"
"65","000","00","003","0305","0000","1906","870","1036","125","2031","3600","0","56.42","24.17"
"65","000","00","003","0305","1293","943","429","514","48","991","1811","0","54.72","23.69"
"65","000","00","003","0305","1294","963","441","522","77","1040","1789","0","58.13","24.65"
"65","000","00","003","0306","0000","1878","705","1173","89","1967","3177","0","61.91","22.19"
"65","000","00","003","0306","1295","532","158","374","32","564","859","0","65.66","18.39"
"65","000","00","003","0306","1296","602","200","402","23","625","972","0","64.3","20.58"
"65","000","00","003","0306","1297","744","347","397","34","778","1346","0","57.8","25.78"
"65","000","00","003","0307","0000","1286","435","851","54","1340","2157","0","62.12","20.17"
"65","000","00","003","0307","1235","618","240","378","30","648","1019","0","63.59","23.55"
"65","000","00","003","0307","1236","668","195","473","24","692","1138","0","60.81","17.14"
"65","000","00","003","0308","0000","3048","1141","1907","129","3177","5702","0","55.72","20.01"
"65","000","00","003","0308","1237","951","344","607","34","985","1878","0","52.45","18.32"
"65","000","00","003","0308","1238","1095","328","767","39","1134","1980","0","57.27","16.57"
"65","000","00","003","0308","1239","1002","469","533","56","1058","1844","0","57.38","25.43"
"65","000","00","003","0309","0000","2867","1146","1721","99","2966","5344","0","55.5","21.44"
"65","000","00","003","0309","1240","1128","470","658","33","1161","2085","0","55.68","22.54"
"65","000","00","003","0309","1241","798","289","509","35","833","1498","0","55.61","19.29"
"65","000","00","003","0309","1242","941","387","554","31","972","1761","0","55.2","21.98"
"65","000","00","003","0310","0000","1821","752","1069","60","1881","3294","0","57.1","22.83"
"65","000","00","003","0310","1248","924","403","521","37","961","1712","0","56.13","23.54"
"65","000","00","003","0310","1249","897","349","548","23","920","1582","0","58.15","22.06"
"65","000","00","003","0311","0000","1826","786","1040","66","1892","3235","0","58.49","24.3"
"65","000","00","003","0311","1250","928","410","518","36","964","1742","0","55.34","23.54"
"65","000","00","003","0311","1251","898","376","522","30","928","1493","0","62.16","25.18"
"65","000","00","003","0312","0000","2177","948","1229","126","2303","3990","0","57.72","23.76"
"65","000","00","003","0312","1252","699","328","371","41","740","1352","0","54.73","24.26"
"65","000","00","003","0312","1253","705","293","412","33","738","1244","0","59.32","23.55"
"65","000","00","003","0312","1254","773","327","446","52","825","1394","0","59.18","23.46"
"65","000","00","003","0313","0000","1775","771","1004","72","1847","3747","0","49.29","20.58"
"65","000","00","003","0313","1255","844","342","502","31","875","1917","0","45.64","17.84"
"65","000","00","003","0313","1256","931","429","502","41","972","1830","0","53.11","23.44"
"65","000","00","003","0314","0000","2050","922","1128","106","2156","3892","0","55.4","23.69"
"65","000","00","003","0314","1257","626","279","347","39","665","1124","0","59.16","24.82"
"65","000","00","003","0314","1258","688","303","385","40","728","1412","0","51.56","21.46"
"65","000","00","003","0314","1259","736","340","396","27","763","1356","0","56.27","25.07"
"65","000","00","003","0315","0000","2120","921","1199","129","2249","3940","0","57.08","23.38"
"65","000","00","003","0315","1260","719","272","447","33","752","1425","0","52.77","19.09"
"65","000","00","003","0315","1261","709","312","397","50","759","1259","0","60.29","24.78"
"65","000","00","003","0315","1262","692","337","355","46","738","1256","0","58.76","26.83"
"65","000","00","003","0316","0000","2385","1060","1325","113","2498","4502","0","55.49","23.55"
"65","000","00","003","0316","1263","782","343","439","30","812","1423","0","57.06","24.1"
"65","000","00","003","0316","1264","685","299","386","35","720","1221","0","58.97","24.49"
"65","000","00","003","0316","1265","918","418","500","48","966","1858","0","51.99","22.5"
"65","000","00","003","0317","0000","2656","1144","1512","106","2762","4958","0","55.71","23.07"
"65","000","00","003","0317","1266","911","405","506","38","949","1804","0","52.61","22.45"
"65","000","00","003","0317","1267","937","375","562","34","971","1669","0","58.18","22.47"
"65","000","00","003","0317","1268","808","364","444","34","842","1485","0","56.7","24.51"
"65","000","00","003","0318","0000","1959","866","1093","104","2063","3351","0","61.56","25.84"
"65","000","00","003","0318","1269","578","247","331","32","610","1005","0","60.7","24.58"
"65","000","00","003","0318","1270","719","338","381","40","759","1175","0","64.6","28.77"
"65","000","00","003","0318","1271","662","281","381","32","694","1171","0","59.27","24.0"
"65","000","00","003","0319","0000","2241","963","1278","77","2318","4413","0","52.53","21.82"
"65","000","00","003","0319","1272","864","346","518","29","893","1746","0","51.15","19.82"
"65","000","00","003","0319","1273","761","342","419","20","781","1555","0","50.23","21.99"
"65","000","00","003","0319","1274","616","275","341","28","644","1112","0","57.91","24.73"
"65","000","00","003","0320","0000","1709","634","1075","58","1767","3286","0","53.77","19.29"
"65","000","00","003","0320","1434","768","312","456","27","795","1462","0","54.38","21.34"
"65","000","00","003","0320","1435","941","322","619","31","972","1824","0","53.29","17.65"
"65","000","00","003","0321","0000","1552","603","949","81","1633","2823","0","57.85","21.36"
"65","000","00","003","0321","1436","737","310","427","41","778","1389","0","56.01","22.32"
"65","000","00","003","0321","1437","815","293","522","40","855","1434","0","59.62","20.43"
"65","000","00","003","0322","0000","2888","1001","1887","93","2981","5350","0","55.72","18.71"
"65","000","00","003","0322","1440","977","329","648","29","1006","1858","0","54.14","17.71"
"65","000","00","003","0322","1441","971","349","622","24","995","1801","0","55.25","19.38"
"65","000","00","003","0322","1442","940","323","617","40","980","1691","0","57.95","19.1"
"65","000","00","003","0323","0000","2373","840","1533","82","2455","3948","0","62.18","21.28"
"65","000","00","003","0323","1443","781","280","501","34","815","1363","0","59.79","20.54"
"65","000","00","003","0323","1444","751","270","481","26","777","1220","0","63.69","22.13"
"65","000","00","003","0323","1445","841","290","551","22","863","1365","0","63.22","21.25"
"65","000","00","003","0324","0000","1750","698","1052","102","1852","3205","0","57.78","21.78"
"65","000","00","003","0324","1446","673","240","433","28","701","1178","0","59.51","20.37"
"65","000","00","003","0324","1447","486","202","284","24","510","830","0","61.45","24.34"
"65","000","00","003","0324","1448","591","256","335","50","641","1197","0","53.55","21.39"
"65","000","00","003","0325","0000","3781","1444","2337","135","3916","7168","0","54.63","20.15"
"65","000","00","003","0325","1275","1019","410","609","39","1058","1780","0","59.44","23.03"
"65","000","00","003","0325","1276","1031","389","642","43","1074","1918","0","56.0","20.28"
"65","000","00","003","0325","1277","747","261","486","23","770","1689","0","45.59","15.45"
"65","000","00","003","0325","1278","984","384","600","30","1014","1781","0","56.93","21.56"
"65","000","00","003","0326","0000","2569","979","1590","115","2684","4567","0","58.77","21.44"
"65","000","00","003","0326","1279","779","305","474","38","817","1419","0","57.58","21.49"
"65","000","00","003","0326","1280","707","301","406","32","739","1344","0","54.99","22.4"
"65","000","00","003","0326","1281","1083","373","710","45","1128","1804","0","62.53","20.68"
"65","000","00","003","0327","0000","2358","877","1481","121","2479","4082","0","60.73","21.48"
"65","000","00","003","0327","1449","764","293","471","45","809","1369","0","59.09","21.4"
"65","000","00","003","0327","1450","770","301","469","31","801","1336","0","59.96","22.53"
"65","000","00","003","0327","1451","824","283","541","45","869","1377","0","63.11","20.55"
"65","000","00","003","0328","0000","1820","722","1098","81","1901","3188","0","59.63","22.65"
"65","000","00","003","0328","1452","844","332","512","46","890","1499","0","59.37","22.15"
"65","000","00","003","0328","1453","976","390","586","35","1011","1689","0","59.86","23.09"
"65","000","00","003","0329","0000","2347","965","1382","114","2461","4314","0","57.05","22.37"
"65","000","00","003","0329","1456","852","363","489","57","909","1545","0","58.83","23.5"
"65","000","00","003","0329","1457","714","302","412","37","751","1326","0","56.64","22.78"
"65","000","00","003","0329","1458","781","300","481","20","801","1443","0","55.51","20.79"
"65","000","00","003","0330","0000","3209","1175","2034","110","3319","5694","0","58.29","20.64"
"65","000","00","003","0330","1459","955","351","604","20","975","1712","0","56.95","20.5"
"65","000","00","003","0330","1460","1000","357","643","53","1053","1916","0","54.96","18.63"
"65","000","00","003","0330","1461","516","211","305","25","541","863","0","62.69","24.45"
"65","000","00","003","0330","1462","738","256","482","12","750","1203","0","62.34","21.28"
"65","000","00","003","0331","0000","2279","701","1578","102","2381","4490","0","53.03","15.61"
"65","000","00","003","0331","1463","787","236","551","22","809","1483","0","54.55","15.91"
"65","000","00","003","0331","1464","807","248","559","38","845","1575","0","53.65","15.75"
"65","000","00","003","0331","1465","685","217","468","42","727","1432","0","50.77","15.15"
"65","000","00","003","0332","0000","2270","815","1455","122","2392","4073","0","58.73","20.01"
"65","000","00","003","0332","1466","763","274","489","51","814","1441","0","56.49","19.01"
"65","000","00","003","0332","1467","725","264","461","38","763","1269","0","60.13","20.8"
"65","000","00","003","0332","1468","782","277","505","33","815","1363","0","59.79","20.32"
"65","000","00","003","0333","0000","1627","624","1003","62","1689","2973","0","56.81","20.99"
"65","000","00","003","0333","1474","805","293","512","30","835","1526","0","54.72","19.2"
"65","000","00","003","0333","1475","822","331","491","32","854","1447","0","59.02","22.87"
"65","000","00","003","0334","0000","1559","566","993","71","1630","2757","0","59.12","20.53"
"65","000","00","003","0334","1305","710","256","454","36","746","1319","0","56.56","19.41"
"65","000","00","003","0334","1306","849","310","539","35","884","1438","0","61.47","21.56"
"65","000","00","003","0335","0000","3272","1159","2113","124","3396","6396","0","53.1","18.12"
"65","000","00","003","0335","1307","907","314","593","30","937","1808","0","51.83","17.37"
"65","000","00","003","0335","1308","618","180","438","14","632","1191","0","53.06","15.11"
"65","000","00","003","0335","1309","859","339","520","51","910","1632","0","55.76","20.77"
"65","000","00","003","0335","1310","888","326","562","29","917","1765","0","51.95","18.47"
"65","000","00","003","0336","0000","2249","629","1620","106","2355","3909","0","60.25","16.09"
"65","000","00","003","0336","1311","660","160","500","36","696","1168","0","59.59","13.7"
"65","000","00","003","0336","1312","645","216","429","20","665","1176","0","56.55","18.37"
"65","000","00","003","0336","1313","944","253","691","50","994","1565","0","63.51","16.17"
"65","000","00","003","0337","0000","2345","853","1492","98","2443","4512","0","54.14","18.91"
"65","000","00","003","0337","1314","775","295","480","38","813","1578","0","51.52","18.69"
"65","000","00","003","0337","1315","1076","347","729","32","1108","2029","0","54.61","17.1"
"65","000","00","003","0337","1316","494","211","283","28","522","905","0","57.68","23.31"
"65","000","00","003","0338","0000","2240","836","1404","144","2384","4293","0","55.53","19.47"
"65","000","00","003","0338","1317","412","160","252","31","443","839","0","52.8","19.07"
"65","000","00","003","0338","1318","430","160","270","15","445","762","0","58.4","21.0"
"65","000","00","003","0338","1319","747","271","476","52","799","1420","0","56.27","19.08"
"65","000","00","003","0338","1320","651","245","406","46","697","1272","0","54.8","19.26"
"65","000","00","003","0339","0000","1946","678","1268","80","2026","3755","0","53.95","18.06"
"65","000","00","003","0339","1321","1009","359","650","47","1056","1976","0","53.44","18.17"
"65","000","00","003","0339","1322","937","319","618","33","970","1779","0","54.53","17.93"
"65","000","00","003","0340","0000","1442","548","894","84","1526","2870","0","53.17","19.09"
"65","000","00","003","0340","1325","665","264","401","33","698","1369","0","50.99","19.28"
"65","000","00","003","0340","1326","777","284","493","51","828","1501","0","55.16","18.92"
"65","000","00","003","0341","0000","180","85","95","18","198","321","0","61.68","26.48"
"65","000","00","003","0341","1329","180","85","95","18","198","321","0","61.68","26.48"
"65","000","00","003","0342","0000","2364","936","1428","136","2500","4556","0","54.87","20.54"
"65","000","00","003","0342","1330","739","306","433","48","787","1474","0","53.39","20.76"
"65","000","00","003","0342","1331","789","304","485","54","843","1461","0","57.7","20.81"
"65","000","00","003","0342","1332","836","326","510","34","870","1621","0","53.67","20.11"
"65","000","00","003","0343","0000","1202","475","727","75","1277","2102","0","60.75","22.6"
"65","000","00","003","0343","1333","772","276","496","55","827","1327","0","62.32","20.8"
"65","000","00","003","0343","1334","430","199","231","20","450","775","0","58.06","25.68"
"65","000","00","003","0344","0000","2061","845","1216","85","2146","6749","0","31.8","12.52"
"65","000","00","003","0344","1337","769","317","452","36","805","4411","0","18.25","7.19"
"65","000","00","003","0344","1338","668","271","397","19","687","1212","0","56.68","22.36"
"65","000","00","003","0344","1339","624","257","367","30","654","1126","0","58.08","22.82"
"65","000","00","003","0345","0000","2234","860","1374","74","2308","4522","0","51.04","19.02"
"65","000","00","003","0345","1346","720","223","497","24","744","1627","0","45.73","13.71"
"65","000","00","003","0345","1347","778","339","439","35","813","1503","0","54.09","22.55"
"65","000","00","003","0345","1348","736","298","438","15","751","1392","0","53.95","21.41"
"65","000","00","003","0346","0000","2107","853","1254","94","2201","3898","0","56.46","21.88"
"65","000","00","003","0346","1349","604","243","361","34","638","1067","0","59.79","22.77"
"65","000","00","003","0346","1350","828","354","474","36","864","1623","0","53.23","21.81"
"65","000","00","003","0346","1351","675","256","419","24","699","1208","0","57.86","21.19"
"65","000","00","003","0347","0000","2340","880","1460","94","2434","4870","0","49.98","18.07"
"65","000","00","003","0347","1352","864","333","531","29","893","1991","0","44.85","16.73"
"65","000","00","003","0347","1353","869","323","546","41","910","1932","0","47.1","16.72"
"65","000","00","003","0347","1354","607","224","383","24","631","947","0","66.63","23.65"
"65","000","00","003","0348","0000","1672","660","1012","83","1755","3234","0","54.27","20.41"
"65","000","00","003","0348","1355","919","364","555","44","963","1660","0","58.01","21.93"
"65","000","00","003","0348","1356","753","296","457","39","792","1574","0","50.32","18.81"
"65","000","00","003","0349","0000","2551","967","1584","139","2690","5146","0","52.27","18.79"
"65","000","00","003","0349","1357","1041","350","691","43","1084","2136","0","50.75","16.39"
"65","000","00","003","0349","1358","740","299","441","50","790","1462","0","54.04","20.45"
"65","000","00","003","0349","1359","770","318","452","46","816","1548","0","52.71","20.54"
"65","000","00","003","0350","0000","2503","962","1541","136","2639","4228","0","62.42","22.75"
"65","000","00","003","0350","1360","441","172","269","18","459","692","0","66.33","24.86"
"65","000","00","003","0350","1361","727","239","488","42","769","1221","0","62.98","19.57"
"65","000","00","003","0350","1362","751","315","436","41","792","1331","0","59.5","23.67"
"65","000","00","003","0350","1363","584","236","348","35","619","984","0","62.91","23.98"
"65","000","00","003","0351","0000","1595","606","989","78","1673","3150","0","53.11","19.24"
"65","000","00","003","0351","1364","914","344","570","35","949","1871","0","50.72","18.39"
"65","000","00","003","0351","1365","681","262","419","43","724","1279","0","56.61","20.48"
"65","000","00","003","0352","0000","2661","1120","1541","114","2775","4826","0","57.5","23.21"
"65","000","00","003","0352","1366","885","375","510","42","927","1629","0","56.91","23.02"
"65","000","00","003","0352","1367","816","331","485","31","847","1482","0","57.15","22.33"
"65","000","00","003","0352","1368","960","414","546","41","1001","1715","0","58.37","24.14"
"65","000","00","003","0353","0000","1053","373","680","52","1105","1952","0","56.61","19.11"
"65","000","00","003","0353","1369","1053","373","680","52","1105","1952","0","56.61","19.11"
"65","000","00","003","0354","0000","385","205","180","23","408","686","0","59.48","29.88"
"65","000","00","003","0354","1370","385","205","180","23","408","686","0","59.48","29.88"
"65","000","00","003","0355","0000","4127","1791","2336","142","4269","7264","0","58.77","24.66"
"65","000","00","003","0355","1371","747","370","377","32","779","1577","0","49.4","23.46"
"65","000","00","003","0355","1372","653","295","358","29","682","1158","0","58.89","25.47"
"65","000","00","003","0355","1373","751","315","436","16","767","1195","0","64.18","26.36"
"65","000","00","003","0355","1374","654","243","411","22","676","1054","0","64.14","23.06"
"65","000","00","003","0355","1375","383","167","216","15","398","612","0","65.03","27.29"
"65","000","00","003","0355","1376","939","401","538","28","967","1668","0","57.97","24.04"
"65","000","00","003","0356","0000","1395","716","679","86","1481","2240","0","66.12","31.96"
"65","000","00","003","0356","1377","632","303","329","51","683","1071","0","63.77","28.29"
"65","000","00","003","0356","1378","763","413","350","35","798","1169","0","68.26","35.33"
"65","000","00","003","0357","0000","2819","1253","1566","113","2932","5558","0","52.75","22.54"
"65","000","00","003","0357","1379","745","386","359","31","776","1370","0","56.64","28.18"
"65","000","00","003","0357","1380","897","401","496","53","950","1574","0","60.36","25.48"
"65","000","00","003","0357","1381","1177","466","711","29","1206","2614","0","46.14","17.83"
"65","000","00","003","0358","0000","1435","660","775","60","1495","2518","0","59.37","26.21"
"65","000","00","003","0358","1382","852","353","499","26","878","1477","0","59.44","23.9"
"65","000","00","003","0358","1383","583","307","276","34","617","1041","0","59.27","29.49"
"65","000","00","003","0359","0000","2523","1221","1302","145","2668","4723","0","56.49","25.85"
"65","000","00","003","0359","1384","789","362","427","50","839","1538","0","54.55","23.54"
"65","000","00","003","0359","1385","844","426","418","42","886","1599","0","55.41","26.64"
"65","000","00","003","0359","1386","890","433","457","53","943","1586","0","59.46","27.3"
"65","000","00","003","0360","0000","2077","1006","1071","106","2183","3580","0","60.98","28.1"
"65","000","00","003","0360","1387","996","479","517","50","1046","1726","0","60.6","27.75"
"65","000","00","003","0360","1388","1081","527","554","56","1137","1854","0","61.33","28.43"
"65","000","00","003","0361","0000","2540","1249","1291","136","2676","4390","0","60.96","28.45"
"65","000","00","003","0361","1389","856","481","375","42","898","1472","0","61.01","32.68"
"65","000","00","003","0361","1390","825","378","447","52","877","1430","0","61.33","26.43"
"65","000","00","003","0361","1391","859","390","469","42","901","1488","0","60.55","26.21"
"65","000","00","003","0362","0000","2200","1062","1138","125","2325","4066","0","57.18","26.12"
"65","000","00","003","0362","1392","681","358","323","32","713","1251","0","56.99","28.62"
"65","000","00","003","0362","1393","832","365","467","35","867","1487","0","58.31","24.55"
"65","000","00","003","0362","1394","687","339","348","58","745","1328","0","56.1","25.53"
"65","000","00","003","0363","0000","1300","573","727","61","1361","2136","0","63.72","26.83"
"65","000","00","003","0363","1395","662","316","346","38","700","1128","0","62.06","28.01"
"65","000","00","003","0363","1396","638","257","381","23","661","1008","0","65.58","25.5"
"65","000","00","003","0364","0000","2166","945","1221","73","2239","4005","0","55.91","23.6"
"65","000","00","003","0364","1397","1006","486","520","27","1033","1786","0","57.84","27.21"
"65","000","00","003","0364","1398","1160","459","701","46","1206","2219","0","54.35","20.68"
"65","000","00","003","0365","0000","1496","720","776","55","1551","2817","0","55.06","25.56"
"65","000","00","003","0365","1399","676","319","357","36","712","1322","0","53.86","24.13"
"65","000","00","003","0365","1400","820","401","419","19","839","1495","0","56.12","26.82"
"65","000","00","003","0366","0000","2414","1367","1047","130","2544","4456","0","57.09","30.68"
"65","000","00","003","0366","1401","733","348","385","47","780","1414","0","55.16","24.61"
"65","000","00","003","0366","1402","933","666","267","49","982","1681","0","58.42","39.62"
"65","000","00","003","0366","1403","748","353","395","34","782","1361","0","57.46","25.94"
"65","000","00","003","0367","0000","2192","928","1264","93","2285","4089","0","55.88","22.7"
"65","000","00","003","0367","1404","781","344","437","33","814","1442","0","56.45","23.86"
"65","000","00","003","0367","1405","714","341","373","28","742","1383","0","53.65","24.66"
"65","000","00","003","0367","1406","697","243","454","32","729","1264","0","57.67","19.22"
"65","000","00","003","0368","0000","1908","834","1074","133","2041","3761","0","54.27","22.17"
"65","000","00","003","0368","1407","1014","448","566","79","1093","1810","0","60.39","24.75"
"65","000","00","003","0368","1408","894","386","508","54","948","1951","0","48.59","19.78"
"65","000","00","003","0369","0000","1867","813","1054","95","1962","3527","0","55.63","23.05"
"65","000","00","003","0369","1409","774","347","427","36","810","1582","0","51.2","21.93"
"65","000","00","003","0369","1410","1093","466","627","59","1152","1945","0","59.23","23.96"
"65","000","00","003","0370","0000","2186","740","1446","88","2274","3950","0","57.57","18.73"
"65","000","00","003","0370","1411","774","254","520","36","810","1390","0","58.27","18.27"
"65","000","00","003","0370","1412","656","297","359","18","674","1161","0","58.05","25.58"
"65","000","00","003","0370","1413","756","189","567","34","790","1399","0","56.47","13.51"
"65","000","00","003","0371","0000","1974","922","1052","75","2049","3453","0","59.34","26.7"
"65","000","00","003","0371","1414","596","308","288","20","616","1070","0","57.57","28.79"
"65","000","00","003","0371","1415","644","306","338","19","663","1169","0","56.72","26.18"
"65","000","00","003","0371","1416","734","308","426","36","770","1214","0","63.43","25.37"
"65","000","00","003","0372","0000","1967","714","1253","94","2061","3371","0","61.14","21.18"
"65","000","00","003","0372","1471","643","243","400","28","671","1150","0","58.35","21.13"
"65","000","00","003","0372","1472","696","253","443","31","727","1154","0","63.0","21.92"
"65","000","00","003","0372","1473","628","218","410","35","663","1067","0","62.14","20.43"
"65","000","00","003","0373","0000","3004","1134","1870","88","3092","5742","0","53.85","19.75"
"65","000","00","003","0373","1245","947","325","622","30","977","1789","0","54.61","18.17"
"65","000","00","003","0373","1246","1103","424","679","33","1136","2000","0","56.8","21.2"
"65","000","00","003","0373","1247","954","385","569","25","979","1953","0","50.13","19.71"
"65","000","00","003","0374","0000","938","352","586","37","975","1712","0","56.95","20.56"
"65","000","00","003","0374","1433","938","352","586","37","975","1712","0","56.95","20.56"
"65","000","00","003","0375","0000","2068","786","1282","109","2177","3955","0","55.04","19.87"
"65","000","00","003","0375","1438","1004","361","643","46","1050","1953","0","53.76","18.48"
"65","000","00","003","0375","1439","1064","425","639","63","1127","2002","0","56.29","21.23"
"65","000","00","003","0376","0000","1417","618","799","61","1478","2402","0","61.53","25.73"
"65","000","00","003","0376","1454","767","346","421","32","799","1323","0","60.39","26.15"
"65","000","00","003","0376","1455","650","272","378","29","679","1079","0","62.93","25.21"
"65","000","00","003","0377","0000","1412","646","766","55","1467","2260","0","64.91","28.58"
"65","000","00","003","0377","1469","811","403","408","27","838","1089","0","76.95","37.01"
"65","000","00","003","0377","1470","601","243","358","28","629","1171","0","53.71","20.75"
"65","000","00","003","0378","0000","1383","538","845","73","1456","2828","0","51.49","19.02"
"65","000","00","003","0378","1323","687","291","396","39","726","1454","0","49.93","20.01"
"65","000","00","003","0378","1324","696","247","449","34","730","1374","0","53.13","17.98"
"65","000","00","003","0379","0000","1173","461","712","83","1256","1970","0","63.76","23.4"
"65","000","00","003","0379","1327","555","223","332","48","603","920","0","65.54","24.24"
"65","000","00","003","0379","1328","618","238","380","35","653","1050","0","62.19","22.67"
"65","000","00","003","0380","0000","1884","695","1189","73","1957","3817","0","51.27","18.21"
"65","000","00","003","0380","1335","936","335","601","28","964","1916","0","50.31","17.48"
"65","000","00","003","0380","1336","948","360","588","45","993","1901","0","52.24","18.94"
"65","000","00","003","0381","0000","3259","1234","2025","126","3385","5946","0","56.93","20.75"
"65","000","00","003","0381","1340","791","302","489","26","817","1507","0","54.21","20.04"
"65","000","00","003","0381","1341","820","268","552","16","836","1519","0","55.04","17.64"
"65","000","00","003","0381","1342","806","320","486","36","842","1467","0","57.4","21.81"
"65","000","00","003","0381","1343","842","344","498","48","890","1453","0","61.25","23.68"
"65","000","00","003","0382","0000","1500","542","958","67","1567","2666","0","58.78","20.33"
"65","000","00","003","0382","1344","793","267","526","35","828","1364","0","60.7","19.57"
"65","000","00","003","0382","1345","707","275","432","32","739","1302","0","56.76","21.12"
"65","000","00","003","0383","0000","1372","612","760","61","1433","2421","0","59.19","25.28"
"65","000","00","003","0383","1298","605","289","316","23","628","1034","0","60.74","27.95"
"65","000","00","003","0383","1299","767","323","444","38","805","1387","0","58.04","23.29"
"65","000","00","003","0384","0000","1878","810","1068","109","1987","3737","0","53.17","21.68"
"65","000","00","003","0384","1300","1104","435","669","78","1182","2067","0","57.18","21.04"
"65","000","00","003","0384","1301","774","375","399","31","805","1670","0","48.2","22.46"
"65","000","00","003","0385","0000","2161","920","1241","99","2260","3771","0","59.93","24.4"
"65","000","00","003","0385","1417","769","321","448","49","818","1398","0","58.51","22.96"
"65","000","00","003","0385","1418","596","256","340","21","617","1049","0","58.82","24.4"
"65","000","00","003","0385","1419","796","343","453","29","825","1324","0","62.31","25.91"
"65","000","00","003","0386","0000","1705","724","981","58","1763","3474","0","50.75","20.84"
"65","000","00","003","0386","1420","842","375","467","27","869","1765","0","49.24","21.25"
"65","000","00","003","0386","1421","863","349","514","31","894","1709","0","52.31","20.42"
"65","000","00","003","0387","0000","1404","651","753","91","1495","2504","0","59.7","26.0"
"65","000","00","003","0387","1422","647","302","345","51","698","1186","0","58.85","25.46"
"65","000","00","003","0387","1423","757","349","408","40","797","1318","0","60.47","26.48"
"65","000","00","003","0388","0000","1514","720","794","63","1577","3067","0","51.42","23.48"
"65","000","00","003","0388","1424","803","370","433","37","840","1430","0","58.74","25.87"
"65","000","00","003","0388","1425","711","350","361","26","737","1637","0","45.02","21.38"
"65","000","00","003","0389","0000","2141","1000","1141","120","2261","3894","0","58.06","25.68"
"65","000","00","003","0389","1426","700","324","376","37","737","1283","0","57.44","25.25"
"65","000","00","003","0389","1427","721","338","383","39","760","1310","0","58.02","25.8"
"65","000","00","003","0389","1428","720","338","382","44","764","1301","0","58.72","25.98"
"65","000","00","003","0390","0000","1744","815","929","60","1804","3065","0","58.86","26.59"
"65","000","00","003","0390","1429","936","454","482","42","978","1681","0","58.18","27.01"
"65","000","00","003","0390","1430","808","361","447","18","826","1384","0","59.68","26.08"
"65","000","00","003","0391","0000","1451","676","775","38","1489","2966","0","50.2","22.79"
"65","000","00","003","0391","1431","650","326","324","33","683","1187","0","57.54","27.46"
"65","000","00","003","0391","1432","801","350","451","5","806","1779","0","45.31","19.67"
"65","000","00","003","0392","0000","1722","661","1061","95","1817","3199","0","56.8","20.66"
"65","000","00","003","0392","1302","631","251","380","35","666","1166","0","57.12","21.53"
"65","000","00","003","0392","1303","545","224","321","29","574","963","0","59.61","23.26"
"65","000","00","003","0392","1304","546","186","360","31","577","1070","0","53.93","17.38"
"65","000","00","003","0393","0000","1441","594","847","55","1496","2597","0","57.6","22.87"
"65","000","00","003","0393","1243","681","332","349","26","707","1254","0","56.38","26.48"
"65","000","00","003","0393","1244","760","262","498","29","789","1343","0","58.75","19.51"
"65","000","00","004","0000","0000","107032","40769","66263","4634","111666","187798","221123","59.46","21.71"
"65","000","00","004","0401","0000","1543","666","877","76","1619","3012","0","53.75","22.11"
"65","000","00","004","0401","1486","772","357","415","42","814","1568","0","51.91","22.77"
"65","000","00","004","0401","1487","771","309","462","34","805","1444","0","55.75","21.4"
"65","000","00","004","0402","0000","1438","536","902","64","1502","2535","0","59.25","21.14"
"65","000","00","004","0402","1601","711","242","469","28","739","1189","0","62.15","20.35"
"65","000","00","004","0402","1602","727","294","433","36","763","1346","0","56.69","21.84"
"65","000","00","004","0403","0000","1696","620","1076","71","1767","4440","0","39.8","13.96"
"65","000","00","004","0403","1495","836","302","534","42","878","1598","0","54.94","18.9"
"65","000","00","004","0403","1496","860","318","542","29","889","2842","0","31.28","11.19"
"65","000","00","004","0404","0000","1654","619","1035","70","1724","2710","0","63.62","22.84"
"65","000","00","004","0404","1497","754","288","466","40","794","1261","0","62.97","22.84"
"65","000","00","004","0404","1498","900","331","569","30","930","1449","0","64.18","22.84"
"65","000","00","004","0405","0000","1463","580","883","61","1524","2418","0","63.03","23.99"
"65","000","00","004","0405","1599","709","275","434","29","738","1155","0","63.9","23.81"
"65","000","00","004","0405","1600","754","305","449","32","786","1263","0","62.23","24.15"
"65","000","00","004","0406","0000","1749","710","1039","48","1797","3034","0","59.23","23.4"
"65","000","00","004","0406","1505","891","336","555","20","911","1566","0","58.17","21.46"
"65","000","00","004","0406","1506","858","374","484","28","886","1468","0","60.35","25.48"
"65","000","00","004","0407","0000","1556","611","945","54","1610","2486","0","64.76","24.58"
"65","000","00","004","0407","1507","844","324","520","27","871","1305","0","66.74","24.83"
"65","000","00","004","0407","1508","712","287","425","27","739","1181","0","62.57","24.3"
"65","000","00","004","0408","0000","1423","530","893","77","1500","2537","0","59.12","20.89"
"65","000","00","004","0408","1543","694","250","444","34","728","1234","0","59.0","20.26"
"65","000","00","004","0408","1544","729","280","449","43","772","1303","0","59.25","21.49"
"65","000","00","004","0409","0000","401","120","281","35","436","893","0","48.82","13.44"
"65","000","00","004","0409","1597","401","120","281","35","436","893","0","48.82","13.44"
"65","000","00","004","0410","0000","408","122","286","29","437","743","0","58.82","16.42"
"65","000","00","004","0410","1598","408","122","286","29","437","743","0","58.82","16.42"
"65","000","00","004","0411","0000","2305","840","1465","121","2426","4189","0","57.91","20.05"
"65","000","00","004","0411","1514","807","295","512","46","853","1488","0","57.33","19.83"
"65","000","00","004","0411","1515","760","284","476","44","804","1288","0","62.42","22.05"
"65","000","00","004","0411","1516","738","261","477","31","769","1413","0","54.42","18.47"
"65","000","00","004","0412","0000","1845","782","1063","81","1926","3289","0","58.56","23.78"
"65","000","00","004","0412","1527","971","412","559","40","1011","1798","0","56.23","22.91"
"65","000","00","004","0412","1528","874","370","504","41","915","1491","0","61.37","24.82"
"65","000","00","004","0413","0000","3659","1421","2238","134","3793","6230","0","60.88","22.81"
"65","000","00","004","0413","1582","884","389","495","40","924","1598","0","57.82","24.34"
"65","000","00","004","0413","1583","948","367","581","32","980","1609","0","60.91","22.81"
"65","000","00","004","0413","1584","821","307","514","30","851","1375","0","61.89","22.33"
"65","000","00","004","0413","1585","1006","358","648","32","1038","1648","0","62.99","21.72"
"65","000","00","004","0414","0000","2471","1035","1436","111","2582","4535","0","56.93","22.82"
"65","000","00","004","0414","1579","871","343","528","39","910","1586","0","57.38","21.63"
"65","000","00","004","0414","1580","710","283","427","22","732","1313","0","55.75","21.55"
"65","000","00","004","0414","1581","890","409","481","50","940","1636","0","57.46","25.0"
"65","000","00","004","0415","0000","2208","809","1399","92","2300","3628","0","63.4","22.3"
"65","000","00","004","0415","1558","728","257","471","30","758","1209","0","62.7","21.26"
"65","000","00","004","0415","1559","699","267","432","24","723","1132","0","63.87","23.59"
"65","000","00","004","0415","1560","781","285","496","38","819","1287","0","63.64","22.14"
"65","000","00","004","0416","0000","2423","887","1536","102","2525","4081","0","61.87","21.73"
"65","000","00","004","0416","1520","721","269","452","24","745","1100","0","67.73","24.45"
"65","000","00","004","0416","1521","914","348","566","45","959","1545","0","62.07","22.52"
"65","000","00","004","0416","1522","788","270","518","33","821","1436","0","57.17","18.8"
"65","000","00","004","0417","0000","2233","795","1438","109","2342","3877","0","60.41","20.51"
"65","000","00","004","0417","1517","739","248","491","40","779","1329","0","58.62","18.66"
"65","000","00","004","0417","1518","859","290","569","36","895","1436","0","62.33","20.19"
"65","000","00","004","0417","1519","635","257","378","33","668","1112","0","60.07","23.11"
"65","000","00","004","0418","0000","1513","592","921","81","1594","2704","0","58.95","21.89"
"65","000","00","004","0418","1489","706","278","428","33","739","1188","0","62.21","23.4"
"65","000","00","004","0418","1490","807","314","493","48","855","1516","0","56.4","20.71"
"65","000","00","004","0419","0000","625","277","348","35","660","1140","0","57.89","24.3"
"65","000","00","004","0419","1488","625","277","348","35","660","1140","0","57.89","24.3"
"65","000","00","004","0420","0000","2082","843","1239","96","2178","3493","0","62.35","24.13"
"65","000","00","004","0420","1523","1034","396","638","53","1087","1731","0","62.8","22.88"
"65","000","00","004","0420","1524","1048","447","601","43","1091","1762","0","61.92","25.37"
"65","000","00","004","0421","0000","1349","570","779","60","1409","2617","0","53.84","21.78"
"65","000","00","004","0421","1525","705","299","406","45","750","1320","0","56.82","22.65"
"65","000","00","004","0421","1526","644","271","373","15","659","1297","0","50.81","20.89"
"65","000","00","004","0422","0000","994","409","585","38","1032","1783","0","57.88","22.94"
"65","000","00","004","0422","1606","477","197","280","11","488","879","0","55.52","22.41"
"65","000","00","004","0422","1607","517","212","305","27","544","904","0","60.18","23.45"
"65","000","00","004","0423","0000","1812","648","1164","79","1891","3314","0","57.06","19.55"
"65","000","00","004","0423","1480","950","334","616","40","990","1733","0","57.13","19.27"
"65","000","00","004","0423","1481","862","314","548","39","901","1581","0","56.99","19.86"
"65","000","00","004","0424","0000","2058","754","1304","86","2144","3452","0","62.11","21.84"
"65","000","00","004","0424","1568","1099","377","722","42","1141","1876","0","60.82","20.1"
"65","000","00","004","0424","1569","959","377","582","44","1003","1576","0","63.64","23.92"
"65","000","00","004","0425","0000","1969","706","1263","62","2031","3469","0","58.55","20.35"
"65","000","00","004","0425","1570","967","367","600","34","1001","1661","0","60.26","22.1"
"65","000","00","004","0425","1571","1002","339","663","28","1030","1808","0","56.97","18.75"
"65","000","00","004","0426","0000","2165","857","1308","90","2255","3547","0","63.57","24.16"
"65","000","00","004","0426","1563","748","268","480","22","770","1222","0","63.01","21.93"
"65","000","00","004","0426","1564","683","263","420","32","715","1157","0","61.8","22.73"
"65","000","00","004","0426","1565","734","326","408","36","770","1168","0","65.92","27.91"
"65","000","00","004","0427","0000","1488","678","810","68","1556","2655","0","58.61","25.54"
"65","000","00","004","0427","1566","714","314","400","40","754","1283","0","58.77","24.47"
"65","000","00","004","0427","1567","774","364","410","28","802","1372","0","58.45","26.53"
"65","000","00","004","0428","0000","1679","606","1073","67","1746","2979","0","58.61","20.34"
"65","000","00","004","0428","1610","857","308","549","25","882","1551","0","56.87","19.86"
"65","000","00","004","0428","1611","822","298","524","42","864","1428","0","60.5","20.87"
"65","000","00","004","0429","0000","1320","520","800","81","1401","2239","0","62.57","23.22"
"65","000","00","004","0429","1608","733","287","446","37","770","1221","0","63.06","23.51"
"65","000","00","004","0429","1609","587","233","354","44","631","1018","0","61.98","22.89"
"65","000","00","004","0430","0000","2304","789","1515","67","2371","3932","0","60.3","20.07"
"65","000","00","004","0430","1551","726","275","451","22","748","1210","0","61.82","22.73"
"65","000","00","004","0430","1552","930","343","587","27","957","1630","0","58.71","21.04"
"65","000","00","004","0430","1553","648","171","477","18","666","1092","0","60.99","15.66"
"65","000","00","004","0431","0000","2495","936","1559","102","2597","4196","0","61.89","22.31"
"65","000","00","004","0431","1547","602","258","344","25","627","991","0","63.27","26.03"
"65","000","00","004","0431","1548","621","231","390","21","642","1016","0","63.19","22.74"
"65","000","00","004","0431","1549","657","221","436","37","694","1146","0","60.56","19.28"
"65","000","00","004","0431","1550","615","226","389","19","634","1043","0","60.79","21.67"
"65","000","00","004","0432","0000","1408","541","867","62","1470","2334","0","62.98","23.18"
"65","000","00","004","0432","1556","617","231","386","33","650","1049","0","61.96","22.02"
"65","000","00","004","0432","1557","791","310","481","29","820","1285","0","63.81","24.12"
"65","000","00","004","0433","0000","2335","987","1348","104","2439","4225","0","57.73","23.36"
"65","000","00","004","0433","1576","671","251","420","22","693","1177","0","58.88","21.33"
"65","000","00","004","0433","1577","875","393","482","42","917","1557","0","58.9","25.24"
"65","000","00","004","0433","1578","789","343","446","40","829","1491","0","55.6","23.0"
"65","000","00","004","0434","0000","1851","724","1127","75","1926","3434","0","56.09","21.08"
"65","000","00","004","0434","1536","941","411","530","35","976","1713","0","56.98","23.99"
"65","000","00","004","0434","1537","910","313","597","40","950","1721","0","55.2","18.19"
"65","000","00","004","0435","0000","2486","890","1596","108","2594","4177","0","62.1","21.31"
"65","000","00","004","0435","1540","819","294","525","32","851","1348","0","63.13","21.81"
"65","000","00","004","0435","1541","893","287","606","33","926","1461","0","63.38","19.64"
"65","000","00","004","0435","1542","774","309","465","43","817","1368","0","59.72","22.59"
"65","000","00","004","0436","0000","867","334","533","53","920","1554","0","59.2","21.49"
"65","000","00","004","0436","1476","867","334","533","53","920","1554","0","59.2","21.49"
"65","000","00","004","0437","0000","1247","456","791","65","1312","2107","0","62.27","21.64"
"65","000","00","004","0437","1478","517","197","320","32","549","854","0","64.29","23.07"
"65","000","00","004","0437","1479","730","259","471","33","763","1253","0","60.89","20.67"
"65","000","00","004","0438","0000","2633","930","1703","108","2741","4561","0","60.1","20.39"
"65","000","00","004","0438","1499","855","301","554","37","892","1511","0","59.03","19.92"
"65","000","00","004","0438","1500","892","319","573","38","930","1470","0","63.27","21.7"
"65","000","00","004","0438","1501","886","310","576","33","919","1580","0","58.16","19.62"
"65","000","00","004","0439","0000","2358","843","1515","84","2442","3789","0","64.45","22.25"
"65","000","00","004","0439","1502","855","279","576","40","895","1438","0","62.24","19.4"
"65","000","00","004","0439","1503","805","272","533","27","832","1305","0","63.75","20.84"
"65","000","00","004","0439","1504","698","292","406","17","715","1046","0","68.36","27.92"
"65","000","00","004","0440","0000","1667","649","1018","69","1736","2938","0","59.09","22.09"
"65","000","00","004","0440","1545","828","313","515","30","858","1516","0","56.6","20.65"
"65","000","00","004","0440","1546","839","336","503","39","878","1422","0","61.74","23.63"
"65","000","00","004","0441","0000","385","140","245","42","427","768","0","55.6","18.23"
"65","000","00","004","0441","1596","385","140","245","42","427","768","0","55.6","18.23"
"65","000","00","004","0442","0000","497","158","339","28","525","853","0","61.55","18.52"
"65","000","00","004","0442","1595","497","158","339","28","525","853","0","61.55","18.52"
"65","000","00","004","0443","0000","1055","398","657","43","1098","1898","0","57.85","20.97"
"65","000","00","004","0443","1572","1055","398","657","43","1098","1898","0","57.85","20.97"
"65","000","00","004","0444","0000","2481","970","1511","111","2592","4271","0","60.69","22.71"
"65","000","00","004","0444","1573","901","358","543","33","934","1508","0","61.94","23.74"
"65","000","00","004","0444","1574","777","295","482","48","825","1341","0","61.52","22.0"
"65","000","00","004","0444","1575","803","317","486","30","833","1422","0","58.58","22.29"
"65","000","00","004","0445","0000","1193","433","760","73","1266","2011","0","62.95","21.53"
"65","000","00","004","0445","1612","612","225","387","41","653","1044","0","62.55","21.55"
"65","000","00","004","0445","1613","581","208","373","32","613","967","0","63.39","21.51"
"65","000","00","004","0446","0000","1966","837","1129","134","2100","3545","0","59.24","23.61"
"65","000","00","004","0446","1593","1046","436","610","89","1135","1938","0","58.57","22.5"
"65","000","00","004","0446","1594","920","401","519","45","965","1607","0","60.05","24.95"
"65","000","00","004","0447","0000","2527","991","1536","107","2634","4361","0","60.4","22.72"
"65","000","00","004","0447","1511","934","377","557","38","972","1649","0","58.94","22.86"
"65","000","00","004","0447","1512","729","272","457","31","760","1206","0","63.02","22.55"
"65","000","00","004","0447","1513","864","342","522","38","902","1506","0","59.89","22.71"
"65","000","00","004","0448","0000","1595","636","959","71","1666","2823","0","59.02","22.53"
"65","000","00","004","0448","1509","916","340","576","40","956","1720","0","55.58","19.77"
"65","000","00","004","0448","1510","679","296","383","31","710","1103","0","64.37","26.84"
"65","000","00","004","0449","0000","2011","787","1224","81","2092","3465","0","60.38","22.71"
"65","000","00","004","0449","1533","607","239","368","19","626","1115","0","56.14","21.43"
"65","000","00","004","0449","1534","691","269","422","37","728","1133","0","64.25","23.74"
"65","000","00","004","0449","1535","713","279","434","25","738","1217","0","60.64","22.93"
"65","000","00","004","0450","0000","1323","291","1032","49","1372","2331","0","58.86","12.48"
"65","000","00","004","0450","1529","689","241","448","16","705","1223","0","57.65","19.71"
"65","000","00","004","0450","1530","634","50","584","33","667","1108","0","60.2","4.51"
"65","000","00","004","0451","0000","1747","589","1158","77","1824","3104","0","58.76","18.98"
"65","000","00","004","0451","1484","952","322","630","39","991","1650","0","60.06","19.52"
"65","000","00","004","0451","1485","795","267","528","38","833","1454","0","57.29","18.36"
"65","000","00","004","0452","0000","620","224","396","21","641","1065","0","60.19","21.03"
"65","000","00","004","0452","1477","620","224","396","21","641","1065","0","60.19","21.03"
"65","000","00","004","0453","0000","1157","526","631","61","1218","2025","0","60.15","25.98"
"65","000","00","004","0453","1493","624","241","383","34","658","1084","0","60.7","22.23"
"65","000","00","004","0453","1494","533","285","248","27","560","941","0","59.51","30.29"
"65","000","00","004","0454","0000","1538","591","947","62","1600","2835","0","56.44","20.85"
"65","000","00","004","0454","1491","748","280","468","34","782","1397","0","55.98","20.04"
"65","000","00","004","0454","1492","790","311","479","28","818","1438","0","56.88","21.63"
"65","000","00","004","0455","0000","1752","618","1134","66","1818","3298","0","55.12","18.74"
"65","000","00","004","0455","1482","919","337","582","46","965","1735","0","55.62","19.42"
"65","000","00","004","0455","1483","833","281","552","20","853","1563","0","54.57","17.98"
"65","000","00","004","0456","0000","2049","856","1193","75","2124","3653","0","58.14","23.43"
"65","000","00","004","0456","1554","1062","404","658","46","1108","1872","0","59.19","21.58"
"65","000","00","004","0456","1555","987","452","535","29","1016","1781","0","57.05","25.38"
"65","000","00","004","0457","0000","1359","549","810","63","1422","2411","0","58.98","22.77"
"65","000","00","004","0457","1603","760","308","452","43","803","1368","0","58.7","22.51"
"65","000","00","004","0457","1604","599","241","358","20","619","1043","0","59.35","23.11"
"65","000","00","004","0458","0000","1012","423","589","38","1050","1709","0","61.44","24.75"
"65","000","00","004","0458","1605","1012","423","589","38","1050","1709","0","61.44","24.75"
"65","000","00","004","0459","0000","1468","573","895","70","1538","2584","0","59.52","22.17"
"65","000","00","004","0459","1538","707","280","427","49","756","1327","0","56.97","21.1"
"65","000","00","004","0459","1539","761","293","468","21","782","1257","0","62.21","23.31"
"65","000","00","004","0460","0000","1562","621","941","74","1636","2673","0","61.2","23.23"
"65","000","00","004","0460","1531","827","340","487","34","861","1408","0","61.15","24.15"
"65","000","00","004","0460","1532","735","281","454","40","775","1265","0","61.26","22.21"
"65","000","00","004","0461","0000","1315","395","920","53","1368","2166","0","63.16","18.24"
"65","000","00","004","0461","1561","650","120","530","25","675","1068","0","63.2","11.24"
"65","000","00","004","0461","1562","665","275","390","28","693","1098","0","63.11","25.05"
"65","000","00","004","0462","0000","5240","1941","3299","160","5400","8673","0","62.26","22.38"
"65","000","00","004","0462","1586","629","299","330","30","659","1077","0","61.19","27.76"
"65","000","00","004","0462","1587","685","267","418","23","708","1157","0","61.19","23.08"
"65","000","00","004","0462","1588","823","308","515","32","855","1339","0","63.85","23.0"
"65","000","00","004","0462","1589","797","267","530","18","815","1306","0","62.4","20.44"
"65","000","00","004","0462","1590","773","278","495","16","789","1236","0","63.83","22.49"
"65","000","00","004","0462","1591","690","242","448","17","707","1133","0","62.4","21.36"
"65","000","00","004","0462","1592","843","280","563","24","867","1425","0","60.84","19.65"
"65","000","00","005","0000","0000","188754","90070","98684","9447","198201","344981","417405","57.45","26.11"
"65","000","00","005","0501","0000","2800","1388","1412","147","2947","4792","0","61.5","28.96"
"65","000","00","005","0501","0302","619","331","288","44","663","1123","0","59.04","29.47"
"65","000","00","005","0501","0303","739","367","372","48","787","1278","0","61.58","28.72"
"65","000","00","005","0501","0304","708","333","375","32","740","1163","0","63.63","28.63"
"65","000","00","005","0501","0305","734","357","377","23","757","1228","0","61.64","29.07"
"65","000","00","005","0502","0000","3860","1825","2035","151","4011","7166","0","55.97","25.47"
"65","000","00","005","0502","0328","712","347","365","20","732","1382","0","52.97","25.11"
"65","000","00","005","0502","0329","798","378","420","38","836","1475","0","56.68","25.63"
"65","000","00","005","0502","0330","839","397","442","17","856","1462","0","58.55","27.15"
"65","000","00","005","0502","0331","764","342","422","30","794","1426","0","55.68","23.98"
"65","000","00","005","0502","0332","747","361","386","46","793","1421","0","55.81","25.4"
"65","000","00","005","0503","0000","699","355","344","59","758","1341","0","56.52","26.47"
"65","000","00","005","0503","0449","699","355","344","59","758","1341","0","56.52","26.47"
"65","000","00","005","0504","0000","2270","1137","1133","91","2361","3923","0","60.18","28.98"
"65","000","00","005","0504","0306","691","372","319","26","717","1211","0","59.21","30.72"
"65","000","00","005","0504","0307","668","374","294","30","698","1176","0","59.35","31.8"
"65","000","00","005","0504","0308","911","391","520","35","946","1536","0","61.59","25.46"
"65","000","00","005","0505","0000","2123","946","1177","63","2186","3872","0","56.46","24.43"
"65","000","00","005","0505","0333","836","369","467","24","860","1536","0","55.99","24.02"
"65","000","00","005","0505","0334","896","399","497","26","922","1587","0","58.1","25.14"
"65","000","00","005","0505","0335","391","178","213","13","404","749","0","53.94","23.77"
"65","000","00","005","0506","0000","1934","965","969","117","2051","3313","0","61.91","29.13"
"65","000","00","005","0506","0446","605","290","315","51","656","1107","0","59.26","26.2"
"65","000","00","005","0506","0447","668","323","345","31","699","1063","0","65.76","30.39"
"65","000","00","005","0506","0448","661","352","309","35","696","1143","0","60.89","30.8"
"65","000","00","005","0507","0000","2391","1168","1223","101","2492","4240","0","58.77","27.55"
"65","000","00","005","0507","0312","736","366","370","40","776","1353","0","57.35","27.05"
"65","000","00","005","0507","0313","837","431","406","41","878","1409","0","62.31","30.59"
"65","000","00","005","0507","0314","818","371","447","20","838","1478","0","56.7","25.1"
"65","000","00","005","0508","0000","2155","999","1156","135","2290","3930","0","58.27","25.42"
"65","000","00","005","0508","0383","739","345","394","50","789","1342","0","58.79","25.71"
"65","000","00","005","0508","0384","744","350","394","37","781","1341","0","58.24","26.1"
"65","000","00","005","0508","0385","672","304","368","48","720","1247","0","57.74","24.38"
"65","000","00","005","0509","0000","3440","1650","1790","133","3573","6296","0","56.75","26.21"
"65","000","00","005","0509","0501","810","396","414","32","842","1539","0","54.71","25.73"
"65","000","00","005","0509","0502","886","445","441","37","923","1586","0","58.2","28.06"
"65","000","00","005","0509","0503","912","425","487","29","941","1631","0","57.69","26.06"
"65","000","00","005","0509","0504","832","384","448","35","867","1540","0","56.3","24.94"
"65","000","00","005","0510","0000","1129","574","555","66","1195","1892","0","63.16","30.34"
"65","000","00","005","0510","0315","543","272","271","38","581","921","0","63.08","29.53"
"65","000","00","005","0510","0316","586","302","284","28","614","971","0","63.23","31.1"
"65","000","00","005","0511","0000","2875","1388","1487","131","3006","5088","0","59.08","27.28"
"65","000","00","005","0511","0379","704","351","353","29","733","1167","0","62.81","30.08"
"65","000","00","005","0511","0380","692","335","357","38","730","1299","0","56.2","25.79"
"65","000","00","005","0511","0381","668","302","366","37","705","1207","0","58.41","25.02"
"65","000","00","005","0511","0382","811","400","411","27","838","1415","0","59.22","28.27"
"65","000","00","005","0512","0000","1436","745","691","62","1498","2771","0","54.06","26.89"
"65","000","00","005","0512","0518","695","359","336","27","722","1371","0","52.66","26.19"
"65","000","00","005","0512","0519","741","386","355","35","776","1400","0","55.43","27.57"
"65","000","00","005","0513","0000","1706","749","957","89","1795","3070","0","58.47","24.4"
"65","000","00","005","0513","0319","384","195","189","27","411","697","0","58.97","27.98"
"65","000","00","005","0513","0320","694","273","421","29","723","1235","0","58.54","22.11"
"65","000","00","005","0513","0321","628","281","347","33","661","1138","0","58.08","24.69"
"65","000","00","005","0514","0000","2338","1156","1182","112","2450","4068","0","60.23","28.42"
"65","000","00","005","0514","0390","773","401","372","17","790","1346","0","58.69","29.79"
"65","000","00","005","0514","0391","776","380","396","44","820","1372","0","59.77","27.7"
"65","000","00","005","0514","0392","789","375","414","51","840","1350","0","62.22","27.78"
"65","000","00","005","0515","0000","5232","2543","2689","213","5445","9838","0","55.35","25.85"
"65","000","00","005","0515","0547","655","336","319","29","684","1126","0","60.75","29.84"
"65","000","00","005","0515","0548","691","341","350","33","724","1240","0","58.39","27.5"
"65","000","00","005","0515","0549","815","394","421","20","835","1460","0","57.19","26.99"
"65","000","00","005","0515","0550","577","306","271","27","604","1072","0","56.34","28.54"
"65","000","00","005","0515","0551","560","289","271","34","594","1127","0","52.71","25.64"
"65","000","00","005","0515","0552","766","315","451","21","787","1332","0","59.08","23.65"
"65","000","00","005","0515","0553","682","335","347","24","706","1341","0","52.65","24.98"
"65","000","00","005","0515","0554","486","227","259","25","511","1140","0","44.82","19.91"
"65","000","00","005","0516","0000","1368","668","700","56","1424","4462","0","31.91","14.97"
"65","000","00","005","0516","0322","557","256","301","22","579","1063","0","54.47","24.08"
"65","000","00","005","0516","0323","811","412","399","34","845","3399","0","24.86","12.12"
"65","000","00","005","0517","0000","2134","1067","1067","144","2278","3947","0","57.71","27.03"
"65","000","00","005","0517","0393","684","332","352","49","733","1307","0","56.08","25.4"
"65","000","00","005","0517","0394","733","369","364","52","785","1353","0","58.02","27.27"
"65","000","00","005","0517","0395","717","366","351","43","760","1287","0","59.05","28.44"
"65","000","00","005","0518","0000","2828","1429","1399","144","2972","5155","0","57.65","27.72"
"65","000","00","005","0518","0452","720","317","403","33","753","1309","0","57.52","24.22"
"65","000","00","005","0518","0453","710","377","333","31","741","1216","0","60.94","31.0"
"65","000","00","005","0518","0454","655","331","324","37","692","1278","0","54.15","25.9"
"65","000","00","005","0518","0455","743","404","339","43","786","1352","0","58.14","29.88"
"65","000","00","005","0519","0000","897","427","470","38","935","1575","0","59.37","27.11"
"65","000","00","005","0519","0324","897","427","470","38","935","1575","0","59.37","27.11"
"65","000","00","005","0520","0000","1026","505","521","84","1110","1907","0","58.21","26.48"
"65","000","00","005","0520","0413","529","273","256","37","566","955","0","59.27","28.59"
"65","000","00","005","0520","0414","497","232","265","47","544","952","0","57.14","24.37"
"65","000","00","005","0521","0000","3059","1496","1563","217","3276","6100","0","53.7","24.52"
"65","000","00","005","0521","0485","770","381","389","56","826","1505","0","54.88","25.32"
"65","000","00","005","0521","0486","764","368","396","62","826","1527","0","54.09","24.1"
"65","000","00","005","0521","0487","735","359","376","48","783","1482","0","52.83","24.22"
"65","000","00","005","0521","0488","790","388","402","51","841","1586","0","53.03","24.46"
"65","000","00","005","0522","0000","964","477","487","46","1010","1615","0","62.54","29.54"
"65","000","00","005","0522","0325","964","477","487","46","1010","1615","0","62.54","29.54"
"65","000","00","005","0523","0000","3147","1547","1600","161","3308","5541","0","59.7","27.92"
"65","000","00","005","0523","0415","786","413","373","28","814","1412","0","57.65","29.25"
"65","000","00","005","0523","0416","775","383","392","53","828","1415","0","58.52","27.07"
"65","000","00","005","0523","0417","815","387","428","40","855","1421","0","60.17","27.23"
"65","000","00","005","0523","0418","771","364","407","40","811","1293","0","62.72","28.15"
"65","000","00","005","0524","0000","1177","613","564","76","1253","2161","0","57.98","28.37"
"65","000","00","005","0524","0491","584","312","272","34","618","1090","0","56.7","28.62"
"65","000","00","005","0524","0492","593","301","292","42","635","1071","0","59.29","28.1"
"65","000","00","005","0525","0000","2496","1225","1271","133","2629","4748","0","55.37","25.8"
"65","000","00","005","0525","0371","844","401","443","45","889","1571","0","56.59","25.53"
"65","000","00","005","0525","0372","823","415","408","41","864","1594","0","54.2","26.04"
"65","000","00","005","0525","0373","829","409","420","47","876","1583","0","55.34","25.84"
"65","000","00","005","0526","0000","1239","447","792","46","1285","2027","0","63.39","22.05"
"65","000","00","005","0526","0386","639","195","444","16","655","984","0","66.57","19.82"
"65","000","00","005","0526","0387","600","252","348","30","630","1043","0","60.4","24.16"
"65","000","00","005","0527","0000","2556","1284","1272","132","2688","4704","0","57.14","27.3"
"65","000","00","005","0527","0508","596","289","307","38","634","1181","0","53.68","24.47"
"65","000","00","005","0527","0509","631","342","289","34","665","1135","0","58.59","30.13"
"65","000","00","005","0527","0510","639","327","312","41","680","1173","0","57.97","27.88"
"65","000","00","005","0527","0511","690","326","364","19","709","1215","0","58.35","26.83"
"65","000","00","005","0528","0000","1261","632","629","105","1366","2406","0","56.77","26.27"
"65","000","00","005","0528","0362","584","303","281","53","637","1170","0","54.44","25.9"
"65","000","00","005","0528","0363","677","329","348","52","729","1236","0","58.98","26.62"
"65","000","00","005","0529","0000","1406","656","750","54","1460","2320","0","62.93","28.28"
"65","000","00","005","0529","0388","733","336","397","25","758","1135","0","66.78","29.6"
"65","000","00","005","0529","0389","673","320","353","29","702","1185","0","59.24","27.0"
"65","000","00","005","0530","0000","2555","1226","1329","168","2723","4728","0","57.59","25.93"
"65","000","00","005","0530","0353","840","400","440","64","904","1558","0","58.02","25.67"
"65","000","00","005","0530","0354","819","394","425","47","866","1567","0","55.26","25.14"
"65","000","00","005","0530","0355","896","432","464","57","953","1603","0","59.45","26.95"
"65","000","00","005","0531","0000","2644","1216","1428","136","2780","4477","0","62.1","27.16"
"65","000","00","005","0531","0443","870","420","450","41","911","1535","0","59.35","27.36"
"65","000","00","005","0531","0444","913","388","525","40","953","1492","0","63.87","26.01"
"65","000","00","005","0531","0445","861","408","453","55","916","1450","0","63.17","28.14"
"65","000","00","005","0532","0000","2958","1351","1607","139","3097","5219","0","59.34","25.89"
"65","000","00","005","0532","0523","695","356","339","49","744","1318","0","56.45","27.01"
"65","000","00","005","0532","0524","805","352","453","35","840","1411","0","59.53","24.95"
"65","000","00","005","0532","0525","726","333","393","30","756","1262","0","59.9","26.39"
"65","000","00","005","0532","0526","732","310","422","25","757","1228","0","61.64","25.24"
"65","000","00","005","0533","0000","2224","1150","1074","133","2357","4251","0","55.45","27.05"
"65","000","00","005","0533","0344","656","322","334","53","709","1351","0","52.48","23.83"
"65","000","00","005","0533","0345","772","439","333","41","813","1403","0","57.95","31.29"
"65","000","00","005","0533","0346","796","389","407","39","835","1497","0","55.78","25.99"
"65","000","00","005","0534","0000","1630","813","817","82","1712","3285","0","52.12","24.75"
"65","000","00","005","0534","0438","778","396","382","44","822","1633","0","50.34","24.25"
"65","000","00","005","0534","0439","852","417","435","38","890","1652","0","53.87","25.24"
"65","000","00","005","0535","0000","1309","707","602","78","1387","2670","0","51.95","26.48"
"65","000","00","005","0535","0529","670","364","306","41","711","1326","0","53.62","27.45"
"65","000","00","005","0535","0530","639","343","296","37","676","1344","0","50.3","25.52"
"65","000","00","005","0536","0000","1603","803","800","93","1696","3126","0","54.25","25.69"
"65","000","00","005","0536","0326","818","453","365","40","858","1612","0","53.23","28.1"
"65","000","00","005","0536","0327","785","350","435","53","838","1514","0","55.35","23.12"
"65","000","00","005","0537","0000","2049","1043","1006","104","2153","3484","0","61.8","29.94"
"65","000","00","005","0537","0400","661","350","311","51","712","1148","0","62.02","30.49"
"65","000","00","005","0537","0401","693","345","348","9","702","1201","0","58.45","28.73"
"65","000","00","005","0537","0402","695","348","347","44","739","1135","0","65.11","30.66"
"65","000","00","005","0538","0000","3251","1640","1611","196","3447","6209","0","55.52","26.41"
"65","000","00","005","0538","0542","636","342","294","38","674","1245","0","54.14","27.47"
"65","000","00","005","0538","0543","643","319","324","36","679","1212","0","56.02","26.32"
"65","000","00","005","0538","0544","633","326","307","56","689","1253","0","54.99","26.02"
"65","000","00","005","0538","0545","637","313","324","40","677","1272","0","53.22","24.61"
"65","000","00","005","0538","0546","702","340","362","26","728","1227","0","59.33","27.71"
"65","000","00","005","0539","0000","2181","1039","1142","104","2285","3713","0","61.54","27.98"
"65","000","00","005","0539","0374","719","333","386","42","761","1245","0","61.12","26.75"
"65","000","00","005","0539","0375","691","361","330","28","719","1203","0","59.77","30.01"
"65","000","00","005","0539","0376","771","345","426","34","805","1265","0","63.64","27.27"
"65","000","00","005","0540","0000","1138","554","584","56","1194","1990","0","60.0","27.84"
"65","000","00","005","0540","0458","459","211","248","22","481","881","0","54.6","23.95"
"65","000","00","005","0540","0459","679","343","336","34","713","1109","0","64.29","30.93"
"65","000","00","005","0541","0000","2158","955","1203","114","2272","3833","0","59.27","24.92"
"65","000","00","005","0541","0537","785","318","467","34","819","1301","0","62.95","24.44"
"65","000","00","005","0541","0538","683","325","358","45","728","1262","0","57.69","25.75"
"65","000","00","005","0541","0539","690","312","378","35","725","1270","0","57.09","24.57"
"65","000","00","005","0542","0000","1286","681","605","70","1356","2442","0","55.53","27.89"
"65","000","00","005","0542","0369","673","370","303","41","714","1225","0","58.29","30.2"
"65","000","00","005","0542","0370","613","311","302","29","642","1217","0","52.75","25.55"
"65","000","00","005","0543","0000","3949","1767","2182","171","4120","7475","0","55.12","23.64"
"65","000","00","005","0543","0460","695","334","361","30","725","1291","0","56.16","25.87"
"65","000","00","005","0543","0461","671","295","376","27","698","1293","0","53.98","22.82"
"65","000","00","005","0543","0462","754","368","386","37","791","1336","0","59.21","27.54"
"65","000","00","005","0543","0463","724","326","398","39","763","1384","0","55.13","23.55"
"65","000","00","005","0543","0464","605","255","350","18","623","1231","0","50.61","20.71"
"65","000","00","005","0543","0465","500","189","311","20","520","940","0","55.32","20.11"
"65","000","00","005","0544","0000","2224","979","1245","116","2340","4010","0","58.35","24.41"
"65","000","00","005","0544","0531","741","265","476","29","770","1355","0","56.83","19.56"
"65","000","00","005","0544","0532","717","338","379","50","767","1306","0","58.73","25.88"
"65","000","00","005","0544","0533","766","376","390","37","803","1349","0","59.53","27.87"
"65","000","00","005","0545","0000","2485","1251","1234","142","2627","4756","0","55.24","26.3"
"65","000","00","005","0545","0366","936","439","497","33","969","1586","0","61.1","27.68"
"65","000","00","005","0545","0367","787","412","375","43","830","1597","0","51.97","25.8"
"65","000","00","005","0545","0368","762","400","362","66","828","1573","0","52.64","25.43"
"65","000","00","005","0546","0000","2144","1063","1081","163","2307","4025","0","57.32","26.41"
"65","000","00","005","0546","0466","713","354","359","56","769","1369","0","56.17","25.86"
"65","000","00","005","0546","0467","729","363","366","53","782","1384","0","56.5","26.23"
"65","000","00","005","0546","0468","702","346","356","54","756","1272","0","59.43","27.2"
"65","000","00","005","0547","0000","2129","1192","937","140","2269","3876","0","58.54","30.75"
"65","000","00","005","0547","0347","713","364","349","60","773","1272","0","60.77","28.62"
"65","000","00","005","0547","0348","644","345","299","25","669","1269","0","52.72","27.19"
"65","000","00","005","0547","0349","772","483","289","55","827","1335","0","61.95","36.18"
"65","000","00","005","0548","0000","4980","2216","2764","156","5136","9217","0","55.72","24.04"
"65","000","00","005","0548","0471","822","322","500","19","841","1528","0","55.04","21.07"
"65","000","00","005","0548","0472","656","274","382","30","686","1244","0","55.14","22.03"
"65","000","00","005","0548","0473","691","330","361","0","691","1356","0","50.96","24.34"
"65","000","00","005","0548","0474","592","237","355","16","608","1164","0","52.23","20.36"
"65","000","00","005","0548","0475","794","353","441","46","840","1423","0","59.03","24.81"
"65","000","00","005","0548","0476","751","366","385","25","776","1250","0","62.08","29.28"
"65","000","00","005","0548","0477","674","334","340","20","694","1252","0","55.43","26.68"
"65","000","00","005","0549","0000","1171","588","583","75","1246","2200","0","56.64","26.73"
"65","000","00","005","0549","0364","558","261","297","40","598","1071","0","55.84","24.37"
"65","000","00","005","0549","0365","613","327","286","35","648","1129","0","57.4","28.96"
"65","000","00","005","0550","0000","4316","2031","2285","218","4534","7788","0","58.22","26.08"
"65","000","00","005","0550","0480","906","413","493","46","952","1646","0","57.84","25.09"
"65","000","00","005","0550","0481","808","379","429","57","865","1551","0","55.77","24.44"
"65","000","00","005","0550","0482","862","433","429","46","908","1526","0","59.5","28.37"
"65","000","00","005","0550","0483","880","428","452","27","907","1518","0","59.75","28.19"
"65","000","00","005","0550","0484","860","378","482","42","902","1547","0","58.31","24.43"
"65","000","00","005","0551","0000","1448","648","800","78","1526","2542","0","60.03","25.49"
"65","000","00","005","0551","0377","714","321","393","53","767","1255","0","61.12","25.58"
"65","000","00","005","0551","0378","734","327","407","25","759","1287","0","58.97","25.41"
"65","000","00","005","0552","0000","2141","979","1162","112","2253","4004","0","56.27","24.45"
"65","000","00","005","0552","0435","834","388","446","56","890","1584","0","56.19","24.49"
"65","000","00","005","0552","0436","853","368","485","25","878","1602","0","54.81","22.97"
"65","000","00","005","0552","0437","454","223","231","31","485","818","0","59.29","27.26"
"65","000","00","005","0553","0000","5020","2354","2666","203","5223","9369","0","55.75","25.13"
"65","000","00","005","0553","0429","801","368","433","27","828","1641","0","50.46","22.43"
"65","000","00","005","0553","0430","852","388","464","22","874","1633","0","53.52","23.76"
"65","000","00","005","0553","0431","868","412","456","20","888","1531","0","58.0","26.91"
"65","000","00","005","0553","0432","865","450","415","45","910","1517","0","59.99","29.66"
"65","000","00","005","0553","0433","777","373","404","51","828","1487","0","55.68","25.08"
"65","000","00","005","0553","0434","857","363","494","38","895","1560","0","57.37","23.27"
"65","000","00","005","0554","0000","4071","1925","2146","171","4242","7331","0","57.86","26.26"
"65","000","00","005","0554","0419","797","401","396","16","813","1475","0","55.12","27.19"
"65","000","00","005","0554","0420","769","399","370","51","820","1429","0","57.38","27.92"
"65","000","00","005","0554","0421","817","355","462","32","849","1481","0","57.33","23.97"
"65","000","00","005","0554","0422","845","378","467","46","891","1472","0","60.53","25.68"
"65","000","00","005","0554","0423","843","392","451","26","869","1474","0","58.96","26.59"
"65","000","00","005","0555","0000","1999","1002","997","135","2134","4163","0","51.26","24.07"
"65","000","00","005","0555","0505","671","343","328","37","708","1388","0","51.01","24.71"
"65","000","00","005","0555","0506","659","339","320","61","720","1388","0","51.87","24.42"
"65","000","00","005","0555","0507","669","320","349","37","706","1387","0","50.9","23.07"
"65","000","00","005","0556","0000","1310","612","698","77","1387","2241","0","61.89","27.31"
"65","000","00","005","0556","0499","651","306","345","35","686","1130","0","60.71","27.08"
"65","000","00","005","0556","0500","659","306","353","42","701","1111","0","63.1","27.54"
"65","000","00","005","0557","0000","1696","826","870","93","1789","3276","0","54.61","25.21"
"65","000","00","005","0557","0396","736","371","365","30","766","1567","0","48.88","23.68"
"65","000","00","005","0557","0397","960","455","505","63","1023","1709","0","59.86","26.62"
"65","000","00","005","0558","0000","1649","893","756","70","1719","3244","0","52.99","27.53"
"65","000","00","005","0558","0398","819","436","383","32","851","1616","0","52.66","26.98"
"65","000","00","005","0558","0399","830","457","373","38","868","1628","0","53.32","28.07"
"65","000","00","005","0559","0000","2321","1125","1196","131","2452","4258","0","57.59","26.42"
"65","000","00","005","0559","0440","792","396","396","41","833","1498","0","55.61","26.44"
"65","000","00","005","0559","0441","748","367","381","53","801","1379","0","58.09","26.61"
"65","000","00","005","0559","0442","781","362","419","37","818","1381","0","59.23","26.21"
"65","000","00","005","0560","0000","2686","1248","1438","119","2805","4394","0","63.84","28.4"
"65","000","00","005","0560","0309","898","413","485","39","937","1486","0","63.06","27.79"
"65","000","00","005","0560","0310","939","429","510","36","975","1513","0","64.44","28.35"
"65","000","00","005","0560","0311","849","406","443","44","893","1395","0","64.01","29.1"
"65","000","00","005","0561","0000","1789","926","863","129","1918","3322","0","57.74","27.87"
"65","000","00","005","0561","0360","967","483","484","67","1034","1696","0","60.97","28.48"
"65","000","00","005","0561","0361","822","443","379","62","884","1626","0","54.37","27.24"
"65","000","00","005","0562","0000","3230","1440","1790","126","3356","5442","0","61.67","26.46"
"65","000","00","005","0562","0409","825","343","482","51","876","1389","0","63.07","24.69"
"65","000","00","005","0562","0410","724","317","407","33","757","1272","0","59.51","24.92"
"65","000","00","005","0562","0411","862","374","488","19","881","1409","0","62.53","26.54"
"65","000","00","005","0562","0412","819","406","413","23","842","1372","0","61.37","29.59"
"65","000","00","005","0563","0000","1837","889","948","57","1894","3243","0","58.4","27.41"
"65","000","00","005","0563","0358","935","444","491","21","956","1698","0","56.3","26.15"
"65","000","00","005","0563","0359","902","445","457","36","938","1545","0","60.71","28.8"
"65","000","00","005","0564","0000","3245","1363","1882","110","3355","5852","0","57.33","23.29"
"65","000","00","005","0564","0340","820","339","481","29","849","1493","0","56.87","22.71"
"65","000","00","005","0564","0341","836","342","494","42","878","1507","0","58.26","22.69"
"65","000","00","005","0564","0342","807","350","457","21","828","1456","0","56.87","24.04"
"65","000","00","005","0564","0343","782","332","450","18","800","1396","0","57.31","23.78"
"65","000","00","005","0565","0000","1749","770","979","88","1837","3050","0","60.23","25.25"
"65","000","00","005","0565","0317","903","387","516","65","968","1534","0","63.1","25.23"
"65","000","00","005","0565","0318","846","383","463","23","869","1516","0","57.32","25.26"
"65","000","00","005","0566","0000","1809","860","949","96","1905","3301","0","57.71","26.05"
"65","000","00","005","0566","0497","917","433","484","50","967","1689","0","57.25","25.64"
"65","000","00","005","0566","0498","892","427","465","46","938","1612","0","58.19","26.49"
"65","000","00","005","0567","0000","1194","565","629","103","1297","2105","0","61.62","26.84"
"65","000","00","005","0567","0489","558","287","271","66","624","1065","0","58.59","26.95"
"65","000","00","005","0567","0490","636","278","358","37","673","1040","0","64.71","26.73"
"65","000","00","005","0568","0000","1235","633","602","62","1297","2340","0","55.43","27.05"
"65","000","00","005","0568","0456","649","350","299","36","685","1298","0","52.77","26.96"
"65","000","00","005","0568","0457","586","283","303","26","612","1042","0","58.73","27.16"
"65","000","00","005","0569","0000","1602","781","821","72","1674","2712","0","61.73","28.8"
"65","000","00","005","0569","0495","818","396","422","36","854","1362","0","62.7","29.07"
"65","000","00","005","0569","0496","784","385","399","36","820","1350","0","60.74","28.52"
"65","000","00","005","0570","0000","3205","1496","1709","139","3344","5880","0","56.87","25.44"
"65","000","00","005","0570","0512","827","373","454","42","869","1488","0","58.4","25.07"
"65","000","00","005","0570","0513","780","378","402","42","822","1444","0","56.93","26.18"
"65","000","00","005","0570","0514","800","374","426","37","837","1499","0","55.84","24.95"
"65","000","00","005","0570","0515","798","371","427","18","816","1449","0","56.31","25.6"
"65","000","00","005","0571","0000","2208","1103","1105","232","2440","4371","0","55.82","25.23"
"65","000","00","005","0571","0520","783","389","394","39","822","1457","0","56.42","26.7"
"65","000","00","005","0571","0521","790","371","419","39","829","1502","0","55.19","24.7"
"65","000","00","005","0571","0522","635","343","292","154","789","1412","0","55.88","24.29"
"65","000","00","005","0572","0000","2923","1364","1559","138","3061","5129","0","59.68","26.59"
"65","000","00","005","0572","0336","723","295","428","47","770","1276","0","60.34","23.12"
"65","000","00","005","0572","0337","715","369","346","20","735","1303","0","56.41","28.32"
"65","000","00","005","0572","0338","736","371","365","38","774","1259","0","61.48","29.47"
"65","000","00","005","0572","0339","749","329","420","33","782","1291","0","60.57","25.48"
"65","000","00","005","0573","0000","1792","839","953","55","1847","3209","0","57.56","26.15"
"65","000","00","005","0573","0356","859","406","453","26","885","1538","0","57.54","26.4"
"65","000","00","005","0573","0357","933","433","500","29","962","1671","0","57.57","25.91"
"65","000","00","005","0574","0000","2312","1049","1263","91","2403","3841","0","62.56","27.31"
"65","000","00","005","0574","0350","765","311","454","26","791","1300","0","60.85","23.92"
"65","000","00","005","0574","0351","751","345","406","31","782","1286","0","60.81","26.83"
"65","000","00","005","0574","0352","796","393","403","34","830","1255","0","66.14","31.31"
"65","000","00","005","0575","0000","4183","1832","2351","137","4320","7288","0","59.28","25.14"
"65","000","00","005","0575","0424","849","387","462","27","876","1462","0","59.92","26.47"
"65","000","00","005","0575","0425","857","341","516","27","884","1484","0","59.57","22.98"
"65","000","00","005","0575","0426","807","339","468","36","843","1461","0","57.7","23.2"
"65","000","00","005","0575","0427","837","377","460","23","860","1444","0","59.56","26.11"
"65","000","00","005","0575","0428","833","388","445","24","857","1437","0","59.64","27.0"
"65","000","00","005","0576","0000","5388","2320","3068","204","5592","9313","0","60.05","24.91"
"65","000","00","005","0576","0403","871","413","458","57","928","1495","0","62.07","27.63"
"65","000","00","005","0576","0404","873","401","472","41","914","1486","0","61.51","26.99"
"65","000","00","005","0576","0405","899","401","498","29","928","1483","0","62.58","27.04"
"65","000","00","005","0576","0406","818","318","500","39","857","1553","0","55.18","20.48"
"65","000","00","005","0576","0407","992","413","579","17","1009","1625","0","62.09","25.42"
"65","000","00","005","0576","0408","935","374","561","21","956","1671","0","57.21","22.38"
"65","000","00","005","0577","0000","1233","592","641","72","1305","2159","0","60.44","27.42"
"65","000","00","005","0577","0450","593","273","320","35","628","1063","0","59.08","25.68"
"65","000","00","005","0577","0451","640","319","321","37","677","1096","0","61.77","29.11"
"65","000","00","005","0578","0000","1706","837","869","55","1761","3402","0","51.76","24.6"
"65","000","00","005","0578","0493","863","440","423","35","898","1704","0","52.7","25.82"
"65","000","00","005","0578","0494","843","397","446","20","863","1698","0","50.82","23.38"
"65","000","00","005","0579","0000","1059","455","604","70","1129","1981","0","56.99","22.97"
"65","000","00","005","0579","0478","534","206","328","26","560","1022","0","54.79","20.16"
"65","000","00","005","0579","0479","525","249","276","44","569","959","0","59.33","25.96"
"65","000","00","005","0580","0000","1197","581","616","54","1251","2131","0","58.7","27.26"
"65","000","00","005","0580","0469","594","282","312","34","628","1073","0","58.53","26.28"
"65","000","00","005","0580","0470","603","299","304","20","623","1058","0","58.88","28.26"
"65","000","00","005","0581","0000","1740","841","899","96","1836","3288","0","55.84","25.58"
"65","000","00","005","0581","0516","883","416","467","44","927","1640","0","56.52","25.37"
"65","000","00","005","0581","0517","857","425","432","52","909","1648","0","55.16","25.79"
"65","000","00","005","0582","0000","1982","944","1038","96","2078","3509","0","59.22","26.9"
"65","000","00","005","0582","0527","981","481","500","49","1030","1748","0","58.92","27.52"
"65","000","00","005","0582","0528","1001","463","538","47","1048","1761","0","59.51","26.29"
"65","000","00","005","0583","0000","2132","983","1149","125","2257","3784","0","59.65","25.98"
"65","000","00","005","0583","0534","702","320","382","26","728","1265","0","57.55","25.3"
"65","000","00","005","0583","0535","727","338","389","53","780","1282","0","60.84","26.37"
"65","000","00","005","0583","0536","703","325","378","46","749","1237","0","60.55","26.27"
"65","000","00","005","0584","0000","1333","669","664","91","1424","2465","0","57.77","27.14"
"65","000","00","005","0584","0540","693","373","320","43","736","1245","0","59.12","29.96"
"65","000","00","005","0584","0541","640","296","344","48","688","1220","0","56.39","24.26"
"65","000","00","006","0000","0000","144525","53250","91275","5978","150503","264053","302055","57.0","20.17"
"65","000","00","006","0601","0000","1653","557","1096","111","1764","3019","0","58.43","18.45"
"65","000","00","006","0601","2049","860","297","563","54","914","1552","0","58.89","19.14"
"65","000","00","006","0601","2050","793","260","533","57","850","1467","0","57.94","17.72"
"65","000","00","006","0602","0000","2069","720","1349","101","2170","3593","0","60.4","20.04"
"65","000","00","006","0602","2051","775","260","515","34","809","1371","0","59.01","18.96"
"65","000","00","006","0602","2052","585","213","372","24","609","991","0","61.45","21.49"
"65","000","00","006","0602","2053","709","247","462","43","752","1231","0","61.09","20.06"
"65","000","00","006","0603","0000","1934","724","1210","77","2011","3408","0","59.01","21.24"
"65","000","00","006","0603","2054","959","363","596","43","1002","1701","0","58.91","21.34"
"65","000","00","006","0603","2055","975","361","614","34","1009","1707","0","59.11","21.15"
"65","000","00","006","0604","0000","1933","738","1195","63","1996","3639","0","54.85","20.28"
"65","000","00","006","0604","2056","978","379","599","31","1009","1773","0","56.91","21.38"
"65","000","00","006","0604","2057","955","359","596","32","987","1866","0","52.89","19.24"
"65","000","00","006","0605","0000","2932","1030","1902","98","3030","4958","0","61.11","20.77"
"65","000","00","006","0605","2058","1013","348","665","28","1041","1735","0","60.0","20.06"
"65","000","00","006","0605","2059","1020","355","665","24","1044","1632","0","63.97","21.75"
"65","000","00","006","0605","2060","899","327","572","46","945","1591","0","59.4","20.55"
"65","000","00","006","0606","0000","2768","878","1890","116","2884","4790","0","60.21","18.33"
"65","000","00","006","0606","2063","701","272","429","40","741","1260","0","58.81","21.59"
"65","000","00","006","0606","2064","1124","349","775","42","1166","1948","0","59.86","17.92"
"65","000","00","006","0606","2065","943","257","686","34","977","1582","0","61.76","16.25"
"65","000","00","006","0607","0000","2804","923","1881","89","2893","5031","0","57.5","18.35"
"65","000","00","006","0607","2070","964","325","639","30","994","1735","0","57.29","18.73"
"65","000","00","006","0607","2071","935","289","646","35","970","1716","0","56.53","16.84"
"65","000","00","006","0607","2072","905","309","596","24","929","1580","0","58.8","19.56"
"65","000","00","006","0608","0000","3446","1348","2098","149","3595","5947","0","60.45","22.67"
"65","000","00","006","0608","2073","821","287","534","33","854","1358","0","62.89","21.13"
"65","000","00","006","0608","2074","951","364","587","52","1003","1610","0","62.3","22.61"
"65","000","00","006","0608","2075","769","338","431","30","799","1383","0","57.77","24.44"
"65","000","00","006","0608","2076","905","359","546","34","939","1596","0","58.83","22.49"
"65","000","00","006","0609","0000","1292","397","895","54","1346","2520","0","53.41","15.75"
"65","000","00","006","0609","2077","691","215","476","34","725","1360","0","53.31","15.81"
"65","000","00","006","0609","2078","601","182","419","20","621","1160","0","53.53","15.69"
"65","000","00","006","0610","0000","1561","347","1214","56","1617","2470","0","65.47","14.05"
"65","000","00","006","0610","2079","781","158","623","33","814","1236","0","65.86","12.78"
"65","000","00","006","0610","2080","780","189","591","23","803","1234","0","65.07","15.32"
"65","000","00","006","0611","0000","1562","658","904","73","1635","2820","0","57.98","23.33"
"65","000","00","006","0611","2081","882","394","488","42","924","1579","0","58.52","24.95"
"65","000","00","006","0611","2082","680","264","416","31","711","1241","0","57.29","21.27"
"65","000","00","006","0612","0000","757","323","434","38","795","1578","0","50.38","20.47"
"65","000","00","006","0612","2085","757","323","434","38","795","1578","0","50.38","20.47"
"65","000","00","006","0613","0000","1496","678","818","75","1571","2917","0","53.86","23.24"
"65","000","00","006","0613","2086","774","316","458","25","799","1442","0","55.41","21.91"
"65","000","00","006","0613","2087","722","362","360","50","772","1475","0","52.34","24.54"
"65","000","00","006","0614","0000","4264","1631","2633","213","4477","7921","0","56.52","20.59"
"65","000","00","006","0614","2088","874","315","559","48","922","1580","0","58.35","19.94"
"65","000","00","006","0614","2089","849","305","544","40","889","1585","0","56.09","19.24"
"65","000","00","006","0614","2090","847","389","458","48","895","1586","0","56.43","24.53"
"65","000","00","006","0614","2091","1033","382","651","45","1078","1931","0","55.83","19.78"
"65","000","00","006","0614","2092","661","240","421","32","693","1239","0","55.93","19.37"
"65","000","00","006","0615","0000","2425","978","1447","132","2557","4617","0","55.38","21.18"
"65","000","00","006","0615","2097","967","356","611","45","1012","1885","0","53.69","18.89"
"65","000","00","006","0615","2098","693","281","412","43","736","1345","0","54.72","20.89"
"65","000","00","006","0615","2099","765","341","424","44","809","1387","0","58.33","24.59"
"65","000","00","006","0616","0000","5548","2104","3444","254","5802","10556","0","54.96","19.93"
"65","000","00","006","0616","2105","936","359","577","57","993","1835","0","54.11","19.56"
"65","000","00","006","0616","2106","1040","385","655","49","1089","2009","0","54.21","19.16"
"65","000","00","006","0616","2107","765","297","468","47","812","1450","0","56.0","20.48"
"65","000","00","006","0616","2108","925","352","573","37","962","1726","0","55.74","20.39"
"65","000","00","006","0616","2109","938","368","570","36","974","1797","0","54.2","20.48"
"65","000","00","006","0616","2110","944","343","601","28","972","1739","0","55.89","19.72"
"65","000","00","006","0617","0000","2854","1253","1601","104","2958","5599","0","52.83","22.38"
"65","000","00","006","0617","2114","835","362","473","34","869","1662","0","52.29","21.78"
"65","000","00","006","0617","2115","1147","493","654","33","1180","2067","0","57.09","23.85"
"65","000","00","006","0617","2116","872","398","474","37","909","1870","0","48.61","21.28"
"65","000","00","006","0618","0000","2773","1217","1556","125","2898","5222","0","55.5","23.31"
"65","000","00","006","0618","2123","515","239","276","32","547","1079","0","50.7","22.15"
"65","000","00","006","0618","2124","601","261","340","30","631","1140","0","55.35","22.89"
"65","000","00","006","0618","2125","972","399","573","32","1004","1825","0","55.01","21.86"
"65","000","00","006","0618","2126","685","318","367","31","716","1178","0","60.78","26.99"
"65","000","00","006","0619","0000","2517","1035","1482","113","2630","5277","0","49.84","19.61"
"65","000","00","006","0619","2133","934","396","538","50","984","1992","0","49.4","19.88"
"65","000","00","006","0619","2134","820","330","490","26","846","1668","0","50.72","19.78"
"65","000","00","006","0619","2135","763","309","454","37","800","1617","0","49.47","19.11"
"65","000","00","006","0620","0000","2894","1025","1869","188","3082","5428","0","56.78","18.88"
"65","000","00","006","0620","2136","962","324","638","120","1082","2013","0","53.75","16.1"
"65","000","00","006","0620","2137","1033","382","651","33","1066","1791","0","59.52","21.33"
"65","000","00","006","0620","2138","899","319","580","35","934","1624","0","57.51","19.64"
"65","000","00","006","0621","0000","478","267","211","20","498","939","0","53.04","28.43"
"65","000","00","006","0621","2142","478","267","211","20","498","939","0","53.04","28.43"
"65","000","00","006","0622","0000","2647","1007","1640","101","2748","4725","0","58.16","21.31"
"65","000","00","006","0622","2148","1046","400","646","43","1089","1860","0","58.55","21.51"
"65","000","00","006","0622","2149","890","355","535","31","921","1743","0","52.84","20.37"
"65","000","00","006","0622","2150","711","252","459","27","738","1122","0","65.78","22.46"
"65","000","00","006","0623","0000","2425","925","1500","105","2530","4575","0","55.3","20.22"
"65","000","00","006","0623","2151","786","305","481","39","825","1468","0","56.2","20.78"
"65","000","00","006","0623","2152","947","335","612","33","980","1763","0","55.59","19.0"
"65","000","00","006","0623","2153","692","285","407","33","725","1344","0","53.94","21.21"
"65","000","00","006","0624","0000","381","196","185","31","412","753","0","54.71","26.03"
"65","000","00","006","0624","2154","381","196","185","31","412","753","0","54.71","26.03"
"65","000","00","006","0625","0000","1496","661","835","40","1536","2839","0","54.1","23.28"
"65","000","00","006","0625","2155","346","174","172","8","354","602","0","58.8","28.9"
"65","000","00","006","0625","2156","1150","487","663","32","1182","2237","0","52.84","21.77"
"65","000","00","006","0626","0000","1104","514","590","49","1153","2239","0","51.5","22.96"
"65","000","00","006","0626","2157","591","293","298","24","615","1096","0","56.11","26.73"
"65","000","00","006","0626","2158","513","221","292","25","538","1143","0","47.07","19.34"
"65","000","00","006","0627","0000","784","388","396","42","826","1569","0","52.64","24.73"
"65","000","00","006","0627","2159","784","388","396","42","826","1569","0","52.64","24.73"
"65","000","00","006","0628","0000","684","369","315","39","723","1284","0","56.31","28.74"
"65","000","00","006","0628","2160","684","369","315","39","723","1284","0","56.31","28.74"
"65","000","00","006","0629","0000","566","277","289","37","603","1189","0","50.71","23.3"
"65","000","00","006","0629","2161","155","83","72","10","165","439","0","37.59","18.91"
"65","000","00","006","0629","2162","411","194","217","27","438","750","0","58.4","25.87"
"65","000","00","006","0630","0000","2493","958","1535","128","2621","4840","0","54.15","19.79"
"65","000","00","006","0630","2145","916","372","544","53","969","1838","0","52.72","20.24"
"65","000","00","006","0630","2146","784","260","524","32","816","1453","0","56.16","17.89"
"65","000","00","006","0630","2147","793","326","467","43","836","1549","0","53.97","21.05"
"65","000","00","006","0631","0000","890","427","463","37","927","1603","0","57.83","26.64"
"65","000","00","006","0631","1987","890","427","463","37","927","1603","0","57.83","26.64"
"65","000","00","006","0632","0000","1060","410","650","37","1097","1921","0","57.11","21.34"
"65","000","00","006","0632","1988","1060","410","650","37","1097","1921","0","57.11","21.34"
"65","000","00","006","0633","0000","1282","503","779","44","1326","2317","0","57.23","21.71"
"65","000","00","006","0633","1989","585","237","348","16","601","1082","0","55.55","21.9"
"65","000","00","006","0633","1990","697","266","431","28","725","1235","0","58.7","21.54"
"65","000","00","006","0634","0000","907","343","564","17","924","1568","0","58.93","21.88"
"65","000","00","006","0634","1991","907","343","564","17","924","1568","0","58.93","21.88"
"65","000","00","006","0635","0000","458","247","211","13","471","771","0","61.09","32.04"
"65","000","00","006","0635","1992","458","247","211","13","471","771","0","61.09","32.04"
"65","000","00","006","0636","0000","1259","539","720","71","1330","2264","0","58.75","23.81"
"65","000","00","006","0636","1993","687","311","376","35","722","1256","0","57.48","24.76"
"65","000","00","006","0636","1994","572","228","344","36","608","1008","0","60.32","22.62"
"65","000","00","006","0637","0000","2703","896","1807","112","2815","4701","0","59.88","19.06"
"65","000","00","006","0637","1995","849","245","604","44","893","1515","0","58.94","16.17"
"65","000","00","006","0637","1996","989","319","670","31","1020","1637","0","62.31","19.49"
"65","000","00","006","0637","1997","865","332","533","37","902","1549","0","58.23","21.43"
"65","000","00","006","0638","0000","3040","1090","1950","131","3171","5335","0","59.44","20.43"
"65","000","00","006","0638","1998","1221","348","873","43","1264","2011","0","62.85","17.3"
"65","000","00","006","0638","1999","876","381","495","37","913","1554","0","58.75","24.52"
"65","000","00","006","0638","2000","943","361","582","51","994","1770","0","56.16","20.4"
"65","000","00","006","0639","0000","1350","539","811","81","1431","2442","0","58.6","22.07"
"65","000","00","006","0639","2001","740","303","437","43","783","1316","0","59.5","23.02"
"65","000","00","006","0639","2002","610","236","374","38","648","1126","0","57.55","20.96"
"65","000","00","006","0640","0000","4427","1596","2831","196","4623","7834","0","59.01","20.37"
"65","000","00","006","0640","2003","772","337","435","29","801","1460","0","54.86","23.08"
"65","000","00","006","0640","2004","905","330","575","46","951","1584","0","60.04","20.83"
"65","000","00","006","0640","2005","792","298","494","43","835","1449","0","57.63","20.57"
"65","000","00","006","0640","2006","917","309","608","41","958","1520","0","63.03","20.33"
"65","000","00","006","0640","2007","1041","322","719","37","1078","1821","0","59.2","17.68"
"65","000","00","006","0641","0000","3853","1408","2445","114","3967","6728","0","58.96","20.93"
"65","000","00","006","0641","2008","1115","414","701","29","1144","1956","0","58.49","21.17"
"65","000","00","006","0641","2009","944","339","605","42","986","1665","0","59.22","20.36"
"65","000","00","006","0641","2010","944","323","621","27","971","1588","0","61.15","20.34"
"65","000","00","006","0641","2011","850","332","518","16","866","1519","0","57.01","21.86"
"65","000","00","006","0642","0000","2273","801","1472","115","2388","5969","0","40.01","13.42"
"65","000","00","006","0642","2014","653","210","443","45","698","1106","0","63.11","18.99"
"65","000","00","006","0642","2015","396","167","229","19","415","2700","0","15.37","6.19"
"65","000","00","006","0642","2016","582","189","393","20","602","995","0","60.5","18.99"
"65","000","00","006","0642","2017","642","235","407","31","673","1168","0","57.62","20.12"
"65","000","00","006","0643","0000","1418","513","905","54","1472","2208","0","66.67","23.23"
"65","000","00","006","0643","2018","739","244","495","24","763","1123","0","67.94","21.73"
"65","000","00","006","0643","2019","679","269","410","30","709","1085","0","65.35","24.79"
"65","000","00","006","0644","0000","3243","1094","2149","143","3386","5645","0","59.98","19.38"
"65","000","00","006","0644","2020","860","306","554","34","894","1412","0","63.31","21.67"
"65","000","00","006","0644","2021","939","334","605","39","978","1659","0","58.95","20.13"
"65","000","00","006","0644","2022","729","207","522","42","771","1198","0","64.36","17.28"
"65","000","00","006","0644","2023","715","247","468","28","743","1376","0","54.0","17.95"
"65","000","00","006","0645","0000","2148","688","1460","69","2217","3926","0","56.47","17.52"
"65","000","00","006","0645","2024","709","228","481","26","735","1300","0","56.54","17.54"
"65","000","00","006","0645","2025","706","224","482","25","731","1238","0","59.05","18.09"
"65","000","00","006","0645","2026","733","236","497","18","751","1388","0","54.11","17.0"
"65","000","00","006","0646","0000","1140","491","649","44","1184","1841","0","64.31","26.67"
"65","000","00","006","0646","2027","565","314","251","31","596","933","0","63.88","33.65"
"65","000","00","006","0646","2028","575","177","398","13","588","908","0","64.76","19.49"
"65","000","00","006","0647","0000","2044","699","1345","113","2157","3508","0","61.49","19.93"
"65","000","00","006","0647","2031","565","190","375","39","604","971","0","62.2","19.57"
"65","000","00","006","0647","2032","673","211","462","37","710","1145","0","62.01","18.43"
"65","000","00","006","0647","2033","806","298","508","37","843","1392","0","60.56","21.41"
"65","000","00","006","0648","0000","1680","624","1056","80","1760","2892","0","60.86","21.58"
"65","000","00","006","0648","2034","879","333","546","39","918","1452","0","63.22","22.93"
"65","000","00","006","0648","2035","801","291","510","41","842","1440","0","58.47","20.21"
"65","000","00","006","0649","0000","2002","1052","950","90","2092","3611","0","57.93","29.13"
"65","000","00","006","0649","2036","974","386","588","50","1024","1786","0","57.33","21.61"
"65","000","00","006","0649","2037","1028","666","362","40","1068","1825","0","58.52","36.49"
"65","000","00","006","0650","0000","1899","685","1214","53","1952","3227","0","60.49","21.23"
"65","000","00","006","0650","2038","902","336","566","18","920","1477","0","62.29","22.75"
"65","000","00","006","0650","2039","997","349","648","35","1032","1750","0","58.97","19.94"
"65","000","00","006","0651","0000","2076","582","1494","75","2151","3771","0","57.04","15.43"
"65","000","00","006","0651","2040","986","259","727","36","1022","1792","0","57.03","14.45"
"65","000","00","006","0651","2041","1090","323","767","39","1129","1979","0","57.05","16.32"
"65","000","00","006","0652","0000","2450","699","1751","68","2518","4133","0","60.92","16.91"
"65","000","00","006","0652","2042","490","136","354","16","506","826","0","61.26","16.46"
"65","000","00","006","0652","2043","1114","309","805","32","1146","1924","0","59.56","16.06"
"65","000","00","006","0652","2044","846","254","592","20","866","1383","0","62.62","18.37"
"65","000","00","006","0653","0000","397","152","245","29","426","830","0","51.33","18.31"
"65","000","00","006","0653","2045","397","152","245","29","426","830","0","51.33","18.31"
"65","000","00","006","0654","0000","3069","970","2099","96","3165","5197","0","60.9","18.66"
"65","000","00","006","0654","2046","1041","335","706","29","1070","1759","0","60.83","19.04"
"65","000","00","006","0654","2047","1141","345","796","44","1185","1957","0","60.55","17.63"
"65","000","00","006","0654","2048","887","290","597","23","910","1481","0","61.44","19.58"
"65","000","00","006","0655","0000","1865","617","1248","59","1924","3135","0","61.37","19.68"
"65","000","00","006","0655","2119","1003","341","662","34","1037","1712","0","60.57","19.92"
"65","000","00","006","0655","2120","862","276","586","25","887","1423","0","62.33","19.4"
"65","000","00","006","0656","0000","3520","1369","2151","133","3653","6684","0","54.65","20.48"
"65","000","00","006","0656","2093","1015","405","610","35","1050","1892","0","55.5","21.41"
"65","000","00","006","0656","2094","784","323","461","38","822","1529","0","53.76","21.12"
"65","000","00","006","0656","2095","764","295","469","27","791","1358","0","58.25","21.72"
"65","000","00","006","0656","2096","957","346","611","33","990","1905","0","51.97","18.16"
"65","000","00","006","0657","0000","2472","638","1834","64","2536","4334","0","58.51","14.72"
"65","000","00","006","0657","2139","693","210","483","22","715","1178","0","60.7","17.83"
"65","000","00","006","0657","2140","733","215","518","19","752","1277","0","58.89","16.84"
"65","000","00","006","0657","2141","1046","213","833","23","1069","1879","0","56.89","11.34"
"65","000","00","006","0658","0000","3609","1292","2317","125","3734","6377","0","58.55","20.26"
"65","000","00","006","0658","2066","756","306","450","16","772","1315","0","58.71","23.27"
"65","000","00","006","0658","2067","842","339","503","31","873","1562","0","55.89","21.7"
"65","000","00","006","0658","2068","1142","337","805","38","1180","1982","0","59.54","17.0"
"65","000","00","006","0658","2069","869","310","559","40","909","1518","0","59.88","20.42"
"65","000","00","006","0659","0000","2016","601","1415","95","2111","3435","0","61.46","17.5"
"65","000","00","006","0659","2121","964","336","628","48","1012","1666","0","60.74","20.17"
"65","000","00","006","0659","2122","1052","265","787","47","1099","1769","0","62.13","14.98"
"65","000","00","006","0660","0000","4751","1582","3169","173","4924","9469","0","52.0","16.71"
"65","000","00","006","0660","2127","777","274","503","26","803","1463","0","54.89","18.73"
"65","000","00","006","0660","2128","633","230","403","34","667","1152","0","57.9","19.97"
"65","000","00","006","0660","2129","918","304","614","35","953","2008","0","47.46","15.14"
"65","000","00","006","0660","2130","942","301","641","33","975","2120","0","45.99","14.2"
"65","000","00","006","0660","2131","675","218","457","19","694","1153","0","60.19","18.91"
"65","000","00","006","0660","2132","806","255","551","26","832","1573","0","52.89","16.21"
"65","000","00","006","0661","0000","1607","532","1075","89","1696","2829","0","59.95","18.81"
"65","000","00","006","0661","2029","867","299","568","48","915","1582","0","57.84","18.9"
"65","000","00","006","0661","2030","740","233","507","41","781","1247","0","62.63","18.68"
"65","000","00","006","0662","0000","1548","580","968","67","1615","3006","0","53.73","19.29"
"65","000","00","006","0662","2061","774","315","459","46","820","1495","0","54.85","21.07"
"65","000","00","006","0662","2062","774","265","509","21","795","1511","0","52.61","17.54"
"65","000","00","006","0663","0000","1316","486","830","54","1370","2489","0","55.04","19.53"
"65","000","00","006","0663","2083","700","268","432","22","722","1275","0","56.63","21.02"
"65","000","00","006","0663","2084","616","218","398","32","648","1214","0","53.38","17.96"
"65","000","00","006","0664","0000","2627","959","1668","76","2703","4809","0","56.21","19.94"
"65","000","00","006","0664","2111","834","296","538","29","863","1523","0","56.66","19.44"
"65","000","00","006","0664","2112","890","326","564","24","914","1642","0","55.66","19.85"
"65","000","00","006","0664","2113","903","337","566","23","926","1644","0","56.33","20.5"
"65","000","00","006","0665","0000","1417","518","899","37","1454","2280","0","63.77","22.72"
"65","000","00","006","0665","2012","735","272","463","18","753","1185","0","63.54","22.95"
"65","000","00","006","0665","2013","682","246","436","19","701","1095","0","64.02","22.47"
"65","000","00","006","0666","0000","2028","749","1279","87","2115","3797","0","55.7","19.73"
"65","000","00","006","0666","2100","1040","357","683","42","1082","1960","0","55.2","18.21"
"65","000","00","006","0666","2101","988","392","596","45","1033","1837","0","56.23","21.34"
"65","000","00","006","0667","0000","2822","1060","1762","112","2934","4983","0","58.88","21.27"
"65","000","00","006","0667","2102","917","358","559","41","958","1662","0","57.64","21.54"
"65","000","00","006","0667","2103","953","343","610","43","996","1617","0","61.6","21.21"
"65","000","00","006","0667","2104","952","359","593","28","980","1704","0","57.51","21.07"
"65","000","00","006","0668","0000","1923","586","1337","60","1983","3528","0","56.21","16.61"
"65","000","00","006","0668","2117","1048","322","726","37","1085","1982","0","54.74","16.25"
"65","000","00","006","0668","2118","875","264","611","23","898","1546","0","58.09","17.08"
"65","000","00","006","0669","0000","1396","507","889","44","1440","2394","0","60.15","21.18"
"65","000","00","006","0669","2143","527","200","327","26","553","960","0","57.6","20.83"
"65","000","00","006","0669","2144","869","307","562","18","887","1434","0","61.85","21.41"
"65","000","00","007","0000","0000","80782","38133","42649","4017","84799","152102","183780","55.75","25.07"
"65","000","00","007","0701","0000","1704","873","831","105","1809","3613","0","50.07","24.16"
"65","000","00","007","0701","1620","845","420","425","52","897","1897","0","47.29","22.14"
"65","000","00","007","0701","1621","859","453","406","53","912","1716","0","53.15","26.4"
"65","000","00","007","0702","0000","1879","896","983","104","1983","3470","0","57.15","25.82"
"65","000","00","007","0702","1617","592","299","293","41","633","1211","0","52.27","24.69"
"65","000","00","007","0702","1618","631","282","349","32","663","1125","0","58.93","25.07"
"65","000","00","007","0702","1619","656","315","341","31","687","1134","0","60.58","27.78"
"65","000","00","007","0703","0000","2109","1042","1067","113","2222","4252","0","52.26","24.51"
"65","000","00","007","0703","1614","701","306","395","44","745","1408","0","52.91","21.73"
"65","000","00","007","0703","1615","685","336","349","29","714","1310","0","54.5","25.65"
"65","000","00","007","0703","1616","723","400","323","40","763","1534","0","49.74","26.08"
"65","000","00","007","0704","0000","1727","920","807","70","1797","3296","0","54.52","27.91"
"65","000","00","007","0704","1643","616","322","294","40","656","1116","0","58.78","28.85"
"65","000","00","007","0704","1644","549","315","234","17","566","1077","0","52.55","29.25"
"65","000","00","007","0704","1645","562","283","279","13","575","1103","0","52.13","25.66"
"65","000","00","007","0705","0000","2967","1389","1578","122","3089","5619","0","54.97","24.72"
"65","000","00","007","0705","1639","764","342","422","21","785","1483","0","52.93","23.06"
"65","000","00","007","0705","1640","802","365","437","38","840","1524","0","55.12","23.95"
"65","000","00","007","0705","1641","782","383","399","26","808","1431","0","56.46","26.76"
"65","000","00","007","0705","1642","619","299","320","37","656","1181","0","55.55","25.32"
"65","000","00","007","0706","0000","1974","972","1002","115","2089","4297","0","48.62","22.62"
"65","000","00","007","0706","1633","685","381","304","33","718","1927","0","37.26","19.77"
"65","000","00","007","0706","1634","488","221","267","36","524","914","0","57.33","24.18"
"65","000","00","007","0706","1635","801","370","431","46","847","1456","0","58.17","25.41"
"65","000","00","007","0707","0000","2254","1095","1159","91","2345","4468","0","52.48","24.51"
"65","000","00","007","0707","1624","783","384","399","29","812","1542","0","52.66","24.9"
"65","000","00","007","0707","1625","782","377","405","35","817","1470","0","55.58","25.65"
"65","000","00","007","0707","1626","689","334","355","27","716","1456","0","49.18","22.94"
"65","000","00","007","0708","0000","1799","861","938","93","1892","3218","0","58.79","26.76"
"65","000","00","007","0708","1652","482","209","273","21","503","870","0","57.82","24.02"
"65","000","00","007","0708","1653","782","388","394","42","824","1338","0","61.58","29.0"
"65","000","00","007","0708","1654","535","264","271","30","565","1010","0","55.94","26.14"
"65","000","00","007","0709","0000","2549","1100","1449","137","2686","4558","0","58.93","24.13"
"65","000","00","007","0709","1657","827","348","479","67","894","1405","0","63.63","24.77"
"65","000","00","007","0709","1658","856","368","488","35","891","1587","0","56.14","23.19"
"65","000","00","007","0709","1659","866","384","482","35","901","1566","0","57.54","24.52"
"65","000","00","007","0710","0000","2135","1075","1060","109","2244","3749","0","59.86","28.67"
"65","000","00","007","0710","1667","726","392","334","51","777","1268","0","61.28","30.91"
"65","000","00","007","0710","1668","728","331","397","27","755","1281","0","58.94","25.84"
"65","000","00","007","0710","1669","681","352","329","31","712","1200","0","59.33","29.33"
"65","000","00","007","0711","0000","1635","664","971","74","1709","2979","0","57.37","22.29"
"65","000","00","007","0711","1663","942","376","566","40","982","1701","0","57.73","22.1"
"65","000","00","007","0711","1664","693","288","405","34","727","1278","0","56.89","22.54"
"65","000","00","007","0712","0000","765","394","371","41","806","1491","0","54.06","26.43"
"65","000","00","007","0712","1670","765","394","371","41","806","1491","0","54.06","26.43"
"65","000","00","007","0713","0000","565","261","304","26","591","1066","0","55.44","24.48"
"65","000","00","007","0713","1671","565","261","304","26","591","1066","0","55.44","24.48"
"65","000","00","007","0714","0000","1691","753","938","61","1752","3132","0","55.94","24.04"
"65","000","00","007","0714","1686","849","376","473","45","894","1566","0","57.09","24.01"
"65","000","00","007","0714","1687","842","377","465","16","858","1566","0","54.79","24.07"
"65","000","00","007","0715","0000","1856","950","906","102","1958","3427","0","57.13","27.72"
"65","000","00","007","0715","1676","650","333","317","39","689","1144","0","60.23","29.11"
"65","000","00","007","0715","1677","566","298","268","19","585","1059","0","55.24","28.14"
"65","000","00","007","0715","1678","640","319","321","44","684","1224","0","55.88","26.06"
"65","000","00","007","0716","0000","2273","1139","1134","137","2410","4452","0","54.13","25.58"
"65","000","00","007","0716","1683","779","414","365","59","838","1514","0","55.35","27.34"
"65","000","00","007","0716","1684","750","334","416","42","792","1546","0","51.23","21.6"
"65","000","00","007","0716","1685","744","391","353","36","780","1392","0","56.03","28.09"
"65","000","00","007","0717","0000","2325","1109","1216","117","2442","4572","0","53.41","24.26"
"65","000","00","007","0717","1673","833","400","433","47","880","1616","0","54.46","24.75"
"65","000","00","007","0717","1674","725","375","350","36","761","1589","0","47.89","23.6"
"65","000","00","007","0717","1675","767","334","433","34","801","1367","0","58.6","24.43"
"65","000","00","007","0718","0000","1479","769","710","94","1573","2883","0","54.56","26.67"
"65","000","00","007","0718","1699","819","426","393","37","856","1606","0","53.3","26.53"
"65","000","00","007","0718","1700","660","343","317","57","717","1277","0","56.15","26.86"
"65","000","00","007","0719","0000","2760","1323","1437","148","2908","5231","0","55.59","25.29"
"65","000","00","007","0719","1695","651","320","331","49","700","1247","0","56.13","25.66"
"65","000","00","007","0719","1696","707","341","366","48","755","1390","0","54.32","24.53"
"65","000","00","007","0719","1697","709","333","376","34","743","1293","0","57.46","25.75"
"65","000","00","007","0719","1698","693","329","364","17","710","1301","0","54.57","25.29"
"65","000","00","007","0720","0000","2389","1136","1253","131","2520","4264","0","59.1","26.64"
"65","000","00","007","0720","1692","946","469","477","57","1003","1661","0","60.39","28.24"
"65","000","00","007","0720","1693","850","412","438","49","899","1585","0","56.72","25.99"
"65","000","00","007","0720","1694","593","255","338","25","618","1018","0","60.71","25.05"
"65","000","00","007","0721","0000","740","360","380","29","769","1683","0","45.69","21.39"
"65","000","00","007","0721","1708","740","360","380","29","769","1683","0","45.69","21.39"
"65","000","00","007","0722","0000","728","396","332","40","768","1565","0","49.07","25.3"
"65","000","00","007","0722","1722","728","396","332","40","768","1565","0","49.07","25.3"
"65","000","00","007","0723","0000","921","432","489","66","987","1638","0","60.26","26.37"
"65","000","00","007","0723","1714","921","432","489","66","987","1638","0","60.26","26.37"
"65","000","00","007","0724","0000","6373","2517","3856","242","6615","11772","0","56.19","21.38"
"65","000","00","007","0724","1715","820","368","452","34","854","1592","0","53.64","23.12"
"65","000","00","007","0724","1716","853","348","505","31","884","1521","0","58.12","22.88"
"65","000","00","007","0724","1717","990","376","614","47","1037","1707","0","60.75","22.03"
"65","000","00","007","0724","1718","983","370","613","35","1018","1741","0","58.47","21.25"
"65","000","00","007","0724","1719","906","340","566","21","927","1655","0","56.01","20.54"
"65","000","00","007","0724","1720","880","368","512","35","915","1775","0","51.55","20.73"
"65","000","00","007","0724","1721","941","347","594","39","980","1781","0","55.03","19.48"
"65","000","00","007","0725","0000","1072","557","515","43","1115","1966","0","56.71","28.33"
"65","000","00","007","0725","1723","482","239","243","23","505","936","0","53.95","25.53"
"65","000","00","007","0725","1724","590","318","272","20","610","1030","0","59.22","30.87"
"65","000","00","007","0726","0000","4351","1705","2646","141","4492","7662","0","58.63","22.25"
"65","000","00","007","0726","1709","809","388","421","38","847","1452","0","58.33","26.72"
"65","000","00","007","0726","1710","893","329","564","30","923","1592","0","57.98","20.67"
"65","000","00","007","0726","1711","926","352","574","26","952","1619","0","58.8","21.74"
"65","000","00","007","0726","1712","981","370","611","24","1005","1642","0","61.21","22.53"
"65","000","00","007","0726","1713","742","266","476","23","765","1357","0","56.37","19.6"
"65","000","00","007","0727","0000","531","297","234","34","565","877","0","64.42","33.87"
"65","000","00","007","0727","1672","531","297","234","34","565","877","0","64.42","33.87"
"65","000","00","007","0728","0000","2006","995","1011","117","2123","3846","0","55.2","25.87"
"65","000","00","007","0728","1646","740","390","350","36","776","1385","0","56.03","28.16"
"65","000","00","007","0728","1647","655","309","346","33","688","1266","0","54.34","24.41"
"65","000","00","007","0728","1648","611","296","315","48","659","1195","0","55.15","24.77"
"65","000","00","007","0729","0000","1727","772","955","81","1808","3245","0","55.72","23.79"
"65","000","00","007","0729","1660","527","200","327","18","545","997","0","54.66","20.06"
"65","000","00","007","0729","1661","649","304","345","34","683","1187","0","57.54","25.61"
"65","000","00","007","0729","1662","551","268","283","29","580","1061","0","54.67","25.26"
"65","000","00","007","0730","0000","1832","826","1006","103","1935","3196","0","60.54","25.84"
"65","000","00","007","0730","1655","906","390","516","60","966","1658","0","58.26","23.52"
"65","000","00","007","0730","1656","926","436","490","43","969","1538","0","63.0","28.35"
"65","000","00","007","0731","0000","1939","985","954","66","2005","3571","0","56.15","27.58"
"65","000","00","007","0731","1627","639","333","306","19","658","1124","0","58.54","29.63"
"65","000","00","007","0731","1628","636","321","315","23","659","1235","0","53.36","25.99"
"65","000","00","007","0731","1629","664","331","333","24","688","1212","0","56.77","27.31"
"65","000","00","007","0732","0000","1949","994","955","98","2047","3764","0","54.38","26.41"
"65","000","00","007","0732","1630","604","315","289","33","637","1223","0","52.09","25.76"
"65","000","00","007","0732","1631","709","358","351","37","746","1335","0","55.88","26.82"
"65","000","00","007","0732","1632","636","321","315","28","664","1206","0","55.06","26.62"
"65","000","00","007","0733","0000","2550","1256","1294","141","2691","5192","0","51.83","24.19"
"65","000","00","007","0733","1679","590","276","314","34","624","1141","0","54.69","24.19"
"65","000","00","007","0733","1680","622","279","343","25","647","1396","0","46.35","19.99"
"65","000","00","007","0733","1681","616","308","308","22","638","1157","0","55.14","26.62"
"65","000","00","007","0733","1682","722","393","329","60","782","1498","0","52.2","26.23"
"65","000","00","007","0734","0000","2436","1165","1271","128","2564","4454","0","57.57","26.16"
"65","000","00","007","0734","1636","748","350","398","39","787","1409","0","55.86","24.84"
"65","000","00","007","0734","1637","856","422","434","50","906","1500","0","60.4","28.13"
"65","000","00","007","0734","1638","832","393","439","39","871","1545","0","56.38","25.44"
"65","000","00","007","0735","0000","2673","1246","1427","139","2812","4995","0","56.3","24.94"
"65","000","00","007","0735","1701","651","346","305","49","700","1219","0","57.42","28.38"
"65","000","00","007","0735","1702","733","346","387","31","764","1454","0","52.54","23.8"
"65","000","00","007","0735","1703","670","258","412","35","705","1314","0","53.65","19.63"
"65","000","00","007","0735","1704","619","296","323","24","643","1008","0","63.79","29.37"
"65","000","00","007","0736","0000","2369","1141","1228","150","2519","4615","0","54.58","24.72"
"65","000","00","007","0736","1705","791","402","389","59","850","1574","0","54.0","25.54"
"65","000","00","007","0736","1706","766","358","408","40","806","1364","0","59.09","26.25"
"65","000","00","007","0736","1707","812","381","431","51","863","1677","0","51.46","22.72"
"65","000","00","007","0737","0000","1597","732","865","90","1687","2739","0","61.59","26.73"
"65","000","00","007","0737","1665","837","377","460","42","879","1433","0","61.34","26.31"
"65","000","00","007","0737","1666","760","355","405","48","808","1306","0","61.87","27.18"
"65","000","00","007","0738","0000","1572","710","862","89","1661","2998","0","55.4","23.68"
"65","000","00","007","0738","1688","777","355","422","53","830","1517","0","54.71","23.4"
"65","000","00","007","0738","1689","795","355","440","36","831","1481","0","56.11","23.97"
"65","000","00","007","0739","0000","1255","606","649","52","1307","2424","0","53.92","25.0"
"65","000","00","007","0739","1690","656","313","343","32","688","1261","0","54.56","24.82"
"65","000","00","007","0739","1691","599","293","306","20","619","1163","0","53.22","25.19"
"65","000","00","007","0740","0000","1349","669","680","73","1422","2517","0","56.5","26.58"
"65","000","00","007","0740","1649","645","332","313","41","686","1254","0","54.7","26.48"
"65","000","00","007","0740","1650","704","337","367","32","736","1263","0","58.27","26.68"
"65","000","00","007","0741","0000","867","484","383","51","918","1473","0","62.32","32.86"
"65","000","00","007","0741","1651","867","484","383","51","918","1473","0","62.32","32.86"
"65","000","00","007","0742","0000","1110","567","543","54","1164","1873","0","62.15","30.27"
"65","000","00","007","0742","1622","431","230","201","28","459","736","0","62.36","31.25"
"65","000","00","007","0742","1623","679","337","342","26","705","1137","0","62.01","29.64"
"65","000","00","008","0000","0000","36651","17470","19181","1688","38339","71645","86223","53.51","24.38"
"65","000","00","008","0801","0000","550","303","247","35","585","965","0","60.62","31.4"
"65","000","00","008","0801","1726","550","303","247","35","585","965","0","60.62","31.4"
"65","000","00","008","0802","0000","1075","508","567","44","1119","2019","0","55.42","25.16"
"65","000","00","008","0802","1729","574","263","311","31","605","1057","0","57.24","24.88"
"65","000","00","008","0802","1730","501","245","256","13","514","962","0","53.43","25.47"
"65","000","00","008","0803","0000","2720","1305","1415","109","2829","5052","0","56.0","25.83"
"65","000","00","008","0803","1732","1027","497","530","47","1074","1742","0","61.65","28.53"
"65","000","00","008","0803","1733","848","425","423","39","887","1634","0","54.28","26.01"
"65","000","00","008","0803","1734","845","383","462","23","868","1676","0","51.79","22.85"
"65","000","00","008","0804","0000","1867","853","1014","93","1960","3728","0","52.58","22.88"
"65","000","00","008","0804","1727","1013","460","553","56","1069","1931","0","55.36","23.82"
"65","000","00","008","0804","1728","854","393","461","37","891","1797","0","49.58","21.87"
"65","000","00","008","0805","0000","566","269","297","23","589","934","0","63.06","28.8"
"65","000","00","008","0805","1731","566","269","297","23","589","934","0","63.06","28.8"
"65","000","00","008","0806","0000","281","139","142","15","296","515","0","57.48","26.99"
"65","000","00","008","0806","1725","281","139","142","15","296","515","0","57.48","26.99"
"65","000","00","008","0807","0000","813","421","392","32","845","1440","0","58.68","29.24"
"65","000","00","008","0807","1750","813","421","392","32","845","1440","0","58.68","29.24"
"65","000","00","008","0808","0000","3965","1772","2193","184","4149","7315","0","56.72","24.22"
"65","000","00","008","0808","1751","932","430","502","60","992","1809","0","54.84","23.77"
"65","000","00","008","0808","1752","945","406","539","46","991","1758","0","56.37","23.09"
"65","000","00","008","0808","1753","834","353","481","33","867","1589","0","54.56","22.22"
"65","000","00","008","0808","1754","626","300","326","25","651","1067","0","61.01","28.12"
"65","000","00","008","0808","1755","628","283","345","20","648","1092","0","59.34","25.92"
"65","000","00","008","0809","0000","1614","785","829","77","1691","3208","0","52.71","24.47"
"65","000","00","008","0809","1747","496","243","253","16","512","942","0","54.35","25.8"
"65","000","00","008","0809","1748","671","324","347","37","708","1317","0","53.76","24.6"
"65","000","00","008","0809","1749","447","218","229","24","471","949","0","49.63","22.97"
"65","000","00","008","0810","0000","3199","1497","1702","139","3338","6702","0","49.81","22.34"
"65","000","00","008","0810","1743","870","389","481","30","900","1737","0","51.81","22.39"
"65","000","00","008","0810","1744","807","362","445","44","851","1669","0","50.99","21.69"
"65","000","00","008","0810","1745","831","392","439","31","862","1842","0","46.8","21.28"
"65","000","00","008","0810","1746","691","354","337","34","725","1454","0","49.86","24.35"
"65","000","00","008","0811","0000","3394","1596","1798","157","3551","7102","0","50.0","22.47"
"65","000","00","008","0811","1739","877","377","500","39","916","1782","0","51.4","21.16"
"65","000","00","008","0811","1740","771","348","423","24","795","1496","0","53.14","23.26"
"65","000","00","008","0811","1741","994","496","498","45","1039","2071","0","50.17","23.95"
"65","000","00","008","0811","1742","752","375","377","49","801","1753","0","45.69","21.39"
"65","000","00","008","0812","0000","414","219","195","14","428","850","0","50.35","25.76"
"65","000","00","008","0812","1738","414","219","195","14","428","850","0","50.35","25.76"
"65","000","00","008","0813","0000","114","55","59","2","116","227","0","51.1","24.23"
"65","000","00","008","0813","1774","114","55","59","2","116","227","0","51.1","24.23"
"65","000","00","008","0814","0000","2372","1088","1284","96","2468","4604","0","53.61","23.63"
"65","000","00","008","0814","1768","710","341","369","19","729","1479","0","49.29","23.06"
"65","000","00","008","0814","1769","875","386","489","44","919","1736","0","52.94","22.24"
"65","000","00","008","0814","1770","787","361","426","33","820","1389","0","59.04","25.99"
"65","000","00","008","0815","0000","1962","943","1019","109","2071","4064","0","50.96","23.2"
"65","000","00","008","0815","1762","491","225","266","14","505","1026","0","49.22","21.93"
"65","000","00","008","0815","1763","826","399","427","43","869","1721","0","50.49","23.18"
"65","000","00","008","0815","1764","645","319","326","52","697","1317","0","52.92","24.22"
"65","000","00","008","0816","0000","1904","929","975","120","2024","3526","0","57.4","26.35"
"65","000","00","008","0816","1765","593","289","304","38","631","1046","0","60.33","27.63"
"65","000","00","008","0816","1766","649","326","323","42","691","1144","0","60.4","28.5"
"65","000","00","008","0816","1767","662","314","348","40","702","1336","0","52.54","23.5"
"65","000","00","008","0817","0000","2364","1111","1253","103","2467","4249","0","58.06","26.15"
"65","000","00","008","0817","1756","948","443","505","28","976","1730","0","56.42","25.61"
"65","000","00","008","0817","1757","686","317","369","31","717","1281","0","55.97","24.75"
"65","000","00","008","0817","1758","730","351","379","44","774","1238","0","62.52","28.35"
"65","000","00","008","0818","0000","2436","1158","1278","121","2557","5137","0","49.78","22.54"
"65","000","00","008","0818","1771","990","464","526","64","1054","1956","0","53.89","23.72"
"65","000","00","008","0818","1772","731","394","337","30","761","1371","0","55.51","28.74"
"65","000","00","008","0818","1773","715","300","415","27","742","1810","0","40.99","16.57"
"65","000","00","008","0819","0000","1991","946","1045","110","2101","4022","0","52.24","23.52"
"65","000","00","008","0819","1759","817","377","440","52","869","1568","0","55.42","24.04"
"65","000","00","008","0819","1760","654","305","349","36","690","1271","0","54.29","24.0"
"65","000","00","008","0819","1761","520","264","256","22","542","1183","0","45.82","22.32"
"65","000","00","008","0820","0000","3050","1573","1477","105","3155","5986","0","52.71","26.28"
"65","000","00","008","0820","1735","1093","542","551","46","1139","2052","0","55.51","26.41"
"65","000","00","008","0820","1736","920","561","359","29","949","1977","0","48.0","28.38"
"65","000","00","008","0820","1737","1037","470","567","30","1067","1957","0","54.52","24.02"
"65","000","00","009","0000","0000","47876","21638","26238","2325","50201","94291","115712","53.24","22.95"
"65","000","00","009","0901","0000","176","96","80","12","188","274","0","68.61","35.04"
"65","000","00","009","0901","1917","176","96","80","12","188","274","0","68.61","35.04"
"65","000","00","009","0902","0000","294","138","156","29","323","583","0","55.4","23.67"
"65","000","00","009","0902","1918","294","138","156","29","323","583","0","55.4","23.67"
"65","000","00","009","0903","0000","1652","755","897","68","1720","3479","0","49.44","21.7"
"65","000","00","009","0903","1919","790","361","429","19","809","1765","0","45.84","20.45"
"65","000","00","009","0903","1920","862","394","468","49","911","1714","0","53.15","22.99"
"65","000","00","009","0904","0000","1408","655","753","56","1464","2684","0","54.55","24.4"
"65","000","00","009","0904","1921","686","312","374","24","710","1355","0","52.4","23.03"
"65","000","00","009","0904","1922","722","343","379","32","754","1329","0","56.73","25.81"
"65","000","00","009","0905","0000","546","273","273","21","567","1059","0","53.54","25.78"
"65","000","00","009","0905","1923","546","273","273","21","567","1059","0","53.54","25.78"
"65","000","00","009","0906","0000","3453","1787","1666","193","3646","6529","0","55.84","27.37"
"65","000","00","009","0906","1924","748","323","425","37","785","1364","0","57.55","23.68"
"65","000","00","009","0906","1925","607","504","103","39","646","1098","0","58.83","45.9"
"65","000","00","009","0906","1926","669","295","374","49","718","1296","0","55.4","22.76"
"65","000","00","009","0906","1927","650","310","340","29","679","1240","0","54.76","25.0"
"65","000","00","009","0906","1928","779","355","424","39","818","1531","0","53.43","23.19"
"65","000","00","009","0907","0000","2526","1146","1380","118","2644","5025","0","52.62","22.81"
"65","000","00","009","0907","1952","794","368","426","40","834","1634","0","51.04","22.52"
"65","000","00","009","0907","1953","900","416","484","35","935","1716","0","54.49","24.24"
"65","000","00","009","0907","1954","832","362","470","43","875","1675","0","52.24","21.61"
"65","000","00","009","0908","0000","4182","1934","2248","235","4417","8724","0","50.63","22.17"
"65","000","00","009","0908","1929","681","307","374","28","709","1444","0","49.1","21.26"
"65","000","00","009","0908","1930","678","316","362","57","735","1347","0","54.57","23.46"
"65","000","00","009","0908","1931","738","312","426","49","787","1455","0","54.09","21.44"
"65","000","00","009","0908","1932","713","359","354","32","745","1556","0","47.88","23.07"
"65","000","00","009","0908","1933","594","313","281","25","619","1390","0","44.53","22.52"
"65","000","00","009","0908","1934","778","327","451","44","822","1532","0","53.66","21.34"
"65","000","00","009","0909","0000","4088","1827","2261","192","4280","8053","0","53.15","22.69"
"65","000","00","009","0909","1935","633","334","299","42","675","1377","0","49.02","24.26"
"65","000","00","009","0909","1936","852","375","477","47","899","1731","0","51.94","21.66"
"65","000","00","009","0909","1937","843","394","449","31","874","1705","0","51.26","23.11"
"65","000","00","009","0909","1938","843","372","471","39","882","1590","0","55.47","23.4"
"65","000","00","009","0909","1939","917","352","565","33","950","1650","0","57.58","21.33"
"65","000","00","009","0910","0000","1769","794","975","112","1881","3638","0","51.7","21.83"
"65","000","00","009","0910","1966","596","295","301","43","639","1389","0","46.0","21.24"
"65","000","00","009","0910","1967","635","310","325","36","671","1315","0","51.03","23.57"
"65","000","00","009","0910","1968","538","189","349","33","571","934","0","61.13","20.24"
"65","000","00","009","0911","0000","1029","445","584","61","1090","2199","0","49.57","20.24"
"65","000","00","009","0911","1969","601","261","340","28","629","1270","0","49.53","20.55"
"65","000","00","009","0911","1970","428","184","244","33","461","929","0","49.62","19.81"
"65","000","00","009","0912","0000","534","280","254","16","550","1035","0","53.14","27.05"
"65","000","00","009","0912","1971","534","280","254","16","550","1035","0","53.14","27.05"
"65","000","00","009","0913","0000","245","137","108","14","259","502","0","51.59","27.29"
"65","000","00","009","0913","1972","245","137","108","14","259","502","0","51.59","27.29"
"65","000","00","009","0914","0000","374","182","192","36","410","836","0","49.04","21.77"
"65","000","00","009","0914","1973","374","182","192","36","410","836","0","49.04","21.77"
"65","000","00","009","0915","0000","301","163","138","33","334","669","0","49.93","24.36"
"65","000","00","009","0915","1974","301","163","138","33","334","669","0","49.93","24.36"
"65","000","00","009","0916","0000","395","180","215","47","442","733","0","60.3","24.56"
"65","000","00","009","0916","1975","395","180","215","47","442","733","0","60.3","24.56"
"65","000","00","009","0917","0000","1131","567","564","44","1175","2138","0","54.96","26.52"
"65","000","00","009","0917","1979","427","228","199","22","449","771","0","58.24","29.57"
"65","000","00","009","0917","1980","704","339","365","22","726","1367","0","53.11","24.8"
"65","000","00","009","0918","0000","686","332","354","31","717","1394","0","51.43","23.82"
"65","000","00","009","0918","1978","686","332","354","31","717","1394","0","51.43","23.82"
"65","000","00","009","0919","0000","1354","644","710","46","1400","2761","0","50.71","23.32"
"65","000","00","009","0919","1981","615","289","326","33","648","1241","0","52.22","23.29"
"65","000","00","009","0919","1982","739","355","384","13","752","1520","0","49.47","23.36"
"65","000","00","009","0920","0000","532","286","246","25","557","873","0","63.8","32.76"
"65","000","00","009","0920","1983","532","286","246","25","557","873","0","63.8","32.76"
"65","000","00","009","0921","0000","549","303","246","47","596","1322","0","45.08","22.92"
"65","000","00","009","0921","1986","549","303","246","47","596","1322","0","45.08","22.92"
"65","000","00","009","0922","0000","852","449","403","50","902","1865","0","48.36","24.08"
"65","000","00","009","0922","1984","353","210","143","22","375","768","0","48.83","27.34"
"65","000","00","009","0922","1985","499","239","260","28","527","1097","0","48.04","21.79"
"65","000","00","009","0923","0000","2908","1387","1521","126","3034","5947","0","51.02","23.32"
"65","000","00","009","0923","1959","691","322","369","49","740","1363","0","54.29","23.62"
"65","000","00","009","0923","1960","848","400","448","38","886","1624","0","54.56","24.63"
"65","000","00","009","0923","1961","729","379","350","27","756","1352","0","55.92","28.03"
"65","000","00","009","0923","1962","640","286","354","12","652","1608","0","40.55","17.79"
"65","000","00","009","0924","0000","3207","1402","1805","160","3367","6635","0","50.75","21.13"
"65","000","00","009","0924","1955","714","320","394","41","755","1649","0","45.79","19.41"
"65","000","00","009","0924","1956","746","352","394","45","791","1489","0","53.12","23.64"
"65","000","00","009","0924","1957","838","338","500","37","875","1771","0","49.41","19.09"
"65","000","00","009","0924","1958","909","392","517","37","946","1726","0","54.81","22.71"
"65","000","00","009","0925","0000","2245","1065","1180","158","2403","4629","0","51.91","23.01"
"65","000","00","009","0925","1963","738","338","400","44","782","1458","0","53.64","23.18"
"65","000","00","009","0925","1964","778","368","410","30","808","1641","0","49.24","22.43"
"65","000","00","009","0925","1965","729","359","370","84","813","1530","0","53.14","23.46"
"65","000","00","009","0926","0000","1696","685","1011","94","1790","3198","0","55.97","21.42"
"65","000","00","009","0926","1976","883","337","546","56","939","1560","0","60.19","21.6"
"65","000","00","009","0926","1977","813","348","465","38","851","1638","0","51.95","21.25"
"65","000","00","009","0927","0000","6781","2521","4260","197","6978","12019","0","58.06","20.98"
"65","000","00","009","0927","1944","860","335","525","21","881","1579","0","55.79","21.22"
"65","000","00","009","0927","1945","751","294","457","21","772","1435","0","53.8","20.49"
"65","000","00","009","0927","1946","962","357","605","24","986","1659","0","59.43","21.52"
"65","000","00","009","0927","1947","894","347","547","30","924","1512","0","61.11","22.95"
"65","000","00","009","0927","1948","829","310","519","25","854","1463","0","58.37","21.19"
"65","000","00","009","0927","1949","831","301","530","23","854","1465","0","58.29","20.55"
"65","000","00","009","0927","1950","834","258","576","25","859","1463","0","58.71","17.63"
"65","000","00","009","0927","1951","820","319","501","28","848","1443","0","58.77","22.11"
"65","000","00","009","0928","0000","2963","1205","1758","104","3067","5488","0","55.89","21.96"
"65","000","00","009","0928","1940","772","310","462","29","801","1441","0","55.59","21.51"
"65","000","00","009","0928","1941","807","314","493","17","824","1404","0","58.69","22.36"
"65","000","00","009","0928","1942","742","290","452","28","770","1295","0","59.46","22.39"
"65","000","00","009","0928","1943","642","291","351","30","672","1348","0","49.85","21.59"
"65","000","00","010","0000","0000","75365","31732","43633","3072","78437","147272","172677","53.26","21.55"
"65","000","00","010","1001","0000","277","150","127","13","290","544","0","53.31","27.57"
"65","000","00","010","1001","0029","277","150","127","13","290","544","0","53.31","27.57"
"65","000","00","010","1002","0000","545","258","287","40","585","1044","0","56.03","24.71"
"65","000","00","010","1002","0030","545","258","287","40","585","1044","0","56.03","24.71"
"65","000","00","010","1003","0000","724","308","416","37","761","1462","0","52.05","21.07"
"65","000","00","010","1003","0031","724","308","416","37","761","1462","0","52.05","21.07"
"65","000","00","010","1004","0000","754","348","406","53","807","1525","0","52.92","22.82"
"65","000","00","010","1004","0032","754","348","406","53","807","1525","0","52.92","22.82"
"65","000","00","010","1005","0000","450","206","244","27","477","986","0","48.38","20.89"
"65","000","00","010","1005","0033","450","206","244","27","477","986","0","48.38","20.89"
"65","000","00","010","1006","0000","1227","503","724","82","1309","2516","0","52.03","19.99"
"65","000","00","010","1006","0035","621","257","364","42","663","1173","0","56.52","21.91"
"65","000","00","010","1006","0036","606","246","360","40","646","1343","0","48.1","18.32"
"65","000","00","010","1007","0000","430","189","241","31","461","806","0","57.2","23.45"
"65","000","00","010","1007","0034","430","189","241","31","461","806","0","57.2","23.45"
"65","000","00","010","1008","0000","5607","2176","3431","159","5766","12236","0","47.12","17.78"
"65","000","00","010","1008","0065","946","343","603","33","979","1837","0","53.29","18.67"
"65","000","00","010","1008","0066","635","248","387","17","652","1924","0","33.89","12.89"
"65","000","00","010","1008","0067","1168","459","709","24","1192","2340","0","50.94","19.62"
"65","000","00","010","1008","0068","766","315","451","29","795","1704","0","46.65","18.49"
"65","000","00","010","1008","0069","698","282","416","24","722","1363","0","52.97","20.69"
"65","000","00","010","1008","0070","1394","529","865","32","1426","3068","0","46.48","17.24"
"65","000","00","010","1009","0000","744","326","418","30","774","1528","0","50.65","21.34"
"65","000","00","010","1009","0071","744","326","418","30","774","1528","0","50.65","21.34"
"65","000","00","010","1010","0000","3191","1166","2025","141","3332","6351","0","52.46","18.36"
"65","000","00","010","1010","0079","733","203","530","47","780","1373","0","56.81","14.79"
"65","000","00","010","1010","0080","905","334","571","38","943","1732","0","54.45","19.28"
"65","000","00","010","1010","0081","735","300","435","29","764","1519","0","50.3","19.75"
"65","000","00","010","1010","0082","818","329","489","27","845","1727","0","48.93","19.05"
"65","000","00","010","1011","0000","2586","1105","1481","140","2726","5041","0","54.08","21.92"
"65","000","00","010","1011","0072","785","332","453","50","835","1600","0","52.19","20.75"
"65","000","00","010","1011","0073","1010","438","572","46","1056","1874","0","56.35","23.37"
"65","000","00","010","1011","0074","791","335","456","44","835","1567","0","53.29","21.38"
"65","000","00","010","1012","0000","4520","1830","2690","148","4668","8417","0","55.46","21.74"
"65","000","00","010","1012","0093","924","315","609","42","966","1804","0","53.55","17.46"
"65","000","00","010","1012","0094","713","319","394","29","742","1322","0","56.13","24.13"
"65","000","00","010","1012","0095","1051","449","602","27","1078","2019","0","53.39","22.24"
"65","000","00","010","1012","0096","976","387","589","22","998","1696","0","58.84","22.82"
"65","000","00","010","1012","0097","856","360","496","28","884","1576","0","56.09","22.84"
"65","000","00","010","1013","0000","938","512","426","41","979","2027","0","48.3","25.26"
"65","000","00","010","1013","0037","505","266","239","21","526","1153","0","45.62","23.07"
"65","000","00","010","1013","0038","433","246","187","20","453","874","0","51.83","28.15"
"65","000","00","010","1014","0000","558","295","263","41","599","1063","0","56.35","27.75"
"65","000","00","010","1014","0039","558","295","263","41","599","1063","0","56.35","27.75"
"65","000","00","010","1015","0000","641","276","365","32","673","1309","0","51.41","21.08"
"65","000","00","010","1015","0040","641","276","365","32","673","1309","0","51.41","21.08"
"65","000","00","010","1016","0000","660","309","351","36","696","1290","0","53.95","23.95"
"65","000","00","010","1016","0041","660","309","351","36","696","1290","0","53.95","23.95"
"65","000","00","010","1017","0000","3357","1299","2058","109","3466","6129","0","56.55","21.19"
"65","000","00","010","1017","0042","943","350","593","18","961","1675","0","57.37","20.9"
"65","000","00","010","1017","0043","853","333","520","34","887","1589","0","55.82","20.96"
"65","000","00","010","1017","0044","913","342","571","30","943","1624","0","58.07","21.06"
"65","000","00","010","1017","0045","648","274","374","27","675","1241","0","54.39","22.08"
"65","000","00","010","1018","0000","3046","1219","1827","141","3187","5578","0","57.14","21.85"
"65","000","00","010","1018","0046","687","302","385","48","735","1317","0","55.81","22.93"
"65","000","00","010","1018","0047","686","276","410","25","711","1225","0","58.04","22.53"
"65","000","00","010","1018","0048","762","313","449","37","799","1426","0","56.03","21.95"
"65","000","00","010","1018","0049","911","328","583","31","942","1610","0","58.51","20.37"
"65","000","00","010","1019","0000","3319","1490","1829","170","3489","6426","0","54.3","23.19"
"65","000","00","010","1019","0052","887","381","506","32","919","1822","0","50.44","20.91"
"65","000","00","010","1019","0053","700","362","338","48","748","1232","0","60.71","29.38"
"65","000","00","010","1019","0054","846","393","453","69","915","1588","0","57.62","24.75"
"65","000","00","010","1019","0055","886","354","532","21","907","1784","0","50.84","19.84"
"65","000","00","010","1020","0000","2691","1112","1579","93","2784","5205","0","53.49","21.36"
"65","000","00","010","1020","0056","893","406","487","35","928","1762","0","52.67","23.04"
"65","000","00","010","1020","0057","802","309","493","24","826","1546","0","53.43","19.99"
"65","000","00","010","1020","0058","996","397","599","34","1030","1897","0","54.3","20.93"
"65","000","00","010","1021","0000","4730","1766","2964","150","4880","9332","0","52.29","18.92"
"65","000","00","010","1021","0059","763","290","473","24","787","1489","0","52.85","19.48"
"65","000","00","010","1021","0060","842","349","493","26","868","1679","0","51.7","20.79"
"65","000","00","010","1021","0061","815","305","510","38","853","1693","0","50.38","18.02"
"65","000","00","010","1021","0062","844","374","470","21","865","1674","0","51.67","22.34"
"65","000","00","010","1021","0063","714","293","421","23","737","1330","0","55.41","22.03"
"65","000","00","010","1021","0064","752","155","597","18","770","1467","0","52.49","10.57"
"65","000","00","010","1022","0000","2937","1248","1689","122","3059","5459","0","56.04","22.86"
"65","000","00","010","1022","0098","961","394","567","34","995","1781","0","55.87","22.12"
"65","000","00","010","1022","0099","944","429","515","36","980","1665","0","58.86","25.77"
"65","000","00","010","1022","0100","1032","425","607","52","1084","2013","0","53.85","21.11"
"65","000","00","010","1023","0000","1934","836","1098","74","2008","3659","0","54.88","22.85"
"65","000","00","010","1023","0106","596","267","329","15","611","1289","0","47.4","20.71"
"65","000","00","010","1023","0107","750","320","430","39","789","1319","0","59.82","24.26"
"65","000","00","010","1023","0108","588","249","339","20","608","1051","0","57.85","23.69"
"65","000","00","010","1024","0000","727","348","379","24","751","1348","0","55.71","25.82"
"65","000","00","010","1024","0109","727","348","379","24","751","1348","0","55.71","25.82"
"65","000","00","010","1025","0000","578","301","277","29","607","1106","0","54.88","27.22"
"65","000","00","010","1025","0110","578","301","277","29","607","1106","0","54.88","27.22"
"65","000","00","010","1026","0000","402","217","185","23","425","717","0","59.27","30.26"
"65","000","00","010","1026","0111","402","217","185","23","425","717","0","59.27","30.26"
"65","000","00","010","1027","0000","709","332","377","27","736","1385","0","53.14","23.97"
"65","000","00","010","1027","0112","709","332","377","27","736","1385","0","53.14","23.97"
"65","000","00","010","1028","0000","480","229","251","31","511","841","0","60.76","27.23"
"65","000","00","010","1028","0113","480","229","251","31","511","841","0","60.76","27.23"
"65","000","00","010","1029","0000","379","201","178","16","395","665","0","59.4","30.23"
"65","000","00","010","1029","0114","379","201","178","16","395","665","0","59.4","30.23"
"65","000","00","010","1030","0000","244","123","121","8","252","419","0","60.14","29.36"
"65","000","00","010","1030","0115","244","123","121","8","252","419","0","60.14","29.36"
"65","000","00","010","1031","0000","875","369","506","24","899","1599","0","56.22","23.08"
"65","000","00","010","1031","0116","875","369","506","24","899","1599","0","56.22","23.08"
"65","000","00","010","1032","0000","2558","1096","1462","92","2650","4930","0","53.75","22.23"
"65","000","00","010","1032","0117","850","356","494","32","882","1670","0","52.81","21.32"
"65","000","00","010","1032","0118","931","412","519","27","958","1683","0","56.92","24.48"
"65","000","00","010","1032","0119","777","328","449","33","810","1577","0","51.36","20.8"
"65","000","00","010","1033","0000","1809","746","1063","66","1875","3832","0","48.93","19.47"
"65","000","00","010","1033","0120","772","332","440","43","815","1618","0","50.37","20.52"
"65","000","00","010","1033","0121","1037","414","623","23","1060","2214","0","47.88","18.7"
"65","000","00","010","1034","0000","1975","932","1043","113","2088","3750","0","55.68","24.85"
"65","000","00","010","1034","0083","698","317","381","36","734","1297","0","56.59","24.44"
"65","000","00","010","1034","0084","542","266","276","41","583","1066","0","54.69","24.95"
"65","000","00","010","1034","0085","735","349","386","36","771","1387","0","55.59","25.16"
"65","000","00","010","1035","0000","3799","1589","2210","152","3951","7408","0","53.33","21.45"
"65","000","00","010","1035","0086","1016","466","550","34","1050","1909","0","55.0","24.41"
"65","000","00","010","1035","0087","914","353","561","41","955","1770","0","53.95","19.94"
"65","000","00","010","1035","0088","997","409","588","45","1042","2049","0","50.85","19.96"
"65","000","00","010","1035","0089","872","361","511","32","904","1680","0","53.81","21.49"
"65","000","00","010","1036","0000","2343","977","1366","85","2428","4250","0","57.13","22.99"
"65","000","00","010","1036","0090","822","378","444","32","854","1433","0","59.6","26.38"
"65","000","00","010","1036","0091","725","287","438","26","751","1365","0","55.02","21.03"
"65","000","00","010","1036","0092","796","312","484","27","823","1452","0","56.68","21.49"
"65","000","00","010","1037","0000","2181","868","1313","65","2246","4020","0","55.87","21.59"
"65","000","00","010","1037","0077","1087","427","660","36","1123","1992","0","56.38","21.44"
"65","000","00","010","1037","0078","1094","441","653","29","1123","2028","0","55.37","21.75"
"65","000","00","010","1038","0000","1273","525","748","55","1328","2456","0","54.07","21.38"
"65","000","00","010","1038","0075","673","282","391","27","700","1245","0","56.22","22.65"
"65","000","00","010","1038","0076","600","243","357","28","628","1211","0","51.86","20.07"
"65","000","00","010","1039","0000","1946","1021","925","78","2024","3906","0","51.82","26.14"
"65","000","00","010","1039","0050","1081","629","452","35","1116","1982","0","56.31","31.74"
"65","000","00","010","1039","0051","865","392","473","43","908","1924","0","47.19","20.37"
"65","000","00","010","1040","0000","1895","871","1024","89","1984","3612","0","54.93","24.11"
"65","000","00","010","1040","0101","574","257","317","24","598","1108","0","53.97","23.19"
"65","000","00","010","1040","0102","683","311","372","46","729","1305","0","55.86","23.83"
"65","000","00","010","1040","0103","638","303","335","19","657","1199","0","54.8","25.27"
"65","000","00","010","1041","0000","2024","809","1215","87","2111","4142","0","50.97","19.53"
"65","000","00","010","1041","0104","1028","388","640","49","1077","2017","0","53.4","19.24"
"65","000","00","010","1041","0105","996","421","575","38","1034","2125","0","48.66","19.81"
"65","000","00","010","1042","0000","3302","1251","2051","98","3400","6953","0","48.9","17.99"
"65","000","00","010","1042","0122","931","395","536","32","963","1832","0","52.57","21.56"
"65","000","00","010","1042","0123","1078","453","625","47","1125","2123","0","52.99","21.34"
"65","000","00","010","1042","0124","1293","403","890","19","1312","2998","0","43.76","13.44"
"65","000","00","011","0000","0000","88754","37770","50984","3901","92655","173831","200217","53.3","21.73"
"65","000","00","011","1101","0000","684","291","393","33","717","1262","0","56.81","23.06"
"65","000","00","011","1101","2337","684","291","393","33","717","1262","0","56.81","23.06"
"65","000","00","011","1102","0000","513","269","244","27","540","917","0","58.89","29.33"
"65","000","00","011","1102","2338","513","269","244","27","540","917","0","58.89","29.33"
"65","000","00","011","1103","0000","2165","864","1301","97","2262","4156","0","54.43","20.79"
"65","000","00","011","1103","2339","1029","400","629","45","1074","1929","0","55.68","20.74"
"65","000","00","011","1103","2340","1136","464","672","52","1188","2227","0","53.35","20.84"
"65","000","00","011","1104","0000","166","85","81","9","175","322","0","54.35","26.4"
"65","000","00","011","1104","2343","166","85","81","9","175","322","0","54.35","26.4"
"65","000","00","011","1105","0000","1274","579","695","66","1340","2564","0","52.26","22.58"
"65","000","00","011","1105","2373","628","303","325","42","670","1244","0","53.86","24.36"
"65","000","00","011","1105","2374","646","276","370","24","670","1320","0","50.76","20.91"
"65","000","00","011","1106","0000","1816","879","937","73","1889","4797","0","39.38","18.32"
"65","000","00","011","1106","2350","339","177","162","21","360","1809","0","19.9","9.78"
"65","000","00","011","1106","2351","768","376","392","20","788","1601","0","49.22","23.49"
"65","000","00","011","1106","2352","709","326","383","32","741","1387","0","53.42","23.5"
"65","000","00","011","1107","0000","2491","1118","1373","93","2584","4840","0","53.39","23.1"
"65","000","00","011","1107","2344","796","354","442","10","806","1460","0","55.21","24.25"
"65","000","00","011","1107","2345","847","376","471","48","895","1719","0","52.07","21.87"
"65","000","00","011","1107","2346","848","388","460","35","883","1661","0","53.16","23.36"
"65","000","00","011","1108","0000","3331","1350","1981","122","3453","6144","0","56.2","21.97"
"65","000","00","011","1108","2355","1081","445","636","37","1118","2072","0","53.96","21.48"
"65","000","00","011","1108","2356","1198","473","725","52","1250","2120","0","58.96","22.31"
"65","000","00","011","1108","2357","1052","432","620","33","1085","1952","0","55.58","22.13"
"65","000","00","011","1109","0000","1955","907","1048","113","2068","3964","0","52.17","22.88"
"65","000","00","011","1109","2365","680","326","354","43","723","1363","0","53.04","23.92"
"65","000","00","011","1109","2366","657","316","341","38","695","1368","0","50.8","23.1"
"65","000","00","011","1109","2367","618","265","353","32","650","1233","0","52.72","21.49"
"65","000","00","011","1110","0000","723","354","369","29","752","1481","0","50.78","23.9"
"65","000","00","011","1110","2378","723","354","369","29","752","1481","0","50.78","23.9"
"65","000","00","011","1111","0000","733","348","385","49","782","1497","0","52.24","23.25"
"65","000","00","011","1111","2379","733","348","385","49","782","1497","0","52.24","23.25"
"65","000","00","011","1112","0000","1913","798","1115","73","1986","3940","0","50.41","20.25"
"65","000","00","011","1112","2381","923","389","534","37","960","1913","0","50.18","20.33"
"65","000","00","011","1112","2382","990","409","581","36","1026","2027","0","50.62","20.18"
"65","000","00","011","1113","0000","1013","444","569","51","1064","2127","0","50.02","20.87"
"65","000","00","011","1113","2385","1013","444","569","51","1064","2127","0","50.02","20.87"
"65","000","00","011","1114","0000","2547","1207","1340","125","2672","5447","0","49.05","22.16"
"65","000","00","011","1114","2386","737","320","417","46","783","1642","0","47.69","19.49"
"65","000","00","011","1114","2387","961","505","456","47","1008","1912","0","52.72","26.41"
"65","000","00","011","1114","2388","849","382","467","32","881","1893","0","46.54","20.18"
"65","000","00","011","1115","0000","2193","967","1226","117","2310","4554","0","50.72","21.23"
"65","000","00","011","1115","2389","686","310","376","35","721","1466","0","49.18","21.15"
"65","000","00","011","1115","2390","741","334","407","55","796","1538","0","51.76","21.72"
"65","000","00","011","1115","2391","766","323","443","27","793","1550","0","51.16","20.84"
"65","000","00","011","1116","0000","725","330","395","35","760","1456","0","52.2","22.66"
"65","000","00","011","1116","2392","725","330","395","35","760","1456","0","52.2","22.66"
"65","000","00","011","1117","0000","553","292","261","22","575","947","0","60.72","30.83"
"65","000","00","011","1117","2393","553","292","261","22","575","947","0","60.72","30.83"
"65","000","00","011","1118","0000","842","392","450","35","877","1988","0","44.11","19.72"
"65","000","00","011","1118","2400","842","392","450","35","877","1988","0","44.11","19.72"
"65","000","00","011","1119","0000","1890","914","976","107","1997","4055","0","49.25","22.54"
"65","000","00","011","1119","2395","978","458","520","55","1033","2043","0","50.56","22.42"
"65","000","00","011","1119","2396","912","456","456","52","964","2012","0","47.91","22.66"
"65","000","00","011","1120","0000","2849","1209","1640","146","2995","5100","0","58.73","23.71"
"65","000","00","011","1120","2431","732","313","419","34","766","1335","0","57.38","23.45"
"65","000","00","011","1120","2432","776","315","461","32","808","1324","0","61.03","23.79"
"65","000","00","011","1120","2433","722","292","430","59","781","1286","0","60.73","22.71"
"65","000","00","011","1120","2434","619","289","330","21","640","1155","0","55.41","25.02"
"65","000","00","011","1121","0000","1750","733","1017","63","1813","3847","0","47.13","19.05"
"65","000","00","011","1121","2363","858","362","496","31","889","1941","0","45.8","18.65"
"65","000","00","011","1121","2364","892","371","521","32","924","1906","0","48.48","19.46"
"65","000","00","011","1122","0000","2272","967","1305","128","2400","4215","0","56.94","22.94"
"65","000","00","011","1122","2438","1155","510","645","79","1234","2184","0","56.5","23.35"
"65","000","00","011","1122","2439","1117","457","660","49","1166","2031","0","57.41","22.5"
"65","000","00","011","1123","0000","319","159","160","9","328","556","0","58.99","28.6"
"65","000","00","011","1123","2380","319","159","160","9","328","556","0","58.99","28.6"
"65","000","00","011","1124","0000","1800","754","1046","90","1890","3336","0","56.65","22.6"
"65","000","00","011","1124","2440","932","402","530","51","983","1759","0","55.88","22.85"
"65","000","00","011","1124","2441","868","352","516","39","907","1577","0","57.51","22.32"
"65","000","00","011","1125","0000","1516","617","899","61","1577","2765","0","57.03","22.31"
"65","000","00","011","1125","2442","722","283","439","23","745","1364","0","54.62","20.75"
"65","000","00","011","1125","2443","794","334","460","38","832","1401","0","59.39","23.84"
"65","000","00","011","1126","0000","3319","1454","1865","173","3492","6938","0","50.33","20.96"
"65","000","00","011","1126","2411","860","385","475","39","899","1765","0","50.93","21.81"
"65","000","00","011","1126","2412","798","317","481","25","823","1815","0","45.34","17.47"
"65","000","00","011","1126","2413","839","384","455","54","893","1778","0","50.22","21.6"
"65","000","00","011","1126","2414","822","368","454","55","877","1580","0","55.51","23.29"
"65","000","00","011","1127","0000","2707","1069","1638","80","2787","5304","0","52.55","20.15"
"65","000","00","011","1127","2422","976","416","560","27","1003","2035","0","49.29","20.44"
"65","000","00","011","1127","2423","958","410","548","42","1000","1895","0","52.77","21.64"
"65","000","00","011","1127","2424","773","243","530","11","784","1374","0","57.06","17.69"
"65","000","00","011","1128","0000","829","342","487","43","872","1595","0","54.67","21.44"
"65","000","00","011","1128","2336","829","342","487","43","872","1595","0","54.67","21.44"
"65","000","00","011","1129","0000","3247","1305","1942","142","3389","6514","0","52.03","20.03"
"65","000","00","011","1129","2405","786","352","434","25","811","1511","0","53.67","23.3"
"65","000","00","011","1129","2406","796","300","496","35","831","1691","0","49.14","17.74"
"65","000","00","011","1129","2407","829","312","517","42","871","1636","0","53.24","19.07"
"65","000","00","011","1129","2408","836","341","495","40","876","1676","0","52.27","20.35"
"65","000","00","011","1130","0000","3655","1528","2127","176","3831","7292","0","52.54","20.95"
"65","000","00","011","1130","2401","1057","440","617","41","1098","2198","0","49.95","20.02"
"65","000","00","011","1130","2402","839","343","496","33","872","1712","0","50.93","20.04"
"65","000","00","011","1130","2403","958","383","575","52","1010","1806","0","55.92","21.21"
"65","000","00","011","1130","2404","801","362","439","50","851","1576","0","54.0","22.97"
"65","000","00","011","1131","0000","2484","1104","1380","133","2617","4725","0","55.39","23.37"
"65","000","00","011","1131","2358","827","377","450","55","882","1654","0","53.33","22.79"
"65","000","00","011","1131","2359","719","339","380","49","768","1444","0","53.19","23.48"
"65","000","00","011","1131","2360","938","388","550","29","967","1627","0","59.43","23.85"
"65","000","00","011","1132","0000","1883","801","1082","91","1974","3817","0","51.72","20.99"
"65","000","00","011","1132","2361","833","416","417","56","889","1751","0","50.77","23.76"
"65","000","00","011","1132","2362","1050","385","665","35","1085","2066","0","52.52","18.64"
"65","000","00","011","1133","0000","2252","993","1259","101","2353","4604","0","51.11","21.57"
"65","000","00","011","1133","2397","675","289","386","27","702","1471","0","47.72","19.65"
"65","000","00","011","1133","2398","789","352","437","34","823","1603","0","51.34","21.96"
"65","000","00","011","1133","2399","788","352","436","40","828","1530","0","54.12","23.01"
"65","000","00","011","1134","0000","1473","654","819","58","1531","2941","0","52.06","22.24"
"65","000","00","011","1134","2415","784","373","411","30","814","1516","0","53.69","24.6"
"65","000","00","011","1134","2416","689","281","408","28","717","1425","0","50.32","19.72"
"65","000","00","011","1135","0000","1482","650","832","71","1553","2824","0","54.99","23.02"
"65","000","00","011","1135","2417","737","302","435","31","768","1388","0","55.33","21.76"
"65","000","00","011","1135","2418","745","348","397","40","785","1436","0","54.67","24.23"
"65","000","00","011","1136","0000","2287","972","1315","75","2362","4624","0","51.08","21.02"
"65","000","00","011","1136","2419","809","332","477","31","840","1591","0","52.8","20.87"
"65","000","00","011","1136","2420","790","351","439","25","815","1639","0","49.73","21.42"
"65","000","00","011","1136","2421","688","289","399","19","707","1394","0","50.72","20.73"
"65","000","00","011","1137","0000","1896","691","1205","58","1954","3176","0","61.52","21.76"
"65","000","00","011","1137","2435","990","368","622","34","1024","1682","0","60.88","21.88"
"65","000","00","011","1137","2436","906","323","583","24","930","1494","0","62.25","21.62"
"65","000","00","011","1138","0000","665","358","307","42","707","1166","0","60.63","30.7"
"65","000","00","011","1138","2437","665","358","307","42","707","1166","0","60.63","30.7"
"65","000","00","011","1139","0000","2006","809","1197","89","2095","3753","0","55.82","21.56"
"65","000","00","011","1139","2444","642","293","349","53","695","1173","0","59.25","24.98"
"65","000","00","011","1139","2445","534","219","315","13","547","993","0","55.09","22.05"
"65","000","00","011","1139","2446","830","297","533","23","853","1587","0","53.75","18.71"
"65","000","00","011","1140","0000","1235","490","745","48","1283","2429","0","52.82","20.17"
"65","000","00","011","1140","2409","639","253","386","22","661","1264","0","52.29","20.02"
"65","000","00","011","1140","2410","596","237","359","26","622","1165","0","53.39","20.34"
"65","000","00","011","1141","0000","1342","585","757","64","1406","2510","0","56.02","23.31"
"65","000","00","011","1141","2341","608","272","336","37","645","1143","0","56.43","23.8"
"65","000","00","011","1141","2342","734","313","421","27","761","1367","0","55.67","22.9"
"65","000","00","011","1142","0000","2280","972","1308","78","2358","4378","0","53.86","22.2"
"65","000","00","011","1142","2368","807","345","462","26","833","1554","0","53.6","22.2"
"65","000","00","011","1142","2369","855","379","476","36","891","1700","0","52.41","22.29"
"65","000","00","011","1142","2370","618","248","370","16","634","1124","0","56.41","22.06"
"65","000","00","011","1143","0000","3158","1231","1927","95","3253","5763","0","56.45","21.36"
"65","000","00","011","1143","2427","838","309","529","27","865","1548","0","55.88","19.96"
"65","000","00","011","1143","2428","766","298","468","12","778","1350","0","57.63","22.07"
"65","000","00","011","1143","2429","796","338","458","24","820","1499","0","54.7","22.55"
"65","000","00","011","1143","2430","758","286","472","32","790","1366","0","57.83","20.94"
"65","000","00","011","1144","0000","521","227","294","17","538","923","0","58.29","24.59"
"65","000","00","011","1144","2394","521","227","294","17","538","923","0","58.29","24.59"
"65","000","00","011","1145","0000","2645","1131","1514","111","2756","4938","0","55.81","22.9"
"65","000","00","011","1145","2347","863","367","496","40","903","1590","0","56.79","23.08"
"65","000","00","011","1145","2348","847","400","447","33","880","1599","0","55.03","25.02"
"65","000","00","011","1145","2349","935","364","571","38","973","1749","0","55.63","20.81"
"65","000","00","011","1146","0000","2081","851","1230","80","2161","3853","0","56.09","22.09"
"65","000","00","011","1146","2353","953","428","525","47","1000","1779","0","56.21","24.06"
"65","000","00","011","1146","2354","1128","423","705","33","1161","2074","0","55.98","20.4"
"65","000","00","011","1147","0000","2472","876","1596","101","2573","4541","0","56.66","19.29"
"65","000","00","011","1147","2375","808","316","492","31","839","1473","0","56.96","21.45"
"65","000","00","011","1147","2376","952","313","639","41","993","1802","0","55.11","17.37"
"65","000","00","011","1147","2377","712","247","465","29","741","1266","0","58.53","19.51"
"65","000","00","011","1148","0000","2103","854","1249","87","2190","3950","0","55.44","21.62"
"65","000","00","011","1148","2371","1055","448","607","36","1091","1900","0","57.42","23.58"
"65","000","00","011","1148","2372","1048","406","642","51","1099","2050","0","53.61","19.8"
"65","000","00","011","1149","0000","1431","491","940","44","1475","2373","0","62.16","20.69"
"65","000","00","011","1149","2425","603","212","391","31","634","1061","0","59.75","19.98"
"65","000","00","011","1149","2426","828","279","549","13","841","1312","0","64.1","21.27"
"65","000","00","011","1150","0000","1268","505","763","71","1339","2623","0","51.05","19.25"
"65","000","00","011","1150","2383","909","334","575","39","948","1927","0","49.2","17.33"
"65","000","00","011","1150","2384","359","171","188","32","391","696","0","56.18","24.57"
"65","000","00","012","0000","0000","16223","7444","8779","1049","17272","35036","40022","49.3","21.25"
"65","000","00","012","1201","0000","394","186","208","30","424","725","0","58.48","25.66"
"65","000","00","012","1201","2220","394","186","208","30","424","725","0","58.48","25.66"
"65","000","00","012","1202","0000","1006","449","557","60","1066","1899","0","56.13","23.64"
"65","000","00","012","1202","2221","576","269","307","41","617","1074","0","57.45","25.05"
"65","000","00","012","1202","2222","430","180","250","19","449","825","0","54.42","21.82"
"65","000","00","012","1203","0000","638","294","344","37","675","1242","0","54.35","23.67"
"65","000","00","012","1203","2223","638","294","344","37","675","1242","0","54.35","23.67"
"65","000","00","012","1204","0000","803","362","441","48","851","1632","0","52.14","22.18"
"65","000","00","012","1204","2225","445","186","259","27","472","872","0","54.13","21.33"
"65","000","00","012","1204","2226","358","176","182","21","379","760","0","49.87","23.16"
"65","000","00","012","1205","0000","600","258","342","36","636","1330","0","47.82","19.4"
"65","000","00","012","1205","2227","600","258","342","36","636","1330","0","47.82","19.4"
"65","000","00","012","1206","0000","310","128","182","19","329","598","0","55.02","21.4"
"65","000","00","012","1206","2224","310","128","182","19","329","598","0","55.02","21.4"
"65","000","00","012","1207","0000","1691","761","930","126","1817","3609","0","50.35","21.09"
"65","000","00","012","1207","2228","740","327","413","51","791","1683","0","47.0","19.43"
"65","000","00","012","1207","2229","481","222","259","37","518","980","0","52.86","22.65"
"65","000","00","012","1207","2230","470","212","258","38","508","946","0","53.7","22.41"
"65","000","00","012","1208","0000","541","313","228","28","569","1089","0","52.25","28.74"
"65","000","00","012","1208","2235","541","313","228","28","569","1089","0","52.25","28.74"
"65","000","00","012","1209","0000","712","321","391","50","762","1623","0","46.95","19.78"
"65","000","00","012","1209","2233","423","189","234","25","448","978","0","45.81","19.33"
"65","000","00","012","1209","2234","289","132","157","25","314","645","0","48.68","20.47"
"65","000","00","012","1210","0000","592","281","311","36","628","1291","0","48.64","21.77"
"65","000","00","012","1210","2245","344","157","187","26","370","673","0","54.98","23.33"
"65","000","00","012","1210","2246","248","124","124","10","258","618","0","41.75","20.06"
"65","000","00","012","1211","0000","872","408","464","52","924","1701","0","54.32","23.99"
"65","000","00","012","1211","2240","428","204","224","25","453","817","0","55.45","24.97"
"65","000","00","012","1211","2241","444","204","240","27","471","884","0","53.28","23.08"
"65","000","00","012","1212","0000","1373","605","768","96","1469","2985","0","49.21","20.27"
"65","000","00","012","1212","2242","592","268","324","53","645","1333","0","48.39","20.11"
"65","000","00","012","1212","2243","253","97","156","9","262","607","0","43.16","15.98"
"65","000","00","012","1212","2244","528","240","288","34","562","1045","0","53.78","22.97"
"65","000","00","012","1213","0000","905","418","487","64","969","1923","0","50.39","21.74"
"65","000","00","012","1213","2247","465","225","240","29","494","1063","0","46.47","21.17"
"65","000","00","012","1213","2248","440","193","247","35","475","860","0","55.23","22.44"
"65","000","00","012","1214","0000","221","114","107","29","250","461","0","54.23","24.73"
"65","000","00","012","1214","2237","221","114","107","29","250","461","0","54.23","24.73"
"65","000","00","012","1215","0000","131","74","57","10","141","274","0","51.46","27.01"
"65","000","00","012","1215","2238","131","74","57","10","141","274","0","51.46","27.01"
"65","000","00","012","1216","0000","121","83","38","10","131","286","0","45.8","29.02"
"65","000","00","012","1216","2236","121","83","38","10","131","286","0","45.8","29.02"
"65","000","00","012","1217","0000","91","51","40","9","100","155","0","64.52","32.9"
"65","000","00","012","1217","2239","91","51","40","9","100","155","0","64.52","32.9"
"65","000","00","012","1218","0000","144","76","68","4","148","432","0","34.26","17.59"
"65","000","00","012","1218","2249","144","76","68","4","148","432","0","34.26","17.59"
"65","000","00","012","1219","0000","177","88","89","10","187","445","0","42.02","19.78"
"65","000","00","012","1219","2250","177","88","89","10","187","445","0","42.02","19.78"
"65","000","00","012","1220","0000","142","70","72","6","148","318","0","46.54","22.01"
"65","000","00","012","1220","2251","142","70","72","6","148","318","0","46.54","22.01"
"65","000","00","012","1221","0000","73","27","46","4","77","159","0","48.43","16.98"
"65","000","00","012","1221","2252","73","27","46","4","77","159","0","48.43","16.98"
"65","000","00","012","1222","0000","138","59","79","11","149","337","0","44.21","17.51"
"65","000","00","012","1222","2253","138","59","79","11","149","337","0","44.21","17.51"
"65","000","00","012","1223","0000","184","91","93","9","193","369","0","52.3","24.66"
"65","000","00","012","1223","2256","184","91","93","9","193","369","0","52.3","24.66"
"65","000","00","012","1224","0000","95","42","53","3","98","180","0","54.44","23.33"
"65","000","00","012","1224","2254","95","42","53","3","98","180","0","54.44","23.33"
"65","000","00","012","1225","0000","73","33","40","9","82","187","0","43.85","17.65"
"65","000","00","012","1225","2255","73","33","40","9","82","187","0","43.85","17.65"
"65","000","00","012","1226","0000","173","74","99","16","189","335","0","56.42","22.09"
"65","000","00","012","1226","2257","173","74","99","16","189","335","0","56.42","22.09"
"65","000","00","012","1227","0000","118","65","53","3","121","297","0","40.74","21.89"
"65","000","00","012","1227","2259","118","65","53","3","121","297","0","40.74","21.89"
"65","000","00","012","1228","0000","202","96","106","14","216","470","0","45.96","20.43"
"65","000","00","012","1228","2258","202","96","106","14","216","470","0","45.96","20.43"
"65","000","00","012","1229","0000","460","190","270","19","479","1241","0","38.6","15.31"
"65","000","00","012","1229","2262","460","190","270","19","479","1241","0","38.6","15.31"
"65","000","00","012","1230","0000","933","434","499","102","1035","1946","0","53.19","22.3"
"65","000","00","012","1230","2263","482","233","249","51","533","998","0","53.41","23.35"
"65","000","00","012","1230","2264","451","201","250","51","502","948","0","52.95","21.2"
"65","000","00","012","1231","0000","483","202","281","27","510","1308","0","38.99","15.44"
"65","000","00","012","1231","2265","483","202","281","27","510","1308","0","38.99","15.44"
"65","000","00","012","1232","0000","171","78","93","5","176","267","0","65.92","29.21"
"65","000","00","012","1232","2260","171","78","93","5","176","267","0","65.92","29.21"
"65","000","00","012","1233","0000","251","118","133","7","258","876","0","29.45","13.47"
"65","000","00","012","1233","2261","251","118","133","7","258","876","0","29.45","13.47"
"65","000","00","012","1234","0000","1405","595","810","60","1465","3046","0","48.1","19.53"
"65","000","00","012","1234","2231","610","266","344","28","638","1375","0","46.4","19.35"
"65","000","00","012","1234","2232","795","329","466","32","827","1671","0","49.49","19.69"
"65","000","00","013","0000","0000","105460","48850","56610","5222","110682","200783","236964","55.13","24.33"
"65","000","00","013","1301","0000","1651","828","823","116","1767","4869","0","36.29","17.01"
"65","000","00","013","1301","1799","418","281","137","39","457","2518","0","18.15","11.16"
"65","000","00","013","1301","1800","627","276","351","35","662","1218","0","54.35","22.66"
"65","000","00","013","1301","1801","606","271","335","42","648","1133","0","57.19","23.92"
"65","000","00","013","1302","0000","1009","460","549","62","1071","1825","0","58.68","25.21"
"65","000","00","013","1302","1802","492","205","287","27","519","894","0","58.05","22.93"
"65","000","00","013","1302","1803","517","255","262","35","552","931","0","59.29","27.39"
"65","000","00","013","1303","0000","2926","1310","1616","127","3053","5283","0","57.79","24.8"
"65","000","00","013","1303","1808","750","350","400","36","786","1378","0","57.04","25.4"
"65","000","00","013","1303","1809","801","371","430","36","837","1421","0","58.9","26.11"
"65","000","00","013","1303","1810","718","281","437","30","748","1340","0","55.82","20.97"
"65","000","00","013","1303","1811","657","308","349","25","682","1144","0","59.62","26.92"
"65","000","00","013","1304","0000","2565","1207","1358","134","2699","4954","0","54.48","24.36"
"65","000","00","013","1304","1795","700","320","380","26","726","1292","0","56.19","24.77"
"65","000","00","013","1304","1796","675","305","370","25","700","1324","0","52.87","23.04"
"65","000","00","013","1304","1797","579","262","317","37","616","1155","0","53.33","22.68"
"65","000","00","013","1304","1798","611","320","291","46","657","1183","0","55.54","27.05"
"65","000","00","013","1305","0000","1111","354","757","45","1156","1820","0","63.52","19.45"
"65","000","00","013","1305","1804","1111","354","757","45","1156","1820","0","63.52","19.45"
"65","000","00","013","1306","0000","2210","1052","1158","157","2367","4161","0","56.89","25.28"
"65","000","00","013","1306","1820","719","362","357","61","780","1356","0","57.52","26.7"
"65","000","00","013","1306","1821","801","369","432","39","840","1496","0","56.15","24.67"
"65","000","00","013","1306","1822","690","321","369","57","747","1309","0","57.07","24.52"
"65","000","00","013","1307","0000","2833","1344","1489","171","3004","5067","0","59.29","26.52"
"65","000","00","013","1307","1816","675","335","340","36","711","1230","0","57.8","27.24"
"65","000","00","013","1307","1817","725","354","371","47","772","1342","0","57.53","26.38"
"65","000","00","013","1307","1818","721","358","363","27","748","1268","0","58.99","28.23"
"65","000","00","013","1307","1819","712","297","415","61","773","1227","0","63.0","24.21"
"65","000","00","013","1308","0000","2106","1050","1056","102","2208","3900","0","56.62","26.92"
"65","000","00","013","1308","1827","625","332","293","50","675","1182","0","57.11","28.09"
"65","000","00","013","1308","1828","836","402","434","28","864","1558","0","55.46","25.8"
"65","000","00","013","1308","1829","645","316","329","24","669","1160","0","57.67","27.24"
"65","000","00","013","1309","0000","1602","705","897","70","1672","2965","0","56.39","23.78"
"65","000","00","013","1309","1858","748","337","411","37","785","1445","0","54.33","23.32"
"65","000","00","013","1309","1859","854","368","486","33","887","1520","0","58.36","24.21"
"65","000","00","013","1310","0000","4134","1831","2303","188","4322","7503","0","57.6","24.4"
"65","000","00","013","1310","1840","821","421","400","49","870","1576","0","55.2","26.71"
"65","000","00","013","1310","1841","801","365","436","34","835","1458","0","57.27","25.03"
"65","000","00","013","1310","1842","822","368","454","48","870","1517","0","57.35","24.26"
"65","000","00","013","1310","1843","832","311","521","39","871","1489","0","58.5","20.89"
"65","000","00","013","1310","1844","858","366","492","18","876","1463","0","59.88","25.02"
"65","000","00","013","1311","0000","1493","751","742","95","1588","2821","0","56.29","26.62"
"65","000","00","013","1311","1830","736","368","368","38","774","1357","0","57.04","27.12"
"65","000","00","013","1311","1831","757","383","374","57","814","1464","0","55.6","26.16"
"65","000","00","013","1312","0000","3723","1807","1916","172","3895","7204","0","54.07","25.08"
"65","000","00","013","1312","1875","758","373","385","37","795","1402","0","56.7","26.6"
"65","000","00","013","1312","1876","732","357","375","34","766","1379","0","55.55","25.89"
"65","000","00","013","1312","1877","745","352","393","44","789","1471","0","53.64","23.93"
"65","000","00","013","1312","1878","680","310","370","31","711","1410","0","50.43","21.99"
"65","000","00","013","1312","1879","808","415","393","26","834","1542","0","54.09","26.91"
"65","000","00","013","1313","0000","2658","1309","1349","136","2794","5586","0","50.02","23.43"
"65","000","00","013","1313","1864","634","343","291","25","659","1337","0","49.29","25.65"
"65","000","00","013","1313","1865","557","296","261","33","590","1325","0","44.53","22.34"
"65","000","00","013","1313","1866","685","344","341","27","712","1390","0","51.22","24.75"
"65","000","00","013","1313","1867","782","326","456","51","833","1534","0","54.3","21.25"
"65","000","00","013","1314","0000","2138","932","1206","85","2223","3850","0","57.74","24.21"
"65","000","00","013","1314","1880","652","319","333","31","683","1238","0","55.17","25.77"
"65","000","00","013","1314","1881","670","282","388","24","694","1301","0","53.34","21.68"
"65","000","00","013","1314","1882","816","331","485","30","846","1311","0","64.53","25.25"
"65","000","00","013","1315","0000","744","346","398","48","792","1484","0","53.37","23.32"
"65","000","00","013","1315","1868","744","346","398","48","792","1484","0","53.37","23.32"
"65","000","00","013","1316","0000","3243","1381","1862","151","3394","6156","0","55.13","22.43"
"65","000","00","013","1316","1869","760","339","421","35","795","1532","0","51.89","22.13"
"65","000","00","013","1316","1870","807","347","460","51","858","1507","0","56.93","23.03"
"65","000","00","013","1316","1871","842","360","482","31","873","1550","0","56.32","23.23"
"65","000","00","013","1316","1872","834","335","499","34","868","1567","0","55.39","21.38"
"65","000","00","013","1317","0000","3360","1665","1695","157","3517","6530","0","53.86","25.5"
"65","000","00","013","1317","1892","681","355","326","33","714","1312","0","54.42","27.06"
"65","000","00","013","1317","1893","658","330","328","28","686","1301","0","52.73","25.37"
"65","000","00","013","1317","1894","633","315","318","31","664","1254","0","52.95","25.12"
"65","000","00","013","1317","1895","633","326","307","33","666","1215","0","54.81","26.83"
"65","000","00","013","1317","1896","755","339","416","32","787","1448","0","54.35","23.41"
"65","000","00","013","1318","0000","3249","1580","1669","169","3418","6194","0","55.18","25.51"
"65","000","00","013","1318","1906","794","390","404","42","836","1550","0","53.94","25.16"
"65","000","00","013","1318","1907","870","435","435","47","917","1606","0","57.1","27.09"
"65","000","00","013","1318","1908","795","381","414","38","833","1509","0","55.2","25.25"
"65","000","00","013","1318","1909","790","374","416","42","832","1529","0","54.41","24.46"
"65","000","00","013","1319","0000","2320","1091","1229","94","2414","4283","0","56.36","25.47"
"65","000","00","013","1319","1886","764","378","386","27","791","1335","0","59.25","28.31"
"65","000","00","013","1319","1887","772","326","446","38","810","1459","0","55.52","22.34"
"65","000","00","013","1319","1888","784","387","397","29","813","1489","0","54.6","25.99"
"65","000","00","013","1320","0000","2303","1093","1210","105","2408","4330","0","55.61","25.24"
"65","000","00","013","1320","1792","673","356","317","31","704","1206","0","58.37","29.52"
"65","000","00","013","1320","1793","711","353","358","20","731","1255","0","58.25","28.13"
"65","000","00","013","1320","1794","919","384","535","54","973","1869","0","52.06","20.55"
"65","000","00","013","1321","0000","3690","1632","2058","196","3886","7156","0","54.3","22.81"
"65","000","00","013","1321","1787","683","339","344","53","736","1424","0","51.69","23.81"
"65","000","00","013","1321","1788","749","335","414","41","790","1455","0","54.3","23.02"
"65","000","00","013","1321","1789","713","336","377","35","748","1419","0","52.71","23.68"
"65","000","00","013","1321","1790","780","292","488","32","812","1357","0","59.84","21.52"
"65","000","00","013","1321","1791","765","330","435","35","800","1501","0","53.3","21.99"
"65","000","00","013","1322","0000","2063","1052","1011","120","2183","4013","0","54.4","26.21"
"65","000","00","013","1322","1784","674","339","335","40","714","1378","0","51.81","24.6"
"65","000","00","013","1322","1785","641","348","293","34","675","1256","0","53.74","27.71"
"65","000","00","013","1322","1786","748","365","383","46","794","1379","0","57.58","26.47"
"65","000","00","013","1323","0000","2249","1035","1214","122","2371","4405","0","53.83","23.5"
"65","000","00","013","1323","1781","795","378","417","35","830","1499","0","55.37","25.22"
"65","000","00","013","1323","1782","749","296","453","32","781","1495","0","52.24","19.8"
"65","000","00","013","1323","1783","705","361","344","55","760","1411","0","53.86","25.58"
"65","000","00","013","1324","0000","2299","1072","1227","145","2444","4638","0","52.7","23.11"
"65","000","00","013","1324","1778","746","350","396","61","807","1474","0","54.75","23.74"
"65","000","00","013","1324","1779","733","327","406","39","772","1489","0","51.85","21.96"
"65","000","00","013","1324","1780","820","395","425","45","865","1675","0","51.64","23.58"
"65","000","00","013","1325","0000","1425","561","864","35","1460","2448","0","59.64","22.92"
"65","000","00","013","1325","1776","723","288","435","21","744","1242","0","59.9","23.19"
"65","000","00","013","1325","1777","702","273","429","14","716","1206","0","59.37","22.64"
"65","000","00","013","1326","0000","751","374","377","49","800","1505","0","53.16","24.85"
"65","000","00","013","1326","1775","751","374","377","49","800","1505","0","53.16","24.85"
"65","000","00","013","1327","0000","2415","1105","1310","132","2547","4640","0","54.89","23.81"
"65","000","00","013","1327","1847","865","413","452","39","904","1598","0","56.57","25.84"
"65","000","00","013","1327","1848","738","368","370","59","797","1500","0","53.13","24.53"
"65","000","00","013","1327","1849","812","324","488","34","846","1542","0","54.86","21.01"
"65","000","00","013","1328","0000","2554","1082","1472","104","2658","5032","0","52.82","21.5"
"65","000","00","013","1328","1835","867","375","492","47","914","1639","0","55.77","22.88"
"65","000","00","013","1328","1836","961","375","586","27","988","1728","0","57.18","21.7"
"65","000","00","013","1328","1837","726","332","394","30","756","1665","0","45.41","19.94"
"65","000","00","013","1329","0000","1700","781","919","59","1759","3140","0","56.02","24.87"
"65","000","00","013","1329","1850","930","417","513","35","965","1619","0","59.6","25.76"
"65","000","00","013","1329","1851","770","364","406","24","794","1521","0","52.2","23.93"
"65","000","00","013","1330","0000","2170","1043","1127","125","2295","3975","0","57.74","26.24"
"65","000","00","013","1330","1900","748","384","364","61","809","1366","0","59.22","28.11"
"65","000","00","013","1330","1901","732","325","407","29","761","1292","0","58.9","25.15"
"65","000","00","013","1330","1902","690","334","356","35","725","1317","0","55.05","25.36"
"65","000","00","013","1331","0000","2305","1135","1170","122","2427","4421","0","54.9","25.67"
"65","000","00","013","1331","1910","729","358","371","48","777","1458","0","53.29","24.55"
"65","000","00","013","1331","1911","802","439","363","38","840","1468","0","57.22","29.9"
"65","000","00","013","1331","1912","774","338","436","36","810","1495","0","54.18","22.61"
"65","000","00","013","1332","0000","1420","693","727","61","1481","2605","0","56.85","26.6"
"65","000","00","013","1332","1862","676","320","356","25","701","1262","0","55.55","25.36"
"65","000","00","013","1332","1863","744","373","371","36","780","1343","0","58.08","27.77"
"65","000","00","013","1333","0000","2768","1254","1514","106","2874","4947","0","58.1","25.35"
"65","000","00","013","1333","1812","692","356","336","32","724","1268","0","57.1","28.08"
"65","000","00","013","1333","1813","664","302","362","26","690","1196","0","57.69","25.25"
"65","000","00","013","1333","1814","755","303","452","28","783","1308","0","59.86","23.17"
"65","000","00","013","1333","1815","657","293","364","20","677","1175","0","57.62","24.94"
"65","000","00","013","1334","0000","1905","984","921","127","2032","3896","0","52.16","25.26"
"65","000","00","013","1334","1897","673","337","336","45","718","1321","0","54.35","25.51"
"65","000","00","013","1334","1898","563","292","271","43","606","1150","0","52.7","25.39"
"65","000","00","013","1334","1899","669","355","314","39","708","1425","0","49.68","24.91"
"65","000","00","013","1335","0000","2216","1020","1196","112","2328","4116","0","56.56","24.78"
"65","000","00","013","1335","1832","666","326","340","31","697","1335","0","52.21","24.42"
"65","000","00","013","1335","1833","710","335","375","52","762","1346","0","56.61","24.89"
"65","000","00","013","1335","1834","840","359","481","29","869","1435","0","60.56","25.02"
"65","000","00","013","1336","0000","2649","1246","1403","158","2807","4896","0","57.33","25.45"
"65","000","00","013","1336","1823","662","334","328","44","706","1175","0","60.09","28.43"
"65","000","00","013","1336","1824","649","320","329","49","698","1237","0","56.43","25.87"
"65","000","00","013","1336","1825","688","310","378","41","729","1256","0","58.04","24.68"
"65","000","00","013","1336","1826","650","282","368","24","674","1228","0","54.89","22.96"
"65","000","00","013","1337","0000","2090","944","1146","87","2177","3975","0","54.77","23.75"
"65","000","00","013","1337","1805","710","319","391","20","730","1320","0","55.3","24.17"
"65","000","00","013","1337","1806","635","300","335","33","668","1241","0","53.83","24.17"
"65","000","00","013","1337","1807","745","325","420","34","779","1414","0","55.09","22.98"
"65","000","00","013","1338","0000","2258","1059","1199","111","2369","4680","0","50.62","22.63"
"65","000","00","013","1338","1883","731","331","400","27","758","1511","0","50.17","21.91"
"65","000","00","013","1338","1884","774","353","421","47","821","1531","0","53.63","23.06"
"65","000","00","013","1338","1885","753","375","378","37","790","1638","0","48.23","22.89"
"65","000","00","013","1339","0000","1665","809","856","77","1742","2900","0","60.07","27.9"
"65","000","00","013","1339","1838","767","396","371","48","815","1333","0","61.14","29.71"
"65","000","00","013","1339","1839","898","413","485","29","927","1567","0","59.16","26.36"
"65","000","00","013","1340","0000","3028","1424","1604","161","3189","5663","0","56.31","25.15"
"65","000","00","013","1340","1913","716","372","344","33","749","1303","0","57.48","28.55"
"65","000","00","013","1340","1914","740","351","389","33","773","1365","0","56.63","25.71"
"65","000","00","013","1340","1915","754","357","397","67","821","1476","0","55.62","24.19"
"65","000","00","013","1340","1916","818","344","474","28","846","1519","0","55.69","22.65"
"65","000","00","013","1341","0000","1393","619","774","41","1434","2846","0","50.39","21.75"
"65","000","00","013","1341","1860","685","289","396","16","701","1484","0","47.24","19.47"
"65","000","00","013","1341","1861","708","330","378","25","733","1362","0","53.82","24.23"
"65","000","00","013","1342","0000","2413","1126","1287","90","2503","4173","0","59.98","26.98"
"65","000","00","013","1342","1855","791","325","466","23","814","1423","0","57.2","22.84"
"65","000","00","013","1342","1856","782","369","413","35","817","1321","0","61.85","27.93"
"65","000","00","013","1342","1857","840","432","408","32","872","1429","0","61.02","30.23"
"65","000","00","013","1343","0000","2765","1203","1562","94","2859","5120","0","55.84","23.5"
"65","000","00","013","1343","1852","902","405","497","27","929","1691","0","54.94","23.95"
"65","000","00","013","1343","1853","857","396","461","38","895","1657","0","54.01","23.9"
"65","000","00","013","1343","1854","1006","402","604","29","1035","1772","0","58.41","22.69"
"65","000","00","013","1344","0000","1658","743","915","67","1725","3048","0","56.59","24.38"
"65","000","00","013","1344","1845","877","394","483","33","910","1584","0","57.45","24.87"
"65","000","00","013","1344","1846","781","349","432","34","815","1464","0","55.67","23.84"
"65","000","00","013","1345","0000","1397","666","731","79","1476","2660","0","55.49","25.04"
"65","000","00","013","1345","1873","744","348","396","38","782","1367","0","57.21","25.46"
"65","000","00","013","1345","1874","653","318","335","41","694","1293","0","53.67","24.59"
"65","000","00","013","1346","0000","2841","1134","1707","144","2985","5364","0","55.65","21.14"
"65","000","00","013","1346","1889","941","363","578","72","1013","1774","0","57.1","20.46"
"65","000","00","013","1346","1890","965","390","575","20","985","1792","0","54.97","21.76"
"65","000","00","013","1346","1891","935","381","554","52","987","1798","0","54.89","21.19"
"65","000","00","013","1347","0000","1995","958","1037","114","2109","3736","0","56.45","25.64"
"65","000","00","013","1347","1903","720","300","420","32","752","1324","0","56.8","22.66"
"65","000","00","013","1347","1904","604","309","295","35","639","1189","0","53.74","25.99"
"65","000","00","013","1347","1905","671","349","322","47","718","1223","0","58.71","28.54"
"65","000","00","014","0000","0000","85576","42796","42780","4485","90061","167457","201173","53.78","25.56"
"65","000","00","014","1401","0000","5824","2595","3229","223","6047","10484","0","57.68","24.75"
"65","000","00","014","1401","0581","1007","473","534","47","1054","1791","0","58.85","26.41"
"65","000","00","014","1401","0582","996","431","565","41","1037","1714","0","60.5","25.15"
"65","000","00","014","1401","0583","989","376","613","28","1017","1780","0","57.13","21.12"
"65","000","00","014","1401","0584","936","434","502","36","972","1713","0","56.74","25.34"
"65","000","00","014","1401","0585","948","438","510","33","981","1720","0","57.03","25.47"
"65","000","00","014","1401","0586","948","443","505","38","986","1766","0","55.83","25.08"
"65","000","00","014","1402","0000","2644","1376","1268","139","2783","4958","0","56.13","27.75"
"65","000","00","014","1402","0573","905","451","454","47","952","1652","0","57.63","27.3"
"65","000","00","014","1402","0574","871","499","372","49","920","1650","0","55.76","30.24"
"65","000","00","014","1402","0575","868","426","442","43","911","1656","0","55.01","25.72"
"65","000","00","014","1403","0000","1589","671","918","68","1657","3576","0","46.34","18.76"
"65","000","00","014","1403","0561","665","334","331","35","700","1779","0","39.35","18.77"
"65","000","00","014","1403","0562","924","337","587","33","957","1797","0","53.26","18.75"
"65","000","00","014","1404","0000","2511","1221","1290","167","2678","4665","0","57.41","26.17"
"65","000","00","014","1404","0555","868","422","446","48","916","1600","0","57.25","26.38"
"65","000","00","014","1404","0556","817","398","419","52","869","1549","0","56.1","25.69"
"65","000","00","014","1404","0557","826","401","425","67","893","1516","0","58.91","26.45"
"65","000","00","014","1405","0000","1705","820","885","126","1831","3361","0","54.48","24.4"
"65","000","00","014","1405","0655","817","372","445","59","876","1673","0","52.36","22.24"
"65","000","00","014","1405","0656","888","448","440","67","955","1688","0","56.58","26.54"
"65","000","00","014","1406","0000","4450","2082","2368","214","4664","9051","0","51.53","23.0"
"65","000","00","014","1406","0640","959","479","480","57","1016","1851","0","54.89","25.88"
"65","000","00","014","1406","0641","841","398","443","35","876","1791","0","48.91","22.22"
"65","000","00","014","1406","0642","884","445","439","43","927","1853","0","50.03","24.02"
"65","000","00","014","1406","0643","848","342","506","29","877","1758","0","49.89","19.45"
"65","000","00","014","1406","0644","918","418","500","50","968","1798","0","53.84","23.25"
"65","000","00","014","1407","0000","2681","1311","1370","151","2832","5589","0","50.67","23.46"
"65","000","00","014","1407","0604","928","442","486","43","971","1806","0","53.77","24.47"
"65","000","00","014","1407","0605","932","435","497","64","996","1910","0","52.15","22.77"
"65","000","00","014","1407","0606","821","434","387","44","865","1873","0","46.18","23.17"
"65","000","00","014","1408","0000","2573","1290","1283","126","2699","4826","0","55.93","26.73"
"65","000","00","014","1408","0616","849","435","414","47","896","1634","0","54.83","26.62"
"65","000","00","014","1408","0617","832","392","440","46","878","1573","0","55.82","24.92"
"65","000","00","014","1408","0618","892","463","429","33","925","1619","0","57.13","28.6"
"65","000","00","014","1409","0000","2862","1485","1377","154","3016","5491","0","54.93","27.04"
"65","000","00","014","1409","0619","969","554","415","58","1027","1878","0","54.69","29.5"
"65","000","00","014","1409","0620","912","444","468","60","972","1797","0","54.09","24.71"
"65","000","00","014","1409","0621","981","487","494","36","1017","1816","0","56.0","26.82"
"65","000","00","014","1410","0000","1481","737","744","98","1579","2836","0","55.68","25.99"
"65","000","00","014","1410","0622","653","309","344","43","696","1344","0","51.79","22.99"
"65","000","00","014","1410","0623","828","428","400","55","883","1492","0","59.18","28.69"
"65","000","00","014","1411","0000","1523","774","749","72","1595","2963","0","53.83","26.12"
"65","000","00","014","1411","0636","861","430","431","38","899","1602","0","56.12","26.84"
"65","000","00","014","1411","0637","662","344","318","34","696","1361","0","51.14","25.28"
"65","000","00","014","1412","0000","1270","672","598","93","1363","2287","0","59.6","29.38"
"65","000","00","014","1412","0634","605","325","280","47","652","1111","0","58.69","29.25"
"65","000","00","014","1412","0635","665","347","318","46","711","1176","0","60.46","29.51"
"65","000","00","014","1413","0000","1013","498","515","49","1062","1959","0","54.21","25.42"
"65","000","00","014","1413","0624","1013","498","515","49","1062","1959","0","54.21","25.42"
"65","000","00","014","1414","0000","1457","721","736","94","1551","2980","0","52.05","24.19"
"65","000","00","014","1414","0630","697","350","347","39","736","1332","0","55.26","26.28"
"65","000","00","014","1414","0631","760","371","389","55","815","1648","0","49.45","22.51"
"65","000","00","014","1415","0000","2719","1422","1297","171","2890","5122","0","56.42","27.76"
"65","000","00","014","1415","0587","848","450","398","43","891","1623","0","54.9","27.73"
"65","000","00","014","1415","0588","889","459","430","83","972","1740","0","55.86","26.38"
"65","000","00","014","1415","0589","982","513","469","45","1027","1759","0","58.39","29.16"
"65","000","00","014","1416","0000","3051","1511","1540","136","3187","5489","0","58.06","27.53"
"65","000","00","014","1416","0590","987","473","514","53","1040","1775","0","58.59","26.65"
"65","000","00","014","1416","0591","1062","531","531","34","1096","1909","0","57.41","27.82"
"65","000","00","014","1416","0592","1002","507","495","49","1051","1805","0","58.23","28.09"
"65","000","00","014","1417","0000","3068","1584","1484","129","3197","5952","0","53.71","26.61"
"65","000","00","014","1417","0597","735","349","386","34","769","1434","0","53.63","24.34"
"65","000","00","014","1417","0598","780","442","338","30","810","1450","0","55.86","30.48"
"65","000","00","014","1417","0599","767","379","388","23","790","1543","0","51.2","24.56"
"65","000","00","014","1417","0600","786","414","372","42","828","1525","0","54.3","27.15"
"65","000","00","014","1418","0000","1686","861","825","100","1786","3545","0","50.38","24.29"
"65","000","00","014","1418","0607","834","424","410","51","885","1785","0","49.58","23.75"
"65","000","00","014","1418","0608","852","437","415","49","901","1760","0","51.19","24.83"
"65","000","00","014","1419","0000","2572","1241","1331","128","2700","5146","0","52.47","24.12"
"65","000","00","014","1419","0609","979","476","503","46","1025","1841","0","55.68","25.86"
"65","000","00","014","1419","0610","908","402","506","29","937","1855","0","50.51","21.67"
"65","000","00","014","1419","0611","685","363","322","53","738","1450","0","50.9","25.03"
"65","000","00","014","1420","0000","1580","872","708","86","1666","3126","0","53.29","27.9"
"65","000","00","014","1420","0612","816","447","369","48","864","1585","0","54.51","28.2"
"65","000","00","014","1420","0613","764","425","339","38","802","1541","0","52.04","27.58"
"65","000","00","014","1421","0000","3997","2034","1963","201","4198","8323","0","50.44","24.44"
"65","000","00","014","1421","0645","866","409","457","43","909","1645","0","55.26","24.86"
"65","000","00","014","1421","0646","758","402","356","37","795","1612","0","49.32","24.94"
"65","000","00","014","1421","0647","825","454","371","54","879","1784","0","49.27","25.45"
"65","000","00","014","1421","0648","761","390","371","31","792","1701","0","46.56","22.93"
"65","000","00","014","1421","0649","787","379","408","36","823","1581","0","52.06","23.97"
"65","000","00","014","1422","0000","2541","1347","1194","137","2678","4648","0","57.62","28.98"
"65","000","00","014","1422","0650","802","426","376","45","847","1534","0","55.22","27.77"
"65","000","00","014","1422","0651","899","494","405","39","938","1620","0","57.9","30.49"
"65","000","00","014","1422","0652","840","427","413","53","893","1494","0","59.77","28.58"
"65","000","00","014","1423","0000","1516","735","781","86","1602","2881","0","55.61","25.51"
"65","000","00","014","1423","0579","693","326","367","44","737","1367","0","53.91","23.85"
"65","000","00","014","1423","0580","823","409","414","42","865","1514","0","57.13","27.01"
"65","000","00","014","1424","0000","2442","1195","1247","104","2546","4810","0","52.93","24.84"
"65","000","00","014","1424","0566","783","391","392","38","821","1524","0","53.87","25.66"
"65","000","00","014","1424","0567","804","411","393","40","844","1612","0","52.36","25.5"
"65","000","00","014","1424","0568","855","393","462","26","881","1674","0","52.63","23.48"
"65","000","00","014","1425","0000","1564","815","749","64","1628","2938","0","55.41","27.74"
"65","000","00","014","1425","0571","803","451","352","32","835","1473","0","56.69","30.62"
"65","000","00","014","1425","0572","761","364","397","32","793","1465","0","54.13","24.85"
"65","000","00","014","1426","0000","1418","769","649","59","1477","2726","0","54.18","28.21"
"65","000","00","014","1426","0632","717","399","318","25","742","1355","0","54.76","29.45"
"65","000","00","014","1426","0633","701","370","331","34","735","1371","0","53.61","26.99"
"65","000","00","014","1427","0000","2570","1353","1217","163","2733","4838","0","56.49","27.97"
"65","000","00","014","1427","0625","823","451","372","60","883","1611","0","54.81","28.0"
"65","000","00","014","1427","0626","869","467","402","50","919","1574","0","58.39","29.67"
"65","000","00","014","1427","0627","878","435","443","53","931","1653","0","56.32","26.32"
"65","000","00","014","1428","0000","1922","977","945","107","2029","4897","0","41.43","19.95"
"65","000","00","014","1428","0628","1002","507","495","51","1053","3085","0","34.13","16.43"
"65","000","00","014","1428","0629","920","470","450","56","976","1812","0","53.86","25.94"
"65","000","00","014","1429","0000","2237","1115","1122","141","2378","4270","0","55.69","26.11"
"65","000","00","014","1429","0558","716","363","353","59","775","1404","0","55.2","25.85"
"65","000","00","014","1429","0559","713","387","326","50","763","1381","0","55.25","28.02"
"65","000","00","014","1429","0560","808","365","443","32","840","1485","0","56.57","24.58"
"65","000","00","014","1430","0000","1312","584","728","55","1367","2725","0","50.17","21.43"
"65","000","00","014","1430","0657","657","326","331","32","689","1249","0","55.16","26.1"
"65","000","00","014","1430","0658","655","258","397","23","678","1476","0","45.93","17.48"
"65","000","00","014","1431","0000","2333","1254","1079","127","2460","4569","0","53.84","27.45"
"65","000","00","014","1431","0576","789","436","353","41","830","1571","0","52.83","27.75"
"65","000","00","014","1431","0577","771","433","338","52","823","1523","0","54.04","28.43"
"65","000","00","014","1431","0578","773","385","388","34","807","1475","0","54.71","26.1"
"65","000","00","014","1432","0000","1277","646","631","90","1367","2455","0","55.68","26.31"
"65","000","00","014","1432","0638","790","379","411","48","838","1530","0","54.77","24.77"
"65","000","00","014","1432","0639","487","267","220","42","529","925","0","57.19","28.86"
"65","000","00","014","1433","0000","1182","637","545","57","1239","2168","0","57.15","29.38"
"65","000","00","014","1433","0653","637","340","297","29","666","1183","0","56.3","28.74"
"65","000","00","014","1433","0654","545","297","248","28","573","985","0","58.17","30.15"
"65","000","00","014","1434","0000","1493","758","735","89","1582","2867","0","55.18","26.44"
"65","000","00","014","1434","0614","819","431","388","42","861","1626","0","52.95","26.51"
"65","000","00","014","1434","0615","674","327","347","47","721","1241","0","58.1","26.35"
"65","000","00","014","1435","0000","2372","1235","1137","118","2490","4566","0","54.53","27.05"
"65","000","00","014","1435","0563","751","416","335","39","790","1364","0","57.92","30.5"
"65","000","00","014","1435","0564","875","438","437","52","927","1635","0","56.7","26.79"
"65","000","00","014","1435","0565","746","381","365","27","773","1567","0","49.33","24.31"
"65","000","00","014","1436","0000","1652","839","813","72","1724","3652","0","47.21","22.97"
"65","000","00","014","1436","0569","869","433","436","40","909","1838","0","49.46","23.56"
"65","000","00","014","1436","0570","783","406","377","32","815","1814","0","44.93","22.38"
"65","000","00","014","1437","0000","3427","1759","1668","158","3585","6697","0","53.53","26.27"
"65","000","00","014","1437","0593","845","416","429","35","880","1642","0","53.59","25.33"
"65","000","00","014","1437","0594","889","457","432","40","929","1713","0","54.23","26.68"
"65","000","00","014","1437","0595","854","453","401","42","896","1746","0","51.32","25.95"
"65","000","00","014","1437","0596","839","433","406","41","880","1596","0","55.14","27.13"
"65","000","00","014","1438","0000","2062","1000","1062","133","2195","4021","0","54.59","24.87"
"65","000","00","014","1438","0601","693","322","371","48","741","1419","0","52.22","22.69"
"65","000","00","014","1438","0602","699","351","348","43","742","1298","0","57.16","27.04"
"65","000","00","014","1438","0603","670","327","343","42","712","1304","0","54.6","25.08"
"65","000","00","015","0000","0000","37005","18149","18856","1981","38986","72443","86156","53.82","25.05"
"65","000","00","015","1501","0000","2204","1230","974","117","2321","4225","0","54.93","29.11"
"65","000","00","015","1501","0207","752","409","343","52","804","1456","0","55.22","28.09"
"65","000","00","015","1501","0208","739","397","342","50","789","1482","0","53.24","26.79"
"65","000","00","015","1501","0209","713","424","289","15","728","1287","0","56.57","32.94"
"65","000","00","015","1502","0000","581","382","199","26","607","1106","0","54.88","34.54"
"65","000","00","015","1502","0210","581","382","199","26","607","1106","0","54.88","34.54"
"65","000","00","015","1503","0000","1844","962","882","90","1934","3437","0","56.27","27.99"
"65","000","00","015","1503","0212","956","509","447","34","990","1833","0","54.01","27.77"
"65","000","00","015","1503","0213","619","311","308","37","656","1141","0","57.49","27.26"
"65","000","00","015","1503","0214","269","142","127","19","288","463","0","62.2","30.67"
"65","000","00","015","1504","0000","640","351","289","55","695","1283","0","54.17","27.36"
"65","000","00","015","1504","0211","640","351","289","55","695","1283","0","54.17","27.36"
"65","000","00","015","1505","0000","2558","1351","1207","161","2719","5271","0","51.58","25.63"
"65","000","00","015","1505","0219","882","485","397","86","968","1832","0","52.84","26.47"
"65","000","00","015","1505","0220","794","411","383","35","829","1542","0","53.76","26.65"
"65","000","00","015","1505","0221","882","455","427","40","922","1897","0","48.6","23.99"
"65","000","00","015","1506","0000","2576","1311","1265","187","2763","5478","0","50.44","23.93"
"65","000","00","015","1506","0222","893","419","474","74","967","1964","0","49.24","21.33"
"65","000","00","015","1506","0223","825","437","388","62","887","1779","0","49.86","24.56"
"65","000","00","015","1506","0224","858","455","403","51","909","1735","0","52.39","26.22"
"65","000","00","015","1507","0000","615","389","226","23","638","1281","0","49.8","30.37"
"65","000","00","015","1507","0229","615","389","226","23","638","1281","0","49.8","30.37"
"65","000","00","015","1508","0000","1947","1011","936","117","2064","3910","0","52.79","25.86"
"65","000","00","015","1508","0236","509","275","234","25","534","1333","0","40.06","20.63"
"65","000","00","015","1508","0237","721","381","340","41","762","1263","0","60.33","30.17"
"65","000","00","015","1508","0238","717","355","362","51","768","1314","0","58.45","27.02"
"65","000","00","015","1509","0000","1530","750","780","92","1622","3126","0","51.89","23.99"
"65","000","00","015","1509","0230","787","371","416","60","847","1566","0","54.09","23.69"
"65","000","00","015","1509","0231","743","379","364","32","775","1560","0","49.68","24.29"
"65","000","00","015","1510","0000","2390","1102","1288","117","2507","4643","0","54.0","23.73"
"65","000","00","015","1510","0239","735","342","393","34","769","1513","0","50.83","22.6"
"65","000","00","015","1510","0240","818","360","458","39","857","1517","0","56.49","23.73"
"65","000","00","015","1510","0241","837","400","437","44","881","1613","0","54.62","24.8"
"65","000","00","015","1511","0000","1115","269","846","57","1172","2281","0","51.38","11.79"
"65","000","00","015","1511","0253","541","130","411","28","569","1127","0","50.49","11.54"
"65","000","00","015","1511","0254","574","139","435","29","603","1154","0","52.25","12.05"
"65","000","00","015","1512","0000","1557","486","1071","102","1659","2709","0","61.24","17.94"
"65","000","00","015","1512","0251","800","281","519","52","852","1397","0","60.99","20.11"
"65","000","00","015","1512","0252","757","205","552","50","807","1312","0","61.51","15.63"
"65","000","00","015","1513","0000","2156","990","1166","94","2250","3916","0","57.46","25.28"
"65","000","00","015","1513","0248","747","343","404","25","772","1441","0","53.57","23.8"
"65","000","00","015","1513","0249","727","326","401","29","756","1305","0","57.93","24.98"
"65","000","00","015","1513","0250","682","321","361","40","722","1170","0","61.71","27.44"
"65","000","00","015","1514","0000","1477","838","639","111","1588","2819","0","56.33","29.73"
"65","000","00","015","1514","0217","785","427","358","60","845","1534","0","55.08","27.84"
"65","000","00","015","1514","0218","692","411","281","51","743","1285","0","57.82","31.98"
"65","000","00","015","1515","0000","1767","765","1002","66","1833","3401","0","53.9","22.49"
"65","000","00","015","1515","0232","851","357","494","32","883","1622","0","54.44","22.01"
"65","000","00","015","1515","0233","916","408","508","34","950","1779","0","53.4","22.93"
"65","000","00","015","1516","0000","1793","924","869","67","1860","3446","0","53.98","26.81"
"65","000","00","015","1516","0215","949","456","493","39","988","1786","0","55.32","25.53"
"65","000","00","015","1516","0216","844","468","376","28","872","1660","0","52.53","28.19"
"65","000","00","015","1517","0000","1555","756","799","87","1642","3054","0","53.77","24.75"
"65","000","00","015","1517","0234","736","356","380","41","777","1487","0","52.25","23.94"
"65","000","00","015","1517","0235","819","400","419","46","865","1567","0","55.2","25.53"
"65","000","00","015","1518","0000","3681","1797","1884","162","3843","7389","0","52.01","24.32"
"65","000","00","015","1518","0225","1109","494","615","29","1138","2299","0","49.5","21.49"
"65","000","00","015","1518","0226","824","414","410","39","863","1755","0","49.17","23.59"
"65","000","00","015","1518","0227","869","431","438","48","917","1674","0","54.78","25.75"
"65","000","00","015","1518","0228","879","458","421","46","925","1661","0","55.69","27.57"
"65","000","00","015","1519","0000","3480","1718","1762","170","3650","6815","0","53.56","25.21"
"65","000","00","015","1519","0242","827","403","424","49","876","1616","0","54.21","24.94"
"65","000","00","015","1519","0243","823","391","432","43","866","1616","0","53.59","24.2"
"65","000","00","015","1519","0244","873","412","461","51","924","1689","0","54.71","24.39"
"65","000","00","015","1519","0245","957","512","445","27","984","1894","0","51.95","27.03"
"65","000","00","015","1520","0000","1539","767","772","80","1619","2853","0","56.75","26.88"
"65","000","00","015","1520","0246","722","380","342","42","764","1210","0","63.14","31.4"
"65","000","00","015","1520","0247","817","387","430","38","855","1643","0","52.04","23.55"
"65","000","00","016","0000","0000","34340","15601","18739","1473","35813","64252","78683","55.74","24.28"
"65","000","00","016","1601","0000","426","203","223","18","444","829","0","53.56","24.49"
"65","000","00","016","1601","0255","316","156","160","12","328","643","0","51.01","24.26"
"65","000","00","016","1601","0256","110","47","63","6","116","186","0","62.37","25.27"
"65","000","00","016","1602","0000","1558","689","869","87","1645","3051","0","53.92","22.58"
"65","000","00","016","1602","0257","718","319","399","38","756","1457","0","51.89","21.89"
"65","000","00","016","1602","0258","840","370","470","49","889","1594","0","55.77","23.21"
"65","000","00","016","1603","0000","2986","1307","1679","114","3100","5921","0","52.36","22.07"
"65","000","00","016","1603","0259","772","304","468","35","807","1598","0","50.5","19.02"
"65","000","00","016","1603","0260","754","333","421","20","774","1503","0","51.5","22.16"
"65","000","00","016","1603","0261","716","323","393","34","750","1436","0","52.23","22.49"
"65","000","00","016","1603","0262","744","347","397","25","769","1384","0","55.56","25.07"
"65","000","00","016","1604","0000","1345","619","726","60","1405","2526","0","55.62","24.51"
"65","000","00","016","1604","0263","670","305","365","37","707","1231","0","57.43","24.78"
"65","000","00","016","1604","0264","675","314","361","23","698","1295","0","53.9","24.25"
"65","000","00","016","1605","0000","2054","942","1112","93","2147","3901","0","55.04","24.15"
"65","000","00","016","1605","0267","659","322","337","26","685","1253","0","54.67","25.7"
"65","000","00","016","1605","0268","639","279","360","30","669","1294","0","51.7","21.56"
"65","000","00","016","1605","0269","756","341","415","37","793","1354","0","58.57","25.18"
"65","000","00","016","1606","0000","1956","877","1079","74","2030","3605","0","56.31","24.33"
"65","000","00","016","1606","0270","671","265","406","22","693","1259","0","55.04","21.05"
"65","000","00","016","1606","0271","711","328","383","18","729","1252","0","58.23","26.2"
"65","000","00","016","1606","0272","574","284","290","34","608","1094","0","55.58","25.96"
"65","000","00","016","1607","0000","2157","1045","1112","136","2293","4048","0","56.65","25.82"
"65","000","00","016","1607","0280","695","353","342","45","740","1201","0","61.62","29.39"
"65","000","00","016","1607","0281","617","311","306","49","666","1182","0","56.35","26.31"
"65","000","00","016","1607","0282","845","381","464","42","887","1665","0","53.27","22.88"
"65","000","00","016","1608","0000","1803","835","968","94","1897","3306","0","57.38","25.26"
"65","000","00","016","1608","0287","575","260","315","47","622","1152","0","53.99","22.57"
"65","000","00","016","1608","0288","601","288","313","24","625","1114","0","56.1","25.85"
"65","000","00","016","1608","0289","627","287","340","23","650","1040","0","62.5","27.6"
"65","000","00","016","1609","0000","1936","929","1007","73","2009","3517","0","57.12","26.41"
"65","000","00","016","1609","0294","657","295","362","26","683","1211","0","56.4","24.36"
"65","000","00","016","1609","0295","703","365","338","18","721","1237","0","58.29","29.51"
"65","000","00","016","1609","0296","576","269","307","29","605","1069","0","56.59","25.16"
"65","000","00","016","1610","0000","2398","1124","1274","84","2482","4348","0","57.08","25.85"
"65","000","00","016","1610","0299","738","329","409","21","759","1420","0","53.45","23.17"
"65","000","00","016","1610","0300","771","358","413","34","805","1337","0","60.21","26.78"
"65","000","00","016","1610","0301","889","437","452","29","918","1591","0","57.7","27.47"
"65","000","00","016","1611","0000","1748","814","934","68","1816","3224","0","56.33","25.25"
"65","000","00","016","1611","0273","866","380","486","30","896","1590","0","56.35","23.9"
"65","000","00","016","1611","0274","882","434","448","38","920","1634","0","56.3","26.56"
"65","000","00","016","1612","0000","3752","1764","1988","155","3907","7245","0","53.93","24.35"
"65","000","00","016","1612","0283","966","458","508","45","1011","1855","0","54.5","24.69"
"65","000","00","016","1612","0284","995","472","523","43","1038","1866","0","55.63","25.29"
"65","000","00","016","1612","0285","1001","442","559","37","1038","1935","0","53.64","22.84"
"65","000","00","016","1612","0286","790","392","398","30","820","1589","0","51.6","24.67"
"65","000","00","016","1613","0000","1153","554","599","55","1208","1978","0","61.07","28.01"
"65","000","00","016","1613","0290","571","253","318","30","601","1003","0","59.92","25.22"
"65","000","00","016","1613","0291","582","301","281","25","607","975","0","62.26","30.87"
"65","000","00","016","1614","0000","1531","716","815","61","1592","2920","0","54.52","24.52"
"65","000","00","016","1614","0292","753","368","385","35","788","1440","0","54.72","25.56"
"65","000","00","016","1614","0293","778","348","430","26","804","1480","0","54.32","23.51"
"65","000","00","016","1615","0000","1879","816","1063","71","1950","3331","0","58.54","24.5"
"65","000","00","016","1615","0297","951","396","555","46","997","1680","0","59.35","23.57"
"65","000","00","016","1615","0298","928","420","508","25","953","1651","0","57.72","25.44"
"65","000","00","016","1616","0000","1757","755","1002","81","1838","3173","0","57.93","23.79"
"65","000","00","016","1616","0265","864","382","482","38","902","1563","0","57.71","24.44"
"65","000","00","016","1616","0266","893","373","520","43","936","1610","0","58.14","23.17"
"65","000","00","016","1617","0000","3901","1612","2289","149","4050","7329","0","55.26","21.99"
"65","000","00","016","1617","0275","705","303","402","26","731","1536","0","47.59","19.73"
"65","000","00","016","1617","0276","836","361","475","38","874","1534","0","56.98","23.53"
"65","000","00","016","1617","0277","916","345","571","35","951","1545","0","61.55","22.33"
"65","000","00","016","1617","0278","756","295","461","28","784","1399","0","56.04","21.09"
"65","000","00","016","1617","0279","688","308","380","22","710","1315","0","53.99","23.42"
"65","000","00","017","0000","0000","46670","19747","26923","1802","48472","86203","108950","56.23","22.91"
"65","000","00","017","1701","0000","1881","900","981","108","1989","3657","0","54.39","24.61"
"65","000","00","017","1701","0145","653","336","317","34","687","1268","0","54.18","26.5"
"65","000","00","017","1701","0146","568","266","302","39","607","1171","0","51.84","22.72"
"65","000","00","017","1701","0147","660","298","362","35","695","1218","0","57.06","24.47"
"65","000","00","017","1702","0000","2382","1130","1252","127","2509","4861","0","51.61","23.25"
"65","000","00","017","1702","0148","888","386","502","31","919","1788","0","51.4","21.59"
"65","000","00","017","1702","0149","774","393","381","53","827","1625","0","50.89","24.18"
"65","000","00","017","1702","0150","720","351","369","43","763","1448","0","52.69","24.24"
"65","000","00","017","1703","0000","4408","1908","2500","185","4593","8259","0","55.61","23.1"
"65","000","00","017","1703","0151","648","310","338","42","690","1328","0","51.96","23.34"
"65","000","00","017","1703","0152","663","311","352","44","707","1523","0","46.42","20.42"
"65","000","00","017","1703","0153","663","277","386","27","690","1245","0","55.42","22.25"
"65","000","00","017","1703","0154","804","320","484","29","833","1329","0","62.68","24.08"
"65","000","00","017","1703","0155","845","352","493","25","870","1465","0","59.39","24.03"
"65","000","00","017","1703","0156","785","338","447","18","803","1369","0","58.66","24.69"
"65","000","00","017","1704","0000","2142","1027","1115","104","2246","3818","0","58.83","26.9"
"65","000","00","017","1704","0157","764","374","390","31","795","1346","0","59.06","27.79"
"65","000","00","017","1704","0158","599","329","270","52","651","1181","0","55.12","27.86"
"65","000","00","017","1704","0159","779","324","455","21","800","1291","0","61.97","25.1"
"65","000","00","017","1705","0000","1983","923","1060","78","2061","3654","0","56.4","25.26"
"65","000","00","017","1705","0160","653","305","348","22","675","1213","0","55.65","25.14"
"65","000","00","017","1705","0161","706","305","401","28","734","1256","0","58.44","24.28"
"65","000","00","017","1705","0162","624","313","311","28","652","1185","0","55.02","26.41"
"65","000","00","017","1706","0000","734","404","330","40","774","1361","0","56.87","29.68"
"65","000","00","017","1706","0163","734","404","330","40","774","1361","0","56.87","29.68"
"65","000","00","017","1707","0000","9365","3636","5729","279","9644","17256","0","55.89","21.07"
"65","000","00","017","1707","0164","877","271","606","21","898","1756","0","51.14","15.43"
"65","000","00","017","1707","0165","836","318","518","28","864","1676","0","51.55","18.97"
"65","000","00","017","1707","0166","851","307","544","17","868","1540","0","56.36","19.94"
"65","000","00","017","1707","0167","831","285","546","26","857","1569","0","54.62","18.16"
"65","000","00","017","1707","0168","813","282","531","24","837","1514","0","55.28","18.63"
"65","000","00","017","1707","0169","678","272","406","18","696","1193","0","58.34","22.8"
"65","000","00","017","1707","0170","904","354","550","19","923","1610","0","57.33","21.99"
"65","000","00","017","1707","0171","751","330","421","27","778","1338","0","58.15","24.66"
"65","000","00","017","1707","0172","643","315","328","24","667","1141","0","58.46","27.61"
"65","000","00","017","1707","0173","715","310","405","26","741","1307","0","56.69","23.72"
"65","000","00","017","1707","0174","741","284","457","23","764","1327","0","57.57","21.4"
"65","000","00","017","1707","0175","725","308","417","26","751","1285","0","58.44","23.97"
"65","000","00","017","1708","0000","8590","3403","5187","218","8808","15777","0","55.83","21.57"
"65","000","00","017","1708","0176","814","431","383","24","838","1481","0","56.58","29.1"
"65","000","00","017","1708","0177","845","344","501","19","864","1510","0","57.22","22.78"
"65","000","00","017","1708","0178","934","383","551","33","967","1785","0","54.17","21.46"
"65","000","00","017","1708","0179","951","395","556","18","969","1792","0","54.07","22.04"
"65","000","00","017","1708","0180","842","319","523","19","861","1517","0","56.76","21.03"
"65","000","00","017","1708","0181","877","295","582","24","901","1564","0","57.61","18.86"
"65","000","00","017","1708","0182","874","294","580","24","898","1560","0","57.56","18.85"
"65","000","00","017","1708","0183","822","340","482","20","842","1544","0","54.53","22.02"
"65","000","00","017","1708","0184","849","321","528","15","864","1593","0","54.24","20.15"
"65","000","00","017","1708","0185","782","281","501","22","804","1431","0","56.18","19.64"
"65","000","00","017","1709","0000","2987","1275","1712","114","3101","5291","0","58.61","24.1"
"65","000","00","017","1709","0195","808","350","458","25","833","1380","0","60.36","25.36"
"65","000","00","017","1709","0196","742","314","428","36","778","1367","0","56.91","22.97"
"65","000","00","017","1709","0197","767","333","434","20","787","1350","0","58.3","24.67"
"65","000","00","017","1709","0198","670","278","392","33","703","1194","0","58.88","23.28"
"65","000","00","017","1710","0000","468","276","192","37","505","1026","0","49.22","26.9"
"65","000","00","017","1710","0202","468","276","192","37","505","1026","0","49.22","26.9"
"65","000","00","017","1711","0000","647","308","339","33","680","1210","0","56.2","25.45"
"65","000","00","017","1711","0203","647","308","339","33","680","1210","0","56.2","25.45"
"65","000","00","017","1712","0000","478","269","209","42","520","912","0","57.02","29.5"
"65","000","00","017","1712","0204","478","269","209","42","520","912","0","57.02","29.5"
"65","000","00","017","1713","0000","462","234","228","26","488","824","0","59.22","28.4"
"65","000","00","017","1713","0205","462","234","228","26","488","824","0","59.22","28.4"
"65","000","00","017","1714","0000","783","382","401","51","834","1411","0","59.11","27.07"
"65","000","00","017","1714","0206","783","382","401","51","834","1411","0","59.11","27.07"
"65","000","00","017","1715","0000","3233","1260","1973","134","3367","5852","0","57.54","21.53"
"65","000","00","017","1715","0186","808","316","492","37","845","1571","0","53.79","20.11"
"65","000","00","017","1715","0187","802","275","527","29","831","1439","0","57.75","19.11"
"65","000","00","017","1715","0188","809","315","494","34","843","1451","0","58.1","21.71"
"65","000","00","017","1715","0189","814","354","460","34","848","1391","0","60.96","25.45"
"65","000","00","017","1716","0000","4120","1543","2577","140","4260","7417","0","57.44","20.8"
"65","000","00","017","1716","0190","792","292","500","19","811","1461","0","55.51","19.99"
"65","000","00","017","1716","0191","898","320","578","19","917","1691","0","54.23","18.92"
"65","000","00","017","1716","0192","809","300","509","39","848","1524","0","55.64","19.69"
"65","000","00","017","1716","0193","803","295","508","37","840","1343","0","62.55","21.97"
"65","000","00","017","1716","0194","818","336","482","26","844","1398","0","60.37","24.03"
"65","000","00","017","1717","0000","2007","869","1138","86","2093","3617","0","57.87","24.03"
"65","000","00","017","1717","0199","709","303","406","28","737","1344","0","54.84","22.54"
"65","000","00","017","1717","0200","627","289","338","30","657","1154","0","56.93","25.04"
"65","000","00","017","1717","0201","671","277","394","28","699","1119","0","62.47","24.75"
"65","000","00","018","0000","0000","10979","4965","6014","517","11496","20624","23617","55.74","24.07"
"65","000","00","018","1801","0000","1546","696","850","51","1597","3004","0","53.16","23.17"
"65","000","00","018","1801","2169","713","329","384","11","724","1496","0","48.4","21.99"
"65","000","00","018","1801","2170","833","367","466","40","873","1508","0","57.89","24.34"
"65","000","00","018","1802","0000","1216","548","668","63","1279","2281","0","56.07","24.02"
"65","000","00","018","1802","2163","575","268","307","29","604","1142","0","52.89","23.47"
"65","000","00","018","1802","2164","641","280","361","34","675","1139","0","59.26","24.58"
"65","000","00","018","1803","0000","1360","608","752","67","1427","2710","0","52.66","22.44"
"65","000","00","018","1803","2167","680","303","377","36","716","1330","0","53.83","22.78"
"65","000","00","018","1803","2168","680","305","375","31","711","1380","0","51.52","22.1"
"65","000","00","018","1804","0000","1085","461","624","35","1120","1946","0","57.55","23.69"
"65","000","00","018","1804","2174","407","204","203","22","429","782","0","54.86","26.09"
"65","000","00","018","1804","2175","678","257","421","13","691","1164","0","59.36","22.08"
"65","000","00","018","1805","0000","319","161","158","19","338","556","0","60.79","28.96"
"65","000","00","018","1805","2178","319","161","158","19","338","556","0","60.79","28.96"
"65","000","00","018","1806","0000","3025","1401","1624","142","3167","5579","0","56.77","25.11"
"65","000","00","018","1806","2171","887","505","382","45","932","1624","0","57.39","31.1"
"65","000","00","018","1806","2172","1124","477","647","45","1169","2165","0","54.0","22.03"
"65","000","00","018","1806","2173","1014","419","595","52","1066","1790","0","59.55","23.41"
"65","000","00","018","1807","0000","1217","568","649","86","1303","2465","0","52.86","23.04"
"65","000","00","018","1807","2165","523","274","249","58","581","1065","0","54.55","25.73"
"65","000","00","018","1807","2166","694","294","400","28","722","1400","0","51.57","21.0"
"65","000","00","018","1808","0000","1211","522","689","54","1265","2083","0","60.73","25.06"
"65","000","00","018","1808","2176","766","303","463","38","804","1344","0","59.82","22.54"
"65","000","00","018","1808","2177","445","219","226","16","461","739","0","62.38","29.63"
"65","000","00","019","0000","0000","3352","1705","1647","203","3555","6861","7727","51.81","24.85"
"65","000","00","019","1901","0000","230","119","111","14","244","391","0","62.4","30.43"
"65","000","00","019","1901","2179","230","119","111","14","244","391","0","62.4","30.43"
"65","000","00","019","1902","0000","389","172","217","24","413","789","0","52.34","21.8"
"65","000","00","019","1902","2180","389","172","217","24","413","789","0","52.34","21.8"
"65","000","00","019","1903","0000","296","151","145","22","318","683","0","46.56","22.11"
"65","000","00","019","1903","2185","296","151","145","22","318","683","0","46.56","22.11"
"65","000","00","019","1904","0000","271","134","137","12","283","662","0","42.75","20.24"
"65","000","00","019","1904","2181","271","134","137","12","283","662","0","42.75","20.24"
"65","000","00","019","1905","0000","152","70","82","11","163","310","0","52.58","22.58"
"65","000","00","019","1905","2182","152","70","82","11","163","310","0","52.58","22.58"
"65","000","00","019","1906","0000","183","92","91","7","190","373","0","50.94","24.66"
"65","000","00","019","1906","2183","147","71","76","5","152","280","0","54.29","25.36"
"65","000","00","019","1906","2184","36","21","15","2","38","93","0","40.86","22.58"
"65","000","00","019","1907","0000","300","148","152","19","319","591","0","53.98","25.04"
"65","000","00","019","1907","2188","300","148","152","19","319","591","0","53.98","25.04"
"65","000","00","019","1908","0000","283","132","151","7","290","726","0","39.94","18.18"
"65","000","00","019","1908","2187","283","132","151","7","290","726","0","39.94","18.18"
"65","000","00","019","1909","0000","176","109","67","18","194","282","0","68.79","38.65"
"65","000","00","019","1909","2189","176","109","67","18","194","282","0","68.79","38.65"
"65","000","00","019","1910","0000","201","98","103","7","208","323","0","64.4","30.34"
"65","000","00","019","1910","2186","201","98","103","7","208","323","0","64.4","30.34"
"65","000","00","019","1911","0000","359","188","171","17","376","788","0","47.72","23.86"
"65","000","00","019","1911","2190","359","188","171","17","376","788","0","47.72","23.86"
"65","000","00","019","1912","0000","512","292","220","45","557","943","0","59.07","30.97"
"65","000","00","019","1912","2191","512","292","220","45","557","943","0","59.07","30.97"
"65","000","00","020","0000","0000","2900","1546","1354","180","3080","5891","6570","52.28","26.24"
"65","000","00","020","2001","0000","457","239","218","33","490","843","0","58.13","28.35"
"65","000","00","020","2001","2196","313","166","147","23","336","595","0","56.47","27.9"
"65","000","00","020","2001","2197","144","73","71","10","154","248","0","62.1","29.44"
"65","000","00","020","2002","0000","652","322","330","35","687","1248","0","55.05","25.8"
"65","000","00","020","2002","2192","652","322","330","35","687","1248","0","55.05","25.8"
"65","000","00","020","2003","0000","615","348","267","41","656","1141","0","57.49","30.5"
"65","000","00","020","2003","2194","615","348","267","41","656","1141","0","57.49","30.5"
"65","000","00","020","2004","0000","185","99","86","4","189","417","0","45.32","23.74"
"65","000","00","020","2004","2195","185","99","86","4","189","417","0","45.32","23.74"
"65","000","00","020","2005","0000","357","198","159","26","383","816","0","46.94","24.26"
"65","000","00","020","2005","2198","162","91","71","8","170","338","0","50.3","26.92"
"65","000","00","020","2005","2199","195","107","88","18","213","478","0","44.56","22.38"
"65","000","00","020","2006","0000","283","150","133","14","297","612","0","48.53","24.51"
"65","000","00","020","2006","2193","283","150","133","14","297","612","0","48.53","24.51"
"65","000","00","020","2007","0000","351","190","161","27","378","814","0","46.44","23.34"
"65","000","00","020","2007","2200","161","79","82","8","169","390","0","43.33","20.26"
"65","000","00","020","2007","2201","190","111","79","19","209","424","0","49.29","26.18"
"65","000","00","021","0000","0000","9337","4301","5036","532","9869","20119","23010","49.05","21.38"
"65","000","00","021","2101","0000","143","81","62","7","150","312","0","48.08","25.96"
"65","000","00","021","2101","0011","143","81","62","7","150","312","0","48.08","25.96"
"65","000","00","021","2102","0000","2345","1055","1290","127","2472","4806","0","51.44","21.95"
"65","000","00","021","2102","0012","670","298","372","33","703","1421","0","49.47","20.97"
"65","000","00","021","2102","0013","772","330","442","42","814","1557","0","52.28","21.19"
"65","000","00","021","2102","0014","903","427","476","52","955","1828","0","52.24","23.36"
"65","000","00","021","2103","0000","516","254","262","28","544","1060","0","51.32","23.96"
"65","000","00","021","2103","0015","516","254","262","28","544","1060","0","51.32","23.96"
"65","000","00","021","2104","0000","334","165","169","28","362","819","0","44.2","20.15"
"65","000","00","021","2104","0016","334","165","169","28","362","819","0","44.2","20.15"
"65","000","00","021","2105","0000","2683","1192","1491","153","2836","6140","0","46.19","19.41"
"65","000","00","021","2105","0017","709","298","411","26","735","1701","0","43.21","17.52"
"65","000","00","021","2105","0018","794","357","437","50","844","1740","0","48.51","20.52"
"65","000","00","021","2105","0019","648","298","350","35","683","1451","0","47.07","20.54"
"65","000","00","021","2105","0020","532","239","293","42","574","1248","0","45.99","19.15"
"65","000","00","021","2106","0000","326","165","161","15","341","629","0","54.21","26.23"
"65","000","00","021","2106","0021","326","165","161","15","341","629","0","54.21","26.23"
"65","000","00","021","2107","0000","210","86","124","23","233","504","0","46.23","17.06"
"65","000","00","021","2107","0022","210","86","124","23","233","504","0","46.23","17.06"
"65","000","00","021","2108","0000","314","157","157","8","322","698","0","46.13","22.49"
"65","000","00","021","2108","0023","314","157","157","8","322","698","0","46.13","22.49"
"65","000","00","021","2109","0000","974","405","569","28","1002","2069","0","48.43","19.57"
"65","000","00","021","2109","0024","974","405","569","28","1002","2069","0","48.43","19.57"
"65","000","00","021","2110","0000","394","169","225","27","421","784","0","53.7","21.56"
"65","000","00","021","2110","0025","394","169","225","27","421","784","0","53.7","21.56"
"65","000","00","021","2111","0000","239","123","116","25","264","522","0","50.57","23.56"
"65","000","00","021","2111","0026","239","123","116","25","264","522","0","50.57","23.56"
"65","000","00","021","2112","0000","290","146","144","22","312","587","0","53.15","24.87"
"65","000","00","021","2112","0027","290","146","144","22","312","587","0","53.15","24.87"
"65","000","00","021","2113","0000","569","303","266","41","610","1189","0","51.3","25.48"
"65","000","00","021","2113","0028","569","303","266","41","610","1189","0","51.3","25.48"
"65","000","00","022","0000","0000","5181","2352","2829","321","5502","10528","12158","52.26","22.34"
"65","000","00","022","2201","0000","552","261","291","32","584","1121","0","52.1","23.28"
"65","000","00","022","2201","0001","552","261","291","32","584","1121","0","52.1","23.28"
"65","000","00","022","2202","0000","629","297","332","43","672","1389","0","48.38","21.38"
"65","000","00","022","2202","0002","629","297","332","43","672","1389","0","48.38","21.38"
"65","000","00","022","2203","0000","1047","499","548","77","1124","2177","0","51.63","22.92"
"65","000","00","022","2203","0003","465","230","235","35","500","933","0","53.59","24.65"
"65","000","00","022","2203","0004","582","269","313","42","624","1244","0","50.16","21.62"
"65","000","00","022","2204","0000","452","225","227","37","489","883","0","55.38","25.48"
"65","000","00","022","2204","0005","452","225","227","37","489","883","0","55.38","25.48"
"65","000","00","022","2205","0000","829","347","482","33","862","1564","0","55.12","22.19"
"65","000","00","022","2205","0006","829","347","482","33","862","1564","0","55.12","22.19"
"65","000","00","022","2206","0000","760","333","427","41","801","1500","0","53.4","22.2"
"65","000","00","022","2206","0007","760","333","427","41","801","1500","0","53.4","22.2"
"65","000","00","022","2207","0000","148","71","77","4","152","328","0","46.34","21.65"
"65","000","00","022","2207","0008","148","71","77","4","152","328","0","46.34","21.65"
"65","000","00","022","2208","0000","389","167","222","16","405","651","0","62.21","25.65"
"65","000","00","022","2208","0009","389","167","222","16","405","651","0","62.21","25.65"
"65","000","00","022","2209","0000","375","152","223","38","413","915","0","45.14","16.61"
"65","000","00","022","2209","0010","375","152","223","38","413","915","0","45.14","16.61"
"65","000","00","023","0000","0000","16660","7582","9078","897","17557","32970","38861","53.25","23.0"
"65","000","00","023","2301","0000","3247","1408","1839","164","3411","6595","0","51.72","21.35"
"65","000","00","023","2301","0125","716","320","396","40","756","1498","0","50.47","21.36"
"65","000","00","023","2301","0126","868","363","505","32","900","1939","0","46.42","18.72"
"65","000","00","023","2301","0127","764","329","435","47","811","1516","0","53.5","21.7"
"65","000","00","023","2301","0128","899","396","503","45","944","1642","0","57.49","24.12"
"65","000","00","023","2302","0000","1551","747","804","94","1645","3203","0","51.36","23.32"
"65","000","00","023","2302","0129","890","441","449","58","948","1927","0","49.2","22.89"
"65","000","00","023","2302","0130","661","306","355","36","697","1276","0","54.62","23.98"
"65","000","00","023","2303","0000","1518","722","796","66","1584","2752","0","57.56","26.24"
"65","000","00","023","2303","0131","759","371","388","33","792","1349","0","58.71","27.5"
"65","000","00","023","2303","0132","759","351","408","33","792","1403","0","56.45","25.02"
"65","000","00","023","2304","0000","1811","897","914","85","1896","3497","0","54.22","25.65"
"65","000","00","023","2304","0133","855","433","422","38","893","1644","0","54.32","26.34"
"65","000","00","023","2304","0134","956","464","492","47","1003","1853","0","54.13","25.04"
"65","000","00","023","2305","0000","989","420","569","52","1041","1793","0","58.06","23.42"
"65","000","00","023","2305","0135","989","420","569","52","1041","1793","0","58.06","23.42"
"65","000","00","023","2306","0000","3302","1537","1765","150","3452","6457","0","53.46","23.8"
"65","000","00","023","2306","0136","839","386","453","44","883","1644","0","53.71","23.48"
"65","000","00","023","2306","0137","926","439","487","43","969","1846","0","52.49","23.78"
"65","000","00","023","2306","0138","702","337","365","24","726","1346","0","53.94","25.04"
"65","000","00","023","2306","0139","835","375","460","39","874","1621","0","53.92","23.13"
"65","000","00","023","2307","0000","1850","792","1058","101","1951","4077","0","47.85","19.43"
"65","000","00","023","2307","0140","891","362","529","51","942","2110","0","44.64","17.16"
"65","000","00","023","2307","0141","959","430","529","50","1009","1967","0","51.3","21.86"
"65","000","00","023","2308","0000","855","379","476","45","900","1626","0","55.35","23.31"
"65","000","00","023","2308","0142","855","379","476","45","900","1626","0","55.35","23.31"
"65","000","00","023","2309","0000","786","369","417","50","836","1514","0","55.22","24.37"
"65","000","00","023","2309","0143","786","369","417","50","836","1514","0","55.22","24.37"
"65","000","00","023","2310","0000","751","311","440","90","841","1456","0","57.76","21.36"
"65","000","00","023","2310","0144","751","311","440","90","841","1456","0","57.76","21.36"
"65","000","00","024","0000","0000","1980","1025","955","138","2118","4321","4687","49.02","23.72"
"65","000","00","024","2401","0000","187","103","84","10","197","384","0","51.3","26.82"
"65","000","00","024","2401","2208","187","103","84","10","197","384","0","51.3","26.82"
"65","000","00","024","2402","0000","101","51","50","1","102","232","0","43.97","21.98"
"65","000","00","024","2402","2209","101","51","50","1","102","232","0","43.97","21.98"
"65","000","00","024","2403","0000","133","72","61","7","140","249","0","56.22","28.92"
"65","000","00","024","2403","2210","133","72","61","7","140","249","0","56.22","28.92"
"65","000","00","024","2404","0000","236","140","96","21","257","458","0","56.11","30.57"
"65","000","00","024","2404","2211","236","140","96","21","257","458","0","56.11","30.57"
"65","000","00","024","2405","0000","114","63","51","14","128","232","0","55.17","27.16"
"65","000","00","024","2405","2212","114","63","51","14","128","232","0","55.17","27.16"
"65","000","00","024","2406","0000","259","121","138","12","271","635","0","42.68","19.06"
"65","000","00","024","2406","2213","259","121","138","12","271","635","0","42.68","19.06"
"65","000","00","024","2407","0000","228","113","115","19","247","427","0","57.85","26.46"
"65","000","00","024","2407","2214","228","113","115","19","247","427","0","57.85","26.46"
"65","000","00","024","2408","0000","70","41","29","4","74","147","0","50.34","27.89"
"65","000","00","024","2408","2216","70","41","29","4","74","147","0","50.34","27.89"
"65","000","00","024","2409","0000","131","63","68","9","140","365","0","38.36","17.26"
"65","000","00","024","2409","2217","131","63","68","9","140","365","0","38.36","17.26"
"65","000","00","024","2410","0000","103","44","59","7","110","177","0","62.15","24.86"
"65","000","00","024","2410","2219","103","44","59","7","110","177","0","62.15","24.86"
"65","000","00","024","2411","0000","355","187","168","27","382","862","0","44.32","21.69"
"65","000","00","024","2411","2215","355","187","168","27","382","862","0","44.32","21.69"
"65","000","00","024","2412","0000","63","27","36","7","70","153","0","45.75","17.65"
"65","000","00","024","2412","2218","63","27","36","7","70","153","0","45.75","17.65"
"65","000","00","025","0000","0000","3693","1751","1942","255","3948","7999","8872","49.36","21.89"
"65","000","00","025","2501","0000","201","70","131","16","217","455","0","47.69","15.38"
"65","000","00","025","2501","2266","201","70","131","16","217","455","0","47.69","15.38"
"65","000","00","025","2502","0000","192","100","92","12","204","391","0","52.17","25.58"
"65","000","00","025","2502","2278","60","28","32","5","65","120","0","54.17","23.33"
"65","000","00","025","2502","2279","132","72","60","7","139","271","0","51.29","26.57"
"65","000","00","025","2503","0000","407","177","230","19","426","782","0","54.48","22.63"
"65","000","00","025","2503","2267","141","60","81","7","148","286","0","51.75","20.98"
"65","000","00","025","2503","2268","266","117","149","12","278","496","0","56.05","23.59"
"65","000","00","025","2504","0000","385","193","192","23","408","733","0","55.66","26.33"
"65","000","00","025","2504","2280","199","101","98","13","212","362","0","58.56","27.9"
"65","000","00","025","2504","2281","186","92","94","10","196","371","0","52.83","24.8"
"65","000","00","025","2505","0000","160","79","81","10","170","383","0","44.39","20.63"
"65","000","00","025","2505","2269","160","79","81","10","170","383","0","44.39","20.63"
"65","000","00","025","2506","0000","599","263","336","61","660","1539","0","42.88","17.09"
"65","000","00","025","2506","2270","343","162","181","38","381","887","0","42.95","18.26"
"65","000","00","025","2506","2271","256","101","155","23","279","652","0","42.79","15.49"
"65","000","00","025","2507","0000","174","90","84","4","178","333","0","53.45","27.03"
"65","000","00","025","2507","2272","174","90","84","4","178","333","0","53.45","27.03"
"65","000","00","025","2508","0000","422","193","229","37","459","924","0","49.68","20.89"
"65","000","00","025","2508","2273","292","131","161","30","322","642","0","50.16","20.4"
"65","000","00","025","2508","2274","130","62","68","7","137","282","0","48.58","21.99"
"65","000","00","025","2509","0000","254","125","129","17","271","621","0","43.64","20.13"
"65","000","00","025","2509","2275","254","125","129","17","271","621","0","43.64","20.13"
"65","000","00","025","2510","0000","190","105","85","4","194","422","0","45.97","24.88"
"65","000","00","025","2510","2276","190","105","85","4","194","422","0","45.97","24.88"
"65","000","00","025","2511","0000","126","89","37","13","139","369","0","37.67","24.12"
"65","000","00","025","2511","2277","126","89","37","13","139","369","0","37.67","24.12"
"65","000","00","025","2512","0000","583","267","316","39","622","1047","0","59.41","25.5"
"65","000","00","025","2512","2282","583","267","316","39","622","1047","0","59.41","25.5"
"65","000","00","026","0000","0000","4887","2671","2216","308","5195","11279","12364","46.06","23.68"
"65","000","00","026","2601","0000","404","188","216","34","438","876","0","50.0","21.46"
"65","000","00","026","2601","2283","404","188","216","34","438","876","0","50.0","21.46"
"65","000","00","026","2602","0000","242","128","114","10","252","516","0","48.84","24.81"
"65","000","00","026","2602","2285","242","128","114","10","252","516","0","48.84","24.81"
"65","000","00","026","2603","0000","284","156","128","25","309","686","0","45.04","22.74"
"65","000","00","026","2603","2286","136","83","53","17","153","373","0","41.02","22.25"
"65","000","00","026","2603","2287","148","73","75","8","156","313","0","49.84","23.32"
"65","000","00","026","2604","0000","205","120","85","18","223","433","0","51.5","27.71"
"65","000","00","026","2604","2284","205","120","85","18","223","433","0","51.5","27.71"
"65","000","00","026","2605","0000","291","188","103","21","312","676","0","46.15","27.81"
"65","000","00","026","2605","2292","291","188","103","21","312","676","0","46.15","27.81"
"65","000","00","026","2606","0000","729","404","325","48","777","1673","0","46.44","24.15"
"65","000","00","026","2606","2290","338","196","142","19","357","812","0","43.97","24.14"
"65","000","00","026","2606","2291","391","208","183","29","420","861","0","48.78","24.16"
"65","000","00","026","2607","0000","770","413","357","34","804","1731","0","46.45","23.86"
"65","000","00","026","2607","2295","321","175","146","9","330","769","0","42.91","22.76"
"65","000","00","026","2607","2296","449","238","211","25","474","962","0","49.27","24.74"
"65","000","00","026","2608","0000","791","450","341","51","842","2046","0","41.15","21.99"
"65","000","00","026","2608","2293","414","226","188","23","437","1091","0","40.05","20.71"
"65","000","00","026","2608","2294","377","224","153","28","405","955","0","42.41","23.46"
"65","000","00","026","2609","0000","428","221","207","33","461","900","0","51.22","24.56"
"65","000","00","026","2609","2288","239","109","130","9","248","485","0","51.13","22.47"
"65","000","00","026","2609","2289","189","112","77","24","213","415","0","51.33","26.99"
"65","000","00","026","2610","0000","369","190","179","14","383","739","0","51.83","25.71"
"65","000","00","026","2610","2297","207","102","105","8","215","390","0","55.13","26.15"
"65","000","00","026","2610","2298","162","88","74","6","168","349","0","48.14","25.21"
"65","000","00","026","2611","0000","374","213","161","20","394","1003","0","39.28","21.24"
"65","000","00","026","2611","2299","199","115","84","11","210","508","0","41.34","22.64"
"65","000","00","026","2611","2300","175","98","77","9","184","495","0","37.17","19.8"
"65","000","00","027","0000","0000","8984","4298","4686","694","9678","18978","21821","51.0","22.65"
"65","000","00","027","2701","0000","250","105","145","12","262","481","0","54.47","21.83"
"65","000","00","027","2701","2301","250","105","145","12","262","481","0","54.47","21.83"
"65","000","00","027","2702","0000","352","174","178","31","383","715","0","53.57","24.34"
"65","000","00","027","2702","2302","352","174","178","31","383","715","0","53.57","24.34"
"65","000","00","027","2703","0000","194","95","99","22","216","481","0","44.91","19.75"
"65","000","00","027","2703","2303","194","95","99","22","216","481","0","44.91","19.75"
"65","000","00","027","2704","0000","689","386","303","161","850","1792","0","47.43","21.54"
"65","000","00","027","2704","2304","689","386","303","161","850","1792","0","47.43","21.54"
"65","000","00","027","2705","0000","1913","880","1033","93","2006","3791","0","52.91","23.21"
"65","000","00","027","2705","2305","872","421","451","47","919","1781","0","51.6","23.64"
"65","000","00","027","2705","2306","1041","459","582","46","1087","2010","0","54.08","22.84"
"65","000","00","027","2706","0000","862","425","437","40","902","1716","0","52.56","24.77"
"65","000","00","027","2706","2310","413","197","216","22","435","828","0","52.54","23.79"
"65","000","00","027","2706","2311","449","228","221","18","467","888","0","52.59","25.68"
"65","000","00","027","2707","0000","576","279","297","38","614","1211","0","50.7","23.04"
"65","000","00","027","2707","2312","576","279","297","38","614","1211","0","50.7","23.04"
"65","000","00","027","2708","0000","230","124","106","12","242","416","0","58.17","29.81"
"65","000","00","027","2708","2313","230","124","106","12","242","416","0","58.17","29.81"
"65","000","00","027","2709","0000","364","196","168","36","400","682","0","58.65","28.74"
"65","000","00","027","2709","2314","364","196","168","36","400","682","0","58.65","28.74"
"65","000","00","027","2710","0000","309","163","146","41","350","644","0","54.35","25.31"
"65","000","00","027","2710","2315","309","163","146","41","350","644","0","54.35","25.31"
"65","000","00","027","2711","0000","382","168","214","29","411","830","0","49.52","20.24"
"65","000","00","027","2711","2316","382","168","214","29","411","830","0","49.52","20.24"
"65","000","00","027","2712","0000","244","137","107","16","260","469","0","55.44","29.21"
"65","000","00","027","2712","2318","244","137","107","16","260","469","0","55.44","29.21"
"65","000","00","027","2713","0000","90","43","47","12","102","188","0","54.26","22.87"
"65","000","00","027","2713","2317","90","43","47","12","102","188","0","54.26","22.87"
"65","000","00","027","2714","0000","209","108","101","15","224","582","0","38.49","18.56"
"65","000","00","027","2714","2319","209","108","101","15","224","582","0","38.49","18.56"
"65","000","00","027","2715","0000","2320","1015","1305","136","2456","4980","0","49.32","20.38"
"65","000","00","027","2715","2307","734","331","403","40","774","1572","0","49.24","21.06"
"65","000","00","027","2715","2308","857","362","495","55","912","1777","0","51.32","20.37"
"65","000","00","027","2715","2309","729","322","407","41","770","1631","0","47.21","19.74"
"65","000","00","028","0000","0000","9086","4214","4872","610","9696","19297","22102","50.25","21.84"
"65","000","00","028","2801","0000","2136","983","1153","129","2265","4309","0","52.56","22.81"
"65","000","00","028","2801","2320","652","277","375","45","697","1286","0","54.2","21.54"
"65","000","00","028","2801","2321","813","397","416","47","860","1576","0","54.57","25.19"
"65","000","00","028","2801","2322","671","309","362","37","708","1447","0","48.93","21.35"
"65","000","00","028","2802","0000","1086","526","560","85","1171","2532","0","46.25","20.77"
"65","000","00","028","2802","2325","444","216","228","33","477","1215","0","39.26","17.78"
"65","000","00","028","2802","2326","642","310","332","52","694","1317","0","52.7","23.54"
"65","000","00","028","2803","0000","1393","653","740","90","1483","3226","0","45.97","20.24"
"65","000","00","028","2803","2327","700","332","368","41","741","1676","0","44.21","19.81"
"65","000","00","028","2803","2328","693","321","372","49","742","1550","0","47.87","20.71"
"65","000","00","028","2804","0000","1470","642","828","87","1557","2705","0","57.56","23.73"
"65","000","00","028","2804","2329","552","242","310","40","592","945","0","62.65","25.61"
"65","000","00","028","2804","2330","918","400","518","47","965","1760","0","54.83","22.73"
"65","000","00","028","2805","0000","271","116","155","20","291","570","0","51.05","20.35"
"65","000","00","028","2805","2331","271","116","155","20","291","570","0","51.05","20.35"
"65","000","00","028","2806","0000","460","250","210","22","482","952","0","50.63","26.26"
"65","000","00","028","2806","2332","460","250","210","22","482","952","0","50.63","26.26"
"65","000","00","028","2807","0000","362","192","170","39","401","674","0","59.5","28.49"
"65","000","00","028","2807","2333","362","192","170","39","401","674","0","59.5","28.49"
"65","000","00","028","2808","0000","208","94","114","15","223","405","0","55.06","23.21"
"65","000","00","028","2808","2334","208","94","114","15","223","405","0","55.06","23.21"
"65","000","00","028","2809","0000","518","221","297","33","551","1089","0","50.6","20.29"
"65","000","00","028","2809","2335","518","221","297","33","551","1089","0","50.6","20.29"
"65","000","00","028","2810","0000","1182","537","645","90","1272","2835","0","44.87","18.94"
"65","000","00","028","2810","2323","626","286","340","51","677","1466","0","46.18","19.51"
"65","000","00","028","2810","2324","556","251","305","39","595","1369","0","43.46","18.33"
"65","000","00","029","0000","0000","2736","1161","1575","120","2856","5264","6383","54.26","22.06"
"65","000","00","029","2901","0000","1165","474","691","33","1198","2367","0","50.61","20.03"
"65","000","00","029","2901","2203","598","238","360","11","609","1198","0","50.83","19.87"
"65","000","00","029","2901","2204","567","236","331","22","589","1169","0","50.38","20.19"
"65","000","00","029","2902","0000","909","381","528","45","954","1568","0","60.84","24.3"
"65","000","00","029","2902","2202","909","381","528","45","954","1568","0","60.84","24.3"
"65","000","00","029","2903","0000","281","122","159","18","299","615","0","48.62","19.84"
"65","000","00","029","2903","2207","281","122","159","18","299","615","0","48.62","19.84"
"65","000","00","029","2904","0000","259","125","134","20","279","486","0","57.41","25.72"
"65","000","00","029","2904","2206","259","125","134","20","279","486","0","57.41","25.72"
"65","000","00","029","2905","0000","122","59","63","4","126","228","0","55.26","25.88"
"65","000","00","029","2905","2205","122","59","63","4","126","228","0","55.26","25.88"
"68","000","00","000","0000","0000","896635","372182","524453","39083","935718","1801823","2215615","51.93","20.66"
"68","000","00","001","0000","0000","177362","76752","100610","6677","184039","359790","446246","51.15","21.33"
"68","000","00","001","0101","0000","353","165","188","18","371","690","0","53.77","23.91"
"68","000","00","001","0101","0032","353","165","188","18","371","690","0","53.77","23.91"
"68","000","00","001","0102","0000","753","350","403","34","787","1353","0","58.17","25.87"
"68","000","00","001","0102","0034","753","350","403","34","787","1353","0","58.17","25.87"
"68","000","00","001","0103","0000","707","355","352","18","725","1582","0","45.83","22.44"
"68","000","00","001","0103","0043","707","355","352","18","725","1582","0","45.83","22.44"
"68","000","00","001","0104","0000","3153","1435","1718","106","3259","6636","0","49.11","21.62"
"68","000","00","001","0104","0001","777","352","425","31","808","1593","0","50.72","22.1"
"68","000","00","001","0104","0002","834","401","433","20","854","1934","0","44.16","20.73"
"68","000","00","001","0104","0003","883","403","480","35","918","1661","0","55.27","24.26"
"68","000","00","001","0104","0004","659","279","380","20","679","1448","0","46.89","19.27"
"68","000","00","001","0105","0000","1642","628","1014","45","1687","3483","0","48.44","18.03"
"68","000","00","001","0105","0190","836","302","534","24","860","1790","0","48.04","16.87"
"68","000","00","001","0105","0191","806","326","480","21","827","1693","0","48.85","19.26"
"68","000","00","001","0106","0000","4202","1692","2510","129","4331","9063","0","47.79","18.67"
"68","000","00","001","0106","0204","883","372","511","25","908","1796","0","50.56","20.71"
"68","000","00","001","0106","0205","899","364","535","16","915","1878","0","48.72","19.38"
"68","000","00","001","0106","0206","831","334","497","34","865","1729","0","50.03","19.32"
"68","000","00","001","0106","0207","836","311","525","22","858","1843","0","46.55","16.87"
"68","000","00","001","0106","0208","753","311","442","32","785","1817","0","43.2","17.12"
"68","000","00","001","0107","0000","576","321","255","31","607","1028","0","59.05","31.23"
"68","000","00","001","0107","0044","576","321","255","31","607","1028","0","59.05","31.23"
"68","000","00","001","0108","0000","705","350","355","37","742","1452","0","51.1","24.1"
"68","000","00","001","0108","0036","705","350","355","37","742","1452","0","51.1","24.1"
"68","000","00","001","0109","0000","805","400","405","77","882","1681","0","52.47","23.8"
"68","000","00","001","0109","0037","805","400","405","77","882","1681","0","52.47","23.8"
"68","000","00","001","0110","0000","2505","1143","1362","110","2615","5078","0","51.5","22.51"
"68","000","00","001","0110","0187","801","408","393","40","841","1764","0","47.68","23.13"
"68","000","00","001","0110","0188","978","425","553","58","1036","1899","0","54.56","22.38"
"68","000","00","001","0110","0189","726","310","416","12","738","1415","0","52.16","21.91"
"68","000","00","001","0111","0000","2303","1142","1161","91","2394","4509","0","53.09","25.33"
"68","000","00","001","0111","0113","656","330","326","31","687","1308","0","52.52","25.23"
"68","000","00","001","0111","0114","779","352","427","39","818","1583","0","51.67","22.24"
"68","000","00","001","0111","0115","868","460","408","21","889","1618","0","54.94","28.43"
"68","000","00","001","0112","0000","2185","1042","1143","100","2285","4668","0","48.95","22.32"
"68","000","00","001","0112","0131","800","370","430","41","841","1689","0","49.79","21.91"
"68","000","00","001","0112","0132","691","334","357","26","717","1542","0","46.5","21.66"
"68","000","00","001","0112","0133","694","338","356","33","727","1437","0","50.59","23.52"
"68","000","00","001","0113","0000","1509","706","803","49","1558","2928","0","53.21","24.11"
"68","000","00","001","0113","0193","680","332","348","23","703","1434","0","49.02","23.15"
"68","000","00","001","0113","0194","829","374","455","26","855","1494","0","57.23","25.03"
"68","000","00","001","0114","0000","908","455","453","35","943","1916","0","49.22","23.75"
"68","000","00","001","0114","0192","908","455","453","35","943","1916","0","49.22","23.75"
"68","000","00","001","0115","0000","536","274","262","21","557","979","0","56.89","27.99"
"68","000","00","001","0115","0209","536","274","262","21","557","979","0","56.89","27.99"
"68","000","00","001","0116","0000","1719","816","903","58","1777","3565","0","49.85","22.89"
"68","000","00","001","0116","0134","871","448","423","25","896","1679","0","53.37","26.68"
"68","000","00","001","0116","0135","848","368","480","33","881","1886","0","46.71","19.51"
"68","000","00","001","0117","0000","1268","616","652","54","1322","2210","0","59.82","27.87"
"68","000","00","001","0117","0105","663","320","343","29","692","1149","0","60.23","27.85"
"68","000","00","001","0117","0106","605","296","309","25","630","1061","0","59.38","27.9"
"68","000","00","001","0118","0000","1540","771","769","63","1603","3058","0","52.42","25.21"
"68","000","00","001","0118","0127","965","466","499","36","1001","1995","0","50.18","23.36"
"68","000","00","001","0118","0128","575","305","270","27","602","1063","0","56.63","28.69"
"68","000","00","001","0119","0000","737","328","409","32","769","1587","0","48.46","20.67"
"68","000","00","001","0119","0041","737","328","409","32","769","1587","0","48.46","20.67"
"68","000","00","001","0120","0000","768","400","368","38","806","1375","0","58.62","29.09"
"68","000","00","001","0120","0028","768","400","368","38","806","1375","0","58.62","29.09"
"68","000","00","001","0121","0000","499","259","240","22","521","852","0","61.15","30.4"
"68","000","00","001","0121","0033","499","259","240","22","521","852","0","61.15","30.4"
"68","000","00","001","0122","0000","4641","1777","2864","171","4812","9234","0","52.11","19.24"
"68","000","00","001","0122","0155","886","340","546","28","914","1807","0","50.58","18.82"
"68","000","00","001","0122","0156","934","355","579","35","969","1857","0","52.18","19.12"
"68","000","00","001","0122","0157","864","326","538","45","909","1589","0","57.21","20.52"
"68","000","00","001","0122","0158","1023","396","627","36","1059","2088","0","50.72","18.97"
"68","000","00","001","0122","0159","934","360","574","27","961","1893","0","50.77","19.02"
"68","000","00","001","0123","0000","3389","1340","2049","114","3503","6570","0","53.32","20.4"
"68","000","00","001","0123","0050","770","331","439","31","801","1489","0","53.79","22.23"
"68","000","00","001","0123","0051","1001","319","682","21","1022","1821","0","56.12","17.52"
"68","000","00","001","0123","0052","747","315","432","17","764","1563","0","48.88","20.15"
"68","000","00","001","0123","0053","871","375","496","45","916","1697","0","53.98","22.1"
"68","000","00","001","0124","0000","2915","1270","1645","132","3047","6075","0","50.16","20.91"
"68","000","00","001","0124","0151","702","311","391","31","733","1569","0","46.72","19.82"
"68","000","00","001","0124","0152","703","270","433","38","741","1505","0","49.24","17.94"
"68","000","00","001","0124","0153","722","354","368","43","765","1496","0","51.14","23.66"
"68","000","00","001","0124","0154","788","335","453","20","808","1505","0","53.69","22.26"
"68","000","00","001","0125","0000","767","350","417","45","812","1451","0","55.96","24.12"
"68","000","00","001","0125","0042","767","350","417","45","812","1451","0","55.96","24.12"
"68","000","00","001","0126","0000","2919","1300","1619","126","3045","5866","0","51.91","22.16"
"68","000","00","001","0126","0045","922","421","501","51","973","1934","0","50.31","21.77"
"68","000","00","001","0126","0046","537","235","302","28","565","1016","0","55.61","23.13"
"68","000","00","001","0126","0047","575","283","292","20","595","1079","0","55.14","26.23"
"68","000","00","001","0126","0048","885","361","524","27","912","1837","0","49.65","19.65"
"68","000","00","001","0127","0000","757","392","365","37","794","1390","0","57.12","28.2"
"68","000","00","001","0127","0049","757","392","365","37","794","1390","0","57.12","28.2"
"68","000","00","001","0128","0000","2501","1177","1324","135","2636","4944","0","53.32","23.81"
"68","000","00","001","0128","0081","797","395","402","47","844","1449","0","58.25","27.26"
"68","000","00","001","0128","0082","839","390","449","48","887","1803","0","49.2","21.63"
"68","000","00","001","0128","0083","865","392","473","40","905","1692","0","53.49","23.17"
"68","000","00","001","0129","0000","2367","1080","1287","66","2433","4421","0","55.03","24.43"
"68","000","00","001","0129","0060","663","339","324","9","672","1115","0","60.27","30.4"
"68","000","00","001","0129","0061","833","393","440","30","863","1562","0","55.25","25.16"
"68","000","00","001","0129","0062","871","348","523","27","898","1744","0","51.49","19.95"
"68","000","00","001","0130","0000","2657","1106","1551","93","2750","5152","0","53.38","21.47"
"68","000","00","001","0130","0057","921","366","555","27","948","1766","0","53.68","20.72"
"68","000","00","001","0130","0058","804","365","439","37","841","1555","0","54.08","23.47"
"68","000","00","001","0130","0059","932","375","557","29","961","1831","0","52.48","20.48"
"68","000","00","001","0131","0000","662","349","313","27","689","1698","0","40.58","20.55"
"68","000","00","001","0131","0035","662","349","313","27","689","1698","0","40.58","20.55"
"68","000","00","001","0132","0000","3150","1321","1829","104","3254","5981","0","54.41","22.09"
"68","000","00","001","0132","0013","760","362","398","24","784","1482","0","52.9","24.43"
"68","000","00","001","0132","0014","759","319","440","24","783","1423","0","55.02","22.42"
"68","000","00","001","0132","0015","807","345","462","30","837","1509","0","55.47","22.86"
"68","000","00","001","0132","0016","824","295","529","26","850","1567","0","54.24","18.83"
"68","000","00","001","0133","0000","3006","1294","1712","119","3125","5805","0","53.83","22.29"
"68","000","00","001","0133","0020","756","330","426","31","787","1399","0","56.25","23.59"
"68","000","00","001","0133","0021","836","360","476","27","863","1540","0","56.04","23.38"
"68","000","00","001","0133","0022","768","334","434","37","805","1638","0","49.15","20.39"
"68","000","00","001","0133","0023","646","270","376","24","670","1228","0","54.56","21.99"
"68","000","00","001","0134","0000","2514","1166","1348","102","2616","4781","0","54.72","24.39"
"68","000","00","001","0134","0038","830","402","428","34","864","1669","0","51.77","24.09"
"68","000","00","001","0134","0039","850","393","457","30","880","1530","0","57.52","25.69"
"68","000","00","001","0134","0040","834","371","463","38","872","1582","0","55.12","23.45"
"68","000","00","001","0135","0000","1635","710","925","98","1733","3529","0","49.11","20.12"
"68","000","00","001","0135","0086","561","267","294","32","593","1173","0","50.55","22.76"
"68","000","00","001","0135","0087","561","219","342","21","582","1162","0","50.09","18.85"
"68","000","00","001","0135","0088","513","224","289","45","558","1194","0","46.73","18.76"
"68","000","00","001","0136","0000","2679","1031","1648","97","2776","5705","0","48.66","18.07"
"68","000","00","001","0136","0092","852","342","510","52","904","1780","0","50.79","19.21"
"68","000","00","001","0136","0093","845","344","501","27","872","1904","0","45.8","18.07"
"68","000","00","001","0136","0094","982","345","637","18","1000","2021","0","49.48","17.07"
"68","000","00","001","0137","0000","1925","852","1073","61","1986","3870","0","51.32","22.02"
"68","000","00","001","0137","0185","967","408","559","22","989","1925","0","51.38","21.19"
"68","000","00","001","0137","0186","958","444","514","39","997","1945","0","51.26","22.83"
"68","000","00","001","0138","0000","2257","1104","1153","93","2350","4271","0","55.02","25.85"
"68","000","00","001","0138","0195","682","346","336","43","725","1311","0","55.3","26.39"
"68","000","00","001","0138","0196","766","378","388","28","794","1476","0","53.79","25.61"
"68","000","00","001","0138","0197","809","380","429","22","831","1484","0","56.0","25.61"
"68","000","00","001","0139","0000","1015","518","497","49","1064","1970","0","54.01","26.29"
"68","000","00","001","0139","0202","549","282","267","27","576","1015","0","56.75","27.78"
"68","000","00","001","0139","0203","466","236","230","22","488","955","0","51.1","24.71"
"68","000","00","001","0140","0000","2686","1139","1547","90","2776","5333","0","52.05","21.36"
"68","000","00","001","0140","0029","927","457","470","25","952","1743","0","54.62","26.22"
"68","000","00","001","0140","0030","879","377","502","32","911","1862","0","48.93","20.25"
"68","000","00","001","0140","0031","880","305","575","33","913","1728","0","52.84","17.65"
"68","000","00","001","0141","0000","3144","1265","1879","127","3271","6230","0","52.5","20.3"
"68","000","00","001","0141","0024","796","218","578","37","833","1649","0","50.52","13.22"
"68","000","00","001","0141","0025","822","369","453","20","842","1601","0","52.59","23.05"
"68","000","00","001","0141","0026","722","320","402","48","770","1477","0","52.13","21.67"
"68","000","00","001","0141","0027","804","358","446","22","826","1503","0","54.96","23.82"
"68","000","00","001","0142","0000","2472","1130","1342","120","2592","5170","0","50.14","21.86"
"68","000","00","001","0142","0010","764","343","421","36","800","1590","0","50.31","21.57"
"68","000","00","001","0142","0011","803","368","435","38","841","1637","0","51.37","22.48"
"68","000","00","001","0142","0012","905","419","486","46","951","1943","0","48.94","21.56"
"68","000","00","001","0143","0000","2440","1141","1299","107","2547","5024","0","50.7","22.71"
"68","000","00","001","0143","0007","866","374","492","28","894","1800","0","49.67","20.78"
"68","000","00","001","0143","0008","837","401","436","35","872","1598","0","54.57","25.09"
"68","000","00","001","0143","0009","737","366","371","44","781","1626","0","48.03","22.51"
"68","000","00","001","0144","0000","2123","929","1194","92","2215","4160","0","53.25","22.33"
"68","000","00","001","0144","0017","672","290","382","27","699","1305","0","53.56","22.22"
"68","000","00","001","0144","0018","662","281","381","38","700","1416","0","49.44","19.84"
"68","000","00","001","0144","0019","789","358","431","27","816","1439","0","56.71","24.88"
"68","000","00","001","0145","0000","2319","943","1376","82","2401","4197","0","57.21","22.47"
"68","000","00","001","0145","0173","846","335","511","25","871","1432","0","60.82","23.39"
"68","000","00","001","0145","0174","786","319","467","36","822","1421","0","57.85","22.45"
"68","000","00","001","0145","0175","687","289","398","21","708","1344","0","52.68","21.5"
"68","000","00","001","0146","0000","2500","1134","1366","83","2583","5384","0","47.98","21.06"
"68","000","00","001","0146","0182","811","388","423","19","830","1860","0","44.62","20.86"
"68","000","00","001","0146","0183","843","381","462","30","873","1726","0","50.58","22.07"
"68","000","00","001","0146","0184","846","365","481","34","880","1798","0","48.94","20.3"
"68","000","00","001","0147","0000","2941","1310","1631","121","3062","6097","0","50.22","21.49"
"68","000","00","001","0147","0198","757","338","419","34","791","1514","0","52.25","22.32"
"68","000","00","001","0147","0199","722","349","373","40","762","1446","0","52.7","24.14"
"68","000","00","001","0147","0200","762","325","437","20","782","1573","0","49.71","20.66"
"68","000","00","001","0147","0201","700","298","402","27","727","1564","0","46.48","19.05"
"68","000","00","001","0148","0000","3286","1500","1786","134","3420","6901","0","49.56","21.74"
"68","000","00","001","0148","0139","897","418","479","46","943","1846","0","51.08","22.64"
"68","000","00","001","0148","0140","750","384","366","33","783","1644","0","47.63","23.36"
"68","000","00","001","0148","0141","776","335","441","30","806","1674","0","48.15","20.01"
"68","000","00","001","0148","0142","863","363","500","25","888","1737","0","51.12","20.9"
"68","000","00","001","0149","0000","2800","1138","1662","82","2882","5873","0","49.07","19.38"
"68","000","00","001","0149","0107","852","357","495","29","881","1831","0","48.12","19.5"
"68","000","00","001","0149","0108","1050","412","638","34","1084","2168","0","50.0","19.0"
"68","000","00","001","0149","0109","898","369","529","19","917","1874","0","48.93","19.69"
"68","000","00","001","0150","0000","4121","1738","2383","146","4267","8384","0","50.89","20.73"
"68","000","00","001","0150","0116","1009","476","533","51","1060","2127","0","49.84","22.38"
"68","000","00","001","0150","0117","976","394","582","23","999","2033","0","49.14","19.38"
"68","000","00","001","0150","0118","1040","401","639","25","1065","2098","0","50.76","19.11"
"68","000","00","001","0150","0119","1096","467","629","47","1143","2126","0","53.76","21.97"
"68","000","00","001","0151","0000","4143","1591","2552","127","4270","8396","0","50.86","18.95"
"68","000","00","001","0151","0146","882","300","582","30","912","1774","0","51.41","16.91"
"68","000","00","001","0151","0147","840","309","531","27","867","1666","0","52.04","18.55"
"68","000","00","001","0151","0148","783","304","479","14","797","1528","0","52.16","19.9"
"68","000","00","001","0151","0149","811","337","474","34","845","1709","0","49.44","19.72"
"68","000","00","001","0151","0150","827","341","486","22","849","1719","0","49.39","19.84"
"68","000","00","001","0152","0000","1462","665","797","71","1533","2598","0","59.01","25.6"
"68","000","00","001","0152","0079","757","350","407","44","801","1404","0","57.05","24.93"
"68","000","00","001","0152","0080","705","315","390","27","732","1194","0","61.31","26.38"
"68","000","00","001","0153","0000","1815","838","977","87","1902","3728","0","51.02","22.48"
"68","000","00","001","0153","0084","958","432","526","50","1008","1913","0","52.69","22.58"
"68","000","00","001","0153","0085","857","406","451","37","894","1815","0","49.26","22.37"
"68","000","00","001","0154","0000","1862","787","1075","65","1927","3914","0","49.23","20.11"
"68","000","00","001","0154","0074","927","417","510","24","951","1949","0","48.79","21.4"
"68","000","00","001","0154","0075","935","370","565","41","976","1965","0","49.67","18.83"
"68","000","00","001","0155","0000","3296","1590","1706","131","3427","6512","0","52.63","24.42"
"68","000","00","001","0155","0076","1250","625","625","48","1298","2414","0","53.77","25.89"
"68","000","00","001","0155","0077","969","493","476","40","1009","1942","0","51.96","25.39"
"68","000","00","001","0155","0078","1077","472","605","43","1120","2156","0","51.95","21.89"
"68","000","00","001","0156","0000","2328","971","1357","112","2440","4845","0","50.36","20.04"
"68","000","00","001","0156","0095","752","219","533","44","796","1545","0","51.52","14.17"
"68","000","00","001","0156","0096","746","270","476","38","784","1617","0","48.48","16.7"
"68","000","00","001","0156","0097","830","482","348","30","860","1683","0","51.1","28.64"
"68","000","00","001","0157","0000","2742","1063","1679","77","2819","5884","0","47.91","18.07"
"68","000","00","001","0157","0176","881","331","550","26","907","1942","0","46.7","17.04"
"68","000","00","001","0157","0177","983","390","593","29","1012","2001","0","50.57","19.49"
"68","000","00","001","0157","0178","878","342","536","22","900","1941","0","46.37","17.62"
"68","000","00","001","0158","0000","3684","1501","2183","131","3815","8196","0","46.55","18.31"
"68","000","00","001","0158","0213","1027","443","584","46","1073","2164","0","49.58","20.47"
"68","000","00","001","0158","0214","942","389","553","30","972","2020","0","48.12","19.26"
"68","000","00","001","0158","0215","837","333","504","27","864","1924","0","44.91","17.31"
"68","000","00","001","0158","0216","878","336","542","28","906","2088","0","43.39","16.09"
"68","000","00","001","0159","0000","3524","1707","1817","103","3627","9237","0","39.27","18.48"
"68","000","00","001","0159","0101","907","391","516","15","922","1873","0","49.23","20.88"
"68","000","00","001","0159","0102","746","313","433","28","774","3687","0","20.99","8.49"
"68","000","00","001","0159","0103","978","406","572","29","1007","1850","0","54.43","21.95"
"68","000","00","001","0159","0104","893","597","296","31","924","1827","0","50.57","32.68"
"68","000","00","001","0160","0000","2556","1043","1513","91","2647","5084","0","52.07","20.52"
"68","000","00","001","0160","0089","867","379","488","40","907","1695","0","53.51","22.36"
"68","000","00","001","0160","0090","891","378","513","28","919","1797","0","51.14","21.04"
"68","000","00","001","0160","0091","798","286","512","23","821","1592","0","51.57","17.96"
"68","000","00","001","0161","0000","3623","1443","2180","121","3744","7274","0","51.47","19.84"
"68","000","00","001","0161","0123","840","351","489","24","864","1691","0","51.09","20.76"
"68","000","00","001","0161","0124","940","338","602","29","969","1900","0","51.0","17.79"
"68","000","00","001","0161","0125","893","369","524","42","935","1761","0","53.09","20.95"
"68","000","00","001","0161","0126","950","385","565","26","976","1922","0","50.78","20.03"
"68","000","00","001","0162","0000","2713","1191","1522","116","2829","5712","0","49.53","20.85"
"68","000","00","001","0162","0063","829","369","460","35","864","1838","0","47.01","20.08"
"68","000","00","001","0162","0064","984","460","524","42","1026","1889","0","54.31","24.35"
"68","000","00","001","0162","0065","900","362","538","39","939","1985","0","47.3","18.24"
"68","000","00","001","0163","0000","2487","1073","1414","95","2582","4811","0","53.67","22.3"
"68","000","00","001","0163","0136","854","374","480","46","900","1657","0","54.32","22.57"
"68","000","00","001","0163","0137","708","324","384","22","730","1349","0","54.11","24.02"
"68","000","00","001","0163","0138","925","375","550","27","952","1805","0","52.74","20.78"
"68","000","00","001","0164","0000","2424","984","1440","86","2510","4605","0","54.51","21.37"
"68","000","00","001","0164","0054","908","350","558","33","941","1740","0","54.08","20.11"
"68","000","00","001","0164","0055","825","364","461","38","863","1626","0","53.08","22.39"
"68","000","00","001","0164","0056","691","270","421","15","706","1239","0","56.98","21.79"
"68","000","00","001","0165","0000","2577","1056","1521","122","2699","4555","0","59.25","23.18"
"68","000","00","001","0165","0066","835","364","471","47","882","1524","0","57.87","23.88"
"68","000","00","001","0165","0067","850","355","495","30","880","1425","0","61.75","24.91"
"68","000","00","001","0165","0068","892","337","555","45","937","1606","0","58.34","20.98"
"68","000","00","001","0166","0000","2216","807","1409","53","2269","4066","0","55.8","19.85"
"68","000","00","001","0166","0069","1129","418","711","26","1155","2056","0","56.18","20.33"
"68","000","00","001","0166","0070","1087","389","698","27","1114","2010","0","55.42","19.35"
"68","000","00","001","0167","0000","2314","985","1329","91","2405","4702","0","51.15","20.95"
"68","000","00","001","0167","0143","802","359","443","38","840","1566","0","53.64","22.92"
"68","000","00","001","0167","0144","780","342","438","31","811","1517","0","53.46","22.54"
"68","000","00","001","0167","0145","732","284","448","22","754","1619","0","46.57","17.54"
"68","000","00","001","0168","0000","2939","1188","1751","61","3000","5893","0","50.91","20.16"
"68","000","00","001","0168","0168","1208","485","723","22","1230","2204","0","55.81","22.01"
"68","000","00","001","0168","0169","906","402","504","24","930","2033","0","45.75","19.77"
"68","000","00","001","0168","0170","825","301","524","15","840","1656","0","50.72","18.18"
"68","000","00","001","0169","0000","2242","908","1334","88","2330","4541","0","51.31","20.0"
"68","000","00","001","0169","0110","689","304","385","22","711","1524","0","46.65","19.95"
"68","000","00","001","0169","0111","780","284","496","27","807","1528","0","52.81","18.59"
"68","000","00","001","0169","0112","773","320","453","39","812","1489","0","54.53","21.49"
"68","000","00","001","0170","0000","2687","1039","1648","96","2783","5371","0","51.82","19.34"
"68","000","00","001","0170","0071","1068","375","693","45","1113","2245","0","49.58","16.7"
"68","000","00","001","0170","0072","718","346","372","27","745","1590","0","46.86","21.76"
"68","000","00","001","0170","0073","901","318","583","24","925","1536","0","60.22","20.7"
"68","000","00","001","0171","0000","2776","1131","1645","73","2849","5717","0","49.83","19.78"
"68","000","00","001","0171","0098","943","380","563","20","963","1834","0","52.51","20.72"
"68","000","00","001","0171","0099","949","390","559","31","980","2055","0","47.69","18.98"
"68","000","00","001","0171","0100","884","361","523","22","906","1828","0","49.56","19.75"
"68","000","00","001","0172","0000","2863","1285","1578","86","2949","5843","0","50.47","21.99"
"68","000","00","001","0172","0120","923","539","384","25","948","1917","0","49.45","28.12"
"68","000","00","001","0172","0121","948","352","596","34","982","1997","0","49.17","17.63"
"68","000","00","001","0172","0122","992","394","598","27","1019","1929","0","52.83","20.43"
"68","000","00","001","0173","0000","1628","656","972","50","1678","3158","0","53.13","20.77"
"68","000","00","001","0173","0129","708","293","415","30","738","1412","0","52.27","20.75"
"68","000","00","001","0173","0130","920","363","557","20","940","1746","0","53.84","20.79"
"68","000","00","001","0174","0000","3723","1485","2238","137","3860","7902","0","48.85","18.79"
"68","000","00","001","0174","0164","991","371","620","32","1023","2103","0","48.64","17.64"
"68","000","00","001","0174","0165","939","333","606","25","964","1943","0","49.61","17.14"
"68","000","00","001","0174","0166","940","399","541","46","986","1927","0","51.17","20.71"
"68","000","00","001","0174","0167","853","382","471","34","887","1929","0","45.98","19.8"
"68","000","00","001","0175","0000","2758","1180","1578","92","2850","5729","0","49.75","20.6"
"68","000","00","001","0175","0160","563","242","321","29","592","1303","0","45.43","18.57"
"68","000","00","001","0175","0161","738","310","428","21","759","1416","0","53.6","21.89"
"68","000","00","001","0175","0162","648","288","360","23","671","1351","0","49.67","21.32"
"68","000","00","001","0175","0163","809","340","469","19","828","1659","0","49.91","20.49"
"68","000","00","001","0176","0000","1675","690","985","82","1757","3450","0","50.93","20.0"
"68","000","00","001","0176","0171","836","352","484","39","875","1712","0","51.11","20.56"
"68","000","00","001","0176","0172","839","338","501","43","882","1738","0","50.75","19.45"
"68","000","00","001","0177","0000","1769","844","925","63","1832","3856","0","47.51","21.89"
"68","000","00","001","0177","0005","928","461","467","27","955","1974","0","48.38","23.35"
"68","000","00","001","0177","0006","841","383","458","36","877","1882","0","46.6","20.35"
"68","000","00","001","0178","0000","2446","1001","1445","92","2538","4835","0","52.49","20.7"
"68","000","00","001","0178","0179","898","402","496","19","917","1702","0","53.88","23.62"
"68","000","00","001","0178","0180","793","307","486","36","829","1589","0","52.17","19.32"
"68","000","00","001","0178","0181","755","292","463","37","792","1544","0","51.3","18.91"
"68","000","00","001","0179","0000","2129","898","1231","57","2186","4217","0","51.84","21.29"
"68","000","00","001","0179","0210","707","283","424","21","728","1363","0","53.41","20.76"
"68","000","00","001","0179","0211","782","326","456","14","796","1546","0","51.49","21.09"
"68","000","00","001","0179","0212","640","289","351","22","662","1308","0","50.61","22.09"
"68","000","00","002","0000","0000","170027","65661","104366","7201","177228","334402","411135","53.0","19.64"
"68","000","00","002","0201","0000","1376","374","1002","73","1449","2916","0","49.69","12.83"
"68","000","00","002","0201","0617","628","145","483","25","653","1329","0","49.13","10.91"
"68","000","00","002","0201","0618","748","229","519","48","796","1587","0","50.16","14.43"
"68","000","00","002","0202","0000","2786","946","1840","112","2898","5418","0","53.49","17.46"
"68","000","00","002","0202","0614","995","324","671","41","1036","1818","0","56.99","17.82"
"68","000","00","002","0202","0615","967","331","636","34","1001","1991","0","50.28","16.62"
"68","000","00","002","0202","0616","824","291","533","37","861","1609","0","53.51","18.09"
"68","000","00","002","0203","0000","1562","560","1002","81","1643","3033","0","54.17","18.46"
"68","000","00","002","0203","0654","812","300","512","45","857","1588","0","53.97","18.89"
"68","000","00","002","0203","0655","750","260","490","36","786","1445","0","54.39","17.99"
"68","000","00","002","0204","0000","485","214","271","20","505","943","0","53.55","22.69"
"68","000","00","002","0204","0763","485","214","271","20","505","943","0","53.55","22.69"
"68","000","00","002","0205","0000","1114","454","660","51","1165","2152","0","54.14","21.1"
"68","000","00","002","0205","0689","548","224","324","18","566","1087","0","52.07","20.61"
"68","000","00","002","0205","0690","566","230","336","33","599","1065","0","56.24","21.6"
"68","000","00","002","0206","0000","2149","871","1278","104","2253","4283","0","52.6","20.34"
"68","000","00","002","0206","0691","956","394","562","42","998","1844","0","54.12","21.37"
"68","000","00","002","0206","0692","559","228","331","37","596","1220","0","48.85","18.69"
"68","000","00","002","0206","0693","634","249","385","25","659","1219","0","54.06","20.43"
"68","000","00","002","0207","0000","2610","1015","1595","89","2699","5415","0","49.84","18.74"
"68","000","00","002","0207","0771","985","347","638","43","1028","2156","0","47.68","16.09"
"68","000","00","002","0207","0772","714","300","414","13","727","1479","0","49.15","20.28"
"68","000","00","002","0207","0773","911","368","543","33","944","1780","0","53.03","20.67"
"68","000","00","002","0208","0000","2442","651","1791","158","2600","5136","0","50.62","12.68"
"68","000","00","002","0208","0679","770","273","497","48","818","1659","0","49.31","16.46"
"68","000","00","002","0208","0680","900","200","700","74","974","1874","0","51.97","10.67"
"68","000","00","002","0208","0681","772","178","594","36","808","1603","0","50.41","11.1"
"68","000","00","002","0209","0000","1759","594","1165","90","1849","3474","0","53.22","17.1"
"68","000","00","002","0209","0675","814","275","539","52","866","1659","0","52.2","16.58"
"68","000","00","002","0209","0676","945","319","626","38","983","1815","0","54.16","17.58"
"68","000","00","002","0210","0000","1918","672","1246","77","1995","3758","0","53.09","17.88"
"68","000","00","002","0210","0662","744","266","478","36","780","1489","0","52.38","17.86"
"68","000","00","002","0210","0663","447","152","295","19","466","827","0","56.35","18.38"
"68","000","00","002","0210","0664","727","254","473","22","749","1442","0","51.94","17.61"
"68","000","00","002","0211","0000","2256","834","1422","120","2376","4303","0","55.22","19.38"
"68","000","00","002","0211","0602","723","259","464","43","766","1281","0","59.8","20.22"
"68","000","00","002","0211","0603","800","313","487","30","830","1462","0","56.77","21.41"
"68","000","00","002","0211","0604","733","262","471","47","780","1560","0","50.0","16.79"
"68","000","00","002","0212","0000","2668","1298","1370","96","2764","5378","0","51.39","24.14"
"68","000","00","002","0212","0619","961","288","673","34","995","1955","0","50.9","14.73"
"68","000","00","002","0212","0620","858","314","544","31","889","1711","0","51.96","18.35"
"68","000","00","002","0212","0621","849","696","153","31","880","1712","0","51.4","40.65"
"68","000","00","002","0213","0000","1755","710","1045","64","1819","3009","0","60.45","23.6"
"68","000","00","002","0213","0652","921","357","564","38","959","1625","0","59.02","21.97"
"68","000","00","002","0213","0653","834","353","481","26","860","1384","0","62.14","25.51"
"68","000","00","002","0214","0000","1090","485","605","53","1143","2061","0","55.46","23.53"
"68","000","00","002","0214","0754","445","219","226","27","472","852","0","55.4","25.7"
"68","000","00","002","0214","0755","645","266","379","26","671","1209","0","55.5","22.0"
"68","000","00","002","0215","0000","2026","829","1197","73","2099","3498","0","60.01","23.7"
"68","000","00","002","0215","0721","829","322","507","24","853","1384","0","61.63","23.27"
"68","000","00","002","0215","0722","622","251","371","18","640","1122","0","57.04","22.37"
"68","000","00","002","0215","0723","575","256","319","31","606","992","0","61.09","25.81"
"68","000","00","002","0216","0000","2090","835","1255","92","2182","4141","0","52.69","20.16"
"68","000","00","002","0216","0627","642","241","401","31","673","1201","0","56.04","20.07"
"68","000","00","002","0216","0628","694","297","397","27","721","1353","0","53.29","21.95"
"68","000","00","002","0216","0629","754","297","457","34","788","1587","0","49.65","18.71"
"68","000","00","002","0217","0000","1783","641","1142","71","1854","5573","0","33.27","11.5"
"68","000","00","002","0217","0642","693","248","445","23","716","3474","0","20.61","7.14"
"68","000","00","002","0217","0643","1090","393","697","48","1138","2099","0","54.22","18.72"
"68","000","00","002","0218","0000","1647","691","956","52","1699","3540","0","47.99","19.52"
"68","000","00","002","0218","0648","942","385","557","33","975","1900","0","51.32","20.26"
"68","000","00","002","0218","0649","705","306","399","19","724","1640","0","44.15","18.66"
"68","000","00","002","0219","0000","2397","858","1539","104","2501","4845","0","51.62","17.71"
"68","000","00","002","0219","0667","789","308","481","37","826","1764","0","46.83","17.46"
"68","000","00","002","0219","0668","798","258","540","25","823","1488","0","55.31","17.34"
"68","000","00","002","0219","0669","810","292","518","42","852","1593","0","53.48","18.33"
"68","000","00","002","0220","0000","1585","577","1008","44","1629","3362","0","48.45","17.16"
"68","000","00","002","0220","0665","865","334","531","14","879","1842","0","47.72","18.13"
"68","000","00","002","0220","0666","720","243","477","30","750","1520","0","49.34","15.99"
"68","000","00","002","0221","0000","1684","717","967","72","1756","3334","0","52.67","21.51"
"68","000","00","002","0221","0732","939","384","555","44","983","1951","0","50.38","19.68"
"68","000","00","002","0221","0733","745","333","412","28","773","1383","0","55.89","24.08"
"68","000","00","002","0222","0000","2358","981","1377","94","2452","4872","0","50.33","20.14"
"68","000","00","002","0222","0787","529","251","278","33","562","1097","0","51.23","22.88"
"68","000","00","002","0222","0788","905","363","542","29","934","1917","0","48.72","18.94"
"68","000","00","002","0222","0789","924","367","557","32","956","1858","0","51.45","19.75"
"68","000","00","002","0223","0000","1272","510","762","46","1318","2506","0","52.59","20.35"
"68","000","00","002","0223","0673","594","265","329","23","617","1249","0","49.4","21.22"
"68","000","00","002","0223","0674","678","245","433","23","701","1257","0","55.77","19.49"
"68","000","00","002","0224","0000","1989","922","1067","105","2094","3776","0","55.46","24.42"
"68","000","00","002","0224","0768","528","251","277","35","563","1028","0","54.77","24.42"
"68","000","00","002","0224","0769","639","310","329","38","677","1157","0","58.51","26.79"
"68","000","00","002","0224","0770","822","361","461","32","854","1591","0","53.68","22.69"
"68","000","00","002","0225","0000","1846","719","1127","55","1901","3667","0","51.84","19.61"
"68","000","00","002","0225","0724","928","375","553","26","954","1820","0","52.42","20.6"
"68","000","00","002","0225","0725","918","344","574","29","947","1847","0","51.27","18.62"
"68","000","00","002","0226","0000","1908","785","1123","87","1995","3712","0","53.74","21.15"
"68","000","00","002","0226","0696","899","438","461","48","947","1733","0","54.65","25.27"
"68","000","00","002","0226","0697","1009","347","662","39","1048","1979","0","52.96","17.53"
"68","000","00","002","0227","0000","3492","1562","1930","117","3609","6638","0","54.37","23.53"
"68","000","00","002","0227","0716","908","408","500","29","937","1798","0","52.11","22.69"
"68","000","00","002","0227","0717","1013","453","560","39","1052","1822","0","57.74","24.86"
"68","000","00","002","0227","0718","839","362","477","23","862","1613","0","53.44","22.44"
"68","000","00","002","0227","0719","732","339","393","26","758","1405","0","53.95","24.13"
"68","000","00","002","0228","0000","430","191","239","14","444","731","0","60.74","26.13"
"68","000","00","002","0228","0764","430","191","239","14","444","731","0","60.74","26.13"
"68","000","00","002","0229","0000","2424","693","1731","154","2578","4672","0","55.18","14.83"
"68","000","00","002","0229","0608","828","187","641","48","876","1627","0","53.84","11.49"
"68","000","00","002","0229","0609","824","277","547","35","859","1519","0","56.55","18.24"
"68","000","00","002","0229","0610","772","229","543","71","843","1526","0","55.24","15.01"
"68","000","00","002","0230","0000","1399","501","898","85","1484","2836","0","52.33","17.67"
"68","000","00","002","0230","0658","748","272","476","43","791","1546","0","51.16","17.59"
"68","000","00","002","0230","0659","651","229","422","42","693","1290","0","53.72","17.75"
"68","000","00","002","0231","0000","1899","821","1078","83","1982","3544","0","55.93","23.17"
"68","000","00","002","0231","0737","962","438","524","36","998","1703","0","58.6","25.72"
"68","000","00","002","0231","0738","937","383","554","47","984","1841","0","53.45","20.8"
"68","000","00","002","0232","0000","1751","756","995","62","1813","3507","0","51.7","21.56"
"68","000","00","002","0232","0752","971","431","540","29","1000","1987","0","50.33","21.69"
"68","000","00","002","0232","0753","780","325","455","33","813","1520","0","53.49","21.38"
"68","000","00","002","0233","0000","4192","1511","2681","160","4352","8947","0","48.64","16.89"
"68","000","00","002","0233","0701","901","322","579","34","935","1943","0","48.12","16.57"
"68","000","00","002","0233","0702","697","276","421","23","720","1363","0","52.82","20.25"
"68","000","00","002","0233","0703","947","357","590","43","990","2172","0","45.58","16.44"
"68","000","00","002","0233","0704","844","285","559","35","879","1798","0","48.89","15.85"
"68","000","00","002","0233","0705","803","271","532","25","828","1671","0","49.55","16.22"
"68","000","00","002","0234","0000","4284","1677","2607","195","4479","8663","0","51.7","19.36"
"68","000","00","002","0234","0709","794","278","516","33","827","1923","0","43.01","14.46"
"68","000","00","002","0234","0710","853","326","527","50","903","1572","0","57.44","20.74"
"68","000","00","002","0234","0711","993","398","595","27","1020","1850","0","55.14","21.51"
"68","000","00","002","0234","0712","770","309","461","52","822","1583","0","51.93","19.52"
"68","000","00","002","0234","0713","874","366","508","33","907","1735","0","52.28","21.1"
"68","000","00","002","0235","0000","1049","464","585","32","1081","1957","0","55.24","23.71"
"68","000","00","002","0235","0758","1049","464","585","32","1081","1957","0","55.24","23.71"
"68","000","00","002","0236","0000","3800","1421","2379","147","3947","7473","0","52.82","19.02"
"68","000","00","002","0236","0741","906","364","542","32","938","1636","0","57.33","22.25"
"68","000","00","002","0236","0742","843","333","510","30","873","1528","0","57.13","21.79"
"68","000","00","002","0236","0743","1046","300","746","57","1103","2289","0","48.19","13.11"
"68","000","00","002","0236","0744","1005","424","581","28","1033","2020","0","51.14","20.99"
"68","000","00","002","0237","0000","2390","965","1425","75","2465","4365","0","56.47","22.11"
"68","000","00","002","0237","0636","708","318","390","19","727","1368","0","53.14","23.25"
"68","000","00","002","0237","0637","825","334","491","31","856","1424","0","60.11","23.46"
"68","000","00","002","0237","0638","857","313","544","25","882","1573","0","56.07","19.9"
"68","000","00","002","0238","0000","941","405","536","46","987","1730","0","57.05","23.41"
"68","000","00","002","0238","0720","941","405","536","46","987","1730","0","57.05","23.41"
"68","000","00","002","0239","0000","2528","746","1782","174","2702","4878","0","55.39","15.29"
"68","000","00","002","0239","0611","810","274","536","63","873","1618","0","53.96","16.93"
"68","000","00","002","0239","0612","854","249","605","49","903","1554","0","58.11","16.02"
"68","000","00","002","0239","0613","864","223","641","62","926","1706","0","54.28","13.07"
"68","000","00","002","0240","0000","547","293","254","20","567","1011","0","56.08","28.98"
"68","000","00","002","0240","0766","547","293","254","20","567","1011","0","56.08","28.98"
"68","000","00","002","0241","0000","1493","601","892","70","1563","3045","0","51.33","19.74"
"68","000","00","002","0241","0756","760","331","429","50","810","1481","0","54.69","22.35"
"68","000","00","002","0241","0757","733","270","463","20","753","1564","0","48.15","17.26"
"68","000","00","002","0242","0000","2327","947","1380","103","2430","4841","0","50.2","19.56"
"68","000","00","002","0242","0591","708","267","441","40","748","1401","0","53.39","19.06"
"68","000","00","002","0242","0592","868","377","491","32","900","1798","0","50.06","20.97"
"68","000","00","002","0242","0593","751","303","448","31","782","1642","0","47.62","18.45"
"68","000","00","002","0243","0000","2820","1251","1569","119","2939","6378","0","46.08","19.61"
"68","000","00","002","0243","0798","1008","452","556","50","1058","2068","0","51.16","21.86"
"68","000","00","002","0243","0799","862","376","486","30","892","2152","0","41.45","17.47"
"68","000","00","002","0243","0800","950","423","527","39","989","2158","0","45.83","19.6"
"68","000","00","002","0244","0000","3062","1247","1815","136","3198","6013","0","53.18","20.74"
"68","000","00","002","0244","0779","744","303","441","25","769","1426","0","53.93","21.25"
"68","000","00","002","0244","0780","772","325","447","29","801","1618","0","49.51","20.09"
"68","000","00","002","0244","0781","743","290","453","40","783","1441","0","54.34","20.12"
"68","000","00","002","0244","0782","803","329","474","42","845","1528","0","55.3","21.53"
"68","000","00","002","0245","0000","870","397","473","30","900","1532","0","58.75","25.91"
"68","000","00","002","0245","0767","870","397","473","30","900","1532","0","58.75","25.91"
"68","000","00","002","0246","0000","1671","749","922","82","1753","3344","0","52.42","22.4"
"68","000","00","002","0246","0785","793","395","398","33","826","1534","0","53.85","25.75"
"68","000","00","002","0246","0786","878","354","524","49","927","1810","0","51.22","19.56"
"68","000","00","002","0247","0000","2758","1355","1403","143","2901","5162","0","56.2","26.25"
"68","000","00","002","0247","0793","1050","488","562","66","1116","2037","0","54.79","23.96"
"68","000","00","002","0247","0794","674","341","333","29","703","1158","0","60.71","29.45"
"68","000","00","002","0247","0795","1034","526","508","48","1082","1967","0","55.01","26.74"
"68","000","00","002","0248","0000","1502","685","817","74","1576","3148","0","50.06","21.76"
"68","000","00","002","0248","0777","746","336","410","40","786","1609","0","48.85","20.88"
"68","000","00","002","0248","0778","756","349","407","34","790","1539","0","51.33","22.68"
"68","000","00","002","0249","0000","1828","840","988","93","1921","3686","0","52.12","22.79"
"68","000","00","002","0249","0796","881","407","474","41","922","1830","0","50.38","22.24"
"68","000","00","002","0249","0797","947","433","514","52","999","1856","0","53.83","23.33"
"68","000","00","002","0250","0000","469","217","252","30","499","851","0","58.64","25.5"
"68","000","00","002","0250","0765","469","217","252","30","499","851","0","58.64","25.5"
"68","000","00","002","0251","0000","2433","1198","1235","99","2532","4643","0","54.53","25.8"
"68","000","00","002","0251","0790","809","449","360","47","856","1576","0","54.31","28.49"
"68","000","00","002","0251","0791","807","387","420","27","834","1478","0","56.43","26.18"
"68","000","00","002","0251","0792","817","362","455","25","842","1589","0","52.99","22.78"
"68","000","00","002","0252","0000","2332","820","1512","106","2438","4812","0","50.67","17.04"
"68","000","00","002","0252","0729","695","249","446","33","728","1234","0","59.0","20.18"
"68","000","00","002","0252","0730","910","312","598","46","956","2023","0","47.26","15.42"
"68","000","00","002","0252","0731","727","259","468","27","754","1555","0","48.49","16.66"
"68","000","00","002","0253","0000","1478","564","914","55","1533","2587","0","59.26","21.8"
"68","000","00","002","0253","0634","665","249","416","24","689","1177","0","58.54","21.16"
"68","000","00","002","0253","0635","813","315","498","31","844","1410","0","59.86","22.34"
"68","000","00","002","0254","0000","1552","638","914","59","1611","2767","0","58.22","23.06"
"68","000","00","002","0254","0761","597","267","330","35","632","1066","0","59.29","25.05"
"68","000","00","002","0254","0762","955","371","584","24","979","1701","0","57.55","21.81"
"68","000","00","002","0255","0000","2709","956","1753","89","2798","5434","0","51.49","17.59"
"68","000","00","002","0255","0774","853","383","470","41","894","1651","0","54.15","23.2"
"68","000","00","002","0255","0775","1003","337","666","27","1030","1870","0","55.08","18.02"
"68","000","00","002","0255","0776","853","236","617","21","874","1913","0","45.69","12.34"
"68","000","00","002","0256","0000","2829","1080","1749","109","2938","5294","0","55.5","20.4"
"68","000","00","002","0256","0706","949","369","580","33","982","1969","0","49.87","18.74"
"68","000","00","002","0256","0707","946","370","576","33","979","1563","0","62.64","23.67"
"68","000","00","002","0256","0708","934","341","593","43","977","1762","0","55.45","19.35"
"68","000","00","002","0257","0000","2452","931","1521","73","2525","4543","0","55.58","20.49"
"68","000","00","002","0257","0698","870","350","520","21","891","1621","0","54.97","21.59"
"68","000","00","002","0257","0699","757","303","454","27","784","1391","0","56.36","21.78"
"68","000","00","002","0257","0700","825","278","547","25","850","1531","0","55.52","18.16"
"68","000","00","002","0258","0000","1544","591","953","85","1629","2854","0","57.08","20.71"
"68","000","00","002","0258","0694","663","282","381","37","700","1260","0","55.56","22.38"
"68","000","00","002","0258","0695","881","309","572","48","929","1594","0","58.28","19.39"
"68","000","00","002","0259","0000","1347","534","813","35","1382","2557","0","54.05","20.88"
"68","000","00","002","0259","0714","681","274","407","17","698","1292","0","54.02","21.21"
"68","000","00","002","0259","0715","666","260","406","18","684","1265","0","54.07","20.55"
"68","000","00","002","0260","0000","1686","638","1048","64","1750","3331","0","52.54","19.15"
"68","000","00","002","0260","0630","965","385","580","40","1005","1883","0","53.37","20.45"
"68","000","00","002","0260","0631","721","253","468","24","745","1448","0","51.45","17.47"
"68","000","00","002","0261","0000","1854","723","1131","87","1941","3726","0","52.09","19.4"
"68","000","00","002","0261","0632","926","360","566","31","957","1810","0","52.87","19.89"
"68","000","00","002","0261","0633","928","363","565","56","984","1916","0","51.36","18.95"
"68","000","00","002","0262","0000","2515","1021","1494","95","2610","4657","0","56.04","21.92"
"68","000","00","002","0262","0594","855","316","539","38","893","1670","0","53.47","18.92"
"68","000","00","002","0262","0595","789","348","441","19","808","1456","0","55.49","23.9"
"68","000","00","002","0262","0596","871","357","514","38","909","1531","0","59.37","23.32"
"68","000","00","002","0263","0000","1771","579","1192","68","1839","3576","0","51.43","16.19"
"68","000","00","002","0263","0597","904","301","603","39","943","1623","0","58.1","18.55"
"68","000","00","002","0263","0598","867","278","589","29","896","1953","0","45.88","14.23"
"68","000","00","002","0264","0000","1878","791","1087","108","1986","3628","0","54.74","21.8"
"68","000","00","002","0264","0783","852","387","465","60","912","1683","0","54.19","22.99"
"68","000","00","002","0264","0784","1026","404","622","48","1074","1945","0","55.22","20.77"
"68","000","00","002","0265","0000","2322","822","1500","101","2423","4082","0","59.36","20.14"
"68","000","00","002","0265","0605","888","344","544","52","940","1602","0","58.68","21.47"
"68","000","00","002","0265","0606","621","216","405","25","646","1006","0","64.21","21.47"
"68","000","00","002","0265","0607","813","262","551","24","837","1474","0","56.78","17.77"
"68","000","00","002","0266","0000","2305","951","1354","76","2381","4296","0","55.42","22.14"
"68","000","00","002","0266","0639","637","263","374","23","660","1152","0","57.29","22.83"
"68","000","00","002","0266","0640","642","288","354","16","658","1178","0","55.86","24.45"
"68","000","00","002","0266","0641","1026","400","626","37","1063","1966","0","54.07","20.35"
"68","000","00","002","0267","0000","1267","388","879","60","1327","2125","0","62.45","18.26"
"68","000","00","002","0267","0650","569","157","412","28","597","994","0","60.06","15.79"
"68","000","00","002","0267","0651","698","231","467","32","730","1131","0","64.54","20.42"
"68","000","00","002","0268","0000","2402","871","1531","91","2493","4658","0","53.52","18.7"
"68","000","00","002","0268","0670","762","277","485","39","801","1505","0","53.22","18.41"
"68","000","00","002","0268","0671","852","326","526","21","873","1661","0","52.56","19.63"
"68","000","00","002","0268","0672","788","268","520","31","819","1492","0","54.89","17.96"
"68","000","00","002","0269","0000","1446","525","921","80","1526","2575","0","59.26","20.39"
"68","000","00","002","0269","0644","635","225","410","34","669","1178","0","56.79","19.1"
"68","000","00","002","0269","0645","811","300","511","46","857","1397","0","61.35","21.47"
"68","000","00","002","0270","0000","1864","760","1104","78","1942","3756","0","51.7","20.23"
"68","000","00","002","0270","0646","889","363","526","42","931","1669","0","55.78","21.75"
"68","000","00","002","0270","0647","975","397","578","36","1011","2087","0","48.44","19.02"
"68","000","00","002","0271","0000","1683","528","1155","109","1792","3596","0","49.83","14.68"
"68","000","00","002","0271","0660","1000","300","700","74","1074","2145","0","50.07","13.99"
"68","000","00","002","0271","0661","683","228","455","35","718","1451","0","49.48","15.71"
"68","000","00","002","0272","0000","2342","755","1587","100","2442","4686","0","52.11","16.11"
"68","000","00","002","0272","0622","797","260","537","39","836","1448","0","57.73","17.96"
"68","000","00","002","0272","0623","789","253","536","46","835","1605","0","52.02","15.76"
"68","000","00","002","0272","0624","756","242","514","15","771","1633","0","47.21","14.82"
"68","000","00","002","0273","0000","2851","1114","1737","99","2950","5990","0","49.25","18.6"
"68","000","00","002","0273","0745","1046","419","627","42","1088","2027","0","53.68","20.67"
"68","000","00","002","0273","0746","820","327","493","17","837","1883","0","44.45","17.37"
"68","000","00","002","0273","0747","985","368","617","40","1025","2080","0","49.28","17.69"
"68","000","00","002","0274","0000","3094","1437","1657","114","3208","5466","0","58.69","26.29"
"68","000","00","002","0274","0748","337","152","185","15","352","646","0","54.49","23.53"
"68","000","00","002","0274","0749","1066","628","438","44","1110","1780","0","62.36","35.28"
"68","000","00","002","0274","0750","765","298","467","21","786","1372","0","57.29","21.72"
"68","000","00","002","0274","0751","926","359","567","34","960","1668","0","57.55","21.52"
"68","000","00","002","0275","0000","1706","616","1090","72","1778","3555","0","50.01","17.33"
"68","000","00","002","0275","0656","825","286","539","43","868","1743","0","49.8","16.41"
"68","000","00","002","0275","0657","881","330","551","29","910","1812","0","50.22","18.21"
"68","000","00","002","0276","0000","1851","631","1220","71","1922","3484","0","55.17","18.11"
"68","000","00","002","0276","0625","957","456","501","50","1007","1795","0","56.1","25.4"
"68","000","00","002","0276","0626","894","175","719","21","915","1689","0","54.17","10.36"
"68","000","00","002","0277","0000","1738","374","1364","79","1817","3448","0","52.7","10.85"
"68","000","00","002","0277","0685","927","205","722","42","969","1739","0","55.72","11.79"
"68","000","00","002","0277","0686","811","169","642","37","848","1709","0","49.62","9.89"
"68","000","00","002","0278","0000","1732","529","1203","69","1801","3319","0","54.26","15.94"
"68","000","00","002","0278","0687","863","264","599","49","912","1655","0","55.11","15.95"
"68","000","00","002","0278","0688","869","265","604","20","889","1664","0","53.43","15.93"
"68","000","00","002","0279","0000","2389","855","1534","90","2479","4416","0","56.14","19.36"
"68","000","00","002","0279","0734","677","249","428","28","705","1164","0","60.57","21.39"
"68","000","00","002","0279","0735","795","267","528","27","822","1482","0","55.47","18.02"
"68","000","00","002","0279","0736","917","339","578","35","952","1770","0","53.79","19.15"
"68","000","00","002","0280","0000","1340","595","745","62","1402","2405","0","58.3","24.74"
"68","000","00","002","0280","0759","662","301","361","36","698","1223","0","57.07","24.61"
"68","000","00","002","0280","0760","678","294","384","26","704","1182","0","59.56","24.87"
"68","000","00","002","0281","0000","1628","563","1065","66","1694","3243","0","52.24","17.36"
"68","000","00","002","0281","0677","823","289","534","44","867","1702","0","50.94","16.98"
"68","000","00","002","0281","0678","805","274","531","22","827","1541","0","53.67","17.78"
"68","000","00","002","0282","0000","2280","777","1503","81","2361","4712","0","50.11","16.49"
"68","000","00","002","0282","0599","634","240","394","28","662","1155","0","57.32","20.78"
"68","000","00","002","0282","0600","815","263","552","32","847","1800","0","47.06","14.61"
"68","000","00","002","0282","0601","831","274","557","21","852","1757","0","48.49","15.59"
"68","000","00","002","0283","0000","2652","886","1766","80","2732","5423","0","50.38","16.34"
"68","000","00","002","0283","0682","851","269","582","32","883","1735","0","50.89","15.5"
"68","000","00","002","0283","0683","890","294","596","22","912","1815","0","50.25","16.2"
"68","000","00","002","0283","0684","911","323","588","26","937","1873","0","50.03","17.25"
"68","000","00","002","0284","0000","2146","857","1289","109","2255","3731","0","60.44","22.97"
"68","000","00","002","0284","0726","724","297","427","38","762","1302","0","58.53","22.81"
"68","000","00","002","0284","0727","670","266","404","28","698","1203","0","58.02","22.11"
"68","000","00","002","0284","0728","752","294","458","43","795","1226","0","64.85","23.98"
"68","000","00","002","0285","0000","2128","725","1403","55","2183","3970","0","54.99","18.26"
"68","000","00","002","0285","0739","1038","379","659","28","1066","1941","0","54.92","19.53"
"68","000","00","002","0285","0740","1090","346","744","27","1117","2029","0","55.05","17.05"
"68","000","00","003","0000","0000","39565","17905","21660","2146","41711","78285","94862","53.28","22.87"
"68","000","00","003","0301","0000","807","450","357","37","844","1477","0","57.14","30.47"
"68","000","00","003","0301","0522","807","450","357","37","844","1477","0","57.14","30.47"
"68","000","00","003","0302","0000","560","310","250","26","586","1006","0","58.25","30.82"
"68","000","00","003","0302","0523","560","310","250","26","586","1006","0","58.25","30.82"
"68","000","00","003","0303","0000","2264","1072","1192","94","2358","4752","0","49.62","22.56"
"68","000","00","003","0303","0527","731","342","389","32","763","1585","0","48.14","21.58"
"68","000","00","003","0303","0528","810","380","430","33","843","1612","0","52.3","23.57"
"68","000","00","003","0303","0529","723","350","373","29","752","1555","0","48.36","22.51"
"68","000","00","003","0304","0000","2870","1334","1536","160","3030","5544","0","54.65","24.06"
"68","000","00","003","0304","0530","734","339","395","39","773","1282","0","60.3","26.44"
"68","000","00","003","0304","0531","703","285","418","34","737","1392","0","52.95","20.47"
"68","000","00","003","0304","0532","697","356","341","36","733","1422","0","51.55","25.04"
"68","000","00","003","0304","0533","736","354","382","51","787","1448","0","54.35","24.45"
"68","000","00","003","0305","0000","742","389","353","39","781","1269","0","61.54","30.65"
"68","000","00","003","0305","0534","742","389","353","39","781","1269","0","61.54","30.65"
"68","000","00","003","0306","0000","551","323","228","49","600","977","0","61.41","33.06"
"68","000","00","003","0306","0535","551","323","228","49","600","977","0","61.41","33.06"
"68","000","00","003","0307","0000","1513","811","702","83","1596","3036","0","52.57","26.71"
"68","000","00","003","0307","0539","511","282","229","26","537","1056","0","50.85","26.7"
"68","000","00","003","0307","0540","626","320","306","29","655","1263","0","51.86","25.34"
"68","000","00","003","0307","0541","376","209","167","28","404","717","0","56.35","29.15"
"68","000","00","003","0308","0000","1103","608","495","42","1145","2275","0","50.33","26.73"
"68","000","00","003","0308","0542","586","320","266","13","599","1299","0","46.11","24.63"
"68","000","00","003","0308","0543","517","288","229","29","546","976","0","55.94","29.51"
"68","000","00","003","0309","0000","473","240","233","35","508","938","0","54.16","25.59"
"68","000","00","003","0309","0544","473","240","233","35","508","938","0","54.16","25.59"
"68","000","00","003","0310","0000","405","189","216","31","436","832","0","52.4","22.72"
"68","000","00","003","0310","0545","405","189","216","31","436","832","0","52.4","22.72"
"68","000","00","003","0311","0000","765","430","335","34","799","1359","0","58.79","31.64"
"68","000","00","003","0311","0536","765","430","335","34","799","1359","0","58.79","31.64"
"68","000","00","003","0312","0000","990","521","469","58","1048","1795","0","58.38","29.03"
"68","000","00","003","0312","0537","650","319","331","44","694","1135","0","61.15","28.11"
"68","000","00","003","0312","0538","340","202","138","14","354","660","0","53.64","30.61"
"68","000","00","003","0313","0000","1322","664","658","74","1396","2713","0","51.46","24.47"
"68","000","00","003","0313","0548","716","408","308","30","746","1410","0","52.91","28.94"
"68","000","00","003","0313","0549","606","256","350","44","650","1303","0","49.88","19.65"
"68","000","00","003","0314","0000","717","400","317","40","757","1560","0","48.53","25.64"
"68","000","00","003","0314","0546","387","220","167","16","403","866","0","46.54","25.4"
"68","000","00","003","0314","0547","330","180","150","24","354","694","0","51.01","25.94"
"68","000","00","003","0315","0000","1274","401","873","94","1368","2852","0","47.97","14.06"
"68","000","00","003","0315","0557","681","235","446","60","741","1446","0","51.24","16.25"
"68","000","00","003","0315","0558","593","166","427","34","627","1406","0","44.59","11.81"
"68","000","00","003","0316","0000","1317","352","965","68","1385","2542","0","54.48","13.85"
"68","000","00","003","0316","0555","640","148","492","42","682","1173","0","58.14","12.62"
"68","000","00","003","0316","0556","677","204","473","26","703","1369","0","51.35","14.9"
"68","000","00","003","0317","0000","1924","837","1087","82","2006","3603","0","55.68","23.23"
"68","000","00","003","0317","0550","556","271","285","37","593","1125","0","52.71","24.09"
"68","000","00","003","0317","0551","629","267","362","18","647","1170","0","55.3","22.82"
"68","000","00","003","0317","0552","739","299","440","27","766","1308","0","58.56","22.86"
"68","000","00","003","0318","0000","2636","1121","1515","113","2749","5012","0","54.85","22.37"
"68","000","00","003","0318","0562","861","356","505","23","884","1684","0","52.49","21.14"
"68","000","00","003","0318","0563","1047","448","599","39","1086","1959","0","55.44","22.87"
"68","000","00","003","0318","0564","728","317","411","51","779","1369","0","56.9","23.16"
"68","000","00","003","0319","0000","1437","575","862","66","1503","3088","0","48.67","18.62"
"68","000","00","003","0319","0565","759","297","462","43","802","1431","0","56.04","20.75"
"68","000","00","003","0319","0566","678","278","400","23","701","1657","0","42.31","16.78"
"68","000","00","003","0320","0000","711","292","419","27","738","1514","0","48.75","19.29"
"68","000","00","003","0320","0575","711","292","419","27","738","1514","0","48.75","19.29"
"68","000","00","003","0321","0000","2208","1105","1103","172","2380","4947","0","48.11","22.34"
"68","000","00","003","0321","0570","722","375","347","62","784","1511","0","51.89","24.82"
"68","000","00","003","0321","0571","742","380","362","62","804","1719","0","46.77","22.11"
"68","000","00","003","0321","0572","744","350","394","48","792","1717","0","46.13","20.38"
"68","000","00","003","0322","0000","1937","828","1109","85","2022","3732","0","54.18","22.19"
"68","000","00","003","0322","0578","466","167","299","10","476","831","0","57.28","20.1"
"68","000","00","003","0322","0579","754","318","436","33","787","1407","0","55.93","22.6"
"68","000","00","003","0322","0580","717","343","374","42","759","1494","0","50.8","22.96"
"68","000","00","003","0323","0000","1162","421","741","127","1289","2395","0","53.82","17.58"
"68","000","00","003","0323","0573","558","226","332","54","612","1207","0","50.7","18.72"
"68","000","00","003","0323","0574","604","195","409","73","677","1188","0","56.99","16.41"
"68","000","00","003","0324","0000","1529","508","1021","73","1602","2789","0","57.44","18.21"
"68","000","00","003","0324","0576","814","271","543","45","859","1529","0","56.18","17.72"
"68","000","00","003","0324","0577","715","237","478","28","743","1260","0","58.97","18.81"
"68","000","00","003","0325","0000","2318","1154","1164","112","2430","4508","0","53.9","25.6"
"68","000","00","003","0325","0524","780","357","423","40","820","1553","0","52.8","22.99"
"68","000","00","003","0325","0525","836","446","390","41","877","1597","0","54.92","27.93"
"68","000","00","003","0325","0526","702","351","351","31","733","1358","0","53.98","25.85"
"68","000","00","003","0326","0000","1889","821","1068","96","1985","3875","0","51.23","21.19"
"68","000","00","003","0326","0567","586","269","317","27","613","1387","0","44.2","19.39"
"68","000","00","003","0326","0568","543","221","322","34","577","1085","0","53.18","20.37"
"68","000","00","003","0326","0569","760","331","429","35","795","1403","0","56.66","23.59"
"68","000","00","003","0327","0000","2485","1020","1465","115","2600","4648","0","55.94","21.94"
"68","000","00","003","0327","0559","833","317","516","28","861","1592","0","54.08","19.91"
"68","000","00","003","0327","0560","814","341","473","41","855","1497","0","57.11","22.78"
"68","000","00","003","0327","0561","838","362","476","46","884","1559","0","56.7","23.22"
"68","000","00","003","0328","0000","1656","729","927","114","1770","3247","0","54.51","22.45"
"68","000","00","003","0328","0553","563","258","305","58","621","1094","0","56.76","23.58"
"68","000","00","003","0328","0554","1093","471","622","56","1149","2153","0","53.37","21.88"
"68","000","00","004","0000","0000","67715","25154","42561","2889","70604","137917","169991","51.19","18.24"
"68","000","00","004","0401","0000","1901","667","1234","59","1960","3705","0","52.9","18.0"
"68","000","00","004","0401","0960","965","325","640","32","997","1943","0","51.31","16.73"
"68","000","00","004","0401","0961","936","342","594","27","963","1762","0","54.65","19.41"
"68","000","00","004","0402","0000","572","211","361","27","599","1083","0","55.31","19.48"
"68","000","00","004","0402","0962","572","211","361","27","599","1083","0","55.31","19.48"
"68","000","00","004","0403","0000","1431","525","906","84","1515","2633","0","57.54","19.94"
"68","000","00","004","0403","0964","684","268","416","47","731","1274","0","57.38","21.04"
"68","000","00","004","0403","0965","747","257","490","37","784","1359","0","57.69","18.91"
"68","000","00","004","0404","0000","2914","1058","1856","95","3009","6964","0","43.21","15.19"
"68","000","00","004","0404","0966","849","329","520","27","876","2444","0","35.84","13.46"
"68","000","00","004","0404","0967","1009","373","636","32","1041","2298","0","45.3","16.23"
"68","000","00","004","0404","0968","1056","356","700","36","1092","2222","0","49.14","16.02"
"68","000","00","004","0405","0000","1581","596","985","137","1718","3237","0","53.07","18.41"
"68","000","00","004","0405","0969","787","309","478","66","853","1610","0","52.98","19.19"
"68","000","00","004","0405","0970","794","287","507","71","865","1627","0","53.17","17.64"
"68","000","00","004","0406","0000","1224","547","677","56","1280","2776","0","46.11","19.7"
"68","000","00","004","0406","0973","747","326","421","34","781","1776","0","43.98","18.36"
"68","000","00","004","0406","0974","477","221","256","22","499","1000","0","49.9","22.1"
"68","000","00","004","0407","0000","2234","793","1441","111","2345","4112","0","57.03","19.29"
"68","000","00","004","0407","1003","777","268","509","29","806","1448","0","55.66","18.51"
"68","000","00","004","0407","1004","729","270","459","42","771","1351","0","57.07","19.99"
"68","000","00","004","0407","1005","728","255","473","40","768","1313","0","58.49","19.42"
"68","000","00","004","0408","0000","1393","570","823","40","1433","2602","0","55.07","21.91"
"68","000","00","004","0408","0989","639","266","373","20","659","1194","0","55.19","22.28"
"68","000","00","004","0408","0990","754","304","450","20","774","1408","0","54.97","21.59"
"68","000","00","004","0409","0000","995","341","654","54","1049","2027","0","51.75","16.82"
"68","000","00","004","0409","0963","995","341","654","54","1049","2027","0","51.75","16.82"
"68","000","00","004","0410","0000","1760","605","1155","61","1821","3300","0","55.18","18.33"
"68","000","00","004","0410","0956","885","319","566","14","899","1713","0","52.48","18.62"
"68","000","00","004","0410","0957","875","286","589","47","922","1587","0","58.1","18.02"
"68","000","00","004","0411","0000","765","299","466","32","797","1434","0","55.58","20.85"
"68","000","00","004","0411","0929","765","299","466","32","797","1434","0","55.58","20.85"
"68","000","00","004","0412","0000","625","201","424","29","654","1137","0","57.52","17.68"
"68","000","00","004","0412","0932","625","201","424","29","654","1137","0","57.52","17.68"
"68","000","00","004","0413","0000","2506","966","1540","137","2643","5314","0","49.74","18.18"
"68","000","00","004","0413","0936","769","322","447","48","817","1449","0","56.38","22.22"
"68","000","00","004","0413","0937","818","295","523","51","869","1877","0","46.3","15.72"
"68","000","00","004","0413","0938","919","349","570","38","957","1988","0","48.14","17.56"
"68","000","00","004","0414","0000","2044","666","1378","66","2110","4219","0","50.01","15.79"
"68","000","00","004","0414","0933","1056","345","711","41","1097","2211","0","49.62","15.6"
"68","000","00","004","0414","0934","988","321","667","25","1013","2008","0","50.45","15.99"
"68","000","00","004","0415","0000","1838","670","1168","59","1897","3730","0","50.86","17.96"
"68","000","00","004","0415","0942","905","332","573","29","934","1848","0","50.54","17.97"
"68","000","00","004","0415","0943","933","338","595","30","963","1882","0","51.17","17.96"
"68","000","00","004","0416","0000","1674","565","1109","61","1735","3657","0","47.44","15.45"
"68","000","00","004","0416","0991","746","270","476","39","785","1737","0","45.19","15.54"
"68","000","00","004","0416","0992","928","295","633","22","950","1920","0","49.48","15.36"
"68","000","00","004","0417","0000","1747","728","1019","61","1808","3378","0","53.52","21.55"
"68","000","00","004","0417","0997","893","399","494","39","932","1692","0","55.08","23.58"
"68","000","00","004","0417","0998","854","329","525","22","876","1686","0","51.96","19.51"
"68","000","00","004","0418","0000","2173","774","1399","138","2311","3923","0","58.91","19.73"
"68","000","00","004","0418","0926","671","251","420","46","717","1269","0","56.5","19.78"
"68","000","00","004","0418","0927","720","257","463","53","773","1246","0","62.04","20.63"
"68","000","00","004","0418","0928","782","266","516","39","821","1408","0","58.31","18.89"
"68","000","00","004","0419","0000","1512","511","1001","88","1600","3172","0","50.44","16.11"
"68","000","00","004","0419","0930","747","252","495","45","792","1515","0","52.28","16.63"
"68","000","00","004","0419","0931","765","259","506","43","808","1657","0","48.76","15.63"
"68","000","00","004","0420","0000","901","325","576","44","945","1861","0","50.78","17.46"
"68","000","00","004","0420","0977","901","325","576","44","945","1861","0","50.78","17.46"
"68","000","00","004","0421","0000","1765","692","1073","106","1871","3841","0","48.71","18.02"
"68","000","00","004","0421","0975","980","378","602","70","1050","2290","0","45.85","16.51"
"68","000","00","004","0421","0976","785","314","471","36","821","1551","0","52.93","20.25"
"68","000","00","004","0422","0000","1340","540","800","86","1426","2685","0","53.11","20.11"
"68","000","00","004","0422","0980","753","308","445","46","799","1498","0","53.34","20.56"
"68","000","00","004","0422","0981","587","232","355","40","627","1187","0","52.82","19.55"
"68","000","00","004","0423","0000","1784","651","1133","65","1849","3752","0","49.28","17.35"
"68","000","00","004","0423","1006","845","324","521","35","880","1689","0","52.1","19.18"
"68","000","00","004","0423","1007","939","327","612","30","969","2063","0","46.97","15.85"
"68","000","00","004","0424","0000","1392","559","833","66","1458","2694","0","54.12","20.75"
"68","000","00","004","0424","0982","670","257","413","39","709","1270","0","55.83","20.24"
"68","000","00","004","0424","0983","722","302","420","27","749","1424","0","52.6","21.21"
"68","000","00","004","0425","0000","2385","952","1433","115","2500","5412","0","46.19","17.59"
"68","000","00","004","0425","0986","748","296","452","48","796","1783","0","44.64","16.6"
"68","000","00","004","0425","0987","799","314","485","18","817","1709","0","47.81","18.37"
"68","000","00","004","0425","0988","838","342","496","49","887","1920","0","46.2","17.81"
"68","000","00","004","0426","0000","1638","579","1059","56","1694","3007","0","56.34","19.26"
"68","000","00","004","0426","0958","793","275","518","26","819","1416","0","57.84","19.42"
"68","000","00","004","0426","0959","845","304","541","30","875","1591","0","55.0","19.11"
"68","000","00","004","0427","0000","3014","1085","1929","103","3117","6381","0","48.85","17.0"
"68","000","00","004","0427","0950","976","361","615","29","1005","2101","0","47.83","17.18"
"68","000","00","004","0427","0951","1034","370","664","41","1075","2054","0","52.34","18.01"
"68","000","00","004","0427","0952","1004","354","650","33","1037","2226","0","46.59","15.9"
"68","000","00","004","0428","0000","1860","682","1178","47","1907","3687","0","51.72","18.5"
"68","000","00","004","0428","0946","706","259","447","13","719","1562","0","46.03","16.58"
"68","000","00","004","0428","0947","1154","423","731","34","1188","2125","0","55.91","19.91"
"68","000","00","004","0429","0000","1598","541","1057","42","1640","3248","0","50.49","16.66"
"68","000","00","004","0429","0953","742","237","505","19","761","1405","0","54.16","16.87"
"68","000","00","004","0429","0954","856","304","552","23","879","1843","0","47.69","16.49"
"68","000","00","004","0430","0000","1714","651","1063","97","1811","3347","0","54.11","19.45"
"68","000","00","004","0430","0971","837","332","505","39","876","1589","0","55.13","20.89"
"68","000","00","004","0430","0972","877","319","558","58","935","1758","0","53.19","18.15"
"68","000","00","004","0431","0000","1769","713","1056","53","1822","3883","0","46.92","18.36"
"68","000","00","004","0431","0995","924","353","571","33","957","2020","0","47.38","17.48"
"68","000","00","004","0431","0996","845","360","485","20","865","1863","0","46.43","19.32"
"68","000","00","004","0432","0000","1779","705","1074","80","1859","3492","0","53.24","20.19"
"68","000","00","004","0432","1001","900","399","501","32","932","1603","0","58.14","24.89"
"68","000","00","004","0432","1002","879","306","573","48","927","1889","0","49.07","16.2"
"68","000","00","004","0433","0000","1687","625","1062","52","1739","3183","0","54.63","19.64"
"68","000","00","004","0433","0999","852","327","525","37","889","1626","0","54.67","20.11"
"68","000","00","004","0433","1000","835","298","537","15","850","1557","0","54.59","19.14"
"68","000","00","004","0434","0000","2850","1024","1826","80","2930","5546","0","52.83","18.46"
"68","000","00","004","0434","0939","990","345","645","28","1018","1931","0","52.72","17.87"
"68","000","00","004","0434","0940","1003","400","603","28","1031","1938","0","53.2","20.64"
"68","000","00","004","0434","0941","857","279","578","24","881","1677","0","52.53","16.64"
"68","000","00","004","0435","0000","923","350","573","42","965","1911","0","50.5","18.32"
"68","000","00","004","0435","0935","923","350","573","42","965","1911","0","50.5","18.32"
"68","000","00","004","0436","0000","1522","568","954","59","1581","3479","0","45.44","16.33"
"68","000","00","004","0436","0944","613","243","370","17","630","1541","0","40.88","15.77"
"68","000","00","004","0436","0945","909","325","584","42","951","1938","0","49.07","16.77"
"68","000","00","004","0437","0000","1404","568","836","83","1487","2725","0","54.57","20.84"
"68","000","00","004","0437","0993","627","278","349","29","656","1234","0","53.16","22.53"
"68","000","00","004","0437","0994","777","290","487","54","831","1491","0","55.73","19.45"
"68","000","00","004","0438","0000","1344","540","804","66","1410","2926","0","48.19","18.46"
"68","000","00","004","0438","0978","503","202","301","38","541","1141","0","47.41","17.7"
"68","000","00","004","0438","0979","841","338","503","28","869","1785","0","48.68","18.94"
"68","000","00","004","0439","0000","995","370","625","38","1033","2324","0","44.45","15.92"
"68","000","00","004","0439","0955","995","370","625","38","1033","2324","0","44.45","15.92"
"68","000","00","004","0440","0000","1727","571","1156","60","1787","3323","0","53.78","17.18"
"68","000","00","004","0440","0948","854","281","573","38","892","1516","0","58.84","18.54"
"68","000","00","004","0440","0949","873","290","583","22","895","1807","0","49.53","16.05"
"68","000","00","004","0441","0000","1435","570","865","54","1489","2807","0","53.05","20.31"
"68","000","00","004","0441","0984","755","275","480","23","778","1273","0","61.12","21.6"
"68","000","00","004","0441","0985","680","295","385","31","711","1534","0","46.35","19.23"
"68","000","00","005","0000","0000","63313","28046","35267","2857","66170","129252","164057","51.19","21.7"
"68","000","00","005","0501","0000","1423","781","642","90","1513","2896","0","52.24","26.97"
"68","000","00","005","0501","0396","688","384","304","39","727","1358","0","53.53","28.28"
"68","000","00","005","0501","0397","735","397","338","51","786","1538","0","51.11","25.81"
"68","000","00","005","0502","0000","1759","845","914","91","1850","3791","0","48.8","22.29"
"68","000","00","005","0502","0398","857","398","459","48","905","2118","0","42.73","18.79"
"68","000","00","005","0502","0399","902","447","455","43","945","1673","0","56.49","26.72"
"68","000","00","005","0503","0000","2254","1055","1199","94","2348","4816","0","48.75","21.91"
"68","000","00","005","0503","0404","699","334","365","24","723","1446","0","50.0","23.1"
"68","000","00","005","0503","0405","732","380","352","42","774","1623","0","47.69","23.41"
"68","000","00","005","0503","0406","823","341","482","28","851","1747","0","48.71","19.52"
"68","000","00","005","0504","0000","2091","868","1223","103","2194","4687","0","46.81","18.52"
"68","000","00","005","0504","0411","1072","512","560","48","1120","2189","0","51.16","23.39"
"68","000","00","005","0504","0412","1019","356","663","55","1074","2498","0","42.99","14.25"
"68","000","00","005","0506","0000","1766","913","853","98","1864","4088","0","45.6","22.33"
"68","000","00","005","0506","0414","815","433","382","43","858","1991","0","43.09","21.75"
"68","000","00","005","0506","0415","951","480","471","55","1006","2097","0","47.97","22.89"
"68","000","00","005","0507","0000","1756","774","982","75","1831","3567","0","51.33","21.7"
"68","000","00","005","0507","0430","939","400","539","45","984","1864","0","52.79","21.46"
"68","000","00","005","0507","0431","817","374","443","30","847","1703","0","49.74","21.96"
"68","000","00","005","0508","0000","1919","853","1066","85","2004","3815","0","52.53","22.36"
"68","000","00","005","0508","0432","906","407","499","37","943","1893","0","49.82","21.5"
"68","000","00","005","0508","0433","1013","446","567","48","1061","1922","0","55.2","23.2"
"68","000","00","005","0509","0000","1263","533","730","50","1313","2380","0","55.17","22.39"
"68","000","00","005","0509","0440","676","307","369","27","703","1181","0","59.53","25.99"
"68","000","00","005","0509","0441","587","226","361","23","610","1199","0","50.88","18.85"
"68","000","00","005","0510","0000","1244","611","633","96","1340","2521","0","53.15","24.24"
"68","000","00","005","0510","0459","545","271","274","24","569","1318","0","43.17","20.56"
"68","000","00","005","0510","0460","699","340","359","72","771","1203","0","64.09","28.26"
"68","000","00","005","0511","0000","819","370","449","23","842","1771","0","47.54","20.89"
"68","000","00","005","0511","0461","819","370","449","23","842","1771","0","47.54","20.89"
"68","000","00","005","0512","0000","1631","797","834","139","1770","3595","0","49.24","22.17"
"68","000","00","005","0512","0462","804","389","415","76","880","1832","0","48.03","21.23"
"68","000","00","005","0512","0463","827","408","419","63","890","1763","0","50.48","23.14"
"68","000","00","005","0513","0000","665","344","321","17","682","1497","0","45.56","22.98"
"68","000","00","005","0513","0464","665","344","321","17","682","1497","0","45.56","22.98"
"68","000","00","005","0514","0000","906","480","426","86","992","1671","0","59.37","28.73"
"68","000","00","005","0514","0465","906","480","426","86","992","1671","0","59.37","28.73"
"68","000","00","005","0515","0000","1284","650","634","136","1420","2488","0","57.07","26.13"
"68","000","00","005","0515","0466","484","242","242","54","538","929","0","57.91","26.05"
"68","000","00","005","0515","0467","800","408","392","82","882","1559","0","56.57","26.17"
"68","000","00","005","0516","0000","1594","790","804","86","1680","2938","0","57.18","26.89"
"68","000","00","005","0516","0468","744","301","443","25","769","1497","0","51.37","20.11"
"68","000","00","005","0516","0469","850","489","361","61","911","1441","0","63.22","33.93"
"68","000","00","005","0517","0000","1534","685","849","56","1590","3161","0","50.3","21.67"
"68","000","00","005","0517","0428","744","346","398","29","773","1668","0","46.34","20.74"
"68","000","00","005","0517","0429","790","339","451","27","817","1493","0","54.72","22.71"
"68","000","00","005","0518","0000","2513","1236","1277","105","2618","5039","0","51.95","24.53"
"68","000","00","005","0518","0416","822","329","493","28","850","1558","0","54.56","21.12"
"68","000","00","005","0518","0417","956","602","354","39","995","1891","0","52.62","31.84"
"68","000","00","005","0518","0418","735","305","430","38","773","1590","0","48.62","19.18"
"68","000","00","005","0519","0000","1228","553","675","46","1274","2588","0","49.23","21.37"
"68","000","00","005","0519","0438","629","295","334","24","653","1232","0","53.0","23.94"
"68","000","00","005","0519","0439","599","258","341","22","621","1356","0","45.8","19.03"
"68","000","00","005","0520","0000","1538","678","860","73","1611","3150","0","51.14","21.52"
"68","000","00","005","0520","0436","822","321","501","33","855","1688","0","50.65","19.02"
"68","000","00","005","0520","0437","716","357","359","40","756","1462","0","51.71","24.42"
"68","000","00","005","0521","0000","699","335","364","34","733","1322","0","55.45","25.34"
"68","000","00","005","0521","0413","699","335","364","34","733","1322","0","55.45","25.34"
"68","000","00","005","0522","0000","1688","708","980","92","1780","3425","0","51.97","20.67"
"68","000","00","005","0522","0407","961","396","565","59","1020","1988","0","51.31","19.92"
"68","000","00","005","0522","0408","727","312","415","33","760","1437","0","52.89","21.71"
"68","000","00","005","0523","0000","1550","689","861","69","1619","2979","0","54.35","23.13"
"68","000","00","005","0523","0409","818","388","430","46","864","1532","0","56.4","25.33"
"68","000","00","005","0523","0410","732","301","431","23","755","1447","0","52.18","20.8"
"68","000","00","005","0524","0000","1640","674","966","82","1722","3172","0","54.29","21.25"
"68","000","00","005","0524","0457","845","371","474","28","873","1483","0","58.87","25.02"
"68","000","00","005","0524","0458","795","303","492","54","849","1689","0","50.27","17.94"
"68","000","00","005","0525","0000","2148","883","1265","60","2208","4595","0","48.05","19.22"
"68","000","00","005","0525","0453","1289","495","794","33","1322","2727","0","48.48","18.15"
"68","000","00","005","0525","0454","859","388","471","27","886","1868","0","47.43","20.77"
"68","000","00","005","0526","0000","2064","823","1241","69","2133","4233","0","50.39","19.44"
"68","000","00","005","0526","0446","993","410","583","42","1035","2055","0","50.36","19.95"
"68","000","00","005","0526","0447","1071","413","658","27","1098","2178","0","50.41","18.96"
"68","000","00","005","0527","0000","1704","705","999","66","1770","3551","0","49.85","19.85"
"68","000","00","005","0527","0425","810","365","445","34","844","1731","0","48.76","21.09"
"68","000","00","005","0527","0426","894","340","554","32","926","1820","0","50.88","18.68"
"68","000","00","005","0528","0000","2250","912","1338","84","2334","4926","0","47.38","18.51"
"68","000","00","005","0528","0419","1043","430","613","41","1084","2404","0","45.09","17.89"
"68","000","00","005","0528","0420","1207","482","725","43","1250","2522","0","49.56","19.11"
"68","000","00","005","0529","0000","1670","704","966","58","1728","3348","0","51.61","21.03"
"68","000","00","005","0529","0421","826","353","473","22","848","1633","0","51.93","21.62"
"68","000","00","005","0529","0422","844","351","493","36","880","1715","0","51.31","20.47"
"68","000","00","005","0530","0000","843","364","479","46","889","1633","0","54.44","22.29"
"68","000","00","005","0530","0427","843","364","479","46","889","1633","0","54.44","22.29"
"68","000","00","005","0531","0000","2835","1083","1752","104","2939","5379","0","54.64","20.13"
"68","000","00","005","0531","0449","888","331","557","28","916","1667","0","54.95","19.86"
"68","000","00","005","0531","0450","918","362","556","29","947","1745","0","54.27","20.74"
"68","000","00","005","0531","0451","1029","390","639","47","1076","1967","0","54.7","19.83"
"68","000","00","005","0532","0000","1886","748","1138","45","1931","3511","0","55.0","21.3"
"68","000","00","005","0532","0448","893","371","522","26","919","1709","0","53.77","21.71"
"68","000","00","005","0532","0452","993","377","616","19","1012","1802","0","56.16","20.92"
"68","000","00","005","0533","0000","1568","621","947","59","1627","3133","0","51.93","19.82"
"68","000","00","005","0533","0442","889","347","542","23","912","1710","0","53.33","20.29"
"68","000","00","005","0533","0443","679","274","405","36","715","1423","0","50.25","19.26"
"68","000","00","005","0534","0000","1640","705","935","56","1696","3161","0","53.65","22.3"
"68","000","00","005","0534","0444","788","370","418","27","815","1522","0","53.55","24.31"
"68","000","00","005","0534","0445","852","335","517","29","881","1639","0","53.75","20.44"
"68","000","00","005","0535","0000","1436","596","840","45","1481","2731","0","54.23","21.82"
"68","000","00","005","0535","0434","727","300","427","19","746","1393","0","53.55","21.54"
"68","000","00","005","0535","0435","709","296","413","26","735","1338","0","54.93","22.12"
"68","000","00","005","0536","0000","2116","874","1242","71","2187","4604","0","47.5","18.98"
"68","000","00","005","0536","0402","1104","438","666","44","1148","2250","0","51.02","19.47"
"68","000","00","005","0536","0403","1012","436","576","27","1039","2354","0","44.14","18.52"
"68","000","00","005","0537","0000","1663","716","947","55","1718","3199","0","53.7","22.38"
"68","000","00","005","0537","0400","789","336","453","20","809","1500","0","53.93","22.4"
"68","000","00","005","0537","0401","874","380","494","35","909","1699","0","53.5","22.37"
"68","000","00","005","0538","0000","1575","682","893","56","1631","3153","0","51.73","21.63"
"68","000","00","005","0538","0455","753","343","410","29","782","1537","0","50.88","22.32"
"68","000","00","005","0538","0456","822","339","483","27","849","1616","0","52.54","20.98"
"68","000","00","005","0539","0000","1956","873","1083","61","2017","4244","0","47.53","20.57"
"68","000","00","005","0539","0423","1004","458","546","31","1035","2215","0","46.73","20.68"
"68","000","00","005","0539","0424","952","415","537","30","982","2029","0","48.4","20.45"
"68","000","00","005","0540","0000","1195","535","660","96","1291","2494","0","51.76","21.45"
"68","000","00","005","0540","0470","702","299","403","55","757","1465","0","51.67","20.41"
"68","000","00","005","0540","0471","493","236","257","41","534","1029","0","51.9","22.93"
"68","000","00","006","0000","0000","35683","16658","19025","1665","37348","73900","90407","50.54","22.54"
"68","000","00","006","0601","0000","2908","1267","1641","149","3057","6145","0","49.75","20.62"
"68","000","00","006","0601","0472","667","286","381","45","712","1538","0","46.29","18.6"
"68","000","00","006","0601","0473","634","256","378","35","669","1616","0","41.4","15.84"
"68","000","00","006","0601","0474","777","359","418","37","814","1437","0","56.65","24.98"
"68","000","00","006","0601","0475","830","366","464","32","862","1554","0","55.47","23.55"
"68","000","00","006","0602","0000","3133","1502","1631","158","3291","6471","0","50.86","23.21"
"68","000","00","006","0602","0476","622","319","303","28","650","1237","0","52.55","25.79"
"68","000","00","006","0602","0477","654","291","363","43","697","1347","0","51.74","21.6"
"68","000","00","006","0602","0478","628","306","322","24","652","1261","0","51.7","24.27"
"68","000","00","006","0602","0479","606","281","325","34","640","1256","0","50.96","22.37"
"68","000","00","006","0602","0480","623","305","318","29","652","1370","0","47.59","22.26"
"68","000","00","006","0603","0000","2033","794","1239","102","2135","4617","0","46.24","17.2"
"68","000","00","006","0603","0481","704","197","507","44","748","1610","0","46.46","12.24"
"68","000","00","006","0603","0482","685","308","377","34","719","1419","0","50.67","21.71"
"68","000","00","006","0603","0483","644","289","355","24","668","1588","0","42.07","18.2"
"68","000","00","006","0604","0000","780","375","405","34","814","1612","0","50.5","23.26"
"68","000","00","006","0604","0484","780","375","405","34","814","1612","0","50.5","23.26"
"68","000","00","006","0605","0000","4999","2155","2844","225","5224","10011","0","52.18","21.53"
"68","000","00","006","0605","0485","682","298","384","35","717","1440","0","49.79","20.69"
"68","000","00","006","0605","0486","616","277","339","39","655","1326","0","49.4","20.89"
"68","000","00","006","0605","0487","773","307","466","52","825","1455","0","56.7","21.1"
"68","000","00","006","0605","0488","807","405","402","36","843","1562","0","53.97","25.93"
"68","000","00","006","0605","0489","705","289","416","29","734","1284","0","57.17","22.51"
"68","000","00","006","0605","0490","675","281","394","17","692","1454","0","47.59","19.33"
"68","000","00","006","0605","0491","741","298","443","17","758","1490","0","50.87","20.0"
"68","000","00","006","0606","0000","2329","1136","1193","135","2464","4861","0","50.69","23.37"
"68","000","00","006","0606","0492","767","377","390","28","795","1617","0","49.17","23.31"
"68","000","00","006","0606","0493","771","377","394","61","832","1594","0","52.2","23.65"
"68","000","00","006","0606","0494","791","382","409","46","837","1650","0","50.73","23.15"
"68","000","00","006","0607","0000","2956","1311","1645","118","3074","5896","0","52.14","22.24"
"68","000","00","006","0607","0495","692","331","361","16","708","1467","0","48.26","22.56"
"68","000","00","006","0607","0496","733","313","420","31","764","1494","0","51.14","20.95"
"68","000","00","006","0607","0497","843","349","494","44","887","1538","0","57.67","22.69"
"68","000","00","006","0607","0498","688","318","370","27","715","1397","0","51.18","22.76"
"68","000","00","006","0608","0000","788","337","451","22","810","1637","0","49.48","20.59"
"68","000","00","006","0608","0499","788","337","451","22","810","1637","0","49.48","20.59"
"68","000","00","006","0610","0000","1472","1098","374","83","1555","2866","0","54.26","38.31"
"68","000","00","006","0610","0500","667","320","347","34","701","1452","0","48.28","22.04"
"68","000","00","006","0610","0501","805","778","27","49","854","1414","0","60.4","55.02"
"68","000","00","006","0611","0000","3109","1464","1645","141","3250","6871","0","47.3","21.31"
"68","000","00","006","0611","0502","818","390","428","48","866","1670","0","51.86","23.35"
"68","000","00","006","0611","0503","770","364","406","26","796","1701","0","46.8","21.4"
"68","000","00","006","0611","0504","753","354","399","29","782","1813","0","43.13","19.53"
"68","000","00","006","0611","0505","768","356","412","38","806","1687","0","47.78","21.1"
"68","000","00","006","0612","0000","1679","744","935","59","1738","3206","0","54.21","23.21"
"68","000","00","006","0612","0506","838","339","499","17","855","1650","0","51.82","20.55"
"68","000","00","006","0612","0507","841","405","436","42","883","1556","0","56.75","26.03"
"68","000","00","006","0613","0000","802","358","444","22","824","1844","0","44.69","19.41"
"68","000","00","006","0613","0508","802","358","444","22","824","1844","0","44.69","19.41"
"68","000","00","006","0614","0000","1371","733","638","76","1447","2750","0","52.62","26.65"
"68","000","00","006","0614","0509","615","371","244","38","653","1336","0","48.88","27.77"
"68","000","00","006","0614","0510","756","362","394","38","794","1414","0","56.15","25.6"
"68","000","00","006","0615","0000","1425","641","784","78","1503","2465","0","60.97","26.0"
"68","000","00","006","0615","0511","717","322","395","39","756","1238","0","61.07","26.01"
"68","000","00","006","0615","0512","708","319","389","39","747","1227","0","60.88","26.0"
"68","000","00","006","0616","0000","1198","551","647","53","1251","2548","0","49.1","21.62"
"68","000","00","006","0616","0513","581","270","311","29","610","1199","0","50.88","22.52"
"68","000","00","006","0616","0514","617","281","336","24","641","1349","0","47.52","20.83"
"68","000","00","006","0617","0000","1125","543","582","45","1170","2200","0","53.18","24.68"
"68","000","00","006","0617","0515","567","270","297","21","588","1120","0","52.5","24.11"
"68","000","00","006","0617","0516","558","273","285","24","582","1080","0","53.89","25.28"
"68","000","00","006","0618","0000","1302","643","659","72","1374","2686","0","51.15","23.94"
"68","000","00","006","0618","0517","619","322","297","41","660","1341","0","49.22","24.01"
"68","000","00","006","0618","0518","683","321","362","31","714","1345","0","53.09","23.87"
"68","000","00","006","0619","0000","2274","1006","1268","93","2367","5214","0","45.4","19.29"
"68","000","00","006","0619","0519","690","321","369","31","721","1565","0","46.07","20.51"
"68","000","00","006","0619","0520","642","270","372","17","659","1519","0","43.38","17.77"
"68","000","00","006","0619","0521","942","415","527","45","987","2130","0","46.34","19.48"
"68","000","00","007","0000","0000","62604","28405","34199","2644","65248","131702","160182","49.54","21.57"
"68","000","00","007","0701","0000","1905","881","1024","69","1974","3735","0","52.85","23.59"
"68","000","00","007","0701","0270","723","338","385","26","749","1455","0","51.48","23.23"
"68","000","00","007","0701","0271","1182","543","639","43","1225","2280","0","53.73","23.82"
"68","000","00","007","0702","0000","3306","1486","1820","168","3474","6706","0","51.8","22.16"
"68","000","00","007","0702","0231","1083","447","636","50","1133","2178","0","52.02","20.52"
"68","000","00","007","0702","0232","857","439","418","49","906","1672","0","54.19","26.26"
"68","000","00","007","0702","0233","654","278","376","29","683","1376","0","49.64","20.2"
"68","000","00","007","0702","0234","712","322","390","40","752","1480","0","50.81","21.76"
"68","000","00","007","0703","0000","2049","1003","1046","111","2160","4353","0","49.62","23.04"
"68","000","00","007","0703","0261","447","227","220","13","460","841","0","54.7","26.99"
"68","000","00","007","0703","0262","1002","500","502","44","1046","2284","0","45.8","21.89"
"68","000","00","007","0703","0263","600","276","324","54","654","1228","0","53.26","22.48"
"68","000","00","007","0704","0000","2884","1285","1599","130","3014","5735","0","52.55","22.41"
"68","000","00","007","0704","0235","667","317","350","26","693","1258","0","55.09","25.2"
"68","000","00","007","0704","0236","732","310","422","31","763","1464","0","52.12","21.17"
"68","000","00","007","0704","0237","893","410","483","52","945","1844","0","51.25","22.23"
"68","000","00","007","0704","0238","592","248","344","21","613","1169","0","52.44","21.21"
"68","000","00","007","0705","0000","1645","691","954","70","1715","3253","0","52.72","21.24"
"68","000","00","007","0705","0245","962","402","560","37","999","1788","0","55.87","22.48"
"68","000","00","007","0705","0246","683","289","394","33","716","1465","0","48.87","19.73"
"68","000","00","007","0706","0000","2517","1125","1392","88","2605","5386","0","48.37","20.89"
"68","000","00","007","0706","0239","753","310","443","33","786","1921","0","40.92","16.14"
"68","000","00","007","0706","0240","807","373","434","23","830","1694","0","49.0","22.02"
"68","000","00","007","0706","0241","957","442","515","32","989","1771","0","55.84","24.96"
"68","000","00","007","0707","0000","1850","406","1444","120","1970","3629","0","54.28","11.19"
"68","000","00","007","0707","0220","886","167","719","60","946","1744","0","54.24","9.58"
"68","000","00","007","0707","0221","964","239","725","60","1024","1885","0","54.32","12.68"
"68","000","00","007","0708","0000","2469","920","1549","102","2571","5033","0","51.08","18.28"
"68","000","00","007","0708","0217","451","104","347","26","477","874","0","54.58","11.9"
"68","000","00","007","0708","0218","981","314","667","57","1038","2014","0","51.54","15.59"
"68","000","00","007","0708","0219","1037","502","535","19","1056","2145","0","49.23","23.4"
"68","000","00","007","0709","0000","600","293","307","28","628","1156","0","54.33","25.35"
"68","000","00","007","0709","0276","600","293","307","28","628","1156","0","54.33","25.35"
"68","000","00","007","0710","0000","1738","838","900","68","1806","3553","0","50.83","23.59"
"68","000","00","007","0710","0272","831","413","418","34","865","1668","0","51.86","24.76"
"68","000","00","007","0710","0273","907","425","482","34","941","1885","0","49.92","22.55"
"68","000","00","007","0711","0000","919","478","441","65","984","1840","0","53.48","25.98"
"68","000","00","007","0711","0289","919","478","441","65","984","1840","0","53.48","25.98"
"68","000","00","007","0712","0000","889","440","449","34","923","1917","0","48.15","22.95"
"68","000","00","007","0712","0267","889","440","449","34","923","1917","0","48.15","22.95"
"68","000","00","007","0713","0000","2143","981","1162","105","2248","4707","0","47.76","20.84"
"68","000","00","007","0713","0222","674","293","381","48","722","1546","0","46.7","18.95"
"68","000","00","007","0713","0223","787","375","412","45","832","1684","0","49.41","22.27"
"68","000","00","007","0713","0224","682","313","369","12","694","1477","0","46.99","21.19"
"68","000","00","007","0714","0000","2218","996","1222","120","2338","4832","0","48.39","20.61"
"68","000","00","007","0714","0242","749","319","430","40","789","1665","0","47.39","19.16"
"68","000","00","007","0714","0243","700","346","354","40","740","1439","0","51.42","24.04"
"68","000","00","007","0714","0244","769","331","438","40","809","1728","0","46.82","19.16"
"68","000","00","007","0715","0000","2852","1396","1456","139","2991","5448","0","54.9","25.62"
"68","000","00","007","0715","0227","796","392","404","42","838","1525","0","54.95","25.7"
"68","000","00","007","0715","0228","583","271","312","30","613","1041","0","58.89","26.03"
"68","000","00","007","0715","0229","694","353","341","28","722","1404","0","51.42","25.14"
"68","000","00","007","0715","0230","779","380","399","39","818","1478","0","55.35","25.71"
"68","000","00","007","0716","0000","1925","958","967","124","2049","3952","0","51.85","24.24"
"68","000","00","007","0716","0256","499","255","244","41","540","1005","0","53.73","25.37"
"68","000","00","007","0716","0257","743","351","392","33","776","1449","0","53.55","24.22"
"68","000","00","007","0716","0258","683","352","331","50","733","1498","0","48.93","23.5"
"68","000","00","007","0717","0000","872","506","366","36","908","1752","0","51.83","28.88"
"68","000","00","007","0717","0250","872","506","366","36","908","1752","0","51.83","28.88"
"68","000","00","007","0718","0000","1153","574","579","49","1202","2439","0","49.28","23.53"
"68","000","00","007","0718","0265","644","302","342","25","669","1378","0","48.55","21.92"
"68","000","00","007","0718","0266","509","272","237","24","533","1061","0","50.24","25.64"
"68","000","00","007","0719","0000","1686","811","875","85","1771","4057","0","43.65","19.99"
"68","000","00","007","0719","0277","853","403","450","54","907","2114","0","42.9","19.06"
"68","000","00","007","0719","0278","833","408","425","31","864","1943","0","44.47","21.0"
"68","000","00","007","0720","0000","2846","1299","1547","104","2950","6056","0","48.71","21.45"
"68","000","00","007","0720","0286","1063","491","572","44","1107","2187","0","50.62","22.45"
"68","000","00","007","0720","0287","924","418","506","33","957","1959","0","48.85","21.34"
"68","000","00","007","0720","0288","859","390","469","27","886","1910","0","46.39","20.42"
"68","000","00","007","0721","0000","1095","506","589","38","1133","2266","0","50.0","22.33"
"68","000","00","007","0721","0290","1095","506","589","38","1133","2266","0","50.0","22.33"
"68","000","00","007","0722","0000","1965","963","1002","95","2060","5170","0","39.85","18.63"
"68","000","00","007","0722","0247","563","281","282","39","602","1659","0","36.29","16.94"
"68","000","00","007","0722","0248","708","349","359","35","743","1693","0","43.89","20.61"
"68","000","00","007","0722","0249","694","333","361","21","715","1818","0","39.33","18.32"
"68","000","00","007","0723","0000","888","392","496","35","923","1979","0","46.64","19.81"
"68","000","00","007","0723","0264","888","392","496","35","923","1979","0","46.64","19.81"
"68","000","00","007","0724","0000","1656","845","811","35","1691","3317","0","50.98","25.47"
"68","000","00","007","0724","0251","928","479","449","13","941","1818","0","51.76","26.35"
"68","000","00","007","0724","0252","728","366","362","22","750","1499","0","50.03","24.42"
"68","000","00","007","0725","0000","2807","1313","1494","110","2917","5847","0","49.89","22.46"
"68","000","00","007","0725","0253","943","457","486","35","978","1916","0","51.04","23.85"
"68","000","00","007","0725","0254","876","389","487","37","913","1804","0","50.61","21.56"
"68","000","00","007","0725","0255","988","467","521","38","1026","2127","0","48.24","21.96"
"68","000","00","007","0726","0000","1595","781","814","63","1658","3920","0","42.3","19.92"
"68","000","00","007","0726","0259","913","435","478","43","956","2149","0","44.49","20.24"
"68","000","00","007","0726","0260","682","346","336","20","702","1771","0","39.64","19.54"
"68","000","00","007","0727","0000","2422","1051","1371","88","2510","5139","0","48.84","20.45"
"68","000","00","007","0727","0279","773","307","466","21","794","1800","0","44.11","17.06"
"68","000","00","007","0727","0280","948","418","530","38","986","2020","0","48.81","20.69"
"68","000","00","007","0727","0281","701","326","375","29","730","1319","0","55.34","24.72"
"68","000","00","007","0728","0000","4128","1904","2224","112","4240","8591","0","49.35","22.16"
"68","000","00","007","0728","0282","1145","546","599","40","1185","2229","0","53.16","24.5"
"68","000","00","007","0728","0283","953","413","540","18","971","1992","0","48.74","20.73"
"68","000","00","007","0728","0284","1017","488","529","37","1054","2237","0","47.12","21.81"
"68","000","00","007","0728","0285","1013","457","556","17","1030","2133","0","48.29","21.43"
"68","000","00","007","0729","0000","1812","934","878","44","1856","3553","0","52.24","26.29"
"68","000","00","007","0729","0274","878","469","409","29","907","1849","0","49.05","25.37"
"68","000","00","007","0729","0275","934","465","469","15","949","1704","0","55.69","27.29"
"68","000","00","007","0730","0000","1095","392","703","59","1154","2956","0","39.04","13.26"
"68","000","00","007","0730","0225","815","250","565","46","861","1528","0","56.35","16.36"
"68","000","00","007","0730","0226","280","142","138","13","293","1428","0","20.52","9.94"
"68","000","00","007","0731","0000","3038","1261","1777","98","3136","6452","0","48.61","19.54"
"68","000","00","007","0731","0291","1048","411","637","36","1084","2387","0","45.41","17.22"
"68","000","00","007","0731","0292","770","333","437","21","791","1692","0","46.75","19.68"
"68","000","00","007","0731","0293","459","218","241","15","474","904","0","52.43","24.12"
"68","000","00","007","0731","0294","761","299","462","26","787","1469","0","53.57","20.35"
"68","000","00","007","0732","0000","1637","696","941","52","1689","2973","0","56.81","23.41"
"68","000","00","007","0732","0268","881","374","507","22","903","1540","0","58.64","24.29"
"68","000","00","007","0732","0269","756","322","434","30","786","1433","0","54.85","22.47"
"68","000","00","008","0000","0000","80028","33762","46266","3903","83931","165065","201493","50.85","20.45"
"68","000","00","008","0801","0000","2792","1120","1672","121","2913","7162","0","40.67","15.64"
"68","000","00","008","0801","0295","799","387","412","39","838","1761","0","47.59","21.98"
"68","000","00","008","0801","0296","715","314","401","21","736","1804","0","40.8","17.41"
"68","000","00","008","0801","0297","486","214","272","28","514","1813","0","28.35","11.8"
"68","000","00","008","0801","0298","792","205","587","33","825","1784","0","46.24","11.49"
"68","000","00","008","0802","0000","3577","1532","2045","148","3725","8278","0","45.0","18.51"
"68","000","00","008","0802","0299","901","332","569","35","936","2257","0","41.47","14.71"
"68","000","00","008","0802","0300","797","373","424","23","820","1857","0","44.16","20.09"
"68","000","00","008","0802","0301","936","414","522","42","978","2261","0","43.26","18.31"
"68","000","00","008","0802","0302","943","413","530","48","991","1903","0","52.08","21.7"
"68","000","00","008","0803","0000","1640","675","965","72","1712","3620","0","47.29","18.65"
"68","000","00","008","0803","0303","923","357","566","57","980","1955","0","50.13","18.26"
"68","000","00","008","0803","0304","717","318","399","15","732","1665","0","43.96","19.1"
"68","000","00","008","0804","0000","1628","635","993","83","1711","3216","0","53.2","19.75"
"68","000","00","008","0804","0310","852","365","487","54","906","1630","0","55.58","22.39"
"68","000","00","008","0804","0311","776","270","506","29","805","1586","0","50.76","17.02"
"68","000","00","008","0805","0000","1660","619","1041","112","1772","3559","0","49.79","17.39"
"68","000","00","008","0805","0312","821","316","505","51","872","1649","0","52.88","19.16"
"68","000","00","008","0805","0313","839","303","536","61","900","1910","0","47.12","15.86"
"68","000","00","008","0806","0000","1656","566","1090","98","1754","3252","0","53.94","17.4"
"68","000","00","008","0806","0314","839","305","534","61","900","1612","0","55.83","18.92"
"68","000","00","008","0806","0315","817","261","556","37","854","1640","0","52.07","15.91"
"68","000","00","008","0807","0000","1645","771","874","76","1721","3273","0","52.58","23.56"
"68","000","00","008","0807","0318","836","408","428","41","877","1711","0","51.26","23.85"
"68","000","00","008","0807","0319","809","363","446","35","844","1562","0","54.03","23.24"
"68","000","00","008","0808","0000","2261","909","1352","116","2377","4415","0","53.84","20.59"
"68","000","00","008","0808","0320","869","302","567","42","911","1735","0","52.51","17.41"
"68","000","00","008","0808","0321","820","343","477","31","851","1658","0","51.33","20.69"
"68","000","00","008","0808","0322","572","264","308","43","615","1022","0","60.18","25.83"
"68","000","00","008","0809","0000","1575","626","949","75","1650","3414","0","48.33","18.34"
"68","000","00","008","0809","0323","747","307","440","40","787","1673","0","47.04","18.35"
"68","000","00","008","0809","0324","828","319","509","35","863","1741","0","49.57","18.32"
"68","000","00","008","0810","0000","1022","437","585","47","1069","2110","0","50.66","20.71"
"68","000","00","008","0810","0325","1022","437","585","47","1069","2110","0","50.66","20.71"
"68","000","00","008","0811","0000","1372","648","724","76","1448","2519","0","57.48","25.72"
"68","000","00","008","0811","0331","736","344","392","31","767","1341","0","57.2","25.65"
"68","000","00","008","0811","0332","636","304","332","45","681","1178","0","57.81","25.81"
"68","000","00","008","0812","0000","1570","729","841","82","1652","3871","0","42.68","18.83"
"68","000","00","008","0812","0335","849","387","462","38","887","1943","0","45.65","19.92"
"68","000","00","008","0812","0336","721","342","379","44","765","1928","0","39.68","17.74"
"68","000","00","008","0813","0000","1503","659","844","80","1583","3147","0","50.3","20.94"
"68","000","00","008","0813","0339","889","399","490","36","925","1947","0","47.51","20.49"
"68","000","00","008","0813","0340","614","260","354","44","658","1200","0","54.83","21.67"
"68","000","00","008","0814","0000","1840","957","883","84","1924","3883","0","49.55","24.65"
"68","000","00","008","0814","0341","961","546","415","41","1002","1895","0","52.88","28.81"
"68","000","00","008","0814","0342","879","411","468","43","922","1988","0","46.38","20.67"
"68","000","00","008","0815","0000","1807","878","929","82","1889","3410","0","55.4","25.75"
"68","000","00","008","0815","0348","683","345","338","39","722","1317","0","54.82","26.2"
"68","000","00","008","0815","0349","1124","533","591","43","1167","2093","0","55.76","25.47"
"68","000","00","008","0816","0000","1733","720","1013","64","1797","3545","0","50.69","20.31"
"68","000","00","008","0816","0351","868","357","511","40","908","1782","0","50.95","20.03"
"68","000","00","008","0816","0352","865","363","502","24","889","1763","0","50.43","20.59"
"68","000","00","008","0817","0000","3324","1258","2066","141","3465","6933","0","49.98","18.15"
"68","000","00","008","0817","0359","982","412","570","46","1028","1998","0","51.45","20.62"
"68","000","00","008","0817","0360","501","217","284","19","520","916","0","56.77","23.69"
"68","000","00","008","0817","0361","881","308","573","46","927","1943","0","47.71","15.85"
"68","000","00","008","0817","0362","960","321","639","30","990","2076","0","47.69","15.46"
"68","000","00","008","0818","0000","811","340","471","31","842","1505","0","55.95","22.59"
"68","000","00","008","0818","0371","811","340","471","31","842","1505","0","55.95","22.59"
"68","000","00","008","0819","0000","1664","737","927","85","1749","3303","0","52.95","22.31"
"68","000","00","008","0819","0373","849","400","449","42","891","1618","0","55.07","24.72"
"68","000","00","008","0819","0374","815","337","478","43","858","1685","0","50.92","20.0"
"68","000","00","008","0820","0000","1718","679","1039","85","1803","3716","0","48.52","18.27"
"68","000","00","008","0820","0375","817","299","518","37","854","1835","0","46.54","16.29"
"68","000","00","008","0820","0376","901","380","521","48","949","1881","0","50.45","20.2"
"68","000","00","008","0821","0000","838","320","518","33","871","1766","0","49.32","18.12"
"68","000","00","008","0821","0377","838","320","518","33","871","1766","0","49.32","18.12"
"68","000","00","008","0822","0000","2942","1171","1771","122","3064","5083","0","60.28","23.04"
"68","000","00","008","0822","0385","932","355","577","46","978","1685","0","58.04","21.07"
"68","000","00","008","0822","0386","910","420","490","36","946","1748","0","54.12","24.03"
"68","000","00","008","0822","0387","1100","396","704","40","1140","1650","0","69.09","24.0"
"68","000","00","008","0823","0000","1999","901","1098","102","2101","3923","0","53.56","22.97"
"68","000","00","008","0823","0390","975","446","529","48","1023","1841","0","55.57","24.23"
"68","000","00","008","0823","0391","1024","455","569","54","1078","2082","0","51.78","21.85"
"68","000","00","008","0824","0000","1575","710","865","100","1675","3578","0","46.81","19.84"
"68","000","00","008","0824","0365","717","347","370","46","763","1474","0","51.76","23.54"
"68","000","00","008","0824","0366","162","41","121","15","177","718","0","24.65","5.71"
"68","000","00","008","0824","0367","696","322","374","39","735","1386","0","53.03","23.23"
"68","000","00","008","0825","0000","1315","535","780","78","1393","2483","0","56.1","21.55"
"68","000","00","008","0825","0355","622","285","337","46","668","1170","0","57.09","24.36"
"68","000","00","008","0825","0356","693","250","443","32","725","1313","0","55.22","19.04"
"68","000","00","008","0826","0000","1849","881","968","56","1905","4169","0","45.69","21.13"
"68","000","00","008","0826","0344","919","442","477","9","928","2061","0","45.03","21.45"
"68","000","00","008","0826","0345","930","439","491","47","977","2108","0","46.35","20.83"
"68","000","00","008","0827","0000","1992","716","1276","72","2064","4015","0","51.41","17.83"
"68","000","00","008","0827","0378","886","333","553","46","932","1817","0","51.29","18.33"
"68","000","00","008","0827","0379","1106","383","723","26","1132","2198","0","51.5","17.42"
"68","000","00","008","0828","0000","2275","1075","1200","103","2378","4185","0","56.82","25.69"
"68","000","00","008","0828","0307","924","482","442","45","969","1583","0","61.21","30.45"
"68","000","00","008","0828","0308","662","317","345","22","684","1246","0","54.9","25.44"
"68","000","00","008","0828","0309","689","276","413","36","725","1356","0","53.47","20.35"
"68","000","00","008","0829","0000","1414","593","821","104","1518","2854","0","53.19","20.78"
"68","000","00","008","0829","0363","690","299","391","41","731","1363","0","53.63","21.94"
"68","000","00","008","0829","0364","724","294","430","63","787","1491","0","52.78","19.72"
"68","000","00","008","0830","0000","2060","862","1198","85","2145","3951","0","54.29","21.82"
"68","000","00","008","0830","0382","673","295","378","31","704","1257","0","56.01","23.47"
"68","000","00","008","0830","0383","622","262","360","39","661","1267","0","52.17","20.68"
"68","000","00","008","0830","0384","765","305","460","15","780","1427","0","54.66","21.37"
"68","000","00","008","0831","0000","1586","681","905","92","1678","3085","0","54.39","22.07"
"68","000","00","008","0831","0388","762","359","403","45","807","1478","0","54.6","24.29"
"68","000","00","008","0831","0389","824","322","502","47","871","1607","0","54.2","20.04"
"68","000","00","008","0832","0000","992","485","507","58","1050","2006","0","52.34","24.18"
"68","000","00","008","0832","0343","992","485","507","58","1050","2006","0","52.34","24.18"
"68","000","00","008","0833","0000","1675","725","950","68","1743","3543","0","49.2","20.46"
"68","000","00","008","0833","0346","855","354","501","42","897","1862","0","48.17","19.01"
"68","000","00","008","0833","0347","820","371","449","26","846","1681","0","50.33","22.07"
"68","000","00","008","0834","0000","815","409","406","40","855","1499","0","57.04","27.28"
"68","000","00","008","0834","0350","815","409","406","40","855","1499","0","57.04","27.28"
"68","000","00","008","0835","0000","663","309","354","42","705","1436","0","49.09","21.52"
"68","000","00","008","0835","0372","663","309","354","42","705","1436","0","49.09","21.52"
"68","000","00","008","0836","0000","1096","491","605","48","1144","2209","0","51.79","22.23"
"68","000","00","008","0836","0393","1096","491","605","48","1144","2209","0","51.79","22.23"
"68","000","00","008","0837","0000","881","380","501","33","914","1959","0","46.66","19.4"
"68","000","00","008","0837","0392","881","380","501","33","914","1959","0","46.66","19.4"
"68","000","00","008","0838","0000","2082","892","1190","76","2158","4531","0","47.63","19.69"
"68","000","00","008","0838","0328","806","334","472","19","825","1848","0","44.64","18.07"
"68","000","00","008","0838","0329","698","306","392","36","734","1334","0","55.02","22.94"
"68","000","00","008","0838","0330","578","252","326","21","599","1349","0","44.4","18.68"
"68","000","00","008","0839","0000","1444","649","795","59","1503","3075","0","48.88","21.11"
"68","000","00","008","0839","0337","677","300","377","24","701","1403","0","49.96","21.38"
"68","000","00","008","0839","0338","767","349","418","35","802","1672","0","47.97","20.87"
"68","000","00","008","0840","0000","1413","695","718","72","1485","2694","0","55.12","25.8"
"68","000","00","008","0840","0305","742","390","352","38","780","1431","0","54.51","27.25"
"68","000","00","008","0840","0306","671","305","366","34","705","1263","0","55.82","24.15"
"68","000","00","008","0841","0000","1317","554","763","74","1391","2537","0","54.83","21.84"
"68","000","00","008","0841","0353","624","263","361","43","667","1226","0","54.4","21.45"
"68","000","00","008","0841","0354","693","291","402","31","724","1311","0","55.23","22.2"
"68","000","00","008","0842","0000","1826","754","1072","65","1891","3821","0","49.49","19.73"
"68","000","00","008","0842","0380","872","353","519","35","907","1732","0","52.37","20.38"
"68","000","00","008","0842","0381","954","401","553","30","984","2089","0","47.1","19.2"
"68","000","00","008","0843","0000","1868","696","1172","84","1952","3864","0","50.52","18.01"
"68","000","00","008","0843","0394","937","336","601","39","976","1864","0","52.36","18.03"
"68","000","00","008","0843","0395","931","360","571","45","976","2000","0","48.8","18.0"
"68","000","00","008","0844","0000","1428","662","766","65","1493","2716","0","54.97","24.37"
"68","000","00","008","0844","0316","650","324","326","32","682","1303","0","52.34","24.87"
"68","000","00","008","0844","0317","778","338","440","33","811","1413","0","57.4","23.92"
"68","000","00","008","0845","0000","1157","356","801","70","1227","2155","0","56.94","16.52"
"68","000","00","008","0845","0326","581","179","402","35","616","1145","0","53.8","15.63"
"68","000","00","008","0845","0327","576","177","399","35","611","1010","0","60.5","17.52"
"68","000","00","008","0846","0000","2000","562","1438","199","2199","4294","0","51.21","13.09"
"68","000","00","008","0846","0368","699","202","497","70","769","1487","0","51.71","13.58"
"68","000","00","008","0846","0369","742","188","554","71","813","1552","0","52.38","12.11"
"68","000","00","008","0846","0370","559","172","387","58","617","1255","0","49.16","13.71"
"68","000","00","008","0847","0000","1410","606","804","88","1498","2836","0","52.82","21.37"
"68","000","00","008","0847","0333","719","312","407","32","751","1374","0","54.66","22.71"
"68","000","00","008","0847","0334","691","294","397","56","747","1462","0","51.09","20.11"
"68","000","00","008","0848","0000","1318","597","721","57","1375","2667","0","51.56","22.38"
"68","000","00","008","0848","0357","624","250","374","26","650","1186","0","54.81","21.08"
"68","000","00","008","0848","0358","694","347","347","31","725","1481","0","48.95","23.43"
"68","000","00","009","0000","0000","52240","19021","33219","2425","54665","101574","122981","53.82","18.73"
"68","000","00","009","0901","0000","2245","942","1303","108","2353","4513","0","52.14","20.87"
"68","000","00","009","0901","1008","732","284","448","37","769","1482","0","51.89","19.16"
"68","000","00","009","0901","1009","742","336","406","34","776","1528","0","50.79","21.99"
"68","000","00","009","0901","1010","771","322","449","37","808","1503","0","53.76","21.42"
"68","000","00","009","0902","0000","2854","1027","1827","144","2998","5661","0","52.96","18.14"
"68","000","00","009","0902","1013","891","244","647","58","949","2088","0","45.45","11.69"
"68","000","00","009","0902","1014","1058","390","668","58","1116","1987","0","56.17","19.63"
"68","000","00","009","0902","1015","905","393","512","28","933","1586","0","58.83","24.78"
"68","000","00","009","0903","0000","1834","704","1130","92","1926","4006","0","48.08","17.57"
"68","000","00","009","0903","1018","953","360","593","55","1008","2081","0","48.44","17.3"
"68","000","00","009","0903","1019","881","344","537","37","918","1925","0","47.69","17.87"
"68","000","00","009","0904","0000","1560","599","961","43","1603","3188","0","50.28","18.79"
"68","000","00","009","0904","1064","816","301","515","23","839","1649","0","50.88","18.25"
"68","000","00","009","0904","1065","744","298","446","20","764","1539","0","49.64","19.36"
"68","000","00","009","0906","0000","1787","742","1045","115","1902","3662","0","51.94","20.26"
"68","000","00","009","0906","1022","844","362","482","40","884","1790","0","49.39","20.22"
"68","000","00","009","0906","1023","943","380","563","75","1018","1872","0","54.38","20.3"
"68","000","00","009","0907","0000","2134","877","1257","91","2225","4152","0","53.59","21.12"
"68","000","00","009","0907","1026","742","297","445","30","772","1398","0","55.22","21.24"
"68","000","00","009","0907","1027","658","272","386","27","685","1345","0","50.93","20.22"
"68","000","00","009","0907","1028","734","308","426","34","768","1409","0","54.51","21.86"
"68","000","00","009","0908","0000","330","182","148","15","345","678","0","50.88","26.84"
"68","000","00","009","0908","1071","330","182","148","15","345","678","0","50.88","26.84"
"68","000","00","009","0909","0000","2196","890","1306","90","2286","4282","0","53.39","20.78"
"68","000","00","009","0909","1031","801","343","458","29","830","1597","0","51.97","21.48"
"68","000","00","009","0909","1032","721","268","453","23","744","1410","0","52.77","19.01"
"68","000","00","009","0909","1033","674","279","395","38","712","1275","0","55.84","21.88"
"68","000","00","009","0910","0000","2927","966","1961","103","3030","5372","0","56.4","17.98"
"68","000","00","009","0910","1037","982","339","643","35","1017","1786","0","56.94","18.98"
"68","000","00","009","0910","1038","955","320","635","42","997","1756","0","56.78","18.22"
"68","000","00","009","0910","1039","990","307","683","26","1016","1830","0","55.52","16.78"
"68","000","00","009","0911","0000","1050","404","646","68","1118","1909","0","58.56","21.16"
"68","000","00","009","0911","1034","1050","404","646","68","1118","1909","0","58.56","21.16"
"68","000","00","009","0912","0000","2321","961","1360","100","2421","4369","0","55.41","22.0"
"68","000","00","009","0912","1066","849","351","498","35","884","1541","0","57.37","22.78"
"68","000","00","009","0912","1067","715","319","396","38","753","1375","0","54.76","23.2"
"68","000","00","009","0912","1068","757","291","466","27","784","1453","0","53.96","20.03"
"68","000","00","009","0913","0000","1651","667","984","64","1715","3597","0","47.68","18.54"
"68","000","00","009","0913","1042","865","308","557","42","907","1805","0","50.25","17.06"
"68","000","00","009","0913","1043","786","359","427","22","808","1792","0","45.09","20.03"
"68","000","00","009","0914","0000","2062","751","1311","102","2164","4268","0","50.7","17.6"
"68","000","00","009","0914","1049","641","227","414","51","692","1297","0","53.35","17.5"
"68","000","00","009","0914","1050","684","225","459","16","700","1407","0","49.75","15.99"
"68","000","00","009","0914","1051","737","299","438","35","772","1564","0","49.36","19.12"
"68","000","00","009","0915","0000","1826","541","1285","94","1920","3485","0","55.09","15.52"
"68","000","00","009","0915","1054","902","292","610","43","945","1721","0","54.91","16.97"
"68","000","00","009","0915","1055","924","249","675","51","975","1764","0","55.27","14.12"
"68","000","00","009","0916","0000","1321","478","843","58","1379","2373","0","58.11","20.14"
"68","000","00","009","0916","1069","574","242","332","38","612","1074","0","56.98","22.53"
"68","000","00","009","0916","1070","747","236","511","20","767","1299","0","59.05","18.17"
"68","000","00","009","0917","0000","777","307","470","54","831","1499","0","55.44","20.48"
"68","000","00","009","0917","1056","777","307","470","54","831","1499","0","55.44","20.48"
"68","000","00","009","0918","0000","992","370","622","38","1030","2151","0","47.88","17.2"
"68","000","00","009","0918","1057","992","370","622","38","1030","2151","0","47.88","17.2"
"68","000","00","009","0919","0000","1691","513","1178","53","1744","2980","0","58.52","17.21"
"68","000","00","009","0919","1058","839","252","587","28","867","1524","0","56.89","16.54"
"68","000","00","009","0919","1059","852","261","591","25","877","1456","0","60.23","17.93"
"68","000","00","009","0920","0000","1334","507","827","91","1425","2784","0","51.19","18.21"
"68","000","00","009","0920","1011","751","264","487","43","794","1568","0","50.64","16.84"
"68","000","00","009","0920","1012","583","243","340","48","631","1216","0","51.89","19.98"
"68","000","00","009","0921","0000","1186","483","703","90","1276","2355","0","54.18","20.51"
"68","000","00","009","0921","1016","578","260","318","47","625","1221","0","51.19","21.29"
"68","000","00","009","0921","1017","608","223","385","43","651","1134","0","57.41","19.66"
"68","000","00","009","0922","0000","2220","618","1602","73","2293","4135","0","55.45","14.95"
"68","000","00","009","0922","1020","1098","297","801","34","1132","2095","0","54.03","14.18"
"68","000","00","009","0922","1021","1122","321","801","39","1161","2040","0","56.91","15.74"
"68","000","00","009","0923","0000","1849","721","1128","106","1955","3518","0","55.57","20.49"
"68","000","00","009","0923","1024","931","356","575","45","976","1726","0","56.55","20.63"
"68","000","00","009","0923","1025","918","365","553","61","979","1792","0","54.63","20.37"
"68","000","00","009","0924","0000","1550","678","872","63","1613","3012","0","53.55","22.51"
"68","000","00","009","0924","1029","653","286","367","24","677","1362","0","49.71","21.0"
"68","000","00","009","0924","1030","897","392","505","39","936","1650","0","56.73","23.76"
"68","000","00","009","0925","0000","2117","698","1419","73","2190","4026","0","54.4","17.34"
"68","000","00","009","0925","1035","1070","342","728","38","1108","2024","0","54.74","16.9"
"68","000","00","009","0925","1036","1047","356","691","35","1082","2002","0","54.05","17.78"
"68","000","00","009","0926","0000","1789","585","1204","64","1853","3216","0","57.62","18.19"
"68","000","00","009","0926","1040","976","359","617","26","1002","1697","0","59.05","21.15"
"68","000","00","009","0926","1041","813","226","587","38","851","1519","0","56.02","14.88"
"68","000","00","009","0927","0000","811","265","546","50","861","1500","0","57.4","17.67"
"68","000","00","009","0927","1044","811","265","546","50","861","1500","0","57.4","17.67"
"68","000","00","009","0928","0000","1942","650","1292","123","2065","3980","0","51.88","16.33"
"68","000","00","009","0928","1046","616","193","423","42","658","1444","0","45.57","13.37"
"68","000","00","009","0928","1047","622","193","429","50","672","1321","0","50.87","14.61"
"68","000","00","009","0928","1048","704","264","440","31","735","1215","0","60.49","21.73"
"68","000","00","009","0929","0000","1128","414","714","80","1208","2340","0","51.62","17.69"
"68","000","00","009","0929","1052","648","243","405","52","700","1317","0","53.15","18.45"
"68","000","00","009","0929","1053","480","171","309","28","508","1023","0","49.66","16.72"
"68","000","00","009","0930","0000","2195","566","1629","70","2265","3746","0","60.46","15.11"
"68","000","00","009","0930","1060","1071","268","803","42","1113","1847","0","60.26","14.51"
"68","000","00","009","0930","1061","1124","298","826","28","1152","1899","0","60.66","15.69"
"68","000","00","009","0931","0000","1877","622","1255","83","1960","3390","0","57.82","18.35"
"68","000","00","009","0931","1062","917","308","609","28","945","1725","0","54.78","17.86"
"68","000","00","009","0931","1063","960","314","646","55","1015","1665","0","60.96","18.86"
"68","000","00","009","0932","0000","684","293","391","27","711","1427","0","49.82","20.53"
"68","000","00","009","0932","1045","684","293","391","27","711","1427","0","49.82","20.53"
"68","000","00","010","0000","0000","94192","36737","57455","3912","98104","183560","225897","53.45","20.01"
"68","000","00","010","1001","0000","2363","942","1421","95","2458","4781","0","51.41","19.7"
"68","000","00","010","1001","0864","812","310","502","28","840","1717","0","48.92","18.05"
"68","000","00","010","1001","0865","696","290","406","25","721","1319","0","54.66","21.99"
"68","000","00","010","1001","0866","855","342","513","42","897","1745","0","51.4","19.6"
"68","000","00","010","1002","0000","2321","962","1359","92","2413","4129","0","58.44","23.3"
"68","000","00","010","1002","0867","914","387","527","38","952","1721","0","55.32","22.49"
"68","000","00","010","1002","0868","645","247","398","29","674","1206","0","55.89","20.48"
"68","000","00","010","1002","0869","762","328","434","25","787","1202","0","65.47","27.29"
"68","000","00","010","1003","0000","2891","1456","1435","77","2968","5256","0","56.47","27.7"
"68","000","00","010","1003","0850","645","610","35","24","669","1044","0","64.08","58.43"
"68","000","00","010","1003","0851","618","219","399","15","633","1124","0","56.32","19.48"
"68","000","00","010","1003","0852","816","338","478","17","833","1517","0","54.91","22.28"
"68","000","00","010","1003","0853","812","289","523","21","833","1571","0","53.02","18.4"
"68","000","00","010","1004","0000","2935","1189","1746","130","3065","5442","0","56.32","21.85"
"68","000","00","010","1004","0840","687","296","391","44","731","1307","0","55.93","22.65"
"68","000","00","010","1004","0841","728","303","425","27","755","1337","0","56.47","22.66"
"68","000","00","010","1004","0842","615","234","381","28","643","980","0","65.61","23.88"
"68","000","00","010","1004","0843","905","356","549","31","936","1818","0","51.49","19.58"
"68","000","00","010","1005","0000","2585","908","1677","72","2657","5083","0","52.27","17.86"
"68","000","00","010","1005","0857","853","261","592","23","876","1555","0","56.33","16.78"
"68","000","00","010","1005","0858","967","358","609","27","994","2051","0","48.46","17.45"
"68","000","00","010","1005","0859","765","289","476","22","787","1477","0","53.28","19.57"
"68","000","00","010","1006","0000","1859","696","1163","85","1944","3895","0","49.91","17.87"
"68","000","00","010","1006","0835","961","379","582","56","1017","1901","0","53.5","19.94"
"68","000","00","010","1006","0836","898","317","581","29","927","1994","0","46.49","15.9"
"68","000","00","010","1007","0000","2024","826","1198","76","2100","3585","0","58.58","23.04"
"68","000","00","010","1007","0875","557","246","311","31","588","1010","0","58.22","24.36"
"68","000","00","010","1007","0876","713","300","413","20","733","1261","0","58.13","23.79"
"68","000","00","010","1007","0877","754","280","474","25","779","1314","0","59.28","21.31"
"68","000","00","010","1008","0000","2933","1096","1837","122","3055","6426","0","47.54","17.06"
"68","000","00","010","1008","0883","628","260","368","26","654","2213","0","29.55","11.75"
"68","000","00","010","1008","0884","571","222","349","20","591","949","0","62.28","23.39"
"68","000","00","010","1008","0885","923","326","597","46","969","1621","0","59.78","20.11"
"68","000","00","010","1008","0886","811","288","523","30","841","1643","0","51.19","17.53"
"68","000","00","010","1009","0000","1426","707","719","52","1478","2475","0","59.72","28.57"
"68","000","00","010","1009","0870","678","261","417","28","706","1208","0","58.44","21.61"
"68","000","00","010","1009","0871","748","446","302","24","772","1267","0","60.93","35.2"
"68","000","00","010","1010","0000","2162","908","1254","105","2267","3993","0","56.77","22.74"
"68","000","00","010","1010","0891","579","267","312","35","614","1039","0","59.1","25.7"
"68","000","00","010","1010","0892","744","303","441","35","779","1318","0","59.1","22.99"
"68","000","00","010","1010","0893","839","338","501","35","874","1636","0","53.42","20.66"
"68","000","00","010","1011","0000","2037","813","1224","88","2125","4038","0","52.63","20.13"
"68","000","00","010","1011","0896","688","269","419","32","720","1480","0","48.65","18.18"
"68","000","00","010","1011","0897","696","298","398","26","722","1330","0","54.29","22.41"
"68","000","00","010","1011","0898","653","246","407","30","683","1228","0","55.62","20.03"
"68","000","00","010","1012","0000","2212","871","1341","103","2315","4431","0","52.25","19.66"
"68","000","00","010","1012","0801","700","305","395","32","732","1487","0","49.23","20.51"
"68","000","00","010","1012","0802","727","271","456","43","770","1453","0","52.99","18.65"
"68","000","00","010","1012","0803","785","295","490","28","813","1491","0","54.53","19.79"
"68","000","00","010","1013","0000","2806","1015","1791","121","2927","5762","0","50.8","17.62"
"68","000","00","010","1013","0806","878","312","566","45","923","1921","0","48.05","16.24"
"68","000","00","010","1013","0807","1027","354","673","42","1069","1974","0","54.15","17.93"
"68","000","00","010","1013","0808","901","349","552","34","935","1867","0","50.08","18.69"
"68","000","00","010","1014","0000","2362","822","1540","128","2490","4440","0","56.08","18.51"
"68","000","00","010","1014","0827","529","190","339","37","566","1048","0","54.01","18.13"
"68","000","00","010","1014","0828","670","220","450","40","710","1259","0","56.39","17.47"
"68","000","00","010","1014","0829","547","189","358","24","571","1061","0","53.82","17.81"
"68","000","00","010","1014","0830","616","223","393","27","643","1072","0","59.98","20.8"
"68","000","00","010","1015","0000","1166","445","721","50","1216","2326","0","52.28","19.13"
"68","000","00","010","1015","0820","556","227","329","14","570","1130","0","50.44","20.09"
"68","000","00","010","1015","0821","610","218","392","36","646","1196","0","54.01","18.23"
"68","000","00","010","1016","0000","2472","904","1568","91","2563","5300","0","48.36","17.06"
"68","000","00","010","1016","0824","791","337","454","38","829","1564","0","53.01","21.55"
"68","000","00","010","1016","0825","752","259","493","31","783","1824","0","42.93","14.2"
"68","000","00","010","1016","0826","929","308","621","22","951","1912","0","49.74","16.11"
"68","000","00","010","1017","0000","1399","508","891","95","1494","2780","0","53.74","18.27"
"68","000","00","010","1017","0917","690","254","436","61","751","1385","0","54.22","18.34"
"68","000","00","010","1017","0918","709","254","455","34","743","1395","0","53.26","18.21"
"68","000","00","010","1018","0000","1642","534","1108","62","1704","3342","0","50.99","15.98"
"68","000","00","010","1018","0919","844","273","571","25","869","1711","0","50.79","15.96"
"68","000","00","010","1018","0920","798","261","537","37","835","1631","0","51.2","16.0"
"68","000","00","010","1019","0000","1316","424","892","89","1405","2541","0","55.29","16.69"
"68","000","00","010","1019","0923","582","208","374","44","626","1127","0","55.55","18.46"
"68","000","00","010","1019","0924","734","216","518","45","779","1414","0","55.09","15.28"
"68","000","00","010","1020","0000","1023","323","700","39","1062","1931","0","55.0","16.73"
"68","000","00","010","1020","0922","1023","323","700","39","1062","1931","0","55.0","16.73"
"68","000","00","010","1021","0000","595","168","427","20","615","1110","0","55.41","15.14"
"68","000","00","010","1021","0921","595","168","427","20","615","1110","0","55.41","15.14"
"68","000","00","010","1022","0000","799","263","536","55","854","1609","0","53.08","16.35"
"68","000","00","010","1022","0925","799","263","536","55","854","1609","0","53.08","16.35"
"68","000","00","010","1023","0000","2174","859","1315","124","2298","4199","0","54.73","20.46"
"68","000","00","010","1023","0902","671","315","356","48","719","1243","0","57.84","25.34"
"68","000","00","010","1023","0903","798","274","524","42","840","1590","0","52.83","17.23"
"68","000","00","010","1023","0904","705","270","435","34","739","1366","0","54.1","19.77"
"68","000","00","010","1024","0000","2734","1165","1569","129","2863","5390","0","53.12","21.61"
"68","000","00","010","1024","0913","499","232","267","24","523","1052","0","49.71","22.05"
"68","000","00","010","1024","0914","668","317","351","43","711","1154","0","61.61","27.47"
"68","000","00","010","1024","0915","828","345","483","25","853","1645","0","51.85","20.97"
"68","000","00","010","1024","0916","739","271","468","37","776","1539","0","50.42","17.61"
"68","000","00","010","1025","0000","1331","474","857","78","1409","2811","0","50.12","16.86"
"68","000","00","010","1025","0908","652","225","427","54","706","1351","0","52.26","16.65"
"68","000","00","010","1025","0909","679","249","430","24","703","1460","0","48.15","17.05"
"68","000","00","010","1026","0000","2144","836","1308","59","2203","4327","0","50.91","19.32"
"68","000","00","010","1026","0910","906","357","549","24","930","1841","0","50.52","19.39"
"68","000","00","010","1026","0911","693","268","425","20","713","1475","0","48.34","18.17"
"68","000","00","010","1026","0912","545","211","334","15","560","1011","0","55.39","20.87"
"68","000","00","010","1027","0000","1485","630","855","79","1564","3006","0","52.03","20.96"
"68","000","00","010","1027","0804","665","293","372","44","709","1346","0","52.67","21.77"
"68","000","00","010","1027","0805","820","337","483","35","855","1660","0","51.51","20.3"
"68","000","00","010","1028","0000","3314","1282","2032","124","3438","6483","0","53.03","19.77"
"68","000","00","010","1028","0860","804","333","471","23","827","1501","0","55.1","22.19"
"68","000","00","010","1028","0861","752","298","454","36","788","1405","0","56.09","21.21"
"68","000","00","010","1028","0862","841","314","527","43","884","1656","0","53.38","18.96"
"68","000","00","010","1028","0863","917","337","580","22","939","1921","0","48.88","17.54"
"68","000","00","010","1029","0000","883","346","537","41","924","1788","0","51.68","19.35"
"68","000","00","010","1029","0831","883","346","537","41","924","1788","0","51.68","19.35"
"68","000","00","010","1030","0000","2178","877","1301","128","2306","4320","0","53.38","20.3"
"68","000","00","010","1030","0832","762","331","431","33","795","1510","0","52.65","21.92"
"68","000","00","010","1030","0833","692","266","426","48","740","1403","0","52.74","18.96"
"68","000","00","010","1030","0834","724","280","444","47","771","1407","0","54.8","19.9"
"68","000","00","010","1031","0000","2075","881","1194","87","2162","3761","0","57.48","23.42"
"68","000","00","010","1031","0844","776","329","447","31","807","1463","0","55.16","22.49"
"68","000","00","010","1031","0845","689","291","398","27","716","1213","0","59.03","23.99"
"68","000","00","010","1031","0846","610","261","349","29","639","1085","0","58.89","24.06"
"68","000","00","010","1032","0000","1692","755","937","62","1754","3217","0","54.52","23.47"
"68","000","00","010","1032","0822","874","337","537","29","903","1685","0","53.59","20.0"
"68","000","00","010","1032","0823","818","418","400","33","851","1532","0","55.55","27.28"
"68","000","00","010","1033","0000","2905","1119","1786","108","3013","6014","0","50.1","18.61"
"68","000","00","010","1033","0809","893","305","588","34","927","1786","0","51.9","17.08"
"68","000","00","010","1033","0810","659","276","383","30","689","1634","0","42.17","16.89"
"68","000","00","010","1033","0811","582","215","367","19","601","1080","0","55.65","19.91"
"68","000","00","010","1033","0812","771","323","448","25","796","1514","0","52.58","21.33"
"68","000","00","010","1034","0000","2143","910","1233","95","2238","4262","0","52.51","21.35"
"68","000","00","010","1034","0847","714","245","469","22","736","1458","0","50.48","16.8"
"68","000","00","010","1034","0848","740","273","467","42","782","1408","0","55.54","19.39"
"68","000","00","010","1034","0849","689","392","297","31","720","1396","0","51.58","28.08"
"68","000","00","010","1035","0000","1599","545","1054","53","1652","3094","0","53.39","17.61"
"68","000","00","010","1035","0889","769","312","457","31","800","1577","0","50.73","19.78"
"68","000","00","010","1035","0890","830","233","597","22","852","1517","0","56.16","15.36"
"68","000","00","010","1036","0000","2218","874","1344","76","2294","3806","0","60.27","22.96"
"68","000","00","010","1036","0899","788","320","468","29","817","1377","0","59.33","23.24"
"68","000","00","010","1036","0900","697","251","446","29","726","1198","0","60.6","20.95"
"68","000","00","010","1036","0901","733","303","430","18","751","1231","0","61.01","24.61"
"68","000","00","010","1037","0000","2557","1005","1552","114","2671","5039","0","53.01","19.94"
"68","000","00","010","1037","0880","749","322","427","31","780","1399","0","55.75","23.02"
"68","000","00","010","1037","0881","951","380","571","45","996","1968","0","50.61","19.31"
"68","000","00","010","1037","0882","857","303","554","38","895","1672","0","53.53","18.12"
"68","000","00","010","1038","0000","2014","718","1296","73","2087","4201","0","49.68","17.09"
"68","000","00","010","1038","0905","685","245","440","30","715","1332","0","53.68","18.39"
"68","000","00","010","1038","0906","574","208","366","19","593","1201","0","49.38","17.32"
"68","000","00","010","1038","0907","755","265","490","24","779","1668","0","46.7","15.89"
"68","000","00","010","1039","0000","1546","568","978","47","1593","2790","0","57.1","20.36"
"68","000","00","010","1039","0894","722","260","462","27","749","1316","0","56.91","19.76"
"68","000","00","010","1039","0895","824","308","516","20","844","1474","0","57.26","20.9"
"68","000","00","010","1040","0000","826","391","435","54","880","1561","0","56.37","25.05"
"68","000","00","010","1040","0878","394","178","216","31","425","722","0","58.86","24.65"
"68","000","00","010","1040","0879","432","213","219","23","455","839","0","54.23","25.39"
"68","000","00","010","1041","0000","2106","799","1307","74","2180","3703","0","58.87","21.58"
"68","000","00","010","1041","0872","585","208","377","24","609","1094","0","55.67","19.01"
"68","000","00","010","1041","0873","799","312","487","34","833","1394","0","59.76","22.38"
"68","000","00","010","1041","0874","722","279","443","16","738","1215","0","60.74","22.96"
"68","000","00","010","1042","0000","2799","1102","1697","63","2862","4896","0","58.46","22.51"
"68","000","00","010","1042","0854","980","391","589","22","1002","1752","0","57.19","22.32"
"68","000","00","010","1042","0855","857","336","521","18","875","1434","0","61.02","23.43"
"68","000","00","010","1042","0856","962","375","587","23","985","1710","0","57.6","21.93"
"68","000","00","010","1043","0000","2794","1009","1785","93","2887","5358","0","53.88","18.83"
"68","000","00","010","1043","0837","882","295","587","22","904","1730","0","52.25","17.05"
"68","000","00","010","1043","0838","964","368","596","48","1012","1905","0","53.12","19.32"
"68","000","00","010","1043","0839","948","346","602","23","971","1723","0","56.36","20.08"
"68","000","00","010","1044","0000","1898","676","1222","61","1959","3596","0","54.48","18.8"
"68","000","00","010","1044","0887","985","363","622","27","1012","1844","0","54.88","19.69"
"68","000","00","010","1044","0888","913","313","600","34","947","1752","0","54.05","17.87"
"68","000","00","010","1045","0000","2202","895","1307","133","2335","4767","0","48.98","18.77"
"68","000","00","010","1045","0813","818","324","494","52","870","1918","0","45.36","16.89"
"68","000","00","010","1045","0814","610","268","342","50","660","1182","0","55.84","22.67"
"68","000","00","010","1045","0815","774","303","471","31","805","1667","0","48.29","18.18"
"68","000","00","010","1046","0000","3247","1241","2006","110","3357","6496","0","51.68","19.1"
"68","000","00","010","1046","0816","734","281","453","31","765","1640","0","46.65","17.13"
"68","000","00","010","1046","0817","829","342","487","23","852","1603","0","53.15","21.33"
"68","000","00","010","1046","0818","851","315","536","23","874","1556","0","56.17","20.24"
"68","000","00","010","1046","0819","833","303","530","33","866","1697","0","51.03","17.86"
"68","000","00","011","0000","0000","22136","9811","12325","1140","23276","41461","49159","56.14","23.66"
"68","000","00","011","1101","0000","1586","679","907","49","1635","2862","0","57.13","23.72"
"68","000","00","011","1101","1072","749","310","439","24","773","1306","0","59.19","23.74"
"68","000","00","011","1101","1073","837","369","468","25","862","1556","0","55.4","23.71"
"68","000","00","011","1102","0000","2241","890","1351","108","2349","3945","0","59.54","22.56"
"68","000","00","011","1102","1074","1079","424","655","46","1125","1849","0","60.84","22.93"
"68","000","00","011","1102","1075","1162","466","696","62","1224","2096","0","58.4","22.23"
"68","000","00","011","1103","0000","760","373","387","40","800","1517","0","52.74","24.59"
"68","000","00","011","1103","1076","760","373","387","40","800","1517","0","52.74","24.59"
"68","000","00","011","1104","0000","1974","822","1152","96","2070","3951","0","52.39","20.8"
"68","000","00","011","1104","1077","1128","470","658","59","1187","2095","0","56.66","22.43"
"68","000","00","011","1104","1078","846","352","494","37","883","1856","0","47.58","18.97"
"68","000","00","011","1105","0000","2241","934","1307","94","2335","4024","0","58.03","23.21"
"68","000","00","011","1105","1086","1104","436","668","38","1142","1992","0","57.33","21.89"
"68","000","00","011","1105","1087","1137","498","639","56","1193","2032","0","58.71","24.51"
"68","000","00","011","1106","0000","1379","689","690","87","1466","2542","0","57.67","27.1"
"68","000","00","011","1106","1082","731","430","301","51","782","1271","0","61.53","33.83"
"68","000","00","011","1106","1083","648","259","389","36","684","1271","0","53.82","20.38"
"68","000","00","011","1107","0000","1239","575","664","71","1310","2319","0","56.49","24.8"
"68","000","00","011","1107","1084","661","287","374","43","704","1234","0","57.05","23.26"
"68","000","00","011","1107","1085","578","288","290","28","606","1085","0","55.85","26.54"
"68","000","00","011","1108","0000","682","324","358","24","706","1385","0","50.97","23.39"
"68","000","00","011","1108","1081","682","324","358","24","706","1385","0","50.97","23.39"
"68","000","00","011","1109","0000","695","283","412","20","715","1425","0","50.18","19.86"
"68","000","00","011","1109","1080","695","283","412","20","715","1425","0","50.18","19.86"
"68","000","00","011","1110","0000","1048","457","591","59","1107","1986","0","55.74","23.01"
"68","000","00","011","1110","1079","1048","457","591","59","1107","1986","0","55.74","23.01"
"68","000","00","011","1111","0000","425","207","218","22","447","741","0","60.32","27.94"
"68","000","00","011","1111","1098","425","207","218","22","447","741","0","60.32","27.94"
"68","000","00","011","1112","0000","831","392","439","66","897","1714","0","52.33","22.87"
"68","000","00","011","1112","1100","831","392","439","66","897","1714","0","52.33","22.87"
"68","000","00","011","1113","0000","546","225","321","36","582","943","0","61.72","23.86"
"68","000","00","011","1113","1099","546","225","321","36","582","943","0","61.72","23.86"
"68","000","00","011","1114","0000","726","310","416","21","747","1340","0","55.75","23.13"
"68","000","00","011","1114","1101","726","310","416","21","747","1340","0","55.75","23.13"
"68","000","00","011","1115","0000","463","211","252","38","501","995","0","50.35","21.21"
"68","000","00","011","1115","1097","463","211","252","38","501","995","0","50.35","21.21"
"68","000","00","011","1116","0000","1299","594","705","62","1361","2265","0","60.09","26.23"
"68","000","00","011","1116","1095","519","234","285","16","535","896","0","59.71","26.12"
"68","000","00","011","1116","1096","780","360","420","46","826","1369","0","60.34","26.3"
"68","000","00","011","1117","0000","626","285","341","43","669","1050","0","63.71","27.14"
"68","000","00","011","1117","1094","626","285","341","43","669","1050","0","63.71","27.14"
"68","000","00","011","1118","0000","372","169","203","36","408","663","0","61.54","25.49"
"68","000","00","011","1118","1092","372","169","203","36","408","663","0","61.54","25.49"
"68","000","00","011","1119","0000","476","244","232","15","491","908","0","54.07","26.87"
"68","000","00","011","1119","1091","476","244","232","15","491","908","0","54.07","26.87"
"68","000","00","011","1120","0000","552","281","271","41","593","1088","0","54.5","25.83"
"68","000","00","011","1120","1093","552","281","271","41","593","1088","0","54.5","25.83"
"68","000","00","011","1121","0000","612","232","380","35","647","1106","0","58.5","20.98"
"68","000","00","011","1121","1090","612","232","380","35","647","1106","0","58.5","20.98"
"68","000","00","011","1122","0000","670","298","372","37","707","1291","0","54.76","23.08"
"68","000","00","011","1122","1088","670","298","372","37","707","1291","0","54.76","23.08"
"68","000","00","011","1123","0000","693","337","356","40","733","1401","0","52.32","24.05"
"68","000","00","011","1123","1089","693","337","356","40","733","1401","0","52.32","24.05"
"68","000","00","012","0000","0000","26867","12464","14403","1326","28193","55149","67208","51.12","22.6"
"68","000","00","012","1201","0000","1221","568","653","47","1268","2733","0","46.4","20.78"
"68","000","00","012","1201","1102","652","298","354","28","680","1371","0","49.6","21.74"
"68","000","00","012","1201","1103","569","270","299","19","588","1362","0","43.17","19.82"
"68","000","00","012","1202","0000","484","211","273","51","535","997","0","53.66","21.16"
"68","000","00","012","1202","1104","484","211","273","51","535","997","0","53.66","21.16"
"68","000","00","012","1203","0000","659","307","352","27","686","1407","0","48.76","21.82"
"68","000","00","012","1203","1105","659","307","352","27","686","1407","0","48.76","21.82"
"68","000","00","012","1204","0000","875","434","441","27","902","1692","0","53.31","25.65"
"68","000","00","012","1204","1106","875","434","441","27","902","1692","0","53.31","25.65"
"68","000","00","012","1205","0000","487","225","262","21","508","892","0","56.95","25.22"
"68","000","00","012","1205","1109","487","225","262","21","508","892","0","56.95","25.22"
"68","000","00","012","1206","0000","1057","436","621","34","1091","2070","0","52.71","21.06"
"68","000","00","012","1206","1107","657","274","383","19","676","1279","0","52.85","21.42"
"68","000","00","012","1206","1108","400","162","238","15","415","791","0","52.47","20.48"
"68","000","00","012","1207","0000","517","234","283","17","534","886","0","60.27","26.41"
"68","000","00","012","1207","1110","517","234","283","17","534","886","0","60.27","26.41"
"68","000","00","012","1208","0000","367","179","188","31","398","712","0","55.9","25.14"
"68","000","00","012","1208","1111","367","179","188","31","398","712","0","55.9","25.14"
"68","000","00","012","1209","0000","752","361","391","65","817","1609","0","50.78","22.44"
"68","000","00","012","1209","1112","752","361","391","65","817","1609","0","50.78","22.44"
"68","000","00","012","1210","0000","1242","537","705","81","1323","2625","0","50.4","20.46"
"68","000","00","012","1210","1113","665","304","361","40","705","1274","0","55.34","23.86"
"68","000","00","012","1210","1114","577","233","344","41","618","1351","0","45.74","17.25"
"68","000","00","012","1211","0000","1356","647","709","85","1441","2504","0","57.55","25.84"
"68","000","00","012","1211","1115","697","301","396","36","733","1262","0","58.08","23.85"
"68","000","00","012","1211","1116","659","346","313","49","708","1242","0","57.0","27.86"
"68","000","00","012","1212","0000","1553","707","846","80","1633","3074","0","53.12","23.0"
"68","000","00","012","1212","1117","732","344","388","45","777","1461","0","53.18","23.55"
"68","000","00","012","1212","1118","821","363","458","35","856","1613","0","53.07","22.5"
"68","000","00","012","1213","0000","771","379","392","26","797","1479","0","53.89","25.63"
"68","000","00","012","1213","1119","771","379","392","26","797","1479","0","53.89","25.63"
"68","000","00","012","1214","0000","2295","1121","1174","109","2404","4760","0","50.5","23.55"
"68","000","00","012","1214","1120","720","382","338","34","754","1552","0","48.58","24.61"
"68","000","00","012","1214","1121","784","374","410","29","813","1517","0","53.59","24.65"
"68","000","00","012","1214","1122","791","365","426","46","837","1691","0","49.5","21.58"
"68","000","00","012","1215","0000","1926","787","1139","77","2003","3762","0","53.24","20.92"
"68","000","00","012","1215","1123","619","257","362","27","646","1157","0","55.83","22.21"
"68","000","00","012","1215","1124","707","299","408","39","746","1455","0","51.27","20.55"
"68","000","00","012","1215","1125","600","231","369","11","611","1150","0","53.13","20.09"
"68","000","00","012","1216","0000","1207","515","692","59","1266","2363","0","53.58","21.79"
"68","000","00","012","1216","1126","593","262","331","41","634","1112","0","57.01","23.56"
"68","000","00","012","1216","1127","614","253","361","18","632","1251","0","50.52","20.22"
"68","000","00","012","1217","0000","1470","713","757","107","1577","2939","0","53.66","24.26"
"68","000","00","012","1217","1128","725","341","384","58","783","1446","0","54.15","23.58"
"68","000","00","012","1217","1129","745","372","373","49","794","1493","0","53.18","24.92"
"68","000","00","012","1218","0000","1306","608","698","67","1373","2476","0","55.45","24.56"
"68","000","00","012","1218","1130","671","323","348","36","707","1339","0","52.8","24.12"
"68","000","00","012","1218","1131","635","285","350","31","666","1137","0","58.58","25.07"
"68","000","00","012","1219","0000","501","211","290","33","534","1043","0","51.2","20.23"
"68","000","00","012","1219","1132","501","211","290","33","534","1043","0","51.2","20.23"
"68","000","00","012","1220","0000","937","506","431","31","968","1968","0","49.19","25.71"
"68","000","00","012","1220","1133","454","231","223","14","468","993","0","47.13","23.26"
"68","000","00","012","1220","1134","483","275","208","17","500","975","0","51.28","28.21"
"68","000","00","012","1221","0000","902","478","424","40","942","2029","0","46.43","23.56"
"68","000","00","012","1221","1135","902","478","424","40","942","2029","0","46.43","23.56"
"68","000","00","012","1222","0000","1439","730","709","74","1513","3802","0","39.79","19.2"
"68","000","00","012","1222","1139","780","384","396","34","814","1870","0","43.53","20.53"
"68","000","00","012","1222","1140","659","346","313","40","699","1932","0","36.18","17.91"
"68","000","00","012","1223","0000","830","386","444","29","859","1884","0","45.59","20.49"
"68","000","00","012","1223","1141","415","210","205","12","427","899","0","47.5","23.36"
"68","000","00","012","1223","1142","415","176","239","17","432","985","0","43.86","17.87"
"68","000","00","012","1224","0000","2713","1184","1529","108","2821","5443","0","51.83","21.75"
"68","000","00","012","1224","1136","935","410","525","41","976","1765","0","55.3","23.23"
"68","000","00","012","1224","1137","906","393","513","30","936","1809","0","51.74","21.72"
"68","000","00","012","1224","1138","872","381","491","37","909","1869","0","48.64","20.39"
"68","000","00","013","0000","0000","4903","1806","3097","298","5201","9766","11997","53.26","18.49"
"68","000","00","013","1301","0000","1046","391","655","70","1116","1991","0","56.05","19.64"
"68","000","00","013","1301","0581","1046","391","655","70","1116","1991","0","56.05","19.64"
"68","000","00","013","1302","0000","750","253","497","46","796","1392","0","57.18","18.18"
"68","000","00","013","1302","0582","750","253","497","46","796","1392","0","57.18","18.18"
"68","000","00","013","1303","0000","353","106","247","19","372","716","0","51.96","14.8"
"68","000","00","013","1303","0584","353","106","247","19","372","716","0","51.96","14.8"
"68","000","00","013","1304","0000","285","103","182","21","306","564","0","54.26","18.26"
"68","000","00","013","1304","0583","285","103","182","21","306","564","0","54.26","18.26"
"68","000","00","013","1305","0000","280","119","161","8","288","669","0","43.05","17.79"
"68","000","00","013","1305","0586","280","119","161","8","288","669","0","43.05","17.79"
"68","000","00","013","1306","0000","234","70","164","9","243","683","0","35.58","10.25"
"68","000","00","013","1306","0589","234","70","164","9","243","683","0","35.58","10.25"
"68","000","00","013","1307","0000","352","117","235","14","366","760","0","48.16","15.39"
"68","000","00","013","1307","0587","352","117","235","14","366","760","0","48.16","15.39"
"68","000","00","013","1308","0000","639","256","383","31","670","1224","0","54.74","20.92"
"68","000","00","013","1308","0590","639","256","383","31","670","1224","0","54.74","20.92"
"68","000","00","013","1309","0000","586","275","311","56","642","1016","0","63.19","27.07"
"68","000","00","013","1309","0585","586","275","311","56","642","1016","0","63.19","27.07"
"68","000","00","013","1310","0000","378","116","262","24","402","751","0","53.53","15.45"
"68","000","00","013","1310","0588","378","116","262","24","402","751","0","53.53","15.45"
"66","000","00","000","0000","0000","1281430","554566","726864","60389","1341819","2295642","2799254","58.45","24.16"
"66","000","00","001","0000","0000","8036","3924","4112","365","8401","14696","18557","57.17","26.7"
"66","000","00","001","0101","0000","834","422","412","24","858","1531","0","56.04","27.56"
"66","000","00","001","0101","1071","834","422","412","24","858","1531","0","56.04","27.56"
"66","000","00","001","0102","0000","1144","574","570","54","1198","2046","0","58.55","28.05"
"66","000","00","001","0102","1075","658","339","319","44","702","1191","0","58.94","28.46"
"66","000","00","001","0102","1076","486","235","251","10","496","855","0","58.01","27.49"
"66","000","00","001","0103","0000","980","497","483","65","1045","1652","0","63.26","30.08"
"66","000","00","001","0103","1070","980","497","483","65","1045","1652","0","63.26","30.08"
"66","000","00","001","0104","0000","797","388","409","33","830","1431","0","58.0","27.11"
"66","000","00","001","0104","1072","797","388","409","33","830","1431","0","58.0","27.11"
"66","000","00","001","0105","0000","1124","535","589","51","1175","2042","0","57.54","26.2"
"66","000","00","001","0105","1073","595","286","309","24","619","1060","0","58.4","26.98"
"66","000","00","001","0105","1074","529","249","280","27","556","982","0","56.62","25.36"
"66","000","00","001","0106","0000","928","441","487","44","972","1840","0","52.83","23.97"
"66","000","00","001","0106","1077","522","255","267","25","547","1135","0","48.19","22.47"
"66","000","00","001","0106","1078","406","186","220","19","425","705","0","60.28","26.38"
"66","000","00","001","0107","0000","1302","622","680","72","1374","2313","0","59.4","26.89"
"66","000","00","001","0107","1079","629","284","345","14","643","1009","0","63.73","28.15"
"66","000","00","001","0107","1080","673","338","335","58","731","1304","0","56.06","25.92"
"66","000","00","001","0108","0000","927","445","482","22","949","1841","0","51.55","24.17"
"66","000","00","001","0108","1081","927","445","482","22","949","1841","0","51.55","24.17"
"66","000","00","002","0000","0000","36530","16941","19589","1760","38290","64291","76070","59.56","26.35"
"66","000","00","002","0201","0000","1517","757","760","68","1585","2999","0","52.85","25.24"
"66","000","00","002","0201","1148","452","259","193","23","475","1138","0","41.74","22.76"
"66","000","00","002","0201","1149","559","257","302","19","578","984","0","58.74","26.12"
"66","000","00","002","0201","1150","506","241","265","26","532","877","0","60.66","27.48"
"66","000","00","002","0202","0000","1891","973","918","87","1978","3129","0","63.22","31.1"
"66","000","00","002","0202","1151","660","336","324","32","692","1070","0","64.67","31.4"
"66","000","00","002","0202","1152","667","333","334","30","697","1106","0","63.02","30.11"
"66","000","00","002","0202","1153","564","304","260","25","589","953","0","61.8","31.9"
"66","000","00","002","0203","0000","2107","1055","1052","86","2193","3636","0","60.31","29.02"
"66","000","00","002","0203","1154","725","348","377","19","744","1195","0","62.26","29.12"
"66","000","00","002","0203","1155","694","327","367","30","724","1251","0","57.87","26.14"
"66","000","00","002","0203","1156","688","380","308","37","725","1190","0","60.92","31.93"
"66","000","00","002","0204","0000","1646","821","825","67","1713","2837","0","60.38","28.94"
"66","000","00","002","0204","1157","770","380","390","27","797","1394","0","57.17","27.26"
"66","000","00","002","0204","1158","876","441","435","40","916","1443","0","63.48","30.56"
"66","000","00","002","0205","0000","1202","592","610","55","1257","1966","0","63.94","30.11"
"66","000","00","002","0205","1161","740","413","327","34","774","1211","0","63.91","34.1"
"66","000","00","002","0205","1162","462","179","283","21","483","755","0","63.97","23.71"
"66","000","00","002","0206","0000","1133","557","576","71","1204","1902","0","63.3","29.28"
"66","000","00","002","0206","1159","434","230","204","27","461","762","0","60.5","30.18"
"66","000","00","002","0206","1160","699","327","372","44","743","1140","0","65.18","28.68"
"66","000","00","002","0207","0000","1355","658","697","62","1417","2491","0","56.88","26.42"
"66","000","00","002","0207","1163","802","377","425","45","847","1491","0","56.81","25.29"
"66","000","00","002","0207","1164","553","281","272","17","570","1000","0","57.0","28.1"
"66","000","00","002","0208","0000","1269","731","538","66","1335","2215","0","60.27","33.0"
"66","000","00","002","0208","1165","645","328","317","39","684","1114","0","61.4","29.44"
"66","000","00","002","0208","1166","624","403","221","27","651","1101","0","59.13","36.6"
"66","000","00","002","0209","0000","3827","1889","1938","206","4033","6563","0","61.45","28.78"
"66","000","00","002","0209","1167","708","381","327","46","754","1169","0","64.5","32.59"
"66","000","00","002","0209","1168","770","370","400","52","822","1283","0","64.07","28.84"
"66","000","00","002","0209","1169","710","331","379","35","745","1168","0","63.78","28.34"
"66","000","00","002","0209","1170","757","384","373","37","794","1386","0","57.29","27.71"
"66","000","00","002","0209","1171","882","423","459","36","918","1557","0","58.96","27.17"
"66","000","00","002","0210","0000","2698","1259","1439","119","2817","4658","0","60.48","27.03"
"66","000","00","002","0210","1172","780","397","383","40","820","1380","0","59.42","28.77"
"66","000","00","002","0210","1173","960","419","541","36","996","1674","0","59.5","25.03"
"66","000","00","002","0210","1174","958","443","515","43","1001","1604","0","62.41","27.62"
"66","000","00","002","0211","0000","2230","952","1278","90","2320","3743","0","61.98","25.43"
"66","000","00","002","0211","1179","745","291","454","20","765","1252","0","61.1","23.24"
"66","000","00","002","0211","1180","763","370","393","37","800","1250","0","64.0","29.6"
"66","000","00","002","0211","1181","722","291","431","33","755","1241","0","60.84","23.45"
"66","000","00","002","0212","0000","1376","618","758","85","1461","2606","0","56.06","23.71"
"66","000","00","002","0212","1182","689","343","346","30","719","1318","0","54.55","26.02"
"66","000","00","002","0212","1183","687","275","412","55","742","1288","0","57.61","21.35"
"66","000","00","002","0213","0000","2345","901","1444","143","2488","4096","0","60.74","22.0"
"66","000","00","002","0213","1184","864","372","492","49","913","1442","0","63.31","25.8"
"66","000","00","002","0213","1185","681","282","399","38","719","1202","0","59.82","23.46"
"66","000","00","002","0213","1186","800","247","553","56","856","1452","0","58.95","17.01"
"66","000","00","002","0214","0000","861","298","563","46","907","1693","0","53.57","17.6"
"66","000","00","002","0214","1190","861","298","563","46","907","1693","0","53.57","17.6"
"66","000","00","002","0215","0000","2223","769","1454","94","2317","4083","0","56.75","18.83"
"66","000","00","002","0215","1187","796","306","490","38","834","1480","0","56.35","20.68"
"66","000","00","002","0215","1188","947","254","693","36","983","1736","0","56.62","14.63"
"66","000","00","002","0215","1189","480","209","271","20","500","867","0","57.67","24.11"
"66","000","00","002","0216","0000","5017","2377","2640","240","5257","8717","0","60.31","27.27"
"66","000","00","002","0216","1191","893","425","468","56","949","1538","0","61.7","27.63"
"66","000","00","002","0216","1192","936","447","489","59","995","1593","0","62.46","28.06"
"66","000","00","002","0216","1193","790","333","457","26","816","1481","0","55.1","22.48"
"66","000","00","002","0216","1194","845","367","478","35","880","1414","0","62.23","25.95"
"66","000","00","002","0216","1195","749","409","340","28","777","1297","0","59.91","31.53"
"66","000","00","002","0216","1196","804","396","408","36","840","1394","0","60.26","28.41"
"66","000","00","002","0217","0000","3833","1734","2099","175","4008","6957","0","57.61","24.92"
"66","000","00","002","0217","1175","1048","476","572","51","1099","1815","0","60.55","26.23"
"66","000","00","002","0217","1176","919","422","497","44","963","1700","0","56.65","24.82"
"66","000","00","002","0217","1177","877","385","492","38","915","1592","0","57.47","24.18"
"66","000","00","002","0217","1178","989","451","538","42","1031","1850","0","55.73","24.38"
"66","000","00","003","0000","0000","61357","27658","33699","2729","64086","103643","125726","61.83","26.69"
"66","000","00","003","0301","0000","2150","1044","1106","98","2248","3607","0","62.32","28.94"
"66","000","00","003","0301","1201","701","340","361","21","722","1130","0","63.89","30.09"
"66","000","00","003","0301","1202","744","375","369","43","787","1239","0","63.52","30.27"
"66","000","00","003","0301","1203","705","329","376","34","739","1238","0","59.69","26.58"
"66","000","00","003","0302","0000","2255","1127","1128","138","2393","3862","0","61.96","29.18"
"66","000","00","003","0302","1204","758","368","390","44","802","1272","0","63.05","28.93"
"66","000","00","003","0302","1205","732","365","367","49","781","1273","0","61.35","28.67"
"66","000","00","003","0302","1206","765","394","371","45","810","1317","0","61.5","29.92"
"66","000","00","003","0303","0000","2198","1040","1158","87","2285","3476","0","65.74","29.92"
"66","000","00","003","0303","1207","772","359","413","27","799","1160","0","68.88","30.95"
"66","000","00","003","0303","1208","761","354","407","37","798","1205","0","66.22","29.38"
"66","000","00","003","0303","1209","665","327","338","23","688","1111","0","61.93","29.43"
"66","000","00","003","0304","0000","1712","774","938","78","1790","2826","0","63.34","27.39"
"66","000","00","003","0304","1210","895","405","490","38","933","1407","0","66.31","28.78"
"66","000","00","003","0304","1211","817","369","448","40","857","1419","0","60.39","26.0"
"66","000","00","003","0305","0000","1490","692","798","94","1584","2572","0","61.59","26.91"
"66","000","00","003","0305","1212","688","332","356","50","738","1157","0","63.79","28.69"
"66","000","00","003","0305","1213","802","360","442","44","846","1415","0","59.79","25.44"
"66","000","00","003","0306","0000","1657","749","908","77","1734","2743","0","63.22","27.31"
"66","000","00","003","0306","1214","819","374","445","35","854","1289","0","66.25","29.01"
"66","000","00","003","0306","1215","838","375","463","42","880","1454","0","60.52","25.79"
"66","000","00","003","0307","0000","2455","1062","1393","134","2589","4315","0","60.0","24.61"
"66","000","00","003","0307","1216","819","322","497","58","877","1491","0","58.82","21.6"
"66","000","00","003","0307","1217","815","347","468","25","840","1394","0","60.26","24.89"
"66","000","00","003","0307","1218","821","393","428","51","872","1430","0","60.98","27.48"
"66","000","00","003","0308","0000","2369","1089","1280","142","2511","3836","0","65.46","28.39"
"66","000","00","003","0308","1219","811","381","430","46","857","1342","0","63.86","28.39"
"66","000","00","003","0308","1220","825","414","411","64","889","1304","0","68.17","31.75"
"66","000","00","003","0308","1221","733","294","439","32","765","1190","0","64.29","24.71"
"66","000","00","003","0309","0000","3183","1534","1649","141","3324","5320","0","62.48","28.83"
"66","000","00","003","0309","1222","725","330","395","37","762","1273","0","59.86","25.92"
"66","000","00","003","0309","1223","870","516","354","38","908","1387","0","65.47","37.2"
"66","000","00","003","0309","1224","796","372","424","33","829","1356","0","61.14","27.43"
"66","000","00","003","0309","1225","792","316","476","33","825","1304","0","63.27","24.23"
"66","000","00","003","0310","0000","2201","1161","1040","94","2295","3842","0","59.73","30.22"
"66","000","00","003","0310","1230","767","361","406","36","803","1308","0","61.39","27.6"
"66","000","00","003","0310","1231","718","463","255","29","747","1250","0","59.76","37.04"
"66","000","00","003","0310","1232","716","337","379","29","745","1284","0","58.02","26.25"
"66","000","00","003","0311","0000","4630","1914","2716","170","4800","7672","0","62.57","24.95"
"66","000","00","003","0311","1240","1018","408","610","34","1052","1643","0","64.03","24.83"
"66","000","00","003","0311","1241","859","370","489","33","892","1423","0","62.68","26.0"
"66","000","00","003","0311","1242","897","342","555","32","929","1542","0","60.25","22.18"
"66","000","00","003","0311","1243","904","376","528","30","934","1533","0","60.93","24.53"
"66","000","00","003","0311","1244","952","418","534","41","993","1531","0","64.86","27.3"
"66","000","00","003","0312","0000","6113","2597","3516","289","6402","10764","0","59.48","24.13"
"66","000","00","003","0312","1248","949","395","554","46","995","1799","0","55.31","21.96"
"66","000","00","003","0312","1249","1033","483","550","54","1087","1708","0","63.64","28.28"
"66","000","00","003","0312","1250","947","403","544","50","997","1700","0","58.65","23.71"
"66","000","00","003","0312","1251","1056","428","628","36","1092","1751","0","62.36","24.44"
"66","000","00","003","0312","1252","1170","495","675","49","1219","2109","0","57.8","23.47"
"66","000","00","003","0312","1253","958","393","565","54","1012","1697","0","59.63","23.16"
"66","000","00","003","0313","0000","5003","2203","2800","148","5151","7918","0","65.05","27.82"
"66","000","00","003","0313","1258","786","363","423","17","803","1274","0","63.03","28.49"
"66","000","00","003","0313","1259","902","353","549","22","924","1390","0","66.47","25.4"
"66","000","00","003","0313","1260","832","316","516","22","854","1295","0","65.95","24.4"
"66","000","00","003","0313","1261","770","363","407","38","808","1312","0","61.59","27.67"
"66","000","00","003","0313","1262","878","467","411","28","906","1417","0","63.94","32.96"
"66","000","00","003","0313","1263","835","341","494","21","856","1230","0","69.59","27.72"
"66","000","00","003","0314","0000","2398","1024","1374","140","2538","4174","0","60.8","24.53"
"66","000","00","003","0314","1264","745","318","427","50","795","1308","0","60.78","24.31"
"66","000","00","003","0314","1265","832","386","446","50","882","1467","0","60.12","26.31"
"66","000","00","003","0314","1266","821","320","501","40","861","1399","0","61.54","22.87"
"66","000","00","003","0315","0000","1183","583","600","53","1236","1938","0","63.78","30.08"
"66","000","00","003","0315","1197","545","287","258","32","577","937","0","61.58","30.63"
"66","000","00","003","0315","1198","638","296","342","21","659","1001","0","65.83","29.57"
"66","000","00","003","0316","0000","1586","763","823","66","1652","2451","0","67.4","31.13"
"66","000","00","003","0316","1199","790","382","408","36","826","1249","0","66.13","30.58"
"66","000","00","003","0316","1200","796","381","415","30","826","1202","0","68.72","31.7"
"66","000","00","003","0317","0000","3317","1455","1862","110","3427","5388","0","63.6","27.0"
"66","000","00","003","0317","1226","800","350","450","24","824","1256","0","65.61","27.87"
"66","000","00","003","0317","1227","856","387","469","19","875","1364","0","64.15","28.37"
"66","000","00","003","0317","1228","809","384","425","47","856","1361","0","62.89","28.21"
"66","000","00","003","0317","1229","852","334","518","20","872","1407","0","61.98","23.74"
"66","000","00","003","0318","0000","2162","982","1180","104","2266","3501","0","64.72","28.05"
"66","000","00","003","0318","1233","724","322","402","44","768","1175","0","65.36","27.4"
"66","000","00","003","0318","1234","742","353","389","30","772","1158","0","66.67","30.48"
"66","000","00","003","0318","1235","696","307","389","30","726","1168","0","62.16","26.28"
"66","000","00","003","0319","0000","3773","1550","2223","141","3914","7241","0","54.05","21.41"
"66","000","00","003","0319","1236","989","399","590","51","1040","1626","0","63.96","24.54"
"66","000","00","003","0319","1237","868","368","500","28","896","2115","0","42.36","17.4"
"66","000","00","003","0319","1238","976","391","585","36","1012","1805","0","56.07","21.66"
"66","000","00","003","0319","1239","940","392","548","26","966","1695","0","56.99","23.13"
"66","000","00","003","0320","0000","2500","1144","1356","112","2612","4415","0","59.16","25.91"
"66","000","00","003","0320","1245","762","371","391","30","792","1392","0","56.9","26.65"
"66","000","00","003","0320","1246","878","368","510","42","920","1592","0","57.79","23.12"
"66","000","00","003","0320","1247","860","405","455","40","900","1431","0","62.89","28.3"
"66","000","00","003","0321","0000","3919","1615","2304","167","4086","6474","0","63.11","24.95"
"66","000","00","003","0321","1254","837","343","494","31","868","1456","0","59.62","23.56"
"66","000","00","003","0321","1255","1102","463","639","45","1147","1726","0","66.45","26.83"
"66","000","00","003","0321","1256","1054","435","619","42","1096","1723","0","63.61","25.25"
"66","000","00","003","0321","1257","926","374","552","49","975","1569","0","62.14","23.84"
"66","000","00","003","0322","0000","3103","1556","1547","146","3249","5308","0","61.21","29.31"
"66","000","00","003","0322","1267","695","324","371","41","736","1207","0","60.98","26.84"
"66","000","00","003","0322","1268","789","363","426","32","821","1317","0","62.34","27.56"
"66","000","00","003","0322","1269","884","364","520","36","920","1563","0","58.86","23.29"
"66","000","00","003","0322","1270","735","505","230","37","772","1221","0","63.23","41.36"
"66","000","00","004","0000","0000","54193","24080","30113","2028","56221","95040","115551","59.16","25.34"
"66","000","00","004","0401","0000","1116","499","617","44","1160","1798","0","64.52","27.75"
"66","000","00","004","0401","1085","623","268","355","22","645","1020","0","63.24","26.27"
"66","000","00","004","0401","1086","493","231","262","22","515","778","0","66.2","29.69"
"66","000","00","004","0402","0000","837","353","484","24","861","1416","0","60.81","24.93"
"66","000","00","004","0402","1084","837","353","484","24","861","1416","0","60.81","24.93"
"66","000","00","004","0403","0000","1037","435","602","45","1082","2261","0","47.85","19.24"
"66","000","00","004","0403","1082","490","208","282","27","517","1400","0","36.93","14.86"
"66","000","00","004","0403","1083","547","227","320","18","565","861","0","65.62","26.36"
"66","000","00","004","0404","0000","1456","639","817","54","1510","2295","0","65.8","27.84"
"66","000","00","004","0404","1090","791","350","441","28","819","1251","0","65.47","27.98"
"66","000","00","004","0404","1091","665","289","376","26","691","1044","0","66.19","27.68"
"66","000","00","004","0405","0000","802","342","460","39","841","1465","0","57.41","23.34"
"66","000","00","004","0405","1087","802","342","460","39","841","1465","0","57.41","23.34"
"66","000","00","004","0406","0000","1105","483","622","50","1155","1885","0","61.27","25.62"
"66","000","00","004","0406","1088","592","255","337","25","617","1017","0","60.67","25.07"
"66","000","00","004","0406","1089","513","228","285","25","538","868","0","61.98","26.27"
"66","000","00","004","0407","0000","2729","1220","1509","101","2830","4791","0","59.07","25.46"
"66","000","00","004","0407","1092","846","386","460","30","876","1487","0","58.91","25.96"
"66","000","00","004","0407","1093","905","421","484","37","942","1573","0","59.89","26.76"
"66","000","00","004","0407","1094","978","413","565","34","1012","1731","0","58.46","23.86"
"66","000","00","004","0408","0000","2338","1040","1298","84","2422","3948","0","61.35","26.34"
"66","000","00","004","0408","1095","734","344","390","27","761","1209","0","62.94","28.45"
"66","000","00","004","0408","1096","895","371","524","26","921","1564","0","58.89","23.72"
"66","000","00","004","0408","1097","709","325","384","31","740","1175","0","62.98","27.66"
"66","000","00","004","0409","0000","3154","1437","1717","81","3235","5680","0","56.95","25.3"
"66","000","00","004","0409","1098","848","368","480","25","873","1505","0","58.01","24.45"
"66","000","00","004","0409","1099","857","397","460","25","882","1418","0","62.2","28.0"
"66","000","00","004","0409","1100","704","291","413","2","706","1497","0","47.16","19.44"
"66","000","00","004","0409","1101","745","381","364","29","774","1260","0","61.43","30.24"
"66","000","00","004","0410","0000","1279","632","647","68","1347","2330","0","57.81","27.12"
"66","000","00","004","0410","1116","626","304","322","37","663","1129","0","58.72","26.93"
"66","000","00","004","0410","1117","653","328","325","31","684","1201","0","56.95","27.31"
"66","000","00","004","0411","0000","1714","704","1010","70","1784","3196","0","55.82","22.03"
"66","000","00","004","0411","1114","930","368","562","42","972","1822","0","53.35","20.2"
"66","000","00","004","0411","1115","784","336","448","28","812","1374","0","59.1","24.45"
"66","000","00","004","0412","0000","1941","918","1023","89","2030","3502","0","57.97","26.21"
"66","000","00","004","0412","1118","884","390","494","45","929","1639","0","56.68","23.79"
"66","000","00","004","0412","1119","1057","528","529","44","1101","1863","0","59.1","28.34"
"66","000","00","004","0413","0000","1649","774","875","56","1705","2846","0","59.91","27.2"
"66","000","00","004","0413","1102","836","369","467","26","862","1399","0","61.62","26.38"
"66","000","00","004","0413","1103","813","405","408","30","843","1447","0","58.26","27.99"
"66","000","00","004","0414","0000","3710","1581","2129","127","3837","6488","0","59.14","24.37"
"66","000","00","004","0414","1104","961","441","520","37","998","1683","0","59.3","26.2"
"66","000","00","004","0414","1105","926","380","546","37","963","1585","0","60.76","23.97"
"66","000","00","004","0414","1106","945","373","572","18","963","1557","0","61.85","23.96"
"66","000","00","004","0414","1107","878","387","491","35","913","1663","0","54.9","23.27"
"66","000","00","004","0415","0000","3219","1501","1718","170","3389","5656","0","59.92","26.54"
"66","000","00","004","0415","1122","744","346","398","26","770","1308","0","58.87","26.45"
"66","000","00","004","0415","1123","777","364","413","72","849","1433","0","59.25","25.4"
"66","000","00","004","0415","1124","808","366","442","30","838","1450","0","57.79","25.24"
"66","000","00","004","0415","1125","890","425","465","42","932","1465","0","63.62","29.01"
"66","000","00","004","0416","0000","3124","1372","1752","126","3250","5663","0","57.39","24.23"
"66","000","00","004","0416","1140","666","277","389","17","683","1139","0","59.96","24.32"
"66","000","00","004","0416","1141","658","241","417","29","687","1105","0","62.17","21.81"
"66","000","00","004","0416","1142","825","399","426","43","868","1498","0","57.94","26.64"
"66","000","00","004","0416","1143","975","455","520","37","1012","1921","0","52.68","23.69"
"66","000","00","004","0417","0000","3606","1592","2014","109","3715","6075","0","61.15","26.21"
"66","000","00","004","0417","1133","948","425","523","25","973","1613","0","60.32","26.35"
"66","000","00","004","0417","1134","826","339","487","30","856","1454","0","58.87","23.31"
"66","000","00","004","0417","1135","958","467","491","27","985","1597","0","61.68","29.24"
"66","000","00","004","0417","1136","874","361","513","27","901","1411","0","63.86","25.58"
"66","000","00","004","0418","0000","3078","1386","1692","97","3175","5581","0","56.89","24.83"
"66","000","00","004","0418","1108","1099","517","582","33","1132","1921","0","58.93","26.91"
"66","000","00","004","0418","1109","1022","443","579","30","1052","1952","0","53.89","22.69"
"66","000","00","004","0418","1110","957","426","531","34","991","1708","0","58.02","24.94"
"66","000","00","004","0419","0000","3353","1550","1803","116","3469","5667","0","61.21","27.35"
"66","000","00","004","0419","1144","768","363","405","27","795","1340","0","59.33","27.09"
"66","000","00","004","0419","1145","927","428","499","26","953","1536","0","62.04","27.86"
"66","000","00","004","0419","1146","775","385","390","39","814","1361","0","59.81","28.29"
"66","000","00","004","0419","1147","883","374","509","24","907","1430","0","63.43","26.15"
"66","000","00","004","0420","0000","1571","656","915","56","1627","2794","0","58.23","23.48"
"66","000","00","004","0420","1128","863","420","443","31","894","1428","0","62.61","29.41"
"66","000","00","004","0420","1129","708","236","472","25","733","1366","0","53.66","17.28"
"66","000","00","004","0421","0000","1982","925","1057","80","2062","3600","0","57.28","25.69"
"66","000","00","004","0421","1126","962","414","548","45","1007","1818","0","55.39","22.77"
"66","000","00","004","0421","1127","1020","511","509","35","1055","1782","0","59.2","28.68"
"66","000","00","004","0422","0000","2730","1160","1570","119","2849","4803","0","59.32","24.15"
"66","000","00","004","0422","1137","849","390","459","43","892","1493","0","59.75","26.12"
"66","000","00","004","0422","1138","946","361","585","39","985","1600","0","61.56","22.56"
"66","000","00","004","0422","1139","935","409","526","37","972","1710","0","56.84","23.92"
"66","000","00","004","0423","0000","2447","1068","1379","73","2520","4187","0","60.19","25.51"
"66","000","00","004","0423","1130","827","366","461","31","858","1498","0","57.28","24.43"
"66","000","00","004","0423","1131","812","375","437","24","836","1350","0","61.93","27.78"
"66","000","00","004","0423","1132","808","327","481","18","826","1339","0","61.69","24.42"
"66","000","00","004","0424","0000","1716","743","973","57","1773","2791","0","63.53","26.62"
"66","000","00","004","0424","1120","819","342","477","18","837","1287","0","65.03","26.57"
"66","000","00","004","0424","1121","897","401","496","39","936","1504","0","62.23","26.66"
"66","000","00","004","0425","0000","2500","1070","1430","93","2593","4322","0","60.0","24.76"
"66","000","00","004","0425","1111","708","279","429","29","737","1131","0","65.16","24.67"
"66","000","00","004","0425","1112","1021","413","608","42","1063","1916","0","55.48","21.56"
"66","000","00","004","0425","1113","771","378","393","22","793","1275","0","62.2","29.65"
"66","000","00","005","0000","0000","68507","29447","39060","2757","71264","124621","147528","57.18","23.63"
"66","000","00","005","0501","0000","1111","547","564","55","1166","2047","0","56.96","26.72"
"66","000","00","005","0501","0985","537","258","279","31","568","1051","0","54.04","24.55"
"66","000","00","005","0501","0986","574","289","285","24","598","996","0","60.04","29.02"
"66","000","00","005","0502","0000","1927","713","1214","90","2017","3365","0","59.94","21.19"
"66","000","00","005","0502","0987","852","218","634","24","876","1504","0","58.24","14.49"
"66","000","00","005","0502","0988","572","271","301","39","611","975","0","62.67","27.79"
"66","000","00","005","0502","0989","503","224","279","27","530","886","0","59.82","25.28"
"66","000","00","005","0503","0000","728","352","376","54","782","1404","0","55.7","25.07"
"66","000","00","005","0503","0992","728","352","376","54","782","1404","0","55.7","25.07"
"66","000","00","005","0504","0000","851","366","485","32","883","1532","0","57.64","23.89"
"66","000","00","005","0504","0997","401","186","215","13","414","773","0","53.56","24.06"
"66","000","00","005","0504","0998","450","180","270","19","469","759","0","61.79","23.72"
"66","000","00","005","0505","0000","984","464","520","34","1018","1683","0","60.49","27.57"
"66","000","00","005","0505","0995","445","211","234","13","458","704","0","65.06","29.97"
"66","000","00","005","0505","0996","539","253","286","21","560","979","0","57.2","25.84"
"66","000","00","005","0506","0000","1428","404","1024","64","1492","2650","0","56.3","15.25"
"66","000","00","005","0506","0999","805","209","596","40","845","1438","0","58.76","14.53"
"66","000","00","005","0506","1000","623","195","428","24","647","1212","0","53.38","16.09"
"66","000","00","005","0507","0000","1860","747","1113","58","1918","3176","0","60.39","23.52"
"66","000","00","005","0507","1001","977","410","567","36","1013","1731","0","58.52","23.69"
"66","000","00","005","0507","1002","883","337","546","22","905","1445","0","62.63","23.32"
"66","000","00","005","0508","0000","2814","1180","1634","107","2921","5461","0","53.49","21.61"
"66","000","00","005","0508","1003","1027","480","547","33","1060","1855","0","57.14","25.88"
"66","000","00","005","0508","1004","852","328","524","39","891","1728","0","51.56","18.98"
"66","000","00","005","0508","1005","935","372","563","35","970","1878","0","51.65","19.81"
"66","000","00","005","0509","0000","1741","699","1042","54","1795","3340","0","53.74","20.93"
"66","000","00","005","0509","1008","887","357","530","26","913","1761","0","51.85","20.27"
"66","000","00","005","0509","1009","854","342","512","28","882","1579","0","55.86","21.66"
"66","000","00","005","0510","0000","1443","609","834","53","1496","2482","0","60.27","24.54"
"66","000","00","005","0510","1012","839","361","478","25","864","1476","0","58.54","24.46"
"66","000","00","005","0510","1013","604","248","356","28","632","1006","0","62.82","24.65"
"66","000","00","005","0511","0000","2358","993","1365","93","2451","4309","0","56.88","23.04"
"66","000","00","005","0511","1014","784","305","479","36","820","1403","0","58.45","21.74"
"66","000","00","005","0511","1015","773","330","443","28","801","1446","0","55.39","22.82"
"66","000","00","005","0511","1016","801","358","443","29","830","1460","0","56.85","24.52"
"66","000","00","005","0512","0000","1348","525","823","47","1395","2260","0","61.73","23.23"
"66","000","00","005","0512","1017","693","268","425","28","721","1233","0","58.48","21.74"
"66","000","00","005","0512","1018","655","257","398","19","674","1027","0","65.63","25.02"
"66","000","00","005","0513","0000","3254","1494","1760","122","3376","5590","0","60.39","26.73"
"66","000","00","005","0513","1019","701","309","392","16","717","1207","0","59.4","25.6"
"66","000","00","005","0513","1020","698","303","395","29","727","1167","0","62.3","25.96"
"66","000","00","005","0513","1021","662","315","347","25","687","1150","0","59.74","27.39"
"66","000","00","005","0513","1022","592","274","318","32","624","1061","0","58.81","25.82"
"66","000","00","005","0513","1023","601","293","308","20","621","1005","0","61.79","29.15"
"66","000","00","005","0514","0000","2331","1022","1309","101","2432","4077","0","59.65","25.07"
"66","000","00","005","0514","1024","709","299","410","19","728","1250","0","58.24","23.92"
"66","000","00","005","0514","1025","831","397","434","50","881","1448","0","60.84","27.42"
"66","000","00","005","0514","1026","791","326","465","32","823","1379","0","59.68","23.64"
"66","000","00","005","0515","0000","2286","895","1391","90","2376","5070","0","46.86","17.65"
"66","000","00","005","0515","1029","571","236","335","18","589","2078","0","28.34","11.36"
"66","000","00","005","0515","1030","911","333","578","44","955","1562","0","61.14","21.32"
"66","000","00","005","0515","1031","804","326","478","28","832","1430","0","58.18","22.8"
"66","000","00","005","0516","0000","2459","1140","1319","85","2544","4440","0","57.3","25.68"
"66","000","00","005","0516","1045","764","382","382","27","791","1461","0","54.14","26.15"
"66","000","00","005","0516","1046","774","359","415","31","805","1310","0","61.45","27.4"
"66","000","00","005","0516","1047","921","399","522","27","948","1669","0","56.8","23.91"
"66","000","00","005","0517","0000","1995","862","1133","87","2082","3614","0","57.61","23.85"
"66","000","00","005","0517","1048","1072","445","627","58","1130","1932","0","58.49","23.03"
"66","000","00","005","0517","1049","923","417","506","29","952","1682","0","56.6","24.79"
"66","000","00","005","0518","0000","2695","1201","1494","92","2787","4932","0","56.51","24.35"
"66","000","00","005","0518","1050","1021","470","551","25","1046","1891","0","55.31","24.85"
"66","000","00","005","0518","1051","1028","466","562","43","1071","1882","0","56.91","24.76"
"66","000","00","005","0518","1052","646","265","381","24","670","1159","0","57.81","22.86"
"66","000","00","005","0519","0000","1459","633","826","87","1546","2613","0","59.17","24.23"
"66","000","00","005","0519","1068","762","343","419","44","806","1346","0","59.88","25.48"
"66","000","00","005","0519","1069","697","290","407","43","740","1267","0","58.41","22.89"
"66","000","00","005","0520","0000","2018","818","1200","106","2124","3752","0","56.61","21.8"
"66","000","00","005","0520","1010","1126","474","652","61","1187","2192","0","54.15","21.62"
"66","000","00","005","0520","1011","892","344","548","45","937","1560","0","60.06","22.05"
"66","000","00","005","0521","0000","3557","1683","1874","147","3704","6457","0","57.36","26.06"
"66","000","00","005","0521","1053","859","390","469","41","900","1553","0","57.95","25.11"
"66","000","00","005","0521","1054","874","394","480","32","906","1607","0","56.38","24.52"
"66","000","00","005","0521","1055","986","474","512","30","1016","1773","0","57.3","26.73"
"66","000","00","005","0521","1056","838","425","413","44","882","1524","0","57.87","27.89"
"66","000","00","005","0522","0000","3047","1338","1709","122","3169","5282","0","60.0","25.33"
"66","000","00","005","0522","1057","962","452","510","49","1011","1613","0","62.68","28.02"
"66","000","00","005","0522","1058","1075","447","628","38","1113","1877","0","59.3","23.81"
"66","000","00","005","0522","1059","1010","439","571","35","1045","1792","0","58.31","24.5"
"66","000","00","005","0523","0000","3379","1472","1907","108","3487","6037","0","57.76","24.38"
"66","000","00","005","0523","1062","910","381","529","40","950","1556","0","61.05","24.49"
"66","000","00","005","0523","1063","820","350","470","26","846","1497","0","56.51","23.38"
"66","000","00","005","0523","1064","852","374","478","24","876","1550","0","56.52","24.13"
"66","000","00","005","0523","1065","797","367","430","18","815","1434","0","56.83","25.59"
"66","000","00","005","0524","0000","2068","838","1230","74","2142","3734","0","57.36","22.44"
"66","000","00","005","0524","1040","705","297","408","21","726","1243","0","58.41","23.89"
"66","000","00","005","0524","1041","629","207","422","20","649","1219","0","53.24","16.98"
"66","000","00","005","0524","1042","734","334","400","33","767","1272","0","60.3","26.26"
"66","000","00","005","0525","0000","2155","891","1264","80","2235","3777","0","59.17","23.59"
"66","000","00","005","0525","1034","774","306","468","28","802","1432","0","56.01","21.37"
"66","000","00","005","0525","1035","689","316","373","27","716","1157","0","61.88","27.31"
"66","000","00","005","0525","1036","692","269","423","25","717","1188","0","60.35","22.64"
"66","000","00","005","0526","0000","771","388","383","30","801","1437","0","55.74","27.0"
"66","000","00","005","0526","0983","771","388","383","30","801","1437","0","55.74","27.0"
"66","000","00","005","0527","0000","870","418","452","63","933","1708","0","54.63","24.47"
"66","000","00","005","0527","0984","870","418","452","63","933","1708","0","54.63","24.47"
"66","000","00","005","0528","0000","1086","546","540","55","1141","2214","0","51.54","24.66"
"66","000","00","005","0528","0990","594","312","282","29","623","1276","0","48.82","24.45"
"66","000","00","005","0528","0991","492","234","258","26","518","938","0","55.22","24.95"
"66","000","00","005","0529","0000","1030","490","540","49","1079","1865","0","57.86","26.27"
"66","000","00","005","0529","0993","551","232","319","19","570","996","0","57.23","23.29"
"66","000","00","005","0529","0994","479","258","221","30","509","869","0","58.57","29.69"
"66","000","00","005","0530","0000","1820","815","1005","97","1917","3348","0","57.26","24.34"
"66","000","00","005","0530","1006","912","385","527","37","949","1793","0","52.93","21.47"
"66","000","00","005","0530","1007","908","430","478","60","968","1555","0","62.25","27.65"
"66","000","00","005","0531","0000","1921","843","1078","72","1993","3519","0","56.64","23.96"
"66","000","00","005","0531","1027","927","418","509","42","969","1652","0","58.66","25.3"
"66","000","00","005","0531","1028","994","425","569","30","1024","1867","0","54.85","22.76"
"66","000","00","005","0532","0000","2386","1006","1380","82","2468","4305","0","57.33","23.37"
"66","000","00","005","0532","1037","794","324","470","23","817","1419","0","57.58","22.83"
"66","000","00","005","0532","1038","892","376","516","27","919","1653","0","55.6","22.75"
"66","000","00","005","0532","1039","700","306","394","32","732","1233","0","59.37","24.82"
"66","000","00","005","0533","0000","1529","671","858","72","1601","2689","0","59.54","24.95"
"66","000","00","005","0533","1060","803","339","464","42","845","1392","0","60.7","24.35"
"66","000","00","005","0533","1061","726","332","394","30","756","1297","0","58.29","25.6"
"66","000","00","005","0534","0000","2010","817","1193","83","2093","3659","0","57.2","22.33"
"66","000","00","005","0534","1066","990","405","585","44","1034","1793","0","57.67","22.59"
"66","000","00","005","0534","1067","1020","412","608","39","1059","1866","0","56.75","22.08"
"66","000","00","005","0535","0000","1773","739","1034","49","1822","3065","0","59.45","24.11"
"66","000","00","005","0535","1043","746","308","438","22","768","1285","0","59.77","23.97"
"66","000","00","005","0535","1044","1027","431","596","27","1054","1780","0","59.21","24.21"
"66","000","00","005","0536","0000","2015","828","1187","63","2078","3728","0","55.74","22.21"
"66","000","00","005","0536","1032","1150","454","696","38","1188","2018","0","58.87","22.5"
"66","000","00","005","0536","1033","865","374","491","25","890","1710","0","52.05","21.87"
"66","000","00","006","0000","0000","103175","42283","60892","4271","107446","183814","228128","58.45","23.0"
"66","000","00","006","0601","0000","2728","1187","1541","105","2833","4749","0","59.65","24.99"
"66","000","00","006","0601","0625","989","437","552","34","1023","1638","0","62.45","26.68"
"66","000","00","006","0601","0626","717","353","364","30","747","1335","0","55.96","26.44"
"66","000","00","006","0601","0627","1022","397","625","41","1063","1776","0","59.85","22.35"
"66","000","00","006","0602","0000","2894","1195","1699","124","3018","5323","0","56.7","22.45"
"66","000","00","006","0602","0634","964","438","526","43","1007","1749","0","57.58","25.04"
"66","000","00","006","0602","0635","1030","375","655","46","1076","1877","0","57.33","19.98"
"66","000","00","006","0602","0636","900","382","518","35","935","1697","0","55.1","22.51"
"66","000","00","006","0603","0000","2713","1144","1569","93","2806","5447","0","51.51","21.0"
"66","000","00","006","0603","0637","876","326","550","34","910","1480","0","61.49","22.03"
"66","000","00","006","0603","0638","941","448","493","34","975","1483","0","65.75","30.21"
"66","000","00","006","0603","0639","896","370","526","25","921","2484","0","37.08","14.9"
"66","000","00","006","0604","0000","497","259","238","32","529","781","0","67.73","33.16"
"66","000","00","006","0604","0640","497","259","238","32","529","781","0","67.73","33.16"
"66","000","00","006","0605","0000","7438","2885","4553","244","7682","13148","0","58.43","21.94"
"66","000","00","006","0605","0641","863","346","517","37","900","1477","0","60.93","23.43"
"66","000","00","006","0605","0642","965","384","581","43","1008","1784","0","56.5","21.52"
"66","000","00","006","0605","0643","941","343","598","29","970","1686","0","57.53","20.34"
"66","000","00","006","0605","0644","944","374","570","30","974","1692","0","57.57","22.1"
"66","000","00","006","0605","0645","883","315","568","25","908","1659","0","54.73","18.99"
"66","000","00","006","0605","0646","959","376","583","19","978","1648","0","59.34","22.82"
"66","000","00","006","0605","0647","919","392","527","27","946","1536","0","61.59","25.52"
"66","000","00","006","0605","0648","964","355","609","34","998","1666","0","59.9","21.31"
"66","000","00","006","0606","0000","2628","1049","1579","118","2746","4812","0","57.07","21.8"
"66","000","00","006","0606","0649","813","325","488","45","858","1428","0","60.08","22.76"
"66","000","00","006","0606","0650","945","398","547","46","991","1810","0","54.75","21.99"
"66","000","00","006","0606","0651","870","326","544","27","897","1574","0","56.99","20.71"
"66","000","00","006","0607","0000","2436","1009","1427","97","2533","4314","0","58.72","23.39"
"66","000","00","006","0607","0658","949","392","557","33","982","1714","0","57.29","22.87"
"66","000","00","006","0607","0659","811","335","476","37","848","1424","0","59.55","23.53"
"66","000","00","006","0607","0660","676","282","394","27","703","1176","0","59.78","23.98"
"66","000","00","006","0608","0000","1626","364","1262","77","1703","2739","0","62.18","13.29"
"66","000","00","006","0608","0665","786","182","604","56","842","1355","0","62.14","13.43"
"66","000","00","006","0608","0666","840","182","658","21","861","1384","0","62.21","13.15"
"66","000","00","006","0609","0000","2670","1135","1535","132","2802","5068","0","55.29","22.4"
"66","000","00","006","0609","0679","917","407","510","55","972","1699","0","57.21","23.96"
"66","000","00","006","0609","0680","886","370","516","35","921","1715","0","53.7","21.57"
"66","000","00","006","0609","0681","867","358","509","42","909","1654","0","54.96","21.64"
"66","000","00","006","0610","0000","1820","799","1021","69","1889","3175","0","59.5","25.17"
"66","000","00","006","0610","0667","937","400","537","35","972","1613","0","60.26","24.8"
"66","000","00","006","0610","0668","883","399","484","34","917","1562","0","58.71","25.54"
"66","000","00","006","0611","0000","2303","1110","1193","122","2425","3774","0","64.26","29.41"
"66","000","00","006","0611","0695","727","344","383","33","760","1221","0","62.24","28.17"
"66","000","00","006","0611","0696","802","408","394","48","850","1252","0","67.89","32.59"
"66","000","00","006","0611","0697","774","358","416","41","815","1301","0","62.64","27.52"
"66","000","00","006","0612","0000","1280","281","999","71","1351","2162","0","62.49","13.0"
"66","000","00","006","0612","0698","642","155","487","28","670","1049","0","63.87","14.78"
"66","000","00","006","0612","0699","638","126","512","43","681","1113","0","61.19","11.32"
"66","000","00","006","0613","0000","1715","666","1049","64","1779","3197","0","55.65","20.83"
"66","000","00","006","0613","0700","831","296","535","30","861","1557","0","55.3","19.01"
"66","000","00","006","0613","0701","884","370","514","34","918","1640","0","55.98","22.56"
"66","000","00","006","0614","0000","2652","1084","1568","162","2814","4807","0","58.54","22.55"
"66","000","00","006","0614","0702","891","413","478","48","939","1402","0","66.98","29.46"
"66","000","00","006","0614","0703","849","328","521","64","913","1717","0","53.17","19.1"
"66","000","00","006","0614","0704","912","343","569","50","962","1688","0","56.99","20.32"
"66","000","00","006","0615","0000","2694","1108","1586","65","2759","4904","0","56.26","22.59"
"66","000","00","006","0615","0705","698","323","375","26","724","1168","0","61.99","27.65"
"66","000","00","006","0615","0706","948","367","581","7","955","1729","0","55.23","21.23"
"66","000","00","006","0615","0707","1048","418","630","32","1080","2007","0","53.81","20.83"
"66","000","00","006","0616","0000","1289","633","656","81","1370","2364","0","57.95","26.78"
"66","000","00","006","0616","0708","743","361","382","58","801","1296","0","61.81","27.85"
"66","000","00","006","0616","0709","546","272","274","23","569","1068","0","53.28","25.47"
"66","000","00","006","0617","0000","1787","696","1091","106","1893","3343","0","56.63","20.82"
"66","000","00","006","0617","0710","846","338","508","66","912","1707","0","53.43","19.8"
"66","000","00","006","0617","0711","941","358","583","40","981","1636","0","59.96","21.88"
"66","000","00","006","0618","0000","6577","2728","3849","271","6848","12239","0","55.95","22.29"
"66","000","00","006","0618","0712","871","445","426","33","904","1761","0","51.33","25.27"
"66","000","00","006","0618","0713","746","323","423","38","784","1314","0","59.67","24.58"
"66","000","00","006","0618","0714","755","288","467","39","794","1233","0","64.4","23.36"
"66","000","00","006","0618","0715","835","362","473","36","871","1549","0","56.23","23.37"
"66","000","00","006","0618","0716","866","334","532","30","896","1639","0","54.67","20.38"
"66","000","00","006","0618","0717","776","271","505","45","821","1486","0","55.25","18.24"
"66","000","00","006","0618","0718","959","398","561","27","986","1806","0","54.6","22.04"
"66","000","00","006","0618","0719","769","307","462","23","792","1451","0","54.58","21.16"
"66","000","00","006","0619","0000","1573","693","880","61","1634","2655","0","61.54","26.1"
"66","000","00","006","0619","0720","764","321","443","21","785","1302","0","60.29","24.65"
"66","000","00","006","0619","0721","809","372","437","40","849","1353","0","62.75","27.49"
"66","000","00","006","0620","0000","2596","1187","1409","135","2731","4520","0","60.42","26.26"
"66","000","00","006","0620","0741","629","301","328","43","672","1206","0","55.72","24.96"
"66","000","00","006","0620","0742","664","334","330","32","696","1086","0","64.09","30.76"
"66","000","00","006","0620","0743","653","277","376","32","685","1088","0","62.96","25.46"
"66","000","00","006","0620","0744","650","275","375","28","678","1140","0","59.47","24.12"
"66","000","00","006","0621","0000","3478","1578","1900","104","3582","6178","0","57.98","25.54"
"66","000","00","006","0621","0682","890","386","504","23","913","1636","0","55.81","23.59"
"66","000","00","006","0621","0683","703","334","369","21","724","1298","0","55.78","25.73"
"66","000","00","006","0621","0684","828","405","423","15","843","1391","0","60.6","29.12"
"66","000","00","006","0621","0685","1057","453","604","45","1102","1853","0","59.47","24.45"
"66","000","00","006","0622","0000","2003","852","1151","91","2094","3629","0","57.7","23.48"
"66","000","00","006","0622","0686","984","400","584","46","1030","1820","0","56.59","21.98"
"66","000","00","006","0622","0687","1019","452","567","45","1064","1809","0","58.82","24.99"
"66","000","00","006","0623","0000","3730","1481","2249","153","3883","6663","0","58.28","22.23"
"66","000","00","006","0623","0691","955","402","553","35","990","1674","0","59.14","24.01"
"66","000","00","006","0623","0692","943","398","545","49","992","1610","0","61.61","24.72"
"66","000","00","006","0623","0693","919","346","573","38","957","1695","0","56.46","20.41"
"66","000","00","006","0623","0694","913","335","578","31","944","1684","0","56.06","19.89"
"66","000","00","006","0624","0000","2608","938","1670","125","2733","4890","0","55.89","19.18"
"66","000","00","006","0624","0631","882","299","583","38","920","1710","0","53.8","17.49"
"66","000","00","006","0624","0632","823","357","466","42","865","1595","0","54.23","22.38"
"66","000","00","006","0624","0633","903","282","621","45","948","1585","0","59.81","17.79"
"66","000","00","006","0625","0000","2491","1074","1417","88","2579","4205","0","61.33","25.54"
"66","000","00","006","0625","0672","907","415","492","37","944","1494","0","63.19","27.78"
"66","000","00","006","0625","0673","775","296","479","24","799","1325","0","60.3","22.34"
"66","000","00","006","0625","0674","809","363","446","27","836","1386","0","60.32","26.19"
"66","000","00","006","0626","0000","2467","961","1506","95","2562","4271","0","59.99","22.5"
"66","000","00","006","0626","0628","760","305","455","32","792","1351","0","58.62","22.58"
"66","000","00","006","0626","0629","791","317","474","39","830","1338","0","62.03","23.69"
"66","000","00","006","0626","0630","916","339","577","24","940","1582","0","59.42","21.43"
"66","000","00","006","0627","0000","2795","1134","1661","90","2885","4987","0","57.85","22.74"
"66","000","00","006","0627","0652","936","358","578","27","963","1650","0","58.36","21.7"
"66","000","00","006","0627","0653","941","411","530","34","975","1681","0","58.0","24.45"
"66","000","00","006","0627","0654","918","365","553","29","947","1656","0","57.19","22.04"
"66","000","00","006","0628","0000","2506","991","1515","115","2621","4145","0","63.23","23.91"
"66","000","00","006","0628","0655","723","273","450","44","767","1243","0","61.71","21.96"
"66","000","00","006","0628","0656","913","377","536","39","952","1471","0","64.72","25.63"
"66","000","00","006","0628","0657","870","341","529","32","902","1431","0","63.03","23.83"
"66","000","00","006","0629","0000","3149","1230","1919","145","3294","5327","0","61.84","23.09"
"66","000","00","006","0629","0661","834","335","499","46","880","1456","0","60.44","23.01"
"66","000","00","006","0629","0662","880","322","558","32","912","1451","0","62.85","22.19"
"66","000","00","006","0629","0663","674","253","421","28","702","1063","0","66.04","23.8"
"66","000","00","006","0629","0664","761","320","441","39","800","1357","0","58.95","23.58"
"66","000","00","006","0630","0000","2119","968","1151","111","2230","3585","0","62.2","27.0"
"66","000","00","006","0630","0669","766","362","404","40","806","1219","0","66.12","29.7"
"66","000","00","006","0630","0670","709","318","391","36","745","1235","0","60.32","25.75"
"66","000","00","006","0630","0671","644","288","356","35","679","1131","0","60.04","25.46"
"66","000","00","006","0631","0000","3944","1660","2284","170","4114","7145","0","57.58","23.23"
"66","000","00","006","0631","0675","1042","442","600","40","1082","1816","0","59.58","24.34"
"66","000","00","006","0631","0676","921","396","525","40","961","1734","0","55.42","22.84"
"66","000","00","006","0631","0677","1031","438","593","42","1073","1777","0","60.38","24.65"
"66","000","00","006","0631","0678","950","384","566","48","998","1818","0","54.9","21.12"
"66","000","00","006","0632","0000","2562","1106","1456","97","2659","4359","0","61.0","25.37"
"66","000","00","006","0632","0688","815","346","469","32","847","1352","0","62.65","25.59"
"66","000","00","006","0632","0689","868","381","487","31","899","1521","0","59.11","25.05"
"66","000","00","006","0632","0690","879","379","500","34","913","1486","0","61.44","25.5"
"66","000","00","006","0633","0000","2529","1195","1334","126","2655","4285","0","61.96","27.89"
"66","000","00","006","0633","0733","871","422","449","46","917","1526","0","60.09","27.65"
"66","000","00","006","0633","0734","864","427","437","41","905","1425","0","63.51","29.96"
"66","000","00","006","0633","0735","794","346","448","39","833","1334","0","62.44","25.94"
"66","000","00","006","0634","0000","1839","769","1070","64","1903","3215","0","59.19","23.92"
"66","000","00","006","0634","0736","975","393","582","36","1011","1649","0","61.31","23.83"
"66","000","00","006","0634","0737","864","376","488","28","892","1566","0","56.96","24.01"
"66","000","00","006","0635","0000","2773","1158","1615","98","2871","4699","0","61.1","24.64"
"66","000","00","006","0635","0738","964","373","591","33","997","1629","0","61.2","22.9"
"66","000","00","006","0635","0739","941","443","498","32","973","1628","0","59.77","27.21"
"66","000","00","006","0635","0740","868","342","526","33","901","1442","0","62.48","23.72"
"66","000","00","006","0636","0000","1530","625","905","69","1599","3043","0","52.55","20.54"
"66","000","00","006","0636","0731","732","278","454","27","759","1541","0","49.25","18.04"
"66","000","00","006","0636","0732","798","347","451","42","840","1502","0","55.93","23.1"
"66","000","00","006","0637","0000","1602","617","985","57","1659","2917","0","56.87","21.15"
"66","000","00","006","0637","0729","788","314","474","29","817","1402","0","58.27","22.4"
"66","000","00","006","0637","0730","814","303","511","28","842","1515","0","55.58","20.0"
"66","000","00","006","0638","0000","4022","1556","2466","145","4167","7133","0","58.42","21.81"
"66","000","00","006","0638","0725","1010","385","625","42","1052","1847","0","56.96","20.84"
"66","000","00","006","0638","0726","979","409","570","32","1011","1738","0","58.17","23.53"
"66","000","00","006","0638","0727","970","394","576","38","1008","1640","0","61.46","24.02"
"66","000","00","006","0638","0728","1063","368","695","33","1096","1908","0","57.44","19.29"
"66","000","00","006","0639","0000","3112","1178","1934","99","3211","5617","0","57.17","20.97"
"66","000","00","006","0639","0722","1233","495","738","31","1264","2162","0","58.46","22.9"
"66","000","00","006","0639","0723","825","301","524","42","867","1520","0","57.04","19.8"
"66","000","00","006","0639","0724","1054","382","672","26","1080","1935","0","55.81","19.74"
"66","000","00","007","0000","0000","79080","33372","45708","3333","82413","135448","170160","60.84","24.64"
"66","000","00","007","0701","0000","4992","2167","2825","194","5186","8349","0","62.12","25.96"
"66","000","00","007","0701","0745","788","362","426","31","819","1321","0","62.0","27.4"
"66","000","00","007","0701","0746","798","395","403","47","845","1346","0","62.78","29.35"
"66","000","00","007","0701","0747","859","388","471","36","895","1428","0","62.68","27.17"
"66","000","00","007","0701","0748","815","349","466","35","850","1442","0","58.95","24.2"
"66","000","00","007","0701","0749","888","355","533","23","911","1408","0","64.7","25.21"
"66","000","00","007","0701","0750","844","318","526","22","866","1404","0","61.68","22.65"
"66","000","00","007","0702","0000","6628","2907","3721","260","6888","10909","0","63.14","26.65"
"66","000","00","007","0702","0751","832","376","456","32","864","1354","0","63.81","27.77"
"66","000","00","007","0702","0752","792","325","467","47","839","1332","0","62.99","24.4"
"66","000","00","007","0702","0753","903","329","574","23","926","1463","0","63.29","22.49"
"66","000","00","007","0702","0754","813","356","457","43","856","1413","0","60.58","25.19"
"66","000","00","007","0702","0755","775","354","421","29","804","1218","0","66.01","29.06"
"66","000","00","007","0702","0756","776","368","408","25","801","1308","0","61.24","28.13"
"66","000","00","007","0702","0757","938","449","489","34","972","1527","0","63.65","29.4"
"66","000","00","007","0702","0758","799","350","449","27","826","1294","0","63.83","27.05"
"66","000","00","007","0703","0000","3255","1353","1902","188","3443","5848","0","58.87","23.14"
"66","000","00","007","0703","0759","787","301","486","33","820","1516","0","54.09","19.85"
"66","000","00","007","0703","0760","887","376","511","66","953","1529","0","62.33","24.59"
"66","000","00","007","0703","0761","815","360","455","49","864","1397","0","61.85","25.77"
"66","000","00","007","0703","0762","766","316","450","40","806","1406","0","57.33","22.48"
"66","000","00","007","0704","0000","2299","1119","1180","135","2434","4409","0","55.21","25.38"
"66","000","00","007","0704","0763","801","372","429","37","838","1497","0","55.98","24.85"
"66","000","00","007","0704","0764","763","372","391","65","828","1424","0","58.15","26.12"
"66","000","00","007","0704","0765","735","375","360","33","768","1488","0","51.61","25.2"
"66","000","00","007","0705","0000","3306","1357","1949","155","3461","6387","0","54.19","21.25"
"66","000","00","007","0705","0768","702","306","396","37","739","1190","0","62.1","25.71"
"66","000","00","007","0705","0769","648","258","390","35","683","1174","0","58.18","21.98"
"66","000","00","007","0705","0770","710","297","413","16","726","1224","0","59.31","24.26"
"66","000","00","007","0705","0771","700","281","419","43","743","1466","0","50.68","19.17"
"66","000","00","007","0705","0772","546","215","331","24","570","1333","0","42.76","16.13"
"66","000","00","007","0706","0000","476","206","270","44","520","814","0","63.88","25.31"
"66","000","00","007","0706","0773","476","206","270","44","520","814","0","63.88","25.31"
"66","000","00","007","0707","0000","5319","2200","3119","261","5580","9662","0","57.75","22.77"
"66","000","00","007","0707","0774","746","303","443","48","794","1436","0","55.29","21.1"
"66","000","00","007","0707","0775","865","365","500","44","909","1515","0","60.0","24.09"
"66","000","00","007","0707","0776","771","327","444","26","797","1545","0","51.59","21.17"
"66","000","00","007","0707","0777","781","305","476","38","819","1383","0","59.22","22.05"
"66","000","00","007","0707","0778","834","364","470","34","868","1433","0","60.57","25.4"
"66","000","00","007","0707","0779","596","262","334","31","627","1134","0","55.29","23.1"
"66","000","00","007","0707","0780","726","274","452","40","766","1216","0","62.99","22.53"
"66","000","00","007","0708","0000","784","358","426","35","819","1397","0","58.63","25.63"
"66","000","00","007","0708","0785","784","358","426","35","819","1397","0","58.63","25.63"
"66","000","00","007","0709","0000","2716","1180","1536","130","2846","4800","0","59.29","24.58"
"66","000","00","007","0709","0786","865","401","464","52","917","1607","0","57.06","24.95"
"66","000","00","007","0709","0787","918","423","495","40","958","1582","0","60.56","26.74"
"66","000","00","007","0709","0788","933","356","577","38","971","1611","0","60.27","22.1"
"66","000","00","007","0710","0000","4028","1623","2405","141","4169","6621","0","62.97","24.51"
"66","000","00","007","0710","0789","812","344","468","29","841","1322","0","63.62","26.02"
"66","000","00","007","0710","0790","841","347","494","26","867","1321","0","65.63","26.27"
"66","000","00","007","0710","0791","797","324","473","39","836","1360","0","61.47","23.82"
"66","000","00","007","0710","0792","820","315","505","15","835","1361","0","61.35","23.14"
"66","000","00","007","0710","0793","758","293","465","32","790","1257","0","62.85","23.31"
"66","000","00","007","0711","0000","3140","1346","1794","127","3267","5151","0","63.42","26.13"
"66","000","00","007","0711","0809","725","304","421","29","754","1171","0","64.39","25.96"
"66","000","00","007","0711","0810","772","352","420","40","812","1349","0","60.19","26.09"
"66","000","00","007","0711","0811","856","373","483","24","880","1368","0","64.33","27.27"
"66","000","00","007","0711","0812","787","317","470","34","821","1263","0","65.0","25.1"
"66","000","00","007","0712","0000","3636","1719","1917","134","3770","6052","0","62.29","28.4"
"66","000","00","007","0712","0822","1020","535","485","26","1046","1544","0","67.75","34.65"
"66","000","00","007","0712","0823","945","452","493","33","978","1482","0","65.99","30.5"
"66","000","00","007","0712","0824","884","393","491","46","930","1488","0","62.5","26.41"
"66","000","00","007","0712","0825","787","339","448","29","816","1538","0","53.06","22.04"
"66","000","00","007","0713","0000","2667","1032","1635","107","2774","4239","0","65.44","24.35"
"66","000","00","007","0713","0805","669","253","416","24","693","981","0","70.64","25.79"
"66","000","00","007","0713","0806","665","237","428","39","704","1097","0","64.18","21.6"
"66","000","00","007","0713","0807","630","252","378","19","649","991","0","65.49","25.43"
"66","000","00","007","0713","0808","703","290","413","25","728","1170","0","62.22","24.79"
"66","000","00","007","0714","0000","893","463","430","57","950","1421","0","66.85","32.58"
"66","000","00","007","0714","0766","390","191","199","20","410","608","0","67.43","31.41"
"66","000","00","007","0714","0767","503","272","231","37","540","813","0","66.42","33.46"
"66","000","00","007","0715","0000","2908","1303","1605","103","3011","4733","0","63.62","27.53"
"66","000","00","007","0715","0836","769","329","440","22","791","1278","0","61.89","25.74"
"66","000","00","007","0715","0837","733","355","378","28","761","1144","0","66.52","31.03"
"66","000","00","007","0715","0838","694","316","378","22","716","1140","0","62.81","27.72"
"66","000","00","007","0715","0839","712","303","409","31","743","1171","0","63.45","25.88"
"66","000","00","007","0716","0000","2202","905","1297","98","2300","3673","0","62.62","24.64"
"66","000","00","007","0716","0829","749","293","456","40","789","1217","0","64.83","24.08"
"66","000","00","007","0716","0830","775","344","431","31","806","1347","0","59.84","25.54"
"66","000","00","007","0716","0831","678","268","410","27","705","1109","0","63.57","24.17"
"66","000","00","007","0717","0000","2990","1266","1724","125","3115","5144","0","60.56","24.61"
"66","000","00","007","0717","0832","878","358","520","27","905","1546","0","58.54","23.16"
"66","000","00","007","0717","0833","874","358","516","32","906","1408","0","64.35","25.43"
"66","000","00","007","0717","0834","581","264","317","28","609","1057","0","57.62","24.98"
"66","000","00","007","0717","0835","657","286","371","38","695","1133","0","61.34","25.24"
"66","000","00","007","0718","0000","2741","1177","1564","110","2851","5184","0","55.0","22.7"
"66","000","00","007","0718","0826","1022","456","566","39","1061","1674","0","63.38","27.24"
"66","000","00","007","0718","0827","847","358","489","19","866","1996","0","43.39","17.94"
"66","000","00","007","0718","0828","872","363","509","52","924","1514","0","61.03","23.98"
"66","000","00","007","0719","0000","2162","935","1227","100","2262","3517","0","64.32","26.59"
"66","000","00","007","0719","0843","703","321","382","33","736","1139","0","64.62","28.18"
"66","000","00","007","0719","0844","752","331","421","31","783","1216","0","64.39","27.22"
"66","000","00","007","0719","0845","707","283","424","36","743","1162","0","63.94","24.35"
"66","000","00","007","0720","0000","2480","1029","1451","89","2569","4276","0","60.08","24.06"
"66","000","00","007","0720","0840","817","327","490","23","840","1303","0","64.47","25.1"
"66","000","00","007","0720","0841","788","354","434","25","813","1402","0","57.99","25.25"
"66","000","00","007","0720","0842","875","348","527","41","916","1571","0","58.31","22.15"
"66","000","00","007","0721","0000","3624","1482","2142","138","3762","6405","0","58.74","23.14"
"66","000","00","007","0721","0813","925","355","570","39","964","1547","0","62.31","22.95"
"66","000","00","007","0721","0814","953","397","556","40","993","1649","0","60.22","24.08"
"66","000","00","007","0721","0815","913","363","550","30","943","1629","0","57.89","22.28"
"66","000","00","007","0721","0816","833","367","466","29","862","1580","0","54.56","23.23"
"66","000","00","007","0722","0000","4243","1773","2470","129","4372","7096","0","61.61","24.99"
"66","000","00","007","0722","0817","920","385","535","28","948","1444","0","65.65","26.66"
"66","000","00","007","0722","0818","833","352","481","10","843","1413","0","59.66","24.91"
"66","000","00","007","0722","0819","773","288","485","27","800","1377","0","58.1","20.92"
"66","000","00","007","0722","0820","902","418","484","35","937","1527","0","61.36","27.37"
"66","000","00","007","0722","0821","815","330","485","29","844","1335","0","63.22","24.72"
"66","000","00","007","0723","0000","2840","1239","1601","157","2997","5132","0","58.4","24.14"
"66","000","00","007","0723","0781","697","330","367","44","741","1271","0","58.3","25.96"
"66","000","00","007","0723","0782","647","279","368","26","673","1203","0","55.94","23.19"
"66","000","00","007","0723","0783","710","290","420","37","747","1268","0","58.91","22.87"
"66","000","00","007","0723","0784","786","340","446","50","836","1390","0","60.14","24.46"
"66","000","00","007","0724","0000","4840","1713","3127","185","5025","7974","0","63.02","21.48"
"66","000","00","007","0724","0799","665","220","445","40","705","1102","0","63.97","19.96"
"66","000","00","007","0724","0800","1011","321","690","44","1055","1630","0","64.72","19.69"
"66","000","00","007","0724","0801","799","287","512","34","833","1333","0","62.49","21.53"
"66","000","00","007","0724","0802","801","295","506","20","821","1292","0","63.54","22.83"
"66","000","00","007","0724","0803","765","284","481","28","793","1272","0","62.34","22.33"
"66","000","00","007","0724","0804","799","306","493","19","818","1345","0","60.82","22.75"
"66","000","00","007","0725","0000","3911","1520","2391","131","4042","6255","0","64.62","24.3"
"66","000","00","007","0725","0794","764","282","482","26","790","1207","0","65.45","23.36"
"66","000","00","007","0725","0795","806","299","507","18","824","1282","0","64.27","23.32"
"66","000","00","007","0725","0796","789","317","472","37","826","1248","0","66.19","25.4"
"66","000","00","007","0725","0797","833","326","507","23","856","1304","0","65.64","25.0"
"66","000","00","007","0725","0798","719","296","423","27","746","1214","0","61.45","24.38"
"66","000","00","008","0000","0000","126974","52336","74638","4910","131884","227720","278096","57.91","22.98"
"66","000","00","008","0801","0000","1701","668","1033","62","1763","3258","0","54.11","20.5"
"66","000","00","008","0801","0850","585","227","358","15","600","1107","0","54.2","20.51"
"66","000","00","008","0801","0851","1116","441","675","47","1163","2151","0","54.07","20.5"
"66","000","00","008","0802","0000","2021","755","1266","71","2092","3376","0","61.97","22.36"
"66","000","00","008","0802","0846","1017","398","619","35","1052","1670","0","62.99","23.83"
"66","000","00","008","0802","0847","1004","357","647","36","1040","1706","0","60.96","20.93"
"66","000","00","008","0803","0000","3929","1799","2130","101","4030","7049","0","57.17","25.52"
"66","000","00","008","0803","0852","968","544","424","21","989","1612","0","61.35","33.75"
"66","000","00","008","0803","0853","973","399","574","26","999","1743","0","57.31","22.89"
"66","000","00","008","0803","0854","1080","460","620","35","1115","2099","0","53.12","21.92"
"66","000","00","008","0803","0855","908","396","512","19","927","1595","0","58.12","24.83"
"66","000","00","008","0804","0000","3164","1391","1773","113","3277","5567","0","58.86","24.99"
"66","000","00","008","0804","0924","899","413","486","25","924","1640","0","56.34","25.18"
"66","000","00","008","0804","0925","1175","522","653","64","1239","2052","0","60.38","25.44"
"66","000","00","008","0804","0926","1090","456","634","24","1114","1875","0","59.41","24.32"
"66","000","00","008","0805","0000","2869","1141","1728","104","2973","5056","0","58.8","22.57"
"66","000","00","008","0805","0943","978","395","583","35","1013","1661","0","60.99","23.78"
"66","000","00","008","0805","0944","946","390","556","26","972","1667","0","58.31","23.4"
"66","000","00","008","0805","0945","945","356","589","43","988","1728","0","57.18","20.6"
"66","000","00","008","0806","0000","2363","1131","1232","74","2437","4533","0","53.76","24.95"
"66","000","00","008","0806","0860","825","480","345","25","850","1563","0","54.38","30.71"
"66","000","00","008","0806","0861","814","375","439","36","850","1559","0","54.52","24.05"
"66","000","00","008","0806","0862","724","276","448","13","737","1411","0","52.23","19.56"
"66","000","00","008","0807","0000","3347","1451","1896","131","3478","5930","0","58.65","24.47"
"66","000","00","008","0807","0894","843","358","485","42","885","1445","0","61.25","24.78"
"66","000","00","008","0807","0895","961","403","558","31","992","1842","0","53.85","21.88"
"66","000","00","008","0807","0896","692","296","396","30","722","1187","0","60.83","24.94"
"66","000","00","008","0807","0897","851","394","457","28","879","1456","0","60.37","27.06"
"66","000","00","008","0808","0000","7556","3240","4316","306","7862","12981","0","60.57","24.96"
"66","000","00","008","0808","0863","1013","398","615","33","1046","1761","0","59.4","22.6"
"66","000","00","008","0808","0864","829","354","475","34","863","1361","0","63.41","26.01"
"66","000","00","008","0808","0865","1012","423","589","63","1075","1852","0","58.05","22.84"
"66","000","00","008","0808","0866","1099","446","653","41","1140","1928","0","59.13","23.13"
"66","000","00","008","0808","0867","948","393","555","26","974","1492","0","65.28","26.34"
"66","000","00","008","0808","0868","1063","445","618","47","1110","1998","0","55.56","22.27"
"66","000","00","008","0808","0869","802","350","452","31","833","1272","0","65.49","27.52"
"66","000","00","008","0808","0870","790","431","359","31","821","1317","0","62.34","32.73"
"66","000","00","008","0809","0000","6457","2742","3715","267","6724","11817","0","56.9","23.2"
"66","000","00","008","0809","0871","675","337","338","47","722","1327","0","54.41","25.4"
"66","000","00","008","0809","0872","690","344","346","21","711","1280","0","55.55","26.88"
"66","000","00","008","0809","0873","962","387","575","33","995","1865","0","53.35","20.75"
"66","000","00","008","0809","0874","756","301","455","33","789","1230","0","64.15","24.47"
"66","000","00","008","0809","0875","726","295","431","27","753","1356","0","55.53","21.76"
"66","000","00","008","0809","0876","951","360","591","45","996","1732","0","57.51","20.79"
"66","000","00","008","0809","0877","907","381","526","33","940","1586","0","59.27","24.02"
"66","000","00","008","0809","0878","790","337","453","28","818","1441","0","56.77","23.39"
"66","000","00","008","0810","0000","5304","2091","3213","180","5484","9996","0","54.86","20.92"
"66","000","00","008","0810","0879","1075","471","604","45","1120","2045","0","54.77","23.03"
"66","000","00","008","0810","0880","980","436","544","34","1014","1914","0","52.98","22.78"
"66","000","00","008","0810","0881","1065","430","635","38","1103","1918","0","57.51","22.42"
"66","000","00","008","0810","0882","1059","285","774","25","1084","2079","0","52.14","13.71"
"66","000","00","008","0810","0883","1125","469","656","38","1163","2040","0","57.01","22.99"
"66","000","00","008","0811","0000","1015","468","547","37","1052","2037","0","51.64","22.97"
"66","000","00","008","0811","0890","1015","468","547","37","1052","2037","0","51.64","22.97"
"66","000","00","008","0812","0000","555","231","324","33","588","985","0","59.7","23.45"
"66","000","00","008","0812","0889","555","231","324","33","588","985","0","59.7","23.45"
"66","000","00","008","0813","0000","4929","2007","2922","166","5095","9749","0","52.26","20.59"
"66","000","00","008","0813","0884","981","383","598","30","1011","2027","0","49.88","18.89"
"66","000","00","008","0813","0885","764","315","449","32","796","1402","0","56.78","22.47"
"66","000","00","008","0813","0886","1041","442","599","42","1083","1826","0","59.31","24.21"
"66","000","00","008","0813","0887","1063","416","647","34","1097","2162","0","50.74","19.24"
"66","000","00","008","0813","0888","1080","451","629","28","1108","2332","0","47.51","19.34"
"66","000","00","008","0814","0000","1204","527","677","57","1261","2094","0","60.22","25.17"
"66","000","00","008","0814","0891","614","291","323","24","638","1032","0","61.82","28.2"
"66","000","00","008","0814","0892","590","236","354","33","623","1062","0","58.66","22.22"
"66","000","00","008","0815","0000","493","212","281","35","528","909","0","58.09","23.32"
"66","000","00","008","0815","0893","493","212","281","35","528","909","0","58.09","23.32"
"66","000","00","008","0816","0000","4650","1823","2827","220","4870","8139","0","59.84","22.4"
"66","000","00","008","0816","0915","849","349","500","41","890","1458","0","61.04","23.94"
"66","000","00","008","0816","0916","932","387","545","35","967","1571","0","61.55","24.63"
"66","000","00","008","0816","0917","884","357","527","67","951","1579","0","60.23","22.61"
"66","000","00","008","0816","0918","1056","402","654","41","1097","1849","0","59.33","21.74"
"66","000","00","008","0816","0919","929","328","601","36","965","1682","0","57.37","19.5"
"66","000","00","008","0817","0000","4350","1792","2558","164","4514","8903","0","50.7","20.13"
"66","000","00","008","0817","0949","1186","518","668","53","1239","2078","0","59.62","24.93"
"66","000","00","008","0817","0950","1115","434","681","41","1156","2059","0","56.14","21.08"
"66","000","00","008","0817","0951","1017","427","590","39","1056","1792","0","58.93","23.83"
"66","000","00","008","0817","0952","1032","413","619","31","1063","2974","0","35.74","13.89"
"66","000","00","008","0818","0000","4712","1945","2767","169","4881","7936","0","61.5","24.51"
"66","000","00","008","0818","0954","1243","443","800","32","1275","2099","0","60.74","21.11"
"66","000","00","008","0818","0955","1151","538","613","45","1196","1823","0","65.61","29.51"
"66","000","00","008","0818","0956","1192","505","687","60","1252","2022","0","61.92","24.98"
"66","000","00","008","0818","0957","1126","459","667","32","1158","1992","0","58.13","23.04"
"66","000","00","008","0819","0000","943","437","506","44","987","1585","0","62.27","27.57"
"66","000","00","008","0819","0958","943","437","506","44","987","1585","0","62.27","27.57"
"66","000","00","008","0820","0000","5719","2137","3582","207","5926","9652","0","61.4","22.14"
"66","000","00","008","0820","0962","1041","415","626","31","1072","1755","0","61.08","23.65"
"66","000","00","008","0820","0963","998","367","631","27","1025","1497","0","68.47","24.52"
"66","000","00","008","0820","0964","927","355","572","48","975","1567","0","62.22","22.65"
"66","000","00","008","0820","0965","901","320","581","33","934","1624","0","57.51","19.7"
"66","000","00","008","0820","0966","956","368","588","38","994","1614","0","61.59","22.8"
"66","000","00","008","0820","0967","896","312","584","30","926","1595","0","58.06","19.56"
"66","000","00","008","0821","0000","2987","1171","1816","102","3089","5219","0","59.19","22.44"
"66","000","00","008","0821","0959","929","362","567","40","969","1565","0","61.92","23.13"
"66","000","00","008","0821","0960","938","361","577","23","961","1780","0","53.99","20.28"
"66","000","00","008","0821","0961","1120","448","672","39","1159","1874","0","61.85","23.91"
"66","000","00","008","0822","0000","655","322","333","30","685","1072","0","63.9","30.04"
"66","000","00","008","0822","0953","655","322","333","30","685","1072","0","63.9","30.04"
"66","000","00","008","0823","0000","3781","1607","2174","246","4027","6608","0","60.94","24.32"
"66","000","00","008","0823","0979","1036","501","535","103","1139","1785","0","63.81","28.07"
"66","000","00","008","0823","0980","939","367","572","48","987","1596","0","61.84","22.99"
"66","000","00","008","0823","0981","997","406","591","50","1047","1731","0","60.49","23.45"
"66","000","00","008","0823","0982","809","333","476","45","854","1496","0","57.09","22.26"
"66","000","00","008","0824","0000","2578","1016","1562","141","2719","4576","0","59.42","22.2"
"66","000","00","008","0824","0971","728","298","430","46","774","1372","0","56.41","21.72"
"66","000","00","008","0824","0972","795","289","506","51","846","1415","0","59.79","20.42"
"66","000","00","008","0824","0973","1055","429","626","44","1099","1789","0","61.43","23.98"
"66","000","00","008","0825","0000","2198","826","1372","111","2309","4210","0","54.85","19.62"
"66","000","00","008","0825","0968","912","346","566","48","960","1782","0","53.87","19.42"
"66","000","00","008","0825","0969","692","258","434","26","718","1357","0","52.91","19.01"
"66","000","00","008","0825","0970","594","222","372","37","631","1071","0","58.92","20.73"
"66","000","00","008","0826","0000","2860","1296","1564","133","2993","5209","0","57.46","24.88"
"66","000","00","008","0826","0930","1067","480","587","38","1105","1889","0","58.5","25.41"
"66","000","00","008","0826","0931","943","442","501","40","983","1728","0","56.89","25.58"
"66","000","00","008","0826","0932","850","374","476","55","905","1592","0","56.85","23.49"
"66","000","00","008","0827","0000","1681","730","951","78","1759","3180","0","55.31","22.96"
"66","000","00","008","0827","0933","892","395","497","43","935","1656","0","56.46","23.85"
"66","000","00","008","0827","0934","789","335","454","35","824","1524","0","54.07","21.98"
"66","000","00","008","0828","0000","3327","1369","1958","109","3436","6168","0","55.71","22.2"
"66","000","00","008","0828","0940","1043","437","606","37","1080","2033","0","53.12","21.5"
"66","000","00","008","0828","0941","1044","408","636","33","1077","1947","0","55.32","20.96"
"66","000","00","008","0828","0942","1240","524","716","39","1279","2188","0","58.46","23.95"
"66","000","00","008","0829","0000","2622","1141","1481","120","2742","4803","0","57.09","23.76"
"66","000","00","008","0829","0908","944","420","524","42","986","1601","0","61.59","26.23"
"66","000","00","008","0829","0909","830","374","456","36","866","1527","0","56.71","24.49"
"66","000","00","008","0829","0910","848","347","501","42","890","1675","0","53.13","20.72"
"66","000","00","008","0830","0000","2904","1039","1865","97","3001","5216","0","57.53","19.92"
"66","000","00","008","0830","0898","1035","354","681","48","1083","1866","0","58.04","18.97"
"66","000","00","008","0830","0899","894","359","535","23","917","1667","0","55.01","21.54"
"66","000","00","008","0830","0900","975","326","649","26","1001","1683","0","59.48","19.37"
"66","000","00","008","0831","0000","2775","1065","1710","112","2887","4895","0","58.98","21.76"
"66","000","00","008","0831","0976","845","329","516","42","887","1541","0","57.56","21.35"
"66","000","00","008","0831","0977","968","353","615","37","1005","1669","0","60.22","21.15"
"66","000","00","008","0831","0978","962","383","579","33","995","1685","0","59.05","22.73"
"66","000","00","008","0832","0000","3652","1421","2231","81","3733","6364","0","58.66","22.33"
"66","000","00","008","0832","0901","903","357","546","21","924","1642","0","56.27","21.74"
"66","000","00","008","0832","0902","895","373","522","14","909","1475","0","61.63","25.29"
"66","000","00","008","0832","0903","898","348","550","23","921","1644","0","56.02","21.17"
"66","000","00","008","0832","0904","956","343","613","23","979","1603","0","61.07","21.4"
"66","000","00","008","0833","0000","3056","1204","1852","123","3179","5179","0","61.38","23.25"
"66","000","00","008","0833","0905","1108","450","658","59","1167","1949","0","59.88","23.09"
"66","000","00","008","0833","0906","1104","403","701","40","1144","1790","0","63.91","22.51"
"66","000","00","008","0833","0907","844","351","493","24","868","1440","0","60.28","24.38"
"66","000","00","008","0834","0000","1794","816","978","77","1871","3159","0","59.23","25.83"
"66","000","00","008","0834","0848","827","391","436","45","872","1507","0","57.86","25.95"
"66","000","00","008","0834","0849","967","425","542","32","999","1652","0","60.47","25.73"
"66","000","00","008","0835","0000","2690","1129","1561","77","2767","4735","0","58.44","23.84"
"66","000","00","008","0835","0935","869","382","487","25","894","1502","0","59.52","25.43"
"66","000","00","008","0835","0936","966","383","583","27","993","1772","0","56.04","21.61"
"66","000","00","008","0835","0937","855","364","491","25","880","1461","0","60.23","24.91"
"66","000","00","008","0836","0000","1988","782","1206","67","2055","3663","0","56.1","21.35"
"66","000","00","008","0836","0938","902","333","569","16","918","1769","0","51.89","18.82"
"66","000","00","008","0836","0939","1086","449","637","51","1137","1894","0","60.03","23.71"
"66","000","00","008","0837","0000","3385","1362","2023","146","3531","6379","0","55.35","21.35"
"66","000","00","008","0837","0911","777","347","430","29","806","1579","0","51.04","21.98"
"66","000","00","008","0837","0912","850","341","509","38","888","1524","0","58.27","22.38"
"66","000","00","008","0837","0913","900","327","573","29","929","1677","0","55.4","19.5"
"66","000","00","008","0837","0914","858","347","511","50","908","1599","0","56.79","21.7"
"66","000","00","008","0838","0000","2788","1170","1618","71","2859","4844","0","59.02","24.15"
"66","000","00","008","0838","0946","920","390","530","23","943","1688","0","55.86","23.1"
"66","000","00","008","0838","0947","825","349","476","28","853","1475","0","57.83","23.66"
"66","000","00","008","0838","0948","1043","431","612","20","1063","1681","0","63.24","25.64"
"66","000","00","008","0839","0000","3811","1589","2222","115","3926","6576","0","59.7","24.16"
"66","000","00","008","0839","0920","964","358","606","22","986","1760","0","56.02","20.34"
"66","000","00","008","0839","0921","954","381","573","45","999","1699","0","58.8","22.42"
"66","000","00","008","0839","0922","991","431","560","36","1027","1626","0","63.16","26.51"
"66","000","00","008","0839","0923","902","419","483","12","914","1491","0","61.3","28.1"
"66","000","00","008","0840","0000","2523","1082","1441","120","2643","4436","0","59.58","24.39"
"66","000","00","008","0840","0927","883","372","511","30","913","1559","0","58.56","23.86"
"66","000","00","008","0840","0928","833","363","470","54","887","1480","0","59.93","24.53"
"66","000","00","008","0840","0929","807","347","460","36","843","1397","0","60.34","24.84"
"66","000","00","008","0841","0000","3345","1260","2085","120","3465","5762","0","60.14","21.87"
"66","000","00","008","0841","0856","1089","401","688","38","1127","1923","0","58.61","20.85"
"66","000","00","008","0841","0857","866","328","538","40","906","1641","0","55.21","19.99"
"66","000","00","008","0841","0858","751","280","471","18","769","1157","0","66.46","24.2"
"66","000","00","008","0841","0859","639","251","388","24","663","1041","0","63.69","24.11"
"66","000","00","008","0842","0000","2293","951","1342","93","2386","3915","0","60.95","24.29"
"66","000","00","008","0842","0974","1152","515","637","49","1201","1907","0","62.98","27.01"
"66","000","00","008","0842","0975","1141","436","705","44","1185","2008","0","59.01","21.71"
"66","000","00","009","0000","0000","78945","35654","43291","3839","82784","136658","166867","60.58","26.09"
"66","000","00","009","0901","0000","1309","551","758","66","1375","2292","0","59.99","24.04"
"66","000","00","009","0901","0394","544","256","288","25","569","983","0","57.88","26.04"
"66","000","00","009","0901","0395","765","295","470","41","806","1309","0","61.57","22.54"
"66","000","00","009","0902","0000","570","268","302","37","607","945","0","64.23","28.36"
"66","000","00","009","0902","0397","570","268","302","37","607","945","0","64.23","28.36"
"66","000","00","009","0903","0000","520","260","260","38","558","850","0","65.65","30.59"
"66","000","00","009","0903","0398","520","260","260","38","558","850","0","65.65","30.59"
"66","000","00","009","0904","0000","665","346","319","37","702","1116","0","62.9","31.0"
"66","000","00","009","0904","0396","665","346","319","37","702","1116","0","62.9","31.0"
"66","000","00","009","0905","0000","472","241","231","28","500","760","0","65.79","31.71"
"66","000","00","009","0905","0399","472","241","231","28","500","760","0","65.79","31.71"
"66","000","00","009","0906","0000","509","233","276","32","541","759","0","71.28","30.7"
"66","000","00","009","0906","0419","509","233","276","32","541","759","0","71.28","30.7"
"66","000","00","009","0907","0000","403","202","201","26","429","642","0","66.82","31.46"
"66","000","00","009","0907","0420","403","202","201","26","429","642","0","66.82","31.46"
"66","000","00","009","0908","0000","926","478","448","33","959","1647","0","58.23","29.02"
"66","000","00","009","0908","0415","926","478","448","33","959","1647","0","58.23","29.02"
"66","000","00","009","0909","0000","3065","1395","1670","132","3197","4979","0","64.21","28.02"
"66","000","00","009","0909","0421","923","422","501","31","954","1528","0","62.43","27.62"
"66","000","00","009","0909","0422","1103","499","604","42","1145","1788","0","64.04","27.91"
"66","000","00","009","0909","0423","1039","474","565","59","1098","1663","0","66.03","28.5"
"66","000","00","009","0910","0000","1365","621","744","66","1431","2162","0","66.19","28.72"
"66","000","00","009","0910","0424","845","373","472","39","884","1260","0","70.16","29.6"
"66","000","00","009","0910","0425","520","248","272","27","547","902","0","60.64","27.49"
"66","000","00","009","0911","0000","874","455","419","43","917","1457","0","62.94","31.23"
"66","000","00","009","0911","0437","874","455","419","43","917","1457","0","62.94","31.23"
"66","000","00","009","0912","0000","710","344","366","27","737","1184","0","62.25","29.05"
"66","000","00","009","0912","0438","710","344","366","27","737","1184","0","62.25","29.05"
"66","000","00","009","0913","0000","1400","627","773","67","1467","2507","0","58.52","25.01"
"66","000","00","009","0913","0403","633","306","327","39","672","1145","0","58.69","26.72"
"66","000","00","009","0913","0404","767","321","446","28","795","1362","0","58.37","23.57"
"66","000","00","009","0914","0000","1708","711","997","96","1804","2919","0","61.8","24.36"
"66","000","00","009","0914","0405","817","345","472","38","855","1389","0","61.56","24.84"
"66","000","00","009","0914","0406","891","366","525","58","949","1530","0","62.03","23.92"
"66","000","00","009","0915","0000","2278","1095","1183","163","2441","4043","0","60.38","27.08"
"66","000","00","009","0915","0407","830","413","417","55","885","1471","0","60.16","28.08"
"66","000","00","009","0915","0408","803","388","415","69","872","1410","0","61.84","27.52"
"66","000","00","009","0915","0409","645","294","351","39","684","1162","0","58.86","25.3"
"66","000","00","009","0916","0000","5079","2313","2766","231","5310","8802","0","60.33","26.28"
"66","000","00","009","0916","0410","948","453","495","29","977","1656","0","59.0","27.36"
"66","000","00","009","0916","0411","1006","445","561","41","1047","1838","0","56.96","24.21"
"66","000","00","009","0916","0412","922","468","454","52","974","1666","0","58.46","28.09"
"66","000","00","009","0916","0413","1045","473","572","51","1096","1821","0","60.19","25.97"
"66","000","00","009","0916","0414","1158","474","684","58","1216","1821","0","66.78","26.03"
"66","000","00","009","0917","0000","784","397","387","60","844","1256","0","67.2","31.61"
"66","000","00","009","0917","0416","784","397","387","60","844","1256","0","67.2","31.61"
"66","000","00","009","0918","0000","2015","853","1162","75","2090","3345","0","62.48","25.5"
"66","000","00","009","0918","0417","988","418","570","39","1027","1552","0","66.17","26.93"
"66","000","00","009","0918","0418","1027","435","592","36","1063","1793","0","59.29","24.26"
"66","000","00","009","0919","0000","5488","2473","3015","268","5756","9838","0","58.51","25.14"
"66","000","00","009","0919","0428","1067","470","597","44","1111","1873","0","59.32","25.09"
"66","000","00","009","0919","0429","1065","454","611","45","1110","1867","0","59.45","24.32"
"66","000","00","009","0919","0430","995","468","527","60","1055","1823","0","57.87","25.67"
"66","000","00","009","0919","0431","999","467","532","51","1050","1962","0","53.52","23.8"
"66","000","00","009","0919","0432","1362","614","748","68","1430","2313","0","61.82","26.55"
"66","000","00","009","0920","0000","3686","1605","2081","169","3855","6232","0","61.86","25.75"
"66","000","00","009","0920","0433","906","406","500","35","941","1510","0","62.32","26.89"
"66","000","00","009","0920","0434","1044","441","603","55","1099","1824","0","60.25","24.18"
"66","000","00","009","0920","0435","803","332","471","38","841","1363","0","61.7","24.36"
"66","000","00","009","0920","0436","933","426","507","41","974","1535","0","63.45","27.75"
"66","000","00","009","0921","0000","1596","599","997","61","1657","2949","0","56.19","20.31"
"66","000","00","009","0921","0426","649","247","402","20","669","1357","0","49.3","18.2"
"66","000","00","009","0921","0427","947","352","595","41","988","1592","0","62.06","22.11"
"66","000","00","009","0922","0000","3349","1601","1748","139","3488","6306","0","55.31","25.39"
"66","000","00","009","0922","0439","1089","476","613","41","1130","2299","0","49.15","20.7"
"66","000","00","009","0922","0440","1101","566","535","52","1153","1940","0","59.43","29.18"
"66","000","00","009","0922","0441","1159","559","600","46","1205","2067","0","58.3","27.04"
"66","000","00","009","0923","0000","5573","2442","3131","296","5869","10123","0","57.98","24.12"
"66","000","00","009","0923","0442","1109","475","634","53","1162","2038","0","57.02","23.31"
"66","000","00","009","0923","0443","1035","484","551","44","1079","1835","0","58.8","26.38"
"66","000","00","009","0923","0444","1093","493","600","60","1153","1979","0","58.26","24.91"
"66","000","00","009","0923","0445","1081","449","632","69","1150","2014","0","57.1","22.29"
"66","000","00","009","0923","0446","1255","541","714","70","1325","2257","0","58.71","23.97"
"66","000","00","009","0924","0000","2746","1232","1514","138","2884","4596","0","62.75","26.81"
"66","000","00","009","0924","0447","852","382","470","41","893","1406","0","63.51","27.17"
"66","000","00","009","0924","0448","831","387","444","37","868","1418","0","61.21","27.29"
"66","000","00","009","0924","0449","1063","463","600","60","1123","1772","0","63.37","26.13"
"66","000","00","009","0925","0000","6161","2623","3538","251","6412","10381","0","61.77","25.27"
"66","000","00","009","0925","0452","1020","439","581","58","1078","1758","0","61.32","24.97"
"66","000","00","009","0925","0453","964","410","554","37","1001","1546","0","64.75","26.52"
"66","000","00","009","0925","0454","1104","437","667","38","1142","1815","0","62.92","24.08"
"66","000","00","009","0925","0455","1141","515","626","34","1175","1932","0","60.82","26.66"
"66","000","00","009","0925","0456","1091","478","613","48","1139","1770","0","64.35","27.01"
"66","000","00","009","0925","0457","841","344","497","36","877","1560","0","56.22","22.05"
"66","000","00","009","0926","0000","1620","719","901","72","1692","2649","0","63.87","27.14"
"66","000","00","009","0926","0450","749","342","407","37","786","1202","0","65.39","28.45"
"66","000","00","009","0926","0451","871","377","494","35","906","1447","0","62.61","26.05"
"66","000","00","009","0927","0000","7426","3240","4186","386","7812","13032","0","59.94","24.86"
"66","000","00","009","0927","0458","1028","438","590","47","1075","1810","0","59.39","24.2"
"66","000","00","009","0927","0459","1002","423","579","36","1038","1653","0","62.79","25.59"
"66","000","00","009","0927","0460","833","362","471","43","876","1444","0","60.66","25.07"
"66","000","00","009","0927","0461","819","348","471","26","845","1318","0","64.11","26.4"
"66","000","00","009","0927","0462","907","432","475","51","958","1566","0","61.17","27.59"
"66","000","00","009","0927","0463","975","390","585","54","1029","1748","0","58.87","22.31"
"66","000","00","009","0927","0464","903","416","487","67","970","1772","0","54.74","23.48"
"66","000","00","009","0927","0465","959","431","528","62","1021","1721","0","59.33","25.04"
"66","000","00","009","0928","0000","2902","1300","1602","86","2988","5065","0","58.99","25.67"
"66","000","00","009","0928","0400","930","451","479","17","947","1617","0","58.57","27.89"
"66","000","00","009","0928","0401","868","369","499","35","903","1677","0","53.85","22.0"
"66","000","00","009","0928","0402","1104","480","624","34","1138","1771","0","64.26","27.1"
"66","000","00","009","0929","0000","923","449","474","32","955","1578","0","60.52","28.45"
"66","000","00","009","0929","0466","923","449","474","32","955","1578","0","60.52","28.45"
"66","000","00","009","0930","0000","2974","1297","1677","133","3107","5227","0","59.44","24.81"
"66","000","00","009","0930","0467","1036","490","546","61","1097","1859","0","59.01","26.36"
"66","000","00","009","0930","0468","848","338","510","37","885","1479","0","59.84","22.85"
"66","000","00","009","0930","0469","1090","469","621","35","1125","1889","0","59.56","24.83"
"66","000","00","009","0931","0000","1782","840","942","87","1869","3224","0","57.97","26.05"
"66","000","00","009","0931","0470","993","442","551","43","1036","1803","0","57.46","24.51"
"66","000","00","009","0931","0471","789","398","391","44","833","1421","0","58.62","28.01"
"66","000","00","009","0932","0000","2013","942","1071","111","2124","3359","0","63.23","28.04"
"66","000","00","009","0932","0472","957","484","473","52","1009","1585","0","63.66","30.54"
"66","000","00","009","0932","0473","1056","458","598","59","1115","1774","0","62.85","25.82"
"66","000","00","009","0933","0000","1206","524","682","67","1273","2132","0","59.71","24.58"
"66","000","00","009","0933","0474","1206","524","682","67","1273","2132","0","59.71","24.58"
"66","000","00","009","0934","0000","1580","751","829","69","1649","2874","0","57.38","26.13"
"66","000","00","009","0934","0475","864","425","439","47","911","1515","0","60.13","28.05"
"66","000","00","009","0934","0476","716","326","390","22","738","1359","0","54.3","23.99"
"66","000","00","009","0935","0000","1245","581","664","72","1317","2082","0","63.26","27.91"
"66","000","00","009","0935","0477","569","271","298","33","602","948","0","63.5","28.59"
"66","000","00","009","0935","0478","676","310","366","39","715","1134","0","63.05","27.34"
"66","000","00","009","0936","0000","2023","1046","977","145","2168","3346","0","64.79","31.26"
"66","000","00","009","0936","0479","701","374","327","49","750","1114","0","67.32","33.57"
"66","000","00","009","0936","0480","606","309","297","37","643","1050","0","61.24","29.43"
"66","000","00","009","0936","0481","716","363","353","59","775","1182","0","65.57","30.71"
"66","000","00","010","0000","0000","24007","9348","14659","1511","25518","43181","50308","59.1","21.65"
"66","000","00","010","1001","0000","815","265","550","49","864","1357","0","63.67","19.53"
"66","000","00","010","1001","1540","815","265","550","49","864","1357","0","63.67","19.53"
"66","000","00","010","1002","0000","536","188","348","40","576","865","0","66.59","21.73"
"66","000","00","010","1002","1539","536","188","348","40","576","865","0","66.59","21.73"
"66","000","00","010","1003","0000","614","253","361","27","641","1031","0","62.17","24.54"
"66","000","00","010","1003","1538","614","253","361","27","641","1031","0","62.17","24.54"
"66","000","00","010","1004","0000","1127","388","739","57","1184","1850","0","64.0","20.97"
"66","000","00","010","1004","1536","572","198","374","26","598","984","0","60.77","20.12"
"66","000","00","010","1004","1537","555","190","365","31","586","866","0","67.67","21.94"
"66","000","00","010","1005","0000","1284","514","770","99","1383","2196","0","62.98","23.41"
"66","000","00","010","1005","1534","689","268","421","51","740","1169","0","63.3","22.93"
"66","000","00","010","1005","1535","595","246","349","48","643","1027","0","62.61","23.95"
"66","000","00","010","1006","0000","594","213","381","31","625","977","0","63.97","21.8"
"66","000","00","010","1006","1532","594","213","381","31","625","977","0","63.97","21.8"
"66","000","00","010","1007","0000","772","251","521","32","804","1395","0","57.63","17.99"
"66","000","00","010","1007","1533","772","251","521","32","804","1395","0","57.63","17.99"
"66","000","00","010","1008","0000","2072","757","1315","95","2167","3486","0","62.16","21.72"
"66","000","00","010","1008","1529","674","237","437","28","702","1222","0","57.45","19.39"
"66","000","00","010","1008","1530","773","284","489","42","815","1228","0","66.37","23.13"
"66","000","00","010","1008","1531","625","236","389","25","650","1036","0","62.74","22.78"
"66","000","00","010","1009","0000","995","358","637","61","1056","1878","0","56.23","19.06"
"66","000","00","010","1009","1527","457","159","298","23","480","872","0","55.05","18.23"
"66","000","00","010","1009","1528","538","199","339","38","576","1006","0","57.26","19.78"
"66","000","00","010","1010","0000","2053","646","1407","133","2186","3662","0","59.69","17.64"
"66","000","00","010","1010","1523","771","168","603","53","824","1372","0","60.06","12.24"
"66","000","00","010","1010","1524","799","294","505","43","842","1412","0","59.63","20.82"
"66","000","00","010","1010","1525","483","184","299","37","520","878","0","59.23","20.96"
"66","000","00","010","1011","0000","736","299","437","40","776","1475","0","52.61","20.27"
"66","000","00","010","1011","1526","736","299","437","40","776","1475","0","52.61","20.27"
"66","000","00","010","1012","0000","2760","1098","1662","166","2926","4908","0","59.62","22.37"
"66","000","00","010","1012","1519","676","308","368","46","722","1335","0","54.08","23.07"
"66","000","00","010","1012","1520","665","266","399","34","699","1092","0","64.01","24.36"
"66","000","00","010","1012","1521","632","255","377","43","675","1050","0","64.29","24.29"
"66","000","00","010","1012","1522","787","269","518","43","830","1431","0","58.0","18.8"
"66","000","00","010","1013","0000","858","362","496","69","927","1628","0","56.94","22.24"
"66","000","00","010","1013","1518","858","362","496","69","927","1628","0","56.94","22.24"
"66","000","00","010","1014","0000","595","242","353","55","650","991","0","65.59","24.42"
"66","000","00","010","1014","1516","595","242","353","55","650","991","0","65.59","24.42"
"66","000","00","010","1015","0000","442","200","242","31","473","863","0","54.81","23.17"
"66","000","00","010","1015","1517","442","200","242","31","473","863","0","54.81","23.17"
"66","000","00","010","1016","0000","989","429","560","78","1067","1866","0","57.18","22.99"
"66","000","00","010","1016","1514","549","233","316","37","586","1007","0","58.19","23.14"
"66","000","00","010","1016","1515","440","196","244","41","481","859","0","56.0","22.82"
"66","000","00","010","1017","0000","675","276","399","51","726","1299","0","55.89","21.25"
"66","000","00","010","1017","1513","675","276","399","51","726","1299","0","55.89","21.25"
"66","000","00","010","1018","0000","1149","444","705","64","1213","1957","0","61.98","22.69"
"66","000","00","010","1018","1544","552","225","327","28","580","950","0","61.05","23.68"
"66","000","00","010","1018","1545","597","219","378","36","633","1007","0","62.86","21.75"
"66","000","00","010","1019","0000","1169","485","684","75","1244","2050","0","60.68","23.66"
"66","000","00","010","1019","1541","428","177","251","29","457","736","0","62.09","24.05"
"66","000","00","010","1019","1542","741","308","433","46","787","1314","0","59.89","23.44"
"66","000","00","010","1020","0000","849","385","464","79","928","1677","0","55.34","22.96"
"66","000","00","010","1020","1543","849","385","464","79","928","1677","0","55.34","22.96"
"66","000","00","010","1021","0000","619","286","333","29","648","1214","0","53.38","23.56"
"66","000","00","010","1021","1546","619","286","333","29","648","1214","0","53.38","23.56"
"66","000","00","010","1022","0000","950","392","558","74","1024","1809","0","56.61","21.67"
"66","000","00","010","1022","1547","486","197","289","39","525","907","0","57.88","21.72"
"66","000","00","010","1022","1548","464","195","269","35","499","902","0","55.32","21.62"
"66","000","00","010","1023","0000","322","144","178","13","335","720","0","46.53","20.0"
"66","000","00","010","1023","1549","322","144","178","13","335","720","0","46.53","20.0"
"66","000","00","010","1024","0000","330","157","173","14","344","666","0","51.65","23.57"
"66","000","00","010","1024","1550","330","157","173","14","344","666","0","51.65","23.57"
"66","000","00","010","1025","0000","702","316","386","49","751","1361","0","55.18","23.22"
"66","000","00","010","1025","1551","702","316","386","49","751","1361","0","55.18","23.22"
"66","000","00","011","0000","0000","34726","15257","19469","1898","36624","63069","77697","58.07","24.19"
"66","000","00","011","1101","0000","769","369","400","46","815","1356","0","60.1","27.21"
"66","000","00","011","1101","0001","769","369","400","46","815","1356","0","60.1","27.21"
"66","000","00","011","1102","0000","634","323","311","31","665","1059","0","62.8","30.5"
"66","000","00","011","1102","0002","634","323","311","31","665","1059","0","62.8","30.5"
"66","000","00","011","1103","0000","948","454","494","38","986","1568","0","62.88","28.95"
"66","000","00","011","1103","0003","435","206","229","17","452","694","0","65.13","29.68"
"66","000","00","011","1103","0004","513","248","265","21","534","874","0","61.1","28.38"
"66","000","00","011","1104","0000","412","173","239","16","428","763","0","56.09","22.67"
"66","000","00","011","1104","0005","412","173","239","16","428","763","0","56.09","22.67"
"66","000","00","011","1105","0000","1250","552","698","58","1308","2105","0","62.14","26.22"
"66","000","00","011","1105","0006","526","239","287","27","553","856","0","64.6","27.92"
"66","000","00","011","1105","0007","724","313","411","31","755","1249","0","60.45","25.06"
"66","000","00","011","1106","0000","1204","559","645","48","1252","2111","0","59.31","26.48"
"66","000","00","011","1106","0008","512","250","262","20","532","922","0","57.7","27.11"
"66","000","00","011","1106","0009","692","309","383","28","720","1189","0","60.56","25.99"
"66","000","00","011","1107","0000","1972","799","1173","143","2115","3374","0","62.69","23.68"
"66","000","00","011","1107","0010","637","279","358","47","684","1065","0","64.23","26.2"
"66","000","00","011","1107","0011","737","269","468","65","802","1252","0","64.06","21.49"
"66","000","00","011","1107","0012","598","251","347","31","629","1057","0","59.51","23.75"
"66","000","00","011","1108","0000","1209","497","712","66","1275","2091","0","60.98","23.77"
"66","000","00","011","1108","0013","578","258","320","26","604","1031","0","58.58","25.02"
"66","000","00","011","1108","0014","631","239","392","40","671","1060","0","63.3","22.55"
"66","000","00","011","1109","0000","2447","995","1452","123","2570","4405","0","58.34","22.59"
"66","000","00","011","1109","0015","731","286","445","37","768","1311","0","58.58","21.82"
"66","000","00","011","1109","0016","788","311","477","38","826","1424","0","58.01","21.84"
"66","000","00","011","1109","0017","928","398","530","48","976","1670","0","58.44","23.83"
"66","000","00","011","1110","0000","462","213","249","31","493","812","0","60.71","26.23"
"66","000","00","011","1110","0018","462","213","249","31","493","812","0","60.71","26.23"
"66","000","00","011","1111","0000","521","227","294","24","545","863","0","63.15","26.3"
"66","000","00","011","1111","0019","521","227","294","24","545","863","0","63.15","26.3"
"66","000","00","011","1112","0000","1785","722","1063","79","1864","3186","0","58.51","22.66"
"66","000","00","011","1112","0020","908","384","524","41","949","1598","0","59.39","24.03"
"66","000","00","011","1112","0021","877","338","539","38","915","1588","0","57.62","21.28"
"66","000","00","011","1113","0000","660","280","380","42","702","1197","0","58.65","23.39"
"66","000","00","011","1113","0022","660","280","380","42","702","1197","0","58.65","23.39"
"66","000","00","011","1114","0000","567","285","282","65","632","1106","0","57.14","25.77"
"66","000","00","011","1114","0023","567","285","282","65","632","1106","0","57.14","25.77"
"66","000","00","011","1115","0000","954","399","555","71","1025","1772","0","57.84","22.52"
"66","000","00","011","1115","0024","536","257","279","35","571","903","0","63.23","28.46"
"66","000","00","011","1115","0025","418","142","276","36","454","869","0","52.24","16.34"
"66","000","00","011","1116","0000","3057","1311","1746","158","3215","5269","0","61.02","24.88"
"66","000","00","011","1116","0026","776","344","432","31","807","1350","0","59.78","25.48"
"66","000","00","011","1116","0027","661","297","364","52","713","1144","0","62.33","25.96"
"66","000","00","011","1116","0028","704","288","416","39","743","1208","0","61.51","23.84"
"66","000","00","011","1116","0029","916","382","534","36","952","1567","0","60.75","24.38"
"66","000","00","011","1117","0000","1194","513","681","63","1257","2013","0","62.44","25.48"
"66","000","00","011","1117","0030","760","323","437","25","785","1246","0","63.0","25.92"
"66","000","00","011","1117","0031","434","190","244","38","472","767","0","61.54","24.77"
"66","000","00","011","1118","0000","1042","486","556","47","1089","1762","0","61.8","27.58"
"66","000","00","011","1118","0032","469","238","231","15","484","790","0","61.27","30.13"
"66","000","00","011","1118","0033","573","248","325","32","605","972","0","62.24","25.51"
"66","000","00","011","1119","0000","716","296","420","50","766","1388","0","55.19","21.33"
"66","000","00","011","1119","0034","716","296","420","50","766","1388","0","55.19","21.33"
"66","000","00","011","1120","0000","2481","991","1490","105","2586","4432","0","58.35","22.36"
"66","000","00","011","1120","0035","687","280","407","31","718","1331","0","53.94","21.04"
"66","000","00","011","1120","0036","703","269","434","31","734","1167","0","62.9","23.05"
"66","000","00","011","1120","0037","1091","442","649","43","1134","1934","0","58.63","22.85"
"66","000","00","011","1121","0000","619","297","322","47","666","1263","0","52.73","23.52"
"66","000","00","011","1121","0038","619","297","322","47","666","1263","0","52.73","23.52"
"66","000","00","011","1122","0000","2119","978","1141","84","2203","3973","0","55.45","24.62"
"66","000","00","011","1122","0039","776","322","454","24","800","1390","0","57.55","23.17"
"66","000","00","011","1122","0040","579","294","285","24","603","1186","0","50.84","24.79"
"66","000","00","011","1122","0041","764","362","402","36","800","1397","0","57.27","25.91"
"66","000","00","011","1123","0000","1258","617","641","64","1322","2571","0","51.42","24.0"
"66","000","00","011","1123","0042","534","275","259","18","552","1173","0","47.06","23.44"
"66","000","00","011","1123","0043","724","342","382","46","770","1398","0","55.08","24.46"
"66","000","00","011","1124","0000","2815","1279","1536","143","2958","5453","0","54.25","23.45"
"66","000","00","011","1124","0044","612","313","299","31","643","1228","0","52.36","25.49"
"66","000","00","011","1124","0045","650","289","361","32","682","1258","0","54.21","22.97"
"66","000","00","011","1124","0046","757","340","417","32","789","1435","0","54.98","23.69"
"66","000","00","011","1124","0047","796","337","459","48","844","1532","0","55.09","22.0"
"66","000","00","011","1125","0000","782","354","428","50","832","1522","0","54.66","23.26"
"66","000","00","011","1125","0048","365","146","219","17","382","652","0","58.59","22.39"
"66","000","00","011","1125","0049","417","208","209","33","450","870","0","51.72","23.91"
"66","000","00","011","1126","0000","899","401","498","63","962","1675","0","57.43","23.94"
"66","000","00","011","1126","0050","449","201","248","31","480","891","0","53.87","22.56"
"66","000","00","011","1126","0051","450","200","250","32","482","784","0","61.48","25.51"
"66","000","00","011","1127","0000","688","287","401","56","744","1368","0","54.39","20.98"
"66","000","00","011","1127","0052","688","287","401","56","744","1368","0","54.39","20.98"
"66","000","00","011","1128","0000","565","244","321","40","605","1126","0","53.73","21.67"
"66","000","00","011","1128","0053","565","244","321","40","605","1126","0","53.73","21.67"
"66","000","00","011","1129","0000","697","356","341","47","744","1486","0","50.07","23.96"
"66","000","00","011","1129","0054","697","356","341","47","744","1486","0","50.07","23.96"
"66","000","00","012","0000","0000","40056","17895","22161","2216","42272","71528","86659","59.1","25.02"
"66","000","00","012","1201","0000","569","267","302","26","595","1076","0","55.3","24.81"
"66","000","00","012","1201","0091","569","267","302","26","595","1076","0","55.3","24.81"
"66","000","00","012","1202","0000","601","288","313","24","625","953","0","65.58","30.22"
"66","000","00","012","1202","0092","601","288","313","24","625","953","0","65.58","30.22"
"66","000","00","012","1203","0000","1241","578","663","69","1310","2057","0","63.68","28.1"
"66","000","00","012","1203","0093","535","262","273","36","571","914","0","62.47","28.67"
"66","000","00","012","1203","0094","706","316","390","33","739","1143","0","64.65","27.65"
"66","000","00","012","1204","0000","401","192","209","25","426","680","0","62.65","28.24"
"66","000","00","012","1204","0095","401","192","209","25","426","680","0","62.65","28.24"
"66","000","00","012","1205","0000","1086","518","568","66","1152","1797","0","64.11","28.83"
"66","000","00","012","1205","0096","535","250","285","31","566","904","0","62.61","27.65"
"66","000","00","012","1205","0097","551","268","283","35","586","893","0","65.62","30.01"
"66","000","00","012","1206","0000","887","411","476","31","918","1577","0","58.21","26.06"
"66","000","00","012","1206","0098","887","411","476","31","918","1577","0","58.21","26.06"
"66","000","00","012","1207","0000","404","216","188","15","419","690","0","60.72","31.3"
"66","000","00","012","1207","0099","404","216","188","15","419","690","0","60.72","31.3"
"66","000","00","012","1208","0000","235","107","128","13","248","403","0","61.54","26.55"
"66","000","00","012","1208","0100","235","107","128","13","248","403","0","61.54","26.55"
"66","000","00","012","1209","0000","1243","665","578","74","1317","2190","0","60.14","30.37"
"66","000","00","012","1209","0101","814","478","336","38","852","1413","0","60.3","33.83"
"66","000","00","012","1209","0102","429","187","242","36","465","777","0","59.85","24.07"
"66","000","00","012","1210","0000","5437","2279","3158","264","5701","9237","0","61.72","24.67"
"66","000","00","012","1210","0103","782","328","454","23","805","1313","0","61.31","24.98"
"66","000","00","012","1210","0104","783","300","483","114","897","1439","0","62.33","20.85"
"66","000","00","012","1210","0105","682","341","341","17","699","1265","0","55.26","26.96"
"66","000","00","012","1210","0106","788","326","462","26","814","1277","0","63.74","25.53"
"66","000","00","012","1210","0107","742","287","455","42","784","1276","0","61.44","22.49"
"66","000","00","012","1210","0108","854","353","501","18","872","1376","0","63.37","25.65"
"66","000","00","012","1210","0109","806","344","462","24","830","1291","0","64.29","26.65"
"66","000","00","012","1211","0000","871","417","454","50","921","1510","0","60.99","27.62"
"66","000","00","012","1211","0110","871","417","454","50","921","1510","0","60.99","27.62"
"66","000","00","012","1212","0000","865","369","496","48","913","1524","0","59.91","24.21"
"66","000","00","012","1212","0111","865","369","496","48","913","1524","0","59.91","24.21"
"66","000","00","012","1213","0000","2403","1050","1353","129","2532","4302","0","58.86","24.41"
"66","000","00","012","1213","0112","770","335","435","35","805","1474","0","54.61","22.73"
"66","000","00","012","1213","0113","815","353","462","50","865","1507","0","57.4","23.42"
"66","000","00","012","1213","0114","818","362","456","44","862","1321","0","65.25","27.4"
"66","000","00","012","1214","0000","1815","890","925","82","1897","3293","0","57.61","27.03"
"66","000","00","012","1214","0115","592","327","265","27","619","1157","0","53.5","28.26"
"66","000","00","012","1214","0116","736","327","409","29","765","1255","0","60.96","26.06"
"66","000","00","012","1214","0117","487","236","251","26","513","881","0","58.23","26.79"
"66","000","00","012","1215","0000","1208","539","669","62","1270","2034","0","62.44","26.5"
"66","000","00","012","1215","0118","627","282","345","44","671","1083","0","61.96","26.04"
"66","000","00","012","1215","0119","581","257","324","18","599","951","0","62.99","27.02"
"66","000","00","012","1216","0000","2675","1286","1389","153","2828","5145","0","54.97","25.0"
"66","000","00","012","1216","0120","743","348","395","45","788","1424","0","55.34","24.44"
"66","000","00","012","1216","0121","641","327","314","35","676","1233","0","54.83","26.52"
"66","000","00","012","1216","0122","606","297","309","29","635","1288","0","49.3","23.06"
"66","000","00","012","1216","0123","685","314","371","44","729","1200","0","60.75","26.17"
"66","000","00","012","1217","0000","1659","541","1118","39","1698","2745","0","61.86","19.71"
"66","000","00","012","1217","0124","942","236","706","24","966","1609","0","60.04","14.67"
"66","000","00","012","1217","0125","717","305","412","15","732","1136","0","64.44","26.85"
"66","000","00","012","1218","0000","694","272","422","50","744","1302","0","57.14","20.89"
"66","000","00","012","1218","0126","694","272","422","50","744","1302","0","57.14","20.89"
"66","000","00","012","1219","0000","726","326","400","59","785","1373","0","57.17","23.74"
"66","000","00","012","1219","0127","726","326","400","59","785","1373","0","57.17","23.74"
"66","000","00","012","1220","0000","597","273","324","59","656","1257","0","52.19","21.72"
"66","000","00","012","1220","0128","597","273","324","59","656","1257","0","52.19","21.72"
"66","000","00","012","1221","0000","590","281","309","37","627","1184","0","52.96","23.73"
"66","000","00","012","1221","0129","590","281","309","37","627","1184","0","52.96","23.73"
"66","000","00","012","1222","0000","710","302","408","48","758","1322","0","57.34","22.84"
"66","000","00","012","1222","0130","710","302","408","48","758","1322","0","57.34","22.84"
"66","000","00","012","1223","0000","1111","471","640","81","1192","2120","0","56.23","22.22"
"66","000","00","012","1223","0131","589","208","381","48","637","1193","0","53.39","17.44"
"66","000","00","012","1223","0132","522","263","259","33","555","927","0","59.87","28.37"
"66","000","00","012","1224","0000","1306","636","670","85","1391","2236","0","62.21","28.44"
"66","000","00","012","1224","0133","624","292","332","39","663","1073","0","61.79","27.21"
"66","000","00","012","1224","0134","682","344","338","46","728","1163","0","62.6","29.58"
"66","000","00","012","1225","0000","908","416","492","76","984","1757","0","56.0","23.68"
"66","000","00","012","1225","0135","448","201","247","29","477","855","0","55.79","23.51"
"66","000","00","012","1225","0136","460","215","245","47","507","902","0","56.21","23.84"
"66","000","00","012","1226","0000","1334","687","647","84","1418","2481","0","57.15","27.69"
"66","000","00","012","1226","0137","778","399","379","42","820","1415","0","57.95","28.2"
"66","000","00","012","1226","0138","556","288","268","42","598","1066","0","56.1","27.02"
"66","000","00","012","1227","0000","3994","1748","2246","180","4174","7264","0","57.46","24.06"
"66","000","00","012","1227","0139","737","336","401","45","782","1391","0","56.22","24.16"
"66","000","00","012","1227","0140","733","346","387","32","765","1449","0","52.8","23.88"
"66","000","00","012","1227","0141","799","359","440","36","835","1377","0","60.64","26.07"
"66","000","00","012","1227","0142","811","329","482","36","847","1423","0","59.52","23.12"
"66","000","00","012","1227","0143","914","378","536","31","945","1624","0","58.19","23.28"
"66","000","00","012","1228","0000","1515","670","845","104","1619","2822","0","57.37","23.74"
"66","000","00","012","1228","0144","695","304","391","65","760","1358","0","55.96","22.39"
"66","000","00","012","1228","0145","820","366","454","39","859","1464","0","58.67","25.0"
"66","000","00","012","1229","0000","674","262","412","59","733","1211","0","60.53","21.64"
"66","000","00","012","1229","0146","674","262","412","59","733","1211","0","60.53","21.64"
"66","000","00","012","1230","0000","673","275","398","56","729","1162","0","62.74","23.67"
"66","000","00","012","1230","0148","673","275","398","56","729","1162","0","62.74","23.67"
"66","000","00","012","1231","0000","843","344","499","38","881","1368","0","64.4","25.15"
"66","000","00","012","1231","0149","843","344","499","38","881","1368","0","64.4","25.15"
"66","000","00","012","1232","0000","781","319","462","30","811","1456","0","55.7","21.91"
"66","000","00","012","1232","0147","781","319","462","30","811","1456","0","55.7","21.91"
"66","000","00","013","0000","0000","40516","17498","23018","2000","42516","74207","93720","57.29","23.58"
"66","000","00","013","1301","0000","719","345","374","39","758","1380","0","54.93","25.0"
"66","000","00","013","1301","0186","719","345","374","39","758","1380","0","54.93","25.0"
"66","000","00","013","1302","0000","1201","529","672","58","1259","2028","0","62.08","26.08"
"66","000","00","013","1302","0187","496","238","258","26","522","852","0","61.27","27.93"
"66","000","00","013","1302","0188","705","291","414","32","737","1176","0","62.67","24.74"
"66","000","00","013","1303","0000","606","307","299","42","648","958","0","67.64","32.05"
"66","000","00","013","1303","0189","606","307","299","42","648","958","0","67.64","32.05"
"66","000","00","013","1304","0000","317","134","183","20","337","488","0","69.06","27.46"
"66","000","00","013","1304","0190","317","134","183","20","337","488","0","69.06","27.46"
"66","000","00","013","1305","0000","1368","596","772","74","1442","2462","0","58.57","24.21"
"66","000","00","013","1305","0191","664","293","371","29","693","1177","0","58.88","24.89"
"66","000","00","013","1305","0192","704","303","401","45","749","1285","0","58.29","23.58"
"66","000","00","013","1306","0000","2448","1052","1396","91","2539","4336","0","58.56","24.26"
"66","000","00","013","1306","0195","772","345","427","26","798","1469","0","54.32","23.49"
"66","000","00","013","1306","0196","847","356","491","30","877","1423","0","61.63","25.02"
"66","000","00","013","1306","0197","829","351","478","35","864","1444","0","59.83","24.31"
"66","000","00","013","1307","0000","2822","1288","1534","145","2967","5046","0","58.8","25.53"
"66","000","00","013","1307","0198","820","366","454","49","869","1469","0","59.16","24.91"
"66","000","00","013","1307","0199","1045","459","586","61","1106","1902","0","58.15","24.13"
"66","000","00","013","1307","0200","957","463","494","35","992","1675","0","59.22","27.64"
"66","000","00","013","1308","0000","3876","1845","2031","165","4041","6728","0","60.06","27.42"
"66","000","00","013","1308","0201","612","298","314","25","637","1098","0","58.01","27.14"
"66","000","00","013","1308","0202","905","395","510","39","944","1539","0","61.34","25.67"
"66","000","00","013","1308","0203","800","377","423","33","833","1329","0","62.68","28.37"
"66","000","00","013","1308","0204","684","368","316","33","717","1255","0","57.13","29.32"
"66","000","00","013","1308","0205","875","407","468","35","910","1507","0","60.38","27.01"
"66","000","00","013","1309","0000","3967","1790","2177","250","4217","7300","0","57.77","24.52"
"66","000","00","013","1309","0206","820","345","475","52","872","1463","0","59.6","23.58"
"66","000","00","013","1309","0207","659","294","365","55","714","1279","0","55.82","22.99"
"66","000","00","013","1309","0208","537","229","308","20","557","1024","0","54.39","22.36"
"66","000","00","013","1309","0209","702","297","405","59","761","1388","0","54.83","21.4"
"66","000","00","013","1309","0210","625","358","267","34","659","1074","0","61.36","33.33"
"66","000","00","013","1309","0211","624","267","357","30","654","1072","0","61.01","24.91"
"66","000","00","013","1310","0000","639","290","349","50","689","1107","0","62.24","26.2"
"66","000","00","013","1310","0212","639","290","349","50","689","1107","0","62.24","26.2"
"66","000","00","013","1311","0000","2469","1034","1435","109","2578","4771","0","54.03","21.67"
"66","000","00","013","1311","0215","925","366","559","36","961","1633","0","58.85","22.41"
"66","000","00","013","1311","0216","786","303","483","45","831","1533","0","54.21","19.77"
"66","000","00","013","1311","0217","758","365","393","28","786","1605","0","48.97","22.74"
"66","000","00","013","1312","0000","1791","730","1061","81","1872","3629","0","51.58","20.12"
"66","000","00","013","1312","0213","954","382","572","34","988","1947","0","50.74","19.62"
"66","000","00","013","1312","0214","837","348","489","47","884","1682","0","52.56","20.69"
"66","000","00","013","1313","0000","895","381","514","39","934","1694","0","55.14","22.49"
"66","000","00","013","1313","0218","895","381","514","39","934","1694","0","55.14","22.49"
"66","000","00","013","1314","0000","2655","1112","1543","107","2762","4944","0","55.87","22.49"
"66","000","00","013","1314","0219","836","362","474","41","877","1628","0","53.87","22.24"
"66","000","00","013","1314","0220","946","398","548","23","969","1665","0","58.2","23.9"
"66","000","00","013","1314","0221","873","352","521","43","916","1651","0","55.48","21.32"
"66","000","00","013","1315","0000","1908","816","1092","83","1991","3289","0","60.54","24.81"
"66","000","00","013","1315","0222","660","304","356","30","690","1108","0","62.27","27.44"
"66","000","00","013","1315","0223","664","288","376","36","700","1142","0","61.3","25.22"
"66","000","00","013","1315","0224","584","224","360","17","601","1039","0","57.84","21.56"
"66","000","00","013","1316","0000","2750","1101","1649","146","2896","5270","0","54.95","20.89"
"66","000","00","013","1316","0225","964","375","589","52","1016","1840","0","55.22","20.38"
"66","000","00","013","1316","0226","1004","376","628","37","1041","1872","0","55.61","20.09"
"66","000","00","013","1316","0227","782","350","432","57","839","1558","0","53.85","22.46"
"66","000","00","013","1317","0000","2387","935","1452","112","2499","4314","0","57.93","21.67"
"66","000","00","013","1317","0232","870","357","513","42","912","1593","0","57.25","22.41"
"66","000","00","013","1317","0233","517","162","355","25","542","981","0","55.25","16.51"
"66","000","00","013","1317","0234","1000","416","584","45","1045","1740","0","60.06","23.91"
"66","000","00","013","1318","0000","1324","516","808","60","1384","2294","0","60.33","22.49"
"66","000","00","013","1318","0235","723","318","405","45","768","1247","0","61.59","25.5"
"66","000","00","013","1318","0236","601","198","403","15","616","1047","0","58.83","18.91"
"66","000","00","013","1319","0000","1191","506","685","57","1248","2144","0","58.21","23.6"
"66","000","00","013","1319","0237","629","282","347","40","669","1119","0","59.79","25.2"
"66","000","00","013","1319","0238","562","224","338","17","579","1025","0","56.49","21.85"
"66","000","00","013","1320","0000","1832","821","1011","118","1950","3364","0","57.97","24.41"
"66","000","00","013","1320","0193","881","393","488","64","945","1736","0","54.44","22.64"
"66","000","00","013","1320","0194","951","428","523","54","1005","1628","0","61.73","26.29"
"66","000","00","013","1321","0000","3351","1370","1981","154","3505","6661","0","52.62","20.57"
"66","000","00","013","1321","0228","875","365","510","35","910","1739","0","52.33","20.99"
"66","000","00","013","1321","0229","801","314","487","54","855","1672","0","51.14","18.78"
"66","000","00","013","1321","0230","871","343","528","38","909","1634","0","55.63","20.99"
"66","000","00","013","1321","0231","804","348","456","27","831","1616","0","51.42","21.53"
"66","000","00","014","0000","0000","25764","11670","14094","1306","27070","47040","58189","57.55","24.81"
"66","000","00","014","1401","0000","1671","742","929","92","1763","3122","0","56.47","23.77"
"66","000","00","014","1401","0150","832","390","442","43","875","1541","0","56.78","25.31"
"66","000","00","014","1401","0151","839","352","487","49","888","1581","0","56.17","22.26"
"66","000","00","014","1402","0000","1131","545","586","48","1179","1959","0","60.18","27.82"
"66","000","00","014","1402","0152","617","303","314","30","647","1083","0","59.74","27.98"
"66","000","00","014","1402","0153","514","242","272","18","532","876","0","60.73","27.63"
"66","000","00","014","1403","0000","2125","940","1185","100","2225","3929","0","56.63","23.92"
"66","000","00","014","1403","0154","592","273","319","34","626","1043","0","60.02","26.17"
"66","000","00","014","1403","0155","764","339","425","27","791","1502","0","52.66","22.57"
"66","000","00","014","1403","0156","769","328","441","39","808","1384","0","58.38","23.7"
"66","000","00","014","1404","0000","324","141","183","28","352","517","0","68.09","27.27"
"66","000","00","014","1404","0157","324","141","183","28","352","517","0","68.09","27.27"
"66","000","00","014","1405","0000","729","342","387","29","758","1169","0","64.84","29.26"
"66","000","00","014","1405","0158","729","342","387","29","758","1169","0","64.84","29.26"
"66","000","00","014","1406","0000","497","245","252","29","526","863","0","60.95","28.39"
"66","000","00","014","1406","0159","497","245","252","29","526","863","0","60.95","28.39"
"66","000","00","014","1407","0000","3217","1448","1769","201","3418","6128","0","55.78","23.63"
"66","000","00","014","1407","0160","597","238","359","46","643","1277","0","50.35","18.64"
"66","000","00","014","1407","0161","910","406","504","40","950","1742","0","54.54","23.31"
"66","000","00","014","1407","0162","756","358","398","43","799","1342","0","59.54","26.68"
"66","000","00","014","1407","0163","954","446","508","72","1026","1767","0","58.06","25.24"
"66","000","00","014","1408","0000","2552","1281","1271","100","2652","4974","0","53.32","25.75"
"66","000","00","014","1408","0164","754","367","387","38","792","1542","0","51.36","23.8"
"66","000","00","014","1408","0165","867","491","376","30","897","1636","0","54.83","30.01"
"66","000","00","014","1408","0166","931","423","508","32","963","1796","0","53.62","23.55"
"66","000","00","014","1409","0000","2325","1018","1307","143","2468","4364","0","56.55","23.33"
"66","000","00","014","1409","0167","762","317","445","38","800","1450","0","55.17","21.86"
"66","000","00","014","1409","0168","796","372","424","64","860","1548","0","55.56","24.03"
"66","000","00","014","1409","0169","767","329","438","41","808","1366","0","59.15","24.08"
"66","000","00","014","1410","0000","4207","1836","2371","188","4395","7342","0","59.86","25.01"
"66","000","00","014","1410","0170","611","290","321","21","632","955","0","66.18","30.37"
"66","000","00","014","1410","0171","684","296","388","33","717","1305","0","54.94","22.68"
"66","000","00","014","1410","0172","715","314","401","26","741","1239","0","59.81","25.34"
"66","000","00","014","1410","0173","628","252","376","41","669","1079","0","62.0","23.35"
"66","000","00","014","1410","0174","671","268","403","31","702","1220","0","57.54","21.97"
"66","000","00","014","1410","0175","898","416","482","36","934","1544","0","60.49","26.94"
"66","000","00","014","1411","0000","3134","1393","1741","137","3271","5607","0","58.34","24.84"
"66","000","00","014","1411","0176","861","401","460","26","887","1460","0","60.75","27.47"
"66","000","00","014","1411","0177","763","322","441","35","798","1292","0","61.76","24.92"
"66","000","00","014","1411","0178","705","313","392","37","742","1300","0","57.08","24.08"
"66","000","00","014","1411","0179","805","357","448","39","844","1555","0","54.28","22.96"
"66","000","00","014","1412","0000","1299","593","706","56","1355","2308","0","58.71","25.69"
"66","000","00","014","1412","0180","554","230","324","28","582","1031","0","56.45","22.31"
"66","000","00","014","1412","0181","745","363","382","28","773","1277","0","60.53","28.43"
"66","000","00","014","1413","0000","1223","565","658","75","1298","2224","0","58.36","25.4"
"66","000","00","014","1413","0182","554","265","289","32","586","1037","0","56.51","25.55"
"66","000","00","014","1413","0183","669","300","369","43","712","1187","0","59.98","25.27"
"66","000","00","014","1414","0000","1330","581","749","80","1410","2534","0","55.64","22.93"
"66","000","00","014","1414","0184","716","323","393","46","762","1399","0","54.47","23.09"
"66","000","00","014","1414","0185","614","258","356","34","648","1135","0","57.09","22.73"
"66","000","00","015","0000","0000","25028","10863","14165","1385","26413","44962","54682","58.75","24.16"
"66","000","00","015","1501","0000","1109","425","684","87","1196","1987","0","60.19","21.39"
"66","000","00","015","1501","0357","509","195","314","37","546","852","0","64.08","22.89"
"66","000","00","015","1501","0358","600","230","370","50","650","1135","0","57.27","20.26"
"66","000","00","015","1502","0000","587","289","298","24","611","1079","0","56.63","26.78"
"66","000","00","015","1502","0359","587","289","298","24","611","1079","0","56.63","26.78"
"66","000","00","015","1503","0000","1747","624","1123","99","1846","3130","0","58.98","19.94"
"66","000","00","015","1503","0360","870","309","561","47","917","1539","0","59.58","20.08"
"66","000","00","015","1503","0361","877","315","562","52","929","1591","0","58.39","19.8"
"66","000","00","015","1504","0000","2162","1010","1152","137","2299","3701","0","62.12","27.29"
"66","000","00","015","1504","0364","796","366","430","54","850","1428","0","59.52","25.63"
"66","000","00","015","1504","0365","746","409","337","43","789","1178","0","66.98","34.72"
"66","000","00","015","1504","0366","620","235","385","40","660","1095","0","60.27","21.46"
"66","000","00","015","1505","0000","1170","493","677","63","1233","2126","0","58.0","23.19"
"66","000","00","015","1505","0367","536","232","304","23","559","963","0","58.05","24.09"
"66","000","00","015","1505","0368","634","261","373","40","674","1163","0","57.95","22.44"
"66","000","00","015","1506","0000","2703","1141","1562","147","2850","4712","0","60.48","24.21"
"66","000","00","015","1506","0369","582","238","344","39","621","1018","0","61.0","23.38"
"66","000","00","015","1506","0370","524","221","303","31","555","854","0","64.99","25.88"
"66","000","00","015","1506","0371","776","320","456","39","815","1485","0","54.88","21.55"
"66","000","00","015","1506","0372","821","362","459","38","859","1355","0","63.39","26.72"
"66","000","00","015","1507","0000","1093","517","576","67","1160","1986","0","58.41","26.03"
"66","000","00","015","1507","0373","435","200","235","34","469","840","0","55.83","23.81"
"66","000","00","015","1507","0374","658","317","341","33","691","1146","0","60.3","27.66"
"66","000","00","015","1508","0000","1951","849","1102","119","2070","3342","0","61.94","25.4"
"66","000","00","015","1508","0375","974","424","550","59","1033","1669","0","61.89","25.4"
"66","000","00","015","1508","0376","977","425","552","60","1037","1673","0","61.98","25.4"
"66","000","00","015","1509","0000","1930","862","1068","104","2034","3454","0","58.89","24.96"
"66","000","00","015","1509","0377","831","354","477","41","872","1493","0","58.41","23.71"
"66","000","00","015","1509","0378","610","279","331","48","658","1052","0","62.55","26.52"
"66","000","00","015","1509","0379","489","229","260","15","504","909","0","55.45","25.19"
"66","000","00","015","1510","0000","1443","682","761","64","1507","2433","0","61.94","28.03"
"66","000","00","015","1510","0380","629","327","302","44","673","1091","0","61.69","29.97"
"66","000","00","015","1510","0381","814","355","459","20","834","1342","0","62.15","26.45"
"66","000","00","015","1511","0000","1177","536","641","67","1244","2115","0","58.82","25.34"
"66","000","00","015","1511","0382","616","305","311","33","649","1138","0","57.03","26.8"
"66","000","00","015","1511","0383","561","231","330","34","595","977","0","60.9","23.64"
"66","000","00","015","1512","0000","756","328","428","42","798","1584","0","50.38","20.71"
"66","000","00","015","1512","0384","756","328","428","42","798","1584","0","50.38","20.71"
"66","000","00","015","1513","0000","1196","488","708","92","1288","2140","0","60.19","22.8"
"66","000","00","015","1513","0385","514","196","318","32","546","915","0","59.67","21.42"
"66","000","00","015","1513","0386","682","292","390","60","742","1225","0","60.57","23.84"
"66","000","00","015","1514","0000","1724","684","1040","68","1792","3152","0","56.85","21.7"
"66","000","00","015","1514","0387","852","356","496","38","890","1552","0","57.35","22.94"
"66","000","00","015","1514","0388","872","328","544","30","902","1600","0","56.38","20.5"
"66","000","00","015","1515","0000","689","328","361","29","718","1340","0","53.58","24.48"
"66","000","00","015","1515","0393","689","328","361","29","718","1340","0","53.58","24.48"
"66","000","00","015","1516","0000","1112","500","612","80","1192","2122","0","56.17","23.56"
"66","000","00","015","1516","0391","530","233","297","31","561","1055","0","53.18","22.09"
"66","000","00","015","1516","0392","582","267","315","49","631","1067","0","59.14","25.02"
"66","000","00","015","1517","0000","1050","484","566","46","1096","1885","0","58.14","25.68"
"66","000","00","015","1517","0389","530","234","296","20","550","942","0","58.39","24.84"
"66","000","00","015","1517","0390","520","250","270","26","546","943","0","57.9","26.51"
"66","000","00","015","1518","0000","1429","623","806","50","1479","2674","0","55.31","23.3"
"66","000","00","015","1518","0362","691","332","359","30","721","1376","0","52.4","24.13"
"66","000","00","015","1518","0363","738","291","447","20","758","1298","0","58.4","22.42"
"66","000","00","016","0000","0000","31068","14344","16724","1666","32734","54565","65692","59.99","26.29"
"66","000","00","016","1601","0000","1871","821","1050","88","1959","3243","0","60.41","25.32"
"66","000","00","016","1601","0482","979","431","548","50","1029","1684","0","61.1","25.59"
"66","000","00","016","1601","0483","892","390","502","38","930","1559","0","59.65","25.02"
"66","000","00","016","1602","0000","1252","555","697","73","1325","2139","0","61.94","25.95"
"66","000","00","016","1602","0484","575","239","336","37","612","1095","0","55.89","21.83"
"66","000","00","016","1602","0485","677","316","361","36","713","1044","0","68.3","30.27"
"66","000","00","016","1603","0000","1588","716","872","98","1686","2604","0","64.75","27.5"
"66","000","00","016","1603","0486","802","350","452","52","854","1310","0","65.19","26.72"
"66","000","00","016","1603","0487","786","366","420","46","832","1294","0","64.3","28.28"
"66","000","00","016","1604","0000","1264","654","610","85","1349","2165","0","62.31","30.21"
"66","000","00","016","1604","0488","668","357","311","44","712","1143","0","62.29","31.23"
"66","000","00","016","1604","0489","596","297","299","41","637","1022","0","62.33","29.06"
"66","000","00","016","1605","0000","4039","1856","2183","155","4194","7265","0","57.73","25.55"
"66","000","00","016","1605","0498","816","346","470","19","835","1452","0","57.51","23.83"
"66","000","00","016","1605","0499","907","410","497","48","955","1551","0","61.57","26.43"
"66","000","00","016","1605","0500","823","366","457","44","867","1567","0","55.33","23.36"
"66","000","00","016","1605","0501","820","400","420","25","845","1449","0","58.32","27.61"
"66","000","00","016","1605","0502","673","334","339","19","692","1246","0","55.54","26.81"
"66","000","00","016","1606","0000","3134","1522","1612","162","3296","5267","0","62.58","28.9"
"66","000","00","016","1606","0503","820","379","441","51","871","1431","0","60.87","26.48"
"66","000","00","016","1606","0504","703","367","336","36","739","1163","0","63.54","31.56"
"66","000","00","016","1606","0505","868","425","443","46","914","1402","0","65.19","30.31"
"66","000","00","016","1606","0506","743","351","392","29","772","1271","0","60.74","27.62"
"66","000","00","016","1607","0000","1455","690","765","108","1563","2510","0","62.27","27.49"
"66","000","00","016","1607","0507","696","341","355","53","749","1198","0","62.52","28.46"
"66","000","00","016","1607","0508","759","349","410","55","814","1312","0","62.04","26.6"
"66","000","00","016","1608","0000","1672","817","855","77","1749","2885","0","60.62","28.32"
"66","000","00","016","1608","0512","918","448","470","43","961","1483","0","64.8","30.21"
"66","000","00","016","1608","0513","754","369","385","34","788","1402","0","56.21","26.32"
"66","000","00","016","1609","0000","2360","1008","1352","120","2480","4329","0","57.29","23.28"
"66","000","00","016","1609","0509","880","437","443","44","924","1590","0","58.11","27.48"
"66","000","00","016","1609","0510","716","283","433","38","754","1324","0","56.95","21.37"
"66","000","00","016","1609","0511","764","288","476","38","802","1415","0","56.68","20.35"
"66","000","00","016","1610","0000","4018","1791","2227","215","4233","7224","0","58.6","24.79"
"66","000","00","016","1610","0514","682","274","408","34","716","1275","0","56.16","21.49"
"66","000","00","016","1610","0515","670","311","359","39","709","1288","0","55.05","24.15"
"66","000","00","016","1610","0516","576","278","298","45","621","1080","0","57.5","25.74"
"66","000","00","016","1610","0517","739","340","399","24","763","1344","0","56.77","25.3"
"66","000","00","016","1610","0518","625","269","356","45","670","1061","0","63.15","25.35"
"66","000","00","016","1610","0519","726","319","407","28","754","1176","0","64.12","27.13"
"66","000","00","016","1611","0000","1548","770","778","91","1639","2562","0","63.97","30.05"
"66","000","00","016","1611","0520","735","374","361","47","782","1244","0","62.86","30.06"
"66","000","00","016","1611","0521","813","396","417","44","857","1318","0","65.02","30.05"
"66","000","00","016","1612","0000","1607","771","836","93","1700","2794","0","60.84","27.59"
"66","000","00","016","1612","0522","778","348","430","43","821","1471","0","55.81","23.66"
"66","000","00","016","1612","0523","829","423","406","50","879","1323","0","66.44","31.97"
"66","000","00","016","1613","0000","1218","535","683","54","1272","2354","0","54.04","22.73"
"66","000","00","016","1613","0490","690","329","361","34","724","1269","0","57.05","25.93"
"66","000","00","016","1613","0491","528","206","322","20","548","1085","0","50.51","18.99"
"66","000","00","016","1614","0000","2237","1013","1224","144","2381","4090","0","58.22","24.77"
"66","000","00","016","1614","0494","749","367","382","43","792","1390","0","56.98","26.4"
"66","000","00","016","1614","0495","807","356","451","61","868","1372","0","63.27","25.95"
"66","000","00","016","1614","0496","681","290","391","40","721","1328","0","54.29","21.84"
"66","000","00","016","1615","0000","1225","535","690","75","1300","2096","0","62.02","25.52"
"66","000","00","016","1615","0492","560","268","292","44","604","942","0","64.12","28.45"
"66","000","00","016","1615","0493","665","267","398","31","696","1154","0","60.31","23.14"
"66","000","00","016","1616","0000","580","290","290","28","608","1038","0","58.57","27.94"
"66","000","00","016","1616","0497","580","290","290","28","608","1038","0","58.57","27.94"
"66","000","00","017","0000","0000","49727","21605","28122","2169","51896","89487","108777","57.99","24.14"
"66","000","00","017","1701","0000","5985","2590","3395","269","6254","10976","0","56.98","23.6"
"66","000","00","017","1701","0573","954","419","535","49","1003","1630","0","61.53","25.71"
"66","000","00","017","1701","0574","851","364","487","36","887","1532","0","57.9","23.76"
"66","000","00","017","1701","0575","863","388","475","30","893","1677","0","53.25","23.14"
"66","000","00","017","1701","0576","891","366","525","43","934","1744","0","53.56","20.99"
"66","000","00","017","1701","0577","1001","451","550","39","1040","1795","0","57.94","25.13"
"66","000","00","017","1701","0578","641","272","369","40","681","1171","0","58.16","23.23"
"66","000","00","017","1701","0579","784","330","454","32","816","1427","0","57.18","23.13"
"66","000","00","017","1702","0000","775","359","416","39","814","1306","0","62.33","27.49"
"66","000","00","017","1702","0570","775","359","416","39","814","1306","0","62.33","27.49"
"66","000","00","017","1703","0000","1372","592","780","68","1440","2287","0","62.96","25.89"
"66","000","00","017","1703","0571","664","290","374","30","694","1128","0","61.52","25.71"
"66","000","00","017","1703","0572","708","302","406","38","746","1159","0","64.37","26.06"
"66","000","00","017","1704","0000","5615","2446","3169","262","5877","10187","0","57.69","24.01"
"66","000","00","017","1704","0580","943","397","546","48","991","1709","0","57.99","23.23"
"66","000","00","017","1704","0581","941","391","550","41","982","1723","0","56.99","22.69"
"66","000","00","017","1704","0582","936","406","530","40","976","1782","0","54.77","22.78"
"66","000","00","017","1704","0583","732","272","460","38","770","1407","0","54.73","19.33"
"66","000","00","017","1704","0584","1033","553","480","36","1069","1771","0","60.36","31.23"
"66","000","00","017","1704","0585","1030","427","603","59","1089","1795","0","60.67","23.79"
"66","000","00","017","1705","0000","2971","1250","1721","108","3079","5195","0","59.27","24.06"
"66","000","00","017","1705","0586","977","393","584","36","1013","1612","0","62.84","24.38"
"66","000","00","017","1705","0587","1046","459","587","36","1082","1894","0","57.13","24.23"
"66","000","00","017","1705","0588","948","398","550","36","984","1689","0","58.26","23.56"
"66","000","00","017","1706","0000","5219","2141","3078","220","5439","9343","0","58.21","22.92"
"66","000","00","017","1706","0599","953","355","598","45","998","1666","0","59.9","21.31"
"66","000","00","017","1706","0600","950","394","556","42","992","1750","0","56.69","22.51"
"66","000","00","017","1706","0601","783","325","458","37","820","1437","0","57.06","22.62"
"66","000","00","017","1706","0602","968","418","550","32","1000","1735","0","57.64","24.09"
"66","000","00","017","1706","0603","881","375","506","41","922","1612","0","57.2","23.26"
"66","000","00","017","1706","0604","684","274","410","23","707","1143","0","61.85","23.97"
"66","000","00","017","1707","0000","6721","2957","3764","244","6965","11996","0","58.06","24.65"
"66","000","00","017","1707","0605","1131","485","646","41","1172","2096","0","55.92","23.14"
"66","000","00","017","1707","0606","887","389","498","45","932","1549","0","60.17","25.11"
"66","000","00","017","1707","0607","929","416","513","23","952","1573","0","60.52","26.45"
"66","000","00","017","1707","0608","862","465","397","29","891","1585","0","56.21","29.34"
"66","000","00","017","1707","0609","858","350","508","35","893","1572","0","56.81","22.26"
"66","000","00","017","1707","0610","1034","409","625","32","1066","1738","0","61.33","23.53"
"66","000","00","017","1707","0611","1020","443","577","39","1059","1883","0","56.24","23.53"
"66","000","00","017","1708","0000","1638","762","876","65","1703","2753","0","61.86","27.68"
"66","000","00","017","1708","0612","831","410","421","34","865","1401","0","61.74","29.26"
"66","000","00","017","1708","0613","807","352","455","31","838","1352","0","61.98","26.04"
"66","000","00","017","1709","0000","3225","1371","1854","169","3394","5805","0","58.47","23.62"
"66","000","00","017","1709","0614","1168","493","675","69","1237","2085","0","59.33","23.65"
"66","000","00","017","1709","0615","1167","496","671","75","1242","2047","0","60.67","24.23"
"66","000","00","017","1709","0616","890","382","508","25","915","1673","0","54.69","22.83"
"66","000","00","017","1710","0000","2535","1213","1322","127","2662","4599","0","57.88","26.38"
"66","000","00","017","1710","0617","1053","479","574","63","1116","1874","0","59.55","25.56"
"66","000","00","017","1710","0618","612","345","267","28","640","1051","0","60.89","32.83"
"66","000","00","017","1710","0619","870","389","481","36","906","1674","0","54.12","23.24"
"66","000","00","017","1711","0000","2105","964","1141","96","2201","3834","0","57.41","25.14"
"66","000","00","017","1711","0620","1042","503","539","45","1087","1831","0","59.37","27.47"
"66","000","00","017","1711","0621","1063","461","602","51","1114","2003","0","55.62","23.02"
"66","000","00","017","1712","0000","871","434","437","36","907","1535","0","59.09","28.27"
"66","000","00","017","1712","0622","871","434","437","36","907","1535","0","59.09","28.27"
"66","000","00","017","1713","0000","2059","869","1190","118","2177","4147","0","52.5","20.95"
"66","000","00","017","1713","0623","1092","452","640","80","1172","2286","0","51.27","19.77"
"66","000","00","017","1713","0624","967","417","550","38","1005","1861","0","54.0","22.41"
"66","000","00","017","1714","0000","2375","1018","1357","118","2493","4347","0","57.35","23.42"
"66","000","00","017","1714","0589","798","332","466","37","835","1525","0","54.75","21.77"
"66","000","00","017","1714","0590","893","385","508","40","933","1622","0","57.52","23.74"
"66","000","00","017","1714","0591","684","301","383","41","725","1200","0","60.42","25.08"
"66","000","00","017","1715","0000","3622","1485","2137","122","3744","6729","0","55.64","22.07"
"66","000","00","017","1715","0592","725","328","397","14","739","1355","0","54.54","24.21"
"66","000","00","017","1715","0593","955","400","555","24","979","1777","0","55.09","22.51"
"66","000","00","017","1715","0594","1060","394","666","35","1095","1923","0","56.94","20.49"
"66","000","00","017","1715","0595","882","363","519","49","931","1674","0","55.62","21.68"
"66","000","00","017","1716","0000","2639","1154","1485","108","2747","4448","0","61.76","25.94"
"66","000","00","017","1716","0596","890","394","496","35","925","1451","0","63.75","27.15"
"66","000","00","017","1716","0597","867","374","493","37","904","1486","0","60.83","25.17"
"66","000","00","017","1716","0598","882","386","496","36","918","1511","0","60.75","25.55"
"66","000","00","018","0000","0000","42593","17763","24830","2100","44693","77189","95703","57.9","23.01"
"66","000","00","018","1801","0000","2561","1057","1504","125","2686","4378","0","61.35","24.14"
"66","000","00","018","1801","0527","911","349","562","36","947","1537","0","61.61","22.71"
"66","000","00","018","1801","0528","851","353","498","49","900","1439","0","62.54","24.53"
"66","000","00","018","1801","0529","799","355","444","40","839","1402","0","59.84","25.32"
"66","000","00","018","1802","0000","5233","2320","2913","303","5536","9096","0","60.86","25.51"
"66","000","00","018","1802","0553","949","399","550","57","1006","1568","0","64.16","25.45"
"66","000","00","018","1802","0554","962","455","507","84","1046","1761","0","59.4","25.84"
"66","000","00","018","1802","0555","1028","411","617","45","1073","1752","0","61.24","23.46"
"66","000","00","018","1802","0556","720","320","400","42","762","1264","0","60.28","25.32"
"66","000","00","018","1802","0557","787","348","439","30","817","1302","0","62.75","26.73"
"66","000","00","018","1802","0558","787","387","400","45","832","1449","0","57.42","26.71"
"66","000","00","018","1803","0000","3418","1413","2005","181","3599","6169","0","58.34","22.9"
"66","000","00","018","1803","0559","933","388","545","67","1000","1621","0","61.69","23.94"
"66","000","00","018","1803","0560","881","348","533","48","929","1647","0","56.41","21.13"
"66","000","00","018","1803","0561","786","297","489","35","821","1441","0","56.97","20.61"
"66","000","00","018","1803","0562","818","380","438","31","849","1460","0","58.15","26.03"
"66","000","00","018","1804","0000","1900","871","1029","100","2000","3203","0","62.44","27.19"
"66","000","00","018","1804","0563","1077","505","572","52","1129","1832","0","61.63","27.57"
"66","000","00","018","1804","0564","823","366","457","48","871","1371","0","63.53","26.7"
"66","000","00","018","1805","0000","1816","521","1295","164","1980","3617","0","54.74","14.4"
"66","000","00","018","1805","0568","933","271","662","63","996","1733","0","57.47","15.64"
"66","000","00","018","1805","0569","883","250","633","101","984","1884","0","52.23","13.27"
"66","000","00","018","1806","0000","2347","1033","1314","116","2463","4226","0","58.28","24.44"
"66","000","00","018","1806","0565","735","317","418","14","749","1418","0","52.82","22.36"
"66","000","00","018","1806","0566","870","385","485","51","921","1473","0","62.53","26.14"
"66","000","00","018","1806","0567","742","331","411","51","793","1335","0","59.4","24.79"
"66","000","00","018","1807","0000","2957","1274","1683","133","3090","5183","0","59.62","24.58"
"66","000","00","018","1807","0533","1072","452","620","46","1118","1887","0","59.25","23.95"
"66","000","00","018","1807","0534","876","397","479","37","913","1480","0","61.69","26.82"
"66","000","00","018","1807","0535","1009","425","584","50","1059","1816","0","58.31","23.4"
"66","000","00","018","1808","0000","2585","1108","1477","144","2729","4728","0","57.72","23.43"
"66","000","00","018","1808","0542","887","398","489","55","942","1635","0","57.61","24.34"
"66","000","00","018","1808","0543","882","359","523","48","930","1565","0","59.42","22.94"
"66","000","00","018","1808","0544","816","351","465","41","857","1528","0","56.09","22.97"
"66","000","00","018","1809","0000","3173","1386","1787","114","3287","6020","0","54.6","23.02"
"66","000","00","018","1809","0545","1045","470","575","33","1078","1963","0","54.92","23.94"
"66","000","00","018","1809","0546","1060","466","594","44","1104","2073","0","53.26","22.48"
"66","000","00","018","1809","0547","1068","450","618","37","1105","1984","0","55.7","22.68"
"66","000","00","018","1810","0000","3163","1228","1935","127","3290","5882","0","55.93","20.88"
"66","000","00","018","1810","0536","946","397","549","40","986","1898","0","51.95","20.92"
"66","000","00","018","1810","0537","1103","414","689","47","1150","2008","0","57.27","20.62"
"66","000","00","018","1810","0538","1114","417","697","40","1154","1976","0","58.4","21.1"
"66","000","00","018","1811","0000","2613","1089","1524","94","2707","4464","0","60.64","24.4"
"66","000","00","018","1811","0539","954","390","564","35","989","1673","0","59.12","23.31"
"66","000","00","018","1811","0540","858","375","483","31","889","1409","0","63.09","26.61"
"66","000","00","018","1811","0541","801","324","477","28","829","1382","0","59.99","23.44"
"66","000","00","018","1812","0000","3162","1305","1857","104","3266","5906","0","55.3","22.1"
"66","000","00","018","1812","0524","1131","450","681","44","1175","2027","0","57.97","22.2"
"66","000","00","018","1812","0525","1006","428","578","23","1029","1967","0","52.31","21.76"
"66","000","00","018","1812","0526","1025","427","598","37","1062","1912","0","55.54","22.33"
"66","000","00","018","1813","0000","3213","1286","1927","141","3354","5941","0","56.46","21.65"
"66","000","00","018","1813","0530","1065","394","671","42","1107","2013","0","54.99","19.57"
"66","000","00","018","1813","0531","1066","463","603","56","1122","1917","0","58.53","24.15"
"66","000","00","018","1813","0532","1082","429","653","43","1125","2011","0","55.94","21.33"
"66","000","00","018","1814","0000","2659","1162","1497","146","2805","4776","0","58.73","24.33"
"66","000","00","018","1814","0548","911","407","504","47","958","1688","0","56.75","24.11"
"66","000","00","018","1814","0549","761","337","424","47","808","1387","0","58.26","24.3"
"66","000","00","018","1814","0550","987","418","569","52","1039","1701","0","61.08","24.57"
"66","000","00","018","1815","0000","1793","710","1083","108","1901","3600","0","52.81","19.72"
"66","000","00","018","1815","0551","924","368","556","58","982","1721","0","57.06","21.38"
"66","000","00","018","1815","0552","869","342","527","50","919","1879","0","48.91","18.2"
"66","000","00","019","0000","0000","10869","4811","6058","612","11481","20860","24605","55.04","23.06"
"66","000","00","019","1901","0000","1884","793","1091","96","1980","3259","0","60.75","24.33"
"66","000","00","019","1901","1562","569","250","319","30","599","1011","0","59.25","24.73"
"66","000","00","019","1901","1563","682","271","411","35","717","1195","0","60.0","22.68"
"66","000","00","019","1901","1564","633","272","361","31","664","1053","0","63.06","25.83"
"66","000","00","019","1902","0000","911","393","518","41","952","1880","0","50.64","20.9"
"66","000","00","019","1902","1565","419","186","233","28","447","961","0","46.51","19.35"
"66","000","00","019","1902","1566","492","207","285","13","505","919","0","54.95","22.52"
"66","000","00","019","1903","0000","786","330","456","59","845","1367","0","61.81","24.14"
"66","000","00","019","1903","1567","786","330","456","59","845","1367","0","61.81","24.14"
"66","000","00","019","1904","0000","548","286","262","35","583","1010","0","57.72","28.32"
"66","000","00","019","1904","1568","548","286","262","35","583","1010","0","57.72","28.32"
"66","000","00","019","1905","0000","571","334","237","38","609","1169","0","52.1","28.57"
"66","000","00","019","1905","1569","571","334","237","38","609","1169","0","52.1","28.57"
"66","000","00","019","1906","0000","1034","479","555","44","1078","1883","0","57.25","25.44"
"66","000","00","019","1906","1570","535","251","284","30","565","989","0","57.13","25.38"
"66","000","00","019","1906","1571","499","228","271","14","513","894","0","57.38","25.5"
"66","000","00","019","1907","0000","1442","650","792","70","1512","2936","0","51.5","22.14"
"66","000","00","019","1907","1572","545","226","319","27","572","1033","0","55.37","21.88"
"66","000","00","019","1907","1573","467","198","269","23","490","1058","0","46.31","18.71"
"66","000","00","019","1907","1574","430","226","204","20","450","845","0","53.25","26.75"
"66","000","00","019","1908","0000","359","112","247","27","386","576","0","67.01","19.44"
"66","000","00","019","1908","1575","359","112","247","27","386","576","0","67.01","19.44"
"66","000","00","019","1909","0000","1423","715","708","78","1501","2900","0","51.76","24.66"
"66","000","00","019","1909","1576","594","292","302","34","628","1229","0","51.1","23.76"
"66","000","00","019","1909","1577","443","247","196","18","461","890","0","51.8","27.75"
"66","000","00","019","1909","1578","386","176","210","26","412","781","0","52.75","22.54"
"66","000","00","019","1910","0000","656","250","406","30","686","1244","0","55.14","20.1"
"66","000","00","019","1910","1579","656","250","406","30","686","1244","0","55.14","20.1"
"66","000","00","019","1911","0000","380","180","200","36","416","889","0","46.79","20.25"
"66","000","00","019","1911","1580","74","29","45","10","84","213","0","39.44","13.62"
"66","000","00","019","1911","1581","306","151","155","26","332","676","0","49.11","22.34"
"66","000","00","019","1912","0000","261","70","191","22","283","585","0","48.38","11.97"
"66","000","00","019","1912","1582","261","70","191","22","283","585","0","48.38","11.97"
"66","000","00","019","1913","0000","614","219","395","36","650","1162","0","55.94","18.85"
"66","000","00","019","1913","1583","509","180","329","31","540","938","0","57.57","19.19"
"66","000","00","019","1913","1584","105","39","66","5","110","224","0","49.11","17.41"
"66","000","00","020","0000","0000","7228","3080","4148","455","7683","12880","14968","59.65","23.91"
"66","000","00","020","2001","0000","701","289","412","33","734","1244","0","59.0","23.23"
"66","000","00","020","2001","1552","701","289","412","33","734","1244","0","59.0","23.23"
"66","000","00","020","2002","0000","843","366","477","34","877","1539","0","56.99","23.78"
"66","000","00","020","2002","1553","843","366","477","34","877","1539","0","56.99","23.78"
"66","000","00","020","2003","0000","668","314","354","47","715","1202","0","59.48","26.12"
"66","000","00","020","2003","1554","668","314","354","47","715","1202","0","59.48","26.12"
"66","000","00","020","2004","0000","639","293","346","58","697","1272","0","54.8","23.03"
"66","000","00","020","2004","1555","639","293","346","58","697","1272","0","54.8","23.03"
"66","000","00","020","2005","0000","372","155","217","19","391","652","0","59.97","23.77"
"66","000","00","020","2005","1556","372","155","217","19","391","652","0","59.97","23.77"
"66","000","00","020","2006","0000","906","404","502","54","960","1457","0","65.89","27.73"
"66","000","00","020","2006","1557","906","404","502","54","960","1457","0","65.89","27.73"
"66","000","00","020","2007","0000","1002","441","561","59","1061","1836","0","57.79","24.02"
"66","000","00","020","2007","1558","1002","441","561","59","1061","1836","0","57.79","24.02"
"66","000","00","020","2008","0000","548","221","327","39","587","1001","0","58.64","22.08"
"66","000","00","020","2008","1559","548","221","327","39","587","1001","0","58.64","22.08"
"66","000","00","020","2009","0000","842","310","532","53","895","1448","0","61.81","21.41"
"66","000","00","020","2009","1560","842","310","532","53","895","1448","0","61.81","21.41"
"66","000","00","020","2010","0000","707","287","420","59","766","1229","0","62.33","23.35"
"66","000","00","020","2010","1561","707","287","420","59","766","1229","0","62.33","23.35"
"66","000","00","021","0000","0000","15055","6256","8799","857","15912","27059","32202","58.8","23.12"
"66","000","00","021","2101","0000","564","228","336","38","602","1059","0","56.85","21.53"
"66","000","00","021","2101","0071","564","228","336","38","602","1059","0","56.85","21.53"
"66","000","00","021","2102","0000","1255","490","765","72","1327","2163","0","61.35","22.65"
"66","000","00","021","2102","0072","582","212","370","23","605","1013","0","59.72","20.93"
"66","000","00","021","2102","0073","673","278","395","49","722","1150","0","62.78","24.17"
"66","000","00","021","2103","0000","1002","410","592","72","1074","1902","0","56.47","21.56"
"66","000","00","021","2103","0081","1002","410","592","72","1074","1902","0","56.47","21.56"
"66","000","00","021","2104","0000","2734","1001","1733","129","2863","4635","0","61.77","21.6"
"66","000","00","021","2104","0074","1134","412","722","51","1185","1855","0","63.88","22.21"
"66","000","00","021","2104","0075","761","277","484","34","795","1327","0","59.91","20.87"
"66","000","00","021","2104","0076","839","312","527","44","883","1453","0","60.77","21.47"
"66","000","00","021","2105","0000","2065","867","1198","134","2199","3446","0","63.81","25.16"
"66","000","00","021","2105","0082","685","296","389","46","731","1138","0","64.24","26.01"
"66","000","00","021","2105","0083","633","256","377","51","684","1065","0","64.23","24.04"
"66","000","00","021","2105","0084","747","315","432","37","784","1243","0","63.07","25.34"
"66","000","00","021","2106","0000","3404","1406","1998","155","3559","6297","0","56.52","22.33"
"66","000","00","021","2106","0077","861","353","508","61","922","1653","0","55.78","21.36"
"66","000","00","021","2106","0078","851","323","528","30","881","1615","0","54.55","20.0"
"66","000","00","021","2106","0079","785","326","459","21","806","1470","0","54.83","22.18"
"66","000","00","021","2106","0080","907","404","503","43","950","1559","0","60.94","25.91"
"66","000","00","021","2107","0000","754","330","424","30","784","1391","0","56.36","23.72"
"66","000","00","021","2107","0088","754","330","424","30","784","1391","0","56.36","23.72"
"66","000","00","021","2108","0000","744","314","430","55","799","1216","0","65.71","25.82"
"66","000","00","021","2108","0087","744","314","430","55","799","1216","0","65.71","25.82"
"66","000","00","021","2109","0000","1098","532","566","91","1189","2131","0","55.8","24.96"
"66","000","00","021","2109","0085","490","198","292","41","531","962","0","55.2","20.58"
"66","000","00","021","2109","0086","608","334","274","50","658","1169","0","56.29","28.57"
"66","000","00","021","2110","0000","867","397","470","53","920","1616","0","56.93","24.57"
"66","000","00","021","2110","0089","867","397","470","53","920","1616","0","56.93","24.57"
"66","000","00","021","2111","0000","568","281","287","28","596","1203","0","49.54","23.36"
"66","000","00","021","2111","0090","568","281","287","28","596","1203","0","49.54","23.36"
"66","000","00","022","0000","0000","9173","4122","5051","610","9783","16520","19250","59.22","24.95"
"66","000","00","022","2201","0000","537","245","292","41","578","1068","0","54.12","22.94"
"66","000","00","022","2201","0055","537","245","292","41","578","1068","0","54.12","22.94"
"66","000","00","022","2202","0000","571","273","298","43","614","1050","0","58.48","26.0"
"66","000","00","022","2202","0056","571","273","298","43","614","1050","0","58.48","26.0"
"66","000","00","022","2203","0000","1450","627","823","97","1547","2643","0","58.53","23.72"
"66","000","00","022","2203","0057","700","314","386","57","757","1246","0","60.75","25.2"
"66","000","00","022","2203","0058","750","313","437","40","790","1397","0","56.55","22.41"
"66","000","00","022","2204","0000","893","411","482","50","943","1581","0","59.65","26.0"
"66","000","00","022","2204","0061","568","255","313","28","596","914","0","65.21","27.9"
"66","000","00","022","2204","0062","325","156","169","22","347","667","0","52.02","23.39"
"66","000","00","022","2205","0000","656","313","343","40","696","1170","0","59.49","26.75"
"66","000","00","022","2205","0060","656","313","343","40","696","1170","0","59.49","26.75"
"66","000","00","022","2206","0000","733","342","391","34","767","1227","0","62.51","27.87"
"66","000","00","022","2206","0059","733","342","391","34","767","1227","0","62.51","27.87"
"66","000","00","022","2207","0000","442","191","251","44","486","890","0","54.61","21.46"
"66","000","00","022","2207","0063","442","191","251","44","486","890","0","54.61","21.46"
"66","000","00","022","2208","0000","918","418","500","67","985","1744","0","56.48","23.97"
"66","000","00","022","2208","0064","693","321","372","46","739","1289","0","57.33","24.9"
"66","000","00","022","2208","0065","225","97","128","21","246","455","0","54.07","21.32"
"66","000","00","022","2209","0000","555","255","300","38","593","1028","0","57.68","24.81"
"66","000","00","022","2209","0066","555","255","300","38","593","1028","0","57.68","24.81"
"66","000","00","022","2210","0000","808","325","483","68","876","1446","0","60.58","22.48"
"66","000","00","022","2210","0067","808","325","483","68","876","1446","0","60.58","22.48"
"66","000","00","022","2211","0000","1031","446","585","66","1097","1750","0","62.69","25.49"
"66","000","00","022","2211","0068","425","180","245","22","447","688","0","64.97","26.16"
"66","000","00","022","2211","0069","606","266","340","44","650","1062","0","61.21","25.05"
"66","000","00","022","2212","0000","579","276","303","22","601","923","0","65.11","29.9"
"66","000","00","022","2212","0070","579","276","303","22","601","923","0","65.11","29.9"
"66","000","00","023","0000","0000","34567","15313","19254","1901","36468","61705","75275","59.1","24.82"
"66","000","00","023","2301","0000","4890","2208","2682","225","5115","8455","0","60.5","26.11"
"66","000","00","023","2301","0317","898","439","459","46","944","1480","0","63.78","29.66"
"66","000","00","023","2301","0318","1080","482","598","49","1129","1841","0","61.33","26.18"
"66","000","00","023","2301","0319","956","422","534","50","1006","1751","0","57.45","24.1"
"66","000","00","023","2301","0320","920","437","483","40","960","1547","0","62.06","28.25"
"66","000","00","023","2301","0321","1036","428","608","40","1076","1836","0","58.61","23.31"
"66","000","00","023","2302","0000","1467","741","726","117","1584","2534","0","62.51","29.24"
"66","000","00","023","2302","0322","772","418","354","62","834","1239","0","67.31","33.74"
"66","000","00","023","2302","0323","695","323","372","55","750","1295","0","57.92","24.94"
"66","000","00","023","2303","0000","2553","1115","1438","128","2681","4707","0","56.96","23.69"
"66","000","00","023","2303","0324","712","353","359","21","733","1263","0","58.04","27.95"
"66","000","00","023","2303","0325","879","395","484","31","910","1622","0","56.1","24.35"
"66","000","00","023","2303","0326","962","367","595","76","1038","1822","0","56.97","20.14"
"66","000","00","023","2304","0000","2580","1082","1498","194","2774","4813","0","57.64","22.48"
"66","000","00","023","2304","0327","971","412","559","120","1091","1966","0","55.49","20.96"
"66","000","00","023","2304","0328","915","376","539","38","953","1615","0","59.01","23.28"
"66","000","00","023","2304","0329","694","294","400","36","730","1232","0","59.25","23.86"
"66","000","00","023","2305","0000","1323","569","754","57","1380","2512","0","54.94","22.65"
"66","000","00","023","2305","0330","718","293","425","35","753","1347","0","55.9","21.75"
"66","000","00","023","2305","0331","605","276","329","22","627","1165","0","53.82","23.69"
"66","000","00","023","2306","0000","7254","3153","4101","332","7586","12812","0","59.21","24.61"
"66","000","00","023","2306","0332","978","422","556","33","1011","1664","0","60.76","25.36"
"66","000","00","023","2306","0333","747","321","426","37","784","1230","0","63.74","26.1"
"66","000","00","023","2306","0334","939","422","517","61","1000","1574","0","63.53","26.81"
"66","000","00","023","2306","0335","886","376","510","34","920","1452","0","63.36","25.9"
"66","000","00","023","2306","0336","966","423","543","49","1015","1879","0","54.02","22.51"
"66","000","00","023","2306","0337","894","398","496","35","929","1601","0","58.03","24.86"
"66","000","00","023","2306","0338","911","380","531","51","962","1546","0","62.23","24.58"
"66","000","00","023","2306","0339","933","411","522","32","965","1866","0","51.71","22.03"
"66","000","00","023","2307","0000","4170","1598","2572","193","4363","7449","0","58.57","21.45"
"66","000","00","023","2307","0340","1106","389","717","50","1156","1938","0","59.65","20.07"
"66","000","00","023","2307","0341","992","402","590","50","1042","1759","0","59.24","22.85"
"66","000","00","023","2307","0342","1102","433","669","58","1160","2061","0","56.28","21.01"
"66","000","00","023","2307","0343","970","374","596","35","1005","1691","0","59.43","22.12"
"66","000","00","023","2308","0000","1362","703","659","75","1437","2260","0","63.58","31.11"
"66","000","00","023","2308","0344","634","335","299","45","679","1039","0","65.35","32.24"
"66","000","00","023","2308","0345","728","368","360","30","758","1221","0","62.08","30.14"
"66","000","00","023","2309","0000","941","422","519","66","1007","1650","0","61.03","25.58"
"66","000","00","023","2309","0346","941","422","519","66","1007","1650","0","61.03","25.58"
"66","000","00","023","2310","0000","1224","588","636","78","1302","2157","0","60.36","27.26"
"66","000","00","023","2310","0347","539","268","271","29","568","937","0","60.62","28.6"
"66","000","00","023","2310","0348","685","320","365","49","734","1220","0","60.16","26.23"
"66","000","00","023","2311","0000","1061","498","563","84","1145","2139","0","53.53","23.28"
"66","000","00","023","2311","0349","1061","498","563","84","1145","2139","0","53.53","23.28"
"66","000","00","023","2312","0000","2469","1107","1362","143","2612","4356","0","59.96","25.41"
"66","000","00","023","2312","0350","841","381","460","52","893","1371","0","65.13","27.79"
"66","000","00","023","2312","0351","713","304","409","49","762","1277","0","59.67","23.81"
"66","000","00","023","2312","0352","915","422","493","42","957","1708","0","56.03","24.71"
"66","000","00","023","2313","0000","1200","590","610","57","1257","2048","0","61.38","28.81"
"66","000","00","023","2313","0353","1200","590","610","57","1257","2048","0","61.38","28.81"
"66","000","00","023","2314","0000","849","406","443","63","912","1632","0","55.88","24.88"
"66","000","00","023","2314","0354","849","406","443","63","912","1632","0","55.88","24.88"
"66","000","00","023","2315","0000","772","354","418","38","810","1327","0","61.04","26.68"
"66","000","00","023","2315","0355","772","354","418","38","810","1327","0","61.04","26.68"
"66","000","00","023","2316","0000","452","179","273","51","503","854","0","58.9","20.96"
"66","000","00","023","2316","0356","452","179","273","51","503","854","0","58.9","20.96"
"66","000","00","024","0000","0000","26481","11483","14998","1402","27883","47457","57267","58.75","24.2"
"66","000","00","024","2401","0000","2386","1060","1326","110","2496","4327","0","57.68","24.5"
"66","000","00","024","2401","0284","802","393","409","22","824","1415","0","58.23","27.77"
"66","000","00","024","2401","0285","704","299","405","46","750","1392","0","53.88","21.48"
"66","000","00","024","2401","0286","880","368","512","42","922","1520","0","60.66","24.21"
"66","000","00","024","2402","0000","544","263","281","42","586","862","0","67.98","30.51"
"66","000","00","024","2402","0287","544","263","281","42","586","862","0","67.98","30.51"
"66","000","00","024","2403","0000","2028","833","1195","126","2154","3558","0","60.54","23.41"
"66","000","00","024","2403","0288","743","298","445","41","784","1256","0","62.42","23.73"
"66","000","00","024","2403","0289","705","267","438","46","751","1292","0","58.13","20.67"
"66","000","00","024","2403","0290","580","268","312","39","619","1010","0","61.29","26.53"
"66","000","00","024","2404","0000","856","356","500","63","919","1485","0","61.89","23.97"
"66","000","00","024","2404","0291","856","356","500","63","919","1485","0","61.89","23.97"
"66","000","00","024","2405","0000","1427","596","831","91","1518","2440","0","62.21","24.43"
"66","000","00","024","2405","0292","728","289","439","44","772","1190","0","64.87","24.29"
"66","000","00","024","2405","0293","699","307","392","47","746","1250","0","59.68","24.56"
"66","000","00","024","2406","0000","1444","624","820","74","1518","2604","0","58.29","23.96"
"66","000","00","024","2406","0294","749","291","458","31","780","1310","0","59.54","22.21"
"66","000","00","024","2406","0295","695","333","362","43","738","1294","0","57.03","25.73"
"66","000","00","024","2407","0000","1769","742","1027","102","1871","3050","0","61.34","24.33"
"66","000","00","024","2407","0296","1042","436","606","51","1093","1734","0","63.03","25.14"
"66","000","00","024","2407","0297","727","306","421","51","778","1316","0","59.12","23.25"
"66","000","00","024","2408","0000","1269","568","701","76","1345","2127","0","63.23","26.7"
"66","000","00","024","2408","0298","474","221","253","40","514","854","0","60.19","25.88"
"66","000","00","024","2408","0299","795","347","448","36","831","1273","0","65.28","27.26"
"66","000","00","024","2409","0000","536","233","303","14","550","851","0","64.63","27.38"
"66","000","00","024","2409","0300","536","233","303","14","550","851","0","64.63","27.38"
"66","000","00","024","2410","0000","902","376","526","27","929","1629","0","57.03","23.08"
"66","000","00","024","2410","0301","902","376","526","27","929","1629","0","57.03","23.08"
"66","000","00","024","2411","0000","905","411","494","62","967","1709","0","56.58","24.05"
"66","000","00","024","2411","0302","905","411","494","62","967","1709","0","56.58","24.05"
"66","000","00","024","2412","0000","504","222","282","24","528","953","0","55.4","23.29"
"66","000","00","024","2412","0303","504","222","282","24","528","953","0","55.4","23.29"
"66","000","00","024","2413","0000","770","334","436","45","815","1336","0","61.0","25.0"
"66","000","00","024","2413","0304","770","334","436","45","815","1336","0","61.0","25.0"
"66","000","00","024","2414","0000","3932","1640","2292","212","4144","7282","0","56.91","22.52"
"66","000","00","024","2414","0305","1085","493","592","65","1150","2113","0","54.42","23.33"
"66","000","00","024","2414","0306","957","399","558","64","1021","1730","0","59.02","23.06"
"66","000","00","024","2414","0307","927","374","553","34","961","1692","0","56.8","22.1"
"66","000","00","024","2414","0308","963","374","589","49","1012","1747","0","57.93","21.41"
"66","000","00","024","2415","0000","2732","1228","1504","120","2852","5020","0","56.81","24.46"
"66","000","00","024","2415","0309","925","425","500","39","964","1672","0","57.66","25.42"
"66","000","00","024","2415","0310","898","419","479","33","931","1675","0","55.58","25.01"
"66","000","00","024","2415","0311","909","384","525","48","957","1673","0","57.2","22.95"
"66","000","00","024","2416","0000","2524","1204","1320","124","2648","4732","0","55.96","25.44"
"66","000","00","024","2416","0312","947","470","477","35","982","1636","0","60.02","28.73"
"66","000","00","024","2416","0313","895","421","474","61","956","1753","0","54.54","24.02"
"66","000","00","024","2416","0314","682","313","369","28","710","1343","0","52.87","23.31"
"66","000","00","024","2417","0000","1953","793","1160","90","2043","3492","0","58.51","22.71"
"66","000","00","024","2417","0315","960","427","533","50","1010","1822","0","55.43","23.44"
"66","000","00","024","2417","0316","993","366","627","40","1033","1670","0","61.86","21.92"
"66","000","00","025","0000","0000","34430","14854","19576","1694","36124","63584","77922","56.81","23.36"
"66","000","00","025","2501","0000","1698","711","987","99","1797","3033","0","59.25","23.44"
"66","000","00","025","2501","0239","1005","435","570","63","1068","1758","0","60.75","24.74"
"66","000","00","025","2501","0240","693","276","417","36","729","1275","0","57.18","21.65"
"66","000","00","025","2502","0000","1408","633","775","51","1459","2782","0","52.44","22.75"
"66","000","00","025","2502","0241","690","324","366","19","709","1379","0","51.41","23.5"
"66","000","00","025","2502","0242","718","309","409","32","750","1403","0","53.46","22.02"
"66","000","00","025","2503","0000","1039","442","597","71","1110","1875","0","59.2","23.57"
"66","000","00","025","2503","0243","534","242","292","36","570","974","0","58.52","24.85"
"66","000","00","025","2503","0244","505","200","305","35","540","901","0","59.93","22.2"
"66","000","00","025","2504","0000","1844","813","1031","107","1951","3388","0","57.59","24.0"
"66","000","00","025","2504","0245","925","395","530","62","987","1779","0","55.48","22.2"
"66","000","00","025","2504","0246","919","418","501","45","964","1609","0","59.91","25.98"
"66","000","00","025","2505","0000","477","217","260","25","502","1038","0","48.36","20.91"
"66","000","00","025","2505","0247","477","217","260","25","502","1038","0","48.36","20.91"
"66","000","00","025","2506","0000","1338","566","772","76","1414","2249","0","62.87","25.17"
"66","000","00","025","2506","0248","781","328","453","52","833","1328","0","62.73","24.7"
"66","000","00","025","2506","0249","557","238","319","24","581","921","0","63.08","25.84"
"66","000","00","025","2507","0000","2545","1182","1363","117","2662","5028","0","52.94","23.51"
"66","000","00","025","2507","0250","819","346","473","35","854","1609","0","53.08","21.5"
"66","000","00","025","2507","0251","598","283","315","20","618","1227","0","50.37","23.06"
"66","000","00","025","2507","0252","690","304","386","43","733","1278","0","57.36","23.79"
"66","000","00","025","2507","0253","438","249","189","19","457","914","0","50.0","27.24"
"66","000","00","025","2508","0000","1421","616","805","62","1483","2911","0","50.94","21.16"
"66","000","00","025","2508","0254","810","346","464","26","836","1678","0","49.82","20.62"
"66","000","00","025","2508","0255","611","270","341","36","647","1233","0","52.47","21.9"
"66","000","00","025","2509","0000","2622","1262","1360","139","2761","4945","0","55.83","25.52"
"66","000","00","025","2509","0256","808","350","458","55","863","1520","0","56.78","23.03"
"66","000","00","025","2509","0257","944","394","550","35","979","1905","0","51.39","20.68"
"66","000","00","025","2509","0258","870","518","352","49","919","1520","0","60.46","34.08"
"66","000","00","025","2510","0000","3052","1377","1675","125","3177","5692","0","55.82","24.19"
"66","000","00","025","2510","0259","709","298","411","47","756","1385","0","54.58","21.52"
"66","000","00","025","2510","0260","658","313","345","30","688","1212","0","56.77","25.83"
"66","000","00","025","2510","0261","818","362","456","15","833","1432","0","58.17","25.28"
"66","000","00","025","2510","0262","867","404","463","33","900","1663","0","54.12","24.29"
"66","000","00","025","2511","0000","3889","1554","2335","165","4054","7249","0","55.92","21.44"
"66","000","00","025","2511","0263","740","288","452","33","773","1422","0","54.36","20.25"
"66","000","00","025","2511","0264","782","363","419","40","822","1616","0","50.87","22.46"
"66","000","00","025","2511","0265","796","314","482","51","847","1422","0","59.56","22.08"
"66","000","00","025","2511","0266","694","216","478","18","712","1165","0","61.12","18.54"
"66","000","00","025","2511","0267","877","373","504","23","900","1624","0","55.42","22.97"
"66","000","00","025","2512","0000","1408","608","800","94","1502","2556","0","58.76","23.79"
"66","000","00","025","2512","0268","850","374","476","53","903","1613","0","55.98","23.19"
"66","000","00","025","2512","0269","558","234","324","41","599","943","0","63.52","24.81"
"66","000","00","025","2513","0000","3252","1381","1871","198","3450","6091","0","56.64","22.67"
"66","000","00","025","2513","0270","799","338","461","69","868","1595","0","54.42","21.19"
"66","000","00","025","2513","0271","832","319","513","57","889","1508","0","58.95","21.15"
"66","000","00","025","2513","0272","779","344","435","34","813","1479","0","54.97","23.26"
"66","000","00","025","2513","0273","842","380","462","38","880","1509","0","58.32","25.18"
"66","000","00","025","2514","0000","919","402","517","48","967","1582","0","61.13","25.41"
"66","000","00","025","2514","0274","919","402","517","48","967","1582","0","61.13","25.41"
"66","000","00","025","2515","0000","2710","1206","1504","118","2828","4692","0","60.27","25.7"
"66","000","00","025","2515","0280","642","297","345","26","668","1121","0","59.59","26.49"
"66","000","00","025","2515","0281","590","289","301","30","620","987","0","62.82","29.28"
"66","000","00","025","2515","0282","654","307","347","37","691","1206","0","57.3","25.46"
"66","000","00","025","2515","0283","824","313","511","25","849","1378","0","61.61","22.71"
"66","000","00","025","2516","0000","4808","1884","2924","199","5007","8473","0","59.09","22.24"
"66","000","00","025","2516","0275","930","353","577","49","979","1725","0","56.75","20.46"
"66","000","00","025","2516","0276","916","313","603","26","942","1616","0","58.29","19.37"
"66","000","00","025","2516","0277","964","409","555","29","993","1657","0","59.93","24.68"
"66","000","00","025","2516","0278","998","389","609","48","1046","1774","0","58.96","21.93"
"66","000","00","025","2516","0279","1000","420","580","47","1047","1701","0","61.55","24.69"
"66","000","00","026","0000","0000","31591","13869","17722","2013","33604","55225","65632","60.85","25.11"
"66","000","00","026","2601","0000","714","308","406","36","750","1205","0","62.24","25.56"
"66","000","00","026","2601","1470","714","308","406","36","750","1205","0","62.24","25.56"
"66","000","00","026","2602","0000","5172","2184","2988","298","5470","9281","0","58.94","23.53"
"66","000","00","026","2602","1471","884","384","500","50","934","1620","0","57.65","23.7"
"66","000","00","026","2602","1472","900","371","529","62","962","1559","0","61.71","23.8"
"66","000","00","026","2602","1473","904","376","528","51","955","1660","0","57.53","22.65"
"66","000","00","026","2602","1474","940","375","565","48","988","1602","0","61.67","23.41"
"66","000","00","026","2602","1475","700","331","369","36","736","1325","0","55.55","24.98"
"66","000","00","026","2602","1476","844","347","497","51","895","1515","0","59.08","22.9"
"66","000","00","026","2603","0000","2525","1063","1462","150","2675","4738","0","56.46","22.44"
"66","000","00","026","2603","1477","842","337","505","46","888","1561","0","56.89","21.59"
"66","000","00","026","2603","1478","869","396","473","51","920","1691","0","54.41","23.42"
"66","000","00","026","2603","1479","814","330","484","53","867","1486","0","58.34","22.21"
"66","000","00","026","2604","0000","1374","602","772","85","1459","2333","0","62.54","25.8"
"66","000","00","026","2604","1480","571","269","302","42","613","975","0","62.87","27.59"
"66","000","00","026","2604","1481","803","333","470","43","846","1358","0","62.3","24.52"
"66","000","00","026","2605","0000","1265","533","732","71","1336","1996","0","66.93","26.7"
"66","000","00","026","2605","1482","735","295","440","34","769","1141","0","67.4","25.85"
"66","000","00","026","2605","1483","530","238","292","37","567","855","0","66.32","27.84"
"66","000","00","026","2606","0000","680","285","395","72","752","1202","0","62.56","23.71"
"66","000","00","026","2606","1484","680","285","395","72","752","1202","0","62.56","23.71"
"66","000","00","026","2607","0000","575","273","302","40","615","1078","0","57.05","25.32"
"66","000","00","026","2607","1485","575","273","302","40","615","1078","0","57.05","25.32"
"66","000","00","026","2608","0000","3445","1428","2017","158","3603","5834","0","61.76","24.48"
"66","000","00","026","2608","1486","861","369","492","43","904","1456","0","62.09","25.34"
"66","000","00","026","2608","1487","938","384","554","28","966","1573","0","61.41","24.41"
"66","000","00","026","2608","1488","898","362","536","49","947","1591","0","59.52","22.75"
"66","000","00","026","2608","1489","748","313","435","38","786","1214","0","64.74","25.78"
"66","000","00","026","2609","0000","1722","696","1026","95","1817","2936","0","61.89","23.71"
"66","000","00","026","2609","1508","806","300","506","45","851","1363","0","62.44","22.01"
"66","000","00","026","2609","1509","916","396","520","50","966","1573","0","61.41","25.17"
"66","000","00","026","2610","0000","2163","1017","1146","131","2294","3910","0","58.67","26.01"
"66","000","00","026","2610","1490","686","304","382","47","733","1267","0","57.85","23.99"
"66","000","00","026","2610","1491","715","325","390","50","765","1277","0","59.91","25.45"
"66","000","00","026","2610","1492","762","388","374","34","796","1366","0","58.27","28.4"
"66","000","00","026","2611","0000","1167","500","667","80","1247","1857","0","67.15","26.93"
"66","000","00","026","2611","1493","638","287","351","52","690","994","0","69.42","28.87"
"66","000","00","026","2611","1494","529","213","316","28","557","863","0","64.54","24.68"
"66","000","00","026","2612","0000","1314","610","704","86","1400","2436","0","57.47","25.04"
"66","000","00","026","2612","1495","698","310","388","36","734","1274","0","57.61","24.33"
"66","000","00","026","2612","1496","616","300","316","50","666","1162","0","57.31","25.82"
"66","000","00","026","2613","0000","1463","666","797","112","1575","2574","0","61.19","25.87"
"66","000","00","026","2613","1497","729","314","415","57","786","1252","0","62.78","25.08"
"66","000","00","026","2613","1498","734","352","382","55","789","1322","0","59.68","26.63"
"66","000","00","026","2614","0000","1441","708","733","101","1542","2642","0","58.36","26.8"
"66","000","00","026","2614","1504","676","351","325","46","722","1314","0","54.95","26.71"
"66","000","00","026","2614","1505","765","357","408","55","820","1328","0","61.75","26.88"
"66","000","00","026","2615","0000","1179","540","639","106","1285","2077","0","61.87","26.0"
"66","000","00","026","2615","1506","555","278","277","46","601","989","0","60.77","28.11"
"66","000","00","026","2615","1507","624","262","362","60","684","1088","0","62.87","24.08"
"66","000","00","026","2616","0000","615","281","334","46","661","1117","0","59.18","25.16"
"66","000","00","026","2616","1510","615","281","334","46","661","1117","0","59.18","25.16"
"66","000","00","026","2617","0000","1465","690","775","98","1563","2366","0","66.06","29.16"
"66","000","00","026","2617","1511","820","362","458","54","874","1342","0","65.13","26.97"
"66","000","00","026","2617","1512","645","328","317","44","689","1024","0","67.29","32.03"
"66","000","00","026","2618","0000","1340","668","672","112","1452","2272","0","63.91","29.4"
"66","000","00","026","2618","1499","669","313","356","43","712","1116","0","63.8","28.05"
"66","000","00","026","2618","1500","671","355","316","69","740","1156","0","64.01","30.71"
"66","000","00","026","2619","0000","1275","529","746","99","1374","2075","0","66.22","25.49"
"66","000","00","026","2619","1501","692","296","396","52","744","1147","0","64.86","25.81"
"66","000","00","026","2619","1502","583","233","350","47","630","928","0","67.89","25.11"
"66","000","00","026","2620","0000","697","288","409","37","734","1296","0","56.64","22.22"
"66","000","00","026","2620","1503","697","288","409","37","734","1296","0","56.64","22.22"
"66","000","00","027","0000","0000","83057","35443","47614","4008","87065","157926","191097","55.13","22.44"
"66","000","00","027","2701","0000","2853","1318","1535","159","3012","5448","0","55.29","24.19"
"66","000","00","027","2701","1271","936","422","514","64","1000","1821","0","54.91","23.17"
"66","000","00","027","2701","1272","842","373","469","40","882","1680","0","52.5","22.2"
"66","000","00","027","2701","1273","1075","523","552","55","1130","1947","0","58.04","26.86"
"66","000","00","027","2702","0000","3001","1221","1780","155","3156","5757","0","54.82","21.21"
"66","000","00","027","2702","1274","1083","480","603","71","1154","1910","0","60.42","25.13"
"66","000","00","027","2702","1275","986","442","544","33","1019","1894","0","53.8","23.34"
"66","000","00","027","2702","1276","932","299","633","51","983","1953","0","50.33","15.31"
"66","000","00","027","2703","0000","2140","995","1145","88","2228","4067","0","54.78","24.47"
"66","000","00","027","2703","1281","1052","488","564","54","1106","2011","0","55.0","24.27"
"66","000","00","027","2703","1282","1088","507","581","34","1122","2056","0","54.57","24.66"
"66","000","00","027","2704","0000","1887","880","1007","109","1996","3317","0","60.17","26.53"
"66","000","00","027","2704","1287","1081","506","575","50","1131","1886","0","59.97","26.83"
"66","000","00","027","2704","1288","806","374","432","59","865","1431","0","60.45","26.14"
"66","000","00","027","2705","0000","1540","670","870","93","1633","2924","0","55.85","22.91"
"66","000","00","027","2705","1297","698","286","412","52","750","1378","0","54.43","20.75"
"66","000","00","027","2705","1298","842","384","458","41","883","1546","0","57.12","24.84"
"66","000","00","027","2706","0000","2123","838","1285","87","2210","4083","0","54.13","20.52"
"66","000","00","027","2706","1291","1074","400","674","42","1116","2048","0","54.49","19.53"
"66","000","00","027","2706","1292","1049","438","611","45","1094","2035","0","53.76","21.52"
"66","000","00","027","2707","0000","3188","1439","1749","131","3319","6114","0","54.29","23.54"
"66","000","00","027","2707","1316","925","383","542","33","958","1623","0","59.03","23.6"
"66","000","00","027","2707","1317","752","361","391","33","785","1548","0","50.71","23.32"
"66","000","00","027","2707","1318","784","346","438","37","821","1442","0","56.93","23.99"
"66","000","00","027","2707","1319","727","349","378","28","755","1501","0","50.3","23.25"
"66","000","00","027","2708","0000","1749","658","1091","71","1820","3605","0","50.49","18.25"
"66","000","00","027","2708","1312","954","339","615","50","1004","1654","0","60.7","20.5"
"66","000","00","027","2708","1313","795","319","476","21","816","1951","0","41.82","16.35"
"66","000","00","027","2709","0000","1832","722","1110","123","1955","3281","0","59.59","22.01"
"66","000","00","027","2709","1301","895","385","510","65","960","1582","0","60.68","24.34"
"66","000","00","027","2709","1302","937","337","600","58","995","1699","0","58.56","19.84"
"66","000","00","027","2710","0000","2633","1052","1581","122","2755","5163","0","53.36","20.38"
"66","000","00","027","2710","1307","924","409","515","40","964","1776","0","54.28","23.03"
"66","000","00","027","2710","1308","909","329","580","37","946","1729","0","54.71","19.03"
"66","000","00","027","2710","1309","800","314","486","45","845","1658","0","50.97","18.94"
"66","000","00","027","2711","0000","3894","1508","2386","157","4051","7262","0","55.78","20.77"
"66","000","00","027","2711","1325","1164","448","716","50","1214","2075","0","58.51","21.59"
"66","000","00","027","2711","1326","867","337","530","39","906","1723","0","52.58","19.56"
"66","000","00","027","2711","1327","1100","431","669","45","1145","2049","0","55.88","21.03"
"66","000","00","027","2711","1328","763","292","471","23","786","1415","0","55.55","20.64"
"66","000","00","027","2712","0000","3852","1639","2213","171","4023","7197","0","55.9","22.77"
"66","000","00","027","2712","1335","833","331","502","43","876","1667","0","52.55","19.86"
"66","000","00","027","2712","1336","989","422","567","41","1030","1793","0","57.45","23.54"
"66","000","00","027","2712","1337","1047","433","614","44","1091","1903","0","57.33","22.75"
"66","000","00","027","2712","1338","983","453","530","43","1026","1834","0","55.94","24.7"
"66","000","00","027","2713","0000","3039","1261","1778","111","3150","5993","0","52.56","21.04"
"66","000","00","027","2713","1346","961","380","581","39","1000","1974","0","50.66","19.25"
"66","000","00","027","2713","1347","1019","431","588","35","1054","1828","0","57.66","23.58"
"66","000","00","027","2713","1348","1059","450","609","37","1096","2191","0","50.02","20.54"
"66","000","00","027","2714","0000","907","393","514","71","978","1825","0","53.59","21.53"
"66","000","00","027","2714","1349","907","393","514","71","978","1825","0","53.59","21.53"
"66","000","00","027","2715","0000","628","286","342","66","694","1225","0","56.65","23.35"
"66","000","00","027","2715","1351","628","286","342","66","694","1225","0","56.65","23.35"
"66","000","00","027","2716","0000","1678","719","959","72","1750","3179","0","55.05","22.62"
"66","000","00","027","2716","1352","903","339","564","38","941","1678","0","56.08","20.2"
"66","000","00","027","2716","1353","775","380","395","34","809","1501","0","53.9","25.32"
"66","000","00","027","2717","0000","1613","789","824","99","1712","3094","0","55.33","25.5"
"66","000","00","027","2717","1357","699","352","347","34","733","1428","0","51.33","24.65"
"66","000","00","027","2717","1358","914","437","477","65","979","1666","0","58.76","26.23"
"66","000","00","027","2718","0000","2406","1120","1286","136","2542","4710","0","53.97","23.78"
"66","000","00","027","2718","1361","637","300","337","35","672","1166","0","57.63","25.73"
"66","000","00","027","2718","1362","1000","493","507","58","1058","1790","0","59.11","27.54"
"66","000","00","027","2718","1363","769","327","442","43","812","1754","0","46.29","18.64"
"66","000","00","027","2719","0000","421","177","244","30","451","699","0","64.52","25.32"
"66","000","00","027","2719","1356","421","177","244","30","451","699","0","64.52","25.32"
"66","000","00","027","2720","0000","3553","1585","1968","190","3743","6563","0","57.03","24.15"
"66","000","00","027","2720","1277","1006","445","561","59","1065","1846","0","57.69","24.11"
"66","000","00","027","2720","1278","860","376","484","41","901","1493","0","60.35","25.18"
"66","000","00","027","2720","1279","752","373","379","51","803","1605","0","50.03","23.24"
"66","000","00","027","2720","1280","935","391","544","39","974","1619","0","60.16","24.15"
"66","000","00","027","2721","0000","2076","937","1139","109","2185","4094","0","53.37","22.89"
"66","000","00","027","2721","1289","995","460","535","65","1060","1930","0","54.92","23.83"
"66","000","00","027","2721","1290","1081","477","604","44","1125","2164","0","51.99","22.04"
"66","000","00","027","2722","0000","1914","888","1026","104","2018","3870","0","52.14","22.95"
"66","000","00","027","2722","1293","885","401","484","51","936","1685","0","55.55","23.8"
"66","000","00","027","2722","1294","1029","487","542","53","1082","2185","0","49.52","22.29"
"66","000","00","027","2723","0000","1476","633","843","54","1530","2773","0","55.17","22.83"
"66","000","00","027","2723","1295","626","277","349","29","655","1176","0","55.7","23.55"
"66","000","00","027","2723","1296","850","356","494","25","875","1597","0","54.79","22.29"
"66","000","00","027","2724","0000","1918","801","1117","109","2027","3691","0","54.92","21.7"
"66","000","00","027","2724","1283","976","436","540","57","1033","1876","0","55.06","23.24"
"66","000","00","027","2724","1284","942","365","577","52","994","1815","0","54.77","20.11"
"66","000","00","027","2725","0000","1314","644","670","75","1389","2285","0","60.79","28.18"
"66","000","00","027","2725","1285","697","345","352","38","735","1281","0","57.38","26.93"
"66","000","00","027","2725","1286","617","299","318","37","654","1004","0","65.14","29.78"
"66","000","00","027","2726","0000","1468","602","866","91","1559","2943","0","52.97","20.46"
"66","000","00","027","2726","1299","908","380","528","53","961","1890","0","50.85","20.11"
"66","000","00","027","2726","1300","560","222","338","38","598","1053","0","56.79","21.08"
"66","000","00","027","2727","0000","2671","1129","1542","79","2750","4703","0","58.47","24.01"
"66","000","00","027","2727","1339","821","354","467","27","848","1526","0","55.57","23.2"
"66","000","00","027","2727","1340","916","392","524","27","943","1483","0","63.59","26.43"
"66","000","00","027","2727","1341","934","383","551","25","959","1694","0","56.61","22.61"
"66","000","00","027","2728","0000","3755","1634","2121","105","3860","6795","0","56.81","24.05"
"66","000","00","027","2728","1342","951","421","530","29","980","1952","0","50.2","21.57"
"66","000","00","027","2728","1343","1065","454","611","31","1096","1995","0","54.94","22.76"
"66","000","00","027","2728","1344","747","333","414","17","764","1311","0","58.28","25.4"
"66","000","00","027","2728","1345","992","426","566","28","1020","1537","0","66.36","27.72"
"66","000","00","027","2729","0000","2960","1200","1760","105","3065","5574","0","54.99","21.53"
"66","000","00","027","2729","1329","999","450","549","28","1027","1778","0","57.76","25.31"
"66","000","00","027","2729","1330","868","335","533","36","904","1706","0","52.99","19.64"
"66","000","00","027","2729","1331","1093","415","678","41","1134","2090","0","54.26","19.86"
"66","000","00","027","2730","0000","2516","1013","1503","104","2620","5269","0","49.72","19.23"
"66","000","00","027","2730","1332","1005","373","632","35","1040","2093","0","49.69","17.82"
"66","000","00","027","2730","1333","792","330","462","29","821","1688","0","48.64","19.55"
"66","000","00","027","2730","1334","719","310","409","40","759","1488","0","51.01","20.83"
"66","000","00","027","2731","0000","2941","1227","1714","127","3068","6065","0","50.59","20.23"
"66","000","00","027","2731","1320","969","404","565","34","1003","2025","0","49.53","19.95"
"66","000","00","027","2731","1321","960","377","583","41","1001","1885","0","53.1","20.0"
"66","000","00","027","2731","1322","1012","446","566","52","1064","2155","0","49.37","20.7"
"66","000","00","027","2732","0000","1763","765","998","94","1857","3796","0","48.92","20.15"
"66","000","00","027","2732","1323","902","419","483","40","942","1775","0","53.07","23.61"
"66","000","00","027","2732","1324","861","346","515","54","915","2021","0","45.27","17.12"
"66","000","00","027","2733","0000","1916","685","1231","100","2016","3762","0","53.59","18.21"
"66","000","00","027","2733","1310","1020","365","655","57","1077","2010","0","53.58","18.16"
"66","000","00","027","2733","1311","896","320","576","43","939","1752","0","53.6","18.26"
"66","000","00","027","2734","0000","2591","1042","1549","118","2709","4401","0","61.55","23.68"
"66","000","00","027","2734","1314","1301","543","758","64","1365","2170","0","62.9","25.02"
"66","000","00","027","2734","1315","1290","499","791","54","1344","2231","0","60.24","22.37"
"66","000","00","027","2735","0000","1318","571","747","89","1407","2556","0","55.05","22.34"
"66","000","00","027","2735","1303","769","327","442","47","816","1493","0","54.66","21.9"
"66","000","00","027","2735","1304","549","244","305","42","591","1063","0","55.6","22.95"
"66","000","00","027","2736","0000","1274","495","779","70","1344","2201","0","61.06","22.49"
"66","000","00","027","2736","1305","649","247","402","31","680","1117","0","60.88","22.11"
"66","000","00","027","2736","1306","625","248","377","39","664","1084","0","61.25","22.88"
"66","000","00","027","2737","0000","786","340","446","21","807","1559","0","51.76","21.81"
"66","000","00","027","2737","1350","786","340","446","21","807","1559","0","51.76","21.81"
"66","000","00","027","2738","0000","2046","894","1152","118","2164","3576","0","60.51","25.0"
"66","000","00","027","2738","1354","900","457","443","52","952","1450","0","65.66","31.52"
"66","000","00","027","2738","1355","1146","437","709","66","1212","2126","0","57.01","20.56"
"66","000","00","027","2739","0000","1417","673","744","95","1512","2507","0","60.31","26.84"
"66","000","00","027","2739","1359","695","321","374","34","729","1241","0","58.74","25.87"
"66","000","00","027","2739","1360","722","352","370","61","783","1266","0","61.85","27.8"
"66","000","00","028","0000","0000","93039","41337","51702","4281","97320","171769","211860","56.66","24.07"
"66","000","00","028","2801","0000","1937","912","1025","120","2057","3508","0","58.64","26.0"
"66","000","00","028","2801","1373","919","441","478","47","966","1697","0","56.92","25.99"
"66","000","00","028","2801","1374","1018","471","547","73","1091","1811","0","60.24","26.01"
"66","000","00","028","2802","0000","5268","2272","2996","218","5486","9923","0","55.29","22.9"
"66","000","00","028","2802","1375","944","400","544","44","988","1830","0","53.99","21.86"
"66","000","00","028","2802","1376","929","426","503","41","970","2228","0","43.54","19.12"
"66","000","00","028","2802","1377","1082","471","611","51","1133","1997","0","56.74","23.59"
"66","000","00","028","2802","1378","1247","473","774","43","1290","2033","0","63.45","23.27"
"66","000","00","028","2802","1379","1066","502","564","39","1105","1835","0","60.22","27.36"
"66","000","00","028","2803","0000","1773","867","906","108","1881","3418","0","55.03","25.37"
"66","000","00","028","2803","1384","841","441","400","54","895","1621","0","55.21","27.21"
"66","000","00","028","2803","1385","932","426","506","54","986","1797","0","54.87","23.71"
"66","000","00","028","2804","0000","3809","1690","2119","168","3977","7122","0","55.84","23.73"
"66","000","00","028","2804","1422","1014","459","555","29","1043","1875","0","55.63","24.48"
"66","000","00","028","2804","1423","915","391","524","45","960","1670","0","57.49","23.41"
"66","000","00","028","2804","1424","1011","453","558","53","1064","1898","0","56.06","23.87"
"66","000","00","028","2804","1425","869","387","482","41","910","1679","0","54.2","23.05"
"66","000","00","028","2805","0000","3751","1828","1923","203","3954","6924","0","57.11","26.4"
"66","000","00","028","2805","1386","656","296","360","28","684","1230","0","55.61","24.07"
"66","000","00","028","2805","1387","779","329","450","39","818","1488","0","54.97","22.11"
"66","000","00","028","2805","1388","761","353","408","45","806","1459","0","55.24","24.19"
"66","000","00","028","2805","1389","897","434","463","43","940","1647","0","57.07","26.35"
"66","000","00","028","2805","1390","658","416","242","48","706","1100","0","64.18","37.82"
"66","000","00","028","2806","0000","2185","859","1326","114","2299","3956","0","58.11","21.71"
"66","000","00","028","2806","1434","678","261","417","18","696","1103","0","63.1","23.66"
"66","000","00","028","2806","1435","739","301","438","49","788","1419","0","55.53","21.21"
"66","000","00","028","2806","1436","768","297","471","47","815","1434","0","56.83","20.71"
"66","000","00","028","2807","0000","2927","1292","1635","93","3020","5587","0","54.05","23.13"
"66","000","00","028","2807","1437","948","410","538","29","977","1875","0","52.11","21.87"
"66","000","00","028","2807","1438","996","468","528","37","1033","1862","0","55.48","25.13"
"66","000","00","028","2807","1439","983","414","569","27","1010","1850","0","54.59","22.38"
"66","000","00","028","2808","0000","4295","1772","2523","183","4478","8258","0","54.23","21.46"
"66","000","00","028","2808","1391","777","323","454","29","806","1410","0","57.16","22.91"
"66","000","00","028","2808","1392","919","363","556","45","964","1807","0","53.35","20.09"
"66","000","00","028","2808","1393","734","332","402","32","766","1331","0","57.55","24.94"
"66","000","00","028","2808","1394","936","390","546","35","971","1801","0","53.91","21.65"
"66","000","00","028","2808","1395","929","364","565","42","971","1909","0","50.86","19.07"
"66","000","00","028","2809","0000","1745","762","983","104","1849","3355","0","55.11","22.71"
"66","000","00","028","2809","1399","881","397","484","66","947","1753","0","54.02","22.65"
"66","000","00","028","2809","1400","864","365","499","38","902","1602","0","56.3","22.78"
"66","000","00","028","2810","0000","2652","1190","1462","159","2811","5278","0","53.26","22.55"
"66","000","00","028","2810","1451","933","422","511","48","981","1759","0","55.77","23.99"
"66","000","00","028","2810","1452","889","395","494","59","948","1783","0","53.17","22.15"
"66","000","00","028","2810","1453","830","373","457","52","882","1736","0","50.81","21.49"
"66","000","00","028","2811","0000","3923","1908","2015","211","4134","7599","0","54.4","25.11"
"66","000","00","028","2811","1458","965","433","532","60","1025","1836","0","55.83","23.58"
"66","000","00","028","2811","1459","999","438","561","54","1053","1913","0","55.04","22.9"
"66","000","00","028","2811","1460","980","444","536","60","1040","1913","0","54.36","23.21"
"66","000","00","028","2811","1461","979","593","386","37","1016","1937","0","52.45","30.61"
"66","000","00","028","2812","0000","2354","1082","1272","119","2473","4237","0","58.37","25.54"
"66","000","00","028","2812","1401","637","294","343","44","681","1144","0","59.53","25.7"
"66","000","00","028","2812","1402","939","446","493","37","976","1655","0","58.97","26.95"
"66","000","00","028","2812","1403","778","342","436","38","816","1438","0","56.75","23.78"
"66","000","00","028","2813","0000","571","283","288","34","605","1000","0","60.5","28.3"
"66","000","00","028","2813","1404","571","283","288","34","605","1000","0","60.5","28.3"
"66","000","00","028","2814","0000","4513","2020","2493","215","4728","8369","0","56.49","24.14"
"66","000","00","028","2814","1405","931","402","529","39","970","1711","0","56.69","23.5"
"66","000","00","028","2814","1406","894","399","495","18","912","1698","0","53.71","23.5"
"66","000","00","028","2814","1407","1022","472","550","58","1080","1914","0","56.43","24.66"
"66","000","00","028","2814","1408","820","362","458","36","856","1465","0","58.43","24.71"
"66","000","00","028","2814","1409","846","385","461","64","910","1581","0","57.56","24.35"
"66","000","00","028","2815","0000","2163","998","1165","82","2245","4438","0","50.59","22.49"
"66","000","00","028","2815","1414","593","295","298","22","615","1204","0","51.08","24.5"
"66","000","00","028","2815","1415","873","404","469","33","906","1761","0","51.45","22.94"
"66","000","00","028","2815","1416","697","299","398","27","724","1473","0","49.15","20.3"
"66","000","00","028","2816","0000","4578","2138","2440","251","4829","8428","0","57.3","25.37"
"66","000","00","028","2816","1417","899","421","478","49","948","1675","0","56.6","25.13"
"66","000","00","028","2816","1418","956","406","550","42","998","1755","0","56.87","23.13"
"66","000","00","028","2816","1419","890","419","471","67","957","1593","0","60.08","26.3"
"66","000","00","028","2816","1420","955","470","485","53","1008","1799","0","56.03","26.13"
"66","000","00","028","2816","1421","878","422","456","40","918","1606","0","57.16","26.28"
"66","000","00","028","2817","0000","6293","2752","3541","248","6541","11504","0","56.86","23.92"
"66","000","00","028","2817","1462","795","356","439","38","833","1508","0","55.24","23.61"
"66","000","00","028","2817","1463","784","345","439","24","808","1340","0","60.3","25.75"
"66","000","00","028","2817","1464","917","383","534","55","972","1656","0","58.7","23.13"
"66","000","00","028","2817","1465","701","289","412","35","736","1290","0","57.05","22.4"
"66","000","00","028","2817","1466","907","403","504","27","934","1655","0","56.44","24.35"
"66","000","00","028","2817","1467","629","279","350","15","644","1260","0","51.11","22.14"
"66","000","00","028","2817","1468","725","330","395","21","746","1247","0","59.82","26.46"
"66","000","00","028","2817","1469","835","367","468","33","868","1548","0","56.07","23.71"
"66","000","00","028","2818","0000","5124","2330","2794","296","5420","9578","0","56.59","24.33"
"66","000","00","028","2818","1445","853","401","452","42","895","1701","0","52.62","23.57"
"66","000","00","028","2818","1446","787","368","419","46","833","1549","0","53.78","23.76"
"66","000","00","028","2818","1447","899","382","517","49","948","1567","0","60.5","24.38"
"66","000","00","028","2818","1448","877","396","481","55","932","1614","0","57.74","24.54"
"66","000","00","028","2818","1449","983","450","533","66","1049","1811","0","57.92","24.85"
"66","000","00","028","2818","1450","725","333","392","38","763","1336","0","57.11","24.93"
"66","000","00","028","2819","0000","5269","2332","2937","239","5508","10155","0","54.24","22.96"
"66","000","00","028","2819","1364","832","336","496","36","868","1614","0","53.78","20.82"
"66","000","00","028","2819","1365","797","313","484","39","836","1599","0","52.28","19.57"
"66","000","00","028","2819","1366","836","381","455","37","873","1715","0","50.9","22.22"
"66","000","00","028","2819","1367","711","346","365","36","747","1264","0","59.1","27.37"
"66","000","00","028","2819","1368","731","318","413","32","763","1416","0","53.88","22.46"
"66","000","00","028","2819","1369","636","292","344","24","660","1188","0","55.56","24.58"
"66","000","00","028","2819","1370","726","346","380","35","761","1359","0","56.0","25.46"
"66","000","00","028","2820","0000","1594","711","883","93","1687","2860","0","58.99","24.86"
"66","000","00","028","2820","1371","796","380","416","54","850","1457","0","58.34","26.08"
"66","000","00","028","2820","1372","798","331","467","39","837","1403","0","59.66","23.59"
"66","000","00","028","2821","0000","3395","1418","1977","109","3504","5775","0","60.68","24.55"
"66","000","00","028","2821","1380","719","315","404","24","743","1268","0","58.6","24.84"
"66","000","00","028","2821","1381","925","369","556","36","961","1645","0","58.42","22.43"
"66","000","00","028","2821","1382","923","402","521","29","952","1561","0","60.99","25.75"
"66","000","00","028","2821","1383","828","332","496","20","848","1301","0","65.18","25.52"
"66","000","00","028","2822","0000","2213","974","1239","119","2332","4102","0","56.85","23.74"
"66","000","00","028","2822","1426","720","322","398","39","759","1373","0","55.28","23.45"
"66","000","00","028","2822","1427","704","315","389","50","754","1299","0","58.04","24.25"
"66","000","00","028","2822","1428","789","337","452","30","819","1430","0","57.27","23.57"
"66","000","00","028","2823","0000","5675","2309","3366","168","5843","9149","0","63.86","25.24"
"66","000","00","028","2823","1429","1108","466","642","29","1137","1805","0","62.99","25.82"
"66","000","00","028","2823","1430","1154","469","685","21","1175","1806","0","65.06","25.97"
"66","000","00","028","2823","1431","1153","478","675","42","1195","1826","0","65.44","26.18"
"66","000","00","028","2823","1432","1146","432","714","38","1184","1805","0","65.6","23.93"
"66","000","00","028","2823","1433","1114","464","650","38","1152","1907","0","60.41","24.33"
"66","000","00","028","2824","0000","4834","2097","2737","193","5027","8472","0","59.34","24.75"
"66","000","00","028","2824","1440","898","392","506","39","937","1622","0","57.77","24.17"
"66","000","00","028","2824","1441","983","384","599","40","1023","1638","0","62.45","23.44"
"66","000","00","028","2824","1442","984","447","537","50","1034","1633","0","63.32","27.37"
"66","000","00","028","2824","1443","867","418","449","30","897","1662","0","53.97","25.15"
"66","000","00","028","2824","1444","1102","456","646","34","1136","1917","0","59.26","23.79"
"66","000","00","028","2825","0000","2729","1160","1569","120","2849","5238","0","54.39","22.15"
"66","000","00","028","2825","1396","837","373","464","34","871","1699","0","51.27","21.95"
"66","000","00","028","2825","1397","884","384","500","47","931","1627","0","57.22","23.6"
"66","000","00","028","2825","1398","1008","403","605","39","1047","1912","0","54.76","21.08"
"66","000","00","028","2826","0000","4231","1928","2303","153","4384","7648","0","57.32","25.21"
"66","000","00","028","2826","1454","1033","458","575","42","1075","1874","0","57.36","24.44"
"66","000","00","028","2826","1455","1066","531","535","20","1086","1889","0","57.49","28.11"
"66","000","00","028","2826","1456","1039","475","564","55","1094","1947","0","56.19","24.4"
"66","000","00","028","2826","1457","1093","464","629","36","1129","1938","0","58.26","23.94"
"66","000","00","028","2827","0000","3238","1453","1785","161","3399","5888","0","57.73","24.68"
"66","000","00","028","2827","1410","854","366","488","44","898","1509","0","59.51","24.25"
"66","000","00","028","2827","1411","828","358","470","23","851","1570","0","54.2","22.8"
"66","000","00","028","2827","1412","788","363","425","41","829","1425","0","58.18","25.47"
"66","000","00","028","2827","1413","768","366","402","53","821","1384","0","59.32","26.45"
"66","000","00","029","0000","0000","5658","2060","3598","313","5971","9498","11066","62.87","21.69"
"66","000","00","029","2901","0000","1180","520","660","65","1245","1919","0","64.88","27.1"
"66","000","00","029","2901","1585","579","318","261","38","617","956","0","64.54","33.26"
"66","000","00","029","2901","1586","601","202","399","27","628","963","0","65.21","20.98"
"66","000","00","029","2902","0000","263","104","159","11","274","456","0","60.09","22.81"
"66","000","00","029","2902","1587","263","104","159","11","274","456","0","60.09","22.81"
"66","000","00","029","2903","0000","983","326","657","57","1040","1647","0","63.15","19.79"
"66","000","00","029","2903","1588","611","193","418","45","656","1011","0","64.89","19.09"
"66","000","00","029","2903","1589","372","133","239","12","384","636","0","60.38","20.91"
"66","000","00","029","2904","0000","317","121","196","9","326","451","0","72.28","26.83"
"66","000","00","029","2904","1595","317","121","196","9","326","451","0","72.28","26.83"
"66","000","00","029","2905","0000","738","208","530","44","782","1051","0","74.41","19.79"
"66","000","00","029","2905","1590","172","58","114","10","182","270","0","67.41","21.48"
"66","000","00","029","2905","1591","340","75","265","17","357","460","0","77.61","16.3"
"66","000","00","029","2905","1592","226","75","151","17","243","321","0","75.7","23.36"
"66","000","00","029","2906","0000","705","259","446","43","748","1119","0","66.85","23.15"
"66","000","00","029","2906","1593","491","197","294","26","517","783","0","66.03","25.16"
"66","000","00","029","2906","1594","214","62","152","17","231","336","0","68.75","18.45"
"66","000","00","029","2907","0000","976","366","610","62","1038","1985","0","52.29","18.44"
"66","000","00","029","2907","1596","196","82","114","11","207","366","0","56.56","22.4"
"66","000","00","029","2907","1597","331","130","201","11","342","771","0","44.36","16.86"
"66","000","00","029","2907","1598","289","100","189","29","318","574","0","55.4","17.42"
"66","000","00","029","2907","1599","160","54","106","11","171","274","0","62.41","19.71"
"66","000","00","029","2908","0000","496","156","340","22","518","870","0","59.54","17.93"
"66","000","00","029","2908","1600","85","29","56","6","91","157","0","57.96","18.47"
"66","000","00","029","2908","1601","411","127","284","16","427","713","0","59.89","17.81"
"67","000","00","000","0000","0000","797325","420409","376916","37455","834780","1594821","1883804","52.34","26.36"
"67","000","00","001","0000","0000","31831","15671","16160","1133","32964","64949","77651","50.75","24.13"
"67","000","00","001","0101","0000","2423","1055","1368","73","2496","4741","0","52.65","22.25"
"67","000","00","001","0101","0116","776","327","449","29","805","1693","0","47.55","19.31"
"67","000","00","001","0101","0117","853","379","474","23","876","1561","0","56.12","24.28"
"67","000","00","001","0101","0118","794","349","445","21","815","1487","0","54.81","23.47"
"67","000","00","001","0102","0000","1189","561","628","30","1219","2299","0","53.02","24.4"
"67","000","00","001","0102","0119","646","305","341","14","660","1232","0","53.57","24.76"
"67","000","00","001","0102","0120","543","256","287","16","559","1067","0","52.39","23.99"
"67","000","00","001","0103","0000","1460","740","720","57","1517","2885","0","52.58","25.65"
"67","000","00","001","0103","0121","665","355","310","29","694","1419","0","48.91","25.02"
"67","000","00","001","0103","0122","795","385","410","28","823","1466","0","56.14","26.26"
"67","000","00","001","0107","0000","1510","765","745","42","1552","2940","0","52.79","26.02"
"67","000","00","001","0107","0126","486","243","243","20","506","888","0","56.98","27.36"
"67","000","00","001","0107","0127","566","274","292","11","577","1115","0","51.75","24.57"
"67","000","00","001","0107","0128","458","248","210","11","469","937","0","50.05","26.47"
"67","000","00","001","0108","0000","2120","1025","1095","70","2190","4214","0","51.97","24.32"
"67","000","00","001","0108","0129","673","345","328","21","694","1387","0","50.04","24.87"
"67","000","00","001","0108","0130","728","340","388","34","762","1526","0","49.93","22.28"
"67","000","00","001","0108","0131","719","340","379","15","734","1301","0","56.42","26.13"
"67","000","00","001","0109","0000","696","341","355","27","723","1193","0","60.6","28.58"
"67","000","00","001","0109","0136","696","341","355","27","723","1193","0","60.6","28.58"
"67","000","00","001","0110","0000","597","322","275","16","613","1439","0","42.6","22.38"
"67","000","00","001","0110","0137","597","322","275","16","613","1439","0","42.6","22.38"
"67","000","00","001","0112","0000","1059","517","542","36","1095","2460","0","44.51","21.02"
"67","000","00","001","0112","0140","523","270","253","20","543","1233","0","44.04","21.9"
"67","000","00","001","0112","0141","536","247","289","16","552","1227","0","44.99","20.13"
"67","000","00","001","0113","0000","983","468","515","45","1028","1797","0","57.21","26.04"
"67","000","00","001","0113","0138","784","351","433","34","818","1438","0","56.88","24.41"
"67","000","00","001","0113","0139","199","117","82","11","210","359","0","58.5","32.59"
"67","000","00","001","0114","0000","1435","734","701","34","1469","3250","0","45.2","22.58"
"67","000","00","001","0114","0142","606","302","304","19","625","1320","0","47.35","22.88"
"67","000","00","001","0114","0143","829","432","397","15","844","1930","0","43.73","22.38"
"67","000","00","001","0115","0000","2104","1061","1043","95","2199","4419","0","49.76","24.01"
"67","000","00","001","0115","0150","805","399","406","29","834","1595","0","52.29","25.02"
"67","000","00","001","0115","0151","451","228","223","15","466","959","0","48.59","23.77"
"67","000","00","001","0115","0152","848","434","414","51","899","1865","0","48.2","23.27"
"67","000","00","001","0116","0000","764","419","345","27","791","1678","0","47.14","24.97"
"67","000","00","001","0116","0153","764","419","345","27","791","1678","0","47.14","24.97"
"67","000","00","001","0117","0000","616","344","272","26","642","1373","0","46.76","25.05"
"67","000","00","001","0117","0154","616","344","272","26","642","1373","0","46.76","25.05"
"67","000","00","001","0118","0000","702","422","280","21","723","1722","0","41.99","24.51"
"67","000","00","001","0118","0155","582","340","242","19","601","1431","0","42.0","23.76"
"67","000","00","001","0118","0156","120","82","38","2","122","291","0","41.92","28.18"
"67","000","00","001","0119","0000","772","400","372","25","797","1749","0","45.57","22.87"
"67","000","00","001","0119","0157","772","400","372","25","797","1749","0","45.57","22.87"
"67","000","00","001","0120","0000","1780","862","918","94","1874","3683","0","50.88","23.4"
"67","000","00","001","0120","0158","853","423","430","31","884","1862","0","47.48","22.72"
"67","000","00","001","0120","0159","927","439","488","63","990","1821","0","54.37","24.11"
"67","000","00","001","0121","0000","844","446","398","22","866","1845","0","46.94","24.17"
"67","000","00","001","0121","0160","844","446","398","22","866","1845","0","46.94","24.17"
"67","000","00","001","0125","0000","804","437","367","52","856","1644","0","52.07","26.58"
"67","000","00","001","0125","0163","380","204","176","31","411","703","0","58.46","29.02"
"67","000","00","001","0125","0164","424","233","191","21","445","941","0","47.29","24.76"
"67","000","00","001","0126","0000","362","212","150","14","376","944","0","39.83","22.46"
"67","000","00","001","0126","0161","218","134","84","8","226","542","0","41.7","24.72"
"67","000","00","001","0126","0162","144","78","66","6","150","402","0","37.31","19.4"
"67","000","00","001","0127","0000","2380","1126","1254","85","2465","4729","0","52.13","23.81"
"67","000","00","001","0127","0144","767","366","401","36","803","1501","0","53.5","24.38"
"67","000","00","001","0127","0145","702","312","390","21","723","1475","0","49.02","21.15"
"67","000","00","001","0127","0146","911","448","463","28","939","1753","0","53.57","25.56"
"67","000","00","001","0128","0000","2418","1179","1239","69","2487","4922","0","50.53","23.95"
"67","000","00","001","0128","0147","849","418","431","29","878","1748","0","50.23","23.91"
"67","000","00","001","0128","0148","872","402","470","24","896","1741","0","51.46","23.09"
"67","000","00","001","0128","0149","697","359","338","16","713","1433","0","49.76","25.05"
"67","000","00","001","0129","0000","3362","1452","1910","109","3471","6235","0","55.67","23.29"
"67","000","00","001","0129","0132","841","376","465","32","873","1538","0","56.76","24.45"
"67","000","00","001","0129","0133","825","359","466","32","857","1584","0","54.1","22.66"
"67","000","00","001","0129","0134","878","350","528","21","899","1583","0","56.79","22.11"
"67","000","00","001","0129","0135","818","367","451","24","842","1530","0","55.03","23.99"
"67","000","00","001","0130","0000","1451","783","668","64","1515","2788","0","54.34","28.08"
"67","000","00","001","0130","0123","559","290","269","23","582","932","0","62.45","31.12"
"67","000","00","001","0130","0124","523","298","225","23","546","1099","0","49.68","27.12"
"67","000","00","001","0130","0125","369","195","174","18","387","757","0","51.12","25.76"
"67","000","00","002","0000","0000","10590","6084","4506","557","11147","22121","25397","50.39","27.5"
"67","000","00","002","0201","0000","765","424","341","61","826","1517","0","54.45","27.95"
"67","000","00","002","0201","0085","519","289","230","48","567","1037","0","54.68","27.87"
"67","000","00","002","0201","0086","246","135","111","13","259","480","0","53.96","28.13"
"67","000","00","002","0208","0000","1785","962","823","71","1856","3743","0","49.59","25.7"
"67","000","00","002","0208","0093","393","236","157","21","414","863","0","47.97","27.35"
"67","000","00","002","0208","0094","661","337","324","20","681","1373","0","49.6","24.54"
"67","000","00","002","0208","0095","731","389","342","30","761","1507","0","50.5","25.81"
"67","000","00","002","0210","0000","361","258","103","30","391","921","0","42.45","28.01"
"67","000","00","002","0210","0099","361","258","103","30","391","921","0","42.45","28.01"
"67","000","00","002","0211","0000","1784","960","824","101","1885","3640","0","51.79","26.37"
"67","000","00","002","0211","0096","697","370","327","38","735","1374","0","53.49","26.93"
"67","000","00","002","0211","0097","584","320","264","23","607","1244","0","48.79","25.72"
"67","000","00","002","0211","0098","503","270","233","40","543","1022","0","53.13","26.42"
"67","000","00","002","0214","0000","771","470","301","34","805","1653","0","48.7","28.43"
"67","000","00","002","0214","0107","449","270","179","20","469","925","0","50.7","29.19"
"67","000","00","002","0214","0108","322","200","122","14","336","728","0","46.15","27.47"
"67","000","00","002","0226","0000","822","465","357","45","867","1454","0","59.63","31.98"
"67","000","00","002","0226","0087","368","214","154","16","384","636","0","60.38","33.65"
"67","000","00","002","0226","0088","175","101","74","8","183","321","0","57.01","31.46"
"67","000","00","002","0226","0089","279","150","129","21","300","497","0","60.36","30.18"
"67","000","00","002","0227","0000","876","465","411","39","915","1607","0","56.94","28.94"
"67","000","00","002","0227","0090","445","240","205","16","461","759","0","60.74","31.62"
"67","000","00","002","0227","0091","157","83","74","10","167","341","0","48.97","24.34"
"67","000","00","002","0227","0092","274","142","132","13","287","507","0","56.61","28.01"
"67","000","00","002","0228","0000","742","445","297","31","773","1539","0","50.23","28.91"
"67","000","00","002","0228","0102","392","246","146","8","400","761","0","52.56","32.33"
"67","000","00","002","0228","0103","136","74","62","7","143","285","0","50.18","25.96"
"67","000","00","002","0228","0104","214","125","89","16","230","493","0","46.65","25.35"
"67","000","00","002","0229","0000","740","454","286","37","777","1583","0","49.08","28.68"
"67","000","00","002","0229","0100","436","275","161","27","463","847","0","54.66","32.47"
"67","000","00","002","0229","0101","304","179","125","10","314","736","0","42.66","24.32"
"67","000","00","002","0230","0000","414","265","149","18","432","1013","0","42.65","26.16"
"67","000","00","002","0230","0105","256","161","95","11","267","621","0","43.0","25.93"
"67","000","00","002","0230","0106","158","104","54","7","165","392","0","42.09","26.53"
"67","000","00","002","0231","0000","464","304","160","26","490","1120","0","43.75","27.14"
"67","000","00","002","0231","0112","314","208","106","12","326","755","0","43.18","27.55"
"67","000","00","002","0231","0113","150","96","54","14","164","365","0","44.93","26.3"
"67","000","00","002","0232","0000","411","240","171","21","432","902","0","47.89","26.61"
"67","000","00","002","0232","0109","83","57","26","6","89","214","0","41.59","26.64"
"67","000","00","002","0232","0110","179","101","78","7","186","387","0","48.06","26.1"
"67","000","00","002","0232","0111","149","82","67","8","157","301","0","52.16","27.24"
"67","000","00","002","0233","0000","655","372","283","43","698","1429","0","48.85","26.03"
"67","000","00","002","0233","0114","431","244","187","27","458","935","0","48.98","26.1"
"67","000","00","002","0233","0115","224","128","96","16","240","494","0","48.58","25.91"
"67","000","00","003","0000","0000","10732","6281","4451","636","11368","24894","28152","45.67","25.23"
"67","000","00","003","0301","0000","881","498","383","50","931","1722","0","54.07","28.92"
"67","000","00","003","0301","0030","602","340","262","43","645","1176","0","54.85","28.91"
"67","000","00","003","0301","0031","279","158","121","7","286","546","0","52.38","28.94"
"67","000","00","003","0302","0000","1530","872","658","79","1609","2921","0","55.08","29.85"
"67","000","00","003","0302","0032","455","252","203","21","476","859","0","55.41","29.34"
"67","000","00","003","0302","0033","513","300","213","27","540","946","0","57.08","31.71"
"67","000","00","003","0302","0034","562","320","242","31","593","1116","0","53.14","28.67"
"67","000","00","003","0303","0000","557","321","236","25","582","1397","0","41.66","22.98"
"67","000","00","003","0303","0035","557","321","236","25","582","1397","0","41.66","22.98"
"67","000","00","003","0304","0000","716","383","333","43","759","1627","0","46.65","23.54"
"67","000","00","003","0304","0036","309","160","149","16","325","756","0","42.99","21.16"
"67","000","00","003","0304","0037","407","223","184","27","434","871","0","49.83","25.6"
"67","000","00","003","0305","0000","436","236","200","18","454","897","0","50.61","26.31"
"67","000","00","003","0305","0038","436","236","200","18","454","897","0","50.61","26.31"
"67","000","00","003","0306","0000","534","336","198","26","560","1356","0","41.3","24.78"
"67","000","00","003","0306","0039","281","172","109","19","300","784","0","38.27","21.94"
"67","000","00","003","0306","0040","253","164","89","7","260","572","0","45.45","28.67"
"67","000","00","003","0307","0000","156","89","67","6","162","457","0","35.45","19.47"
"67","000","00","003","0307","0041","156","89","67","6","162","457","0","35.45","19.47"
"67","000","00","003","0308","0000","223","138","85","13","236","600","0","39.33","23.0"
"67","000","00","003","0308","0042","223","138","85","13","236","600","0","39.33","23.0"
"67","000","00","003","0309","0000","120","67","53","3","123","375","0","32.8","17.87"
"67","000","00","003","0309","0043","120","67","53","3","123","375","0","32.8","17.87"
"67","000","00","003","0310","0000","176","127","49","3","179","508","0","35.24","25.0"
"67","000","00","003","0310","0044","176","127","49","3","179","508","0","35.24","25.0"
"67","000","00","003","0311","0000","453","276","177","38","491","1305","0","37.62","21.15"
"67","000","00","003","0311","0047","296","196","100","22","318","799","0","39.8","24.53"
"67","000","00","003","0311","0048","157","80","77","16","173","506","0","34.19","15.81"
"67","000","00","003","0312","0000","322","187","135","17","339","1022","0","33.17","18.3"
"67","000","00","003","0312","0045","208","125","83","9","217","631","0","34.39","19.81"
"67","000","00","003","0312","0046","114","62","52","8","122","391","0","31.2","15.86"
"67","000","00","003","0314","0000","559","334","225","26","585","1443","0","40.54","23.15"
"67","000","00","003","0314","0051","289","178","111","13","302","744","0","40.59","23.92"
"67","000","00","003","0314","0052","270","156","114","13","283","699","0","40.49","22.32"
"67","000","00","003","0318","0000","365","193","172","34","399","884","0","45.14","21.83"
"67","000","00","003","0318","0055","365","193","172","34","399","884","0","45.14","21.83"
"67","000","00","003","0319","0000","198","113","85","8","206","740","0","27.84","15.27"
"67","000","00","003","0319","0056","198","113","85","8","206","740","0","27.84","15.27"
"67","000","00","003","0320","0000","555","310","245","33","588","1334","0","44.08","23.24"
"67","000","00","003","0320","0057","555","310","245","33","588","1334","0","44.08","23.24"
"67","000","00","003","0321","0000","324","191","133","39","363","723","0","50.21","26.42"
"67","000","00","003","0321","0058","324","191","133","39","363","723","0","50.21","26.42"
"67","000","00","003","0322","0000","351","203","148","43","394","682","0","57.77","29.77"
"67","000","00","003","0322","0059","351","203","148","43","394","682","0","57.77","29.77"
"67","000","00","003","0325","0000","962","586","376","36","998","2011","0","49.63","29.14"
"67","000","00","003","0325","0049","403","266","137","15","418","832","0","50.24","31.97"
"67","000","00","003","0325","0050","559","320","239","21","580","1179","0","49.19","27.14"
"67","000","00","003","0326","0000","690","455","235","42","732","1492","0","49.06","30.5"
"67","000","00","003","0326","0053","256","183","73","12","268","633","0","42.34","28.91"
"67","000","00","003","0326","0054","434","272","162","30","464","859","0","54.02","31.66"
"67","000","00","003","0327","0000","624","366","258","54","678","1398","0","48.5","26.18"
"67","000","00","003","0327","0060","412","233","179","33","445","855","0","52.05","27.25"
"67","000","00","003","0327","0061","212","133","79","21","233","543","0","42.91","24.49"
"67","000","00","004","0000","0000","8960","4986","3974","619","9579","18804","21212","50.94","26.52"
"67","000","00","004","0401","0000","881","512","369","52","933","1791","0","52.09","28.59"
"67","000","00","004","0401","0165","538","303","235","42","580","1166","0","49.74","25.99"
"67","000","00","004","0401","0166","343","209","134","10","353","625","0","56.48","33.44"
"67","000","00","004","0402","0000","787","428","359","44","831","1572","0","52.86","27.23"
"67","000","00","004","0402","0167","319","174","145","28","347","738","0","47.02","23.58"
"67","000","00","004","0402","0168","468","254","214","16","484","834","0","58.03","30.46"
"67","000","00","004","0403","0000","517","308","209","27","544","1104","0","49.28","27.9"
"67","000","00","004","0403","0169","517","308","209","27","544","1104","0","49.28","27.9"
"67","000","00","004","0404","0000","1359","699","660","85","1444","2735","0","52.8","25.56"
"67","000","00","004","0404","0170","490","272","218","9","499","1015","0","49.16","26.8"
"67","000","00","004","0404","0171","869","427","442","76","945","1720","0","54.94","24.83"
"67","000","00","004","0405","0000","628","331","297","38","666","1391","0","47.88","23.8"
"67","000","00","004","0405","0172","628","331","297","38","666","1391","0","47.88","23.8"
"67","000","00","004","0406","0000","334","174","160","17","351","743","0","47.24","23.42"
"67","000","00","004","0406","0173","202","102","100","5","207","425","0","48.71","24.0"
"67","000","00","004","0406","0174","132","72","60","12","144","318","0","45.28","22.64"
"67","000","00","004","0407","0000","683","366","317","55","738","1483","0","49.76","24.68"
"67","000","00","004","0407","0175","368","204","164","21","389","753","0","51.66","27.09"
"67","000","00","004","0407","0176","315","162","153","34","349","730","0","47.81","22.19"
"67","000","00","004","0408","0000","901","526","375","67","968","1809","0","53.51","29.08"
"67","000","00","004","0408","0177","349","209","140","19","368","725","0","50.76","28.83"
"67","000","00","004","0408","0178","403","236","167","26","429","787","0","54.51","29.99"
"67","000","00","004","0408","0179","149","81","68","22","171","297","0","57.58","27.27"
"67","000","00","004","0409","0000","682","386","296","70","752","1313","0","57.27","29.4"
"67","000","00","004","0409","0180","347","196","151","31","378","673","0","56.17","29.12"
"67","000","00","004","0409","0181","335","190","145","39","374","640","0","58.44","29.69"
"67","000","00","004","0410","0000","297","192","105","12","309","660","0","46.82","29.09"
"67","000","00","004","0410","0182","297","192","105","12","309","660","0","46.82","29.09"
"67","000","00","004","0411","0000","610","359","251","48","658","1414","0","46.53","25.39"
"67","000","00","004","0411","0183","522","306","216","43","565","1212","0","46.62","25.25"
"67","000","00","004","0411","0184","88","53","35","5","93","202","0","46.04","26.24"
"67","000","00","004","0412","0000","555","314","241","50","605","1207","0","50.12","26.01"
"67","000","00","004","0412","0185","473","269","204","49","522","1049","0","49.76","25.64"
"67","000","00","004","0412","0186","82","45","37","1","83","158","0","52.53","28.48"
"67","000","00","004","0413","0000","726","391","335","54","780","1582","0","49.3","24.72"
"67","000","00","004","0413","0187","424","223","201","40","464","921","0","50.38","24.21"
"67","000","00","004","0413","0188","235","127","108","12","247","504","0","49.01","25.2"
"67","000","00","004","0413","0189","67","41","26","2","69","157","0","43.95","26.11"
"67","000","00","005","0000","0000","9615","5630","3985","666","10281","20841","23424","49.33","27.01"
"67","000","00","005","0501","0000","846","451","395","39","885","1641","0","53.93","27.48"
"67","000","00","005","0501","0001","400","246","154","29","429","743","0","57.74","33.11"
"67","000","00","005","0501","0002","446","205","241","10","456","898","0","50.78","22.83"
"67","000","00","005","0502","0000","599","348","251","70","669","1320","0","50.68","26.36"
"67","000","00","005","0502","0003","365","212","153","28","393","786","0","50.0","26.97"
"67","000","00","005","0502","0004","234","136","98","42","276","534","0","51.69","25.47"
"67","000","00","005","0503","0000","599","350","249","45","644","1266","0","50.87","27.65"
"67","000","00","005","0503","0005","499","273","226","37","536","1034","0","51.84","26.4"
"67","000","00","005","0503","0006","100","77","23","8","108","232","0","46.55","33.19"
"67","000","00","005","0504","0000","618","374","244","44","662","1316","0","50.3","28.42"
"67","000","00","005","0504","0007","228","141","87","14","242","479","0","50.52","29.44"
"67","000","00","005","0504","0008","390","233","157","30","420","837","0","50.18","27.84"
"67","000","00","005","0510","0000","659","422","237","24","683","1399","0","48.82","30.16"
"67","000","00","005","0510","0021","417","281","136","11","428","958","0","44.68","29.33"
"67","000","00","005","0510","0022","242","141","101","13","255","441","0","57.82","31.97"
"67","000","00","005","0511","0000","847","497","350","82","929","1673","0","55.53","29.71"
"67","000","00","005","0511","0023","349","216","133","38","387","677","0","57.16","31.91"
"67","000","00","005","0511","0024","498","281","217","44","542","996","0","54.42","28.21"
"67","000","00","005","0512","0000","547","290","257","25","572","1255","0","45.58","23.11"
"67","000","00","005","0512","0025","547","290","257","25","572","1255","0","45.58","23.11"
"67","000","00","005","0513","0000","550","315","235","21","571","1231","0","46.39","25.59"
"67","000","00","005","0513","0026","308","177","131","13","321","678","0","47.35","26.11"
"67","000","00","005","0513","0027","242","138","104","8","250","553","0","45.21","24.95"
"67","000","00","005","0514","0000","817","473","344","42","859","1805","0","47.59","26.2"
"67","000","00","005","0514","0028","248","159","89","11","259","616","0","42.05","25.81"
"67","000","00","005","0514","0029","569","314","255","31","600","1189","0","50.46","26.41"
"67","000","00","005","0518","0000","657","371","286","59","716","1475","0","48.54","25.15"
"67","000","00","005","0518","0013","173","85","88","13","186","371","0","50.13","22.91"
"67","000","00","005","0518","0014","303","182","121","34","337","676","0","49.85","26.92"
"67","000","00","005","0518","0015","181","104","77","12","193","428","0","45.09","24.3"
"67","000","00","005","0519","0000","453","302","151","36","489","1002","0","48.8","30.14"
"67","000","00","005","0519","0016","241","170","71","12","253","547","0","46.25","31.08"
"67","000","00","005","0519","0017","212","132","80","24","236","455","0","51.87","29.01"
"67","000","00","005","0522","0000","816","484","332","89","905","2003","0","45.18","24.16"
"67","000","00","005","0522","0018","395","234","161","44","439","984","0","44.61","23.78"
"67","000","00","005","0522","0019","206","140","66","29","235","483","0","48.65","28.99"
"67","000","00","005","0522","0020","215","110","105","16","231","536","0","43.1","20.52"
"67","000","00","005","0523","0000","1011","645","366","31","1042","2242","0","46.48","28.77"
"67","000","00","005","0523","0009","524","342","182","22","546","1085","0","50.32","31.52"
"67","000","00","005","0523","0010","487","303","184","9","496","1157","0","42.87","26.19"
"67","000","00","005","0524","0000","596","308","288","59","655","1213","0","54.0","25.39"
"67","000","00","005","0524","0011","355","185","170","36","391","755","0","51.79","24.5"
"67","000","00","005","0524","0012","241","123","118","23","264","458","0","57.64","26.86"
"67","000","00","006","0000","0000","6833","3823","3010","453","7286","18471","20870","39.45","20.7"
"67","000","00","006","0601","0000","587","298","289","35","622","1401","0","44.4","21.27"
"67","000","00","006","0601","0062","587","298","289","35","622","1401","0","44.4","21.27"
"67","000","00","006","0602","0000","999","565","434","74","1073","2488","0","43.13","22.71"
"67","000","00","006","0602","0063","503","280","223","32","535","1185","0","45.15","23.63"
"67","000","00","006","0602","0064","496","285","211","42","538","1303","0","41.29","21.87"
"67","000","00","006","0603","0000","552","324","228","39","591","1453","0","40.67","22.3"
"67","000","00","006","0603","0065","284","167","117","16","300","732","0","40.98","22.81"
"67","000","00","006","0603","0066","268","157","111","23","291","721","0","40.36","21.78"
"67","000","00","006","0604","0000","390","237","153","20","410","943","0","43.48","25.13"
"67","000","00","006","0604","0068","390","237","153","20","410","943","0","43.48","25.13"
"67","000","00","006","0605","0000","388","215","173","24","412","1104","0","37.32","19.47"
"67","000","00","006","0605","0067","388","215","173","24","412","1104","0","37.32","19.47"
"67","000","00","006","0606","0000","435","240","195","24","459","1249","0","36.75","19.22"
"67","000","00","006","0606","0069","173","82","91","3","176","653","0","26.95","12.56"
"67","000","00","006","0606","0070","262","158","104","21","283","596","0","47.48","26.51"
"67","000","00","006","0607","0000","374","241","133","32","406","878","0","46.24","27.45"
"67","000","00","006","0607","0071","374","241","133","32","406","878","0","46.24","27.45"
"67","000","00","006","0608","0000","108","60","48","4","112","425","0","26.35","14.12"
"67","000","00","006","0608","0075","108","60","48","4","112","425","0","26.35","14.12"
"67","000","00","006","0609","0000","142","87","55","7","149","394","0","37.82","22.08"
"67","000","00","006","0609","0076","142","87","55","7","149","394","0","37.82","22.08"
"67","000","00","006","0610","0000","171","109","62","21","192","373","0","51.47","29.22"
"67","000","00","006","0610","0077","171","109","62","21","192","373","0","51.47","29.22"
"67","000","00","006","0611","0000","662","321","341","38","700","2144","0","32.65","14.97"
"67","000","00","006","0611","0078","437","214","223","28","465","1257","0","36.99","17.02"
"67","000","00","006","0611","0079","225","107","118","10","235","887","0","26.49","12.06"
"67","000","00","006","0612","0000","193","124","69","11","204","658","0","31.0","18.84"
"67","000","00","006","0612","0080","193","124","69","11","204","658","0","31.0","18.84"
"67","000","00","006","0613","0000","326","183","143","26","352","1101","0","31.97","16.62"
"67","000","00","006","0613","0081","326","183","143","26","352","1101","0","31.97","16.62"
"67","000","00","006","0614","0000","292","158","134","13","305","1057","0","28.86","14.95"
"67","000","00","006","0614","0082","292","158","134","13","305","1057","0","28.86","14.95"
"67","000","00","006","0615","0000","394","184","210","28","422","909","0","46.42","20.24"
"67","000","00","006","0615","0083","287","131","156","17","304","639","0","47.57","20.5"
"67","000","00","006","0615","0084","107","53","54","11","118","270","0","43.7","19.63"
"67","000","00","006","0616","0000","820","477","343","57","877","1894","0","46.3","25.18"
"67","000","00","006","0616","0072","325","208","117","16","341","771","0","44.23","26.98"
"67","000","00","006","0616","0073","193","95","98","20","213","483","0","44.1","19.67"
"67","000","00","006","0616","0074","302","174","128","21","323","640","0","50.47","27.19"
"67","000","00","007","0000","0000","18869","11585","7284","784","19653","37963","44306","51.77","30.52"
"67","000","00","007","0703","0000","1416","793","623","57","1473","2587","0","56.94","30.65"
"67","000","00","007","0703","0385","679","385","294","30","709","1262","0","56.18","30.51"
"67","000","00","007","0703","0386","737","408","329","27","764","1325","0","57.66","30.79"
"67","000","00","007","0704","0000","1284","812","472","41","1325","2505","0","52.89","32.42"
"67","000","00","007","0704","0387","693","421","272","28","721","1384","0","52.1","30.42"
"67","000","00","007","0704","0388","591","391","200","13","604","1121","0","53.88","34.88"
"67","000","00","007","0705","0000","1091","637","454","44","1135","2120","0","53.54","30.05"
"67","000","00","007","0705","0383","298","191","107","9","307","523","0","58.7","36.52"
"67","000","00","007","0705","0384","793","446","347","35","828","1597","0","51.85","27.93"
"67","000","00","007","0706","0000","976","576","400","29","1005","1975","0","50.89","29.16"
"67","000","00","007","0706","0389","500","297","203","11","511","1021","0","50.05","29.09"
"67","000","00","007","0706","0390","476","279","197","18","494","954","0","51.78","29.25"
"67","000","00","007","0707","0000","705","433","272","25","730","1513","0","48.25","28.62"
"67","000","00","007","0707","0391","705","433","272","25","730","1513","0","48.25","28.62"
"67","000","00","007","0709","0000","1656","973","683","74","1730","3530","0","49.01","27.56"
"67","000","00","007","0709","0392","777","469","308","30","807","1726","0","46.76","27.17"
"67","000","00","007","0709","0393","879","504","375","44","923","1804","0","51.16","27.94"
"67","000","00","007","0710","0000","543","365","178","21","564","1106","0","50.99","33.0"
"67","000","00","007","0710","0394","543","365","178","21","564","1106","0","50.99","33.0"
"67","000","00","007","0711","0000","1450","868","582","53","1503","2805","0","53.58","30.94"
"67","000","00","007","0711","0395","806","473","333","22","828","1503","0","55.09","31.47"
"67","000","00","007","0711","0396","644","395","249","31","675","1302","0","51.84","30.34"
"67","000","00","007","0714","0000","1069","615","454","62","1131","2330","0","48.54","26.39"
"67","000","00","007","0714","0399","736","420","316","57","793","1612","0","49.19","26.05"
"67","000","00","007","0714","0400","333","195","138","5","338","718","0","47.08","27.16"
"67","000","00","007","0715","0000","746","470","276","27","773","1656","0","46.68","28.38"
"67","000","00","007","0715","0401","746","470","276","27","773","1656","0","46.68","28.38"
"67","000","00","007","0717","0000","1058","675","383","50","1108","2332","0","47.51","28.95"
"67","000","00","007","0717","0402","635","392","243","40","675","1355","0","49.82","28.93"
"67","000","00","007","0717","0403","423","283","140","10","433","977","0","44.32","28.97"
"67","000","00","007","0719","0000","1014","659","355","39","1053","2105","0","50.02","31.31"
"67","000","00","007","0719","0404","480","304","176","21","501","1012","0","49.51","30.04"
"67","000","00","007","0719","0405","354","234","120","15","369","626","0","58.95","37.38"
"67","000","00","007","0719","0406","180","121","59","3","183","467","0","39.19","25.91"
"67","000","00","007","0721","0000","603","365","238","18","621","1260","0","49.29","28.97"
"67","000","00","007","0721","0407","603","365","238","18","621","1260","0","49.29","28.97"
"67","000","00","007","0722","0000","583","369","214","29","612","1111","0","55.09","33.21"
"67","000","00","007","0722","0408","583","369","214","29","612","1111","0","55.09","33.21"
"67","000","00","007","0724","0000","725","501","224","40","765","1348","0","56.75","37.17"
"67","000","00","007","0724","0409","313","210","103","19","332","550","0","60.36","38.18"
"67","000","00","007","0724","0410","412","291","121","21","433","798","0","54.26","36.47"
"67","000","00","007","0728","0000","429","247","182","17","446","941","0","47.4","26.25"
"67","000","00","007","0728","0413","429","247","182","17","446","941","0","47.4","26.25"
"67","000","00","007","0730","0000","967","599","368","39","1006","1865","0","53.94","32.12"
"67","000","00","007","0730","0381","612","373","239","21","633","1205","0","52.53","30.95"
"67","000","00","007","0730","0382","355","226","129","18","373","660","0","56.52","34.24"
"67","000","00","007","0731","0000","905","590","315","48","953","1682","0","56.66","35.08"
"67","000","00","007","0731","0411","472","295","177","43","515","852","0","60.45","34.62"
"67","000","00","007","0731","0412","433","295","138","5","438","830","0","52.77","35.54"
"67","000","00","007","0732","0000","896","575","321","37","933","1770","0","52.71","32.49"
"67","000","00","007","0732","0414","615","414","201","28","643","1158","0","55.53","35.75"
"67","000","00","007","0732","0415","281","161","120","9","290","612","0","47.39","26.31"
"67","000","00","007","0733","0000","753","463","290","34","787","1422","0","55.34","32.56"
"67","000","00","007","0733","0397","335","191","144","10","345","645","0","53.49","29.61"
"67","000","00","007","0733","0398","418","272","146","24","442","777","0","56.89","35.01"
"67","000","00","008","0000","0000","9696","5732","3964","576","10272","20947","23938","49.04","27.36"
"67","000","00","008","0801","0000","666","443","223","32","698","1558","0","44.8","28.43"
"67","000","00","008","0801","0343","666","443","223","32","698","1558","0","44.8","28.43"
"67","000","00","008","0802","0000","869","509","360","49","918","2005","0","45.79","25.39"
"67","000","00","008","0802","0344","463","258","205","23","486","1112","0","43.71","23.2"
"67","000","00","008","0802","0345","406","251","155","26","432","893","0","48.38","28.11"
"67","000","00","008","0803","0000","689","367","322","34","723","1623","0","44.55","22.61"
"67","000","00","008","0803","0346","689","367","322","34","723","1623","0","44.55","22.61"
"67","000","00","008","0804","0000","731","396","335","50","781","1568","0","49.81","25.26"
"67","000","00","008","0804","0347","731","396","335","50","781","1568","0","49.81","25.26"
"67","000","00","008","0805","0000","911","485","426","50","961","1938","0","49.59","25.03"
"67","000","00","008","0805","0348","475","247","228","36","511","985","0","51.88","25.08"
"67","000","00","008","0805","0349","436","238","198","14","450","953","0","47.22","24.97"
"67","000","00","008","0806","0000","1048","573","475","73","1121","2108","0","53.18","27.18"
"67","000","00","008","0806","0350","485","273","212","25","510","1031","0","49.47","26.48"
"67","000","00","008","0806","0351","563","300","263","48","611","1077","0","56.73","27.86"
"67","000","00","008","0811","0000","914","525","389","53","967","1894","0","51.06","27.72"
"67","000","00","008","0811","0356","466","263","203","31","497","959","0","51.82","27.42"
"67","000","00","008","0811","0357","448","262","186","22","470","935","0","50.27","28.02"
"67","000","00","008","0812","0000","468","301","167","23","491","893","0","54.98","33.71"
"67","000","00","008","0812","0358","468","301","167","23","491","893","0","54.98","33.71"
"67","000","00","008","0813","0000","624","399","225","52","676","1293","0","52.28","30.86"
"67","000","00","008","0813","0359","624","399","225","52","676","1293","0","52.28","30.86"
"67","000","00","008","0816","0000","1072","684","388","51","1123","2255","0","49.8","30.33"
"67","000","00","008","0816","0354","587","386","201","32","619","1164","0","53.18","33.16"
"67","000","00","008","0816","0355","485","298","187","19","504","1091","0","46.2","27.31"
"67","000","00","008","0817","0000","660","378","282","35","695","1557","0","44.64","24.28"
"67","000","00","008","0817","0352","294","177","117","21","315","703","0","44.81","25.18"
"67","000","00","008","0817","0353","366","201","165","14","380","854","0","44.5","23.54"
"67","000","00","008","0818","0000","1044","672","372","74","1118","2255","0","49.58","29.8"
"67","000","00","008","0818","0360","584","382","202","53","637","1185","0","53.76","32.24"
"67","000","00","008","0818","0361","460","290","170","21","481","1070","0","44.95","27.1"
"67","000","00","009","0000","0000","9068","5182","3886","528","9596","19144","22196","50.13","27.07"
"67","000","00","009","0901","0000","1441","844","597","72","1513","2908","0","52.03","29.02"
"67","000","00","009","0901","0362","440","248","192","32","472","819","0","57.63","30.28"
"67","000","00","009","0901","0363","342","198","144","11","353","645","0","54.73","30.7"
"67","000","00","009","0901","0364","659","398","261","29","688","1444","0","47.65","27.56"
"67","000","00","009","0902","0000","1185","680","505","59","1244","2725","0","45.65","24.95"
"67","000","00","009","0902","0365","682","393","289","26","708","1554","0","45.56","25.29"
"67","000","00","009","0902","0366","503","287","216","33","536","1171","0","45.77","24.51"
"67","000","00","009","0903","0000","628","360","268","32","660","1351","0","48.85","26.65"
"67","000","00","009","0903","0367","628","360","268","32","660","1351","0","48.85","26.65"
"67","000","00","009","0905","0000","848","496","352","81","929","1929","0","48.16","25.71"
"67","000","00","009","0905","0368","440","252","188","41","481","1010","0","47.62","24.95"
"67","000","00","009","0905","0369","408","244","164","40","448","919","0","48.75","26.55"
"67","000","00","009","0906","0000","1657","984","673","111","1768","3360","0","52.62","29.29"
"67","000","00","009","0906","0370","649","390","259","39","688","1369","0","50.26","28.49"
"67","000","00","009","0906","0371","478","281","197","40","518","976","0","53.07","28.79"
"67","000","00","009","0906","0372","530","313","217","32","562","1015","0","55.37","30.84"
"67","000","00","009","0907","0000","1004","574","430","43","1047","2115","0","49.5","27.14"
"67","000","00","009","0907","0373","535","308","227","20","555","1176","0","47.19","26.19"
"67","000","00","009","0907","0374","469","266","203","23","492","939","0","52.4","28.33"
"67","000","00","009","0908","0000","788","435","353","56","844","1593","0","52.98","27.31"
"67","000","00","009","0908","0375","350","210","140","31","381","712","0","53.51","29.49"
"67","000","00","009","0908","0376","438","225","213","25","463","881","0","52.55","25.54"
"67","000","00","009","0909","0000","665","337","328","30","695","1184","0","58.7","28.46"
"67","000","00","009","0909","0377","665","337","328","30","695","1184","0","58.7","28.46"
"67","000","00","009","0910","0000","358","195","163","20","378","599","0","63.11","32.55"
"67","000","00","009","0910","0378","358","195","163","20","378","599","0","63.11","32.55"
"67","000","00","009","0911","0000","259","144","115","7","266","759","0","35.05","18.97"
"67","000","00","009","0911","0379","259","144","115","7","266","759","0","35.05","18.97"
"67","000","00","009","0912","0000","235","133","102","17","252","621","0","40.58","21.42"
"67","000","00","009","0912","0380","235","133","102","17","252","621","0","40.58","21.42"
"67","000","00","010","0000","0000","8989","5375","3614","484","9473","18675","21329","50.73","28.78"
"67","000","00","010","1001","0000","957","536","421","34","991","2069","0","47.9","25.91"
"67","000","00","010","1001","0416","509","271","238","8","517","1104","0","46.83","24.55"
"67","000","00","010","1001","0417","448","265","183","26","474","965","0","49.12","27.46"
"67","000","00","010","1002","0000","1548","959","589","96","1644","3055","0","53.81","31.39"
"67","000","00","010","1002","0418","702","426","276","29","731","1402","0","52.14","30.39"
"67","000","00","010","1002","0419","846","533","313","67","913","1653","0","55.23","32.24"
"67","000","00","010","1005","0000","135","89","46","4","139","402","0","34.58","22.14"
"67","000","00","010","1005","0422","135","89","46","4","139","402","0","34.58","22.14"
"67","000","00","010","1006","0000","916","513","403","29","945","1957","0","48.29","26.21"
"67","000","00","010","1006","0423","492","275","217","7","499","982","0","50.81","28.0"
"67","000","00","010","1006","0424","424","238","186","22","446","975","0","45.74","24.41"
"67","000","00","010","1007","0000","1666","887","779","77","1743","3375","0","51.64","26.28"
"67","000","00","010","1007","0425","373","194","179","26","399","802","0","49.75","24.19"
"67","000","00","010","1007","0426","583","327","256","27","610","1118","0","54.56","29.25"
"67","000","00","010","1007","0427","710","366","344","24","734","1455","0","50.45","25.15"
"67","000","00","010","1008","0000","596","353","243","25","621","1208","0","51.41","29.22"
"67","000","00","010","1008","0428","596","353","243","25","621","1208","0","51.41","29.22"
"67","000","00","010","1013","0000","408","245","163","20","428","873","0","49.03","28.06"
"67","000","00","010","1013","0435","408","245","163","20","428","873","0","49.03","28.06"
"67","000","00","010","1014","0000","569","374","195","35","604","1250","0","48.32","29.92"
"67","000","00","010","1014","0420","448","302","146","28","476","966","0","49.28","31.26"
"67","000","00","010","1014","0421","121","72","49","7","128","284","0","45.07","25.35"
"67","000","00","010","1015","0000","1268","747","521","102","1370","2586","0","52.98","28.89"
"67","000","00","010","1015","0431","229","127","102","19","248","501","0","49.5","25.35"
"67","000","00","010","1015","0432","369","221","148","37","406","728","0","55.77","30.36"
"67","000","00","010","1015","0433","414","248","166","22","436","842","0","51.78","29.45"
"67","000","00","010","1015","0434","256","151","105","24","280","515","0","54.37","29.32"
"67","000","00","010","1016","0000","926","672","254","62","988","1900","0","52.0","35.37"
"67","000","00","010","1016","0429","640","451","189","48","688","1293","0","53.21","34.88"
"67","000","00","010","1016","0430","286","221","65","14","300","607","0","49.42","36.41"
"67","000","00","011","0000","0000","4054","2317","1737","259","4313","8654","9643","49.84","26.77"
"67","000","00","011","1101","0000","394","208","186","25","419","1021","0","41.04","20.37"
"67","000","00","011","1101","0436","304","173","131","25","329","759","0","43.35","22.79"
"67","000","00","011","1101","0437","90","35","55","0","90","262","0","34.35","13.36"
"67","000","00","011","1102","0000","265","176","89","8","273","646","0","42.26","27.24"
"67","000","00","011","1102","0438","265","176","89","8","273","646","0","42.26","27.24"
"67","000","00","011","1103","0000","578","340","238","32","610","1473","0","41.41","23.08"
"67","000","00","011","1103","0439","578","340","238","32","610","1473","0","41.41","23.08"
"67","000","00","011","1104","0000","469","258","211","35","504","915","0","55.08","28.2"
"67","000","00","011","1104","0440","469","258","211","35","504","915","0","55.08","28.2"
"67","000","00","011","1105","0000","425","246","179","32","457","779","0","58.66","31.58"
"67","000","00","011","1105","0441","425","246","179","32","457","779","0","58.66","31.58"
"67","000","00","011","1106","0000","381","241","140","15","396","637","0","62.17","37.83"
"67","000","00","011","1106","0442","381","241","140","15","396","637","0","62.17","37.83"
"67","000","00","011","1107","0000","461","276","185","35","496","993","0","49.95","27.79"
"67","000","00","011","1107","0443","461","276","185","35","496","993","0","49.95","27.79"
"67","000","00","011","1108","0000","392","173","219","20","412","766","0","53.79","22.58"
"67","000","00","011","1108","0444","392","173","219","20","412","766","0","53.79","22.58"
"67","000","00","011","1109","0000","419","236","183","33","452","841","0","53.75","28.06"
"67","000","00","011","1109","0445","419","236","183","33","452","841","0","53.75","28.06"
"67","000","00","011","1110","0000","270","163","107","24","294","583","0","50.43","27.96"
"67","000","00","011","1110","0446","270","163","107","24","294","583","0","50.43","27.96"
"67","000","00","012","0000","0000","25692","14077","11615","1147","26839","50407","59087","53.24","27.93"
"67","000","00","012","1201","0000","1233","710","523","49","1282","2220","0","57.75","31.98"
"67","000","00","012","1201","0282","745","440","305","34","779","1391","0","56.0","31.63"
"67","000","00","012","1201","0283","488","270","218","15","503","829","0","60.68","32.57"
"67","000","00","012","1202","0000","1302","695","607","31","1333","2853","0","46.72","24.36"
"67","000","00","012","1202","0284","658","366","292","14","672","1401","0","47.97","26.12"
"67","000","00","012","1202","0285","644","329","315","17","661","1452","0","45.52","22.66"
"67","000","00","012","1203","0000","2818","1572","1246","149","2967","5611","0","52.88","28.02"
"67","000","00","012","1203","0286","676","378","298","48","724","1382","0","52.39","27.35"
"67","000","00","012","1203","0287","753","399","354","38","791","1463","0","54.07","27.27"
"67","000","00","012","1203","0288","627","361","266","22","649","1280","0","50.7","28.2"
"67","000","00","012","1203","0289","762","434","328","41","803","1486","0","54.04","29.21"
"67","000","00","012","1204","0000","2067","1083","984","104","2171","4204","0","51.64","25.76"
"67","000","00","012","1204","0297","713","383","330","35","748","1425","0","52.49","26.88"
"67","000","00","012","1204","0298","634","348","286","28","662","1255","0","52.75","27.73"
"67","000","00","012","1204","0299","720","352","368","41","761","1524","0","49.93","23.1"
"67","000","00","012","1205","0000","3070","1628","1442","151","3221","5877","0","54.81","27.7"
"67","000","00","012","1205","0290","728","412","316","43","771","1378","0","55.95","29.9"
"67","000","00","012","1205","0291","808","409","399","35","843","1505","0","56.01","27.18"
"67","000","00","012","1205","0292","941","511","430","33","974","1860","0","52.37","27.47"
"67","000","00","012","1205","0293","593","296","297","40","633","1134","0","55.82","26.1"
"67","000","00","012","1206","0000","2106","1113","993","50","2156","4059","0","53.12","27.42"
"67","000","00","012","1206","0303","723","381","342","20","743","1381","0","53.8","27.59"
"67","000","00","012","1206","0304","680","376","304","19","699","1364","0","51.25","27.57"
"67","000","00","012","1206","0305","703","356","347","11","714","1314","0","54.34","27.09"
"67","000","00","012","1207","0000","1119","640","479","60","1179","2125","0","55.48","30.12"
"67","000","00","012","1207","0306","626","357","269","33","659","1164","0","56.62","30.67"
"67","000","00","012","1207","0307","493","283","210","27","520","961","0","54.11","29.45"
"67","000","00","012","1212","0000","1013","529","484","59","1072","2209","0","48.53","23.95"
"67","000","00","012","1212","0312","679","336","343","44","723","1507","0","47.98","22.3"
"67","000","00","012","1212","0313","334","193","141","15","349","702","0","49.72","27.49"
"67","000","00","012","1219","0000","740","434","306","52","792","1513","0","52.35","28.68"
"67","000","00","012","1219","0319","740","434","306","52","792","1513","0","52.35","28.68"
"67","000","00","012","1220","0000","1095","684","411","63","1158","2410","0","48.05","28.38"
"67","000","00","012","1220","0320","304","183","121","15","319","714","0","44.68","25.63"
"67","000","00","012","1220","0321","350","212","138","27","377","745","0","50.6","28.46"
"67","000","00","012","1220","0322","441","289","152","21","462","951","0","48.58","30.39"
"67","000","00","012","1222","0000","532","306","226","39","571","1072","0","53.26","28.54"
"67","000","00","012","1222","0310","347","200","147","32","379","689","0","55.01","29.03"
"67","000","00","012","1222","0311","185","106","79","7","192","383","0","50.13","27.68"
"67","000","00","012","1223","0000","2668","1337","1331","97","2765","5111","0","54.1","26.16"
"67","000","00","012","1223","0294","750","408","342","22","772","1426","0","54.14","28.61"
"67","000","00","012","1223","0295","899","459","440","44","943","1779","0","53.01","25.8"
"67","000","00","012","1223","0296","1019","470","549","31","1050","1906","0","55.09","24.66"
"67","000","00","012","1224","0000","1148","670","478","47","1195","2137","0","55.92","31.35"
"67","000","00","012","1224","0308","628","373","255","33","661","1218","0","54.27","30.62"
"67","000","00","012","1224","0309","520","297","223","14","534","919","0","58.11","32.32"
"67","000","00","012","1225","0000","1024","570","454","45","1069","1844","0","57.97","30.91"
"67","000","00","012","1225","0314","488","282","206","20","508","907","0","56.01","31.09"
"67","000","00","012","1225","0315","536","288","248","25","561","937","0","59.87","30.74"
"67","000","00","012","1226","0000","1434","892","542","57","1491","2798","0","53.29","31.88"
"67","000","00","012","1226","0316","540","329","211","23","563","1030","0","54.66","31.94"
"67","000","00","012","1226","0317","505","318","187","21","526","981","0","53.62","32.42"
"67","000","00","012","1226","0318","389","245","144","13","402","787","0","51.08","31.13"
"67","000","00","012","1227","0000","2323","1214","1109","94","2417","4364","0","55.38","27.82"
"67","000","00","012","1227","0300","807","417","390","26","833","1631","0","51.07","25.57"
"67","000","00","012","1227","0301","837","432","405","38","875","1546","0","56.6","27.94"
"67","000","00","012","1227","0302","679","365","314","30","709","1187","0","59.73","30.75"
"67","000","00","013","0000","0000","10501","6136","4365","555","11056","22567","25725","48.99","27.19"
"67","000","00","013","1301","0000","1909","1044","865","111","2020","3852","0","52.44","27.1"
"67","000","00","013","1301","0216","682","390","292","30","712","1370","0","51.97","28.47"
"67","000","00","013","1301","0217","584","314","270","33","617","1117","0","55.24","28.11"
"67","000","00","013","1301","0218","643","340","303","48","691","1365","0","50.62","24.91"
"67","000","00","013","1302","0000","1082","590","492","34","1116","2235","0","49.93","26.4"
"67","000","00","013","1302","0221","516","318","198","15","531","1052","0","50.48","30.23"
"67","000","00","013","1302","0222","566","272","294","19","585","1183","0","49.45","22.99"
"67","000","00","013","1303","0000","481","314","167","22","503","1238","0","40.63","25.36"
"67","000","00","013","1303","0227","325","211","114","15","340","832","0","40.87","25.36"
"67","000","00","013","1303","0228","156","103","53","7","163","406","0","40.15","25.37"
"67","000","00","013","1304","0000","405","244","161","25","430","818","0","52.57","29.83"
"67","000","00","013","1304","0229","405","244","161","25","430","818","0","52.57","29.83"
"67","000","00","013","1305","0000","880","484","396","42","922","1900","0","48.53","25.47"
"67","000","00","013","1305","0213","318","174","144","16","334","635","0","52.6","27.4"
"67","000","00","013","1305","0214","379","208","171","12","391","822","0","47.57","25.3"
"67","000","00","013","1305","0215","183","102","81","14","197","443","0","44.47","23.02"
"67","000","00","013","1306","0000","1261","703","558","71","1332","2409","0","55.29","29.18"
"67","000","00","013","1306","0208","456","246","210","37","493","862","0","57.19","28.54"
"67","000","00","013","1306","0209","340","195","145","12","352","611","0","57.61","31.91"
"67","000","00","013","1306","0210","465","262","203","22","487","936","0","52.03","27.99"
"67","000","00","013","1307","0000","975","674","301","46","1021","1935","0","52.76","34.83"
"67","000","00","013","1307","0211","507","405","102","29","536","1066","0","50.28","37.99"
"67","000","00","013","1307","0212","468","269","199","17","485","869","0","55.81","30.96"
"67","000","00","013","1308","0000","542","321","221","27","569","1241","0","45.85","25.87"
"67","000","00","013","1308","0224","542","321","221","27","569","1241","0","45.85","25.87"
"67","000","00","013","1309","0000","428","293","135","15","443","1052","0","42.11","27.85"
"67","000","00","013","1309","0230","428","293","135","15","443","1052","0","42.11","27.85"
"67","000","00","013","1310","0000","923","531","392","73","996","2116","0","47.07","25.09"
"67","000","00","013","1310","0219","667","360","307","53","720","1489","0","48.35","24.18"
"67","000","00","013","1310","0220","256","171","85","20","276","627","0","44.02","27.27"
"67","000","00","013","1311","0000","416","239","177","20","436","979","0","44.54","24.41"
"67","000","00","013","1311","0223","416","239","177","20","436","979","0","44.54","24.41"
"67","000","00","013","1312","0000","600","350","250","30","630","1369","0","46.02","25.57"
"67","000","00","013","1312","0231","256","161","95","10","266","578","0","46.02","27.85"
"67","000","00","013","1312","0232","177","100","77","13","190","430","0","44.19","23.26"
"67","000","00","013","1312","0233","167","89","78","7","174","361","0","48.2","24.65"
"67","000","00","013","1313","0000","599","349","250","39","638","1423","0","44.83","24.53"
"67","000","00","013","1313","0225","341","202","139","14","355","843","0","42.11","23.96"
"67","000","00","013","1313","0226","258","147","111","25","283","580","0","48.79","25.34"
"67","000","00","014","0000","0000","10098","5737","4361","523","10621","21564","24724","49.25","26.6"
"67","000","00","014","1401","0000","1549","855","694","67","1616","3148","0","51.33","27.16"
"67","000","00","014","1401","0323","452","240","212","20","472","933","0","50.59","25.72"
"67","000","00","014","1401","0324","470","273","197","19","489","901","0","54.27","30.3"
"67","000","00","014","1401","0325","627","342","285","28","655","1314","0","49.85","26.03"
"67","000","00","014","1402","0000","1136","690","446","47","1183","2401","0","49.27","28.74"
"67","000","00","014","1402","0329","772","449","323","36","808","1663","0","48.59","27.0"
"67","000","00","014","1402","0330","364","241","123","11","375","738","0","50.81","32.66"
"67","000","00","014","1403","0000","791","426","365","67","858","1593","0","53.86","26.74"
"67","000","00","014","1403","0331","617","313","304","47","664","1211","0","54.83","25.85"
"67","000","00","014","1403","0332","174","113","61","20","194","382","0","50.79","29.58"
"67","000","00","014","1404","0000","747","424","323","43","790","1624","0","48.65","26.11"
"67","000","00","014","1404","0333","354","212","142","21","375","786","0","47.71","26.97"
"67","000","00","014","1404","0334","393","212","181","22","415","838","0","49.52","25.3"
"67","000","00","014","1405","0000","633","401","232","29","662","1449","0","45.69","27.67"
"67","000","00","014","1405","0335","633","401","232","29","662","1449","0","45.69","27.67"
"67","000","00","014","1406","0000","635","365","270","25","660","1479","0","44.62","24.68"
"67","000","00","014","1406","0336","635","365","270","25","660","1479","0","44.62","24.68"
"67","000","00","014","1407","0000","395","239","156","38","433","763","0","56.75","31.32"
"67","000","00","014","1407","0337","395","239","156","38","433","763","0","56.75","31.32"
"67","000","00","014","1408","0000","612","358","254","18","630","1297","0","48.57","27.6"
"67","000","00","014","1408","0338","612","358","254","18","630","1297","0","48.57","27.6"
"67","000","00","014","1409","0000","664","387","277","21","685","1393","0","49.17","27.78"
"67","000","00","014","1409","0339","664","387","277","21","685","1393","0","49.17","27.78"
"67","000","00","014","1410","0000","590","335","255","32","622","1349","0","46.11","24.83"
"67","000","00","014","1410","0340","372","207","165","25","397","958","0","41.44","21.61"
"67","000","00","014","1410","0341","218","128","90","7","225","391","0","57.54","32.74"
"67","000","00","014","1411","0000","400","207","193","30","430","805","0","53.42","25.71"
"67","000","00","014","1411","0342","400","207","193","30","430","805","0","53.42","25.71"
"67","000","00","014","1412","0000","1946","1050","896","106","2052","4263","0","48.14","24.63"
"67","000","00","014","1412","0326","655","348","307","46","701","1349","0","51.96","25.8"
"67","000","00","014","1412","0327","541","306","235","36","577","1014","0","56.9","30.18"
"67","000","00","014","1412","0328","750","396","354","24","774","1900","0","40.74","20.84"
"67","000","00","015","0000","0000","9146","5398","3748","501","9647","19950","22810","48.36","27.06"
"67","000","00","015","1501","0000","548","345","203","18","566","1042","0","54.32","33.11"
"67","000","00","015","1501","0258","261","160","101","10","271","534","0","50.75","29.96"
"67","000","00","015","1501","0259","287","185","102","8","295","508","0","58.07","36.42"
"67","000","00","015","1502","0000","273","177","96","4","277","665","0","41.65","26.62"
"67","000","00","015","1502","0260","273","177","96","4","277","665","0","41.65","26.62"
"67","000","00","015","1504","0000","358","217","141","20","378","834","0","45.32","26.02"
"67","000","00","015","1504","0261","358","217","141","20","378","834","0","45.32","26.02"
"67","000","00","015","1505","0000","353","221","132","13","366","810","0","45.19","27.28"
"67","000","00","015","1505","0262","353","221","132","13","366","810","0","45.19","27.28"
"67","000","00","015","1506","0000","197","138","59","11","208","480","0","43.33","28.75"
"67","000","00","015","1506","0263","197","138","59","11","208","480","0","43.33","28.75"
"67","000","00","015","1507","0000","220","155","65","12","232","445","0","52.13","34.83"
"67","000","00","015","1507","0264","220","155","65","12","232","445","0","52.13","34.83"
"67","000","00","015","1508","0000","675","436","239","33","708","1618","0","43.76","26.95"
"67","000","00","015","1508","0266","359","229","130","16","375","838","0","44.75","27.33"
"67","000","00","015","1508","0267","316","207","109","17","333","780","0","42.69","26.54"
"67","000","00","015","1509","0000","187","105","82","10","197","350","0","56.29","30.0"
"67","000","00","015","1509","0268","187","105","82","10","197","350","0","56.29","30.0"
"67","000","00","015","1510","0000","500","290","210","36","536","907","0","59.1","31.97"
"67","000","00","015","1510","0269","500","290","210","36","536","907","0","59.1","31.97"
"67","000","00","015","1511","0000","363","192","171","15","378","780","0","48.46","24.62"
"67","000","00","015","1511","0270","363","192","171","15","378","780","0","48.46","24.62"
"67","000","00","015","1512","0000","1136","630","506","48","1184","2571","0","46.05","24.5"
"67","000","00","015","1512","0271","724","388","336","27","751","1658","0","45.3","23.4"
"67","000","00","015","1512","0272","412","242","170","21","433","913","0","47.43","26.51"
"67","000","00","015","1515","0000","849","476","373","41","890","1898","0","46.89","25.08"
"67","000","00","015","1515","0273","580","315","265","34","614","1202","0","51.08","26.21"
"67","000","00","015","1515","0274","269","161","108","7","276","696","0","39.66","23.13"
"67","000","00","015","1517","0000","259","176","83","7","266","680","0","39.12","25.88"
"67","000","00","015","1517","0265","259","176","83","7","266","680","0","39.12","25.88"
"67","000","00","015","1518","0000","679","405","274","60","739","1269","0","58.23","31.91"
"67","000","00","015","1518","0275","316","188","128","24","340","647","0","52.55","29.06"
"67","000","00","015","1518","0276","363","217","146","36","399","622","0","64.15","34.89"
"67","000","00","015","1519","0000","955","540","415","58","1013","1873","0","54.08","28.83"
"67","000","00","015","1519","0277","634","346","288","46","680","1175","0","57.87","29.45"
"67","000","00","015","1519","0278","321","194","127","12","333","698","0","47.71","27.79"
"67","000","00","015","1521","0000","477","272","205","42","519","983","0","52.8","27.67"
"67","000","00","015","1521","0279","477","272","205","42","519","983","0","52.8","27.67"
"67","000","00","015","1522","0000","543","293","250","26","569","1366","0","41.65","21.45"
"67","000","00","015","1522","0280","543","293","250","26","569","1366","0","41.65","21.45"
"67","000","00","015","1523","0000","574","330","244","47","621","1379","0","45.03","23.93"
"67","000","00","015","1523","0281","574","330","244","47","621","1379","0","45.03","23.93"
"67","000","00","016","0000","0000","8069","4851","3218","398","8467","17754","19691","47.69","27.32"
"67","000","00","016","1601","0000","602","358","244","37","639","1110","0","57.57","32.25"
"67","000","00","016","1601","0234","602","358","244","37","639","1110","0","57.57","32.25"
"67","000","00","016","1613","0000","363","242","121","15","378","849","0","44.52","28.5"
"67","000","00","016","1613","0250","363","242","121","15","378","849","0","44.52","28.5"
"67","000","00","016","1614","0000","247","129","118","23","270","645","0","41.86","20.0"
"67","000","00","016","1614","0251","247","129","118","23","270","645","0","41.86","20.0"
"67","000","00","016","1615","0000","506","319","187","26","532","1353","0","39.32","23.58"
"67","000","00","016","1615","0252","283","184","99","15","298","690","0","43.19","26.67"
"67","000","00","016","1615","0253","223","135","88","11","234","663","0","35.29","20.36"
"67","000","00","016","1616","0000","521","318","203","18","539","1175","0","45.87","27.06"
"67","000","00","016","1616","0254","521","318","203","18","539","1175","0","45.87","27.06"
"67","000","00","016","1617","0000","859","568","291","56","915","1898","0","48.21","29.93"
"67","000","00","016","1617","0255","346","237","109","12","358","837","0","42.77","28.32"
"67","000","00","016","1617","0256","513","331","182","44","557","1061","0","52.5","31.2"
"67","000","00","016","1618","0000","417","282","135","11","428","976","0","43.85","28.89"
"67","000","00","016","1618","0257","417","282","135","11","428","976","0","43.85","28.89"
"67","000","00","016","1619","0000","501","345","156","19","520","1223","0","42.52","28.21"
"67","000","00","016","1619","0245","277","192","85","10","287","650","0","44.15","29.54"
"67","000","00","016","1619","0246","224","153","71","9","233","573","0","40.66","26.7"
"67","000","00","016","1620","0000","1173","660","513","40","1213","2387","0","50.82","27.65"
"67","000","00","016","1620","0235","703","398","305","24","727","1418","0","51.27","28.07"
"67","000","00","016","1620","0236","470","262","208","16","486","969","0","50.15","27.04"
"67","000","00","016","1621","0000","1193","632","561","73","1266","2482","0","51.01","25.46"
"67","000","00","016","1621","0237","286","164","122","29","315","519","0","60.69","31.6"
"67","000","00","016","1621","0238","525","248","277","23","548","1106","0","49.55","22.42"
"67","000","00","016","1621","0239","257","155","102","16","273","542","0","50.37","28.6"
"67","000","00","016","1621","0240","125","65","60","5","130","315","0","41.27","20.63"
"67","000","00","016","1622","0000","928","538","390","41","969","2032","0","47.69","26.48"
"67","000","00","016","1622","0241","243","138","105","16","259","584","0","44.35","23.63"
"67","000","00","016","1622","0242","194","115","79","5","199","398","0","50.0","28.89"
"67","000","00","016","1622","0243","265","167","98","10","275","608","0","45.23","27.47"
"67","000","00","016","1622","0244","226","118","108","10","236","442","0","53.39","26.7"
"67","000","00","016","1623","0000","759","460","299","39","798","1624","0","49.14","28.33"
"67","000","00","016","1623","0247","267","158","109","10","277","617","0","44.89","25.61"
"67","000","00","016","1623","0248","282","182","100","15","297","573","0","51.83","31.76"
"67","000","00","016","1623","0249","210","120","90","14","224","434","0","51.61","27.65"
"67","000","00","017","0000","0000","4107","2304","1803","188","4295","9925","11099","43.27","23.21"
"67","000","00","017","1701","0000","569","300","269","17","586","1341","0","43.7","22.37"
"67","000","00","017","1701","0196","319","174","145","3","322","742","0","43.4","23.45"
"67","000","00","017","1701","0197","250","126","124","14","264","599","0","44.07","21.04"
"67","000","00","017","1702","0000","176","96","80","7","183","473","0","38.69","20.3"
"67","000","00","017","1702","0201","176","96","80","7","183","473","0","38.69","20.3"
"67","000","00","017","1705","0000","375","206","169","20","395","838","0","47.14","24.58"
"67","000","00","017","1705","0192","174","74","100","5","179","456","0","39.25","16.23"
"67","000","00","017","1705","0193","201","132","69","15","216","382","0","56.54","34.55"
"67","000","00","017","1706","0000","329","212","117","15","344","954","0","36.06","22.22"
"67","000","00","017","1706","0202","329","212","117","15","344","954","0","36.06","22.22"
"67","000","00","017","1707","0000","449","258","191","27","476","1200","0","39.67","21.5"
"67","000","00","017","1707","0204","250","138","112","8","258","679","0","38.0","20.32"
"67","000","00","017","1707","0205","199","120","79","19","218","521","0","41.84","23.03"
"67","000","00","017","1709","0000","352","230","122","18","370","745","0","49.66","30.87"
"67","000","00","017","1709","0194","177","113","64","14","191","356","0","53.65","31.74"
"67","000","00","017","1709","0195","175","117","58","4","179","389","0","46.02","30.08"
"67","000","00","017","1711","0000","374","185","189","25","399","737","0","54.14","25.1"
"67","000","00","017","1711","0203","374","185","189","25","399","737","0","54.14","25.1"
"67","000","00","017","1713","0000","389","202","187","16","405","885","0","45.76","22.82"
"67","000","00","017","1713","0190","226","129","97","9","235","484","0","48.55","26.65"
"67","000","00","017","1713","0191","163","73","90","7","170","401","0","42.39","18.2"
"67","000","00","017","1714","0000","590","308","282","29","619","1484","0","41.71","20.75"
"67","000","00","017","1714","0198","241","115","126","10","251","594","0","42.26","19.36"
"67","000","00","017","1714","0199","236","120","116","17","253","572","0","44.23","20.98"
"67","000","00","017","1714","0200","113","73","40","2","115","318","0","36.16","22.96"
"67","000","00","017","1715","0000","504","307","197","14","518","1268","0","40.85","24.21"
"67","000","00","017","1715","0206","257","164","93","7","264","632","0","41.77","25.95"
"67","000","00","017","1715","0207","247","143","104","7","254","636","0","39.94","22.48"
"67","000","00","018","0000","0000","18977","9846","9131","1190","20167","37296","43516","54.07","26.4"
"67","000","00","018","1801","0000","1772","894","878","126","1898","3165","0","59.97","28.25"
"67","000","00","018","1801","0581","430","197","233","24","454","746","0","60.86","26.41"
"67","000","00","018","1801","0582","622","332","290","33","655","1102","0","59.44","30.13"
"67","000","00","018","1801","0583","204","110","94","18","222","370","0","60.0","29.73"
"67","000","00","018","1801","0584","516","255","261","51","567","947","0","59.87","26.93"
"67","000","00","018","1802","0000","2025","1043","982","144","2169","3951","0","54.9","26.4"
"67","000","00","018","1802","0585","570","282","288","41","611","1154","0","52.95","24.44"
"67","000","00","018","1802","0586","551","301","250","56","607","1082","0","56.1","27.82"
"67","000","00","018","1802","0587","574","276","298","37","611","1075","0","56.84","25.67"
"67","000","00","018","1802","0588","330","184","146","10","340","640","0","53.13","28.75"
"67","000","00","018","1803","0000","1333","658","675","74","1407","2757","0","51.03","23.87"
"67","000","00","018","1803","0589","207","111","96","14","221","410","0","53.9","27.07"
"67","000","00","018","1803","0590","254","119","135","28","282","533","0","52.91","22.33"
"67","000","00","018","1803","0591","462","234","228","17","479","836","0","57.3","27.99"
"67","000","00","018","1803","0592","410","194","216","15","425","978","0","43.46","19.84"
"67","000","00","018","1804","0000","2236","1203","1033","113","2349","4380","0","53.63","27.47"
"67","000","00","018","1804","0593","728","438","290","27","755","1348","0","56.01","32.49"
"67","000","00","018","1804","0594","508","230","278","32","540","1015","0","53.2","22.66"
"67","000","00","018","1804","0595","563","293","270","34","597","1228","0","48.62","23.86"
"67","000","00","018","1804","0596","437","242","195","20","457","789","0","57.92","30.67"
"67","000","00","018","1809","0000","1709","847","862","91","1800","3272","0","55.01","25.89"
"67","000","00","018","1809","0597","519","259","260","29","548","1022","0","53.62","25.34"
"67","000","00","018","1809","0598","521","254","267","16","537","1021","0","52.6","24.88"
"67","000","00","018","1809","0599","669","334","335","46","715","1229","0","58.18","27.18"
"67","000","00","018","1810","0000","1031","547","484","37","1068","2165","0","49.33","25.27"
"67","000","00","018","1810","0600","583","280","303","21","604","1153","0","52.39","24.28"
"67","000","00","018","1810","0601","448","267","181","16","464","1012","0","45.85","26.38"
"67","000","00","018","1811","0000","768","397","371","43","811","1458","0","55.62","27.23"
"67","000","00","018","1811","0602","768","397","371","43","811","1458","0","55.62","27.23"
"67","000","00","018","1812","0000","1718","853","865","97","1815","3220","0","56.37","26.49"
"67","000","00","018","1812","0603","870","414","456","55","925","1645","0","56.23","25.17"
"67","000","00","018","1812","0604","560","285","275","33","593","1016","0","58.37","28.05"
"67","000","00","018","1812","0605","288","154","134","9","297","559","0","53.13","27.55"
"67","000","00","018","1813","0000","1443","717","726","59","1502","2784","0","53.95","25.75"
"67","000","00","018","1813","0606","659","320","339","22","681","1222","0","55.73","26.19"
"67","000","00","018","1813","0607","784","397","387","37","821","1562","0","52.56","25.42"
"67","000","00","018","1814","0000","970","529","441","72","1042","2007","0","51.92","26.36"
"67","000","00","018","1814","0608","456","252","204","22","478","994","0","48.09","25.35"
"67","000","00","018","1814","0609","514","277","237","50","564","1013","0","55.68","27.34"
"67","000","00","018","1815","0000","1103","602","501","99","1202","2218","0","54.19","27.14"
"67","000","00","018","1815","0610","633","345","288","48","681","1197","0","56.89","28.82"
"67","000","00","018","1815","0611","470","257","213","51","521","1021","0","51.03","25.17"
"67","000","00","018","1816","0000","608","328","280","47","655","1428","0","45.87","22.97"
"67","000","00","018","1816","0612","608","328","280","47","655","1428","0","45.87","22.97"
"67","000","00","018","1817","0000","208","127","81","13","221","456","0","48.46","27.85"
"67","000","00","018","1817","0613","208","127","81","13","221","456","0","48.46","27.85"
"67","000","00","018","1818","0000","1116","569","547","90","1206","2134","0","56.51","26.66"
"67","000","00","018","1818","0614","547","276","271","43","590","1037","0","56.89","26.62"
"67","000","00","018","1818","0615","569","293","276","47","616","1097","0","56.15","26.71"
"67","000","00","018","1819","0000","462","236","226","40","502","902","0","55.65","26.16"
"67","000","00","018","1819","0616","462","236","226","40","502","902","0","55.65","26.16"
"67","000","00","018","1820","0000","475","296","179","45","520","999","0","52.05","29.63"
"67","000","00","018","1820","0617","475","296","179","45","520","999","0","52.05","29.63"
"67","000","00","019","0000","0000","19644","10715","8929","1170","20814","39950","48870","52.1","26.82"
"67","000","00","019","1901","0000","501","252","249","32","533","1132","0","47.08","22.26"
"67","000","00","019","1901","0492","501","252","249","32","533","1132","0","47.08","22.26"
"67","000","00","019","1902","0000","1871","889","982","137","2008","3935","0","51.03","22.59"
"67","000","00","019","1902","0493","865","398","467","88","953","1845","0","51.65","21.57"
"67","000","00","019","1902","0494","1006","491","515","49","1055","2090","0","50.48","23.49"
"67","000","00","019","1903","0000","2759","1464","1295","149","2908","5301","0","54.86","27.62"
"67","000","00","019","1903","0495","827","430","397","53","880","1582","0","55.63","27.18"
"67","000","00","019","1903","0496","1018","541","477","41","1059","1901","0","55.71","28.46"
"67","000","00","019","1903","0497","914","493","421","55","969","1818","0","53.3","27.12"
"67","000","00","019","1904","0000","1382","721","661","68","1450","2700","0","53.7","26.7"
"67","000","00","019","1904","0498","814","417","397","43","857","1639","0","52.29","25.44"
"67","000","00","019","1904","0499","568","304","264","25","593","1061","0","55.89","28.65"
"67","000","00","019","1905","0000","948","510","438","60","1008","1786","0","56.44","28.56"
"67","000","00","019","1905","0500","948","510","438","60","1008","1786","0","56.44","28.56"
"67","000","00","019","1908","0000","742","390","352","50","792","1581","0","50.09","24.67"
"67","000","00","019","1908","0502","742","390","352","50","792","1581","0","50.09","24.67"
"67","000","00","019","1909","0000","605","393","212","64","669","1240","0","53.95","31.69"
"67","000","00","019","1909","0503","605","393","212","64","669","1240","0","53.95","31.69"
"67","000","00","019","1910","0000","721","427","294","27","748","1743","0","42.91","24.5"
"67","000","00","019","1910","0504","721","427","294","27","748","1743","0","42.91","24.5"
"67","000","00","019","1911","0000","667","366","301","52","719","1246","0","57.7","29.37"
"67","000","00","019","1911","0505","667","366","301","52","719","1246","0","57.7","29.37"
"67","000","00","019","1912","0000","903","491","412","41","944","1899","0","49.71","25.86"
"67","000","00","019","1912","0506","462","251","211","30","492","961","0","51.2","26.12"
"67","000","00","019","1912","0507","441","240","201","11","452","938","0","48.19","25.59"
"67","000","00","019","1913","0000","390","243","147","12","402","722","0","55.68","33.66"
"67","000","00","019","1913","0508","390","243","147","12","402","722","0","55.68","33.66"
"67","000","00","019","1914","0000","522","315","207","11","533","1062","0","50.19","29.66"
"67","000","00","019","1914","0509","522","315","207","11","533","1062","0","50.19","29.66"
"67","000","00","019","1915","0000","822","480","342","66","888","1715","0","51.78","27.99"
"67","000","00","019","1915","0510","822","480","342","66","888","1715","0","51.78","27.99"
"67","000","00","019","1918","0000","782","455","327","45","827","1574","0","52.54","28.91"
"67","000","00","019","1918","0513","782","455","327","45","827","1574","0","52.54","28.91"
"67","000","00","019","1919","0000","665","376","289","39","704","1535","0","45.86","24.5"
"67","000","00","019","1919","0514","665","376","289","39","704","1535","0","45.86","24.5"
"67","000","00","019","1920","0000","536","328","208","55","591","1106","0","53.44","29.66"
"67","000","00","019","1920","0515","536","328","208","55","591","1106","0","53.44","29.66"
"67","000","00","019","1921","0000","2097","1093","1004","132","2229","4240","0","52.57","25.78"
"67","000","00","019","1921","0516","669","380","289","41","710","1402","0","50.64","27.1"
"67","000","00","019","1921","0517","805","393","412","71","876","1458","0","60.08","26.95"
"67","000","00","019","1921","0518","623","320","303","20","643","1380","0","46.59","23.19"
"67","000","00","019","1922","0000","616","332","284","29","645","1147","0","56.23","28.95"
"67","000","00","019","1922","0501","616","332","284","29","645","1147","0","56.23","28.95"
"67","000","00","019","1923","0000","913","543","370","77","990","1985","0","49.87","27.36"
"67","000","00","019","1923","0511","515","312","203","39","554","1120","0","49.46","27.86"
"67","000","00","019","1923","0512","398","231","167","38","436","865","0","50.4","26.71"
"67","000","00","019","1924","0000","1202","647","555","24","1226","2301","0","53.28","28.12"
"67","000","00","019","1924","0519","632","330","302","11","643","1232","0","52.19","26.79"
"67","000","00","019","1924","0520","570","317","253","13","583","1069","0","54.54","29.65"
"67","000","00","020","0000","0000","15733","8670","7063","757","16490","30386","36824","54.27","28.53"
"67","000","00","020","2001","0000","1507","793","714","53","1560","2928","0","53.28","27.08"
"67","000","00","020","2001","0545","465","249","216","17","482","960","0","50.21","25.94"
"67","000","00","020","2001","0546","638","346","292","20","658","1118","0","58.86","30.95"
"67","000","00","020","2001","0547","404","198","206","16","420","850","0","49.41","23.29"
"67","000","00","020","2002","0000","3184","1640","1544","159","3343","6063","0","55.14","27.05"
"67","000","00","020","2002","0548","627","323","304","38","665","1241","0","53.59","26.03"
"67","000","00","020","2002","0549","687","379","308","25","712","1297","0","54.9","29.22"
"67","000","00","020","2002","0550","524","233","291","22","546","962","0","56.76","24.22"
"67","000","00","020","2002","0551","668","333","335","35","703","1237","0","56.83","26.92"
"67","000","00","020","2002","0552","678","372","306","39","717","1326","0","54.07","28.05"
"67","000","00","020","2003","0000","1312","964","348","58","1370","2516","0","54.45","38.31"
"67","000","00","020","2003","0553","663","578","85","35","698","1211","0","57.64","47.73"
"67","000","00","020","2003","0554","649","386","263","23","672","1305","0","51.49","29.58"
"67","000","00","020","2004","0000","351","180","171","27","378","688","0","54.94","26.16"
"67","000","00","020","2004","0555","351","180","171","27","378","688","0","54.94","26.16"
"67","000","00","020","2005","0000","493","261","232","25","518","911","0","56.86","28.65"
"67","000","00","020","2005","0556","493","261","232","25","518","911","0","56.86","28.65"
"67","000","00","020","2006","0000","723","410","313","26","749","1525","0","49.11","26.89"
"67","000","00","020","2006","0557","723","410","313","26","749","1525","0","49.11","26.89"
"67","000","00","020","2007","0000","1518","779","739","42","1560","3262","0","47.82","23.88"
"67","000","00","020","2007","0558","452","218","234","5","457","1091","0","41.89","19.98"
"67","000","00","020","2007","0559","554","301","253","17","571","1122","0","50.89","26.83"
"67","000","00","020","2007","0560","512","260","252","20","532","1049","0","50.71","24.79"
"67","000","00","020","2008","0000","2241","1225","1016","75","2316","4457","0","51.96","27.48"
"67","000","00","020","2008","0561","727","433","294","19","746","1564","0","47.7","27.69"
"67","000","00","020","2008","0562","783","404","379","36","819","1515","0","54.06","26.67"
"67","000","00","020","2008","0563","731","388","343","20","751","1378","0","54.5","28.16"
"67","000","00","020","2009","0000","1039","592","447","89","1128","1787","0","63.12","33.13"
"67","000","00","020","2009","0564","473","267","206","42","515","827","0","62.27","32.29"
"67","000","00","020","2009","0565","566","325","241","47","613","960","0","63.85","33.85"
"67","000","00","020","2010","0000","1720","942","778","106","1826","3388","0","53.9","27.8"
"67","000","00","020","2010","0566","459","240","219","42","501","951","0","52.68","25.24"
"67","000","00","020","2010","0567","654","359","295","42","696","1264","0","55.06","28.4"
"67","000","00","020","2010","0568","607","343","264","22","629","1173","0","53.62","29.24"
"67","000","00","020","2011","0000","1645","884","761","97","1742","2861","0","60.89","30.9"
"67","000","00","020","2011","0569","376","199","177","21","397","684","0","58.04","29.09"
"67","000","00","020","2011","0570","598","326","272","50","648","1055","0","61.42","30.9"
"67","000","00","020","2011","0571","671","359","312","26","697","1122","0","62.12","32.0"
"67","000","00","021","0000","0000","13295","7400","5895","908","14203","26104","30522","54.41","28.35"
"67","000","00","021","2101","0000","1203","679","524","85","1288","2150","0","59.91","31.58"
"67","000","00","021","2101","0521","734","401","333","50","784","1251","0","62.67","32.05"
"67","000","00","021","2101","0522","469","278","191","35","504","899","0","56.06","30.92"
"67","000","00","021","2102","0000","1066","579","487","78","1144","2054","0","55.7","28.19"
"67","000","00","021","2102","0523","572","320","252","36","608","1106","0","54.97","28.93"
"67","000","00","021","2102","0524","494","259","235","42","536","948","0","56.54","27.32"
"67","000","00","021","2103","0000","660","347","313","47","707","1442","0","49.03","24.06"
"67","000","00","021","2103","0525","660","347","313","47","707","1442","0","49.03","24.06"
"67","000","00","021","2104","0000","1094","578","516","70","1164","2186","0","53.25","26.44"
"67","000","00","021","2104","0526","665","374","291","38","703","1385","0","50.76","27.0"
"67","000","00","021","2104","0527","429","204","225","32","461","801","0","57.55","25.47"
"67","000","00","021","2106","0000","707","395","312","54","761","1517","0","50.16","26.04"
"67","000","00","021","2106","0528","335","204","131","18","353","736","0","47.96","27.72"
"67","000","00","021","2106","0529","372","191","181","36","408","781","0","52.24","24.46"
"67","000","00","021","2107","0000","880","500","380","70","950","1657","0","57.33","30.18"
"67","000","00","021","2107","0530","411","232","179","27","438","795","0","55.09","29.18"
"67","000","00","021","2107","0531","469","268","201","43","512","862","0","59.4","31.09"
"67","000","00","021","2108","0000","1419","737","682","45","1464","2872","0","50.97","25.66"
"67","000","00","021","2108","0532","719","376","343","20","739","1487","0","49.7","25.29"
"67","000","00","021","2108","0533","700","361","339","25","725","1385","0","52.35","26.06"
"67","000","00","021","2109","0000","1308","724","584","74","1382","2612","0","52.91","27.72"
"67","000","00","021","2109","0534","706","415","291","33","739","1518","0","48.68","27.34"
"67","000","00","021","2109","0535","602","309","293","41","643","1094","0","58.78","28.24"
"67","000","00","021","2112","0000","381","197","184","33","414","716","0","57.82","27.51"
"67","000","00","021","2112","0538","381","197","184","33","414","716","0","57.82","27.51"
"67","000","00","021","2113","0000","1241","710","531","92","1333","2435","0","54.74","29.16"
"67","000","00","021","2113","0539","767","419","348","46","813","1492","0","54.49","28.08"
"67","000","00","021","2113","0540","474","291","183","46","520","943","0","55.14","30.86"
"67","000","00","021","2114","0000","1313","837","476","93","1406","2541","0","55.33","32.94"
"67","000","00","021","2114","0541","605","439","166","28","633","1157","0","54.71","37.94"
"67","000","00","021","2114","0542","708","398","310","65","773","1384","0","55.85","28.76"
"67","000","00","021","2117","0000","835","461","374","46","881","1578","0","55.83","29.21"
"67","000","00","021","2117","0543","506","308","198","27","533","967","0","55.12","31.85"
"67","000","00","021","2117","0544","329","153","176","19","348","611","0","56.96","25.04"
"67","000","00","021","2118","0000","1188","656","532","121","1309","2344","0","55.84","27.99"
"67","000","00","021","2118","0536","791","460","331","87","878","1590","0","55.22","28.93"
"67","000","00","021","2118","0537","397","196","201","34","431","754","0","57.16","25.99"
"67","000","00","022","0000","0000","2758","1588","1170","192","2950","6511","7328","45.31","24.39"
"67","000","00","022","2201","0000","650","393","257","60","710","1691","0","41.99","23.24"
"67","000","00","022","2201","0572","330","189","141","36","366","855","0","42.81","22.11"
"67","000","00","022","2201","0573","320","204","116","24","344","836","0","41.15","24.4"
"67","000","00","022","2202","0000","704","423","281","53","757","1541","0","49.12","27.45"
"67","000","00","022","2202","0574","340","202","138","38","378","753","0","50.2","26.83"
"67","000","00","022","2202","0575","364","221","143","15","379","788","0","48.1","28.05"
"67","000","00","022","2203","0000","469","253","216","31","500","984","0","50.81","25.71"
"67","000","00","022","2203","0576","469","253","216","31","500","984","0","50.81","25.71"
"67","000","00","022","2204","0000","431","255","176","16","447","972","0","45.99","26.23"
"67","000","00","022","2204","0577","431","255","176","16","447","972","0","45.99","26.23"
"67","000","00","022","2205","0000","177","93","84","3","180","553","0","32.55","16.82"
"67","000","00","022","2205","0578","177","93","84","3","180","553","0","32.55","16.82"
"67","000","00","022","2206","0000","159","79","80","8","167","378","0","44.18","20.9"
"67","000","00","022","2206","0579","159","79","80","8","167","378","0","44.18","20.9"
"67","000","00","022","2207","0000","168","92","76","21","189","392","0","48.21","23.47"
"67","000","00","022","2207","0580","168","92","76","21","189","392","0","48.21","23.47"
"67","000","00","023","0000","0000","5740","2695","3045","380","6120","12357","14021","49.53","21.81"
"67","000","00","023","2301","0000","596","268","328","22","618","1242","0","49.76","21.58"
"67","000","00","023","2301","0466","596","268","328","22","618","1242","0","49.76","21.58"
"67","000","00","023","2302","0000","1792","783","1009","96","1888","3637","0","51.91","21.53"
"67","000","00","023","2302","0467","567","234","333","30","597","1141","0","52.32","20.51"
"67","000","00","023","2302","0468","328","167","161","20","348","698","0","49.86","23.93"
"67","000","00","023","2302","0469","410","188","222","17","427","849","0","50.29","22.14"
"67","000","00","023","2302","0470","487","194","293","29","516","949","0","54.37","20.44"
"67","000","00","023","2303","0000","563","262","301","35","598","1212","0","49.34","21.62"
"67","000","00","023","2303","0471","299","137","162","23","322","618","0","52.1","22.17"
"67","000","00","023","2303","0472","264","125","139","12","276","594","0","46.46","21.04"
"67","000","00","023","2304","0000","635","327","308","46","681","1439","0","47.32","22.72"
"67","000","00","023","2304","0473","387","205","182","14","401","927","0","43.26","22.11"
"67","000","00","023","2304","0474","248","122","126","32","280","512","0","54.69","23.83"
"67","000","00","023","2305","0000","227","97","130","18","245","509","0","48.13","19.06"
"67","000","00","023","2305","0475","227","97","130","18","245","509","0","48.13","19.06"
"67","000","00","023","2306","0000","247","124","123","25","272","496","0","54.84","25.0"
"67","000","00","023","2306","0476","247","124","123","25","272","496","0","54.84","25.0"
"67","000","00","023","2307","0000","353","165","188","13","366","759","0","48.22","21.74"
"67","000","00","023","2307","0477","353","165","188","13","366","759","0","48.22","21.74"
"67","000","00","023","2308","0000","594","321","273","53","647","1456","0","44.44","22.05"
"67","000","00","023","2308","0478","256","128","128","8","264","669","0","39.46","19.13"
"67","000","00","023","2308","0479","338","193","145","45","383","787","0","48.67","24.52"
"67","000","00","023","2309","0000","265","148","117","36","301","620","0","48.55","23.87"
"67","000","00","023","2309","0480","265","148","117","36","301","620","0","48.55","23.87"
"67","000","00","023","2310","0000","468","200","268","36","504","987","0","51.06","20.26"
"67","000","00","023","2310","0481","468","200","268","36","504","987","0","51.06","20.26"
"67","000","00","024","0000","0000","3679","1650","2029","239","3918","8528","9572","45.94","19.35"
"67","000","00","024","2401","0000","901","374","527","55","956","1848","0","51.73","20.24"
"67","000","00","024","2401","0447","449","187","262","28","477","978","0","48.77","19.12"
"67","000","00","024","2401","0448","452","187","265","27","479","870","0","55.06","21.49"
"67","000","00","024","2402","0000","403","186","217","8","411","1160","0","35.43","16.03"
"67","000","00","024","2402","0449","403","186","217","8","411","1160","0","35.43","16.03"
"67","000","00","024","2403","0000","278","130","148","23","301","699","0","43.06","18.6"
"67","000","00","024","2403","0450","278","130","148","23","301","699","0","43.06","18.6"
"67","000","00","024","2404","0000","377","168","209","16","393","990","0","39.7","16.97"
"67","000","00","024","2404","0451","377","168","209","16","393","990","0","39.7","16.97"
"67","000","00","024","2405","0000","400","191","209","22","422","928","0","45.47","20.58"
"67","000","00","024","2405","0452","400","191","209","22","422","928","0","45.47","20.58"
"67","000","00","024","2406","0000","289","146","143","42","331","660","0","50.15","22.12"
"67","000","00","024","2406","0453","289","146","143","42","331","660","0","50.15","22.12"
"67","000","00","024","2407","0000","1031","455","576","73","1104","2243","0","49.22","20.29"
"67","000","00","024","2407","0454","546","253","293","45","591","1187","0","49.79","21.31"
"67","000","00","024","2407","0455","485","202","283","28","513","1056","0","48.58","19.13"
"67","000","00","025","0000","0000","3501","1690","1811","233","3734","7786","8741","47.96","21.71"
"67","000","00","025","2501","0000","724","362","362","44","768","1385","0","55.45","26.14"
"67","000","00","025","2501","0456","359","190","169","19","378","690","0","54.78","27.54"
"67","000","00","025","2501","0457","365","172","193","25","390","695","0","56.12","24.75"
"67","000","00","025","2502","0000","328","165","163","39","367","806","0","45.53","20.47"
"67","000","00","025","2502","0458","328","165","163","39","367","806","0","45.53","20.47"
"67","000","00","025","2503","0000","194","100","94","13","207","425","0","48.71","23.53"
"67","000","00","025","2503","0461","194","100","94","13","207","425","0","48.71","23.53"
"67","000","00","025","2504","0000","261","138","123","18","279","559","0","49.91","24.69"
"67","000","00","025","2504","0462","261","138","123","18","279","559","0","49.91","24.69"
"67","000","00","025","2505","0000","245","118","127","27","272","654","0","41.59","18.04"
"67","000","00","025","2505","0459","245","118","127","27","272","654","0","41.59","18.04"
"67","000","00","025","2506","0000","266","142","124","21","287","783","0","36.65","18.14"
"67","000","00","025","2506","0460","266","142","124","21","287","783","0","36.65","18.14"
"67","000","00","025","2507","0000","505","241","264","18","523","1189","0","43.99","20.27"
"67","000","00","025","2507","0463","505","241","264","18","523","1189","0","43.99","20.27"
"67","000","00","025","2508","0000","517","224","293","25","542","1044","0","51.92","21.46"
"67","000","00","025","2508","0464","517","224","293","25","542","1044","0","51.92","21.46"
"67","000","00","025","2509","0000","461","200","261","28","489","941","0","51.97","21.25"
"67","000","00","025","2509","0465","461","200","261","28","489","941","0","51.97","21.25"
"67","000","00","026","0000","0000","1871","1051","820","163","2034","4418","4801","46.04","23.79"
"67","000","00","026","2601","0000","179","92","87","14","193","392","0","49.23","23.47"
"67","000","00","026","2601","0482","179","92","87","14","193","392","0","49.23","23.47"
"67","000","00","026","2602","0000","311","173","138","28","339","644","0","52.64","26.86"
"67","000","00","026","2602","0483","311","173","138","28","339","644","0","52.64","26.86"
"67","000","00","026","2603","0000","185","115","70","9","194","468","0","41.45","24.57"
"67","000","00","026","2603","0484","185","115","70","9","194","468","0","41.45","24.57"
"67","000","00","026","2604","0000","298","152","146","31","329","753","0","43.69","20.19"
"67","000","00","026","2604","0485","298","152","146","31","329","753","0","43.69","20.19"
"67","000","00","026","2605","0000","143","70","73","17","160","345","0","46.38","20.29"
"67","000","00","026","2605","0486","143","70","73","17","160","345","0","46.38","20.29"
"67","000","00","026","2606","0000","160","75","85","16","176","393","0","44.78","19.08"
"67","000","00","026","2606","0487","160","75","85","16","176","393","0","44.78","19.08"
"67","000","00","026","2607","0000","203","149","54","28","231","504","0","45.83","29.56"
"67","000","00","026","2607","0491","203","149","54","28","231","504","0","45.83","29.56"
"67","000","00","026","2608","0000","198","115","83","11","209","420","0","49.76","27.38"
"67","000","00","026","2608","0488","198","115","83","11","209","420","0","49.76","27.38"
"67","000","00","026","2609","0000","121","60","61","7","128","313","0","40.89","19.17"
"67","000","00","026","2609","0489","121","60","61","7","128","313","0","40.89","19.17"
"67","000","00","026","2610","0000","73","50","23","2","75","186","0","40.32","26.88"
"67","000","00","026","2610","0490","73","50","23","2","75","186","0","40.32","26.88"
"67","000","00","027","0000","0000","33291","16551","16740","1640","34931","64632","75797","54.05","25.61"
"67","000","00","027","2701","0000","2822","1562","1260","191","3013","5381","0","55.99","29.03"
"67","000","00","027","2701","1188","697","427","270","44","741","1318","0","56.22","32.4"
"67","000","00","027","2701","1189","720","332","388","52","772","1406","0","54.91","23.61"
"67","000","00","027","2701","1190","724","418","306","50","774","1465","0","52.83","28.53"
"67","000","00","027","2701","1191","681","385","296","45","726","1192","0","60.91","32.3"
"67","000","00","027","2702","0000","1461","811","650","97","1558","2749","0","56.68","29.5"
"67","000","00","027","2702","1192","793","417","376","41","834","1429","0","58.36","29.18"
"67","000","00","027","2702","1193","668","394","274","56","724","1320","0","54.85","29.85"
"67","000","00","027","2703","0000","1537","785","752","81","1618","2703","0","59.86","29.04"
"67","000","00","027","2703","1194","789","412","377","47","836","1373","0","60.89","30.01"
"67","000","00","027","2703","1195","748","373","375","34","782","1330","0","58.8","28.05"
"67","000","00","027","2704","0000","3674","1795","1879","168","3842","7201","0","53.35","24.93"
"67","000","00","027","2704","1196","923","444","479","30","953","1687","0","56.49","26.32"
"67","000","00","027","2704","1197","705","359","346","60","765","1491","0","51.31","24.08"
"67","000","00","027","2704","1198","519","287","232","28","547","1151","0","47.52","24.93"
"67","000","00","027","2704","1199","717","297","420","18","735","1407","0","52.24","21.11"
"67","000","00","027","2704","1200","810","408","402","32","842","1465","0","57.47","27.85"
"67","000","00","027","2705","0000","4792","2303","2489","244","5036","9066","0","55.55","25.4"
"67","000","00","027","2705","1201","732","344","388","31","763","1335","0","57.15","25.77"
"67","000","00","027","2705","1202","752","361","391","39","791","1490","0","53.09","24.23"
"67","000","00","027","2705","1203","811","379","432","44","855","1453","0","58.84","26.08"
"67","000","00","027","2705","1204","502","207","295","14","516","990","0","52.12","20.91"
"67","000","00","027","2705","1205","839","384","455","53","892","1573","0","56.71","24.41"
"67","000","00","027","2705","1206","535","295","240","35","570","1031","0","55.29","28.61"
"67","000","00","027","2705","1207","621","333","288","28","649","1194","0","54.36","27.89"
"67","000","00","027","2706","0000","1694","876","818","71","1765","3342","0","52.81","26.21"
"67","000","00","027","2706","1208","638","339","299","25","663","1268","0","52.29","26.74"
"67","000","00","027","2706","1209","508","275","233","31","539","929","0","58.02","29.6"
"67","000","00","027","2706","1210","548","262","286","15","563","1145","0","49.17","22.88"
"67","000","00","027","2707","0000","4694","2394","2300","212","4906","9116","0","53.82","26.26"
"67","000","00","027","2707","1211","718","391","327","34","752","1413","0","53.22","27.67"
"67","000","00","027","2707","1212","737","369","368","50","787","1465","0","53.72","25.19"
"67","000","00","027","2707","1213","780","425","355","26","806","1390","0","57.99","30.58"
"67","000","00","027","2707","1214","746","405","341","37","783","1396","0","56.09","29.01"
"67","000","00","027","2707","1215","970","473","497","32","1002","1906","0","52.57","24.82"
"67","000","00","027","2707","1216","743","331","412","33","776","1546","0","50.19","21.41"
"67","000","00","027","2708","0000","2915","1501","1414","141","3056","5833","0","52.39","25.73"
"67","000","00","027","2708","1217","683","378","305","25","708","1546","0","45.8","24.45"
"67","000","00","027","2708","1218","730","360","370","34","764","1399","0","54.61","25.73"
"67","000","00","027","2708","1219","880","465","415","50","930","1748","0","53.2","26.6"
"67","000","00","027","2708","1220","622","298","324","32","654","1140","0","57.37","26.14"
"67","000","00","027","2711","0000","1340","704","636","38","1378","2763","0","49.87","25.48"
"67","000","00","027","2711","1223","704","368","336","21","725","1414","0","51.27","26.03"
"67","000","00","027","2711","1224","636","336","300","17","653","1349","0","48.41","24.91"
"67","000","00","027","2712","0000","2320","975","1345","98","2418","4659","0","51.9","20.93"
"67","000","00","027","2712","1225","725","312","413","25","750","1471","0","50.99","21.21"
"67","000","00","027","2712","1226","682","294","388","24","706","1324","0","53.32","22.21"
"67","000","00","027","2712","1227","623","227","396","28","651","1310","0","49.69","17.33"
"67","000","00","027","2712","1228","290","142","148","21","311","554","0","56.14","25.63"
"67","000","00","027","2713","0000","711","182","529","42","753","1395","0","53.98","13.05"
"67","000","00","027","2713","1229","711","182","529","42","753","1395","0","53.98","13.05"
"67","000","00","027","2714","0000","651","270","381","11","662","1264","0","52.37","21.36"
"67","000","00","027","2714","1230","651","270","381","11","662","1264","0","52.37","21.36"
"67","000","00","027","2715","0000","1045","551","494","77","1122","2108","0","53.23","26.14"
"67","000","00","027","2715","1231","596","306","290","60","656","1180","0","55.59","25.93"
"67","000","00","027","2715","1232","449","245","204","17","466","928","0","50.22","26.4"
"67","000","00","027","2716","0000","996","561","435","51","1047","2084","0","50.24","26.92"
"67","000","00","027","2716","1233","451","259","192","25","476","965","0","49.33","26.84"
"67","000","00","027","2716","1234","545","302","243","26","571","1119","0","51.03","26.99"
"67","000","00","027","2717","0000","1342","730","612","70","1412","2672","0","52.84","27.32"
"67","000","00","027","2717","1235","615","323","292","39","654","1206","0","54.23","26.78"
"67","000","00","027","2717","1236","727","407","320","31","758","1466","0","51.71","27.76"
"67","000","00","027","2719","0000","1297","551","746","48","1345","2296","0","58.58","24.0"
"67","000","00","027","2719","1221","665","334","331","23","688","1277","0","53.88","26.16"
"67","000","00","027","2719","1222","632","217","415","25","657","1019","0","64.47","21.3"
"67","000","00","028","0000","0000","29625","15705","13920","1309","30934","57387","68391","53.9","27.37"
"67","000","00","028","2801","0000","3066","1577","1489","149","3215","5916","0","54.34","26.66"
"67","000","00","028","2801","1237","768","385","383","48","816","1560","0","52.31","24.68"
"67","000","00","028","2801","1238","805","397","408","33","838","1383","0","60.59","28.71"
"67","000","00","028","2801","1239","773","405","368","27","800","1491","0","53.66","27.16"
"67","000","00","028","2801","1240","720","390","330","41","761","1482","0","51.35","26.32"
"67","000","00","028","2802","0000","1751","977","774","81","1832","3756","0","48.78","26.01"
"67","000","00","028","2802","1244","579","316","263","23","602","1336","0","45.06","23.65"
"67","000","00","028","2802","1245","556","314","242","38","594","1183","0","50.21","26.54"
"67","000","00","028","2802","1246","616","347","269","20","636","1237","0","51.41","28.05"
"67","000","00","028","2803","0000","1221","610","611","49","1270","2293","0","55.39","26.6"
"67","000","00","028","2803","1271","683","358","325","30","713","1245","0","57.27","28.76"
"67","000","00","028","2803","1272","538","252","286","19","557","1048","0","53.15","24.05"
"67","000","00","028","2804","0000","1754","914","840","90","1844","3286","0","56.12","27.81"
"67","000","00","028","2804","1249","584","295","289","12","596","1105","0","53.94","26.7"
"67","000","00","028","2804","1250","585","304","281","25","610","1099","0","55.51","27.66"
"67","000","00","028","2804","1251","585","315","270","53","638","1082","0","58.96","29.11"
"67","000","00","028","2805","0000","1663","834","829","69","1732","3301","0","52.47","25.27"
"67","000","00","028","2805","1254","555","263","292","27","582","1090","0","53.39","24.13"
"67","000","00","028","2805","1255","572","299","273","11","583","1131","0","51.55","26.44"
"67","000","00","028","2805","1256","536","272","264","31","567","1080","0","52.5","25.19"
"67","000","00","028","2806","0000","1711","924","787","83","1794","3285","0","54.61","28.13"
"67","000","00","028","2806","1259","572","308","264","47","619","1128","0","54.88","27.3"
"67","000","00","028","2806","1260","557","318","239","18","575","1055","0","54.5","30.14"
"67","000","00","028","2806","1261","582","298","284","18","600","1102","0","54.45","27.04"
"67","000","00","028","2807","0000","1151","653","498","48","1199","2101","0","57.07","31.08"
"67","000","00","028","2807","1262","584","335","249","16","600","1068","0","56.18","31.37"
"67","000","00","028","2807","1263","567","318","249","32","599","1033","0","57.99","30.78"
"67","000","00","028","2808","0000","723","368","355","28","751","1772","0","42.38","20.77"
"67","000","00","028","2808","1264","723","368","355","28","751","1772","0","42.38","20.77"
"67","000","00","028","2809","0000","1563","818","745","64","1627","2943","0","55.28","27.79"
"67","000","00","028","2809","1265","747","411","336","32","779","1399","0","55.68","29.38"
"67","000","00","028","2809","1266","816","407","409","32","848","1544","0","54.92","26.36"
"67","000","00","028","2810","0000","308","158","150","10","318","684","0","46.49","23.1"
"67","000","00","028","2810","1267","308","158","150","10","318","684","0","46.49","23.1"
"67","000","00","028","2811","0000","1047","624","423","67","1114","1853","0","60.12","33.68"
"67","000","00","028","2811","1268","481","278","203","26","507","839","0","60.43","33.13"
"67","000","00","028","2811","1269","566","346","220","41","607","1014","0","59.86","34.12"
"67","000","00","028","2812","0000","693","370","323","24","717","1906","0","37.62","19.41"
"67","000","00","028","2812","1270","693","370","323","24","717","1906","0","37.62","19.41"
"67","000","00","028","2813","0000","1312","710","602","40","1352","2586","0","52.28","27.46"
"67","000","00","028","2813","1273","613","334","279","21","634","1175","0","53.96","28.43"
"67","000","00","028","2813","1274","699","376","323","19","718","1411","0","50.89","26.65"
"67","000","00","028","2814","0000","1707","897","810","66","1773","3192","0","55.55","28.1"
"67","000","00","028","2814","1275","833","422","411","31","864","1514","0","57.07","27.87"
"67","000","00","028","2814","1276","874","475","399","35","909","1678","0","54.17","28.31"
"67","000","00","028","2815","0000","1118","646","472","44","1162","1958","0","59.35","32.99"
"67","000","00","028","2815","1277","528","306","222","15","543","949","0","57.22","32.24"
"67","000","00","028","2815","1278","590","340","250","29","619","1009","0","61.35","33.7"
"67","000","00","028","2816","0000","1032","575","457","35","1067","1740","0","61.32","33.05"
"67","000","00","028","2816","1279","608","340","268","5","613","984","0","62.3","34.55"
"67","000","00","028","2816","1280","424","235","189","30","454","756","0","60.05","31.08"
"67","000","00","028","2817","0000","1677","849","828","77","1754","2945","0","59.56","28.83"
"67","000","00","028","2817","1281","839","408","431","45","884","1478","0","59.81","27.6"
"67","000","00","028","2817","1282","838","441","397","32","870","1467","0","59.3","30.06"
"67","000","00","028","2818","0000","2162","1123","1039","79","2241","4145","0","54.07","27.09"
"67","000","00","028","2818","1241","711","357","354","24","735","1330","0","55.26","26.84"
"67","000","00","028","2818","1242","764","415","349","28","792","1399","0","56.61","29.66"
"67","000","00","028","2818","1243","687","351","336","27","714","1416","0","50.42","24.79"
"67","000","00","028","2819","0000","1219","659","560","58","1277","2457","0","51.97","26.82"
"67","000","00","028","2819","1257","535","306","229","17","552","1121","0","49.24","27.3"
"67","000","00","028","2819","1258","684","353","331","41","725","1336","0","54.27","26.42"
"67","000","00","028","2820","0000","1157","631","526","77","1234","2282","0","54.08","27.65"
"67","000","00","028","2820","1247","590","327","263","46","636","1133","0","56.13","28.86"
"67","000","00","028","2820","1248","567","304","263","31","598","1149","0","52.05","26.46"
"67","000","00","028","2821","0000","1590","788","802","71","1661","2986","0","55.63","26.39"
"67","000","00","028","2821","1252","787","380","407","30","817","1519","0","53.79","25.02"
"67","000","00","028","2821","1253","803","408","395","41","844","1467","0","57.53","27.81"
"67","000","00","029","0000","0000","15488","8288","7200","781","16269","29913","34387","54.39","27.71"
"67","000","00","029","2901","0000","1201","633","568","50","1251","2138","0","58.51","29.61"
"67","000","00","029","2901","1283","530","273","257","24","554","982","0","56.42","27.8"
"67","000","00","029","2901","1284","671","360","311","26","697","1156","0","60.29","31.14"
"67","000","00","029","2902","0000","1085","592","493","63","1148","2049","0","56.03","28.89"
"67","000","00","029","2902","1285","482","259","223","24","506","1006","0","50.3","25.75"
"67","000","00","029","2902","1286","603","333","270","39","642","1043","0","61.55","31.93"
"67","000","00","029","2903","0000","1643","867","776","91","1734","3319","0","52.24","26.12"
"67","000","00","029","2903","1287","540","293","247","45","585","1012","0","57.81","28.95"
"67","000","00","029","2903","1288","484","253","231","8","492","1013","0","48.57","24.98"
"67","000","00","029","2903","1289","619","321","298","38","657","1294","0","50.77","24.81"
"67","000","00","029","2904","0000","1223","656","567","58","1281","2430","0","52.72","27.0"
"67","000","00","029","2904","1290","633","337","296","26","659","1264","0","52.14","26.66"
"67","000","00","029","2904","1291","590","319","271","32","622","1166","0","53.34","27.36"
"67","000","00","029","2905","0000","496","278","218","20","516","1018","0","50.69","27.31"
"67","000","00","029","2905","1292","496","278","218","20","516","1018","0","50.69","27.31"
"67","000","00","029","2906","0000","323","179","144","23","346","733","0","47.2","24.42"
"67","000","00","029","2906","1293","323","179","144","23","346","733","0","47.2","24.42"
"67","000","00","029","2907","0000","1750","857","893","75","1825","3152","0","57.9","27.19"
"67","000","00","029","2907","1294","626","291","335","26","652","1093","0","59.65","26.62"
"67","000","00","029","2907","1295","580","294","286","16","596","1081","0","55.13","27.2"
"67","000","00","029","2907","1296","544","272","272","33","577","978","0","59.0","27.81"
"67","000","00","029","2908","0000","1590","811","779","83","1673","3133","0","53.4","25.89"
"67","000","00","029","2908","1297","531","275","256","16","547","1116","0","49.01","24.64"
"67","000","00","029","2908","1298","488","210","278","34","522","972","0","53.7","21.6"
"67","000","00","029","2908","1299","571","326","245","33","604","1045","0","57.8","31.2"
"67","000","00","029","2909","0000","1034","570","464","47","1081","1879","0","57.53","30.34"
"67","000","00","029","2909","1300","459","239","220","25","484","872","0","55.5","27.41"
"67","000","00","029","2909","1301","575","331","244","22","597","1007","0","59.29","32.87"
"67","000","00","029","2912","0000","798","438","360","49","847","1524","0","55.58","28.74"
"67","000","00","029","2912","1306","437","243","194","33","470","804","0","58.46","30.22"
"67","000","00","029","2912","1307","361","195","166","16","377","720","0","52.36","27.08"
"67","000","00","029","2913","0000","558","292","266","21","579","1201","0","48.21","24.31"
"67","000","00","029","2913","1308","384","194","190","13","397","843","0","47.09","23.01"
"67","000","00","029","2913","1309","174","98","76","8","182","358","0","50.84","27.37"
"67","000","00","029","2916","0000","929","536","393","30","959","1867","0","51.37","28.71"
"67","000","00","029","2916","1312","412","236","176","15","427","904","0","47.23","26.11"
"67","000","00","029","2916","1313","517","300","217","15","532","963","0","55.24","31.15"
"67","000","00","029","2917","0000","281","166","115","8","289","489","0","59.1","33.95"
"67","000","00","029","2917","1314","281","166","115","8","289","489","0","59.1","33.95"
"67","000","00","029","2918","0000","1849","1017","832","118","1967","3475","0","56.6","29.27"
"67","000","00","029","2918","1302","428","233","195","35","463","763","0","60.68","30.54"
"67","000","00","029","2918","1303","315","170","145","19","334","630","0","53.02","26.98"
"67","000","00","029","2918","1304","536","321","215","33","569","959","0","59.33","33.47"
"67","000","00","029","2918","1305","570","293","277","31","601","1123","0","53.52","26.09"
"67","000","00","029","2919","0000","728","396","332","45","773","1506","0","51.33","26.29"
"67","000","00","029","2919","1310","405","235","170","30","435","797","0","54.58","29.49"
"67","000","00","029","2919","1311","323","161","162","15","338","709","0","47.67","22.71"
"67","000","00","030","0000","0000","1753","899","854","118","1871","3713","3999","50.39","24.21"
"67","000","00","030","3001","0000","522","282","240","40","562","1047","0","53.68","26.93"
"67","000","00","030","3001","1315","522","282","240","40","562","1047","0","53.68","26.93"
"67","000","00","030","3002","0000","305","165","140","16","321","630","0","50.95","26.19"
"67","000","00","030","3002","1316","305","165","140","16","321","630","0","50.95","26.19"
"67","000","00","030","3003","0000","57","31","26","3","60","141","0","42.55","21.99"
"67","000","00","030","3003","1317","57","31","26","3","60","141","0","42.55","21.99"
"67","000","00","030","3004","0000","175","91","84","8","183","367","0","49.86","24.8"
"67","000","00","030","3004","1318","175","91","84","8","183","367","0","49.86","24.8"
"67","000","00","030","3005","0000","168","77","91","13","181","337","0","53.71","22.85"
"67","000","00","030","3005","1319","168","77","91","13","181","337","0","53.71","22.85"
"67","000","00","030","3006","0000","140","75","65","10","150","318","0","47.17","23.58"
"67","000","00","030","3006","1320","140","75","65","10","150","318","0","47.17","23.58"
"67","000","00","030","3007","0000","198","84","114","18","216","427","0","50.59","19.67"
"67","000","00","030","3007","1321","198","84","114","18","216","427","0","50.59","19.67"
"67","000","00","030","3008","0000","188","94","94","10","198","446","0","44.39","21.08"
"67","000","00","030","3008","1322","188","94","94","10","198","446","0","44.39","21.08"
"67","000","00","031","0000","0000","98486","48369","50117","3912","102398","195001","234921","52.51","24.8"
"67","000","00","031","3101","0000","2749","1318","1431","112","2861","5671","0","50.45","23.24"
"67","000","00","031","3101","0708","727","363","364","43","770","1398","0","55.08","25.97"
"67","000","00","031","3101","0709","666","335","331","26","692","1478","0","46.82","22.67"
"67","000","00","031","3101","0710","708","337","371","20","728","1442","0","50.49","23.37"
"67","000","00","031","3101","0711","648","283","365","23","671","1353","0","49.59","20.92"
"67","000","00","031","3102","0000","3272","1573","1699","124","3396","6821","0","49.79","23.06"
"67","000","00","031","3102","0719","798","412","386","39","837","1709","0","48.98","24.11"
"67","000","00","031","3102","0720","806","370","436","32","838","1717","0","48.81","21.55"
"67","000","00","031","3102","0721","821","408","413","27","848","1759","0","48.21","23.19"
"67","000","00","031","3102","0722","847","383","464","26","873","1636","0","53.36","23.41"
"67","000","00","031","3103","0000","3979","2038","1941","166","4145","8791","0","47.15","23.18"
"67","000","00","031","3103","0728","745","402","343","31","776","1389","0","55.87","28.94"
"67","000","00","031","3103","0729","712","381","331","27","739","1369","0","53.98","27.83"
"67","000","00","031","3103","0730","727","371","356","57","784","1415","0","55.41","26.22"
"67","000","00","031","3103","0731","617","273","344","15","632","1386","0","45.6","19.7"
"67","000","00","031","3103","0732","434","215","219","9","443","1747","0","25.36","12.31"
"67","000","00","031","3103","0733","744","396","348","27","771","1485","0","51.92","26.67"
"67","000","00","031","3104","0000","3325","1612","1713","148","3473","7088","0","49.0","22.74"
"67","000","00","031","3104","0734","841","410","431","54","895","1747","0","51.23","23.47"
"67","000","00","031","3104","0735","777","382","395","22","799","1744","0","45.81","21.9"
"67","000","00","031","3104","0736","838","432","406","29","867","1797","0","48.25","24.04"
"67","000","00","031","3104","0737","869","388","481","43","912","1800","0","50.67","21.56"
"67","000","00","031","3105","0000","3056","1505","1551","100","3156","5710","0","55.27","26.36"
"67","000","00","031","3105","0745","795","386","409","34","829","1531","0","54.15","25.21"
"67","000","00","031","3105","0746","751","398","353","24","775","1327","0","58.4","29.99"
"67","000","00","031","3105","0747","763","362","401","7","770","1456","0","52.88","24.86"
"67","000","00","031","3105","0748","747","359","388","35","782","1396","0","56.02","25.72"
"67","000","00","031","3106","0000","1369","748","621","51","1420","2525","0","56.24","29.62"
"67","000","00","031","3106","0785","711","413","298","36","747","1285","0","58.13","32.14"
"67","000","00","031","3106","0786","658","335","323","15","673","1240","0","54.27","27.02"
"67","000","00","031","3107","0000","1393","697","696","54","1447","2670","0","54.19","26.1"
"67","000","00","031","3107","0787","646","331","315","35","681","1343","0","50.71","24.65"
"67","000","00","031","3107","0788","747","366","381","19","766","1327","0","57.72","27.58"
"67","000","00","031","3108","0000","1012","539","473","27","1039","1862","0","55.8","28.95"
"67","000","00","031","3108","0758","479","261","218","16","495","924","0","53.57","28.25"
"67","000","00","031","3108","0759","533","278","255","11","544","938","0","58.0","29.64"
"67","000","00","031","3109","0000","781","411","370","48","829","1453","0","57.05","28.29"
"67","000","00","031","3109","0760","521","254","267","25","546","957","0","57.05","26.54"
"67","000","00","031","3109","0761","260","157","103","23","283","496","0","57.06","31.65"
"67","000","00","031","3110","0000","2452","1292","1160","69","2521","4886","0","51.6","26.44"
"67","000","00","031","3110","0762","890","475","415","25","915","1717","0","53.29","27.66"
"67","000","00","031","3110","0763","779","410","369","23","802","1615","0","49.66","25.39"
"67","000","00","031","3110","0764","783","407","376","21","804","1554","0","51.74","26.19"
"67","000","00","031","3111","0000","1277","680","597","74","1351","2276","0","59.36","29.88"
"67","000","00","031","3111","0772","483","224","259","35","518","890","0","58.2","25.17"
"67","000","00","031","3111","0773","590","348","242","28","618","1018","0","60.71","34.18"
"67","000","00","031","3111","0774","204","108","96","11","215","368","0","58.42","29.35"
"67","000","00","031","3112","0000","1754","929","825","84","1838","3366","0","54.6","27.6"
"67","000","00","031","3112","0795","560","311","249","40","600","1117","0","53.72","27.84"
"67","000","00","031","3112","0796","516","268","248","24","540","1069","0","50.51","25.07"
"67","000","00","031","3112","0797","678","350","328","20","698","1180","0","59.15","29.66"
"67","000","00","031","3113","0000","1869","1028","841","110","1979","3542","0","55.87","29.02"
"67","000","00","031","3113","0798","598","344","254","51","649","1176","0","55.19","29.25"
"67","000","00","031","3113","0799","585","308","277","25","610","1158","0","52.68","26.6"
"67","000","00","031","3113","0800","686","376","310","34","720","1208","0","59.6","31.13"
"67","000","00","031","3114","0000","3906","1988","1918","174","4080","7237","0","56.38","27.47"
"67","000","00","031","3114","0801","776","440","336","45","821","1501","0","54.7","29.31"
"67","000","00","031","3114","0802","725","364","361","29","754","1298","0","58.09","28.04"
"67","000","00","031","3114","0803","787","393","394","28","815","1542","0","52.85","25.49"
"67","000","00","031","3114","0804","834","410","424","30","864","1537","0","56.21","26.68"
"67","000","00","031","3114","0805","784","381","403","42","826","1359","0","60.78","28.04"
"67","000","00","031","3115","0000","1844","1010","834","81","1925","3835","0","50.2","26.34"
"67","000","00","031","3115","0806","542","300","242","18","560","1139","0","49.17","26.34"
"67","000","00","031","3115","0807","556","307","249","22","578","1158","0","49.91","26.51"
"67","000","00","031","3115","0808","746","403","343","41","787","1538","0","51.17","26.2"
"67","000","00","031","3116","0000","3114","1684","1430","104","3218","5872","0","54.8","28.68"
"67","000","00","031","3116","0809","582","288","294","17","599","1166","0","51.37","24.7"
"67","000","00","031","3116","0810","656","385","271","12","668","1228","0","54.4","31.35"
"67","000","00","031","3116","0811","648","371","277","37","685","1200","0","57.08","30.92"
"67","000","00","031","3116","0812","620","323","297","21","641","1131","0","56.68","28.56"
"67","000","00","031","3116","0813","608","317","291","17","625","1147","0","54.49","27.64"
"67","000","00","031","3117","0000","1958","1039","919","76","2034","4027","0","50.51","25.8"
"67","000","00","031","3117","0814","705","384","321","29","734","1442","0","50.9","26.63"
"67","000","00","031","3117","0815","666","350","316","21","687","1325","0","51.85","26.42"
"67","000","00","031","3117","0816","587","305","282","26","613","1260","0","48.65","24.21"
"67","000","00","031","3118","0000","1131","625","506","101","1232","2099","0","58.69","29.78"
"67","000","00","031","3118","0793","524","288","236","51","575","983","0","58.49","29.3"
"67","000","00","031","3118","0794","607","337","270","50","657","1116","0","58.87","30.2"
"67","000","00","031","3119","0000","885","322","563","60","945","1988","0","47.54","16.2"
"67","000","00","031","3119","0820","462","163","299","37","499","1012","0","49.31","16.11"
"67","000","00","031","3119","0821","423","159","264","23","446","976","0","45.7","16.29"
"67","000","00","031","3120","0000","4107","1786","2321","170","4277","8430","0","50.74","21.19"
"67","000","00","031","3120","0825","668","259","409","36","704","1307","0","53.86","19.82"
"67","000","00","031","3120","0826","687","304","383","25","712","1482","0","48.04","20.51"
"67","000","00","031","3120","0827","608","267","341","24","632","1341","0","47.13","19.91"
"67","000","00","031","3120","0828","675","306","369","28","703","1376","0","51.09","22.24"
"67","000","00","031","3120","0829","663","305","358","29","692","1390","0","49.78","21.94"
"67","000","00","031","3120","0830","806","345","461","28","834","1534","0","54.37","22.49"
"67","000","00","031","3121","0000","906","388","518","62","968","1796","0","53.9","21.6"
"67","000","00","031","3121","0823","457","187","270","36","493","859","0","57.39","21.77"
"67","000","00","031","3121","0824","449","201","248","26","475","937","0","50.69","21.45"
"67","000","00","031","3122","0000","561","230","331","35","596","1151","0","51.78","19.98"
"67","000","00","031","3122","0838","561","230","331","35","596","1151","0","51.78","19.98"
"67","000","00","031","3123","0000","3153","1588","1565","130","3283","5980","0","54.9","26.56"
"67","000","00","031","3123","0789","795","385","410","24","819","1565","0","52.33","24.6"
"67","000","00","031","3123","0790","780","422","358","52","832","1476","0","56.37","28.59"
"67","000","00","031","3123","0791","758","377","381","26","784","1476","0","53.12","25.54"
"67","000","00","031","3123","0792","820","404","416","28","848","1463","0","57.96","27.61"
"67","000","00","031","3124","0000","1133","425","708","60","1193","2097","0","56.89","20.27"
"67","000","00","031","3124","0839","621","216","405","40","661","1026","0","64.42","21.05"
"67","000","00","031","3124","0840","512","209","303","20","532","1071","0","49.67","19.51"
"67","000","00","031","3125","0000","1679","758","921","75","1754","3387","0","51.79","22.38"
"67","000","00","031","3125","0843","869","379","490","38","907","1687","0","53.76","22.47"
"67","000","00","031","3125","0844","810","379","431","37","847","1700","0","49.82","22.29"
"67","000","00","031","3126","0000","3768","1742","2026","151","3919","7729","0","50.71","22.54"
"67","000","00","031","3126","0845","786","388","398","26","812","1444","0","56.23","26.87"
"67","000","00","031","3126","0846","731","349","382","29","760","1485","0","51.18","23.5"
"67","000","00","031","3126","0847","809","365","444","29","838","1717","0","48.81","21.26"
"67","000","00","031","3126","0848","765","356","409","43","808","1701","0","47.5","20.93"
"67","000","00","031","3126","0849","677","284","393","24","701","1382","0","50.72","20.55"
"67","000","00","031","3127","0000","2915","1592","1323","141","3056","6072","0","50.33","26.22"
"67","000","00","031","3127","0778","706","382","324","35","741","1405","0","52.74","27.19"
"67","000","00","031","3127","0779","687","375","312","46","733","1445","0","50.73","25.95"
"67","000","00","031","3127","0780","819","423","396","31","850","1687","0","50.39","25.07"
"67","000","00","031","3127","0781","703","412","291","29","732","1535","0","47.69","26.84"
"67","000","00","031","3128","0000","274","93","181","15","289","531","0","54.43","17.51"
"67","000","00","031","3128","0822","274","93","181","15","289","531","0","54.43","17.51"
"67","000","00","031","3129","0000","2939","1563","1376","85","3024","5725","0","52.82","27.3"
"67","000","00","031","3129","0768","764","396","368","16","780","1457","0","53.53","27.18"
"67","000","00","031","3129","0769","764","382","382","18","782","1451","0","53.89","26.33"
"67","000","00","031","3129","0770","672","387","285","25","697","1423","0","48.98","27.2"
"67","000","00","031","3129","0771","739","398","341","26","765","1394","0","54.88","28.55"
"67","000","00","031","3130","0000","3808","1689","2119","130","3938","7784","0","50.59","21.7"
"67","000","00","031","3130","0723","726","339","387","45","771","1442","0","53.47","23.51"
"67","000","00","031","3130","0724","761","300","461","21","782","1545","0","50.61","19.42"
"67","000","00","031","3130","0725","764","334","430","36","800","1565","0","51.12","21.34"
"67","000","00","031","3130","0726","806","363","443","13","819","1684","0","48.63","21.56"
"67","000","00","031","3130","0727","751","353","398","15","766","1548","0","49.48","22.8"
"67","000","00","031","3131","0000","2803","1299","1504","107","2910","5428","0","53.61","23.93"
"67","000","00","031","3131","0715","642","298","344","20","662","1317","0","50.27","22.63"
"67","000","00","031","3131","0716","690","345","345","23","713","1376","0","51.82","25.07"
"67","000","00","031","3131","0717","706","326","380","27","733","1361","0","53.86","23.95"
"67","000","00","031","3131","0718","765","330","435","37","802","1374","0","58.37","24.02"
"67","000","00","031","3132","0000","1763","882","881","65","1828","3447","0","53.03","25.59"
"67","000","00","031","3132","0712","579","297","282","25","604","1160","0","52.07","25.6"
"67","000","00","031","3132","0713","606","289","317","24","630","1122","0","56.15","25.76"
"67","000","00","031","3132","0714","578","296","282","16","594","1165","0","50.99","25.41"
"67","000","00","031","3133","0000","2952","1498","1454","98","3050","5917","0","51.55","25.32"
"67","000","00","031","3133","0749","819","398","421","29","848","1636","0","51.83","24.33"
"67","000","00","031","3133","0750","824","434","390","35","859","1592","0","53.96","27.26"
"67","000","00","031","3133","0751","938","460","478","21","959","2017","0","47.55","22.81"
"67","000","00","031","3133","0752","371","206","165","13","384","672","0","57.14","30.65"
"67","000","00","031","3134","0000","2169","1070","1099","60","2229","4811","0","46.33","22.24"
"67","000","00","031","3134","0755","729","360","369","17","746","1660","0","44.94","21.69"
"67","000","00","031","3134","0756","674","329","345","24","698","1561","0","44.71","21.08"
"67","000","00","031","3134","0757","766","381","385","19","785","1590","0","49.37","23.96"
"67","000","00","031","3135","0000","1528","782","746","55","1583","3113","0","50.85","25.12"
"67","000","00","031","3135","0753","759","388","371","25","784","1611","0","48.67","24.08"
"67","000","00","031","3135","0754","769","394","375","30","799","1502","0","53.2","26.23"
"67","000","00","031","3136","0000","1974","964","1010","72","2046","3776","0","54.18","25.53"
"67","000","00","031","3136","0775","696","373","323","27","723","1208","0","59.85","30.88"
"67","000","00","031","3136","0776","594","352","242","24","618","1187","0","52.06","29.65"
"67","000","00","031","3136","0777","684","239","445","21","705","1381","0","51.05","17.31"
"67","000","00","031","3137","0000","4855","2130","2725","169","5024","9284","0","54.11","22.94"
"67","000","00","031","3137","0831","768","359","409","34","802","1460","0","54.93","24.59"
"67","000","00","031","3137","0832","697","320","377","12","709","1383","0","51.27","23.14"
"67","000","00","031","3137","0833","674","282","392","27","701","1299","0","53.96","21.71"
"67","000","00","031","3137","0834","674","317","357","27","701","1264","0","55.46","25.08"
"67","000","00","031","3137","0835","746","323","423","27","773","1355","0","57.05","23.84"
"67","000","00","031","3137","0836","686","303","383","22","708","1414","0","50.07","21.43"
"67","000","00","031","3137","0837","610","226","384","20","630","1109","0","56.81","20.38"
"67","000","00","031","3138","0000","4156","2069","2087","163","4319","7603","0","56.81","27.21"
"67","000","00","031","3138","0740","845","415","430","24","869","1519","0","57.21","27.32"
"67","000","00","031","3138","0741","795","424","371","49","844","1497","0","56.38","28.32"
"67","000","00","031","3138","0742","810","387","423","23","833","1509","0","55.2","25.65"
"67","000","00","031","3138","0743","878","482","396","43","921","1542","0","59.73","31.26"
"67","000","00","031","3138","0744","828","361","467","24","852","1536","0","55.47","23.5"
"67","000","00","031","3139","0000","1633","773","860","56","1689","2764","0","61.11","27.97"
"67","000","00","031","3139","0841","843","383","460","29","872","1387","0","62.87","27.61"
"67","000","00","031","3139","0842","790","390","400","27","817","1377","0","59.33","28.32"
"67","000","00","031","3140","0000","2343","1154","1189","70","2413","4846","0","49.79","23.81"
"67","000","00","031","3140","0817","782","414","368","22","804","1631","0","49.29","25.38"
"67","000","00","031","3140","0818","747","356","391","28","775","1549","0","50.03","22.98"
"67","000","00","031","3140","0819","814","384","430","20","834","1666","0","50.06","23.05"
"67","000","00","031","3141","0000","1724","810","914","46","1770","3428","0","51.63","23.63"
"67","000","00","031","3141","0738","828","392","436","20","848","1720","0","49.3","22.79"
"67","000","00","031","3141","0739","896","418","478","26","922","1708","0","53.98","24.47"
"67","000","00","031","3142","0000","2338","1069","1269","76","2414","4498","0","53.67","23.77"
"67","000","00","031","3142","0782","811","376","435","28","839","1542","0","54.41","24.38"
"67","000","00","031","3142","0783","804","357","447","28","832","1618","0","51.42","22.06"
"67","000","00","031","3142","0784","723","336","387","20","743","1338","0","55.53","25.11"
"67","000","00","031","3143","0000","1879","977","902","58","1937","3685","0","52.56","26.51"
"67","000","00","031","3143","0765","602","334","268","18","620","1196","0","51.84","27.93"
"67","000","00","031","3143","0766","642","314","328","21","663","1274","0","52.04","24.65"
"67","000","00","031","3143","0767","635","329","306","19","654","1215","0","53.83","27.08"
"67","000","00","032","0000","0000","81247","39193","42054","3036","84283","153359","186117","54.96","25.56"
"67","000","00","032","3201","0000","1102","581","521","33","1135","2191","0","51.8","26.52"
"67","000","00","032","3201","1170","1102","581","521","33","1135","2191","0","51.8","26.52"
"67","000","00","032","3202","0000","1555","757","798","88","1643","2944","0","55.81","25.71"
"67","000","00","032","3202","1166","668","332","336","48","716","1287","0","55.63","25.8"
"67","000","00","032","3202","1167","887","425","462","40","927","1657","0","55.94","25.65"
"67","000","00","032","3203","0000","3364","1402","1962","136","3500","6583","0","53.17","21.3"
"67","000","00","032","3203","1113","1011","482","529","61","1072","2067","0","51.86","23.32"
"67","000","00","032","3203","1114","1143","445","698","31","1174","2153","0","54.53","20.67"
"67","000","00","032","3203","1115","1210","475","735","44","1254","2363","0","53.07","20.1"
"67","000","00","032","3204","0000","1613","866","747","82","1695","2869","0","59.08","30.18"
"67","000","00","032","3204","1097","889","494","395","51","940","1491","0","63.04","33.13"
"67","000","00","032","3204","1098","724","372","352","31","755","1378","0","54.79","27.0"
"67","000","00","032","3205","0000","2426","1241","1185","108","2534","4730","0","53.57","26.24"
"67","000","00","032","3205","1180","786","417","369","31","817","1486","0","54.98","28.06"
"67","000","00","032","3205","1181","848","426","422","30","878","1560","0","56.28","27.31"
"67","000","00","032","3205","1182","792","398","394","47","839","1684","0","49.82","23.63"
"67","000","00","032","3206","0000","2059","977","1082","76","2135","4455","0","47.92","21.93"
"67","000","00","032","3206","1118","936","422","514","32","968","2115","0","45.77","19.95"
"67","000","00","032","3206","1119","1123","555","568","44","1167","2340","0","49.87","23.72"
"67","000","00","032","3207","0000","1557","775","782","80","1637","2932","0","55.83","26.43"
"67","000","00","032","3207","1139","804","408","396","35","839","1489","0","56.35","27.4"
"67","000","00","032","3207","1140","753","367","386","45","798","1443","0","55.3","25.43"
"67","000","00","032","3208","0000","2744","1288","1456","64","2808","4858","0","57.8","26.51"
"67","000","00","032","3208","1141","882","448","434","27","909","1498","0","60.68","29.91"
"67","000","00","032","3208","1142","907","424","483","15","922","1622","0","56.84","26.14"
"67","000","00","032","3208","1143","955","416","539","22","977","1738","0","56.21","23.94"
"67","000","00","032","3209","0000","1354","676","678","54","1408","2433","0","57.87","27.78"
"67","000","00","032","3209","1161","614","302","312","13","627","1101","0","56.95","27.43"
"67","000","00","032","3209","1162","740","374","366","41","781","1332","0","58.63","28.08"
"67","000","00","032","3210","0000","1673","809","864","57","1730","3086","0","56.06","26.22"
"67","000","00","032","3210","1158","838","397","441","30","868","1589","0","54.63","24.98"
"67","000","00","032","3210","1159","835","412","423","27","862","1497","0","57.58","27.52"
"67","000","00","032","3211","0000","692","383","309","40","732","1386","0","52.81","27.63"
"67","000","00","032","3211","1160","692","383","309","40","732","1386","0","52.81","27.63"
"67","000","00","032","3212","0000","2235","995","1240","77","2312","4048","0","57.11","24.58"
"67","000","00","032","3212","1173","1044","441","603","52","1096","1863","0","58.83","23.67"
"67","000","00","032","3212","1174","1191","554","637","25","1216","2185","0","55.65","25.35"
"67","000","00","032","3213","0000","2647","1293","1354","100","2747","5122","0","53.63","25.24"
"67","000","00","032","3213","1129","853","449","404","40","893","1708","0","52.28","26.29"
"67","000","00","032","3213","1130","836","372","464","26","862","1560","0","55.26","23.85"
"67","000","00","032","3213","1131","958","472","486","34","992","1854","0","53.51","25.46"
"67","000","00","032","3214","0000","2503","1299","1204","62","2565","4865","0","52.72","26.7"
"67","000","00","032","3214","1120","1284","624","660","36","1320","2474","0","53.35","25.22"
"67","000","00","032","3214","1121","1219","675","544","26","1245","2391","0","52.07","28.23"
"67","000","00","032","3215","0000","889","374","515","32","921","1602","0","57.49","23.35"
"67","000","00","032","3215","1177","889","374","515","32","921","1602","0","57.49","23.35"
"67","000","00","032","3216","0000","825","401","424","47","872","1556","0","56.04","25.77"
"67","000","00","032","3216","1176","825","401","424","47","872","1556","0","56.04","25.77"
"67","000","00","032","3217","0000","2289","982","1307","89","2378","4335","0","54.86","22.65"
"67","000","00","032","3217","1133","1060","479","581","38","1098","2093","0","52.46","22.89"
"67","000","00","032","3217","1134","1229","503","726","51","1280","2242","0","57.09","22.44"
"67","000","00","032","3218","0000","763","371","392","32","795","1517","0","52.41","24.46"
"67","000","00","032","3218","1165","763","371","392","32","795","1517","0","52.41","24.46"
"67","000","00","032","3219","0000","2703","1386","1317","98","2801","4992","0","56.11","27.76"
"67","000","00","032","3219","1102","924","440","484","24","948","1639","0","57.84","26.85"
"67","000","00","032","3219","1103","907","426","481","33","940","1724","0","54.52","24.71"
"67","000","00","032","3219","1104","872","520","352","41","913","1629","0","56.05","31.92"
"67","000","00","032","3220","0000","2331","1093","1238","105","2436","4484","0","54.33","24.38"
"67","000","00","032","3220","1168","1167","500","667","69","1236","2238","0","55.23","22.34"
"67","000","00","032","3220","1169","1164","593","571","36","1200","2246","0","53.43","26.4"
"67","000","00","032","3221","0000","1035","544","491","44","1079","1986","0","54.33","27.39"
"67","000","00","032","3221","1156","584","316","268","10","594","1090","0","54.5","28.99"
"67","000","00","032","3221","1157","451","228","223","34","485","896","0","54.13","25.45"
"67","000","00","032","3222","0000","2289","1047","1242","97","2386","4242","0","56.25","24.68"
"67","000","00","032","3222","1148","798","357","441","34","832","1427","0","58.3","25.02"
"67","000","00","032","3222","1149","739","361","378","33","772","1427","0","54.1","25.3"
"67","000","00","032","3222","1150","752","329","423","30","782","1388","0","56.34","23.7"
"67","000","00","032","3223","0000","685","340","345","16","701","1131","0","61.98","30.06"
"67","000","00","032","3223","1151","685","340","345","16","701","1131","0","61.98","30.06"
"67","000","00","032","3224","0000","2537","1294","1243","58","2595","4615","0","56.23","28.04"
"67","000","00","032","3224","1183","899","460","439","22","921","1653","0","55.72","27.83"
"67","000","00","032","3224","1184","849","457","392","17","866","1554","0","55.73","29.41"
"67","000","00","032","3224","1185","789","377","412","19","808","1408","0","57.39","26.78"
"67","000","00","032","3225","0000","2666","1279","1387","91","2757","4874","0","56.57","26.24"
"67","000","00","032","3225","1122","928","424","504","30","958","1673","0","57.26","25.34"
"67","000","00","032","3225","1123","852","446","406","25","877","1594","0","55.02","27.98"
"67","000","00","032","3225","1124","886","409","477","36","922","1607","0","57.37","25.45"
"67","000","00","032","3226","0000","1643","854","789","59","1702","2982","0","57.08","28.64"
"67","000","00","032","3226","1116","763","402","361","31","794","1427","0","55.64","28.17"
"67","000","00","032","3226","1117","880","452","428","28","908","1555","0","58.39","29.07"
"67","000","00","032","3227","0000","1827","813","1014","67","1894","3593","0","52.71","22.63"
"67","000","00","032","3227","1146","901","405","496","27","928","1829","0","50.74","22.14"
"67","000","00","032","3227","1147","926","408","518","40","966","1764","0","54.76","23.13"
"67","000","00","032","3228","0000","820","425","395","26","846","1721","0","49.16","24.69"
"67","000","00","032","3228","1175","820","425","395","26","846","1721","0","49.16","24.69"
"67","000","00","032","3229","0000","2265","1041","1224","90","2355","4240","0","55.54","24.55"
"67","000","00","032","3229","1171","1061","486","575","32","1093","2063","0","52.98","23.56"
"67","000","00","032","3229","1172","1204","555","649","58","1262","2177","0","57.97","25.49"
"67","000","00","032","3230","0000","1360","655","705","61","1421","2447","0","58.07","26.77"
"67","000","00","032","3230","1163","644","277","367","28","672","1185","0","56.71","23.38"
"67","000","00","032","3230","1164","716","378","338","33","749","1262","0","59.35","29.95"
"67","000","00","032","3231","0000","1574","794","780","72","1646","2983","0","55.18","26.62"
"67","000","00","032","3231","1144","769","381","388","31","800","1501","0","53.3","25.38"
"67","000","00","032","3231","1145","805","413","392","41","846","1482","0","57.09","27.87"
"67","000","00","032","3232","0000","2484","1258","1226","97","2581","4472","0","57.71","28.13"
"67","000","00","032","3232","1099","871","422","449","30","901","1552","0","58.05","27.19"
"67","000","00","032","3232","1100","757","436","321","22","779","1326","0","58.75","32.88"
"67","000","00","032","3232","1101","856","400","456","45","901","1594","0","56.52","25.09"
"67","000","00","032","3233","0000","1197","576","621","53","1250","2296","0","54.44","25.09"
"67","000","00","032","3233","1111","568","266","302","30","598","1039","0","57.56","25.6"
"67","000","00","032","3233","1112","629","310","319","23","652","1257","0","51.87","24.66"
"67","000","00","032","3234","0000","1117","576","541","25","1142","2278","0","50.13","25.29"
"67","000","00","032","3234","1132","1117","576","541","25","1142","2278","0","50.13","25.29"
"67","000","00","032","3235","0000","1584","740","844","58","1642","2933","0","55.98","25.23"
"67","000","00","032","3235","1105","762","364","398","29","791","1399","0","56.54","26.02"
"67","000","00","032","3235","1106","822","376","446","29","851","1534","0","55.48","24.51"
"67","000","00","032","3236","0000","1003","560","443","50","1053","1882","0","55.95","29.76"
"67","000","00","032","3236","1154","486","252","234","19","505","935","0","54.01","26.95"
"67","000","00","032","3236","1155","517","308","209","31","548","947","0","57.87","32.52"
"67","000","00","032","3237","0000","1059","485","574","48","1107","1996","0","55.46","24.3"
"67","000","00","032","3237","1152","522","249","273","30","552","1000","0","55.2","24.9"
"67","000","00","032","3237","1153","537","236","301","18","555","996","0","55.72","23.69"
"67","000","00","032","3238","0000","1461","764","697","71","1532","2905","0","52.74","26.3"
"67","000","00","032","3238","1178","769","391","378","45","814","1523","0","53.45","25.67"
"67","000","00","032","3238","1179","692","373","319","26","718","1382","0","51.95","26.99"
"67","000","00","032","3239","0000","2201","1061","1140","75","2276","3980","0","57.19","26.66"
"67","000","00","032","3239","1186","1202","586","616","30","1232","2084","0","59.12","28.12"
"67","000","00","032","3239","1187","999","475","524","45","1044","1896","0","55.06","25.05"
"67","000","00","032","3240","0000","1990","1029","961","53","2043","4492","0","45.48","22.91"
"67","000","00","032","3240","1095","1050","535","515","23","1073","2681","0","40.02","19.96"
"67","000","00","032","3240","1096","940","494","446","30","970","1811","0","53.56","27.28"
"67","000","00","032","3241","0000","3109","1421","1688","110","3219","5929","0","54.29","23.97"
"67","000","00","032","3241","1107","915","415","500","21","936","1656","0","56.52","25.06"
"67","000","00","032","3241","1108","695","309","386","39","734","1322","0","55.52","23.37"
"67","000","00","032","3241","1109","714","401","313","21","735","1620","0","45.37","24.75"
"67","000","00","032","3241","1110","785","296","489","29","814","1331","0","61.16","22.24"
"67","000","00","032","3242","0000","1729","915","814","91","1820","3308","0","55.02","27.66"
"67","000","00","032","3242","1127","856","455","401","58","914","1696","0","53.89","26.83"
"67","000","00","032","3242","1128","873","460","413","33","906","1612","0","56.2","28.54"
"67","000","00","032","3243","0000","2523","1070","1453","51","2574","4456","0","57.76","24.01"
"67","000","00","032","3243","1125","1187","502","685","26","1213","2087","0","58.12","24.05"
"67","000","00","032","3243","1126","1336","568","768","25","1361","2369","0","57.45","23.98"
"67","000","00","032","3244","0000","1449","666","783","43","1492","2470","0","60.4","26.96"
"67","000","00","032","3244","1135","658","334","324","33","691","1152","0","59.98","28.99"
"67","000","00","032","3244","1136","791","332","459","10","801","1318","0","60.77","25.19"
"67","000","00","032","3245","0000","2316","1037","1279","70","2386","4160","0","57.36","24.93"
"67","000","00","032","3245","1137","1197","571","626","40","1237","2200","0","56.23","25.95"
"67","000","00","032","3245","1138","1119","466","653","30","1149","1960","0","58.62","23.78"
"67","000","00","033","0000","0000","54467","29421","25046","2497","56964","108650","124790","52.43","27.08"
"67","000","00","033","3301","0000","838","400","438","30","868","1637","0","53.02","24.43"
"67","000","00","033","3301","1024","838","400","438","30","868","1637","0","53.02","24.43"
"67","000","00","033","3303","0000","396","162","234","11","407","871","0","46.73","18.6"
"67","000","00","033","3303","1025","396","162","234","11","407","871","0","46.73","18.6"
"67","000","00","033","3304","0000","820","427","393","48","868","1390","0","62.45","30.72"
"67","000","00","033","3304","1026","317","143","174","21","338","589","0","57.39","24.28"
"67","000","00","033","3304","1027","503","284","219","27","530","801","0","66.17","35.46"
"67","000","00","033","3305","0000","1236","701","535","42","1278","2262","0","56.5","30.99"
"67","000","00","033","3305","1035","618","365","253","13","631","1127","0","55.99","32.39"
"67","000","00","033","3305","1036","618","336","282","29","647","1135","0","57.0","29.6"
"67","000","00","033","3306","0000","1170","567","603","43","1213","2277","0","53.27","24.9"
"67","000","00","033","3306","1037","652","331","321","25","677","1263","0","53.6","26.21"
"67","000","00","033","3306","1038","518","236","282","18","536","1014","0","52.86","23.27"
"67","000","00","033","3307","0000","1331","730","601","60","1391","2774","0","50.14","26.32"
"67","000","00","033","3307","1031","615","351","264","27","642","1204","0","53.32","29.15"
"67","000","00","033","3307","1032","716","379","337","33","749","1570","0","47.71","24.14"
"67","000","00","033","3308","0000","1809","954","855","115","1924","3209","0","59.96","29.73"
"67","000","00","033","3308","1028","541","290","251","38","579","990","0","58.48","29.29"
"67","000","00","033","3308","1029","718","359","359","28","746","1222","0","61.05","29.38"
"67","000","00","033","3308","1030","550","305","245","49","599","997","0","60.08","30.59"
"67","000","00","033","3309","0000","1546","851","695","92","1638","3006","0","54.49","28.31"
"67","000","00","033","3309","1047","821","454","367","34","855","1542","0","55.45","29.44"
"67","000","00","033","3309","1048","725","397","328","58","783","1464","0","53.48","27.12"
"67","000","00","033","3311","0000","2018","1166","852","101","2119","4217","0","50.25","27.65"
"67","000","00","033","3311","1052","658","398","260","40","698","1419","0","49.19","28.05"
"67","000","00","033","3311","1053","644","347","297","29","673","1333","0","50.49","26.03"
"67","000","00","033","3311","1054","716","421","295","32","748","1465","0","51.06","28.74"
"67","000","00","033","3313","0000","1823","991","832","77","1900","3607","0","52.68","27.47"
"67","000","00","033","3313","1055","586","319","267","24","610","1099","0","55.51","29.03"
"67","000","00","033","3313","1056","548","279","269","20","568","1133","0","50.13","24.62"
"67","000","00","033","3313","1057","689","393","296","33","722","1375","0","52.51","28.58"
"67","000","00","033","3314","0000","951","559","392","40","991","2064","0","48.01","27.08"
"67","000","00","033","3314","1082","951","559","392","40","991","2064","0","48.01","27.08"
"67","000","00","033","3315","0000","1126","697","429","57","1183","2173","0","54.44","32.08"
"67","000","00","033","3315","1079","622","342","280","32","654","1119","0","58.45","30.56"
"67","000","00","033","3315","1080","504","355","149","25","529","1054","0","50.19","33.68"
"67","000","00","033","3316","0000","615","402","213","36","651","1245","0","52.29","32.29"
"67","000","00","033","3316","1081","615","402","213","36","651","1245","0","52.29","32.29"
"67","000","00","033","3317","0000","1495","863","632","55","1550","3429","0","45.2","25.17"
"67","000","00","033","3317","1083","846","469","377","31","877","2056","0","42.66","22.81"
"67","000","00","033","3317","1084","649","394","255","24","673","1373","0","49.02","28.7"
"67","000","00","033","3318","0000","1130","697","433","40","1170","2109","0","55.48","33.05"
"67","000","00","033","3318","1093","558","372","186","26","584","1093","0","53.43","34.03"
"67","000","00","033","3318","1094","572","325","247","14","586","1016","0","57.68","31.99"
"67","000","00","033","3319","0000","1037","603","434","80","1117","2162","0","51.67","27.89"
"67","000","00","033","3319","1091","414","253","161","30","444","897","0","49.5","28.21"
"67","000","00","033","3319","1092","623","350","273","50","673","1265","0","53.2","27.67"
"67","000","00","033","3320","0000","1343","791","552","63","1406","2544","0","55.27","31.09"
"67","000","00","033","3320","1089","625","374","251","30","655","1186","0","55.23","31.53"
"67","000","00","033","3320","1090","718","417","301","33","751","1358","0","55.3","30.71"
"67","000","00","033","3321","0000","1262","554","708","51","1313","2272","0","57.79","24.38"
"67","000","00","033","3321","1017","642","293","349","25","667","1150","0","58.0","25.48"
"67","000","00","033","3321","1018","620","261","359","26","646","1122","0","57.58","23.26"
"67","000","00","033","3322","0000","2296","1101","1195","99","2395","4507","0","53.14","24.43"
"67","000","00","033","3322","1019","702","361","341","33","735","1444","0","50.9","25.0"
"67","000","00","033","3322","1020","863","404","459","33","896","1765","0","50.76","22.89"
"67","000","00","033","3322","1021","731","336","395","33","764","1298","0","58.86","25.89"
"67","000","00","033","3323","0000","1649","815","834","74","1723","3392","0","50.8","24.03"
"67","000","00","033","3323","1015","666","335","331","40","706","1221","0","57.82","27.44"
"67","000","00","033","3323","1016","983","480","503","34","1017","2171","0","46.84","22.11"
"67","000","00","033","3324","0000","1703","600","1103","76","1779","3398","0","52.35","17.66"
"67","000","00","033","3324","1022","771","284","487","35","806","1458","0","55.28","19.48"
"67","000","00","033","3324","1023","932","316","616","41","973","1940","0","50.15","16.29"
"67","000","00","033","3325","0000","1202","668","534","42","1244","2298","0","54.13","29.07"
"67","000","00","033","3325","1033","663","369","294","25","688","1222","0","56.3","30.2"
"67","000","00","033","3325","1034","539","299","240","17","556","1076","0","51.67","27.79"
"67","000","00","033","3326","0000","1624","935","689","70","1694","3341","0","50.7","27.99"
"67","000","00","033","3326","1061","881","504","377","49","930","1640","0","56.71","30.73"
"67","000","00","033","3326","1062","743","431","312","21","764","1701","0","44.91","25.34"
"67","000","00","033","3327","0000","1743","947","796","68","1811","3306","0","54.78","28.64"
"67","000","00","033","3327","1039","805","471","334","39","844","1491","0","56.61","31.59"
"67","000","00","033","3327","1040","938","476","462","29","967","1815","0","53.28","26.23"
"67","000","00","033","3328","0000","2526","1390","1136","126","2652","5017","0","52.86","27.71"
"67","000","00","033","3328","1044","838","447","391","45","883","1626","0","54.31","27.49"
"67","000","00","033","3328","1045","865","460","405","28","893","1761","0","50.71","26.12"
"67","000","00","033","3328","1046","823","483","340","53","876","1630","0","53.74","29.63"
"67","000","00","033","3329","0000","1147","621","526","43","1190","2734","0","43.53","22.71"
"67","000","00","033","3329","1068","591","318","273","15","606","1657","0","36.57","19.19"
"67","000","00","033","3329","1069","556","303","253","28","584","1077","0","54.22","28.13"
"67","000","00","033","3330","0000","2551","1398","1153","107","2658","5719","0","46.48","24.44"
"67","000","00","033","3330","1072","867","425","442","25","892","1985","0","44.94","21.41"
"67","000","00","033","3330","1073","877","518","359","39","916","2017","0","45.41","25.68"
"67","000","00","033","3330","1074","807","455","352","43","850","1717","0","49.5","26.5"
"67","000","00","033","3331","0000","879","481","398","50","929","1624","0","57.2","29.62"
"67","000","00","033","3331","1075","500","272","228","31","531","929","0","57.16","29.28"
"67","000","00","033","3331","1076","379","209","170","19","398","695","0","57.27","30.07"
"67","000","00","033","3332","0000","2645","1427","1218","109","2754","5094","0","54.06","28.01"
"67","000","00","033","3332","1065","1001","498","503","44","1045","1774","0","58.91","28.07"
"67","000","00","033","3332","1066","797","450","347","44","841","1613","0","52.14","27.9"
"67","000","00","033","3332","1067","847","479","368","21","868","1707","0","50.85","28.06"
"67","000","00","033","3333","0000","1679","931","748","111","1790","3568","0","50.17","26.09"
"67","000","00","033","3333","1063","720","404","316","46","766","1541","0","49.71","26.22"
"67","000","00","033","3333","1064","959","527","432","65","1024","2027","0","50.52","26.0"
"67","000","00","033","3334","0000","2388","1245","1143","75","2463","4809","0","51.22","25.89"
"67","000","00","033","3334","1058","821","428","393","18","839","1781","0","47.11","24.03"
"67","000","00","033","3334","1059","846","429","417","34","880","1542","0","57.07","27.82"
"67","000","00","033","3334","1060","721","388","333","23","744","1486","0","50.07","26.11"
"67","000","00","033","3335","0000","2529","1343","1186","88","2617","5092","0","51.39","26.37"
"67","000","00","033","3335","1041","714","406","308","21","735","1398","0","52.58","29.04"
"67","000","00","033","3335","1042","912","455","457","26","938","2107","0","44.52","21.59"
"67","000","00","033","3335","1043","903","482","421","41","944","1587","0","59.48","30.37"
"67","000","00","033","3336","0000","850","435","415","41","891","1781","0","50.03","24.42"
"67","000","00","033","3336","1077","480","251","229","14","494","997","0","49.55","25.18"
"67","000","00","033","3336","1078","370","184","186","27","397","784","0","50.64","23.47"
"67","000","00","033","3337","0000","936","588","348","75","1011","1775","0","56.96","33.13"
"67","000","00","033","3337","1087","543","370","173","47","590","1031","0","57.23","35.89"
"67","000","00","033","3337","1088","393","218","175","28","421","744","0","56.59","29.3"
"67","000","00","033","3338","0000","919","587","332","49","968","1762","0","54.94","33.31"
"67","000","00","033","3338","1085","482","310","172","17","499","1002","0","49.8","30.94"
"67","000","00","033","3338","1086","437","277","160","32","469","760","0","61.71","36.45"
"67","000","00","033","3339","0000","1255","644","611","58","1313","2434","0","53.94","26.46"
"67","000","00","033","3339","1070","611","302","309","30","641","1185","0","54.09","25.49"
"67","000","00","033","3339","1071","644","342","302","28","672","1249","0","53.8","27.38"
"67","000","00","033","3340","0000","2000","1150","850","95","2095","3751","0","55.85","30.66"
"67","000","00","033","3340","1049","869","505","364","49","918","1727","0","53.16","29.24"
"67","000","00","033","3340","1050","643","378","265","32","675","1085","0","62.21","34.84"
"67","000","00","033","3340","1051","488","267","221","14","502","939","0","53.46","28.43"
"67","000","00","034","0000","0000","58023","29375","28648","2485","60508","110906","132020","54.56","26.49"
"67","000","00","034","3401","0000","1689","837","852","93","1782","3501","0","50.9","23.91"
"67","000","00","034","3401","0850","870","418","452","40","910","1793","0","50.75","23.31"
"67","000","00","034","3401","0851","819","419","400","53","872","1708","0","51.05","24.53"
"67","000","00","034","3404","0000","1147","608","539","53","1200","2030","0","59.11","29.95"
"67","000","00","034","3404","0862","598","345","253","29","627","1076","0","58.27","32.06"
"67","000","00","034","3404","0863","549","263","286","24","573","954","0","60.06","27.57"
"67","000","00","034","3405","0000","1357","639","718","55","1412","2451","0","57.61","26.07"
"67","000","00","034","3405","0858","614","298","316","23","637","1189","0","53.57","25.06"
"67","000","00","034","3405","0859","743","341","402","32","775","1262","0","61.41","27.02"
"67","000","00","034","3407","0000","1045","527","518","28","1073","1964","0","54.63","26.83"
"67","000","00","034","3407","0867","512","249","263","10","522","974","0","53.59","25.56"
"67","000","00","034","3407","0868","533","278","255","18","551","990","0","55.66","28.08"
"67","000","00","034","3408","0000","1183","573","610","40","1223","2069","0","59.11","27.69"
"67","000","00","034","3408","0869","620","292","328","12","632","1016","0","62.2","28.74"
"67","000","00","034","3408","0870","563","281","282","28","591","1053","0","56.13","26.69"
"67","000","00","034","3418","0000","2132","1176","956","89","2221","4291","0","51.76","27.41"
"67","000","00","034","3418","0926","688","360","328","18","706","1502","0","47.0","23.97"
"67","000","00","034","3418","0927","774","410","364","29","803","1470","0","54.63","27.89"
"67","000","00","034","3418","0928","670","406","264","42","712","1319","0","53.98","30.78"
"67","000","00","034","3419","0000","1054","468","586","39","1093","1864","0","58.64","25.11"
"67","000","00","034","3419","0860","593","257","336","21","614","1017","0","60.37","25.27"
"67","000","00","034","3419","0861","461","211","250","18","479","847","0","56.55","24.91"
"67","000","00","034","3420","0000","2669","1373","1296","81","2750","4824","0","57.01","28.46"
"67","000","00","034","3420","0908","955","452","503","22","977","1709","0","57.17","26.45"
"67","000","00","034","3420","0909","880","451","429","31","911","1517","0","60.05","29.73"
"67","000","00","034","3420","0910","834","470","364","28","862","1598","0","53.94","29.41"
"67","000","00","034","3423","0000","1536","905","631","70","1606","3203","0","50.14","28.25"
"67","000","00","034","3423","0894","525","296","229","21","546","1091","0","50.05","27.13"
"67","000","00","034","3423","0895","510","300","210","15","525","993","0","52.87","30.21"
"67","000","00","034","3423","0896","501","309","192","34","535","1119","0","47.81","27.61"
"67","000","00","034","3424","0000","2343","1249","1094","100","2443","4442","0","55.0","28.12"
"67","000","00","034","3424","0897","886","483","403","51","937","1685","0","55.61","28.66"
"67","000","00","034","3424","0898","724","391","333","23","747","1368","0","54.61","28.58"
"67","000","00","034","3424","0899","733","375","358","26","759","1389","0","54.64","27.0"
"67","000","00","034","3425","0000","1684","858","826","60","1744","3296","0","52.91","26.03"
"67","000","00","034","3425","0919","868","450","418","33","901","1662","0","54.21","27.08"
"67","000","00","034","3425","0920","816","408","408","27","843","1634","0","51.59","24.97"
"67","000","00","034","3426","0000","2701","1351","1350","155","2856","5387","0","53.02","25.08"
"67","000","00","034","3426","0923","955","515","440","60","1015","1874","0","54.16","27.48"
"67","000","00","034","3426","0924","885","446","439","48","933","1760","0","53.01","25.34"
"67","000","00","034","3426","0925","861","390","471","47","908","1753","0","51.8","22.25"
"67","000","00","034","3432","0000","725","384","341","44","769","1466","0","52.46","26.19"
"67","000","00","034","3432","0871","725","384","341","44","769","1466","0","52.46","26.19"
"67","000","00","034","3433","0000","948","490","458","66","1014","1829","0","55.44","26.79"
"67","000","00","034","3433","0884","473","226","247","42","515","892","0","57.74","25.34"
"67","000","00","034","3433","0885","475","264","211","24","499","937","0","53.26","28.18"
"67","000","00","034","3438","0000","1793","894","899","63","1856","3800","0","48.84","23.53"
"67","000","00","034","3438","0852","503","248","255","11","514","997","0","51.55","24.87"
"67","000","00","034","3438","0853","622","319","303","32","654","1452","0","45.04","21.97"
"67","000","00","034","3438","0854","668","327","341","20","688","1351","0","50.93","24.2"
"67","000","00","034","3439","0000","1597","779","818","83","1680","3079","0","54.56","25.3"
"67","000","00","034","3439","0872","807","369","438","46","853","1535","0","55.57","24.04"
"67","000","00","034","3439","0873","790","410","380","37","827","1544","0","53.56","26.55"
"67","000","00","034","3440","0000","2383","1167","1216","105","2488","4317","0","57.63","27.03"
"67","000","00","034","3440","0905","736","367","369","56","792","1340","0","59.1","27.39"
"67","000","00","034","3440","0906","786","368","418","32","818","1464","0","55.87","25.14"
"67","000","00","034","3440","0907","861","432","429","17","878","1513","0","58.03","28.55"
"67","000","00","034","3441","0000","1630","878","752","64","1694","2975","0","56.94","29.51"
"67","000","00","034","3441","0915","764","429","335","26","790","1391","0","56.79","30.84"
"67","000","00","034","3441","0916","866","449","417","38","904","1584","0","57.07","28.35"
"67","000","00","034","3442","0000","1983","1061","922","88","2071","3665","0","56.51","28.95"
"67","000","00","034","3442","0921","969","536","433","52","1021","1793","0","56.94","29.89"
"67","000","00","034","3442","0922","1014","525","489","36","1050","1872","0","56.09","28.04"
"67","000","00","034","3443","0000","1917","995","922","61","1978","3596","0","55.01","27.67"
"67","000","00","034","3443","0929","1015","527","488","41","1056","1876","0","56.29","28.09"
"67","000","00","034","3443","0930","902","468","434","20","922","1720","0","53.6","27.21"
"67","000","00","034","3444","0000","2058","810","1248","119","2177","4008","0","54.32","20.21"
"67","000","00","034","3444","0864","653","296","357","46","699","1300","0","53.77","22.77"
"67","000","00","034","3444","0865","693","204","489","40","733","1390","0","52.73","14.68"
"67","000","00","034","3444","0866","712","310","402","33","745","1318","0","56.53","23.52"
"67","000","00","034","3445","0000","2046","1054","992","79","2125","3534","0","60.13","29.82"
"67","000","00","034","3445","0855","800","391","409","35","835","1323","0","63.11","29.55"
"67","000","00","034","3445","0856","601","307","294","20","621","1073","0","57.88","28.61"
"67","000","00","034","3445","0857","645","356","289","24","669","1138","0","58.79","31.28"
"67","000","00","034","3446","0000","2834","1451","1383","151","2985","5305","0","56.27","27.35"
"67","000","00","034","3446","0874","927","434","493","57","984","1760","0","55.91","24.66"
"67","000","00","034","3446","0875","698","411","287","29","727","1372","0","52.99","29.96"
"67","000","00","034","3446","0876","557","252","305","30","587","1002","0","58.58","25.15"
"67","000","00","034","3446","0877","652","354","298","35","687","1171","0","58.67","30.23"
"67","000","00","034","3447","0000","1990","1062","928","90","2080","3964","0","52.47","26.79"
"67","000","00","034","3447","0891","761","411","350","31","792","1522","0","52.04","27.0"
"67","000","00","034","3447","0892","646","322","324","23","669","1278","0","52.35","25.2"
"67","000","00","034","3447","0893","583","329","254","36","619","1164","0","53.18","28.26"
"67","000","00","034","3448","0000","2426","991","1435","139","2565","4860","0","52.78","20.39"
"67","000","00","034","3448","0878","606","209","397","26","632","1285","0","49.18","16.26"
"67","000","00","034","3448","0879","506","162","344","37","543","1036","0","52.41","15.64"
"67","000","00","034","3448","0880","706","286","420","36","742","1392","0","53.3","20.55"
"67","000","00","034","3448","0881","608","334","274","40","648","1147","0","56.5","29.12"
"67","000","00","034","3449","0000","1532","792","740","56","1588","3085","0","51.47","25.67"
"67","000","00","034","3449","0882","714","347","367","27","741","1526","0","48.56","22.74"
"67","000","00","034","3449","0883","818","445","373","29","847","1559","0","54.33","28.54"
"67","000","00","034","3450","0000","1394","745","649","48","1442","2797","0","51.56","26.64"
"67","000","00","034","3450","0889","699","400","299","31","730","1346","0","54.23","29.72"
"67","000","00","034","3450","0890","695","345","350","17","712","1451","0","49.07","23.78"
"67","000","00","034","3451","0000","1966","1108","858","106","2072","4176","0","49.62","26.53"
"67","000","00","034","3451","0886","790","444","346","53","843","1449","0","58.18","30.64"
"67","000","00","034","3451","0887","593","333","260","29","622","1160","0","53.62","28.71"
"67","000","00","034","3451","0888","583","331","252","24","607","1567","0","38.74","21.12"
"67","000","00","034","3452","0000","1746","844","902","53","1799","3124","0","57.59","27.02"
"67","000","00","034","3452","0900","829","406","423","19","848","1469","0","57.73","27.64"
"67","000","00","034","3452","0901","917","438","479","34","951","1655","0","57.46","26.47"
"67","000","00","034","3453","0000","2277","1076","1201","70","2347","4187","0","56.05","25.7"
"67","000","00","034","3453","0902","698","326","372","24","722","1261","0","57.26","25.85"
"67","000","00","034","3453","0903","768","367","401","20","788","1490","0","52.89","24.63"
"67","000","00","034","3453","0904","811","383","428","26","837","1436","0","58.29","26.67"
"67","000","00","034","3454","0000","1355","787","568","59","1414","2613","0","54.11","30.12"
"67","000","00","034","3454","0911","720","394","326","24","744","1399","0","53.18","28.16"
"67","000","00","034","3454","0912","635","393","242","35","670","1214","0","55.19","32.37"
"67","000","00","034","3455","0000","1268","643","625","36","1304","2212","0","58.95","29.07"
"67","000","00","034","3455","0913","581","277","304","16","597","1064","0","56.11","26.03"
"67","000","00","034","3455","0914","687","366","321","20","707","1148","0","61.59","31.88"
"67","000","00","034","3456","0000","1615","800","815","42","1657","2992","0","55.38","26.74"
"67","000","00","034","3456","0917","870","433","437","24","894","1595","0","56.05","27.15"
"67","000","00","034","3456","0918","745","367","378","18","763","1397","0","54.62","26.27"
"67","000","00","035","0000","0000","80435","43287","37148","3855","84290","159654","193163","52.8","27.11"
"67","000","00","035","3501","0000","1320","671","649","36","1356","2549","0","53.2","26.32"
"67","000","00","035","3501","0618","1320","671","649","36","1356","2549","0","53.2","26.32"
"67","000","00","035","3502","0000","2216","1164","1052","111","2327","4600","0","50.59","25.3"
"67","000","00","035","3502","0624","938","473","465","56","994","2143","0","46.38","22.07"
"67","000","00","035","3502","0625","1278","691","587","55","1333","2457","0","54.25","28.12"
"67","000","00","035","3503","0000","2340","1213","1127","81","2421","4477","0","54.08","27.09"
"67","000","00","035","3503","0619","1177","605","572","44","1221","2321","0","52.61","26.07"
"67","000","00","035","3503","0620","1163","608","555","37","1200","2156","0","55.66","28.2"
"67","000","00","035","3504","0000","2548","1333","1215","158","2706","4799","0","56.39","27.78"
"67","000","00","035","3504","0621","928","502","426","49","977","1662","0","58.78","30.2"
"67","000","00","035","3504","0622","841","426","415","58","899","1512","0","59.46","28.17"
"67","000","00","035","3504","0623","779","405","374","51","830","1625","0","51.08","24.92"
"67","000","00","035","3505","0000","2334","1235","1099","108","2442","4512","0","54.12","27.37"
"67","000","00","035","3505","0626","1147","634","513","59","1206","2148","0","56.15","29.52"
"67","000","00","035","3505","0627","1187","601","586","49","1236","2364","0","52.28","25.42"
"67","000","00","035","3506","0000","1533","824","709","96","1629","2805","0","58.07","29.38"
"67","000","00","035","3506","0644","823","451","372","37","860","1447","0","59.43","31.17"
"67","000","00","035","3506","0645","710","373","337","59","769","1358","0","56.63","27.47"
"67","000","00","035","3507","0000","1897","1061","836","87","1984","3494","0","56.78","30.37"
"67","000","00","035","3507","0639","920","534","386","50","970","1721","0","56.36","31.03"
"67","000","00","035","3507","0640","977","527","450","37","1014","1773","0","57.19","29.72"
"67","000","00","035","3508","0000","2102","1140","962","98","2200","4546","0","48.39","25.08"
"67","000","00","035","3508","0631","1001","573","428","51","1052","2291","0","45.92","25.01"
"67","000","00","035","3508","0632","1101","567","534","47","1148","2255","0","50.91","25.14"
"67","000","00","035","3509","0000","2995","1648","1347","108","3103","5977","0","51.92","27.57"
"67","000","00","035","3509","0633","903","519","384","40","943","1940","0","48.61","26.75"
"67","000","00","035","3509","0634","1087","606","481","27","1114","2013","0","55.34","30.1"
"67","000","00","035","3509","0635","1005","523","482","41","1046","2024","0","51.68","25.84"
"67","000","00","035","3510","0000","3068","1566","1502","122","3190","5933","0","53.77","26.39"
"67","000","00","035","3510","0628","877","435","442","36","913","1868","0","48.88","23.29"
"67","000","00","035","3510","0629","1010","529","481","39","1049","1797","0","58.38","29.44"
"67","000","00","035","3510","0630","1181","602","579","47","1228","2268","0","54.14","26.54"
"67","000","00","035","3511","0000","1100","545","555","71","1171","2188","0","53.52","24.91"
"67","000","00","035","3511","0654","1100","545","555","71","1171","2188","0","53.52","24.91"
"67","000","00","035","3512","0000","970","550","420","70","1040","1835","0","56.68","29.97"
"67","000","00","035","3512","0659","970","550","420","70","1040","1835","0","56.68","29.97"
"67","000","00","035","3513","0000","2139","1129","1010","109","2248","4646","0","48.39","24.3"
"67","000","00","035","3513","0655","1115","582","533","60","1175","2399","0","48.98","24.26"
"67","000","00","035","3513","0656","1024","547","477","49","1073","2247","0","47.75","24.34"
"67","000","00","035","3514","0000","681","408","273","44","725","1165","0","62.23","35.02"
"67","000","00","035","3514","0657","681","408","273","44","725","1165","0","62.23","35.02"
"67","000","00","035","3515","0000","2544","1306","1238","116","2660","5476","0","48.58","23.85"
"67","000","00","035","3515","0670","676","360","316","44","720","1547","0","46.54","23.27"
"67","000","00","035","3515","0671","879","461","418","31","910","1784","0","51.01","25.84"
"67","000","00","035","3515","0672","989","485","504","41","1030","2145","0","48.02","22.61"
"67","000","00","035","3516","0000","1381","763","618","89","1470","2728","0","53.89","27.97"
"67","000","00","035","3516","0668","903","497","406","49","952","1763","0","54.0","28.19"
"67","000","00","035","3516","0669","478","266","212","40","518","965","0","53.68","27.56"
"67","000","00","035","3517","0000","1144","653","491","82","1226","1978","0","61.98","33.01"
"67","000","00","035","3517","0693","529","322","207","34","563","905","0","62.21","35.58"
"67","000","00","035","3517","0694","615","331","284","48","663","1073","0","61.79","30.85"
"67","000","00","035","3518","0000","3615","1891","1724","124","3739","7488","0","49.93","25.25"
"67","000","00","035","3518","0673","1262","657","605","55","1317","2443","0","53.91","26.89"
"67","000","00","035","3518","0674","1123","561","562","6","1129","2565","0","44.02","21.87"
"67","000","00","035","3518","0675","1230","673","557","63","1293","2480","0","52.14","27.14"
"67","000","00","035","3519","0000","585","346","239","41","626","977","0","64.07","35.41"
"67","000","00","035","3519","0662","585","346","239","41","626","977","0","64.07","35.41"
"67","000","00","035","3520","0000","2121","1160","961","116","2237","4517","0","49.52","25.68"
"67","000","00","035","3520","0676","1012","553","459","59","1071","2349","0","45.59","23.54"
"67","000","00","035","3520","0677","1109","607","502","57","1166","2168","0","53.78","28.0"
"67","000","00","035","3521","0000","1543","840","703","100","1643","3228","0","50.9","26.02"
"67","000","00","035","3521","0666","660","366","294","44","704","1319","0","53.37","27.75"
"67","000","00","035","3521","0667","883","474","409","56","939","1909","0","49.19","24.83"
"67","000","00","035","3522","0000","1661","890","771","59","1720","3339","0","51.51","26.65"
"67","000","00","035","3522","0663","751","409","342","27","778","1642","0","47.38","24.91"
"67","000","00","035","3522","0664","910","481","429","32","942","1697","0","55.51","28.34"
"67","000","00","035","3523","0000","927","480","447","33","960","1966","0","48.83","24.42"
"67","000","00","035","3523","0665","927","480","447","33","960","1966","0","48.83","24.42"
"67","000","00","035","3524","0000","846","435","411","37","883","1501","0","58.83","28.98"
"67","000","00","035","3524","0707","846","435","411","37","883","1501","0","58.83","28.98"
"67","000","00","035","3525","0000","937","528","409","44","981","1797","0","54.59","29.38"
"67","000","00","035","3525","0660","937","528","409","44","981","1797","0","54.59","29.38"
"67","000","00","035","3526","0000","1029","564","465","61","1090","2223","0","49.03","25.37"
"67","000","00","035","3526","0661","1029","564","465","61","1090","2223","0","49.03","25.37"
"67","000","00","035","3527","0000","875","441","434","44","919","1579","0","58.2","27.93"
"67","000","00","035","3527","0695","875","441","434","44","919","1579","0","58.2","27.93"
"67","000","00","035","3528","0000","720","419","301","25","745","1462","0","50.96","28.66"
"67","000","00","035","3528","0700","720","419","301","25","745","1462","0","50.96","28.66"
"67","000","00","035","3529","0000","582","295","287","42","624","1044","0","59.77","28.26"
"67","000","00","035","3529","0701","582","295","287","42","624","1044","0","59.77","28.26"
"67","000","00","035","3530","0000","1496","776","720","107","1603","3070","0","52.21","25.28"
"67","000","00","035","3530","0696","910","490","420","72","982","1876","0","52.35","26.12"
"67","000","00","035","3530","0697","586","286","300","35","621","1194","0","52.01","23.95"
"67","000","00","035","3531","0000","672","394","278","22","694","1380","0","50.29","28.55"
"67","000","00","035","3531","0699","672","394","278","22","694","1380","0","50.29","28.55"
"67","000","00","035","3532","0000","605","315","290","16","621","1475","0","42.1","21.36"
"67","000","00","035","3532","0698","605","315","290","16","621","1475","0","42.1","21.36"
"67","000","00","035","3533","0000","738","395","343","59","797","1293","0","61.64","30.55"
"67","000","00","035","3533","0702","358","186","172","37","395","603","0","65.51","30.85"
"67","000","00","035","3533","0703","380","209","171","22","402","690","0","58.26","30.29"
"67","000","00","035","3534","0000","693","368","325","33","726","1447","0","50.17","25.43"
"67","000","00","035","3534","0704","693","368","325","33","726","1447","0","50.17","25.43"
"67","000","00","035","3535","0000","567","305","262","38","605","910","0","66.48","33.52"
"67","000","00","035","3535","0705","567","305","262","38","605","910","0","66.48","33.52"
"67","000","00","035","3536","0000","875","495","380","46","921","1850","0","49.78","26.76"
"67","000","00","035","3536","0706","875","495","380","46","921","1850","0","49.78","26.76"
"67","000","00","035","3537","0000","1104","625","479","59","1163","2143","0","54.27","29.16"
"67","000","00","035","3537","0638","1104","625","479","59","1163","2143","0","54.27","29.16"
"67","000","00","035","3538","0000","1552","846","706","72","1624","2791","0","58.19","30.31"
"67","000","00","035","3538","0636","936","479","457","50","986","1613","0","61.13","29.7"
"67","000","00","035","3538","0637","616","367","249","22","638","1178","0","54.16","31.15"
"67","000","00","035","3539","0000","2338","1215","1123","76","2414","4412","0","54.71","27.54"
"67","000","00","035","3539","0641","768","421","347","15","783","1428","0","54.83","29.48"
"67","000","00","035","3539","0642","860","456","404","35","895","1626","0","55.04","28.04"
"67","000","00","035","3539","0643","710","338","372","26","736","1358","0","54.2","24.89"
"67","000","00","035","3540","0000","1745","957","788","103","1848","3120","0","59.23","30.67"
"67","000","00","035","3540","0680","956","499","457","64","1020","1627","0","62.69","30.67"
"67","000","00","035","3540","0681","789","458","331","39","828","1493","0","55.46","30.68"
"67","000","00","035","3541","0000","2220","1257","963","108","2328","4273","0","54.48","29.42"
"67","000","00","035","3541","0682","747","390","357","40","787","1397","0","56.34","27.92"
"67","000","00","035","3541","0683","712","415","297","44","756","1416","0","53.39","29.31"
"67","000","00","035","3541","0684","761","452","309","24","785","1460","0","53.77","30.96"
"67","000","00","035","3542","0000","1712","985","727","66","1778","3661","0","48.57","26.91"
"67","000","00","035","3542","0691","814","450","364","42","856","1815","0","47.16","24.79"
"67","000","00","035","3542","0692","898","535","363","24","922","1846","0","49.95","28.98"
"67","000","00","035","3543","0000","2116","1119","997","81","2197","4437","0","49.52","25.22"
"67","000","00","035","3543","0646","1017","549","468","39","1056","2116","0","49.91","25.95"
"67","000","00","035","3543","0647","1099","570","529","42","1141","2321","0","49.16","24.56"
"67","000","00","035","3544","0000","1952","1101","851","88","2040","4044","0","50.45","27.23"
"67","000","00","035","3544","0648","1051","580","471","28","1079","2117","0","50.97","27.4"
"67","000","00","035","3544","0649","901","521","380","60","961","1927","0","49.87","27.04"
"67","000","00","035","3545","0000","2206","1190","1016","109","2315","4576","0","50.59","26.01"
"67","000","00","035","3545","0650","1083","578","505","69","1152","2242","0","51.38","25.78"
"67","000","00","035","3545","0651","1123","612","511","40","1163","2334","0","49.83","26.22"
"67","000","00","035","3546","0000","1982","1045","937","86","2068","3809","0","54.29","27.44"
"67","000","00","035","3546","0686","1043","550","493","58","1101","2070","0","53.19","26.57"
"67","000","00","035","3546","0687","939","495","444","28","967","1739","0","55.61","28.46"
"67","000","00","035","3547","0000","1576","831","745","78","1654","3305","0","50.05","25.14"
"67","000","00","035","3547","0678","813","417","396","39","852","1630","0","52.27","25.58"
"67","000","00","035","3547","0679","763","414","349","39","802","1675","0","47.88","24.72"
"67","000","00","035","3548","0000","745","399","346","36","781","1539","0","50.75","25.93"
"67","000","00","035","3548","0658","745","399","346","36","781","1539","0","50.75","25.93"
"67","000","00","035","3549","0000","984","515","469","27","1011","2222","0","45.5","23.18"
"67","000","00","035","3549","0685","984","515","469","27","1011","2222","0","45.5","23.18"
"67","000","00","035","3550","0000","2889","1603","1286","129","3018","5433","0","55.55","29.5"
"67","000","00","035","3550","0688","899","513","386","41","940","1830","0","51.37","28.03"
"67","000","00","035","3550","0689","1014","558","456","46","1060","1803","0","58.79","30.95"
"67","000","00","035","3550","0690","976","532","444","42","1018","1800","0","56.56","29.56"
"67","000","00","035","3551","0000","1915","1053","862","104","2019","3635","0","55.54","28.97"
"67","000","00","035","3551","0652","951","516","435","41","992","1822","0","54.45","28.32"
"67","000","00","035","3551","0653","964","537","427","63","1027","1813","0","56.65","29.62"
"67","000","00","036","0000","0000","27349","13735","13614","1023","28372","55379","66677","51.23","24.8"
"67","000","00","036","3602","0000","951","458","493","47","998","2001","0","49.88","22.89"
"67","000","00","036","3602","1014","951","458","493","47","998","2001","0","49.88","22.89"
"67","000","00","036","3604","0000","218","133","85","9","227","438","0","51.83","30.37"
"67","000","00","036","3604","1007","218","133","85","9","227","438","0","51.83","30.37"
"67","000","00","036","3605","0000","2456","1228","1228","81","2537","4954","0","51.21","24.79"
"67","000","00","036","3605","0986","1232","630","602","45","1277","2547","0","50.14","24.73"
"67","000","00","036","3605","0987","1224","598","626","36","1260","2407","0","52.35","24.84"
"67","000","00","036","3606","0000","2039","998","1041","55","2094","4202","0","49.83","23.75"
"67","000","00","036","3606","0988","944","444","500","26","970","2070","0","46.86","21.45"
"67","000","00","036","3606","0989","1095","554","541","29","1124","2132","0","52.72","25.98"
"67","000","00","036","3607","0000","2496","1262","1234","72","2568","4810","0","53.39","26.24"
"67","000","00","036","3607","0990","788","388","400","15","803","1450","0","55.38","26.76"
"67","000","00","036","3607","0991","798","446","352","19","817","1605","0","50.9","27.79"
"67","000","00","036","3607","0992","910","428","482","38","948","1755","0","54.02","24.39"
"67","000","00","036","3608","0000","3345","1731","1614","106","3451","7011","0","49.22","24.69"
"67","000","00","036","3608","0993","790","423","367","33","823","1728","0","47.63","24.48"
"67","000","00","036","3608","0994","740","367","373","16","756","1754","0","43.1","20.92"
"67","000","00","036","3608","0995","851","444","407","23","874","1686","0","51.84","26.33"
"67","000","00","036","3608","0996","964","497","467","34","998","1843","0","54.15","26.97"
"67","000","00","036","3609","0000","2648","1259","1389","100","2748","4994","0","55.03","25.21"
"67","000","00","036","3609","0983","940","462","478","39","979","1753","0","55.85","26.35"
"67","000","00","036","3609","0984","932","448","484","36","968","1859","0","52.07","24.1"
"67","000","00","036","3609","0985","776","349","427","25","801","1382","0","57.96","25.25"
"67","000","00","036","3610","0000","3429","1689","1740","137","3566","6842","0","52.12","24.69"
"67","000","00","036","3610","1003","892","429","463","38","930","1675","0","55.52","25.61"
"67","000","00","036","3610","1004","987","491","496","42","1029","1979","0","52.0","24.81"
"67","000","00","036","3610","1005","778","428","350","21","799","1602","0","49.88","26.72"
"67","000","00","036","3610","1006","772","341","431","36","808","1586","0","50.95","21.5"
"67","000","00","036","3611","0000","3590","1729","1861","117","3707","7611","0","48.71","22.72"
"67","000","00","036","3611","0999","795","401","394","19","814","1653","0","49.24","24.26"
"67","000","00","036","3611","1000","820","360","460","25","845","1697","0","49.79","21.21"
"67","000","00","036","3611","1001","980","478","502","34","1014","2154","0","47.08","22.19"
"67","000","00","036","3611","1002","995","490","505","39","1034","2107","0","49.07","23.26"
"67","000","00","036","3612","0000","1535","787","748","52","1587","2853","0","55.63","27.58"
"67","000","00","036","3612","0997","868","438","430","23","891","1565","0","56.93","27.99"
"67","000","00","036","3612","0998","667","349","318","29","696","1288","0","54.04","27.1"
"67","000","00","036","3615","0000","1643","879","764","83","1726","3403","0","50.72","25.83"
"67","000","00","036","3615","1008","849","443","406","57","906","1780","0","50.9","24.89"
"67","000","00","036","3615","1009","794","436","358","26","820","1623","0","50.52","26.86"
"67","000","00","036","3616","0000","1655","921","734","76","1731","3443","0","50.28","26.75"
"67","000","00","036","3616","1010","1030","548","482","40","1070","2157","0","49.61","25.41"
"67","000","00","036","3616","1011","625","373","252","36","661","1286","0","51.4","29.0"
"67","000","00","036","3617","0000","1344","661","683","88","1432","2817","0","50.83","23.46"
"67","000","00","036","3617","1012","732","390","342","62","794","1492","0","53.22","26.14"
"67","000","00","036","3617","1013","612","271","341","26","638","1325","0","48.15","20.45"
"67","000","00","037","0000","0000","35113","19112","16001","1560","36673","65261","78093","56.19","29.29"
"67","000","00","037","3705","0000","2043","1165","878","102","2145","3854","0","55.66","30.23"
"67","000","00","037","3705","0931","709","409","300","31","740","1332","0","55.56","30.71"
"67","000","00","037","3705","0932","694","383","311","29","723","1246","0","58.03","30.74"
"67","000","00","037","3705","0933","640","373","267","42","682","1276","0","53.45","29.23"
"67","000","00","037","3707","0000","1689","890","799","54","1743","3047","0","57.2","29.21"
"67","000","00","037","3707","0934","876","443","433","27","903","1583","0","57.04","27.98"
"67","000","00","037","3707","0935","813","447","366","27","840","1464","0","57.38","30.53"
"67","000","00","037","3709","0000","1398","718","680","50","1448","2602","0","55.65","27.59"
"67","000","00","037","3709","0936","640","350","290","19","659","1234","0","53.4","28.36"
"67","000","00","037","3709","0937","758","368","390","31","789","1368","0","57.68","26.9"
"67","000","00","037","3711","0000","1256","744","512","56","1312","2538","0","51.69","29.31"
"67","000","00","037","3711","0938","635","376","259","26","661","1322","0","50.0","28.44"
"67","000","00","037","3711","0939","621","368","253","30","651","1216","0","53.54","30.26"
"67","000","00","037","3716","0000","1361","769","592","54","1415","2526","0","56.02","30.44"
"67","000","00","037","3716","0940","671","388","283","32","703","1289","0","54.54","30.1"
"67","000","00","037","3716","0941","690","381","309","22","712","1237","0","57.56","30.8"
"67","000","00","037","3722","0000","1837","1070","767","90","1927","3455","0","55.77","30.97"
"67","000","00","037","3722","0942","577","348","229","26","603","1189","0","50.71","29.27"
"67","000","00","037","3722","0943","652","395","257","33","685","1201","0","57.04","32.89"
"67","000","00","037","3722","0944","608","327","281","31","639","1065","0","60.0","30.7"
"67","000","00","037","3725","0000","2056","1100","956","77","2133","3505","0","60.86","31.38"
"67","000","00","037","3725","0945","589","332","257","30","619","1055","0","58.67","31.47"
"67","000","00","037","3725","0946","694","373","321","20","714","1170","0","61.03","31.88"
"67","000","00","037","3725","0947","773","395","378","27","800","1280","0","62.5","30.86"
"67","000","00","037","3731","0000","1402","713","689","55","1457","2515","0","57.93","28.35"
"67","000","00","037","3731","0948","673","360","313","25","698","1223","0","57.07","29.44"
"67","000","00","037","3731","0949","729","353","376","30","759","1292","0","58.75","27.32"
"67","000","00","037","3733","0000","3004","1504","1500","145","3149","5398","0","58.34","27.86"
"67","000","00","037","3733","0950","577","285","292","18","595","993","0","59.92","28.7"
"67","000","00","037","3733","0951","817","425","392","46","863","1541","0","56.0","27.58"
"67","000","00","037","3733","0952","937","445","492","56","993","1652","0","60.11","26.94"
"67","000","00","037","3733","0953","673","349","324","25","698","1212","0","57.59","28.8"
"67","000","00","037","3734","0000","2651","1355","1296","92","2743","4876","0","56.26","27.79"
"67","000","00","037","3734","0954","900","473","427","30","930","1621","0","57.37","29.18"
"67","000","00","037","3734","0955","905","463","442","39","944","1660","0","56.87","27.89"
"67","000","00","037","3734","0956","846","419","427","23","869","1595","0","54.48","26.27"
"67","000","00","037","3739","0000","1936","1072","864","94","2030","3557","0","57.07","30.14"
"67","000","00","037","3739","0957","736","406","330","35","771","1436","0","53.69","28.27"
"67","000","00","037","3739","0958","703","373","330","26","729","1265","0","57.63","29.49"
"67","000","00","037","3739","0959","497","293","204","33","530","856","0","61.92","34.23"
"67","000","00","037","3740","0000","1858","1046","812","78","1936","3297","0","58.72","31.73"
"67","000","00","037","3740","0960","613","354","259","24","637","1168","0","54.54","30.31"
"67","000","00","037","3740","0961","647","359","288","23","670","1134","0","59.08","31.66"
"67","000","00","037","3740","0962","598","333","265","31","629","995","0","63.22","33.47"
"67","000","00","037","3741","0000","1497","713","784","73","1570","2578","0","60.9","27.66"
"67","000","00","037","3741","0963","782","336","446","33","815","1313","0","62.07","25.59"
"67","000","00","037","3741","0964","715","377","338","40","755","1265","0","59.68","29.8"
"67","000","00","037","3742","0000","1670","904","766","68","1738","3150","0","55.17","28.7"
"67","000","00","037","3742","0965","626","342","284","26","652","1215","0","53.66","28.15"
"67","000","00","037","3742","0966","673","344","329","23","696","1248","0","55.77","27.56"
"67","000","00","037","3742","0967","371","218","153","19","390","687","0","56.77","31.73"
"67","000","00","037","3743","0000","1150","646","504","67","1217","2110","0","57.68","30.62"
"67","000","00","037","3743","0968","607","363","244","42","649","1139","0","56.98","31.87"
"67","000","00","037","3743","0969","543","283","260","25","568","971","0","58.5","29.15"
"67","000","00","037","3744","0000","1941","1121","820","99","2040","3978","0","51.28","28.18"
"67","000","00","037","3744","0970","522","304","218","28","550","1254","0","43.86","24.24"
"67","000","00","037","3744","0971","552","312","240","26","578","979","0","59.04","31.87"
"67","000","00","037","3744","0972","867","505","362","45","912","1745","0","52.26","28.94"
"67","000","00","037","3745","0000","1274","678","596","54","1328","2510","0","52.91","27.01"
"67","000","00","037","3745","0973","573","315","258","22","595","1074","0","55.4","29.33"
"67","000","00","037","3745","0974","701","363","338","32","733","1436","0","51.04","25.28"
"67","000","00","037","3746","0000","1102","645","457","54","1156","2029","0","56.97","31.79"
"67","000","00","037","3746","0975","483","296","187","32","515","865","0","59.54","34.22"
"67","000","00","037","3746","0976","619","349","270","22","641","1164","0","55.07","29.98"
"67","000","00","037","3747","0000","1998","1147","851","99","2097","4067","0","51.56","28.2"
"67","000","00","037","3747","0977","658","393","265","22","680","1285","0","52.92","30.58"
"67","000","00","037","3747","0978","559","315","244","38","597","1078","0","55.38","29.22"
"67","000","00","037","3747","0979","781","439","342","39","820","1704","0","48.12","25.76"
"67","000","00","037","3748","0000","1990","1112","878","99","2089","3669","0","56.94","30.31"
"67","000","00","037","3748","0980","725","411","314","39","764","1296","0","58.95","31.71"
"67","000","00","037","3748","0981","598","308","290","33","631","1128","0","55.94","27.3"
"67","000","00","037","3748","0982","667","393","274","27","694","1245","0","55.74","31.57"
"64","000","00","000","0000","0000","1354393","658515","695878","58506","1412899","2353342","2772624","60.04","27.98"
"64","000","00","001","0000","0000","12745","7028","5717","457","13202","21617","24098","61.07","32.51"
"64","000","00","001","0101","0000","825","445","380","25","850","1304","0","65.18","34.13"
"64","000","00","001","0101","0845","825","445","380","25","850","1304","0","65.18","34.13"
"64","000","00","001","0102","0000","212","116","96","16","228","357","0","63.87","32.49"
"64","000","00","001","0102","0846","212","116","96","16","228","357","0","63.87","32.49"
"64","000","00","001","0103","0000","404","266","138","22","426","651","0","65.44","40.86"
"64","000","00","001","0103","0847","404","266","138","22","426","651","0","65.44","40.86"
"64","000","00","001","0104","0000","685","328","357","25","710","1322","0","53.71","24.81"
"64","000","00","001","0104","0848","685","328","357","25","710","1322","0","53.71","24.81"
"64","000","00","001","0105","0000","676","335","341","28","704","1056","0","66.67","31.72"
"64","000","00","001","0105","0849","676","335","341","28","704","1056","0","66.67","31.72"
"64","000","00","001","0106","0000","1241","645","596","37","1278","2034","0","62.83","31.71"
"64","000","00","001","0106","0850","576","304","272","19","595","904","0","65.82","33.63"
"64","000","00","001","0106","0851","665","341","324","18","683","1130","0","60.44","30.18"
"64","000","00","001","0107","0000","515","253","262","16","531","840","0","63.21","30.12"
"64","000","00","001","0107","0852","515","253","262","16","531","840","0","63.21","30.12"
"64","000","00","001","0108","0000","427","246","181","15","442","616","0","71.75","39.94"
"64","000","00","001","0108","0853","427","246","181","15","442","616","0","71.75","39.94"
"64","000","00","001","0109","0000","752","443","309","32","784","1397","0","56.12","31.71"
"64","000","00","001","0109","0854","752","443","309","32","784","1397","0","56.12","31.71"
"64","000","00","001","0110","0000","469","275","194","12","481","766","0","62.79","35.9"
"64","000","00","001","0110","0855","469","275","194","12","481","766","0","62.79","35.9"
"64","000","00","001","0111","0000","1016","557","459","38","1054","1644","0","64.11","33.88"
"64","000","00","001","0111","0856","499","271","228","27","526","839","0","62.69","32.3"
"64","000","00","001","0111","0857","517","286","231","11","528","805","0","65.59","35.53"
"64","000","00","001","0112","0000","438","243","195","14","452","750","0","60.27","32.4"
"64","000","00","001","0112","0858","438","243","195","14","452","750","0","60.27","32.4"
"64","000","00","001","0113","0000","567","320","247","26","593","986","0","60.14","32.45"
"64","000","00","001","0113","0859","567","320","247","26","593","986","0","60.14","32.45"
"64","000","00","001","0114","0000","605","340","265","9","614","1068","0","57.49","31.84"
"64","000","00","001","0114","0860","605","340","265","9","614","1068","0","57.49","31.84"
"64","000","00","001","0115","0000","622","346","276","21","643","1060","0","60.66","32.64"
"64","000","00","001","0115","0861","622","346","276","21","643","1060","0","60.66","32.64"
"64","000","00","001","0116","0000","455","223","232","25","480","805","0","59.63","27.7"
"64","000","00","001","0116","0862","455","223","232","25","480","805","0","59.63","27.7"
"64","000","00","001","0117","0000","1078","623","455","46","1124","1994","0","56.37","31.24"
"64","000","00","001","0117","0863","596","345","251","19","615","1073","0","57.32","32.15"
"64","000","00","001","0117","0864","482","278","204","27","509","921","0","55.27","30.18"
"64","000","00","001","0118","0000","676","371","305","19","695","1171","0","59.35","31.68"
"64","000","00","001","0118","0865","676","371","305","19","695","1171","0","59.35","31.68"
"64","000","00","001","0119","0000","356","218","138","8","364","594","0","61.28","36.7"
"64","000","00","001","0119","0866","356","218","138","8","364","594","0","61.28","36.7"
"64","000","00","001","0120","0000","380","212","168","14","394","592","0","66.55","35.81"
"64","000","00","001","0120","0867","380","212","168","14","394","592","0","66.55","35.81"
"64","000","00","001","0121","0000","346","223","123","9","355","610","0","58.2","36.56"
"64","000","00","001","0121","0868","346","223","123","9","355","610","0","58.2","36.56"
"64","000","00","002","0000","0000","67598","31453","36145","2321","69919","114979","139894","60.81","27.36"
"64","000","00","002","0201","0000","1156","518","638","47","1203","1959","0","61.41","26.44"
"64","000","00","002","0201","0768","519","224","295","16","535","959","0","55.79","23.36"
"64","000","00","002","0201","0769","637","294","343","31","668","1000","0","66.8","29.4"
"64","000","00","002","0202","0000","1219","452","767","45","1264","1995","0","63.36","22.66"
"64","000","00","002","0202","0770","527","195","332","16","543","910","0","59.67","21.43"
"64","000","00","002","0202","0771","692","257","435","29","721","1085","0","66.45","23.69"
"64","000","00","002","0203","0000","2388","1008","1380","92","2480","4147","0","59.8","24.31"
"64","000","00","002","0203","0772","735","350","385","26","761","1484","0","51.28","23.58"
"64","000","00","002","0203","0773","840","347","493","20","860","1393","0","61.74","24.91"
"64","000","00","002","0203","0774","813","311","502","46","859","1270","0","67.64","24.49"
"64","000","00","002","0204","0000","2061","1165","896","75","2136","3402","0","62.79","34.24"
"64","000","00","002","0204","0775","624","378","246","24","648","1055","0","61.42","35.83"
"64","000","00","002","0204","0776","690","377","313","26","716","1172","0","61.09","32.17"
"64","000","00","002","0204","0777","747","410","337","25","772","1175","0","65.7","34.89"
"64","000","00","002","0205","0000","778","431","347","32","810","1274","0","63.58","33.83"
"64","000","00","002","0205","0778","778","431","347","32","810","1274","0","63.58","33.83"
"64","000","00","002","0206","0000","555","319","236","36","591","1085","0","54.47","29.4"
"64","000","00","002","0206","0779","555","319","236","36","591","1085","0","54.47","29.4"
"64","000","00","002","0207","0000","1453","740","713","77","1530","2444","0","62.6","30.28"
"64","000","00","002","0207","0780","828","409","419","41","869","1470","0","59.12","27.82"
"64","000","00","002","0207","0781","625","331","294","36","661","974","0","67.86","33.98"
"64","000","00","002","0208","0000","2209","1118","1091","119","2328","3719","0","62.6","30.06"
"64","000","00","002","0208","0782","756","379","377","53","809","1275","0","63.45","29.73"
"64","000","00","002","0208","0783","711","389","322","40","751","1206","0","62.27","32.26"
"64","000","00","002","0208","0784","742","350","392","26","768","1238","0","62.04","28.27"
"64","000","00","002","0209","0000","485","75","410","11","496","721","0","68.79","10.4"
"64","000","00","002","0209","0785","485","75","410","11","496","721","0","68.79","10.4"
"64","000","00","002","0210","0000","681","332","349","30","711","1220","0","58.28","27.21"
"64","000","00","002","0210","0786","681","332","349","30","711","1220","0","58.28","27.21"
"64","000","00","002","0211","0000","1005","542","463","30","1035","1966","0","52.64","27.57"
"64","000","00","002","0211","0787","1005","542","463","30","1035","1966","0","52.64","27.57"
"64","000","00","002","0212","0000","1925","1031","894","64","1989","3442","0","57.79","29.95"
"64","000","00","002","0212","0788","967","539","428","35","1002","1722","0","58.19","31.3"
"64","000","00","002","0212","0789","958","492","466","29","987","1720","0","57.38","28.6"
"64","000","00","002","0213","0000","1408","769","639","75","1483","2656","0","55.84","28.95"
"64","000","00","002","0213","0790","779","429","350","52","831","1287","0","64.57","33.33"
"64","000","00","002","0213","0791","629","340","289","23","652","1369","0","47.63","24.84"
"64","000","00","002","0214","0000","1801","949","852","52","1853","2992","0","61.93","31.72"
"64","000","00","002","0214","0792","769","371","398","23","792","1222","0","64.81","30.36"
"64","000","00","002","0214","0793","1032","578","454","29","1061","1770","0","59.94","32.66"
"64","000","00","002","0215","0000","8810","3892","4918","261","9071","14867","0","61.01","26.18"
"64","000","00","002","0215","0794","1056","472","584","29","1085","1860","0","58.33","25.38"
"64","000","00","002","0215","0795","1063","506","557","31","1094","1857","0","58.91","27.25"
"64","000","00","002","0215","0796","1083","473","610","31","1114","1841","0","60.51","25.69"
"64","000","00","002","0215","0797","1093","494","599","40","1133","1830","0","61.91","26.99"
"64","000","00","002","0215","0798","1046","474","572","44","1090","1809","0","60.25","26.2"
"64","000","00","002","0215","0799","1151","484","667","30","1181","1894","0","62.35","25.55"
"64","000","00","002","0215","0800","1139","454","685","22","1161","1882","0","61.69","24.12"
"64","000","00","002","0215","0801","1179","535","644","34","1213","1894","0","64.04","28.25"
"64","000","00","002","0216","0000","12752","5459","7293","309","13061","20876","0","62.56","26.15"
"64","000","00","002","0216","0802","989","374","615","26","1015","1745","0","58.17","21.43"
"64","000","00","002","0216","0803","1052","454","598","18","1070","1887","0","56.7","24.06"
"64","000","00","002","0216","0804","1196","525","671","37","1233","1891","0","65.2","27.76"
"64","000","00","002","0216","0805","1126","490","636","44","1170","1903","0","61.48","25.75"
"64","000","00","002","0216","0806","1200","574","626","23","1223","1998","0","61.21","28.73"
"64","000","00","002","0216","0807","1171","520","651","23","1194","1912","0","62.45","27.2"
"64","000","00","002","0216","0808","1177","524","653","35","1212","1923","0","63.03","27.25"
"64","000","00","002","0216","0809","1163","510","653","26","1189","1888","0","62.98","27.01"
"64","000","00","002","0216","0810","1178","511","667","17","1195","1873","0","63.8","27.28"
"64","000","00","002","0216","0811","1293","525","768","21","1314","1959","0","67.08","26.8"
"64","000","00","002","0216","0812","1207","452","755","39","1246","1897","0","65.68","23.83"
"64","000","00","002","0217","0000","9649","4009","5640","225","9874","16100","0","61.33","24.9"
"64","000","00","002","0217","0813","1422","559","863","34","1456","2362","0","61.64","23.67"
"64","000","00","002","0217","0814","1110","455","655","46","1156","1850","0","62.49","24.59"
"64","000","00","002","0217","0815","1207","533","674","18","1225","1928","0","63.54","27.65"
"64","000","00","002","0217","0816","1123","463","660","16","1139","1937","0","58.8","23.9"
"64","000","00","002","0217","0817","1248","497","751","34","1282","2123","0","60.39","23.41"
"64","000","00","002","0217","0818","1156","504","652","24","1180","1861","0","63.41","27.08"
"64","000","00","002","0217","0819","1103","452","651","23","1126","1892","0","59.51","23.89"
"64","000","00","002","0217","0820","1280","546","734","30","1310","2147","0","61.02","25.43"
"64","000","00","002","0218","0000","2406","1046","1360","42","2448","3938","0","62.16","26.56"
"64","000","00","002","0218","0821","1177","499","678","20","1197","1897","0","63.1","26.3"
"64","000","00","002","0218","0822","1229","547","682","22","1251","2041","0","61.29","26.8"
"64","000","00","002","0219","0000","1870","833","1037","75","1945","3176","0","61.24","26.23"
"64","000","00","002","0219","0823","756","335","421","37","793","1309","0","60.58","25.59"
"64","000","00","002","0219","0824","1114","498","616","38","1152","1867","0","61.7","26.67"
"64","000","00","002","0220","0000","1637","606","1031","69","1706","2556","0","66.74","23.71"
"64","000","00","002","0220","0825","762","292","470","28","790","1152","0","68.58","25.35"
"64","000","00","002","0220","0826","875","314","561","41","916","1404","0","65.24","22.36"
"64","000","00","002","0221","0000","580","358","222","22","602","1210","0","49.75","29.59"
"64","000","00","002","0221","0827","580","358","222","22","602","1210","0","49.75","29.59"
"64","000","00","002","0222","0000","694","384","310","22","716","1135","0","63.08","33.83"
"64","000","00","002","0222","0828","694","384","310","22","716","1135","0","63.08","33.83"
"64","000","00","002","0223","0000","646","344","302","43","689","1831","0","37.63","18.79"
"64","000","00","002","0223","0829","646","344","302","43","689","1831","0","37.63","18.79"
"64","000","00","002","0224","0000","774","413","361","27","801","1288","0","62.19","32.07"
"64","000","00","002","0224","0830","774","413","361","27","801","1288","0","62.19","32.07"
"64","000","00","002","0225","0000","695","336","359","25","720","1241","0","58.02","27.07"
"64","000","00","002","0225","0831","695","336","359","25","720","1241","0","58.02","27.07"
"64","000","00","002","0226","0000","787","357","430","38","825","1342","0","61.48","26.6"
"64","000","00","002","0226","0832","787","357","430","38","825","1342","0","61.48","26.6"
"64","000","00","002","0227","0000","875","458","417","44","919","1422","0","64.63","32.21"
"64","000","00","002","0227","0833","875","458","417","44","919","1422","0","64.63","32.21"
"64","000","00","002","0228","0000","875","456","419","55","930","1453","0","64.01","31.38"
"64","000","00","002","0228","0834","875","456","419","55","930","1453","0","64.01","31.38"
"64","000","00","002","0229","0000","375","187","188","30","405","616","0","65.75","30.36"
"64","000","00","002","0229","0835","375","187","188","30","405","616","0","65.75","30.36"
"64","000","00","002","0230","0000","483","256","227","33","516","834","0","61.87","30.7"
"64","000","00","002","0230","0836","483","256","227","33","516","834","0","61.87","30.7"
"64","000","00","002","0231","0000","564","301","263","29","593","969","0","61.2","31.06"
"64","000","00","002","0231","0837","564","301","263","29","593","969","0","61.2","31.06"
"64","000","00","002","0232","0000","567","331","236","37","604","978","0","61.76","33.84"
"64","000","00","002","0232","0838","567","331","236","37","604","978","0","61.76","33.84"
"64","000","00","002","0233","0000","490","311","179","25","515","760","0","67.76","40.92"
"64","000","00","002","0233","0839","490","311","179","25","515","760","0","67.76","40.92"
"64","000","00","002","0234","0000","721","409","312","34","755","1248","0","60.5","32.77"
"64","000","00","002","0234","0840","721","409","312","34","755","1248","0","60.5","32.77"
"64","000","00","002","0235","0000","650","386","264","17","667","1143","0","58.36","33.77"
"64","000","00","002","0235","0841","650","386","264","17","667","1143","0","58.36","33.77"
"64","000","00","002","0236","0000","700","415","285","41","741","1358","0","54.57","30.56"
"64","000","00","002","0236","0842","700","415","285","41","741","1358","0","54.57","30.56"
"64","000","00","002","0237","0000","551","283","268","16","567","1036","0","54.73","27.32"
"64","000","00","002","0237","0843","551","283","268","16","567","1036","0","54.73","27.32"
"64","000","00","002","0238","0000","323","174","149","17","340","580","0","58.62","30.0"
"64","000","00","002","0238","0844","323","174","149","17","340","580","0","58.62","30.0"
"64","000","00","003","0000","0000","96090","41066","55024","3319","99409","161367","196749","61.6","25.45"
"64","000","00","003","0301","0000","882","380","502","39","921","2604","0","35.37","14.59"
"64","000","00","003","0301","0534","882","380","502","39","921","2604","0","35.37","14.59"
"64","000","00","003","0302","0000","604","324","280","45","649","1037","0","62.58","31.24"
"64","000","00","003","0302","0535","604","324","280","45","649","1037","0","62.58","31.24"
"64","000","00","003","0303","0000","350","201","149","14","364","542","0","67.16","37.08"
"64","000","00","003","0303","0536","350","201","149","14","364","542","0","67.16","37.08"
"64","000","00","003","0304","0000","392","238","154","15","407","635","0","64.09","37.48"
"64","000","00","003","0304","0537","392","238","154","15","407","635","0","64.09","37.48"
"64","000","00","003","0305","0000","285","178","107","18","303","518","0","58.49","34.36"
"64","000","00","003","0305","0538","285","178","107","18","303","518","0","58.49","34.36"
"64","000","00","003","0306","0000","499","331","168","21","520","813","0","63.96","40.71"
"64","000","00","003","0306","0539","499","331","168","21","520","813","0","63.96","40.71"
"64","000","00","003","0307","0000","530","329","201","38","568","889","0","63.89","37.01"
"64","000","00","003","0307","0540","530","329","201","38","568","889","0","63.89","37.01"
"64","000","00","003","0308","0000","429","246","183","42","471","731","0","64.43","33.65"
"64","000","00","003","0308","0541","429","246","183","42","471","731","0","64.43","33.65"
"64","000","00","003","0309","0000","1869","963","906","59","1928","3301","0","58.41","29.17"
"64","000","00","003","0309","0542","844","460","384","31","875","1592","0","54.96","28.89"
"64","000","00","003","0309","0543","1025","503","522","28","1053","1709","0","61.61","29.43"
"64","000","00","003","0311","0000","854","256","598","57","911","1588","0","57.37","16.12"
"64","000","00","003","0311","0544","854","256","598","57","911","1588","0","57.37","16.12"
"64","000","00","003","0312","0000","202","54","148","8","210","358","0","58.66","15.08"
"64","000","00","003","0312","0545","202","54","148","8","210","358","0","58.66","15.08"
"64","000","00","003","0313","0000","446","120","326","10","456","666","0","68.47","18.02"
"64","000","00","003","0313","0546","446","120","326","10","456","666","0","68.47","18.02"
"64","000","00","003","0315","0000","971","348","623","51","1022","1748","0","58.47","19.91"
"64","000","00","003","0315","0547","971","348","623","51","1022","1748","0","58.47","19.91"
"64","000","00","003","0316","0000","1496","595","901","78","1574","2436","0","64.61","24.43"
"64","000","00","003","0316","0548","730","264","466","37","767","1196","0","64.13","22.07"
"64","000","00","003","0316","0549","766","331","435","41","807","1240","0","65.08","26.69"
"64","000","00","003","0317","0000","1553","266","1287","68","1621","2575","0","62.95","10.33"
"64","000","00","003","0317","0550","830","156","674","41","871","1402","0","62.13","11.13"
"64","000","00","003","0317","0551","723","110","613","27","750","1173","0","63.94","9.38"
"64","000","00","003","0319","0000","438","122","316","23","461","641","0","71.92","19.03"
"64","000","00","003","0319","0552","438","122","316","23","461","641","0","71.92","19.03"
"64","000","00","003","0321","0000","573","383","190","28","601","951","0","63.2","40.27"
"64","000","00","003","0321","0553","573","383","190","28","601","951","0","63.2","40.27"
"64","000","00","003","0322","0000","434","262","172","20","454","732","0","62.02","35.79"
"64","000","00","003","0322","0554","434","262","172","20","454","732","0","62.02","35.79"
"64","000","00","003","0323","0000","203","117","86","8","211","339","0","62.24","34.51"
"64","000","00","003","0323","0555","203","117","86","8","211","339","0","62.24","34.51"
"64","000","00","003","0324","0000","313","177","136","8","321","519","0","61.85","34.1"
"64","000","00","003","0324","0556","313","177","136","8","321","519","0","61.85","34.1"
"64","000","00","003","0325","0000","320","196","124","22","342","514","0","66.54","38.13"
"64","000","00","003","0325","0557","320","196","124","22","342","514","0","66.54","38.13"
"64","000","00","003","0326","0000","446","261","185","32","478","720","0","66.39","36.25"
"64","000","00","003","0326","0558","446","261","185","32","478","720","0","66.39","36.25"
"64","000","00","003","0327","0000","251","176","75","18","269","411","0","65.45","42.82"
"64","000","00","003","0327","0559","251","176","75","18","269","411","0","65.45","42.82"
"64","000","00","003","0328","0000","382","231","151","23","405","603","0","67.16","38.31"
"64","000","00","003","0328","0560","382","231","151","23","405","603","0","67.16","38.31"
"64","000","00","003","0329","0000","525","280","245","42","567","904","0","62.72","30.97"
"64","000","00","003","0329","0561","525","280","245","42","567","904","0","62.72","30.97"
"64","000","00","003","0330","0000","694","270","424","32","726","1318","0","55.08","20.49"
"64","000","00","003","0330","0562","694","270","424","32","726","1318","0","55.08","20.49"
"64","000","00","003","0331","0000","547","284","263","13","560","966","0","57.97","29.4"
"64","000","00","003","0331","0563","547","284","263","13","560","966","0","57.97","29.4"
"64","000","00","003","0332","0000","3247","804","2443","165","3412","5792","0","58.91","13.88"
"64","000","00","003","0332","0564","792","200","592","29","821","1440","0","57.01","13.89"
"64","000","00","003","0332","0565","1068","268","800","45","1113","1990","0","55.93","13.47"
"64","000","00","003","0332","0566","647","167","480","33","680","1090","0","62.39","15.32"
"64","000","00","003","0332","0567","740","169","571","58","798","1272","0","62.74","13.29"
"64","000","00","003","0334","0000","1906","710","1196","41","1947","3059","0","63.65","23.21"
"64","000","00","003","0334","0568","955","341","614","24","979","1558","0","62.84","21.89"
"64","000","00","003","0334","0569","951","369","582","17","968","1501","0","64.49","24.58"
"64","000","00","003","0335","0000","245","86","159","7","252","360","0","70.0","23.89"
"64","000","00","003","0335","0570","245","86","159","7","252","360","0","70.0","23.89"
"64","000","00","003","0336","0000","1555","367","1188","49","1604","2694","0","59.54","13.62"
"64","000","00","003","0336","0571","762","114","648","28","790","1335","0","59.18","8.54"
"64","000","00","003","0336","0572","793","253","540","21","814","1359","0","59.9","18.62"
"64","000","00","003","0337","0000","880","265","615","51","931","1487","0","62.61","17.82"
"64","000","00","003","0337","0573","880","265","615","51","931","1487","0","62.61","17.82"
"64","000","00","003","0338","0000","933","220","713","50","983","1637","0","60.05","13.44"
"64","000","00","003","0338","0574","933","220","713","50","983","1637","0","60.05","13.44"
"64","000","00","003","0339","0000","8030","3349","4681","284","8314","13089","0","63.52","25.59"
"64","000","00","003","0339","0575","960","409","551","31","991","1553","0","63.81","26.34"
"64","000","00","003","0339","0576","983","429","554","41","1024","1564","0","65.47","27.43"
"64","000","00","003","0339","0577","1140","461","679","43","1183","1788","0","66.16","25.78"
"64","000","00","003","0339","0578","1204","471","733","50","1254","2028","0","61.83","23.22"
"64","000","00","003","0339","0579","1205","544","661","55","1260","2037","0","61.86","26.71"
"64","000","00","003","0339","0580","1292","520","772","29","1321","2101","0","62.87","24.75"
"64","000","00","003","0339","0581","1246","515","731","35","1281","2018","0","63.48","25.52"
"64","000","00","003","0340","0000","15102","6950","8152","432","15534","25058","0","61.99","27.74"
"64","000","00","003","0340","0582","1194","593","601","60","1254","1925","0","65.14","30.81"
"64","000","00","003","0340","0583","1157","566","591","31","1188","1989","0","59.73","28.46"
"64","000","00","003","0340","0584","993","504","489","22","1015","1780","0","57.02","28.31"
"64","000","00","003","0340","0585","1073","497","576","29","1102","1778","0","61.98","27.95"
"64","000","00","003","0340","0586","901","374","527","27","928","1496","0","62.03","25.0"
"64","000","00","003","0340","0587","951","375","576","24","975","1538","0","63.39","24.38"
"64","000","00","003","0340","0588","1222","565","657","49","1271","2058","0","61.76","27.45"
"64","000","00","003","0340","0589","1210","581","629","25","1235","1992","0","62.0","29.17"
"64","000","00","003","0340","0590","1246","562","684","43","1289","2058","0","62.63","27.31"
"64","000","00","003","0340","0591","1262","573","689","28","1290","2090","0","61.72","27.42"
"64","000","00","003","0340","0592","1287","606","681","24","1311","2157","0","60.78","28.09"
"64","000","00","003","0340","0593","1307","536","771","23","1330","2096","0","63.45","25.57"
"64","000","00","003","0340","0594","1299","618","681","47","1346","2101","0","64.06","29.41"
"64","000","00","003","0341","0000","2876","1528","1348","132","3008","4843","0","62.11","31.55"
"64","000","00","003","0341","0595","958","498","460","50","1008","1649","0","61.13","30.2"
"64","000","00","003","0341","0596","874","508","366","38","912","1516","0","60.16","33.51"
"64","000","00","003","0341","0597","1044","522","522","44","1088","1678","0","64.84","31.11"
"64","000","00","003","0342","0000","7876","3441","4435","229","8105","13054","0","62.09","26.36"
"64","000","00","003","0342","0598","1146","533","613","43","1189","1898","0","62.64","28.08"
"64","000","00","003","0342","0599","1129","548","581","35","1164","1837","0","63.36","29.83"
"64","000","00","003","0342","0600","1089","492","597","25","1114","1922","0","57.96","25.6"
"64","000","00","003","0342","0601","1111","501","610","36","1147","1785","0","64.26","28.07"
"64","000","00","003","0342","0602","1114","435","679","19","1133","1886","0","60.07","23.06"
"64","000","00","003","0342","0603","1146","457","689","40","1186","1895","0","62.59","24.12"
"64","000","00","003","0342","0604","1141","475","666","31","1172","1831","0","64.01","25.94"
"64","000","00","003","0343","0000","16855","7283","9572","473","17328","27814","0","62.3","26.18"
"64","000","00","003","0343","0605","1199","688","511","42","1241","2050","0","60.54","33.56"
"64","000","00","003","0343","0606","1479","645","834","25","1504","2251","0","66.81","28.65"
"64","000","00","003","0343","0607","1353","559","794","22","1375","2126","0","64.68","26.29"
"64","000","00","003","0343","0608","1083","483","600","28","1111","1928","0","57.62","25.05"
"64","000","00","003","0343","0609","1264","561","703","28","1292","2166","0","59.65","25.9"
"64","000","00","003","0343","0610","1179","444","735","41","1220","2031","0","60.07","21.86"
"64","000","00","003","0343","0611","1186","478","708","46","1232","1987","0","62.0","24.06"
"64","000","00","003","0343","0612","1372","600","772","35","1407","2166","0","64.96","27.7"
"64","000","00","003","0343","0613","1132","510","622","34","1166","1856","0","62.82","27.48"
"64","000","00","003","0343","0614","1402","692","710","39","1441","2289","0","62.95","30.23"
"64","000","00","003","0343","0615","1183","385","798","37","1220","1973","0","61.83","19.51"
"64","000","00","003","0343","0616","1078","429","649","50","1128","1818","0","62.05","23.6"
"64","000","00","003","0343","0617","912","407","505","26","938","1565","0","59.94","26.01"
"64","000","00","003","0343","0618","1033","402","631","20","1053","1608","0","65.49","25.0"
"64","000","00","003","0344","0000","20097","8475","11622","574","20671","33421","0","61.85","25.36"
"64","000","00","003","0344","0619","1150","477","673","37","1187","1812","0","65.51","26.32"
"64","000","00","003","0344","0620","1049","444","605","19","1068","1821","0","58.65","24.38"
"64","000","00","003","0344","0621","1136","509","627","52","1188","1907","0","62.3","26.69"
"64","000","00","003","0344","0622","1055","406","649","26","1081","1812","0","59.66","22.41"
"64","000","00","003","0344","0623","1145","445","700","36","1181","1833","0","64.43","24.28"
"64","000","00","003","0344","0624","1121","517","604","38","1159","1850","0","62.65","27.95"
"64","000","00","003","0344","0625","1020","465","555","33","1053","1738","0","60.59","26.75"
"64","000","00","003","0344","0626","1179","478","701","38","1217","1864","0","65.29","25.64"
"64","000","00","003","0344","0627","1171","491","680","28","1199","1887","0","63.54","26.02"
"64","000","00","003","0344","0628","1057","459","598","10","1067","1870","0","57.06","24.55"
"64","000","00","003","0344","0629","1115","424","691","23","1138","1866","0","60.99","22.72"
"64","000","00","003","0344","0630","1103","455","648","15","1118","1862","0","60.04","24.44"
"64","000","00","003","0344","0631","1096","453","643","37","1133","1816","0","62.39","24.94"
"64","000","00","003","0344","0632","1135","482","653","23","1158","1833","0","63.18","26.3"
"64","000","00","003","0344","0633","1020","421","599","40","1060","1676","0","63.25","25.12"
"64","000","00","003","0344","0634","1114","619","495","30","1144","1843","0","62.07","33.59"
"64","000","00","003","0344","0635","1132","446","686","33","1165","1872","0","62.23","23.82"
"64","000","00","003","0344","0636","1299","484","815","56","1355","2259","0","59.98","21.43"
"64","000","00","004","0000","0000","88364","41039","47325","3859","92223","153132","185318","60.22","26.8"
"64","000","00","004","0401","0000","11509","5424","6085","364","11873","20704","0","57.35","26.2"
"64","000","00","004","0401","0435","821","408","413","27","848","1309","0","64.78","31.17"
"64","000","00","004","0401","0436","838","417","421","23","861","1408","0","61.15","29.62"
"64","000","00","004","0401","0437","1073","514","559","40","1113","1851","0","60.13","27.77"
"64","000","00","004","0401","0438","960","519","441","27","987","1578","0","62.55","32.89"
"64","000","00","004","0401","0439","963","455","508","15","978","1715","0","57.03","26.53"
"64","000","00","004","0401","0440","884","417","467","15","899","1611","0","55.8","25.88"
"64","000","00","004","0401","0441","1069","488","581","44","1113","2024","0","54.99","24.11"
"64","000","00","004","0401","0442","978","453","525","29","1007","1890","0","53.28","23.97"
"64","000","00","004","0401","0443","888","359","529","30","918","1762","0","52.1","20.37"
"64","000","00","004","0401","0444","1017","466","551","33","1050","1888","0","55.61","24.68"
"64","000","00","004","0401","0445","995","484","511","48","1043","1822","0","57.24","26.56"
"64","000","00","004","0401","0446","1023","444","579","33","1056","1846","0","57.2","24.05"
"64","000","00","004","0402","0000","2427","1128","1299","108","2535","3940","0","64.34","28.63"
"64","000","00","004","0402","0447","761","358","403","44","805","1268","0","63.49","28.23"
"64","000","00","004","0402","0448","804","360","444","34","838","1240","0","67.58","29.03"
"64","000","00","004","0402","0449","862","410","452","30","892","1432","0","62.29","28.63"
"64","000","00","004","0403","0000","3392","1640","1752","144","3536","5991","0","59.02","27.37"
"64","000","00","004","0403","0450","877","434","443","35","912","1490","0","61.21","29.13"
"64","000","00","004","0403","0451","874","409","465","31","905","1464","0","61.82","27.94"
"64","000","00","004","0403","0452","778","374","404","44","822","1435","0","57.28","26.06"
"64","000","00","004","0403","0453","863","423","440","34","897","1602","0","55.99","26.4"
"64","000","00","004","0404","0000","1725","886","839","83","1808","3091","0","58.49","28.66"
"64","000","00","004","0404","0454","834","447","387","41","875","1500","0","58.33","29.8"
"64","000","00","004","0404","0455","891","439","452","42","933","1591","0","58.64","27.59"
"64","000","00","004","0405","0000","1763","943","820","83","1846","3197","0","57.74","29.5"
"64","000","00","004","0405","0458","853","469","384","46","899","1559","0","57.67","30.08"
"64","000","00","004","0405","0459","910","474","436","37","947","1638","0","57.81","28.94"
"64","000","00","004","0406","0000","1506","739","767","75","1581","3138","0","50.38","23.55"
"64","000","00","004","0406","0456","634","351","283","37","671","1669","0","40.2","21.03"
"64","000","00","004","0406","0457","872","388","484","38","910","1469","0","61.95","26.41"
"64","000","00","004","0407","0000","2240","1093","1147","115","2355","3872","0","60.82","28.23"
"64","000","00","004","0407","0460","1135","561","574","50","1185","1960","0","60.46","28.62"
"64","000","00","004","0407","0461","1105","532","573","65","1170","1912","0","61.19","27.82"
"64","000","00","004","0408","0000","2632","1257","1375","91","2723","4678","0","58.21","26.87"
"64","000","00","004","0408","0462","873","366","507","41","914","1559","0","58.63","23.48"
"64","000","00","004","0408","0463","774","320","454","34","808","1423","0","56.78","22.49"
"64","000","00","004","0408","0464","985","571","414","16","1001","1696","0","59.02","33.67"
"64","000","00","004","0409","0000","1727","1036","691","103","1830","3020","0","60.6","34.3"
"64","000","00","004","0409","0465","841","550","291","53","894","1493","0","59.88","36.84"
"64","000","00","004","0409","0466","886","486","400","50","936","1527","0","61.3","31.83"
"64","000","00","004","0410","0000","1332","820","512","72","1404","2217","0","63.33","36.99"
"64","000","00","004","0410","0467","635","395","240","29","664","1020","0","65.1","38.73"
"64","000","00","004","0410","0468","697","425","272","43","740","1197","0","61.82","35.51"
"64","000","00","004","0411","0000","1802","1065","737","68","1870","3446","0","54.27","30.91"
"64","000","00","004","0411","0469","830","518","312","35","865","1528","0","56.61","33.9"
"64","000","00","004","0411","0470","972","547","425","33","1005","1918","0","52.4","28.52"
"64","000","00","004","0412","0000","852","514","338","44","896","1458","0","61.45","35.25"
"64","000","00","004","0412","0471","852","514","338","44","896","1458","0","61.45","35.25"
"64","000","00","004","0413","0000","2184","1095","1089","87","2271","3635","0","62.48","30.12"
"64","000","00","004","0413","0472","1076","566","510","43","1119","1790","0","62.51","31.62"
"64","000","00","004","0413","0473","1108","529","579","44","1152","1845","0","62.44","28.67"
"64","000","00","004","0414","0000","8944","3859","5085","334","9278","15761","0","58.87","24.48"
"64","000","00","004","0414","0474","1201","478","723","55","1256","2037","0","61.66","23.47"
"64","000","00","004","0414","0475","1067","426","641","45","1112","1964","0","56.62","21.69"
"64","000","00","004","0414","0476","1132","445","687","25","1157","2006","0","57.68","22.18"
"64","000","00","004","0414","0477","1075","470","605","35","1110","1951","0","56.89","24.09"
"64","000","00","004","0414","0478","1063","451","612","51","1114","1951","0","57.1","23.12"
"64","000","00","004","0414","0479","1143","410","733","56","1199","2008","0","59.71","20.42"
"64","000","00","004","0414","0480","1137","495","642","39","1176","1923","0","61.15","25.74"
"64","000","00","004","0414","0481","1126","684","442","28","1154","1921","0","60.07","35.61"
"64","000","00","004","0415","0000","562","194","368","20","582","832","0","69.95","23.32"
"64","000","00","004","0415","0482","562","194","368","20","582","832","0","69.95","23.32"
"64","000","00","004","0416","0000","1379","696","683","53","1432","2281","0","62.78","30.51"
"64","000","00","004","0416","0483","682","323","359","18","700","1156","0","60.55","27.94"
"64","000","00","004","0416","0484","697","373","324","35","732","1125","0","65.07","33.16"
"64","000","00","004","0417","0000","1570","662","908","60","1630","2562","0","63.62","25.84"
"64","000","00","004","0417","0485","676","334","342","22","698","1060","0","65.85","31.51"
"64","000","00","004","0417","0486","894","328","566","38","932","1502","0","62.05","21.84"
"64","000","00","004","0418","0000","1598","708","890","89","1687","2956","0","57.07","23.95"
"64","000","00","004","0418","0487","814","384","430","44","858","1404","0","61.11","27.35"
"64","000","00","004","0418","0488","784","324","460","45","829","1552","0","53.41","20.88"
"64","000","00","004","0419","0000","1326","675","651","80","1406","2775","0","50.67","24.32"
"64","000","00","004","0419","0489","729","376","353","46","775","1460","0","53.08","25.75"
"64","000","00","004","0419","0490","597","299","298","34","631","1315","0","47.98","22.74"
"64","000","00","004","0420","0000","1257","562","695","79","1336","2140","0","62.43","26.26"
"64","000","00","004","0420","0491","636","295","341","39","675","1062","0","63.56","27.78"
"64","000","00","004","0420","0492","621","267","354","40","661","1078","0","61.32","24.77"
"64","000","00","004","0421","0000","1267","653","614","76","1343","1978","0","67.9","33.01"
"64","000","00","004","0421","0493","590","313","277","35","625","914","0","68.38","34.25"
"64","000","00","004","0421","0494","677","340","337","41","718","1064","0","67.48","31.95"
"64","000","00","004","0422","0000","3132","1274","1858","132","3264","5350","0","61.01","23.81"
"64","000","00","004","0422","0495","1011","427","584","50","1061","1705","0","62.23","25.04"
"64","000","00","004","0422","0496","1010","426","584","32","1042","1728","0","60.3","24.65"
"64","000","00","004","0422","0497","1111","421","690","50","1161","1917","0","60.56","21.96"
"64","000","00","004","0423","0000","795","370","425","43","838","1439","0","58.23","25.71"
"64","000","00","004","0423","0498","795","370","425","43","838","1439","0","58.23","25.71"
"64","000","00","004","0424","0000","2654","1184","1470","110","2764","4196","0","65.87","28.22"
"64","000","00","004","0424","0499","807","404","403","30","837","1287","0","65.03","31.39"
"64","000","00","004","0424","0500","926","401","525","43","969","1504","0","64.43","26.66"
"64","000","00","004","0424","0501","921","379","542","37","958","1405","0","68.19","26.98"
"64","000","00","004","0425","0000","1523","702","821","81","1604","2582","0","62.12","27.19"
"64","000","00","004","0425","0502","739","362","377","51","790","1287","0","61.38","28.13"
"64","000","00","004","0425","0503","784","340","444","30","814","1295","0","62.86","26.25"
"64","000","00","004","0426","0000","1973","880","1093","75","2048","3132","0","65.39","28.1"
"64","000","00","004","0426","0504","911","391","520","32","943","1483","0","63.59","26.37"
"64","000","00","004","0426","0505","1062","489","573","43","1105","1649","0","67.01","29.65"
"64","000","00","004","0427","0000","1254","576","678","84","1338","2023","0","66.14","28.47"
"64","000","00","004","0427","0506","616","297","319","41","657","998","0","65.83","29.76"
"64","000","00","004","0427","0507","638","279","359","43","681","1025","0","66.44","27.22"
"64","000","00","004","0428","0000","1964","791","1173","110","2074","3124","0","66.39","25.32"
"64","000","00","004","0428","0508","1068","364","704","50","1118","1671","0","66.91","21.78"
"64","000","00","004","0428","0509","896","427","469","60","956","1453","0","65.79","29.39"
"64","000","00","004","0429","0000","1926","883","1043","90","2016","3326","0","60.61","26.55"
"64","000","00","004","0429","0510","985","497","488","47","1032","1673","0","61.69","29.71"
"64","000","00","004","0429","0511","941","386","555","43","984","1653","0","59.53","23.35"
"64","000","00","004","0430","0000","1348","578","770","72","1420","2161","0","65.71","26.75"
"64","000","00","004","0430","0512","609","290","319","34","643","1034","0","62.19","28.05"
"64","000","00","004","0430","0513","739","288","451","38","777","1127","0","68.94","25.55"
"64","000","00","004","0431","0000","2575","1193","1382","125","2700","4512","0","59.84","26.44"
"64","000","00","004","0431","0514","887","452","435","48","935","1575","0","59.37","28.7"
"64","000","00","004","0431","0515","913","383","530","45","958","1559","0","61.45","24.57"
"64","000","00","004","0431","0516","775","358","417","32","807","1378","0","58.56","25.98"
"64","000","00","004","0432","0000","2041","916","1125","99","2140","3435","0","62.3","26.67"
"64","000","00","004","0432","0517","1023","457","566","47","1070","1714","0","62.43","26.66"
"64","000","00","004","0432","0518","1018","459","559","52","1070","1721","0","62.17","26.67"
"64","000","00","004","0433","0000","5042","2041","3001","232","5274","8227","0","64.11","24.81"
"64","000","00","004","0433","0519","961","393","568","36","997","1628","0","61.24","24.14"
"64","000","00","004","0433","0520","1019","421","598","65","1084","1590","0","68.18","26.48"
"64","000","00","004","0433","0521","949","395","554","49","998","1628","0","61.3","24.26"
"64","000","00","004","0433","0522","1101","436","665","35","1136","1739","0","65.32","25.07"
"64","000","00","004","0433","0523","1012","396","616","47","1059","1642","0","64.49","24.12"
"64","000","00","004","0434","0000","2649","1011","1638","139","2788","4997","0","55.79","20.23"
"64","000","00","004","0434","0524","954","370","584","48","1002","1766","0","56.74","20.95"
"64","000","00","004","0434","0525","802","307","495","62","864","1482","0","58.3","20.72"
"64","000","00","004","0434","0526","893","334","559","29","922","1749","0","52.72","19.1"
"64","000","00","004","0435","0000","3983","1749","2234","109","4092","6433","0","63.61","27.19"
"64","000","00","004","0435","0527","944","438","506","24","968","1591","0","60.84","27.53"
"64","000","00","004","0435","0528","977","441","536","27","1004","1545","0","64.98","28.54"
"64","000","00","004","0435","0529","1052","430","622","26","1078","1651","0","65.29","26.04"
"64","000","00","004","0435","0530","1010","440","570","32","1042","1646","0","63.3","26.73"
"64","000","00","004","0436","0000","929","490","439","40","969","1496","0","64.77","32.75"
"64","000","00","004","0436","0531","929","490","439","40","969","1496","0","64.77","32.75"
"64","000","00","004","0437","0000","1582","752","830","90","1672","3027","0","55.24","24.84"
"64","000","00","004","0437","0532","796","448","348","51","847","1403","0","60.37","31.93"
"64","000","00","004","0437","0533","786","304","482","39","825","1624","0","50.8","18.72"
"64","000","00","005","0000","0000","168912","84073","84839","6310","175222","289519","341230","60.52","29.04"
"64","000","00","005","0501","0000","2104","1106","998","104","2208","3875","0","56.98","28.54"
"64","000","00","005","0501","0887","1071","625","446","45","1116","1893","0","58.95","33.02"
"64","000","00","005","0501","0888","1033","481","552","59","1092","1982","0","55.1","24.27"
"64","000","00","005","0502","0000","4134","1876","2258","148","4282","7408","0","57.8","25.32"
"64","000","00","005","0502","0889","937","415","522","48","985","1661","0","59.3","24.98"
"64","000","00","005","0502","0890","1055","467","588","19","1074","1894","0","56.71","24.66"
"64","000","00","005","0502","0891","1024","466","558","39","1063","1839","0","57.8","25.34"
"64","000","00","005","0502","0892","1118","528","590","42","1160","2014","0","57.6","26.22"
"64","000","00","005","0503","0000","2158","1091","1067","96","2254","3913","0","57.6","27.88"
"64","000","00","005","0503","0893","1071","557","514","64","1135","1897","0","59.83","29.36"
"64","000","00","005","0503","0894","1087","534","553","32","1119","2016","0","55.51","26.49"
"64","000","00","005","0504","0000","2064","1216","848","73","2137","3673","0","58.18","33.11"
"64","000","00","005","0504","0895","1049","708","341","30","1079","1924","0","56.08","36.8"
"64","000","00","005","0504","0896","1015","508","507","43","1058","1749","0","60.49","29.05"
"64","000","00","005","0505","0000","4125","2097","2028","181","4306","7080","0","60.82","29.62"
"64","000","00","005","0505","0897","1130","570","560","63","1193","1845","0","64.66","30.89"
"64","000","00","005","0505","0898","966","500","466","45","1011","1724","0","58.64","29.0"
"64","000","00","005","0505","0899","1083","522","561","36","1119","1889","0","59.24","27.63"
"64","000","00","005","0505","0900","946","505","441","37","983","1622","0","60.6","31.13"
"64","000","00","005","0506","0000","2061","1077","984","72","2133","3393","0","62.86","31.74"
"64","000","00","005","0506","0901","1125","595","530","32","1157","1870","0","61.87","31.82"
"64","000","00","005","0506","0902","936","482","454","40","976","1523","0","64.08","31.65"
"64","000","00","005","0507","0000","12002","5094","6908","408","12410","20639","0","60.13","24.68"
"64","000","00","005","0507","0903","1095","602","493","42","1137","2006","0","56.68","30.01"
"64","000","00","005","0507","0904","1278","508","770","37","1315","2076","0","63.34","24.47"
"64","000","00","005","0507","0905","1180","474","706","27","1207","2073","0","58.22","22.87"
"64","000","00","005","0507","0906","1178","497","681","49","1227","2045","0","60.0","24.3"
"64","000","00","005","0507","0907","1007","514","493","47","1054","2070","0","50.92","24.83"
"64","000","00","005","0507","0908","1216","521","695","44","1260","2035","0","61.92","25.6"
"64","000","00","005","0507","0909","1275","498","777","31","1306","2075","0","62.94","24.0"
"64","000","00","005","0507","0910","1210","473","737","35","1245","2053","0","60.64","23.04"
"64","000","00","005","0507","0911","1253","485","768","56","1309","2063","0","63.45","23.51"
"64","000","00","005","0507","0912","1310","522","788","40","1350","2143","0","63.0","24.36"
"64","000","00","005","0508","0000","4796","2361","2435","184","4980","8519","0","58.46","27.71"
"64","000","00","005","0508","0913","1056","507","549","52","1108","1746","0","63.46","29.04"
"64","000","00","005","0508","0914","941","473","468","21","962","1735","0","55.45","27.26"
"64","000","00","005","0508","0915","889","470","419","41","930","1655","0","56.19","28.4"
"64","000","00","005","0508","0916","913","449","464","37","950","1583","0","60.01","28.36"
"64","000","00","005","0508","0917","997","462","535","33","1030","1800","0","57.22","25.67"
"64","000","00","005","0509","0000","4092","1918","2174","142","4234","7001","0","60.48","27.4"
"64","000","00","005","0509","0918","1036","492","544","23","1059","1730","0","61.21","28.44"
"64","000","00","005","0509","0919","1006","483","523","21","1027","1715","0","59.88","28.16"
"64","000","00","005","0509","0920","985","487","498","38","1023","1691","0","60.5","28.8"
"64","000","00","005","0509","0921","1065","456","609","60","1125","1865","0","60.32","24.45"
"64","000","00","005","0510","0000","1325","698","627","56","1381","1990","0","69.4","35.08"
"64","000","00","005","0510","0922","683","345","338","23","706","1073","0","65.8","32.15"
"64","000","00","005","0510","0923","642","353","289","33","675","917","0","73.61","38.5"
"64","000","00","005","0511","0000","952","503","449","39","991","1647","0","60.17","30.54"
"64","000","00","005","0511","0924","952","503","449","39","991","1647","0","60.17","30.54"
"64","000","00","005","0512","0000","3063","1448","1615","124","3187","5126","0","62.17","28.25"
"64","000","00","005","0512","0925","982","487","495","39","1021","1654","0","61.73","29.44"
"64","000","00","005","0512","0926","993","464","529","52","1045","1639","0","63.76","28.31"
"64","000","00","005","0512","0927","1088","497","591","33","1121","1833","0","61.16","27.11"
"64","000","00","005","0513","0000","2759","1272","1487","94","2853","4401","0","64.83","28.9"
"64","000","00","005","0513","0928","868","407","461","29","897","1362","0","65.86","29.88"
"64","000","00","005","0513","0929","954","431","523","44","998","1557","0","64.1","27.68"
"64","000","00","005","0513","0930","937","434","503","21","958","1482","0","64.64","29.28"
"64","000","00","005","0514","0000","2853","1295","1558","94","2947","4583","0","64.3","28.26"
"64","000","00","005","0514","0931","965","458","507","39","1004","1563","0","64.24","29.3"
"64","000","00","005","0514","0932","900","397","503","43","943","1497","0","62.99","26.52"
"64","000","00","005","0514","0933","988","440","548","12","1000","1523","0","65.66","28.89"
"64","000","00","005","0515","0000","4569","2136","2433","124","4693","7198","0","65.2","29.67"
"64","000","00","005","0515","0934","855","414","441","22","877","1293","0","67.83","32.02"
"64","000","00","005","0515","0935","1014","465","549","28","1042","1662","0","62.7","27.98"
"64","000","00","005","0515","0936","848","390","458","27","875","1441","0","60.72","27.06"
"64","000","00","005","0515","0937","887","414","473","25","912","1326","0","68.78","31.22"
"64","000","00","005","0515","0938","965","453","512","22","987","1476","0","66.87","30.69"
"64","000","00","005","0516","0000","1946","944","1002","53","1999","3586","0","55.74","26.32"
"64","000","00","005","0516","0939","1070","526","544","26","1096","1968","0","55.69","26.73"
"64","000","00","005","0516","0940","876","418","458","27","903","1618","0","55.81","25.83"
"64","000","00","005","0517","0000","2899","1440","1459","102","3001","5000","0","60.02","28.8"
"64","000","00","005","0517","0941","1063","473","590","36","1099","1873","0","58.68","25.25"
"64","000","00","005","0517","0942","867","426","441","38","905","1487","0","60.86","28.65"
"64","000","00","005","0517","0943","969","541","428","28","997","1640","0","60.79","32.99"
"64","000","00","005","0518","0000","2187","1070","1117","51","2238","3858","0","58.01","27.73"
"64","000","00","005","0518","0944","1087","541","546","26","1113","1889","0","58.92","28.64"
"64","000","00","005","0518","0945","1100","529","571","25","1125","1969","0","57.14","26.87"
"64","000","00","005","0519","0000","3828","2005","1823","164","3992","6475","0","61.65","30.97"
"64","000","00","005","0519","0946","867","463","404","54","921","1466","0","62.82","31.58"
"64","000","00","005","0519","0947","1014","512","502","39","1053","1697","0","62.05","30.17"
"64","000","00","005","0519","0948","992","587","405","37","1029","1663","0","61.88","35.3"
"64","000","00","005","0519","0949","955","443","512","34","989","1649","0","59.98","26.86"
"64","000","00","005","0520","0000","1720","901","819","77","1797","2981","0","60.28","30.22"
"64","000","00","005","0520","0950","870","486","384","57","927","1486","0","62.38","32.71"
"64","000","00","005","0520","0951","850","415","435","20","870","1495","0","58.19","27.76"
"64","000","00","005","0521","0000","1854","864","990","58","1912","3041","0","62.87","28.41"
"64","000","00","005","0521","0952","978","460","518","32","1010","1548","0","65.25","29.72"
"64","000","00","005","0521","0953","876","404","472","26","902","1493","0","60.42","27.06"
"64","000","00","005","0522","0000","4604","2093","2511","133","4737","7649","0","61.93","27.36"
"64","000","00","005","0522","0954","896","403","493","20","916","1445","0","63.39","27.89"
"64","000","00","005","0522","0955","878","400","478","23","901","1529","0","58.93","26.16"
"64","000","00","005","0522","0956","876","429","447","26","902","1506","0","59.89","28.49"
"64","000","00","005","0522","0957","955","400","555","29","984","1549","0","63.52","25.82"
"64","000","00","005","0522","0958","999","461","538","35","1034","1620","0","63.83","28.46"
"64","000","00","005","0523","0000","1878","873","1005","73","1951","3038","0","64.22","28.74"
"64","000","00","005","0523","0959","966","472","494","39","1005","1550","0","64.84","30.45"
"64","000","00","005","0523","0960","912","401","511","34","946","1488","0","63.58","26.95"
"64","000","00","005","0524","0000","1603","763","840","65","1668","2667","0","62.54","28.61"
"64","000","00","005","0524","0961","814","387","427","30","844","1335","0","63.22","28.99"
"64","000","00","005","0524","0962","789","376","413","35","824","1332","0","61.86","28.23"
"64","000","00","005","0525","0000","3159","1478","1681","115","3274","5268","0","62.15","28.06"
"64","000","00","005","0525","0963","1055","535","520","44","1099","1764","0","62.3","30.33"
"64","000","00","005","0525","0964","1063","465","598","28","1091","1811","0","60.24","25.68"
"64","000","00","005","0525","0965","1041","478","563","43","1084","1693","0","64.03","28.23"
"64","000","00","005","0526","0000","3033","1458","1575","94","3127","4867","0","64.25","29.96"
"64","000","00","005","0526","0966","1072","538","534","42","1114","1684","0","66.15","31.95"
"64","000","00","005","0526","0967","858","421","437","23","881","1464","0","60.18","28.76"
"64","000","00","005","0526","0968","1103","499","604","29","1132","1719","0","65.85","29.03"
"64","000","00","005","0527","0000","3955","1833","2122","138","4093","6858","0","59.68","26.73"
"64","000","00","005","0527","0969","1043","512","531","17","1060","1749","0","60.61","29.27"
"64","000","00","005","0527","0970","1058","478","580","36","1094","1908","0","57.34","25.05"
"64","000","00","005","0527","0971","922","398","524","54","976","1573","0","62.05","25.3"
"64","000","00","005","0527","0972","932","445","487","31","963","1628","0","59.15","27.33"
"64","000","00","005","0528","0000","2373","1156","1217","110","2483","4095","0","60.63","28.23"
"64","000","00","005","0528","0973","744","419","325","32","776","1377","0","56.35","30.43"
"64","000","00","005","0528","0974","939","392","547","43","982","1530","0","64.18","25.62"
"64","000","00","005","0528","0975","690","345","345","35","725","1188","0","61.03","29.04"
"64","000","00","005","0529","0000","2925","1397","1528","116","3041","6302","0","48.25","22.17"
"64","000","00","005","0529","0976","845","456","389","27","872","2791","0","31.24","16.34"
"64","000","00","005","0529","0977","1079","510","569","41","1120","1840","0","60.87","27.72"
"64","000","00","005","0529","0978","1001","431","570","48","1049","1671","0","62.78","25.79"
"64","000","00","005","0530","0000","4928","2288","2640","135","5063","7969","0","63.53","28.71"
"64","000","00","005","0530","0979","947","473","474","36","983","1624","0","60.53","29.13"
"64","000","00","005","0530","0980","1029","468","561","33","1062","1555","0","68.3","30.1"
"64","000","00","005","0530","0981","979","462","517","24","1003","1489","0","67.36","31.03"
"64","000","00","005","0530","0982","1019","461","558","26","1045","1662","0","62.88","27.74"
"64","000","00","005","0530","0983","954","424","530","16","970","1639","0","59.18","25.87"
"64","000","00","005","0531","0000","2175","1053","1122","80","2255","3840","0","58.72","27.42"
"64","000","00","005","0531","0984","1064","565","499","46","1110","1872","0","59.29","30.18"
"64","000","00","005","0531","0985","1111","488","623","34","1145","1968","0","58.18","24.8"
"64","000","00","005","0532","0000","1588","825","763","96","1684","3005","0","56.04","27.45"
"64","000","00","005","0532","0986","729","401","328","57","786","1471","0","53.43","27.26"
"64","000","00","005","0532","0987","859","424","435","39","898","1534","0","58.54","27.64"
"64","000","00","005","0533","0000","2783","1416","1367","121","2904","5282","0","54.98","26.81"
"64","000","00","005","0533","0988","880","474","406","47","927","1659","0","55.88","28.57"
"64","000","00","005","0533","0989","947","473","474","32","979","1815","0","53.94","26.06"
"64","000","00","005","0533","0990","956","469","487","42","998","1808","0","55.2","25.94"
"64","000","00","005","0534","0000","1457","709","748","58","1515","2630","0","57.6","26.96"
"64","000","00","005","0534","0991","667","346","321","32","699","1224","0","57.11","28.27"
"64","000","00","005","0534","0992","790","363","427","26","816","1406","0","58.04","25.82"
"64","000","00","005","0535","0000","1143","640","503","48","1191","1889","0","63.05","33.88"
"64","000","00","005","0535","0993","538","288","250","29","567","945","0","60.0","30.48"
"64","000","00","005","0535","0994","605","352","253","19","624","944","0","66.1","37.29"
"64","000","00","005","0536","0000","1911","1094","817","84","1995","3142","0","63.49","34.82"
"64","000","00","005","0536","0995","998","547","451","42","1040","1669","0","62.31","32.77"
"64","000","00","005","0536","0996","913","547","366","42","955","1473","0","64.83","37.14"
"64","000","00","005","0537","0000","1575","767","808","63","1638","3558","0","46.04","21.56"
"64","000","00","005","0537","0997","923","426","497","34","957","1876","0","51.01","22.71"
"64","000","00","005","0537","0998","652","341","311","29","681","1682","0","40.49","20.27"
"64","000","00","005","0538","0000","6548","2960","3588","165","6713","11459","0","58.58","25.83"
"64","000","00","005","0538","0999","966","523","443","20","986","1791","0","55.05","29.2"
"64","000","00","005","0538","1000","1075","505","570","33","1108","1808","0","61.28","27.93"
"64","000","00","005","0538","1001","989","504","485","26","1015","1798","0","56.45","28.03"
"64","000","00","005","0538","1002","1175","509","666","34","1209","2030","0","59.56","25.07"
"64","000","00","005","0538","1003","1179","452","727","23","1202","2034","0","59.1","22.22"
"64","000","00","005","0538","1004","1164","467","697","29","1193","1998","0","59.71","23.37"
"64","000","00","005","0539","0000","2136","1065","1071","71","2207","3879","0","56.9","27.46"
"64","000","00","005","0539","1005","1046","511","535","34","1080","1914","0","56.43","26.7"
"64","000","00","005","0539","1006","1090","554","536","37","1127","1965","0","57.35","28.19"
"64","000","00","005","0540","0000","1041","541","500","67","1108","1885","0","58.78","28.7"
"64","000","00","005","0540","1007","1041","541","500","67","1108","1885","0","58.78","28.7"
"64","000","00","005","0541","0000","1386","693","693","67","1453","2277","0","63.81","30.43"
"64","000","00","005","0541","1008","782","352","430","20","802","1220","0","65.74","28.85"
"64","000","00","005","0541","1009","604","341","263","47","651","1057","0","61.59","32.26"
"64","000","00","005","0542","0000","1415","772","643","63","1478","2784","0","53.09","27.73"
"64","000","00","005","0542","1010","725","410","315","26","751","1434","0","52.37","28.59"
"64","000","00","005","0542","1011","690","362","328","37","727","1350","0","53.85","26.81"
"64","000","00","005","0543","0000","1009","586","423","37","1046","1826","0","57.28","32.09"
"64","000","00","005","0543","1012","485","299","186","18","503","872","0","57.68","34.29"
"64","000","00","005","0543","1013","524","287","237","19","543","954","0","56.92","30.08"
"64","000","00","005","0544","0000","2521","1276","1245","78","2599","4415","0","58.87","28.9"
"64","000","00","005","0544","1014","911","480","431","16","927","1689","0","54.88","28.42"
"64","000","00","005","0544","1015","808","388","420","23","831","1390","0","59.78","27.91"
"64","000","00","005","0544","1016","802","408","394","39","841","1336","0","62.95","30.54"
"64","000","00","005","0545","0000","2717","1384","1333","103","2820","4402","0","64.06","31.44"
"64","000","00","005","0545","1017","935","452","483","37","972","1437","0","67.64","31.45"
"64","000","00","005","0545","1018","882","467","415","22","904","1452","0","62.26","32.16"
"64","000","00","005","0545","1019","900","465","435","44","944","1513","0","62.39","30.73"
"64","000","00","005","0546","0000","1838","1039","799","87","1925","2848","0","67.59","36.48"
"64","000","00","005","0546","1020","926","537","389","49","975","1467","0","66.46","36.61"
"64","000","00","005","0546","1021","912","502","410","38","950","1381","0","68.79","36.35"
"64","000","00","005","0547","0000","1500","900","600","65","1565","2444","0","64.03","36.82"
"64","000","00","005","0547","1022","670","415","255","33","703","1117","0","62.94","37.15"
"64","000","00","005","0547","1023","830","485","345","32","862","1327","0","64.96","36.55"
"64","000","00","005","0548","0000","788","425","363","33","821","1304","0","62.96","32.59"
"64","000","00","005","0548","1024","788","425","363","33","821","1304","0","62.96","32.59"
"64","000","00","005","0549","0000","825","454","371","27","852","1483","0","57.45","30.61"
"64","000","00","005","0549","1025","825","454","371","27","852","1483","0","57.45","30.61"
"64","000","00","005","0550","0000","885","454","431","60","945","1473","0","64.15","30.82"
"64","000","00","005","0550","1026","885","454","431","60","945","1473","0","64.15","30.82"
"64","000","00","005","0551","0000","582","300","282","27","609","980","0","62.14","30.61"
"64","000","00","005","0551","1027","582","300","282","27","609","980","0","62.14","30.61"
"64","000","00","005","0552","0000","1589","936","653","72","1661","2639","0","62.94","35.47"
"64","000","00","005","0552","1028","850","538","312","33","883","1409","0","62.67","38.18"
"64","000","00","005","0552","1029","739","398","341","39","778","1230","0","63.25","32.36"
"64","000","00","005","0553","0000","1336","699","637","66","1402","2154","0","65.09","32.45"
"64","000","00","005","0553","1030","650","335","315","37","687","1024","0","67.09","32.71"
"64","000","00","005","0553","1031","686","364","322","29","715","1130","0","63.27","32.21"
"64","000","00","005","0554","0000","993","500","493","26","1019","1889","0","53.94","26.47"
"64","000","00","005","0554","1032","993","500","493","26","1019","1889","0","53.94","26.47"
"64","000","00","005","0555","0000","851","483","368","22","873","1427","0","61.18","33.85"
"64","000","00","005","0555","1033","851","483","368","22","873","1427","0","61.18","33.85"
"64","000","00","005","0556","0000","505","258","247","16","521","791","0","65.87","32.62"
"64","000","00","005","0556","1034","505","258","247","16","521","791","0","65.87","32.62"
"64","000","00","005","0557","0000","720","401","319","50","770","1079","0","71.36","37.16"
"64","000","00","005","0557","1035","720","401","319","50","770","1079","0","71.36","37.16"
"64","000","00","005","0558","0000","867","461","406","54","921","1492","0","61.73","30.9"
"64","000","00","005","0558","1036","867","461","406","54","921","1492","0","61.73","30.9"
"64","000","00","005","0559","0000","1273","660","613","41","1314","2021","0","65.02","32.66"
"64","000","00","005","0559","1037","639","340","299","32","671","1020","0","65.78","33.33"
"64","000","00","005","0559","1038","634","320","314","9","643","1001","0","64.24","31.97"
"64","000","00","005","0560","0000","1872","1012","860","52","1924","3052","0","63.04","33.16"
"64","000","00","005","0560","1039","985","554","431","28","1013","1581","0","64.07","35.04"
"64","000","00","005","0560","1040","887","458","429","24","911","1471","0","61.93","31.14"
"64","000","00","005","0561","0000","2309","1201","1108","91","2400","3760","0","63.83","31.94"
"64","000","00","005","0561","1041","722","396","326","18","740","1151","0","64.29","34.4"
"64","000","00","005","0561","1042","834","457","377","41","875","1334","0","65.59","34.26"
"64","000","00","005","0561","1043","753","348","405","32","785","1275","0","61.57","27.29"
"64","000","00","005","0562","0000","2224","1214","1010","88","2312","4051","0","57.07","29.97"
"64","000","00","005","0562","1044","731","399","332","27","758","1688","0","44.91","23.64"
"64","000","00","005","0562","1045","749","425","324","36","785","1214","0","64.66","35.01"
"64","000","00","005","0562","1046","744","390","354","25","769","1149","0","66.93","33.94"
"64","000","00","005","0563","0000","980","552","428","46","1026","1667","0","61.55","33.11"
"64","000","00","005","0563","1047","980","552","428","46","1026","1667","0","61.55","33.11"
"64","000","00","005","0564","0000","983","511","472","32","1015","1786","0","56.83","28.61"
"64","000","00","005","0564","1048","983","511","472","32","1015","1786","0","56.83","28.61"
"64","000","00","005","0565","0000","1124","607","517","44","1168","1821","0","64.14","33.33"
"64","000","00","005","0565","1049","557","317","240","21","578","896","0","64.51","35.38"
"64","000","00","005","0565","1050","567","290","277","23","590","925","0","63.78","31.35"
"64","000","00","005","0566","0000","449","263","186","31","480","684","0","70.18","38.45"
"64","000","00","005","0566","1051","449","263","186","31","480","684","0","70.18","38.45"
"64","000","00","005","0567","0000","634","376","258","35","669","981","0","68.2","38.33"
"64","000","00","005","0567","1052","634","376","258","35","669","981","0","68.2","38.33"
"64","000","00","005","0568","0000","738","416","322","41","779","1383","0","56.33","30.08"
"64","000","00","005","0568","1053","738","416","322","41","779","1383","0","56.33","30.08"
"64","000","00","005","0569","0000","829","429","400","39","868","1382","0","62.81","31.04"
"64","000","00","005","0569","1054","829","429","400","39","868","1382","0","62.81","31.04"
"64","000","00","005","0570","0000","473","274","199","18","491","808","0","60.77","33.91"
"64","000","00","005","0570","1055","473","274","199","18","491","808","0","60.77","33.91"
"64","000","00","005","0572","0000","755","398","357","19","774","1197","0","64.66","33.25"
"64","000","00","005","0572","1056","755","398","357","19","774","1197","0","64.66","33.25"
"64","000","00","005","0573","0000","2463","1289","1174","78","2541","4047","0","62.79","31.85"
"64","000","00","005","0573","1057","788","403","385","29","817","1344","0","60.79","29.99"
"64","000","00","005","0573","1058","839","457","382","37","876","1344","0","65.18","34.0"
"64","000","00","005","0573","1059","836","429","407","12","848","1359","0","62.4","31.57"
"64","000","00","005","0574","0000","664","337","327","27","691","1073","0","64.4","31.41"
"64","000","00","005","0574","1060","664","337","327","27","691","1073","0","64.4","31.41"
"64","000","00","005","0575","0000","653","325","328","26","679","1186","0","57.25","27.4"
"64","000","00","005","0575","1061","653","325","328","26","679","1186","0","57.25","27.4"
"64","000","00","005","0576","0000","1026","526","500","35","1061","1749","0","60.66","30.07"
"64","000","00","005","0576","1062","1026","526","500","35","1061","1749","0","60.66","30.07"
"64","000","00","005","0577","0000","531","318","213","8","539","877","0","61.46","36.26"
"64","000","00","005","0577","1063","531","318","213","8","539","877","0","61.46","36.26"
"64","000","00","005","0578","0000","888","507","381","45","933","1402","0","66.55","36.16"
"64","000","00","005","0578","1064","888","507","381","45","933","1402","0","66.55","36.16"
"64","000","00","005","0579","0000","499","249","250","17","516","769","0","67.1","32.38"
"64","000","00","005","0579","1065","499","249","250","17","516","769","0","67.1","32.38"
"64","000","00","005","0581","0000","1443","779","664","64","1507","2477","0","60.84","31.45"
"64","000","00","005","0581","1066","749","372","377","39","788","1207","0","65.29","30.82"
"64","000","00","005","0581","1067","694","407","287","25","719","1270","0","56.61","32.05"
"64","000","00","005","0582","0000","741","402","339","27","768","1248","0","61.54","32.21"
"64","000","00","005","0582","1068","741","402","339","27","768","1248","0","61.54","32.21"
"64","000","00","005","0583","0000","762","381","381","38","800","1263","0","63.34","30.17"
"64","000","00","005","0583","1069","762","381","381","38","800","1263","0","63.34","30.17"
"64","000","00","005","0584","0000","693","375","318","20","713","1101","0","64.76","34.06"
"64","000","00","005","0584","1070","693","375","318","20","713","1101","0","64.76","34.06"
"64","000","00","005","0585","0000","727","391","336","23","750","1116","0","67.2","35.04"
"64","000","00","005","0585","1071","727","391","336","23","750","1116","0","67.2","35.04"
"64","000","00","005","0586","0000","723","368","355","18","741","1152","0","64.32","31.94"
"64","000","00","005","0586","1072","723","368","355","18","741","1152","0","64.32","31.94"
"64","000","00","005","0587","0000","644","398","246","32","676","1057","0","63.95","37.65"
"64","000","00","005","0587","1073","644","398","246","32","676","1057","0","63.95","37.65"
"64","000","00","005","0588","0000","1179","673","506","46","1225","2033","0","60.26","33.1"
"64","000","00","005","0588","1074","547","315","232","31","578","971","0","59.53","32.44"
"64","000","00","005","0588","1075","632","358","274","15","647","1062","0","60.92","33.71"
"64","000","00","006","0000","0000","26892","13820","13072","965","27857","44355","50942","62.8","31.16"
"64","000","00","006","0601","0000","1104","519","585","41","1145","1791","0","63.93","28.98"
"64","000","00","006","0601","1098","487","231","256","14","501","828","0","60.51","27.9"
"64","000","00","006","0601","1099","617","288","329","27","644","963","0","66.87","29.91"
"64","000","00","006","0602","0000","612","304","308","21","633","1075","0","58.88","28.28"
"64","000","00","006","0602","1100","612","304","308","21","633","1075","0","58.88","28.28"
"64","000","00","006","0603","0000","1751","827","924","51","1802","2926","0","61.59","28.26"
"64","000","00","006","0603","1101","902","440","462","20","922","1488","0","61.96","29.57"
"64","000","00","006","0603","1102","849","387","462","31","880","1438","0","61.2","26.91"
"64","000","00","006","0604","0000","636","308","328","23","659","1049","0","62.82","29.36"
"64","000","00","006","0604","1103","636","308","328","23","659","1049","0","62.82","29.36"
"64","000","00","006","0605","0000","879","442","437","48","927","1378","0","67.27","32.08"
"64","000","00","006","0605","1104","879","442","437","48","927","1378","0","67.27","32.08"
"64","000","00","006","0606","0000","432","200","232","15","447","666","0","67.12","30.03"
"64","000","00","006","0606","1105","432","200","232","15","447","666","0","67.12","30.03"
"64","000","00","006","0607","0000","595","293","302","13","608","981","0","61.98","29.87"
"64","000","00","006","0607","1106","595","293","302","13","608","981","0","61.98","29.87"
"64","000","00","006","0608","0000","1174","671","503","50","1224","1920","0","63.75","34.95"
"64","000","00","006","0608","1107","597","384","213","27","624","933","0","66.88","41.16"
"64","000","00","006","0608","1108","577","287","290","23","600","987","0","60.79","29.08"
"64","000","00","006","0609","0000","633","337","296","18","651","988","0","65.89","34.11"
"64","000","00","006","0609","1109","633","337","296","18","651","988","0","65.89","34.11"
"64","000","00","006","0610","0000","487","251","236","13","500","735","0","68.03","34.15"
"64","000","00","006","0610","1110","487","251","236","13","500","735","0","68.03","34.15"
"64","000","00","006","0611","0000","798","387","411","26","824","1317","0","62.57","29.38"
"64","000","00","006","0611","1111","798","387","411","26","824","1317","0","62.57","29.38"
"64","000","00","006","0612","0000","465","239","226","5","470","800","0","58.75","29.88"
"64","000","00","006","0612","1112","465","239","226","5","470","800","0","58.75","29.88"
"64","000","00","006","0613","0000","1175","612","563","43","1218","1881","0","64.75","32.54"
"64","000","00","006","0613","1113","611","344","267","23","634","968","0","65.5","35.54"
"64","000","00","006","0613","1114","564","268","296","20","584","913","0","63.96","29.35"
"64","000","00","006","0614","0000","1710","869","841","45","1755","2617","0","67.06","33.21"
"64","000","00","006","0614","1115","894","455","439","21","915","1389","0","65.87","32.76"
"64","000","00","006","0614","1116","816","414","402","24","840","1228","0","68.4","33.71"
"64","000","00","006","0615","0000","1449","769","680","45","1494","2312","0","64.62","33.26"
"64","000","00","006","0615","1117","740","440","300","30","770","1211","0","63.58","36.33"
"64","000","00","006","0615","1118","709","329","380","15","724","1101","0","65.76","29.88"
"64","000","00","006","0616","0000","1075","559","516","43","1118","1625","0","68.8","34.4"
"64","000","00","006","0616","1119","482","250","232","11","493","752","0","65.56","33.24"
"64","000","00","006","0616","1120","593","309","284","32","625","873","0","71.59","35.4"
"64","000","00","006","0617","0000","2037","1022","1015","60","2097","3345","0","62.69","30.55"
"64","000","00","006","0617","1121","945","496","449","30","975","1609","0","60.6","30.83"
"64","000","00","006","0617","1122","1092","526","566","30","1122","1736","0","64.63","30.3"
"64","000","00","006","0618","0000","736","321","415","23","759","1258","0","60.33","25.52"
"64","000","00","006","0618","1123","736","321","415","23","759","1258","0","60.33","25.52"
"64","000","00","006","0619","0000","681","380","301","23","704","1105","0","63.71","34.39"
"64","000","00","006","0619","1124","681","380","301","23","704","1105","0","63.71","34.39"
"64","000","00","006","0620","0000","533","298","235","16","549","851","0","64.51","35.02"
"64","000","00","006","0620","1125","533","298","235","16","549","851","0","64.51","35.02"
"64","000","00","006","0621","0000","611","313","298","28","639","1011","0","63.2","30.96"
"64","000","00","006","0621","1126","611","313","298","28","639","1011","0","63.2","30.96"
"64","000","00","006","0622","0000","1229","700","529","51","1280","1893","0","67.62","36.98"
"64","000","00","006","0622","1127","603","353","250","31","634","888","0","71.4","39.75"
"64","000","00","006","0622","1128","626","347","279","20","646","1005","0","64.28","34.53"
"64","000","00","006","0623","0000","1473","701","772","45","1518","2763","0","54.94","25.37"
"64","000","00","006","0623","1129","637","305","332","14","651","1375","0","47.35","22.18"
"64","000","00","006","0623","1130","836","396","440","31","867","1388","0","62.46","28.53"
"64","000","00","006","0624","0000","416","224","192","33","449","719","0","62.45","31.15"
"64","000","00","006","0624","1131","416","224","192","33","449","719","0","62.45","31.15"
"64","000","00","006","0625","0000","624","326","298","45","669","1077","0","62.12","30.27"
"64","000","00","006","0625","1132","624","326","298","45","669","1077","0","62.12","30.27"
"64","000","00","006","0626","0000","463","281","182","18","481","875","0","54.97","32.11"
"64","000","00","006","0626","1133","463","281","182","18","481","875","0","54.97","32.11"
"64","000","00","006","0627","0000","524","275","249","21","545","936","0","58.23","29.38"
"64","000","00","006","0627","1134","524","275","249","21","545","936","0","58.23","29.38"
"64","000","00","006","0628","0000","544","302","242","29","573","944","0","60.7","31.99"
"64","000","00","006","0628","1135","544","302","242","29","573","944","0","60.7","31.99"
"64","000","00","006","0629","0000","490","246","244","17","507","833","0","60.86","29.53"
"64","000","00","006","0629","1136","490","246","244","17","507","833","0","60.86","29.53"
"64","000","00","006","0630","0000","443","245","198","18","461","708","0","65.11","34.6"
"64","000","00","006","0630","1137","443","245","198","18","461","708","0","65.11","34.6"
"64","000","00","006","0631","0000","430","195","235","15","445","741","0","60.05","26.32"
"64","000","00","006","0631","1138","430","195","235","15","445","741","0","60.05","26.32"
"64","000","00","006","0632","0000","683","404","279","23","706","1235","0","57.17","32.71"
"64","000","00","006","0632","1139","683","404","279","23","706","1235","0","57.17","32.71"
"64","000","00","007","0000","0000","14427","7305","7122","499","14926","23928","26732","62.38","30.53"
"64","000","00","007","0701","0000","400","263","137","14","414","673","0","61.52","39.08"
"64","000","00","007","0701","1076","400","263","137","14","414","673","0","61.52","39.08"
"64","000","00","007","0702","0000","636","283","353","17","653","1022","0","63.89","27.69"
"64","000","00","007","0702","1077","636","283","353","17","653","1022","0","63.89","27.69"
"64","000","00","007","0703","0000","772","447","325","21","793","1324","0","59.89","33.76"
"64","000","00","007","0703","1078","772","447","325","21","793","1324","0","59.89","33.76"
"64","000","00","007","0704","0000","502","287","215","21","523","839","0","62.34","34.21"
"64","000","00","007","0704","1079","502","287","215","21","523","839","0","62.34","34.21"
"64","000","00","007","0705","0000","580","330","250","33","613","975","0","62.87","33.85"
"64","000","00","007","0705","1080","580","330","250","33","613","975","0","62.87","33.85"
"64","000","00","007","0706","0000","2143","1010","1133","61","2204","3587","0","61.44","28.16"
"64","000","00","007","0706","1081","1042","472","570","40","1082","1806","0","59.91","26.14"
"64","000","00","007","0706","1082","1101","538","563","21","1122","1781","0","63.0","30.21"
"64","000","00","007","0707","0000","451","228","223","18","469","717","0","65.41","31.8"
"64","000","00","007","0707","1083","451","228","223","18","469","717","0","65.41","31.8"
"64","000","00","007","0708","0000","670","348","322","10","680","1097","0","61.99","31.72"
"64","000","00","007","0708","1084","670","348","322","10","680","1097","0","61.99","31.72"
"64","000","00","007","0709","0000","945","487","458","25","970","1633","0","59.4","29.82"
"64","000","00","007","0709","1085","945","487","458","25","970","1633","0","59.4","29.82"
"64","000","00","007","0710","0000","512","267","245","18","530","759","0","69.83","35.18"
"64","000","00","007","0710","1086","512","267","245","18","530","759","0","69.83","35.18"
"64","000","00","007","0711","0000","602","292","310","33","635","948","0","66.98","30.8"
"64","000","00","007","0711","1087","602","292","310","33","635","948","0","66.98","30.8"
"64","000","00","007","0712","0000","521","296","225","35","556","1009","0","55.1","29.34"
"64","000","00","007","0712","1088","521","296","225","35","556","1009","0","55.1","29.34"
"64","000","00","007","0713","0000","584","299","285","23","607","945","0","64.23","31.64"
"64","000","00","007","0713","1089","584","299","285","23","607","945","0","64.23","31.64"
"64","000","00","007","0714","0000","963","457","506","32","995","1529","0","65.08","29.89"
"64","000","00","007","0714","1090","482","232","250","16","498","772","0","64.51","30.05"
"64","000","00","007","0714","1091","481","225","256","16","497","757","0","65.65","29.72"
"64","000","00","007","0715","0000","659","322","337","23","682","1047","0","65.14","30.75"
"64","000","00","007","0715","1092","659","322","337","23","682","1047","0","65.14","30.75"
"64","000","00","007","0716","0000","612","300","312","22","634","985","0","64.37","30.46"
"64","000","00","007","0716","1093","612","300","312","22","634","985","0","64.37","30.46"
"64","000","00","007","0717","0000","961","446","515","16","977","1674","0","58.36","26.64"
"64","000","00","007","0717","1094","961","446","515","16","977","1674","0","58.36","26.64"
"64","000","00","007","0718","0000","650","303","347","15","665","1088","0","61.12","27.85"
"64","000","00","007","0718","1095","650","303","347","15","665","1088","0","61.12","27.85"
"64","000","00","007","0719","0000","582","304","278","36","618","893","0","69.2","34.04"
"64","000","00","007","0719","1096","582","304","278","36","618","893","0","69.2","34.04"
"64","000","00","007","0720","0000","682","336","346","26","708","1184","0","59.8","28.38"
"64","000","00","007","0720","1097","682","336","346","26","708","1184","0","59.8","28.38"
"64","000","00","008","0000","0000","88923","43358","45565","3225","92148","146786","169840","62.78","29.54"
"64","000","00","008","0801","0000","452","220","232","16","468","718","0","65.18","30.64"
"64","000","00","008","0801","1140","452","220","232","16","468","718","0","65.18","30.64"
"64","000","00","008","0802","0000","860","379","481","29","889","1492","0","59.58","25.4"
"64","000","00","008","0802","1141","860","379","481","29","889","1492","0","59.58","25.4"
"64","000","00","008","0803","0000","731","377","354","28","759","1210","0","62.73","31.16"
"64","000","00","008","0803","1142","731","377","354","28","759","1210","0","62.73","31.16"
"64","000","00","008","0804","0000","902","460","442","28","930","1617","0","57.51","28.45"
"64","000","00","008","0804","1143","902","460","442","28","930","1617","0","57.51","28.45"
"64","000","00","008","0805","0000","871","393","478","37","908","1428","0","63.59","27.52"
"64","000","00","008","0805","1144","871","393","478","37","908","1428","0","63.59","27.52"
"64","000","00","008","0806","0000","791","420","371","24","815","1444","0","56.44","29.09"
"64","000","00","008","0806","1145","791","420","371","24","815","1444","0","56.44","29.09"
"64","000","00","008","0807","0000","827","398","429","49","876","1452","0","60.33","27.41"
"64","000","00","008","0807","1146","827","398","429","49","876","1452","0","60.33","27.41"
"64","000","00","008","0808","0000","343","192","151","20","363","554","0","65.52","34.66"
"64","000","00","008","0808","1147","343","192","151","20","363","554","0","65.52","34.66"
"64","000","00","008","0809","0000","1097","551","546","24","1121","1928","0","58.14","28.58"
"64","000","00","008","0809","1148","553","272","281","12","565","950","0","59.47","28.63"
"64","000","00","008","0809","1149","544","279","265","12","556","978","0","56.85","28.53"
"64","000","00","008","0810","0000","1993","914","1079","70","2063","3718","0","55.49","24.58"
"64","000","00","008","0810","1150","913","438","475","29","942","1673","0","56.31","26.18"
"64","000","00","008","0810","1151","1080","476","604","41","1121","2045","0","54.82","23.28"
"64","000","00","008","0811","0000","577","291","286","34","611","939","0","65.07","30.99"
"64","000","00","008","0811","1152","577","291","286","34","611","939","0","65.07","30.99"
"64","000","00","008","0812","0000","692","335","357","28","720","1284","0","56.07","26.09"
"64","000","00","008","0812","1153","692","335","357","28","720","1284","0","56.07","26.09"
"64","000","00","008","0813","0000","1037","550","487","40","1077","1746","0","61.68","31.5"
"64","000","00","008","0813","1154","559","298","261","24","583","908","0","64.21","32.82"
"64","000","00","008","0813","1155","478","252","226","16","494","838","0","58.95","30.07"
"64","000","00","008","0814","0000","776","362","414","19","795","1267","0","62.75","28.57"
"64","000","00","008","0814","1156","776","362","414","19","795","1267","0","62.75","28.57"
"64","000","00","008","0815","0000","1112","598","514","47","1159","1768","0","65.55","33.82"
"64","000","00","008","0815","1157","649","337","312","31","680","994","0","68.41","33.9"
"64","000","00","008","0815","1158","463","261","202","16","479","774","0","61.89","33.72"
"64","000","00","008","0816","0000","684","343","341","20","704","1121","0","62.8","30.6"
"64","000","00","008","0816","1159","684","343","341","20","704","1121","0","62.8","30.6"
"64","000","00","008","0817","0000","1788","901","887","72","1860","2999","0","62.02","30.04"
"64","000","00","008","0817","1160","882","472","410","33","915","1474","0","62.08","32.02"
"64","000","00","008","0817","1161","906","429","477","39","945","1525","0","61.97","28.13"
"64","000","00","008","0818","0000","1351","704","647","55","1406","2161","0","65.06","32.58"
"64","000","00","008","0818","1162","700","386","314","34","734","1147","0","63.99","33.65"
"64","000","00","008","0818","1163","651","318","333","21","672","1014","0","66.27","31.36"
"64","000","00","008","0819","0000","1823","913","910","70","1893","2995","0","63.21","30.48"
"64","000","00","008","0819","1164","911","499","412","26","937","1496","0","62.63","33.36"
"64","000","00","008","0819","1165","912","414","498","44","956","1499","0","63.78","27.62"
"64","000","00","008","0820","0000","1281","658","623","40","1321","1977","0","66.82","33.28"
"64","000","00","008","0820","1166","709","346","363","23","732","1138","0","64.32","30.4"
"64","000","00","008","0820","1167","572","312","260","17","589","839","0","70.2","37.19"
"64","000","00","008","0821","0000","744","375","369","32","776","2088","0","37.16","17.96"
"64","000","00","008","0821","1168","744","375","369","32","776","2088","0","37.16","17.96"
"64","000","00","008","0822","0000","1945","906","1039","57","2002","3271","0","61.2","27.7"
"64","000","00","008","0822","1169","1015","473","542","22","1037","1648","0","62.92","28.7"
"64","000","00","008","0822","1170","930","433","497","35","965","1623","0","59.46","26.68"
"64","000","00","008","0823","0000","1231","576","655","36","1267","1932","0","65.58","29.81"
"64","000","00","008","0823","1171","1231","576","655","36","1267","1932","0","65.58","29.81"
"64","000","00","008","0824","0000","1575","698","877","35","1610","2283","0","70.52","30.57"
"64","000","00","008","0824","1172","775","328","447","17","792","1127","0","70.28","29.1"
"64","000","00","008","0824","1173","800","370","430","18","818","1156","0","70.76","32.01"
"64","000","00","008","0825","0000","936","406","530","30","966","1465","0","65.94","27.71"
"64","000","00","008","0825","1174","936","406","530","30","966","1465","0","65.94","27.71"
"64","000","00","008","0826","0000","385","228","157","15","400","690","0","57.97","33.04"
"64","000","00","008","0826","1175","385","228","157","15","400","690","0","57.97","33.04"
"64","000","00","008","0827","0000","733","619","114","52","785","1283","0","61.18","48.25"
"64","000","00","008","0827","1176","733","619","114","52","785","1283","0","61.18","48.25"
"64","000","00","008","0828","0000","1648","830","818","70","1718","2745","0","62.59","30.24"
"64","000","00","008","0828","1177","844","435","409","51","895","1432","0","62.5","30.38"
"64","000","00","008","0828","1178","804","395","409","19","823","1313","0","62.68","30.08"
"64","000","00","008","0829","0000","909","440","469","16","925","1579","0","58.58","27.87"
"64","000","00","008","0829","1179","909","440","469","16","925","1579","0","58.58","27.87"
"64","000","00","008","0830","0000","1721","829","892","87","1808","2834","0","63.8","29.25"
"64","000","00","008","0830","1180","843","441","402","50","893","1385","0","64.48","31.84"
"64","000","00","008","0830","1181","878","388","490","37","915","1449","0","63.15","26.78"
"64","000","00","008","0831","0000","1151","468","683","36","1187","1834","0","64.72","25.52"
"64","000","00","008","0831","1182","1151","468","683","36","1187","1834","0","64.72","25.52"
"64","000","00","008","0832","0000","1804","817","987","56","1860","2867","0","64.88","28.5"
"64","000","00","008","0832","1183","910","439","471","23","933","1436","0","64.97","30.57"
"64","000","00","008","0832","1184","894","378","516","33","927","1431","0","64.78","26.42"
"64","000","00","008","0833","0000","1731","780","951","52","1783","2718","0","65.6","28.7"
"64","000","00","008","0833","1185","801","366","435","29","830","1248","0","66.51","29.33"
"64","000","00","008","0833","1186","930","414","516","23","953","1470","0","64.83","28.16"
"64","000","00","008","0834","0000","987","495","492","45","1032","1540","0","67.01","32.14"
"64","000","00","008","0834","1187","987","495","492","45","1032","1540","0","67.01","32.14"
"64","000","00","008","0835","0000","1428","622","806","35","1463","2213","0","66.11","28.11"
"64","000","00","008","0835","1188","878","390","488","21","899","1374","0","65.43","28.38"
"64","000","00","008","0835","1189","550","232","318","14","564","839","0","67.22","27.65"
"64","000","00","008","0836","0000","1357","579","778","41","1398","2084","0","67.08","27.78"
"64","000","00","008","0836","1190","683","294","389","29","712","1022","0","69.67","28.77"
"64","000","00","008","0836","1191","674","285","389","12","686","1062","0","64.6","26.84"
"64","000","00","008","0837","0000","1413","691","722","36","1449","2195","0","66.01","31.48"
"64","000","00","008","0837","1192","690","326","364","18","708","1078","0","65.68","30.24"
"64","000","00","008","0837","1193","723","365","358","18","741","1117","0","66.34","32.68"
"64","000","00","008","0838","0000","969","429","540","37","1006","1516","0","66.36","28.3"
"64","000","00","008","0838","1194","969","429","540","37","1006","1516","0","66.36","28.3"
"64","000","00","008","0839","0000","847","482","365","57","904","1440","0","62.78","33.47"
"64","000","00","008","0839","1195","847","482","365","57","904","1440","0","62.78","33.47"
"64","000","00","008","0840","0000","1044","574","470","43","1087","1727","0","62.94","33.24"
"64","000","00","008","0840","1196","515","292","223","20","535","839","0","63.77","34.8"
"64","000","00","008","0840","1197","529","282","247","23","552","888","0","62.16","31.76"
"64","000","00","008","0841","0000","1406","686","720","57","1463","2105","0","69.5","32.59"
"64","000","00","008","0841","1198","715","363","352","26","741","1101","0","67.3","32.97"
"64","000","00","008","0841","1199","691","323","368","31","722","1004","0","71.91","32.17"
"64","000","00","008","0842","0000","2381","1136","1245","68","2449","3779","0","64.81","30.06"
"64","000","00","008","0842","1200","877","436","441","27","904","1427","0","63.35","30.55"
"64","000","00","008","0842","1201","729","361","368","12","741","1168","0","63.44","30.91"
"64","000","00","008","0842","1202","775","339","436","29","804","1184","0","67.91","28.63"
"64","000","00","008","0843","0000","1101","520","581","35","1136","1823","0","62.31","28.52"
"64","000","00","008","0843","1203","613","272","341","25","638","974","0","65.5","27.93"
"64","000","00","008","0843","1204","488","248","240","10","498","849","0","58.66","29.21"
"64","000","00","008","0844","0000","1116","503","613","33","1149","1821","0","63.1","27.62"
"64","000","00","008","0844","1205","1116","503","613","33","1149","1821","0","63.1","27.62"
"64","000","00","008","0845","0000","2397","1110","1287","87","2484","3906","0","63.59","28.42"
"64","000","00","008","0845","1206","802","341","461","32","834","1306","0","63.86","26.11"
"64","000","00","008","0845","1207","750","357","393","28","778","1185","0","65.65","30.13"
"64","000","00","008","0845","1208","845","412","433","27","872","1415","0","61.63","29.12"
"64","000","00","008","0846","0000","1190","603","587","65","1255","1926","0","65.16","31.31"
"64","000","00","008","0846","1209","623","313","310","30","653","962","0","67.88","32.54"
"64","000","00","008","0846","1210","567","290","277","35","602","964","0","62.45","30.08"
"64","000","00","008","0847","0000","914","372","542","38","952","1524","0","62.47","24.41"
"64","000","00","008","0847","1211","914","372","542","38","952","1524","0","62.47","24.41"
"64","000","00","008","0848","0000","916","456","460","25","941","1455","0","64.67","31.34"
"64","000","00","008","0848","1212","916","456","460","25","941","1455","0","64.67","31.34"
"64","000","00","008","0849","0000","1463","781","682","32","1495","2528","0","59.14","30.89"
"64","000","00","008","0849","1213","712","374","338","18","730","1272","0","57.39","29.4"
"64","000","00","008","0849","1214","751","407","344","14","765","1256","0","60.91","32.4"
"64","000","00","008","0850","0000","701","282","419","17","718","1203","0","59.68","23.44"
"64","000","00","008","0850","1215","701","282","419","17","718","1203","0","59.68","23.44"
"64","000","00","008","0851","0000","677","288","389","23","700","1062","0","65.91","27.12"
"64","000","00","008","0851","1216","677","288","389","23","700","1062","0","65.91","27.12"
"64","000","00","008","0852","0000","1261","691","570","78","1339","1860","0","71.99","37.15"
"64","000","00","008","0852","1217","541","311","230","31","572","850","0","67.29","36.59"
"64","000","00","008","0852","1218","720","380","340","47","767","1010","0","75.94","37.62"
"64","000","00","008","0853","0000","1262","621","641","37","1299","2055","0","63.21","30.22"
"64","000","00","008","0853","1219","661","337","324","20","681","1118","0","60.91","30.14"
"64","000","00","008","0853","1220","601","284","317","17","618","937","0","65.96","30.31"
"64","000","00","008","0854","0000","1561","776","785","54","1615","2676","0","60.35","29.0"
"64","000","00","008","0854","1221","834","442","392","23","857","1493","0","57.4","29.6"
"64","000","00","008","0854","1222","727","334","393","31","758","1183","0","64.07","28.23"
"64","000","00","008","0855","0000","1488","806","682","65","1553","2680","0","57.95","30.07"
"64","000","00","008","0855","1223","688","381","307","31","719","1318","0","54.55","28.91"
"64","000","00","008","0855","1224","800","425","375","34","834","1362","0","61.23","31.2"
"64","000","00","008","0856","0000","1507","749","758","81","1588","2583","0","61.48","29.0"
"64","000","00","008","0856","1225","638","343","295","47","685","1102","0","62.16","31.13"
"64","000","00","008","0856","1226","869","406","463","34","903","1481","0","60.97","27.41"
"64","000","00","008","0857","0000","1076","567","509","43","1119","1786","0","62.65","31.75"
"64","000","00","008","0857","1227","553","294","259","32","585","878","0","66.63","33.49"
"64","000","00","008","0857","1228","523","273","250","11","534","908","0","58.81","30.07"
"64","000","00","008","0858","0000","1318","613","705","42","1360","2147","0","63.34","28.55"
"64","000","00","008","0858","1229","681","318","363","23","704","1056","0","66.67","30.11"
"64","000","00","008","0858","1230","637","295","342","19","656","1091","0","60.13","27.04"
"64","000","00","008","0859","0000","1323","692","631","43","1366","2039","0","66.99","33.94"
"64","000","00","008","0859","1231","624","315","309","20","644","976","0","65.98","32.27"
"64","000","00","008","0859","1232","699","377","322","23","722","1063","0","67.92","35.47"
"64","000","00","008","0860","0000","1703","806","897","67","1770","2774","0","63.81","29.06"
"64","000","00","008","0860","1233","905","395","510","43","948","1484","0","63.88","26.62"
"64","000","00","008","0860","1234","798","411","387","24","822","1290","0","63.72","31.86"
"64","000","00","008","0861","0000","2945","1345","1600","98","3043","4982","0","61.08","27.0"
"64","000","00","008","0861","1235","1045","467","578","42","1087","1740","0","62.47","26.84"
"64","000","00","008","0861","1236","947","440","507","36","983","1594","0","61.67","27.6"
"64","000","00","008","0861","1237","953","438","515","20","973","1648","0","59.04","26.58"
"64","000","00","008","0862","0000","2315","1110","1205","71","2386","3730","0","63.97","29.76"
"64","000","00","008","0862","1238","797","346","451","23","820","1236","0","66.34","27.99"
"64","000","00","008","0862","1239","740","370","370","29","769","1211","0","63.5","30.55"
"64","000","00","008","0862","1240","778","394","384","19","797","1283","0","62.12","30.71"
"64","000","00","008","0863","0000","2167","1039","1128","94","2261","3522","0","64.2","29.5"
"64","000","00","008","0863","1241","1130","553","577","47","1177","1804","0","65.24","30.65"
"64","000","00","008","0863","1242","1037","486","551","47","1084","1718","0","63.1","28.29"
"64","000","00","008","0864","0000","2468","1182","1286","91","2559","4053","0","63.14","29.16"
"64","000","00","008","0864","1243","801","381","420","34","835","1297","0","64.38","29.38"
"64","000","00","008","0864","1244","872","401","471","29","901","1449","0","62.18","27.67"
"64","000","00","008","0864","1245","795","400","395","28","823","1307","0","62.97","30.6"
"64","000","00","008","0865","0000","1532","787","745","67","1599","2434","0","65.69","32.33"
"64","000","00","008","0865","1246","733","370","363","26","759","1184","0","64.1","31.25"
"64","000","00","008","0865","1247","799","417","382","41","840","1250","0","67.2","33.36"
"64","000","00","008","0866","0000","1511","712","799","47","1558","2531","0","61.56","28.13"
"64","000","00","008","0866","1248","725","348","377","22","747","1248","0","59.86","27.88"
"64","000","00","008","0866","1249","786","364","422","25","811","1283","0","63.21","28.37"
"64","000","00","008","0867","0000","2358","1195","1163","58","2416","3718","0","64.98","32.14"
"64","000","00","008","0867","1250","738","380","358","18","756","1121","0","67.44","33.9"
"64","000","00","008","0867","1251","784","394","390","19","803","1258","0","63.83","31.32"
"64","000","00","008","0867","1252","836","421","415","21","857","1339","0","64.0","31.44"
"64","000","00","008","0868","0000","1113","553","560","48","1161","1986","0","58.46","27.84"
"64","000","00","008","0868","1253","1113","553","560","48","1161","1986","0","58.46","27.84"
"64","000","00","008","0869","0000","1207","574","633","43","1250","1976","0","63.26","29.05"
"64","000","00","008","0869","1254","623","296","327","24","647","1028","0","62.94","28.79"
"64","000","00","008","0869","1255","584","278","306","19","603","948","0","63.61","29.32"
"64","000","00","009","0000","0000","92797","45971","46826","4128","96925","161797","188516","59.91","28.41"
"64","000","00","009","0901","0000","4649","2370","2279","239","4888","9323","0","52.43","25.42"
"64","000","00","009","0901","1484","932","412","520","80","1012","1809","0","55.94","22.78"
"64","000","00","009","0901","1485","968","511","457","44","1012","1835","0","55.15","27.85"
"64","000","00","009","0901","1486","811","412","399","33","844","1890","0","44.66","21.8"
"64","000","00","009","0901","1487","1015","555","460","36","1051","2013","0","52.21","27.57"
"64","000","00","009","0901","1488","923","480","443","46","969","1776","0","54.56","27.03"
"64","000","00","009","0902","0000","1197","666","531","67","1264","2377","0","53.18","28.02"
"64","000","00","009","0902","1489","805","460","345","37","842","1705","0","49.38","26.98"
"64","000","00","009","0902","1490","392","206","186","30","422","672","0","62.8","30.65"
"64","000","00","009","0903","0000","2696","1462","1234","118","2814","5013","0","56.13","29.16"
"64","000","00","009","0903","1491","834","419","415","34","868","1726","0","50.29","24.28"
"64","000","00","009","0903","1492","925","519","406","24","949","1597","0","59.42","32.5"
"64","000","00","009","0903","1493","937","524","413","60","997","1690","0","58.99","31.01"
"64","000","00","009","0904","0000","1387","710","677","78","1465","2239","0","65.43","31.71"
"64","000","00","009","0904","1494","645","290","355","45","690","1080","0","63.89","26.85"
"64","000","00","009","0904","1495","742","420","322","33","775","1159","0","66.87","36.24"
"64","000","00","009","0905","0000","725","436","289","42","767","1314","0","58.37","33.18"
"64","000","00","009","0905","1496","725","436","289","42","767","1314","0","58.37","33.18"
"64","000","00","009","0906","0000","1115","539","576","63","1178","1898","0","62.07","28.4"
"64","000","00","009","0906","1497","546","283","263","28","574","896","0","64.06","31.58"
"64","000","00","009","0906","1498","569","256","313","35","604","1002","0","60.28","25.55"
"64","000","00","009","0907","0000","1029","540","489","60","1089","2765","0","39.39","19.53"
"64","000","00","009","0907","1499","1029","540","489","60","1089","2765","0","39.39","19.53"
"64","000","00","009","0908","0000","363","216","147","28","391","600","0","65.17","36.0"
"64","000","00","009","0908","1500","363","216","147","28","391","600","0","65.17","36.0"
"64","000","00","009","0909","0000","583","364","219","18","601","1466","0","41.0","24.83"
"64","000","00","009","0909","1501","583","364","219","18","601","1466","0","41.0","24.83"
"64","000","00","009","0910","0000","835","487","348","39","874","1449","0","60.32","33.61"
"64","000","00","009","0910","1502","835","487","348","39","874","1449","0","60.32","33.61"
"64","000","00","009","0911","0000","1298","678","620","63","1361","2239","0","60.79","30.28"
"64","000","00","009","0911","1503","557","305","252","26","583","991","0","58.83","30.78"
"64","000","00","009","0911","1504","741","373","368","37","778","1248","0","62.34","29.89"
"64","000","00","009","0912","0000","635","383","252","48","683","1066","0","64.07","35.93"
"64","000","00","009","0912","1505","635","383","252","48","683","1066","0","64.07","35.93"
"64","000","00","009","0913","0000","409","247","162","21","430","706","0","60.91","34.99"
"64","000","00","009","0913","1506","409","247","162","21","430","706","0","60.91","34.99"
"64","000","00","009","0914","0000","415","240","175","15","430","713","0","60.31","33.66"
"64","000","00","009","0914","1507","415","240","175","15","430","713","0","60.31","33.66"
"64","000","00","009","0915","0000","735","456","279","31","766","1344","0","56.99","33.93"
"64","000","00","009","0915","1508","735","456","279","31","766","1344","0","56.99","33.93"
"64","000","00","009","0916","0000","1002","581","421","57","1059","1729","0","61.25","33.6"
"64","000","00","009","0916","1509","514","291","223","26","540","856","0","63.08","34.0"
"64","000","00","009","0916","1510","488","290","198","31","519","873","0","59.45","33.22"
"64","000","00","009","0917","0000","1204","700","504","55","1259","2226","0","56.56","31.45"
"64","000","00","009","0917","1511","618","360","258","36","654","1114","0","58.71","32.32"
"64","000","00","009","0917","1512","586","340","246","19","605","1112","0","54.41","30.58"
"64","000","00","009","0918","0000","1089","611","478","55","1144","1984","0","57.66","30.8"
"64","000","00","009","0918","1513","585","315","270","32","617","1044","0","59.1","30.17"
"64","000","00","009","0918","1514","504","296","208","23","527","940","0","56.06","31.49"
"64","000","00","009","0919","0000","2374","1159","1215","109","2483","4064","0","61.1","28.52"
"64","000","00","009","0919","1515","680","360","320","49","729","1342","0","54.32","26.83"
"64","000","00","009","0919","1516","891","446","445","38","929","1402","0","66.26","31.81"
"64","000","00","009","0919","1517","803","353","450","22","825","1320","0","62.5","26.74"
"64","000","00","009","0920","0000","562","306","256","21","583","958","0","60.86","31.94"
"64","000","00","009","0920","1518","562","306","256","21","583","958","0","60.86","31.94"
"64","000","00","009","0921","0000","1711","774","937","92","1803","2735","0","65.92","28.3"
"64","000","00","009","0921","1519","848","361","487","37","885","1276","0","69.36","28.29"
"64","000","00","009","0921","1520","863","413","450","55","918","1459","0","62.92","28.31"
"64","000","00","009","0922","0000","410","251","159","25","435","761","0","57.16","32.98"
"64","000","00","009","0922","1521","410","251","159","25","435","761","0","57.16","32.98"
"64","000","00","009","0923","0000","642","352","290","18","660","1093","0","60.38","32.2"
"64","000","00","009","0923","1522","642","352","290","18","660","1093","0","60.38","32.2"
"64","000","00","009","0924","0000","2849","849","2000","86","2935","4899","0","59.91","17.33"
"64","000","00","009","0924","1523","940","226","714","31","971","1521","0","63.84","14.86"
"64","000","00","009","0924","1524","941","254","687","28","969","1557","0","62.24","16.31"
"64","000","00","009","0924","1525","968","369","599","27","995","1821","0","54.64","20.26"
"64","000","00","009","0925","0000","1358","336","1022","59","1417","2112","0","67.09","15.91"
"64","000","00","009","0925","1526","697","176","521","40","737","1066","0","69.14","16.51"
"64","000","00","009","0925","1527","661","160","501","19","680","1046","0","65.01","15.3"
"64","000","00","009","0928","0000","2008","894","1114","77","2085","3432","0","60.75","26.05"
"64","000","00","009","0928","1528","980","473","507","40","1020","1709","0","59.68","27.68"
"64","000","00","009","0928","1529","1028","421","607","37","1065","1723","0","61.81","24.43"
"64","000","00","009","0929","0000","2577","1116","1461","73","2650","3994","0","66.35","27.94"
"64","000","00","009","0929","1530","771","364","407","24","795","1202","0","66.14","30.28"
"64","000","00","009","0929","1531","852","404","448","26","878","1279","0","68.65","31.59"
"64","000","00","009","0929","1532","954","348","606","23","977","1513","0","64.57","23.0"
"64","000","00","009","0930","0000","762","330","432","23","785","1260","0","62.3","26.19"
"64","000","00","009","0930","1533","762","330","432","23","785","1260","0","62.3","26.19"
"64","000","00","009","0931","0000","1446","679","767","86","1532","2279","0","67.22","29.79"
"64","000","00","009","0931","1534","708","346","362","58","766","1139","0","67.25","30.38"
"64","000","00","009","0931","1535","738","333","405","28","766","1140","0","67.19","29.21"
"64","000","00","009","0932","0000","1713","770","943","68","1781","2821","0","63.13","27.3"
"64","000","00","009","0932","1536","883","422","461","42","925","1462","0","63.27","28.86"
"64","000","00","009","0932","1537","830","348","482","26","856","1359","0","62.99","25.61"
"64","000","00","009","0933","0000","1042","538","504","52","1094","2037","0","53.71","26.41"
"64","000","00","009","0933","1538","1042","538","504","52","1094","2037","0","53.71","26.41"
"64","000","00","009","0934","0000","1552","687","865","31","1583","2717","0","58.26","25.29"
"64","000","00","009","0934","1539","803","340","463","10","813","1410","0","57.66","24.11"
"64","000","00","009","0934","1540","749","347","402","21","770","1307","0","58.91","26.55"
"64","000","00","009","0935","0000","1727","843","884","91","1818","3003","0","60.54","28.07"
"64","000","00","009","0935","1541","856","425","431","46","902","1512","0","59.66","28.11"
"64","000","00","009","0935","1542","871","418","453","45","916","1491","0","61.44","28.03"
"64","000","00","009","0936","0000","1724","821","903","62","1786","3143","0","56.82","26.12"
"64","000","00","009","0936","1543","928","447","481","36","964","1621","0","59.47","27.58"
"64","000","00","009","0936","1544","796","374","422","26","822","1522","0","54.01","24.57"
"64","000","00","009","0937","0000","3198","1514","1684","124","3322","5348","0","62.12","28.31"
"64","000","00","009","0937","1545","945","489","456","36","981","1593","0","61.58","30.7"
"64","000","00","009","0937","1546","1138","538","600","32","1170","1885","0","62.07","28.54"
"64","000","00","009","0937","1547","1115","487","628","56","1171","1870","0","62.62","26.04"
"64","000","00","009","0938","0000","1627","719","908","67","1694","2736","0","61.92","26.28"
"64","000","00","009","0938","1548","827","363","464","23","850","1388","0","61.24","26.15"
"64","000","00","009","0938","1549","800","356","444","44","844","1348","0","62.61","26.41"
"64","000","00","009","0939","0000","1619","812","807","78","1697","2705","0","62.74","30.02"
"64","000","00","009","0939","1550","749","402","347","50","799","1341","0","59.58","29.98"
"64","000","00","009","0939","1551","870","410","460","28","898","1364","0","65.84","30.06"
"64","000","00","009","0940","0000","1586","857","729","75","1661","2693","0","61.68","31.82"
"64","000","00","009","0940","1552","803","415","388","38","841","1367","0","61.52","30.36"
"64","000","00","009","0940","1553","783","442","341","37","820","1326","0","61.84","33.33"
"64","000","00","009","0941","0000","1299","658","641","54","1353","2178","0","62.12","30.21"
"64","000","00","009","0941","1554","614","323","291","29","643","1059","0","60.72","30.5"
"64","000","00","009","0941","1555","685","335","350","25","710","1119","0","63.45","29.94"
"64","000","00","009","0942","0000","3918","1801","2117","121","4039","6642","0","60.81","27.12"
"64","000","00","009","0942","1556","882","471","411","30","912","1565","0","58.27","30.1"
"64","000","00","009","0942","1557","887","413","474","43","930","1549","0","60.04","26.66"
"64","000","00","009","0942","1558","1080","459","621","27","1107","1691","0","65.46","27.14"
"64","000","00","009","0942","1559","1069","458","611","21","1090","1837","0","59.34","24.93"
"64","000","00","009","0943","0000","1391","702","689","49","1440","2218","0","64.92","31.65"
"64","000","00","009","0943","1560","708","360","348","12","720","1092","0","65.93","32.97"
"64","000","00","009","0943","1561","683","342","341","37","720","1126","0","63.94","30.37"
"64","000","00","009","0944","0000","2532","1187","1345","91","2623","4106","0","63.88","28.91"
"64","000","00","009","0944","1562","671","354","317","45","716","1215","0","58.93","29.14"
"64","000","00","009","0944","1563","885","436","449","19","904","1443","0","62.65","30.21"
"64","000","00","009","0944","1564","976","397","579","27","1003","1448","0","69.27","27.42"
"64","000","00","009","0945","0000","1848","876","972","99","1947","3251","0","59.89","26.95"
"64","000","00","009","0945","1565","968","422","546","59","1027","1648","0","62.32","25.61"
"64","000","00","009","0945","1566","880","454","426","40","920","1603","0","57.39","28.32"
"64","000","00","009","0946","0000","818","400","418","19","837","1596","0","52.44","25.06"
"64","000","00","009","0946","1567","818","400","418","19","837","1596","0","52.44","25.06"
"64","000","00","009","0947","0000","2563","1394","1169","145","2708","4607","0","58.78","30.26"
"64","000","00","009","0947","1568","780","413","367","21","801","1450","0","55.24","28.48"
"64","000","00","009","0947","1569","807","389","418","57","864","1510","0","57.22","25.76"
"64","000","00","009","0947","1570","976","592","384","67","1043","1647","0","63.33","35.94"
"64","000","00","009","0948","0000","1514","738","776","62","1576","2726","0","57.81","27.07"
"64","000","00","009","0948","1571","763","352","411","29","792","1342","0","59.02","26.23"
"64","000","00","009","0948","1572","751","386","365","33","784","1384","0","56.65","27.89"
"64","000","00","009","0949","0000","2674","1240","1434","126","2800","4620","0","60.61","26.84"
"64","000","00","009","0949","1573","827","417","410","40","867","1479","0","58.62","28.19"
"64","000","00","009","0949","1574","916","393","523","37","953","1546","0","61.64","25.42"
"64","000","00","009","0949","1575","931","430","501","49","980","1595","0","61.44","26.96"
"64","000","00","009","0950","0000","1326","685","641","62","1388","2283","0","60.8","30.0"
"64","000","00","009","0950","1576","720","338","382","35","755","1201","0","62.86","28.14"
"64","000","00","009","0950","1577","606","347","259","27","633","1082","0","58.5","32.07"
"64","000","00","009","0951","0000","1107","600","507","63","1170","1928","0","60.68","31.12"
"64","000","00","009","0951","1578","556","273","283","22","578","996","0","58.03","27.41"
"64","000","00","009","0951","1579","551","327","224","41","592","932","0","63.52","35.09"
"64","000","00","009","0952","0000","2186","1097","1089","89","2275","3574","0","63.65","30.69"
"64","000","00","009","0952","1580","661","327","334","36","697","1146","0","60.82","28.53"
"64","000","00","009","0952","1581","682","388","294","32","714","1096","0","65.15","35.4"
"64","000","00","009","0952","1582","843","382","461","21","864","1332","0","64.86","28.68"
"64","000","00","009","0953","0000","2064","1095","969","107","2171","3477","0","62.44","31.49"
"64","000","00","009","0953","1583","700","383","317","33","733","1175","0","62.38","32.6"
"64","000","00","009","0953","1584","574","306","268","33","607","986","0","61.56","31.03"
"64","000","00","009","0953","1585","790","406","384","41","831","1316","0","63.15","30.85"
"64","000","00","009","0954","0000","1778","916","862","93","1871","3181","0","58.82","28.8"
"64","000","00","009","0954","1586","810","432","378","47","857","1559","0","54.97","27.71"
"64","000","00","009","0954","1587","968","484","484","46","1014","1622","0","62.52","29.84"
"64","000","00","009","0955","0000","1567","908","659","81","1648","2609","0","63.17","34.8"
"64","000","00","009","0955","1588","772","420","352","34","806","1310","0","61.53","32.06"
"64","000","00","009","0955","1589","795","488","307","47","842","1299","0","64.82","37.57"
"64","000","00","009","0956","0000","1543","776","767","61","1604","2566","0","62.51","30.24"
"64","000","00","009","0956","1590","764","362","402","38","802","1191","0","67.34","30.39"
"64","000","00","009","0956","1591","779","414","365","23","802","1375","0","58.33","30.11"
"64","000","00","009","0957","0000","1490","845","645","47","1537","2513","0","61.16","33.63"
"64","000","00","009","0957","1592","801","431","370","26","827","1338","0","61.81","32.21"
"64","000","00","009","0957","1593","689","414","275","21","710","1175","0","60.43","35.23"
"64","000","00","009","0958","0000","1534","782","752","61","1595","2544","0","62.7","30.74"
"64","000","00","009","0958","1594","764","385","379","21","785","1357","0","57.85","28.37"
"64","000","00","009","0958","1595","770","397","373","40","810","1187","0","68.24","33.45"
"64","000","00","009","0959","0000","1452","810","642","66","1518","2383","0","63.7","33.99"
"64","000","00","009","0959","1596","676","358","318","37","713","1164","0","61.25","30.76"
"64","000","00","009","0959","1597","776","452","324","29","805","1219","0","66.04","37.08"
"64","000","00","009","0960","0000","2569","1230","1339","129","2698","4454","0","60.57","27.62"
"64","000","00","009","0960","1598","804","365","439","24","828","1428","0","57.98","25.56"
"64","000","00","009","0960","1599","845","467","378","60","905","1495","0","60.54","31.24"
"64","000","00","009","0960","1600","920","398","522","45","965","1531","0","63.03","26.0"
"64","000","00","009","0961","0000","1771","938","833","89","1860","3100","0","60.0","30.26"
"64","000","00","009","0961","1601","869","475","394","47","916","1509","0","60.7","31.48"
"64","000","00","009","0961","1602","902","463","439","42","944","1591","0","59.33","29.1"
"64","000","00","010","0000","0000","12778","7375","5403","768","13546","24860","28533","54.49","29.67"
"64","000","00","010","1001","0000","706","430","276","59","765","1177","0","65.0","36.53"
"64","000","00","010","1001","0869","706","430","276","59","765","1177","0","65.0","36.53"
"64","000","00","010","1002","0000","578","327","251","37","615","1109","0","55.46","29.49"
"64","000","00","010","1002","0870","578","327","251","37","615","1109","0","55.46","29.49"
"64","000","00","010","1003","0000","839","497","342","21","860","1642","0","52.38","30.27"
"64","000","00","010","1003","0871","839","497","342","21","860","1642","0","52.38","30.27"
"64","000","00","010","1004","0000","1168","693","475","96","1264","2321","0","54.46","29.86"
"64","000","00","010","1004","0872","613","354","259","66","679","1209","0","56.16","29.28"
"64","000","00","010","1004","0873","555","339","216","30","585","1112","0","52.61","30.49"
"64","000","00","010","1005","0000","1488","876","612","91","1579","2943","0","53.65","29.77"
"64","000","00","010","1005","0874","810","415","395","62","872","1483","0","58.8","27.98"
"64","000","00","010","1005","0875","678","461","217","29","707","1460","0","48.42","31.58"
"64","000","00","010","1006","0000","929","572","357","65","994","1572","0","63.23","36.39"
"64","000","00","010","1006","0876","929","572","357","65","994","1572","0","63.23","36.39"
"64","000","00","010","1007","0000","640","274","366","37","677","1384","0","48.92","19.8"
"64","000","00","010","1007","0877","640","274","366","37","677","1384","0","48.92","19.8"
"64","000","00","010","1008","0000","1247","623","624","76","1323","2629","0","50.32","23.7"
"64","000","00","010","1008","0878","663","326","337","38","701","1390","0","50.43","23.45"
"64","000","00","010","1008","0879","584","297","287","38","622","1239","0","50.2","23.97"
"64","000","00","010","1009","0000","1070","602","468","73","1143","2045","0","55.89","29.44"
"64","000","00","010","1009","0880","1070","602","468","73","1143","2045","0","55.89","29.44"
"64","000","00","010","1010","0000","1420","888","532","81","1501","2759","0","54.4","32.19"
"64","000","00","010","1010","0881","474","299","175","21","495","893","0","55.43","33.48"
"64","000","00","010","1010","0882","946","589","357","60","1006","1866","0","53.91","31.56"
"64","000","00","010","1011","0000","881","562","319","36","917","1874","0","48.93","29.99"
"64","000","00","010","1011","0883","881","562","319","36","917","1874","0","48.93","29.99"
"64","000","00","010","1012","0000","449","280","169","22","471","893","0","52.74","31.35"
"64","000","00","010","1012","0884","449","280","169","22","471","893","0","52.74","31.35"
"64","000","00","010","1013","0000","1363","751","612","74","1437","2512","0","57.21","29.9"
"64","000","00","010","1013","0885","716","400","316","34","750","1215","0","61.73","32.92"
"64","000","00","010","1013","0886","647","351","296","40","687","1297","0","52.97","27.06"
"64","000","00","011","0000","0000","76219","37792","38427","3260","79479","132733","157685","59.88","28.47"
"64","000","00","011","1101","0000","1425","677","748","60","1485","2279","0","65.16","29.71"
"64","000","00","011","1101","1603","708","328","380","30","738","1108","0","66.61","29.6"
"64","000","00","011","1101","1604","717","349","368","30","747","1171","0","63.79","29.8"
"64","000","00","011","1102","0000","1889","864","1025","40","1929","3225","0","59.81","26.79"
"64","000","00","011","1102","1605","985","471","514","18","1003","1557","0","64.42","30.25"
"64","000","00","011","1102","1606","904","393","511","22","926","1668","0","55.52","23.56"
"64","000","00","011","1103","0000","1657","664","993","38","1695","2555","0","66.34","25.99"
"64","000","00","011","1103","1607","806","313","493","17","823","1183","0","69.57","26.46"
"64","000","00","011","1103","1608","851","351","500","21","872","1372","0","63.56","25.58"
"64","000","00","011","1104","0000","1026","524","502","55","1081","1737","0","62.23","30.17"
"64","000","00","011","1104","1609","1026","524","502","55","1081","1737","0","62.23","30.17"
"64","000","00","011","1105","0000","1688","859","829","77","1765","3144","0","56.14","27.32"
"64","000","00","011","1105","1610","874","483","391","37","911","1586","0","57.44","30.45"
"64","000","00","011","1105","1611","814","376","438","40","854","1558","0","54.81","24.13"
"64","000","00","011","1106","0000","1565","821","744","76","1641","2533","0","64.78","32.41"
"64","000","00","011","1106","1612","819","441","378","40","859","1284","0","66.9","34.35"
"64","000","00","011","1106","1613","746","380","366","36","782","1249","0","62.61","30.42"
"64","000","00","011","1107","0000","1101","552","549","45","1146","2400","0","47.75","23.0"
"64","000","00","011","1107","1614","1101","552","549","45","1146","2400","0","47.75","23.0"
"64","000","00","011","1108","0000","1365","710","655","65","1430","2260","0","63.27","31.42"
"64","000","00","011","1108","1615","727","387","340","34","761","1181","0","64.44","32.77"
"64","000","00","011","1108","1616","638","323","315","31","669","1079","0","62.0","29.94"
"64","000","00","011","1109","0000","1513","766","747","60","1573","2576","0","61.06","29.74"
"64","000","00","011","1109","1617","773","389","384","24","797","1335","0","59.7","29.14"
"64","000","00","011","1109","1618","740","377","363","36","776","1241","0","62.53","30.38"
"64","000","00","011","1110","0000","3363","1707","1656","136","3499","5796","0","60.37","29.45"
"64","000","00","011","1110","1619","849","438","411","33","882","1513","0","58.29","28.95"
"64","000","00","011","1110","1620","818","411","407","46","864","1349","0","64.05","30.47"
"64","000","00","011","1110","1621","833","430","403","43","876","1483","0","59.07","29.0"
"64","000","00","011","1110","1622","863","428","435","14","877","1451","0","60.44","29.5"
"64","000","00","011","1111","0000","1495","785","710","75","1570","2503","0","62.72","31.36"
"64","000","00","011","1111","1623","693","360","333","26","719","1241","0","57.94","29.01"
"64","000","00","011","1111","1624","802","425","377","49","851","1262","0","67.43","33.68"
"64","000","00","011","1112","0000","2051","1055","996","86","2137","3690","0","57.91","28.59"
"64","000","00","011","1112","1625","1053","540","513","59","1112","1813","0","61.33","29.78"
"64","000","00","011","1112","1626","998","515","483","27","1025","1877","0","54.61","27.44"
"64","000","00","011","1113","0000","1737","905","832","49","1786","2844","0","62.8","31.82"
"64","000","00","011","1113","1627","819","422","397","17","836","1391","0","60.1","30.34"
"64","000","00","011","1113","1628","918","483","435","32","950","1453","0","65.38","33.24"
"64","000","00","011","1114","0000","2372","1124","1248","104","2476","4056","0","61.05","27.71"
"64","000","00","011","1114","1629","810","394","416","25","835","1374","0","60.77","28.68"
"64","000","00","011","1114","1630","764","358","406","33","797","1348","0","59.12","26.56"
"64","000","00","011","1114","1631","798","372","426","46","844","1334","0","63.27","27.89"
"64","000","00","011","1115","0000","2522","1245","1277","112","2634","4369","0","60.29","28.5"
"64","000","00","011","1115","1632","836","444","392","27","863","1433","0","60.22","30.98"
"64","000","00","011","1115","1633","778","399","379","28","806","1448","0","55.66","27.56"
"64","000","00","011","1115","1634","908","402","506","57","965","1488","0","64.85","27.02"
"64","000","00","011","1116","0000","1651","794","857","78","1729","2584","0","66.91","30.73"
"64","000","00","011","1116","1635","767","387","380","41","808","1278","0","63.22","30.28"
"64","000","00","011","1116","1636","884","407","477","37","921","1306","0","70.52","31.16"
"64","000","00","011","1117","0000","1949","936","1013","93","2042","3265","0","62.54","28.67"
"64","000","00","011","1117","1637","943","472","471","45","988","1625","0","60.8","29.05"
"64","000","00","011","1117","1638","1006","464","542","48","1054","1640","0","64.27","28.29"
"64","000","00","011","1118","0000","1612","613","999","79","1691","2944","0","57.44","20.82"
"64","000","00","011","1118","1639","856","379","477","34","890","1506","0","59.1","25.17"
"64","000","00","011","1118","1640","756","234","522","45","801","1438","0","55.7","16.27"
"64","000","00","011","1119","0000","1369","505","864","49","1418","2272","0","62.41","22.23"
"64","000","00","011","1119","1641","722","242","480","30","752","1105","0","68.05","21.9"
"64","000","00","011","1119","1642","647","263","384","19","666","1167","0","57.07","22.54"
"64","000","00","011","1120","0000","2475","1062","1413","92","2567","4039","0","63.56","26.29"
"64","000","00","011","1120","1643","883","373","510","24","907","1420","0","63.87","26.27"
"64","000","00","011","1120","1644","868","358","510","49","917","1380","0","66.45","25.94"
"64","000","00","011","1120","1645","724","331","393","19","743","1239","0","59.97","26.72"
"64","000","00","011","1121","0000","1896","1117","779","80","1976","3207","0","61.62","34.83"
"64","000","00","011","1121","1646","944","640","304","35","979","1563","0","62.64","40.95"
"64","000","00","011","1121","1647","952","477","475","45","997","1644","0","60.64","29.01"
"64","000","00","011","1122","0000","6163","2951","3212","272","6435","11107","0","57.94","26.57"
"64","000","00","011","1122","1648","1047","472","575","54","1101","1895","0","58.1","24.91"
"64","000","00","011","1122","1649","962","503","459","46","1008","1748","0","57.67","28.78"
"64","000","00","011","1122","1650","918","447","471","57","975","1579","0","61.75","28.31"
"64","000","00","011","1122","1651","1182","543","639","30","1212","2135","0","56.77","25.43"
"64","000","00","011","1122","1652","986","462","524","44","1030","1728","0","59.61","26.74"
"64","000","00","011","1122","1653","1068","524","544","41","1109","2022","0","54.85","25.91"
"64","000","00","011","1123","0000","2183","1150","1033","84","2267","3916","0","57.89","29.37"
"64","000","00","011","1123","1654","668","364","304","22","690","1329","0","51.92","27.39"
"64","000","00","011","1123","1655","768","405","363","20","788","1320","0","59.7","30.68"
"64","000","00","011","1123","1656","747","381","366","42","789","1267","0","62.27","30.07"
"64","000","00","011","1124","0000","1569","801","768","91","1660","2587","0","64.17","30.96"
"64","000","00","011","1124","1657","775","378","397","61","836","1298","0","64.41","29.12"
"64","000","00","011","1124","1658","794","423","371","30","824","1289","0","63.93","32.82"
"64","000","00","011","1125","0000","1822","869","953","72","1894","3028","0","62.55","28.7"
"64","000","00","011","1125","1659","936","477","459","28","964","1534","0","62.84","31.1"
"64","000","00","011","1125","1660","886","392","494","44","930","1494","0","62.25","26.24"
"64","000","00","011","1126","0000","1634","814","820","85","1719","2721","0","63.18","29.92"
"64","000","00","011","1126","1661","809","403","406","46","855","1377","0","62.09","29.27"
"64","000","00","011","1126","1662","825","411","414","39","864","1344","0","64.29","30.58"
"64","000","00","011","1127","0000","3260","1659","1601","125","3385","5757","0","58.8","28.82"
"64","000","00","011","1127","1663","865","463","402","36","901","1508","0","59.75","30.7"
"64","000","00","011","1127","1664","758","427","331","30","788","1400","0","56.29","30.5"
"64","000","00","011","1127","1665","869","395","474","37","906","1457","0","62.18","27.11"
"64","000","00","011","1127","1666","768","374","394","22","790","1392","0","56.75","26.87"
"64","000","00","011","1128","0000","2513","1194","1319","95","2608","4487","0","58.12","26.61"
"64","000","00","011","1128","1667","1083","569","514","41","1124","1983","0","56.68","28.69"
"64","000","00","011","1128","1668","700","317","383","22","722","1204","0","59.97","26.33"
"64","000","00","011","1128","1669","730","308","422","32","762","1300","0","58.62","23.69"
"64","000","00","011","1129","0000","2018","942","1076","76","2094","3423","0","61.17","27.52"
"64","000","00","011","1129","1670","1123","533","590","48","1171","1857","0","63.06","28.7"
"64","000","00","011","1129","1671","895","409","486","28","923","1566","0","58.94","26.12"
"64","000","00","011","1130","0000","1628","842","786","91","1719","2579","0","66.65","32.65"
"64","000","00","011","1130","1672","850","421","429","42","892","1343","0","66.42","31.35"
"64","000","00","011","1130","1673","778","421","357","49","827","1236","0","66.91","34.06"
"64","000","00","011","1131","0000","4483","2287","2196","181","4664","7715","0","60.45","29.64"
"64","000","00","011","1131","1674","959","538","421","58","1017","1564","0","65.03","34.4"
"64","000","00","011","1131","1675","874","445","429","26","900","1484","0","60.65","29.99"
"64","000","00","011","1131","1676","847","425","422","39","886","1477","0","59.99","28.77"
"64","000","00","011","1131","1677","926","440","486","20","946","1482","0","63.83","29.69"
"64","000","00","011","1131","1678","877","439","438","38","915","1708","0","53.57","25.7"
"64","000","00","011","1132","0000","1925","1025","900","119","2044","3576","0","57.16","28.66"
"64","000","00","011","1132","1679","1008","541","467","95","1103","1867","0","59.08","28.98"
"64","000","00","011","1132","1680","917","484","433","24","941","1709","0","55.06","28.32"
"64","000","00","011","1133","0000","1586","775","811","78","1664","3121","0","53.32","24.83"
"64","000","00","011","1133","1681","743","355","388","47","790","1425","0","55.44","24.91"
"64","000","00","011","1133","1682","843","420","423","31","874","1696","0","51.53","24.76"
"64","000","00","011","1134","0000","1602","841","761","75","1677","3053","0","54.93","27.55"
"64","000","00","011","1134","1683","737","375","362","35","772","1522","0","50.72","24.64"
"64","000","00","011","1134","1684","865","466","399","40","905","1531","0","59.11","30.44"
"64","000","00","011","1135","0000","1167","611","556","75","1242","2215","0","56.07","27.58"
"64","000","00","011","1135","1685","1167","611","556","75","1242","2215","0","56.07","27.58"
"64","000","00","011","1136","0000","1739","975","764","57","1796","3050","0","58.89","31.97"
"64","000","00","011","1136","1686","893","510","383","28","921","1515","0","60.79","33.66"
"64","000","00","011","1136","1687","846","465","381","29","875","1535","0","57.0","30.29"
"64","000","00","011","1137","0000","1368","764","604","50","1418","2493","0","56.88","30.65"
"64","000","00","011","1137","1688","723","415","308","19","742","1276","0","58.15","32.52"
"64","000","00","011","1137","1689","645","349","296","31","676","1217","0","55.55","28.68"
"64","000","00","011","1138","0000","1838","1007","831","85","1923","3627","0","53.02","27.76"
"64","000","00","011","1138","1690","846","468","378","31","877","1707","0","51.38","27.42"
"64","000","00","011","1138","1691","992","539","453","54","1046","1920","0","54.48","28.07"
"64","000","00","012","0000","0000","174411","80679","93732","7435","181846","300510","359100","60.51","26.85"
"64","000","00","012","1201","0000","273","134","139","4","277","423","0","65.48","31.68"
"64","000","00","012","1201","1306","273","134","139","4","277","423","0","65.48","31.68"
"64","000","00","012","1202","0000","383","236","147","17","400","618","0","64.72","38.19"
"64","000","00","012","1202","1305","383","236","147","17","400","618","0","64.72","38.19"
"64","000","00","012","1203","0000","763","376","387","40","803","1312","0","61.2","28.66"
"64","000","00","012","1203","1307","763","376","387","40","803","1312","0","61.2","28.66"
"64","000","00","012","1204","0000","593","258","335","34","627","875","0","71.66","29.49"
"64","000","00","012","1204","1321","593","258","335","34","627","875","0","71.66","29.49"
"64","000","00","012","1205","0000","538","270","268","22","560","882","0","63.49","30.61"
"64","000","00","012","1205","1314","538","270","268","22","560","882","0","63.49","30.61"
"64","000","00","012","1206","0000","1246","553","693","35","1281","1982","0","64.63","27.9"
"64","000","00","012","1206","1308","460","233","227","19","479","769","0","62.29","30.3"
"64","000","00","012","1206","1309","786","320","466","16","802","1213","0","66.12","26.38"
"64","000","00","012","1207","0000","695","305","390","29","724","1080","0","67.04","28.24"
"64","000","00","012","1207","1256","695","305","390","29","724","1080","0","67.04","28.24"
"64","000","00","012","1208","0000","2084","884","1200","120","2204","3395","0","64.92","26.04"
"64","000","00","012","1208","1334","691","313","378","42","733","1159","0","63.24","27.01"
"64","000","00","012","1208","1335","634","247","387","44","678","1127","0","60.16","21.92"
"64","000","00","012","1208","1336","759","324","435","34","793","1109","0","71.51","29.22"
"64","000","00","012","1209","0000","4533","2077","2456","186","4719","8473","0","55.69","24.51"
"64","000","00","012","1209","1268","854","448","406","51","905","1496","0","60.49","29.95"
"64","000","00","012","1209","1269","1008","453","555","42","1050","2094","0","50.14","21.63"
"64","000","00","012","1209","1270","888","388","500","28","916","1672","0","54.78","23.21"
"64","000","00","012","1209","1271","947","381","566","21","968","1761","0","54.97","21.64"
"64","000","00","012","1209","1272","836","407","429","44","880","1450","0","60.69","28.07"
"64","000","00","012","1210","0000","506","234","272","24","530","819","0","64.71","28.57"
"64","000","00","012","1210","1257","506","234","272","24","530","819","0","64.71","28.57"
"64","000","00","012","1211","0000","2120","977","1143","90","2210","3533","0","62.55","27.65"
"64","000","00","012","1211","1277","747","370","377","33","780","1247","0","62.55","29.67"
"64","000","00","012","1211","1278","650","320","330","31","681","1087","0","62.65","29.44"
"64","000","00","012","1211","1279","723","287","436","26","749","1199","0","62.47","23.94"
"64","000","00","012","1212","0000","2845","1377","1468","89","2934","4957","0","59.19","27.78"
"64","000","00","012","1212","1260","773","364","409","19","792","1223","0","64.76","29.76"
"64","000","00","012","1212","1261","725","366","359","26","751","1207","0","62.22","30.32"
"64","000","00","012","1212","1262","728","347","381","22","750","1339","0","56.01","25.91"
"64","000","00","012","1212","1263","619","300","319","22","641","1188","0","53.96","25.25"
"64","000","00","012","1213","0000","1369","614","755","47","1416","2465","0","57.44","24.91"
"64","000","00","012","1213","1340","791","343","448","27","818","1432","0","57.12","23.95"
"64","000","00","012","1213","1341","578","271","307","20","598","1033","0","57.89","26.23"
"64","000","00","012","1214","0000","3272","1398","1874","124","3396","5972","0","56.87","23.41"
"64","000","00","012","1214","1362","827","383","444","38","865","1521","0","56.87","25.18"
"64","000","00","012","1214","1363","739","356","383","26","765","1407","0","54.37","25.3"
"64","000","00","012","1214","1364","896","332","564","42","938","1542","0","60.83","21.53"
"64","000","00","012","1214","1365","810","327","483","18","828","1502","0","55.13","21.77"
"64","000","00","012","1215","0000","2380","571","1809","119","2499","4111","0","60.79","13.89"
"64","000","00","012","1215","1366","784","276","508","49","833","1320","0","63.11","20.91"
"64","000","00","012","1215","1367","809","141","668","30","839","1507","0","55.67","9.36"
"64","000","00","012","1215","1368","787","154","633","40","827","1284","0","64.41","11.99"
"64","000","00","012","1216","0000","2678","1320","1358","139","2817","4722","0","59.66","27.95"
"64","000","00","012","1216","1445","612","284","328","41","653","1058","0","61.72","26.84"
"64","000","00","012","1216","1446","595","301","294","43","638","976","0","65.37","30.84"
"64","000","00","012","1216","1447","820","387","433","24","844","1545","0","54.63","25.05"
"64","000","00","012","1216","1448","651","348","303","31","682","1143","0","59.67","30.45"
"64","000","00","012","1217","0000","3829","1925","1904","179","4008","6769","0","59.21","28.44"
"64","000","00","012","1217","1407","741","410","331","21","762","1314","0","57.99","31.2"
"64","000","00","012","1217","1408","863","424","439","20","883","1649","0","53.55","25.71"
"64","000","00","012","1217","1409","856","437","419","69","925","1601","0","57.78","27.3"
"64","000","00","012","1217","1410","767","336","431","18","785","1155","0","67.97","29.09"
"64","000","00","012","1217","1411","602","318","284","51","653","1050","0","62.19","30.29"
"64","000","00","012","1218","0000","2958","1266","1692","152","3110","4988","0","62.35","25.38"
"64","000","00","012","1218","1342","743","344","399","57","800","1253","0","63.85","27.45"
"64","000","00","012","1218","1343","719","315","404","24","743","1217","0","61.05","25.88"
"64","000","00","012","1218","1344","777","285","492","46","823","1267","0","64.96","22.49"
"64","000","00","012","1218","1345","719","322","397","25","744","1251","0","59.47","25.74"
"64","000","00","012","1219","0000","2817","1246","1571","107","2924","4562","0","64.09","27.31"
"64","000","00","012","1219","1325","642","303","339","23","665","974","0","68.28","31.11"
"64","000","00","012","1219","1326","580","246","334","32","612","987","0","62.01","24.92"
"64","000","00","012","1219","1327","787","302","485","22","809","1210","0","66.86","24.96"
"64","000","00","012","1219","1328","808","395","413","30","838","1391","0","60.24","28.4"
"64","000","00","012","1220","0000","2329","938","1391","67","2396","3682","0","65.07","25.48"
"64","000","00","012","1220","1337","1168","467","701","31","1199","1879","0","63.81","24.85"
"64","000","00","012","1220","1338","1161","471","690","36","1197","1803","0","66.39","26.12"
"64","000","00","012","1221","0000","957","516","441","69","1026","2513","0","40.83","20.53"
"64","000","00","012","1221","1316","510","293","217","35","545","853","0","63.89","34.35"
"64","000","00","012","1221","1317","447","223","224","34","481","1660","0","28.98","13.43"
"64","000","00","012","1222","0000","1667","663","1004","80","1747","2926","0","59.71","22.66"
"64","000","00","012","1222","1369","789","327","462","29","818","1441","0","56.77","22.69"
"64","000","00","012","1222","1370","878","336","542","51","929","1485","0","62.56","22.63"
"64","000","00","012","1224","0000","1952","937","1015","76","2028","3411","0","59.45","27.47"
"64","000","00","012","1224","1275","1023","494","529","49","1072","1713","0","62.58","28.84"
"64","000","00","012","1224","1276","929","443","486","27","956","1698","0","56.3","26.09"
"64","000","00","012","1225","0000","1644","811","833","48","1692","2870","0","58.95","28.26"
"64","000","00","012","1225","1387","859","404","455","21","880","1525","0","57.7","26.49"
"64","000","00","012","1225","1388","785","407","378","27","812","1345","0","60.37","30.26"
"64","000","00","012","1226","0000","2813","1380","1433","104","2917","4708","0","61.96","29.31"
"64","000","00","012","1226","1383","512","300","212","26","538","942","0","57.11","31.85"
"64","000","00","012","1226","1384","708","325","383","24","732","1206","0","60.7","26.95"
"64","000","00","012","1226","1385","736","316","420","26","762","1159","0","65.75","27.26"
"64","000","00","012","1226","1386","857","439","418","28","885","1401","0","63.17","31.33"
"64","000","00","012","1227","0000","3710","1964","1746","232","3942","6189","0","63.69","31.73"
"64","000","00","012","1227","1429","830","421","409","48","878","1405","0","62.49","29.96"
"64","000","00","012","1227","1430","679","376","303","44","723","1097","0","65.91","34.28"
"64","000","00","012","1227","1431","772","415","357","57","829","1248","0","66.43","33.25"
"64","000","00","012","1227","1432","722","376","346","49","771","1225","0","62.94","30.69"
"64","000","00","012","1227","1433","707","376","331","34","741","1214","0","61.04","30.97"
"64","000","00","012","1228","0000","1851","963","888","106","1957","3269","0","59.87","29.46"
"64","000","00","012","1228","1437","551","294","257","23","574","968","0","59.3","30.37"
"64","000","00","012","1228","1438","665","344","321","35","700","1200","0","58.33","28.67"
"64","000","00","012","1228","1439","635","325","310","48","683","1101","0","62.03","29.52"
"64","000","00","012","1229","0000","3285","1776","1509","161","3446","5759","0","59.84","30.84"
"64","000","00","012","1229","1474","611","330","281","34","645","1042","0","61.9","31.67"
"64","000","00","012","1229","1475","647","363","284","28","675","1098","0","61.48","33.06"
"64","000","00","012","1229","1476","709","388","321","19","728","1284","0","56.7","30.22"
"64","000","00","012","1229","1477","671","364","307","34","705","1242","0","56.76","29.31"
"64","000","00","012","1229","1478","647","331","316","46","693","1093","0","63.4","30.28"
"64","000","00","012","1230","0000","3081","1208","1873","183","3264","5398","0","60.47","22.38"
"64","000","00","012","1230","1349","862","388","474","32","894","1588","0","56.3","24.43"
"64","000","00","012","1230","1350","751","174","577","53","804","1255","0","64.06","13.86"
"64","000","00","012","1230","1351","718","344","374","46","764","1264","0","60.44","27.22"
"64","000","00","012","1230","1352","750","302","448","52","802","1291","0","62.12","23.39"
"64","000","00","012","1231","0000","2845","1148","1697","120","2965","4819","0","61.53","23.82"
"64","000","00","012","1231","1346","922","378","544","39","961","1563","0","61.48","24.18"
"64","000","00","012","1231","1347","1122","399","723","46","1168","1888","0","61.86","21.13"
"64","000","00","012","1231","1348","801","371","430","35","836","1368","0","61.11","27.12"
"64","000","00","012","1232","0000","1933","965","968","84","2017","3455","0","58.38","27.93"
"64","000","00","012","1232","1465","652","342","310","32","684","1154","0","59.27","29.64"
"64","000","00","012","1232","1466","667","304","363","38","705","1153","0","61.14","26.37"
"64","000","00","012","1232","1467","614","319","295","14","628","1148","0","54.7","27.79"
"64","000","00","012","1233","0000","3133","1481","1652","143","3276","5211","0","62.87","28.42"
"64","000","00","012","1233","1397","762","381","381","33","795","1388","0","57.28","27.45"
"64","000","00","012","1233","1398","742","392","350","56","798","1241","0","64.3","31.59"
"64","000","00","012","1233","1399","854","395","459","33","887","1394","0","63.63","28.34"
"64","000","00","012","1233","1400","775","313","462","21","796","1188","0","67.0","26.35"
"64","000","00","012","1234","0000","2210","1040","1170","96","2306","3815","0","60.45","27.26"
"64","000","00","012","1234","1371","696","329","367","37","733","1205","0","60.83","27.3"
"64","000","00","012","1234","1372","720","333","387","20","740","1284","0","57.63","25.93"
"64","000","00","012","1234","1373","794","378","416","39","833","1326","0","62.82","28.51"
"64","000","00","012","1235","0000","3445","1436","2009","111","3556","5984","0","59.43","24.0"
"64","000","00","012","1235","1359","1206","556","650","45","1251","2173","0","57.57","25.59"
"64","000","00","012","1235","1360","1292","458","834","35","1327","2255","0","58.85","20.31"
"64","000","00","012","1235","1361","947","422","525","31","978","1556","0","62.85","27.12"
"64","000","00","012","1236","0000","2293","1225","1068","71","2364","3999","0","59.11","30.63"
"64","000","00","012","1236","1404","698","392","306","29","727","1216","0","59.79","32.24"
"64","000","00","012","1236","1405","739","442","297","26","765","1318","0","58.04","33.54"
"64","000","00","012","1236","1406","856","391","465","16","872","1465","0","59.52","26.69"
"64","000","00","012","1237","0000","2055","977","1078","104","2159","3295","0","65.52","29.65"
"64","000","00","012","1237","1374","662","326","336","23","685","1096","0","62.5","29.74"
"64","000","00","012","1237","1375","726","340","386","47","773","1182","0","65.4","28.76"
"64","000","00","012","1237","1376","667","311","356","34","701","1017","0","68.93","30.58"
"64","000","00","012","1238","0000","1389","717","672","88","1477","2479","0","59.58","28.92"
"64","000","00","012","1238","1377","674","348","326","59","733","1198","0","61.19","29.05"
"64","000","00","012","1238","1378","715","369","346","29","744","1281","0","58.08","28.81"
"64","000","00","012","1239","0000","5061","2163","2898","162","5223","8716","0","59.92","24.82"
"64","000","00","012","1239","1291","1041","445","596","38","1079","1751","0","61.62","25.41"
"64","000","00","012","1239","1292","1053","456","597","31","1084","1758","0","61.66","25.94"
"64","000","00","012","1239","1293","1014","446","568","38","1052","1749","0","60.15","25.5"
"64","000","00","012","1239","1294","985","407","578","20","1005","1746","0","57.56","23.31"
"64","000","00","012","1239","1295","968","409","559","35","1003","1712","0","58.59","23.89"
"64","000","00","012","1240","0000","7433","3349","4084","209","7642","12977","0","58.89","25.81"
"64","000","00","012","1240","1421","899","505","394","27","926","1688","0","54.86","29.92"
"64","000","00","012","1240","1422","942","395","547","44","986","1657","0","59.51","23.84"
"64","000","00","012","1240","1423","911","408","503","17","928","1729","0","53.67","23.6"
"64","000","00","012","1240","1424","952","449","503","45","997","1628","0","61.24","27.58"
"64","000","00","012","1240","1425","966","426","540","12","978","1891","0","51.72","22.53"
"64","000","00","012","1240","1426","971","387","584","31","1002","1594","0","62.86","24.28"
"64","000","00","012","1240","1427","862","354","508","13","875","1342","0","65.2","26.38"
"64","000","00","012","1240","1428","930","425","505","20","950","1448","0","65.61","29.35"
"64","000","00","012","1241","0000","1165","542","623","64","1229","1926","0","63.81","28.14"
"64","000","00","012","1241","1258","501","234","267","45","546","851","0","64.16","27.5"
"64","000","00","012","1241","1259","664","308","356","19","683","1075","0","63.53","28.65"
"64","000","00","012","1242","0000","1993","931","1062","91","2084","3418","0","60.97","27.24"
"64","000","00","012","1242","1318","685","300","385","23","708","1124","0","62.99","26.69"
"64","000","00","012","1242","1319","656","331","325","42","698","1112","0","62.77","29.77"
"64","000","00","012","1242","1320","652","300","352","26","678","1182","0","57.36","25.38"
"64","000","00","012","1243","0000","1843","815","1028","131","1974","2966","0","66.55","27.48"
"64","000","00","012","1243","1471","640","356","284","28","668","1026","0","65.11","34.7"
"64","000","00","012","1243","1472","627","361","266","57","684","993","0","68.88","36.35"
"64","000","00","012","1243","1473","576","98","478","46","622","947","0","65.68","10.35"
"64","000","00","012","1244","0000","3342","1517","1825","137","3479","5672","0","61.34","26.75"
"64","000","00","012","1244","1329","630","310","320","24","654","1241","0","52.7","24.98"
"64","000","00","012","1244","1330","628","283","345","24","652","1000","0","65.2","28.3"
"64","000","00","012","1244","1331","663","306","357","25","688","1092","0","63.0","28.02"
"64","000","00","012","1244","1332","802","332","470","28","830","1308","0","63.46","25.38"
"64","000","00","012","1244","1333","619","286","333","36","655","1031","0","63.53","27.74"
"64","000","00","012","1245","0000","1075","385","690","53","1128","2045","0","55.16","18.83"
"64","000","00","012","1245","1339","1075","385","690","53","1128","2045","0","55.16","18.83"
"64","000","00","012","1246","0000","2931","1408","1523","116","3047","4742","0","64.26","29.69"
"64","000","00","012","1246","1310","724","349","375","20","744","1107","0","67.21","31.53"
"64","000","00","012","1246","1311","721","347","374","28","749","1188","0","63.05","29.21"
"64","000","00","012","1246","1312","729","334","395","28","757","1183","0","63.99","28.23"
"64","000","00","012","1246","1313","757","378","379","40","797","1264","0","63.05","29.91"
"64","000","00","012","1247","0000","2052","889","1163","92","2144","3351","0","63.98","26.53"
"64","000","00","012","1247","1322","626","307","319","34","660","1040","0","63.46","29.52"
"64","000","00","012","1247","1323","701","252","449","19","720","1094","0","65.81","23.03"
"64","000","00","012","1247","1324","725","330","395","39","764","1217","0","62.78","27.12"
"64","000","00","012","1248","0000","3517","1705","1812","150","3667","6178","0","59.36","27.6"
"64","000","00","012","1248","1286","674","312","362","26","700","1247","0","56.13","25.02"
"64","000","00","012","1248","1287","828","388","440","42","870","1538","0","56.57","25.23"
"64","000","00","012","1248","1288","638","335","303","27","665","1097","0","60.62","30.54"
"64","000","00","012","1248","1289","677","367","310","20","697","1221","0","57.08","30.06"
"64","000","00","012","1248","1290","700","303","397","35","735","1075","0","68.37","28.19"
"64","000","00","012","1249","0000","2522","1230","1292","128","2650","4308","0","61.51","28.55"
"64","000","00","012","1249","1481","777","341","436","39","816","1309","0","62.34","26.05"
"64","000","00","012","1249","1482","941","464","477","39","980","1627","0","60.23","28.52"
"64","000","00","012","1249","1483","804","425","379","50","854","1372","0","62.24","30.98"
"64","000","00","012","1250","0000","1436","557","879","56","1492","2520","0","59.21","22.1"
"64","000","00","012","1250","1353","697","276","421","30","727","1224","0","59.4","22.55"
"64","000","00","012","1250","1354","739","281","458","26","765","1296","0","59.03","21.68"
"64","000","00","012","1251","0000","676","333","343","33","709","1007","0","70.41","33.07"
"64","000","00","012","1251","1315","676","333","343","33","709","1007","0","70.41","33.07"
"64","000","00","012","1253","0000","2396","1189","1207","125","2521","4102","0","61.46","28.99"
"64","000","00","012","1253","1264","623","335","288","27","650","1055","0","61.61","31.75"
"64","000","00","012","1253","1265","609","299","310","44","653","1109","0","58.88","26.96"
"64","000","00","012","1253","1266","493","260","233","27","520","756","0","68.78","34.39"
"64","000","00","012","1253","1267","671","295","376","27","698","1182","0","59.05","24.96"
"64","000","00","012","1254","0000","986","480","506","44","1030","2551","0","40.38","18.82"
"64","000","00","012","1254","1449","355","190","165","15","370","1301","0","28.44","14.6"
"64","000","00","012","1254","1450","631","290","341","29","660","1250","0","52.8","23.2"
"64","000","00","012","1255","0000","4667","2317","2350","237","4904","7753","0","63.25","29.89"
"64","000","00","012","1255","1459","811","364","447","30","841","1291","0","65.14","28.2"
"64","000","00","012","1255","1460","558","288","270","50","608","938","0","64.82","30.7"
"64","000","00","012","1255","1461","1039","523","516","33","1072","1783","0","60.12","29.33"
"64","000","00","012","1255","1462","674","328","346","31","705","1105","0","63.8","29.68"
"64","000","00","012","1255","1463","783","433","350","62","845","1392","0","60.7","31.11"
"64","000","00","012","1255","1464","802","381","421","31","833","1244","0","66.96","30.63"
"64","000","00","012","1256","0000","4900","2003","2897","175","5075","8179","0","62.05","24.49"
"64","000","00","012","1256","1280","850","215","635","49","899","1559","0","57.67","13.79"
"64","000","00","012","1256","1281","754","341","413","29","783","1233","0","63.5","27.66"
"64","000","00","012","1256","1282","767","363","404","40","807","1277","0","63.19","28.43"
"64","000","00","012","1256","1283","866","344","522","15","881","1481","0","59.49","23.23"
"64","000","00","012","1256","1284","747","326","421","21","768","1154","0","66.55","28.25"
"64","000","00","012","1256","1285","916","414","502","21","937","1475","0","63.53","28.07"
"64","000","00","012","1257","0000","2219","1149","1070","120","2339","4340","0","53.89","26.47"
"64","000","00","012","1257","1468","764","339","425","66","830","1432","0","57.96","23.67"
"64","000","00","012","1257","1469","616","400","216","28","644","1429","0","45.07","27.99"
"64","000","00","012","1257","1470","839","410","429","26","865","1479","0","58.49","27.72"
"64","000","00","012","1258","0000","1473","702","771","55","1528","2689","0","56.82","26.11"
"64","000","00","012","1258","1273","756","364","392","18","774","1455","0","53.2","25.02"
"64","000","00","012","1258","1274","717","338","379","37","754","1234","0","61.1","27.39"
"64","000","00","012","1259","0000","2367","1000","1367","91","2458","4003","0","61.4","24.98"
"64","000","00","012","1259","1296","730","302","428","28","758","1247","0","60.79","24.22"
"64","000","00","012","1259","1297","839","370","469","32","871","1409","0","61.82","26.26"
"64","000","00","012","1259","1298","798","328","470","31","829","1347","0","61.54","24.35"
"64","000","00","012","1260","0000","5381","2513","2868","125","5506","9265","0","59.43","27.12"
"64","000","00","012","1260","1299","1006","432","574","20","1026","1771","0","57.93","24.39"
"64","000","00","012","1260","1300","912","394","518","18","930","1537","0","60.51","25.63"
"64","000","00","012","1260","1301","952","360","592","18","970","1605","0","60.44","22.43"
"64","000","00","012","1260","1302","787","600","187","21","808","1375","0","58.76","43.64"
"64","000","00","012","1260","1303","857","352","505","29","886","1393","0","63.6","25.27"
"64","000","00","012","1260","1304","867","375","492","19","886","1584","0","55.93","23.67"
"64","000","00","012","1261","0000","1268","446","822","73","1341","2055","0","65.26","21.7"
"64","000","00","012","1261","1355","523","218","305","36","559","826","0","67.68","26.39"
"64","000","00","012","1261","1356","745","228","517","37","782","1229","0","63.63","18.55"
"64","000","00","012","1262","0000","1588","597","991","66","1654","2685","0","61.6","22.23"
"64","000","00","012","1262","1357","876","301","575","29","905","1467","0","61.69","20.52"
"64","000","00","012","1262","1358","712","296","416","37","749","1218","0","61.49","24.3"
"64","000","00","012","1263","0000","1664","756","908","54","1718","2584","0","66.49","29.26"
"64","000","00","012","1263","1379","863","399","464","22","885","1358","0","65.17","29.38"
"64","000","00","012","1263","1380","801","357","444","32","833","1226","0","67.94","29.12"
"64","000","00","012","1264","0000","1410","677","733","61","1471","2298","0","64.01","29.46"
"64","000","00","012","1264","1381","684","349","335","34","718","1098","0","65.39","31.79"
"64","000","00","012","1264","1382","726","328","398","27","753","1200","0","62.75","27.33"
"64","000","00","012","1265","0000","2289","1100","1189","78","2367","3785","0","62.54","29.06"
"64","000","00","012","1265","1401","675","349","326","25","700","1112","0","62.95","31.38"
"64","000","00","012","1265","1402","770","377","393","32","802","1198","0","66.94","31.47"
"64","000","00","012","1265","1403","844","374","470","21","865","1475","0","58.64","25.36"
"64","000","00","012","1266","0000","1377","693","684","53","1430","2286","0","62.55","30.31"
"64","000","00","012","1266","1389","750","382","368","33","783","1180","0","66.36","32.37"
"64","000","00","012","1266","1390","627","311","316","20","647","1106","0","58.5","28.12"
"64","000","00","012","1267","0000","2649","1257","1392","84","2733","4313","0","63.37","29.14"
"64","000","00","012","1267","1394","815","377","438","15","830","1361","0","60.98","27.7"
"64","000","00","012","1267","1395","852","420","432","39","891","1416","0","62.92","29.66"
"64","000","00","012","1267","1396","982","460","522","30","1012","1536","0","65.89","29.95"
"64","000","00","012","1268","0000","2425","1025","1400","110","2535","4061","0","62.42","25.24"
"64","000","00","012","1268","1391","862","343","519","48","910","1442","0","63.11","23.79"
"64","000","00","012","1268","1392","826","358","468","36","862","1376","0","62.65","26.02"
"64","000","00","012","1268","1393","737","324","413","26","763","1243","0","61.38","26.07"
"64","000","00","012","1269","0000","1416","695","721","57","1473","2515","0","58.57","27.63"
"64","000","00","012","1269","1415","676","362","314","34","710","1190","0","59.66","30.42"
"64","000","00","012","1269","1416","740","333","407","23","763","1325","0","57.58","25.13"
"64","000","00","012","1270","0000","2635","1383","1252","102","2737","4481","0","61.08","30.86"
"64","000","00","012","1270","1417","633","303","330","34","667","1049","0","63.58","28.88"
"64","000","00","012","1270","1418","626","326","300","20","646","1026","0","62.96","31.77"
"64","000","00","012","1270","1419","692","320","372","36","728","1152","0","63.19","27.78"
"64","000","00","012","1270","1420","684","434","250","12","696","1254","0","55.5","34.61"
"64","000","00","012","1271","0000","2479","1151","1328","106","2585","4456","0","58.01","25.83"
"64","000","00","012","1271","1412","753","366","387","17","770","1417","0","54.34","25.83"
"64","000","00","012","1271","1413","847","403","444","50","897","1525","0","58.82","26.43"
"64","000","00","012","1271","1414","879","382","497","39","918","1514","0","60.63","25.23"
"64","000","00","012","1272","0000","2553","1308","1245","112","2665","4447","0","59.93","29.41"
"64","000","00","012","1272","1440","745","393","352","33","778","1369","0","56.83","28.71"
"64","000","00","012","1272","1441","878","453","425","45","923","1542","0","59.86","29.38"
"64","000","00","012","1272","1442","930","462","468","34","964","1536","0","62.76","30.08"
"64","000","00","012","1273","0000","1659","902","757","66","1725","2834","0","60.87","31.83"
"64","000","00","012","1273","1443","794","416","378","18","812","1382","0","58.76","30.1"
"64","000","00","012","1273","1444","865","486","379","48","913","1452","0","62.88","33.47"
"64","000","00","012","1274","0000","1483","696","787","62","1545","2432","0","63.53","28.62"
"64","000","00","012","1274","1455","707","324","383","36","743","1125","0","66.04","28.8"
"64","000","00","012","1274","1456","776","372","404","26","802","1307","0","61.36","28.46"
"64","000","00","012","1275","0000","3031","1496","1535","168","3199","5431","0","58.9","27.55"
"64","000","00","012","1275","1451","702","370","332","24","726","1208","0","60.1","30.63"
"64","000","00","012","1275","1452","694","340","354","51","745","1202","0","61.98","28.29"
"64","000","00","012","1275","1453","823","408","415","58","881","1499","0","58.77","27.22"
"64","000","00","012","1275","1454","812","378","434","35","847","1522","0","55.65","24.84"
"64","000","00","012","1276","0000","1528","750","778","81","1609","2657","0","60.56","28.23"
"64","000","00","012","1276","1457","809","406","403","40","849","1405","0","60.43","28.9"
"64","000","00","012","1276","1458","719","344","375","41","760","1252","0","60.7","27.48"
"64","000","00","012","1277","0000","1474","786","688","56","1530","2706","0","56.54","29.05"
"64","000","00","012","1277","1479","750","414","336","34","784","1353","0","57.95","30.6"
"64","000","00","012","1277","1480","724","372","352","22","746","1353","0","55.14","27.49"
"64","000","00","012","1278","0000","3574","1618","1956","152","3726","6056","0","61.53","26.72"
"64","000","00","012","1278","1434","1185","519","666","70","1255","2032","0","61.76","25.54"
"64","000","00","012","1278","1435","1125","523","602","39","1164","1927","0","60.4","27.14"
"64","000","00","012","1278","1436","1264","576","688","43","1307","2097","0","62.33","27.47"
"64","000","00","013","0000","0000","32102","16857","15245","1695","33797","59129","69829","57.16","28.51"
"64","000","00","013","1301","0000","1542","780","762","92","1634","2824","0","57.86","27.62"
"64","000","00","013","1301","1773","735","393","342","46","781","1262","0","61.89","31.14"
"64","000","00","013","1301","1774","807","387","420","46","853","1562","0","54.61","24.78"
"64","000","00","013","1302","0000","1864","952","912","98","1962","3252","0","60.33","29.27"
"64","000","00","013","1302","1775","623","318","305","23","646","1078","0","59.93","29.5"
"64","000","00","013","1302","1776","595","280","315","37","632","979","0","64.56","28.6"
"64","000","00","013","1302","1777","646","354","292","38","684","1195","0","57.24","29.62"
"64","000","00","013","1303","0000","2092","1014","1078","104","2196","3929","0","55.89","25.81"
"64","000","00","013","1303","1778","713","353","360","46","759","1380","0","55.0","25.58"
"64","000","00","013","1303","1779","699","320","379","39","738","1280","0","57.66","25.0"
"64","000","00","013","1303","1780","680","341","339","19","699","1269","0","55.08","26.87"
"64","000","00","013","1304","0000","1376","663","713","58","1434","2794","0","51.32","23.73"
"64","000","00","013","1304","1781","679","338","341","17","696","1568","0","44.39","21.56"
"64","000","00","013","1304","1782","697","325","372","41","738","1226","0","60.2","26.51"
"64","000","00","013","1305","0000","1604","719","885","86","1690","2939","0","57.5","24.46"
"64","000","00","013","1305","1783","775","351","424","48","823","1480","0","55.61","23.72"
"64","000","00","013","1305","1784","829","368","461","38","867","1459","0","59.42","25.22"
"64","000","00","013","1306","0000","1334","726","608","96","1430","2488","0","57.48","29.18"
"64","000","00","013","1306","1785","836","459","377","45","881","1593","0","55.3","28.81"
"64","000","00","013","1306","1786","498","267","231","51","549","895","0","61.34","29.83"
"64","000","00","013","1307","0000","2467","1313","1154","123","2590","4455","0","58.14","29.47"
"64","000","00","013","1307","1787","562","290","272","27","589","1110","0","53.06","26.13"
"64","000","00","013","1307","1788","714","390","324","26","740","1348","0","54.9","28.93"
"64","000","00","013","1307","1789","520","283","237","32","552","912","0","60.53","31.03"
"64","000","00","013","1307","1790","671","350","321","38","709","1085","0","65.35","32.26"
"64","000","00","013","1308","0000","1045","568","477","64","1109","1834","0","60.47","30.97"
"64","000","00","013","1308","1791","523","277","246","37","560","955","0","58.64","29.01"
"64","000","00","013","1308","1792","522","291","231","27","549","879","0","62.46","33.11"
"64","000","00","013","1309","0000","1935","1052","883","96","2031","3449","0","58.89","30.5"
"64","000","00","013","1309","1793","621","360","261","35","656","1103","0","59.47","32.64"
"64","000","00","013","1309","1794","647","351","296","43","690","1054","0","65.46","33.3"
"64","000","00","013","1309","1795","667","341","326","18","685","1292","0","53.02","26.39"
"64","000","00","013","1310","0000","824","439","385","15","839","1683","0","49.85","26.08"
"64","000","00","013","1310","1796","824","439","385","15","839","1683","0","49.85","26.08"
"64","000","00","013","1311","0000","889","445","444","62","951","1619","0","58.74","27.49"
"64","000","00","013","1311","1797","335","152","183","21","356","607","0","58.65","25.04"
"64","000","00","013","1311","1798","554","293","261","41","595","1012","0","58.79","28.95"
"64","000","00","013","1312","0000","1007","498","509","57","1064","1960","0","54.29","25.41"
"64","000","00","013","1312","1799","584","314","270","36","620","1046","0","59.27","30.02"
"64","000","00","013","1312","1800","423","184","239","21","444","914","0","48.58","20.13"
"64","000","00","013","1313","0000","2220","1082","1138","115","2335","3874","0","60.27","27.93"
"64","000","00","013","1313","1801","804","396","408","39","843","1405","0","60.0","28.19"
"64","000","00","013","1313","1802","756","360","396","48","804","1299","0","61.89","27.71"
"64","000","00","013","1313","1803","660","326","334","28","688","1170","0","58.8","27.86"
"64","000","00","013","1314","0000","626","349","277","31","657","1299","0","50.58","26.87"
"64","000","00","013","1314","1804","626","349","277","31","657","1299","0","50.58","26.87"
"64","000","00","013","1315","0000","1047","537","510","39","1086","1880","0","57.77","28.56"
"64","000","00","013","1315","1805","567","277","290","25","592","1031","0","57.42","26.87"
"64","000","00","013","1315","1806","480","260","220","14","494","849","0","58.19","30.62"
"64","000","00","013","1316","0000","1026","610","416","54","1080","1776","0","60.81","34.35"
"64","000","00","013","1316","1807","462","293","169","37","499","838","0","59.55","34.96"
"64","000","00","013","1316","1808","564","317","247","17","581","938","0","61.94","33.8"
"64","000","00","013","1317","0000","992","575","417","64","1056","1837","0","57.49","31.3"
"64","000","00","013","1317","1809","540","309","231","32","572","1051","0","54.42","29.4"
"64","000","00","013","1317","1810","452","266","186","32","484","786","0","61.58","33.84"
"64","000","00","013","1318","0000","513","301","212","64","577","894","0","64.54","33.67"
"64","000","00","013","1318","1811","513","301","212","64","577","894","0","64.54","33.67"
"64","000","00","013","1319","0000","334","201","133","14","348","749","0","46.46","26.84"
"64","000","00","013","1319","1812","334","201","133","14","348","749","0","46.46","26.84"
"64","000","00","013","1320","0000","1736","920","816","100","1836","2963","0","61.96","31.05"
"64","000","00","013","1320","1813","887","473","414","38","925","1485","0","62.29","31.85"
"64","000","00","013","1320","1814","849","447","402","62","911","1478","0","61.64","30.24"
"64","000","00","013","1321","0000","1371","776","595","66","1437","2383","0","60.3","32.56"
"64","000","00","013","1321","1815","807","376","431","49","856","1345","0","63.64","27.96"
"64","000","00","013","1321","1816","564","400","164","17","581","1038","0","55.97","38.54"
"64","000","00","013","1322","0000","1828","964","864","70","1898","3366","0","56.39","28.64"
"64","000","00","013","1322","1817","672","366","306","29","701","1203","0","58.27","30.42"
"64","000","00","013","1322","1818","644","352","292","24","668","1138","0","58.7","30.93"
"64","000","00","013","1322","1819","512","246","266","17","529","1025","0","51.61","24.0"
"64","000","00","013","1323","0000","1300","689","611","85","1385","2559","0","54.12","26.92"
"64","000","00","013","1323","1820","732","378","354","63","795","1341","0","59.28","28.19"
"64","000","00","013","1323","1821","568","311","257","22","590","1218","0","48.44","25.53"
"64","000","00","013","1324","0000","1130","684","446","42","1172","2323","0","50.45","29.44"
"64","000","00","013","1324","1822","552","334","218","22","574","1147","0","50.04","29.12"
"64","000","00","013","1324","1823","578","350","228","20","598","1176","0","50.85","29.76"
"64","000","00","014","0000","0000","53950","27099","26851","2677","56627","97309","112334","58.19","27.85"
"64","000","00","014","1401","0000","772","468","304","37","809","1445","0","55.99","32.39"
"64","000","00","014","1401","1692","390","243","147","20","410","727","0","56.4","33.43"
"64","000","00","014","1401","1693","382","225","157","17","399","718","0","55.57","31.34"
"64","000","00","014","1402","0000","2676","1274","1402","110","2786","5733","0","48.6","22.22"
"64","000","00","014","1402","1694","684","333","351","32","716","1340","0","53.43","24.85"
"64","000","00","014","1402","1695","722","343","379","26","748","1575","0","47.49","21.78"
"64","000","00","014","1402","1696","247","128","119","17","264","444","0","59.46","28.83"
"64","000","00","014","1402","1697","1023","470","553","35","1058","2374","0","44.57","19.8"
"64","000","00","014","1403","0000","3587","1884","1703","186","3773","6681","0","56.47","28.2"
"64","000","00","014","1403","1698","698","389","309","41","739","1291","0","57.24","30.13"
"64","000","00","014","1403","1699","775","390","385","48","823","1400","0","58.79","27.86"
"64","000","00","014","1403","1700","749","389","360","25","774","1390","0","55.68","27.99"
"64","000","00","014","1403","1701","740","403","337","48","788","1401","0","56.25","28.77"
"64","000","00","014","1403","1702","625","313","312","24","649","1199","0","54.13","26.11"
"64","000","00","014","1404","0000","1272","720","552","59","1331","2405","0","55.34","29.94"
"64","000","00","014","1404","1703","618","352","266","19","637","1210","0","52.64","29.09"
"64","000","00","014","1404","1704","654","368","286","40","694","1195","0","58.08","30.79"
"64","000","00","014","1405","0000","2493","1347","1146","128","2621","4595","0","57.04","29.31"
"64","000","00","014","1405","1705","637","368","269","22","659","1166","0","56.52","31.56"
"64","000","00","014","1405","1706","750","392","358","35","785","1353","0","58.02","28.97"
"64","000","00","014","1405","1707","599","300","299","49","648","1052","0","61.6","28.52"
"64","000","00","014","1405","1708","507","287","220","22","529","1024","0","51.66","28.03"
"64","000","00","014","1406","0000","2398","1285","1113","114","2512","4334","0","57.96","29.65"
"64","000","00","014","1406","1709","682","381","301","16","698","1189","0","58.7","32.04"
"64","000","00","014","1406","1710","868","439","429","50","918","1512","0","60.71","29.03"
"64","000","00","014","1406","1711","848","465","383","48","896","1633","0","54.87","28.48"
"64","000","00","014","1407","0000","2335","1307","1028","115","2450","3795","0","64.56","34.44"
"64","000","00","014","1407","1712","755","427","328","22","777","1214","0","64.0","35.17"
"64","000","00","014","1407","1713","776","422","354","67","843","1258","0","67.01","33.55"
"64","000","00","014","1407","1714","804","458","346","26","830","1323","0","62.74","34.62"
"64","000","00","014","1408","0000","1352","628","724","83","1435","2288","0","62.72","27.45"
"64","000","00","014","1408","1715","746","334","412","32","778","1253","0","62.09","26.66"
"64","000","00","014","1408","1716","606","294","312","51","657","1035","0","63.48","28.41"
"64","000","00","014","1409","0000","6097","2956","3141","295","6392","10761","0","59.4","27.47"
"64","000","00","014","1409","1717","626","302","324","29","655","1106","0","59.22","27.31"
"64","000","00","014","1409","1718","657","335","322","30","687","1195","0","57.49","28.03"
"64","000","00","014","1409","1719","639","356","283","24","663","1051","0","63.08","33.87"
"64","000","00","014","1409","1720","821","392","429","47","868","1425","0","60.91","27.51"
"64","000","00","014","1409","1721","890","396","494","37","927","1635","0","56.7","24.22"
"64","000","00","014","1409","1722","787","413","374","39","826","1359","0","60.78","30.39"
"64","000","00","014","1409","1723","765","352","413","54","819","1361","0","60.18","25.86"
"64","000","00","014","1409","1724","912","410","502","35","947","1629","0","58.13","25.17"
"64","000","00","014","1410","0000","4167","2313","1854","175","4342","7606","0","57.09","30.41"
"64","000","00","014","1410","1725","845","375","470","43","888","1518","0","58.5","24.7"
"64","000","00","014","1410","1726","872","380","492","45","917","1620","0","56.6","23.46"
"64","000","00","014","1410","1727","871","430","441","23","894","1648","0","54.25","26.09"
"64","000","00","014","1410","1728","783","753","30","46","829","1385","0","59.86","54.37"
"64","000","00","014","1410","1729","796","375","421","18","814","1435","0","56.72","26.13"
"64","000","00","014","1411","0000","1007","567","440","48","1055","1835","0","57.49","30.9"
"64","000","00","014","1411","1730","601","331","270","19","620","1046","0","59.27","31.64"
"64","000","00","014","1411","1731","406","236","170","29","435","789","0","55.13","29.91"
"64","000","00","014","1412","0000","890","499","391","57","947","1642","0","57.67","30.39"
"64","000","00","014","1412","1732","470","244","226","28","498","909","0","54.79","26.84"
"64","000","00","014","1412","1733","420","255","165","29","449","733","0","61.26","34.79"
"64","000","00","014","1413","0000","1296","645","651","87","1383","2475","0","55.88","26.06"
"64","000","00","014","1413","1734","800","391","409","57","857","1553","0","55.18","25.18"
"64","000","00","014","1413","1735","496","254","242","30","526","922","0","57.05","27.55"
"64","000","00","014","1414","0000","1642","957","685","125","1767","3001","0","58.88","31.89"
"64","000","00","014","1414","1736","546","313","233","52","598","1012","0","59.09","30.93"
"64","000","00","014","1414","1737","507","313","194","40","547","968","0","56.51","32.33"
"64","000","00","014","1414","1738","589","331","258","33","622","1021","0","60.92","32.42"
"64","000","00","014","1415","0000","751","406","345","39","790","1554","0","50.84","26.13"
"64","000","00","014","1415","1739","751","406","345","39","790","1554","0","50.84","26.13"
"64","000","00","014","1416","0000","3231","1505","1726","135","3366","6101","0","55.17","24.67"
"64","000","00","014","1416","1740","658","330","328","29","687","1120","0","61.34","29.46"
"64","000","00","014","1416","1741","727","350","377","34","761","1225","0","62.12","28.57"
"64","000","00","014","1416","1742","488","219","269","23","511","1320","0","38.71","16.59"
"64","000","00","014","1416","1743","726","329","397","39","765","1317","0","58.09","24.98"
"64","000","00","014","1416","1744","632","277","355","10","642","1119","0","57.37","24.75"
"64","000","00","014","1417","0000","4416","1999","2417","164","4580","7467","0","61.34","26.77"
"64","000","00","014","1417","1745","695","352","343","28","723","1190","0","60.76","29.58"
"64","000","00","014","1417","1746","714","320","394","42","756","1229","0","61.51","26.04"
"64","000","00","014","1417","1747","723","293","430","30","753","1178","0","63.92","24.87"
"64","000","00","014","1417","1748","775","336","439","22","797","1272","0","62.66","26.42"
"64","000","00","014","1417","1749","781","380","401","20","801","1413","0","56.69","26.89"
"64","000","00","014","1417","1750","728","318","410","22","750","1185","0","63.29","26.84"
"64","000","00","014","1418","0000","322","111","211","6","328","553","0","59.31","20.07"
"64","000","00","014","1418","1751","322","111","211","6","328","553","0","59.31","20.07"
"64","000","00","014","1419","0000","3938","1954","1984","184","4122","6837","0","60.29","28.58"
"64","000","00","014","1419","1752","611","315","296","51","662","1121","0","59.05","28.1"
"64","000","00","014","1419","1753","709","339","370","22","731","1227","0","59.58","27.63"
"64","000","00","014","1419","1754","675","326","349","46","721","1058","0","68.15","30.81"
"64","000","00","014","1419","1755","674","350","324","24","698","1209","0","57.73","28.95"
"64","000","00","014","1419","1756","657","325","332","21","678","1100","0","61.64","29.55"
"64","000","00","014","1419","1757","612","299","313","20","632","1122","0","56.33","26.65"
"64","000","00","014","1420","0000","1227","682","545","63","1290","2175","0","59.31","31.36"
"64","000","00","014","1420","1758","606","343","263","44","650","983","0","66.12","34.89"
"64","000","00","014","1420","1759","621","339","282","19","640","1192","0","53.69","28.44"
"64","000","00","014","1421","0000","918","455","463","39","957","1548","0","61.82","29.39"
"64","000","00","014","1421","1760","407","196","211","23","430","719","0","59.81","27.26"
"64","000","00","014","1421","1761","511","259","252","16","527","829","0","63.57","31.24"
"64","000","00","014","1422","0000","1128","578","550","93","1221","1846","0","66.14","31.31"
"64","000","00","014","1422","1762","489","231","258","44","533","771","0","69.13","29.96"
"64","000","00","014","1422","1763","639","347","292","49","688","1075","0","64.0","32.28"
"64","000","00","014","1423","0000","2065","1096","969","128","2193","3669","0","59.77","29.87"
"64","000","00","014","1423","1764","737","404","333","60","797","1280","0","62.27","31.56"
"64","000","00","014","1423","1765","665","359","306","40","705","1179","0","59.8","30.45"
"64","000","00","014","1423","1766","663","333","330","28","691","1210","0","57.11","27.52"
"64","000","00","014","1424","0000","112","46","66","8","120","189","0","63.49","24.34"
"64","000","00","014","1424","1767","112","46","66","8","120","189","0","63.49","24.34"
"64","000","00","014","1425","0000","3858","1417","2441","199","4057","6774","0","59.89","20.92"
"64","000","00","014","1425","1768","707","256","451","50","757","1228","0","61.64","20.85"
"64","000","00","014","1425","1769","644","251","393","39","683","1170","0","58.38","21.45"
"64","000","00","014","1425","1770","837","284","553","40","877","1416","0","61.94","20.06"
"64","000","00","014","1425","1771","876","353","523","36","912","1482","0","61.54","23.82"
"64","000","00","014","1425","1772","794","273","521","34","828","1478","0","56.02","18.47"
"64","000","00","015","0000","0000","20389","10872","9517","985","21374","36772","42431","58.13","29.57"
"64","000","00","015","1501","0000","1606","794","812","55","1661","2701","0","61.5","29.4"
"64","000","00","015","1501","0736","770","396","374","30","800","1386","0","57.72","28.57"
"64","000","00","015","1501","0737","836","398","438","25","861","1315","0","65.48","30.27"
"64","000","00","015","1502","0000","2700","1292","1408","124","2824","5000","0","56.48","25.84"
"64","000","00","015","1502","0738","1302","608","694","58","1360","2461","0","55.26","24.71"
"64","000","00","015","1502","0739","723","357","366","21","744","1274","0","58.4","28.02"
"64","000","00","015","1502","0740","675","327","348","45","720","1265","0","56.92","25.85"
"64","000","00","015","1503","0000","2226","1100","1126","78","2304","4126","0","55.84","26.66"
"64","000","00","015","1503","0741","809","379","430","43","852","1504","0","56.65","25.2"
"64","000","00","015","1503","0742","553","285","268","22","575","1049","0","54.81","27.17"
"64","000","00","015","1503","0743","864","436","428","13","877","1573","0","55.75","27.72"
"64","000","00","015","1504","0000","1346","879","467","66","1412","2328","0","60.65","37.76"
"64","000","00","015","1504","0744","586","341","245","25","611","1121","0","54.5","30.42"
"64","000","00","015","1504","0745","760","538","222","41","801","1207","0","66.36","44.57"
"64","000","00","015","1505","0000","1345","749","596","49","1394","2258","0","61.74","33.17"
"64","000","00","015","1505","0746","645","342","303","22","667","1134","0","58.82","30.16"
"64","000","00","015","1505","0747","700","407","293","27","727","1124","0","64.68","36.21"
"64","000","00","015","1506","0000","1957","1051","906","117","2074","3492","0","59.39","30.1"
"64","000","00","015","1506","0748","678","373","305","42","720","1259","0","57.19","29.63"
"64","000","00","015","1506","0749","654","337","317","44","698","1105","0","63.17","30.5"
"64","000","00","015","1506","0750","625","341","284","31","656","1128","0","58.16","30.23"
"64","000","00","015","1507","0000","564","329","235","46","610","1079","0","56.53","30.49"
"64","000","00","015","1507","0751","564","329","235","46","610","1079","0","56.53","30.49"
"64","000","00","015","1508","0000","537","304","233","40","577","1025","0","56.29","29.66"
"64","000","00","015","1508","0752","537","304","233","40","577","1025","0","56.29","29.66"
"64","000","00","015","1509","0000","507","288","219","30","537","950","0","56.53","30.32"
"64","000","00","015","1509","0753","507","288","219","30","537","950","0","56.53","30.32"
"64","000","00","015","1510","0000","776","439","337","52","828","1433","0","57.78","30.64"
"64","000","00","015","1510","0754","776","439","337","52","828","1433","0","57.78","30.64"
"64","000","00","015","1511","0000","793","468","325","37","830","1575","0","52.7","29.71"
"64","000","00","015","1511","0755","417","241","176","18","435","794","0","54.79","30.35"
"64","000","00","015","1511","0756","376","227","149","19","395","781","0","50.58","29.07"
"64","000","00","015","1512","0000","654","335","319","20","674","1318","0","51.14","25.42"
"64","000","00","015","1512","0757","654","335","319","20","674","1318","0","51.14","25.42"
"64","000","00","015","1513","0000","920","561","359","46","966","1783","0","54.18","31.46"
"64","000","00","015","1513","0758","401","245","156","31","432","736","0","58.7","33.29"
"64","000","00","015","1513","0759","519","316","203","15","534","1047","0","51.0","30.18"
"64","000","00","015","1514","0000","1314","717","597","83","1397","2457","0","56.86","29.18"
"64","000","00","015","1514","0760","712","407","305","48","760","1271","0","59.8","32.02"
"64","000","00","015","1514","0761","602","310","292","35","637","1186","0","53.71","26.14"
"64","000","00","015","1515","0000","579","307","272","37","616","1007","0","61.17","30.49"
"64","000","00","015","1515","0762","579","307","272","37","616","1007","0","61.17","30.49"
"64","000","00","015","1516","0000","925","533","392","29","954","1594","0","59.85","33.44"
"64","000","00","015","1516","0763","511","290","221","18","529","859","0","61.58","33.76"
"64","000","00","015","1516","0764","414","243","171","11","425","735","0","57.82","33.06"
"64","000","00","015","1517","0000","1248","520","728","64","1312","1926","0","68.12","27.0"
"64","000","00","015","1517","0765","618","372","246","40","658","1046","0","62.91","35.56"
"64","000","00","015","1517","0766","630","148","482","24","654","880","0","74.32","16.82"
"64","000","00","015","1518","0000","392","206","186","12","404","720","0","56.11","28.61"
"64","000","00","015","1518","0767","392","206","186","12","404","720","0","56.11","28.61"
"64","000","00","016","0000","0000","16728","8762","7966","829","17557","30046","34591","58.43","29.16"
"64","000","00","016","1601","0000","508","280","228","43","551","950","0","58.0","29.47"
"64","000","00","016","1601","0637","508","280","228","43","551","950","0","58.0","29.47"
"64","000","00","016","1602","0000","1509","714","795","51","1560","3162","0","49.34","22.58"
"64","000","00","016","1602","0638","678","356","322","30","708","1306","0","54.21","27.26"
"64","000","00","016","1602","0639","831","358","473","21","852","1856","0","45.91","19.29"
"64","000","00","016","1603","0000","2870","1520","1350","151","3021","4968","0","60.81","30.6"
"64","000","00","016","1603","0640","610","335","275","37","647","986","0","65.62","33.98"
"64","000","00","016","1603","0641","534","274","260","39","573","1116","0","51.34","24.55"
"64","000","00","016","1603","0642","781","443","338","36","817","1253","0","65.2","35.36"
"64","000","00","016","1603","0643","945","468","477","39","984","1613","0","61.0","29.01"
"64","000","00","016","1604","0000","920","502","418","39","959","1679","0","57.12","29.9"
"64","000","00","016","1604","0659","369","215","154","11","380","745","0","51.01","28.86"
"64","000","00","016","1604","0660","551","287","264","28","579","934","0","61.99","30.73"
"64","000","00","016","1605","0000","1533","855","678","90","1623","2661","0","60.99","32.13"
"64","000","00","016","1605","0646","565","287","278","52","617","1004","0","61.45","28.59"
"64","000","00","016","1605","0647","523","299","224","23","546","879","0","62.12","34.02"
"64","000","00","016","1605","0648","445","269","176","15","460","778","0","59.13","34.58"
"64","000","00","016","1606","0000","3188","1688","1500","153","3341","5391","0","61.97","31.31"
"64","000","00","016","1606","0649","659","350","309","29","688","1110","0","61.98","31.53"
"64","000","00","016","1606","0650","783","418","365","40","823","1432","0","57.47","29.19"
"64","000","00","016","1606","0651","885","457","428","31","916","1466","0","62.48","31.17"
"64","000","00","016","1606","0652","861","463","398","53","914","1383","0","66.09","33.48"
"64","000","00","016","1607","0000","2627","1304","1323","124","2751","4950","0","55.58","26.34"
"64","000","00","016","1607","0653","853","384","469","41","894","1645","0","54.35","23.34"
"64","000","00","016","1607","0654","776","393","383","41","817","1555","0","52.54","25.27"
"64","000","00","016","1607","0655","998","527","471","42","1040","1750","0","59.43","30.11"
"64","000","00","016","1608","0000","1819","946","873","121","1940","3156","0","61.47","29.97"
"64","000","00","016","1608","0656","631","346","285","41","672","1111","0","60.49","31.14"
"64","000","00","016","1608","0657","658","342","316","43","701","1133","0","61.87","30.19"
"64","000","00","016","1608","0658","530","258","272","37","567","912","0","62.17","28.29"
"64","000","00","016","1609","0000","1754","953","801","57","1811","3129","0","57.88","30.46"
"64","000","00","016","1609","0644","759","399","360","24","783","1455","0","53.81","27.42"
"64","000","00","016","1609","0645","995","554","441","33","1028","1674","0","61.41","33.09"
"64","000","00","017","0000","0000","42238","21146","21092","1633","43871","73611","87415","59.6","28.73"
"64","000","00","017","1701","0000","2505","1212","1293","101","2606","4050","0","64.35","29.93"
"64","000","00","017","1701","0661","1145","574","571","46","1191","1777","0","67.02","32.3"
"64","000","00","017","1701","0662","1360","638","722","55","1415","2273","0","62.25","28.07"
"64","000","00","017","1702","0000","4540","2178","2362","190","4730","7511","0","62.97","29.0"
"64","000","00","017","1702","0663","895","456","439","31","926","1384","0","66.91","32.95"
"64","000","00","017","1702","0664","649","308","341","49","698","1170","0","59.66","26.32"
"64","000","00","017","1702","0665","786","416","370","34","820","1216","0","67.43","34.21"
"64","000","00","017","1702","0666","885","425","460","36","921","1598","0","57.63","26.6"
"64","000","00","017","1702","0667","1325","573","752","40","1365","2143","0","63.7","26.74"
"64","000","00","017","1703","0000","1493","770","723","93","1586","2638","0","60.12","29.19"
"64","000","00","017","1703","0668","719","392","327","41","760","1300","0","58.46","30.15"
"64","000","00","017","1703","0669","774","378","396","52","826","1338","0","61.73","28.25"
"64","000","00","017","1704","0000","2023","1002","1021","98","2121","3823","0","55.48","26.21"
"64","000","00","017","1704","0670","688","341","347","17","705","1217","0","57.93","28.02"
"64","000","00","017","1704","0671","576","301","275","51","627","1202","0","52.16","25.04"
"64","000","00","017","1704","0672","759","360","399","30","789","1404","0","56.2","25.64"
"64","000","00","017","1705","0000","454","259","195","31","485","830","0","58.43","31.2"
"64","000","00","017","1705","0673","454","259","195","31","485","830","0","58.43","31.2"
"64","000","00","017","1706","0000","2633","1369","1264","94","2727","5417","0","50.34","25.27"
"64","000","00","017","1706","0674","805","422","383","35","840","1802","0","46.61","23.42"
"64","000","00","017","1706","0675","995","510","485","36","1031","1877","0","54.93","27.17"
"64","000","00","017","1706","0676","833","437","396","23","856","1738","0","49.25","25.14"
"64","000","00","017","1707","0000","5000","2594","2406","185","5185","8679","0","59.74","29.89"
"64","000","00","017","1707","0677","865","488","377","49","914","1549","0","59.01","31.5"
"64","000","00","017","1707","0678","908","464","444","36","944","1579","0","59.78","29.39"
"64","000","00","017","1707","0679","795","415","380","23","818","1406","0","58.18","29.52"
"64","000","00","017","1707","0680","857","410","447","20","877","1461","0","60.03","28.06"
"64","000","00","017","1707","0681","791","394","397","32","823","1311","0","62.78","30.05"
"64","000","00","017","1707","0682","784","423","361","25","809","1373","0","58.92","30.81"
"64","000","00","017","1708","0000","1291","809","482","31","1322","2216","0","59.66","36.51"
"64","000","00","017","1708","0683","613","400","213","8","621","1035","0","60.0","38.65"
"64","000","00","017","1708","0684","678","409","269","23","701","1181","0","59.36","34.63"
"64","000","00","017","1709","0000","9375","4500","4875","330","9705","15899","0","61.04","28.3"
"64","000","00","017","1709","0685","897","494","403","48","945","1670","0","56.59","29.58"
"64","000","00","017","1709","0686","874","445","429","29","903","1576","0","57.3","28.24"
"64","000","00","017","1709","0687","953","447","506","38","991","1576","0","62.88","28.36"
"64","000","00","017","1709","0688","1161","505","656","31","1192","1915","0","62.25","26.37"
"64","000","00","017","1709","0689","972","481","491","23","995","1758","0","56.6","27.36"
"64","000","00","017","1709","0690","1147","512","635","41","1188","1892","0","62.79","27.06"
"64","000","00","017","1709","0691","1184","553","631","48","1232","2025","0","60.84","27.31"
"64","000","00","017","1709","0692","1220","534","686","43","1263","2014","0","62.71","26.51"
"64","000","00","017","1709","0693","967","529","438","29","996","1473","0","67.62","35.91"
"64","000","00","017","1710","0000","1129","616","513","42","1171","1923","0","60.89","32.03"
"64","000","00","017","1710","0694","577","336","241","21","598","979","0","61.08","34.32"
"64","000","00","017","1710","0695","552","280","272","21","573","944","0","60.7","29.66"
"64","000","00","017","1711","0000","1382","755","627","82","1464","2481","0","59.01","30.43"
"64","000","00","017","1711","0696","658","371","287","54","712","1153","0","61.75","32.18"
"64","000","00","017","1711","0697","724","384","340","28","752","1328","0","56.63","28.92"
"64","000","00","017","1712","0000","939","465","474","57","996","1657","0","60.11","28.06"
"64","000","00","017","1712","0698","939","465","474","57","996","1657","0","60.11","28.06"
"64","000","00","017","1713","0000","2656","1294","1362","106","2762","4564","0","60.52","28.35"
"64","000","00","017","1713","0699","798","411","387","37","835","1545","0","54.05","26.6"
"64","000","00","017","1713","0700","856","444","412","36","892","1417","0","62.95","31.33"
"64","000","00","017","1713","0701","1002","439","563","33","1035","1602","0","64.61","27.4"
"64","000","00","017","1714","0000","2246","1106","1140","70","2316","3737","0","61.97","29.6"
"64","000","00","017","1714","0702","1157","554","603","40","1197","1823","0","65.66","30.39"
"64","000","00","017","1714","0703","1089","552","537","30","1119","1914","0","58.46","28.84"
"64","000","00","017","1715","0000","3402","1633","1769","93","3495","6019","0","58.07","27.13"
"64","000","00","017","1715","0704","1143","541","602","41","1184","1992","0","59.44","27.16"
"64","000","00","017","1715","0705","1053","504","549","27","1080","2045","0","52.81","24.65"
"64","000","00","017","1715","0706","1206","588","618","25","1231","1982","0","62.11","29.67"
"64","000","00","017","1716","0000","1170","584","586","30","1200","2167","0","55.38","26.95"
"64","000","00","017","1716","0707","1170","584","586","30","1200","2167","0","55.38","26.95"
"64","000","00","018","0000","0000","23200","11883","11317","966","24166","39191","44387","61.66","30.32"
"64","000","00","018","1801","0000","5717","2846","2871","237","5954","10030","0","59.36","28.37"
"64","000","00","018","1801","0708","968","451","517","30","998","1678","0","59.48","26.88"
"64","000","00","018","1801","0709","883","427","456","49","932","1682","0","55.41","25.39"
"64","000","00","018","1801","0710","756","397","359","40","796","1225","0","64.98","32.41"
"64","000","00","018","1801","0711","697","338","359","40","737","1322","0","55.75","25.57"
"64","000","00","018","1801","0712","719","340","379","26","745","1215","0","61.32","27.98"
"64","000","00","018","1801","0713","966","486","480","38","1004","1779","0","56.44","27.32"
"64","000","00","018","1801","0714","728","407","321","14","742","1129","0","65.72","36.05"
"64","000","00","018","1802","0000","2837","1452","1385","91","2928","4682","0","62.54","31.01"
"64","000","00","018","1802","0715","838","382","456","33","871","1374","0","63.39","27.8"
"64","000","00","018","1802","0716","649","474","175","25","674","1089","0","61.89","43.53"
"64","000","00","018","1802","0717","1350","596","754","33","1383","2219","0","62.33","26.86"
"64","000","00","018","1803","0000","6063","2908","3155","205","6268","9817","0","63.85","29.62"
"64","000","00","018","1803","0718","978","524","454","24","1002","1634","0","61.32","32.07"
"64","000","00","018","1803","0719","947","409","538","49","996","1553","0","64.13","26.34"
"64","000","00","018","1803","0720","980","440","540","31","1011","1572","0","64.31","27.99"
"64","000","00","018","1803","0721","1047","508","539","33","1080","1688","0","63.98","30.09"
"64","000","00","018","1803","0722","1012","499","513","22","1034","1626","0","63.59","30.69"
"64","000","00","018","1803","0723","1099","528","571","46","1145","1744","0","65.65","30.28"
"64","000","00","018","1804","0000","2124","1371","753","99","2223","3548","0","62.66","38.64"
"64","000","00","018","1804","0724","657","348","309","33","690","1230","0","56.1","28.29"
"64","000","00","018","1804","0725","737","664","73","41","778","1201","0","64.78","55.29"
"64","000","00","018","1804","0726","730","359","371","25","755","1117","0","67.59","32.14"
"64","000","00","018","1805","0000","3633","1809","1824","213","3846","6462","0","59.52","27.99"
"64","000","00","018","1805","0727","701","370","331","56","757","1255","0","60.32","29.48"
"64","000","00","018","1805","0728","758","354","404","30","788","1432","0","55.03","24.72"
"64","000","00","018","1805","0729","728","378","350","34","762","1370","0","55.62","27.59"
"64","000","00","018","1805","0730","826","384","442","34","860","1364","0","63.05","28.15"
"64","000","00","018","1805","0731","620","323","297","59","679","1041","0","65.23","31.03"
"64","000","00","018","1806","0000","487","280","207","24","511","702","0","72.79","39.89"
"64","000","00","018","1806","0732","487","280","207","24","511","702","0","72.79","39.89"
"64","000","00","018","1807","0000","2339","1217","1122","97","2436","3950","0","61.67","30.81"
"64","000","00","018","1807","0733","700","421","279","38","738","1212","0","60.89","34.74"
"64","000","00","018","1807","0734","721","342","379","40","761","1289","0","59.04","26.53"
"64","000","00","018","1807","0735","918","454","464","19","937","1449","0","64.67","31.33"
"64","000","00","019","0000","0000","48774","22483","26291","2034","50808","81244","97072","62.54","27.67"
"64","000","00","019","1901","0000","734","360","374","42","776","1159","0","66.95","31.06"
"64","000","00","019","1901","0268","734","360","374","42","776","1159","0","66.95","31.06"
"64","000","00","019","1902","0000","2563","1268","1295","93","2656","4358","0","60.95","29.1"
"64","000","00","019","1902","0261","871","402","469","31","902","1345","0","67.06","29.89"
"64","000","00","019","1902","0262","497","274","223","27","524","1045","0","50.14","26.22"
"64","000","00","019","1902","0263","626","298","328","19","645","1051","0","61.37","28.35"
"64","000","00","019","1902","0264","569","294","275","16","585","917","0","63.79","32.06"
"64","000","00","019","1903","0000","2043","906","1137","83","2126","3239","0","65.64","27.97"
"64","000","00","019","1903","0265","592","295","297","24","616","934","0","65.95","31.58"
"64","000","00","019","1903","0266","671","304","367","31","702","1097","0","63.99","27.71"
"64","000","00","019","1903","0267","780","307","473","28","808","1208","0","66.89","25.41"
"64","000","00","019","1904","0000","614","304","310","27","641","1018","0","62.97","29.86"
"64","000","00","019","1904","0269","614","304","310","27","641","1018","0","62.97","29.86"
"64","000","00","019","1905","0000","2440","1000","1440","71","2511","4091","0","61.38","24.44"
"64","000","00","019","1905","0274","752","386","366","43","795","1328","0","59.86","29.07"
"64","000","00","019","1905","0275","846","333","513","17","863","1382","0","62.45","24.1"
"64","000","00","019","1905","0276","842","281","561","11","853","1381","0","61.77","20.35"
"64","000","00","019","1906","0000","730","425","305","21","751","1316","0","57.07","32.29"
"64","000","00","019","1906","0270","730","425","305","21","751","1316","0","57.07","32.29"
"64","000","00","019","1907","0000","1801","450","1351","50","1851","2895","0","63.94","15.54"
"64","000","00","019","1907","0325","781","186","595","37","818","1336","0","61.23","13.92"
"64","000","00","019","1907","0326","763","150","613","9","772","1218","0","63.38","12.32"
"64","000","00","019","1907","0327","257","114","143","4","261","341","0","76.54","33.43"
"64","000","00","019","1908","0000","236","115","121","6","242","318","0","76.1","36.16"
"64","000","00","019","1908","0332","236","115","121","6","242","318","0","76.1","36.16"
"64","000","00","019","1909","0000","1582","715","867","64","1646","2795","0","58.89","25.58"
"64","000","00","019","1909","0293","748","346","402","32","780","1283","0","60.8","26.97"
"64","000","00","019","1909","0294","834","369","465","32","866","1512","0","57.28","24.4"
"64","000","00","019","1910","0000","811","449","362","19","830","1413","0","58.74","31.78"
"64","000","00","019","1910","0309","811","449","362","19","830","1413","0","58.74","31.78"
"64","000","00","019","1911","0000","2168","965","1203","107","2275","3607","0","63.07","26.75"
"64","000","00","019","1911","0304","754","328","426","33","787","1272","0","61.87","25.79"
"64","000","00","019","1911","0305","664","267","397","35","699","1080","0","64.72","24.72"
"64","000","00","019","1911","0306","750","370","380","39","789","1255","0","62.87","29.48"
"64","000","00","019","1912","0000","3363","1423","1940","129","3492","5535","0","63.09","25.71"
"64","000","00","019","1912","0300","841","376","465","26","867","1360","0","63.75","27.65"
"64","000","00","019","1912","0301","848","391","457","27","875","1363","0","64.2","28.69"
"64","000","00","019","1912","0302","834","321","513","47","881","1352","0","65.16","23.74"
"64","000","00","019","1912","0303","840","335","505","29","869","1460","0","59.52","22.95"
"64","000","00","019","1913","0000","1072","414","658","39","1111","1613","0","68.88","25.67"
"64","000","00","019","1913","0330","548","232","316","28","576","851","0","67.69","27.26"
"64","000","00","019","1913","0331","524","182","342","11","535","762","0","70.21","23.88"
"64","000","00","019","1914","0000","487","288","199","35","522","756","0","69.05","38.1"
"64","000","00","019","1914","0320","487","288","199","35","522","756","0","69.05","38.1"
"64","000","00","019","1915","0000","477","277","200","18","495","866","0","57.16","31.99"
"64","000","00","019","1915","0323","477","277","200","18","495","866","0","57.16","31.99"
"64","000","00","019","1916","0000","1934","901","1033","86","2020","3350","0","60.3","26.9"
"64","000","00","019","1916","0297","664","331","333","28","692","1096","0","63.14","30.2"
"64","000","00","019","1916","0298","627","316","311","28","655","1066","0","61.44","29.64"
"64","000","00","019","1916","0299","643","254","389","30","673","1188","0","56.65","21.38"
"64","000","00","019","1917","0000","2228","1053","1175","89","2317","3849","0","60.2","27.36"
"64","000","00","019","1917","0277","743","362","381","42","785","1282","0","61.23","28.24"
"64","000","00","019","1917","0278","710","321","389","17","727","1240","0","58.63","25.89"
"64","000","00","019","1917","0279","775","370","405","30","805","1327","0","60.66","27.88"
"64","000","00","019","1918","0000","2370","1018","1352","96","2466","4065","0","60.66","25.04"
"64","000","00","019","1918","0271","774","327","447","29","803","1345","0","59.7","24.31"
"64","000","00","019","1918","0272","786","341","445","28","814","1295","0","62.86","26.33"
"64","000","00","019","1918","0273","810","350","460","39","849","1425","0","59.58","24.56"
"64","000","00","019","1919","0000","3716","1910","1806","120","3836","6674","0","57.48","28.62"
"64","000","00","019","1919","0280","939","424","515","32","971","1736","0","55.93","24.42"
"64","000","00","019","1919","0281","920","437","483","36","956","1566","0","61.05","27.91"
"64","000","00","019","1919","0282","921","430","491","19","940","1779","0","52.84","24.17"
"64","000","00","019","1919","0283","936","619","317","33","969","1593","0","60.83","38.86"
"64","000","00","019","1920","0000","3308","1569","1739","114","3422","5402","0","63.35","29.04"
"64","000","00","019","1920","0284","901","444","457","29","930","1480","0","62.84","30.0"
"64","000","00","019","1920","0285","810","347","463","20","830","1364","0","60.85","25.44"
"64","000","00","019","1920","0286","843","418","425","28","871","1410","0","61.77","29.65"
"64","000","00","019","1920","0287","754","360","394","37","791","1148","0","68.9","31.36"
"64","000","00","019","1921","0000","1120","535","585","39","1159","1830","0","63.33","29.23"
"64","000","00","019","1921","0289","579","267","312","24","603","969","0","62.23","27.55"
"64","000","00","019","1921","0290","541","268","273","15","556","861","0","64.58","31.13"
"64","000","00","019","1922","0000","1166","561","605","32","1198","1808","0","66.26","31.03"
"64","000","00","019","1922","0310","493","279","214","11","504","765","0","65.88","36.47"
"64","000","00","019","1922","0311","673","282","391","21","694","1043","0","66.54","27.04"
"64","000","00","019","1923","0000","1167","574","593","66","1233","1837","0","67.12","31.25"
"64","000","00","019","1923","0312","469","250","219","28","497","844","0","58.89","29.62"
"64","000","00","019","1923","0313","698","324","374","38","736","993","0","74.12","32.63"
"64","000","00","019","1924","0000","629","312","317","47","676","1038","0","65.13","30.06"
"64","000","00","019","1924","0314","629","312","317","47","676","1038","0","65.13","30.06"
"64","000","00","019","1925","0000","1040","566","474","57","1097","1712","0","64.08","33.06"
"64","000","00","019","1925","0291","476","259","217","19","495","823","0","60.15","31.47"
"64","000","00","019","1925","0292","564","307","257","38","602","889","0","67.72","34.53"
"64","000","00","019","1926","0000","2092","1168","924","107","2199","3442","0","63.89","33.93"
"64","000","00","019","1926","0315","620","362","258","48","668","1070","0","62.43","33.83"
"64","000","00","019","1926","0316","669","376","293","38","707","1023","0","69.11","36.75"
"64","000","00","019","1926","0317","803","430","373","21","824","1349","0","61.08","31.88"
"64","000","00","019","1927","0000","965","470","495","53","1018","1753","0","58.07","26.81"
"64","000","00","019","1927","0318","761","346","415","46","807","1452","0","55.58","23.83"
"64","000","00","019","1927","0319","204","124","80","7","211","301","0","70.1","41.2"
"64","000","00","019","1928","0000","943","559","384","71","1014","1587","0","63.89","35.22"
"64","000","00","019","1928","0321","392","229","163","15","407","733","0","55.53","31.24"
"64","000","00","019","1928","0322","551","330","221","56","607","854","0","71.08","38.64"
"64","000","00","019","1929","0000","536","247","289","39","575","978","0","58.79","25.26"
"64","000","00","019","1929","0324","536","247","289","39","575","978","0","58.79","25.26"
"64","000","00","019","1930","0000","1358","571","787","69","1427","2175","0","65.61","26.25"
"64","000","00","019","1930","0307","594","258","336","35","629","938","0","67.06","27.51"
"64","000","00","019","1930","0308","764","313","451","34","798","1237","0","64.51","25.3"
"64","000","00","019","1931","0000","407","238","169","19","426","625","0","68.16","38.08"
"64","000","00","019","1931","0288","407","238","169","19","426","625","0","68.16","38.08"
"64","000","00","019","1932","0000","1356","626","730","75","1431","2245","0","63.74","27.88"
"64","000","00","019","1932","0295","632","297","335","41","673","983","0","68.46","30.21"
"64","000","00","019","1932","0296","724","329","395","34","758","1262","0","60.06","26.07"
"64","000","00","019","1933","0000","1318","246","1072","51","1369","1895","0","72.24","12.98"
"64","000","00","019","1933","0328","679","127","552","36","715","955","0","74.87","13.3"
"64","000","00","019","1933","0329","639","119","520","15","654","940","0","69.57","12.66"
"64","000","00","020","0000","0000","19872","10943","8929","922","20794","32565","37647","63.85","33.6"
"64","000","00","020","2001","0000","1327","717","610","55","1382","2078","0","66.51","34.5"
"64","000","00","020","2001","0404","656","361","295","27","683","1005","0","67.96","35.92"
"64","000","00","020","2001","0405","671","356","315","28","699","1073","0","65.14","33.18"
"64","000","00","020","2002","0000","737","414","323","21","758","1129","0","67.14","36.67"
"64","000","00","020","2002","0406","737","414","323","21","758","1129","0","67.14","36.67"
"64","000","00","020","2003","0000","1416","797","619","66","1482","2335","0","63.47","34.13"
"64","000","00","020","2003","0407","756","424","332","47","803","1244","0","64.55","34.08"
"64","000","00","020","2003","0408","660","373","287","19","679","1091","0","62.24","34.19"
"64","000","00","020","2004","0000","1567","837","730","55","1622","2469","0","65.69","33.9"
"64","000","00","020","2004","0409","873","458","415","25","898","1329","0","67.57","34.46"
"64","000","00","020","2004","0410","694","379","315","30","724","1140","0","63.51","33.25"
"64","000","00","020","2005","0000","737","497","240","31","768","1220","0","62.95","40.74"
"64","000","00","020","2005","0411","737","497","240","31","768","1220","0","62.95","40.74"
"64","000","00","020","2006","0000","1443","810","633","71","1514","2362","0","64.1","34.29"
"64","000","00","020","2006","0412","694","378","316","20","714","1047","0","68.19","36.1"
"64","000","00","020","2006","0413","749","432","317","51","800","1315","0","60.84","32.85"
"64","000","00","020","2007","0000","873","567","306","47","920","1411","0","65.2","40.18"
"64","000","00","020","2007","0414","408","253","155","23","431","691","0","62.37","36.61"
"64","000","00","020","2007","0415","465","314","151","24","489","720","0","67.92","43.61"
"64","000","00","020","2008","0000","2000","986","1014","96","2096","3271","0","64.08","30.14"
"64","000","00","020","2008","0416","707","357","350","39","746","1192","0","62.58","29.95"
"64","000","00","020","2008","0417","832","423","409","25","857","1318","0","65.02","32.09"
"64","000","00","020","2008","0418","461","206","255","32","493","761","0","64.78","27.07"
"64","000","00","020","2009","0000","929","500","429","40","969","1560","0","62.12","32.05"
"64","000","00","020","2009","0419","579","317","262","25","604","973","0","62.08","32.58"
"64","000","00","020","2009","0420","350","183","167","15","365","587","0","62.18","31.18"
"64","000","00","020","2010","0000","1533","732","801","67","1600","2421","0","66.09","30.24"
"64","000","00","020","2010","0421","508","275","233","30","538","812","0","66.26","33.87"
"64","000","00","020","2010","0422","220","114","106","10","230","343","0","67.06","33.24"
"64","000","00","020","2010","0423","805","343","462","27","832","1266","0","65.72","27.09"
"64","000","00","020","2011","0000","1217","613","604","103","1320","2012","0","65.61","30.47"
"64","000","00","020","2011","0424","691","370","321","57","748","1128","0","66.31","32.8"
"64","000","00","020","2011","0425","526","243","283","46","572","884","0","64.71","27.49"
"64","000","00","020","2012","0000","1397","697","700","84","1481","2446","0","60.55","28.5"
"64","000","00","020","2012","0426","656","307","349","43","699","1187","0","58.89","25.86"
"64","000","00","020","2012","0427","741","390","351","41","782","1259","0","62.11","30.98"
"64","000","00","020","2013","0000","730","376","354","32","762","1361","0","55.99","27.63"
"64","000","00","020","2013","0428","730","376","354","32","762","1361","0","55.99","27.63"
"64","000","00","020","2014","0000","362","232","130","21","383","671","0","57.08","34.58"
"64","000","00","020","2014","0429","362","232","130","21","383","671","0","57.08","34.58"
"64","000","00","020","2015","0000","2294","1348","946","101","2395","3689","0","64.92","36.54"
"64","000","00","020","2015","0430","758","501","257","30","788","1215","0","64.86","41.23"
"64","000","00","020","2015","0431","778","451","327","39","817","1255","0","65.1","35.94"
"64","000","00","020","2015","0432","758","396","362","32","790","1219","0","64.81","32.49"
"64","000","00","020","2016","0000","823","494","329","24","847","1372","0","61.73","36.01"
"64","000","00","020","2016","0433","823","494","329","24","847","1372","0","61.73","36.01"
"64","000","00","020","2017","0000","487","326","161","8","495","758","0","65.3","43.01"
"64","000","00","020","2017","0434","487","326","161","8","495","758","0","65.3","43.01"
"64","000","00","021","0000","0000","14377","7213","7164","816","15193","26012","29809","58.41","27.73"
"64","000","00","021","2101","0000","609","307","302","55","664","1152","0","57.64","26.65"
"64","000","00","021","2101","0333","609","307","302","55","664","1152","0","57.64","26.65"
"64","000","00","021","2102","0000","1278","716","562","56","1334","2094","0","63.71","34.19"
"64","000","00","021","2102","0334","666","394","272","20","686","1120","0","61.25","35.18"
"64","000","00","021","2102","0335","612","322","290","36","648","974","0","66.53","33.06"
"64","000","00","021","2103","0000","1688","886","802","84","1772","3353","0","52.85","26.42"
"64","000","00","021","2103","0336","573","298","275","19","592","1019","0","58.1","29.24"
"64","000","00","021","2103","0337","569","275","294","42","611","1058","0","57.75","25.99"
"64","000","00","021","2103","0338","505","300","205","22","527","1017","0","51.82","29.5"
"64","000","00","021","2103","0339","41","13","28","1","42","259","0","16.22","5.02"
"64","000","00","021","2104","0000","1611","775","836","84","1695","2652","0","63.91","29.22"
"64","000","00","021","2104","0340","580","262","318","39","619","926","0","66.85","28.29"
"64","000","00","021","2104","0341","330","189","141","21","351","624","0","56.25","30.29"
"64","000","00","021","2104","0342","701","324","377","24","725","1102","0","65.79","29.4"
"64","000","00","021","2105","0000","1334","696","638","69","1403","2433","0","57.67","28.61"
"64","000","00","021","2105","0343","569","307","262","22","591","1072","0","55.13","28.64"
"64","000","00","021","2105","0344","765","389","376","47","812","1361","0","59.66","28.58"
"64","000","00","021","2106","0000","270","118","152","21","291","472","0","61.65","25.0"
"64","000","00","021","2106","0345","270","118","152","21","291","472","0","61.65","25.0"
"64","000","00","021","2107","0000","1295","634","661","98","1393","2331","0","59.76","27.2"
"64","000","00","021","2107","0346","618","300","318","37","655","1197","0","54.72","25.06"
"64","000","00","021","2107","0347","677","334","343","61","738","1134","0","65.08","29.45"
"64","000","00","021","2108","0000","2123","1042","1081","106","2229","3757","0","59.33","27.73"
"64","000","00","021","2108","0348","647","410","237","12","659","1148","0","57.4","35.71"
"64","000","00","021","2108","0349","614","267","347","48","662","1207","0","54.85","22.12"
"64","000","00","021","2108","0350","862","365","497","46","908","1402","0","64.76","26.03"
"64","000","00","021","2109","0000","1938","926","1012","126","2064","3401","0","60.69","27.23"
"64","000","00","021","2109","0351","576","299","277","41","617","1000","0","61.7","29.9"
"64","000","00","021","2109","0352","652","301","351","44","696","1110","0","62.7","27.12"
"64","000","00","021","2109","0353","710","326","384","41","751","1291","0","58.17","25.25"
"64","000","00","021","2110","0000","1013","546","467","59","1072","1895","0","56.57","28.81"
"64","000","00","021","2110","0354","468","278","190","29","497","797","0","62.36","34.88"
"64","000","00","021","2110","0355","545","268","277","30","575","1098","0","52.37","24.41"
"64","000","00","021","2111","0000","1218","567","651","58","1276","2472","0","51.62","22.94"
"64","000","00","021","2111","0356","716","341","375","39","755","1393","0","54.2","24.48"
"64","000","00","021","2111","0357","502","226","276","19","521","1079","0","48.29","20.95"
"64","000","00","022","0000","0000","3182","1838","1344","214","3396","6671","7196","50.91","27.55"
"64","000","00","022","2201","0000","165","79","86","7","172","369","0","46.61","21.41"
"64","000","00","022","2201","0237","165","79","86","7","172","369","0","46.61","21.41"
"64","000","00","022","2202","0000","428","258","170","26","454","1062","0","42.75","24.29"
"64","000","00","022","2202","0238","280","159","121","20","300","656","0","45.73","24.24"
"64","000","00","022","2202","0239","148","99","49","6","154","406","0","37.93","24.38"
"64","000","00","022","2203","0000","184","112","72","15","199","380","0","52.37","29.47"
"64","000","00","022","2203","0240","184","112","72","15","199","380","0","52.37","29.47"
"64","000","00","022","2204","0000","209","116","93","7","216","379","0","56.99","30.61"
"64","000","00","022","2204","0241","209","116","93","7","216","379","0","56.99","30.61"
"64","000","00","022","2205","0000","334","219","115","30","364","625","0","58.24","35.04"
"64","000","00","022","2205","0242","334","219","115","30","364","625","0","58.24","35.04"
"64","000","00","022","2206","0000","479","250","229","21","500","946","0","52.85","26.43"
"64","000","00","022","2206","0243","479","250","229","21","500","946","0","52.85","26.43"
"64","000","00","022","2207","0000","364","187","177","33","397","794","0","50.0","23.55"
"64","000","00","022","2207","0244","364","187","177","33","397","794","0","50.0","23.55"
"64","000","00","022","2208","0000","155","82","73","15","170","382","0","44.5","21.47"
"64","000","00","022","2208","0245","155","82","73","15","170","382","0","44.5","21.47"
"64","000","00","022","2209","0000","184","119","65","21","205","513","0","39.96","23.2"
"64","000","00","022","2209","0246","184","119","65","21","205","513","0","39.96","23.2"
"64","000","00","022","2210","0000","680","416","264","39","719","1221","0","58.89","34.07"
"64","000","00","022","2210","0247","330","211","119","10","340","601","0","56.57","35.11"
"64","000","00","022","2210","0248","350","205","145","29","379","620","0","61.13","33.06"
"64","000","00","023","0000","0000","13054","6635","6419","658","13712","24534","28676","55.89","27.04"
"64","000","00","023","2301","0000","644","370","274","24","668","1299","0","51.42","28.48"
"64","000","00","023","2301","0216","644","370","274","24","668","1299","0","51.42","28.48"
"64","000","00","023","2302","0000","1099","642","457","48","1147","2005","0","57.21","32.02"
"64","000","00","023","2302","0217","620","349","271","31","651","1107","0","58.81","31.53"
"64","000","00","023","2302","0218","479","293","186","17","496","898","0","55.23","32.63"
"64","000","00","023","2303","0000","657","364","293","49","706","1259","0","56.08","28.91"
"64","000","00","023","2303","0219","657","364","293","49","706","1259","0","56.08","28.91"
"64","000","00","023","2304","0000","1135","450","685","38","1173","2143","0","54.74","21.0"
"64","000","00","023","2304","0220","801","283","518","32","833","1579","0","52.75","17.92"
"64","000","00","023","2304","0221","334","167","167","6","340","564","0","60.28","29.61"
"64","000","00","023","2305","0000","458","226","232","41","499","768","0","64.97","29.43"
"64","000","00","023","2305","0222","458","226","232","41","499","768","0","64.97","29.43"
"64","000","00","023","2306","0000","2665","1358","1307","120","2785","4886","0","57.0","27.79"
"64","000","00","023","2306","0223","616","349","267","37","653","1092","0","59.8","31.96"
"64","000","00","023","2306","0224","600","310","290","36","636","1099","0","57.87","28.21"
"64","000","00","023","2306","0225","642","286","356","23","665","1134","0","58.64","25.22"
"64","000","00","023","2306","0226","807","413","394","24","831","1561","0","53.24","26.46"
"64","000","00","023","2307","0000","1386","628","758","105","1491","2649","0","56.29","23.71"
"64","000","00","023","2307","0227","824","446","378","83","907","1533","0","59.17","29.09"
"64","000","00","023","2307","0228","562","182","380","22","584","1116","0","52.33","16.31"
"64","000","00","023","2308","0000","1249","696","553","50","1299","2314","0","56.14","30.08"
"64","000","00","023","2308","0229","584","325","259","22","606","1054","0","57.5","30.83"
"64","000","00","023","2308","0230","665","371","294","28","693","1260","0","55.0","29.44"
"64","000","00","023","2309","0000","751","359","392","56","807","1504","0","53.66","23.87"
"64","000","00","023","2309","0231","751","359","392","56","807","1504","0","53.66","23.87"
"64","000","00","023","2310","0000","858","441","417","37","895","1671","0","53.56","26.39"
"64","000","00","023","2310","0232","430","247","183","15","445","848","0","52.48","29.13"
"64","000","00","023","2310","0233","428","194","234","22","450","823","0","54.68","23.57"
"64","000","00","023","2311","0000","594","340","254","11","605","1021","0","59.26","33.3"
"64","000","00","023","2311","0234","594","340","254","11","605","1021","0","59.26","33.3"
"64","000","00","023","2312","0000","1558","761","797","79","1637","3015","0","54.3","25.24"
"64","000","00","023","2312","0235","885","429","456","48","933","1715","0","54.4","25.01"
"64","000","00","023","2312","0236","673","332","341","31","704","1300","0","54.15","25.54"
"64","000","00","024","0000","0000","24833","12332","12501","1465","26298","43850","52578","59.97","28.12"
"64","000","00","024","2401","0000","1787","930","857","123","1910","3222","0","59.28","28.86"
"64","000","00","024","2401","0175","549","290","259","27","576","1026","0","56.14","28.27"
"64","000","00","024","2401","0176","595","324","271","43","638","1069","0","59.68","30.31"
"64","000","00","024","2401","0177","643","316","327","53","696","1127","0","61.76","28.04"
"64","000","00","024","2402","0000","628","300","328","49","677","1179","0","57.42","25.45"
"64","000","00","024","2402","0178","628","300","328","49","677","1179","0","57.42","25.45"
"64","000","00","024","2403","0000","648","349","299","54","702","1237","0","56.75","28.21"
"64","000","00","024","2403","0179","648","349","299","54","702","1237","0","56.75","28.21"
"64","000","00","024","2404","0000","623","309","314","38","661","1096","0","60.31","28.19"
"64","000","00","024","2404","0180","623","309","314","38","661","1096","0","60.31","28.19"
"64","000","00","024","2405","0000","768","399","369","39","807","1272","0","63.44","31.37"
"64","000","00","024","2405","0181","768","399","369","39","807","1272","0","63.44","31.37"
"64","000","00","024","2406","0000","1288","612","676","74","1362","2309","0","58.99","26.5"
"64","000","00","024","2406","0182","664","308","356","37","701","1182","0","59.31","26.06"
"64","000","00","024","2406","0183","624","304","320","37","661","1127","0","58.65","26.97"
"64","000","00","024","2407","0000","1178","558","620","76","1254","2088","0","60.06","26.72"
"64","000","00","024","2407","0184","546","261","285","33","579","956","0","60.56","27.3"
"64","000","00","024","2407","0185","632","297","335","43","675","1132","0","59.63","26.24"
"64","000","00","024","2408","0000","1817","865","952","151","1968","3333","0","59.05","25.95"
"64","000","00","024","2408","0186","582","275","307","78","660","1025","0","64.39","26.83"
"64","000","00","024","2408","0187","555","255","300","20","575","1007","0","57.1","25.32"
"64","000","00","024","2408","0188","680","335","345","53","733","1301","0","56.34","25.75"
"64","000","00","024","2409","0000","1426","708","718","87","1513","2652","0","57.05","26.7"
"64","000","00","024","2409","0189","501","244","257","26","527","885","0","59.55","27.57"
"64","000","00","024","2409","0190","402","185","217","19","421","837","0","50.3","22.1"
"64","000","00","024","2409","0191","523","279","244","42","565","930","0","60.75","30.0"
"64","000","00","024","2410","0000","953","513","440","76","1029","1804","0","57.04","28.44"
"64","000","00","024","2410","0192","389","199","190","28","417","781","0","53.39","25.48"
"64","000","00","024","2410","0193","564","314","250","48","612","1023","0","59.82","30.69"
"64","000","00","024","2411","0000","1922","939","983","97","2019","3400","0","59.38","27.62"
"64","000","00","024","2411","0194","1017","498","519","57","1074","1763","0","60.92","28.25"
"64","000","00","024","2411","0195","905","441","464","40","945","1637","0","57.73","26.94"
"64","000","00","024","2412","0000","1301","628","673","56","1357","2247","0","60.39","27.95"
"64","000","00","024","2412","0196","606","297","309","24","630","1070","0","58.88","27.76"
"64","000","00","024","2412","0197","695","331","364","32","727","1177","0","61.77","28.12"
"64","000","00","024","2413","0000","1686","864","822","124","1810","3050","0","59.34","28.33"
"64","000","00","024","2413","0198","557","280","277","44","601","1007","0","59.68","27.81"
"64","000","00","024","2413","0199","551","301","250","50","601","1026","0","58.58","29.34"
"64","000","00","024","2413","0200","578","283","295","30","608","1017","0","59.78","27.83"
"64","000","00","024","2414","0000","1366","672","694","66","1432","2353","0","60.86","28.56"
"64","000","00","024","2414","0201","714","356","358","32","746","1264","0","59.02","28.16"
"64","000","00","024","2414","0202","652","316","336","34","686","1089","0","62.99","29.02"
"64","000","00","024","2415","0000","489","264","225","25","514","851","0","60.4","31.02"
"64","000","00","024","2415","0203","489","264","225","25","514","851","0","60.4","31.02"
"64","000","00","024","2416","0000","1218","621","597","50","1268","1948","0","65.09","31.88"
"64","000","00","024","2416","0204","627","323","304","21","648","1011","0","64.09","31.95"
"64","000","00","024","2416","0205","591","298","293","29","620","937","0","66.17","31.8"
"64","000","00","024","2417","0000","973","494","479","29","1002","1730","0","57.92","28.55"
"64","000","00","024","2417","0206","413","211","202","11","424","820","0","51.71","25.73"
"64","000","00","024","2417","0207","560","283","277","18","578","910","0","63.52","31.1"
"64","000","00","024","2418","0000","458","246","212","38","496","867","0","57.21","28.37"
"64","000","00","024","2418","0208","458","246","212","38","496","867","0","57.21","28.37"
"64","000","00","024","2419","0000","1580","812","768","92","1672","2737","0","61.09","29.67"
"64","000","00","024","2419","0209","534","280","254","33","567","937","0","60.51","29.88"
"64","000","00","024","2419","0210","521","264","257","19","540","900","0","60.0","29.33"
"64","000","00","024","2419","0211","525","268","257","40","565","900","0","62.78","29.78"
"64","000","00","024","2420","0000","2724","1249","1475","121","2845","4475","0","63.58","27.91"
"64","000","00","024","2420","0212","539","262","277","27","566","918","0","61.66","28.54"
"64","000","00","024","2420","0213","537","252","285","32","569","870","0","65.4","28.97"
"64","000","00","024","2420","0214","703","333","370","22","725","1150","0","63.04","28.96"
"64","000","00","024","2420","0215","945","402","543","40","985","1537","0","64.09","26.15"
"64","000","00","025","0000","0000","14074","7333","6741","667","14741","25729","29812","57.29","28.5"
"64","000","00","025","2501","0000","586","346","240","27","613","1112","0","55.13","31.12"
"64","000","00","025","2501","0151","586","346","240","27","613","1112","0","55.13","31.12"
"64","000","00","025","2502","0000","558","293","265","38","596","1017","0","58.6","28.81"
"64","000","00","025","2502","0152","558","293","265","38","596","1017","0","58.6","28.81"
"64","000","00","025","2503","0000","430","245","185","27","457","796","0","57.41","30.78"
"64","000","00","025","2503","0153","430","245","185","27","457","796","0","57.41","30.78"
"64","000","00","025","2504","0000","1292","665","627","47","1339","2194","0","61.03","30.31"
"64","000","00","025","2504","0154","651","345","306","18","669","1079","0","62.0","31.97"
"64","000","00","025","2504","0155","641","320","321","29","670","1115","0","60.09","28.7"
"64","000","00","025","2505","0000","1394","743","651","47","1441","2630","0","54.79","28.25"
"64","000","00","025","2505","0156","710","380","330","23","733","1311","0","55.91","28.99"
"64","000","00","025","2505","0157","684","363","321","24","708","1319","0","53.68","27.52"
"64","000","00","025","2506","0000","2180","1038","1142","122","2302","3634","0","63.35","28.56"
"64","000","00","025","2506","0158","753","378","375","44","797","1244","0","64.07","30.39"
"64","000","00","025","2506","0159","748","346","402","40","788","1227","0","64.22","28.2"
"64","000","00","025","2506","0160","679","314","365","38","717","1163","0","61.65","27.0"
"64","000","00","025","2507","0000","577","282","295","24","601","981","0","61.26","28.75"
"64","000","00","025","2507","0161","577","282","295","24","601","981","0","61.26","28.75"
"64","000","00","025","2508","0000","2105","1089","1016","89","2194","3680","0","59.62","29.59"
"64","000","00","025","2508","0162","418","234","184","22","440","780","0","56.41","30.0"
"64","000","00","025","2508","0163","458","224","234","30","488","832","0","58.65","26.92"
"64","000","00","025","2508","0164","614","316","298","26","640","1017","0","62.93","31.07"
"64","000","00","025","2508","0165","615","315","300","11","626","1051","0","59.56","29.97"
"64","000","00","025","2509","0000","997","567","430","59","1056","1804","0","58.54","31.43"
"64","000","00","025","2509","0166","536","320","216","21","557","941","0","59.19","34.01"
"64","000","00","025","2509","0167","461","247","214","38","499","863","0","57.82","28.62"
"64","000","00","025","2510","0000","605","331","274","30","635","1160","0","54.74","28.53"
"64","000","00","025","2510","0168","605","331","274","30","635","1160","0","54.74","28.53"
"64","000","00","025","2511","0000","1097","601","496","54","1151","2212","0","52.03","27.17"
"64","000","00","025","2511","0169","480","257","223","12","492","1090","0","45.14","23.58"
"64","000","00","025","2511","0170","617","344","273","42","659","1122","0","58.73","30.66"
"64","000","00","025","2512","0000","560","330","230","26","586","1123","0","52.18","29.39"
"64","000","00","025","2512","0171","560","330","230","26","586","1123","0","52.18","29.39"
"64","000","00","025","2513","0000","386","195","191","22","408","684","0","59.65","28.51"
"64","000","00","025","2513","0172","386","195","191","22","408","684","0","59.65","28.51"
"64","000","00","025","2514","0000","1307","608","699","55","1362","2702","0","50.41","22.5"
"64","000","00","025","2514","0173","613","278","335","24","637","1249","0","51.0","22.26"
"64","000","00","025","2514","0174","694","330","364","31","725","1453","0","49.9","22.71"
"64","000","00","026","0000","0000","13724","7266","6458","775","14499","26212","30055","55.31","27.72"
"64","000","00","026","2601","0000","503","287","216","13","516","976","0","52.87","29.41"
"64","000","00","026","2601","0130","503","287","216","13","516","976","0","52.87","29.41"
"64","000","00","026","2602","0000","451","263","188","37","488","887","0","55.02","29.65"
"64","000","00","026","2602","0131","451","263","188","37","488","887","0","55.02","29.65"
"64","000","00","026","2603","0000","900","445","455","23","923","1710","0","53.98","26.02"
"64","000","00","026","2603","0132","900","445","455","23","923","1710","0","53.98","26.02"
"64","000","00","026","2604","0000","2081","1084","997","67","2148","3751","0","57.26","28.9"
"64","000","00","026","2604","0133","587","313","274","27","614","1280","0","47.97","24.45"
"64","000","00","026","2604","0134","766","393","373","20","786","1314","0","59.82","29.91"
"64","000","00","026","2604","0135","728","378","350","20","748","1157","0","64.65","32.67"
"64","000","00","026","2605","0000","934","470","464","65","999","1785","0","55.97","26.33"
"64","000","00","026","2605","0136","934","470","464","65","999","1785","0","55.97","26.33"
"64","000","00","026","2606","0000","594","350","244","39","633","1139","0","55.58","30.73"
"64","000","00","026","2606","0142","594","350","244","39","633","1139","0","55.58","30.73"
"64","000","00","026","2607","0000","1616","897","719","116","1732","2961","0","58.49","30.29"
"64","000","00","026","2607","0143","720","398","322","58","778","1363","0","57.08","29.2"
"64","000","00","026","2607","0144","896","499","397","58","954","1598","0","59.7","31.23"
"64","000","00","026","2608","0000","416","224","192","28","444","925","0","48.0","24.22"
"64","000","00","026","2608","0146","416","224","192","28","444","925","0","48.0","24.22"
"64","000","00","026","2609","0000","577","275","302","28","605","1111","0","54.46","24.75"
"64","000","00","026","2609","0145","577","275","302","28","605","1111","0","54.46","24.75"
"64","000","00","026","2610","0000","612","354","258","30","642","1148","0","55.92","30.84"
"64","000","00","026","2610","0147","612","354","258","30","642","1148","0","55.92","30.84"
"64","000","00","026","2611","0000","1220","644","576","93","1313","2087","0","62.91","30.86"
"64","000","00","026","2611","0137","444","240","204","48","492","838","0","58.71","28.64"
"64","000","00","026","2611","0138","776","404","372","45","821","1249","0","65.73","32.35"
"64","000","00","026","2612","0000","573","317","256","49","622","1116","0","55.73","28.41"
"64","000","00","026","2612","0139","573","317","256","49","622","1116","0","55.73","28.41"
"64","000","00","026","2613","0000","487","244","243","33","520","978","0","53.17","24.95"
"64","000","00","026","2613","0140","487","244","243","33","520","978","0","53.17","24.95"
"64","000","00","026","2614","0000","538","289","249","22","560","1125","0","49.78","25.69"
"64","000","00","026","2614","0141","538","289","249","22","560","1125","0","49.78","25.69"
"64","000","00","026","2615","0000","2222","1123","1099","132","2354","4513","0","52.16","24.88"
"64","000","00","026","2615","0148","672","335","337","29","701","1353","0","51.81","24.76"
"64","000","00","026","2615","0149","689","354","335","48","737","1331","0","55.37","26.6"
"64","000","00","026","2615","0150","861","434","427","55","916","1829","0","50.08","23.73"
"64","000","00","027","0000","0000","7318","3574","3744","366","7684","12001","13888","64.03","29.78"
"64","000","00","027","2701","0000","983","486","497","51","1034","1574","0","65.69","30.88"
"64","000","00","027","2701","0249","493","237","256","18","511","756","0","67.59","31.35"
"64","000","00","027","2701","0250","490","249","241","33","523","818","0","63.94","30.44"
"64","000","00","027","2702","0000","1168","557","611","55","1223","1817","0","67.31","30.65"
"64","000","00","027","2702","0251","579","274","305","22","601","866","0","69.4","31.64"
"64","000","00","027","2702","0252","589","283","306","33","622","951","0","65.4","29.76"
"64","000","00","027","2703","0000","1352","693","659","66","1418","2339","0","60.62","29.63"
"64","000","00","027","2703","0253","609","304","305","32","641","992","0","64.62","30.65"
"64","000","00","027","2703","0254","346","197","149","14","360","682","0","52.79","28.89"
"64","000","00","027","2703","0255","397","192","205","20","417","665","0","62.71","28.87"
"64","000","00","027","2704","0000","202","120","82","9","211","371","0","56.87","32.35"
"64","000","00","027","2704","0256","202","120","82","9","211","371","0","56.87","32.35"
"64","000","00","027","2705","0000","1549","704","845","76","1625","2532","0","64.18","27.8"
"64","000","00","027","2705","0257","690","328","362","47","737","1114","0","66.16","29.44"
"64","000","00","027","2705","0258","859","376","483","29","888","1418","0","62.62","26.52"
"64","000","00","027","2706","0000","2064","1014","1050","109","2173","3368","0","64.52","30.11"
"64","000","00","027","2706","0259","915","448","467","63","978","1477","0","66.22","30.33"
"64","000","00","027","2706","0260","1149","566","583","46","1195","1891","0","63.19","29.93"
"64","000","00","028","0000","0000","9736","4807","4929","627","10363","16487","19266","62.86","29.16"
"64","000","00","028","2801","0000","713","327","386","48","761","1246","0","61.08","26.24"
"64","000","00","028","2801","0358","713","327","386","48","761","1246","0","61.08","26.24"
"64","000","00","028","2802","0000","1122","506","616","81","1203","1840","0","65.38","27.5"
"64","000","00","028","2802","0359","522","230","292","30","552","885","0","62.37","25.99"
"64","000","00","028","2802","0360","600","276","324","51","651","955","0","68.17","28.9"
"64","000","00","028","2803","0000","295","153","142","30","325","534","0","60.86","28.65"
"64","000","00","028","2803","0361","295","153","142","30","325","534","0","60.86","28.65"
"64","000","00","028","2804","0000","438","189","249","22","460","738","0","62.33","25.61"
"64","000","00","028","2804","0362","438","189","249","22","460","738","0","62.33","25.61"
"64","000","00","028","2805","0000","1113","542","571","58","1171","1732","0","67.61","31.29"
"64","000","00","028","2805","0363","562","251","311","28","590","855","0","69.01","29.36"
"64","000","00","028","2805","0364","551","291","260","30","581","877","0","66.25","33.18"
"64","000","00","028","2806","0000","962","518","444","47","1009","1589","0","63.5","32.6"
"64","000","00","028","2806","0365","461","253","208","33","494","781","0","63.25","32.39"
"64","000","00","028","2806","0366","501","265","236","14","515","808","0","63.74","32.8"
"64","000","00","028","2807","0000","928","477","451","63","991","1729","0","57.32","27.59"
"64","000","00","028","2807","0367","455","234","221","26","481","904","0","53.21","25.88"
"64","000","00","028","2807","0368","473","243","230","37","510","825","0","61.82","29.45"
"64","000","00","028","2808","0000","1200","629","571","82","1282","2037","0","62.94","30.88"
"64","000","00","028","2808","0370","580","300","280","27","607","1013","0","59.92","29.62"
"64","000","00","028","2808","0371","620","329","291","55","675","1024","0","65.92","32.13"
"64","000","00","028","2809","0000","513","270","243","27","540","941","0","57.39","28.69"
"64","000","00","028","2809","0369","513","270","243","27","540","941","0","57.39","28.69"
"64","000","00","028","2810","0000","443","194","249","13","456","861","0","52.96","22.53"
"64","000","00","028","2810","0372","443","194","249","13","456","861","0","52.96","22.53"
"64","000","00","028","2811","0000","686","354","332","49","735","1163","0","63.2","30.44"
"64","000","00","028","2811","0373","686","354","332","49","735","1163","0","63.2","30.44"
"64","000","00","028","2812","0000","1323","648","675","107","1430","2077","0","68.85","31.2"
"64","000","00","028","2812","0374","737","327","410","64","801","1216","0","65.87","26.89"
"64","000","00","028","2812","0375","586","321","265","43","629","861","0","73.05","37.28"
"64","000","00","029","0000","0000","17757","9243","8514","874","18631","31025","35896","60.05","29.79"
"64","000","00","029","2901","0000","1252","676","576","70","1322","2124","0","62.24","31.83"
"64","000","00","029","2901","0376","643","354","289","39","682","1061","0","64.28","33.36"
"64","000","00","029","2901","0377","609","322","287","31","640","1063","0","60.21","30.29"
"64","000","00","029","2902","0000","1152","758","394","43","1195","2047","0","58.38","37.03"
"64","000","00","029","2902","0378","589","438","151","25","614","969","0","63.36","45.2"
"64","000","00","029","2902","0379","563","320","243","18","581","1078","0","53.9","29.68"
"64","000","00","029","2903","0000","1386","770","616","65","1451","2231","0","65.04","34.51"
"64","000","00","029","2903","0380","506","292","214","28","534","838","0","63.72","34.84"
"64","000","00","029","2903","0381","397","216","181","19","416","611","0","68.09","35.35"
"64","000","00","029","2903","0382","483","262","221","18","501","782","0","64.07","33.5"
"64","000","00","029","2904","0000","913","488","425","43","956","1451","0","65.89","33.63"
"64","000","00","029","2904","0383","913","488","425","43","956","1451","0","65.89","33.63"
"64","000","00","029","2905","0000","646","331","315","17","663","1144","0","57.95","28.93"
"64","000","00","029","2905","0384","646","331","315","17","663","1144","0","57.95","28.93"
"64","000","00","029","2906","0000","988","524","464","39","1027","1827","0","56.21","28.68"
"64","000","00","029","2906","0389","593","302","291","18","611","1112","0","54.95","27.16"
"64","000","00","029","2906","0390","395","222","173","21","416","715","0","58.18","31.05"
"64","000","00","029","2907","0000","1253","678","575","108","1361","2072","0","65.69","32.72"
"64","000","00","029","2907","0394","652","380","272","55","707","1052","0","67.21","36.12"
"64","000","00","029","2907","0395","601","298","303","53","654","1020","0","64.12","29.22"
"64","000","00","029","2908","0000","1561","771","790","52","1613","2855","0","56.5","27.01"
"64","000","00","029","2908","0396","708","372","336","22","730","1260","0","57.94","29.52"
"64","000","00","029","2908","0397","853","399","454","30","883","1595","0","55.36","25.02"
"64","000","00","029","2909","0000","1303","609","694","49","1352","2361","0","57.26","25.79"
"64","000","00","029","2909","0398","469","239","230","30","499","829","0","60.19","28.83"
"64","000","00","029","2909","0399","834","370","464","19","853","1532","0","55.68","24.15"
"64","000","00","029","2910","0000","516","263","253","19","535","975","0","54.87","26.97"
"64","000","00","029","2910","0385","516","263","253","19","535","975","0","54.87","26.97"
"64","000","00","029","2911","0000","2108","1051","1057","113","2221","3608","0","61.56","29.13"
"64","000","00","029","2911","0386","766","421","345","34","800","1317","0","60.74","31.97"
"64","000","00","029","2911","0387","717","317","400","50","767","1218","0","62.97","26.03"
"64","000","00","029","2911","0388","625","313","312","29","654","1073","0","60.95","29.17"
"64","000","00","029","2912","0000","1221","680","541","73","1294","2250","0","57.51","30.22"
"64","000","00","029","2912","0391","686","374","312","45","731","1311","0","55.76","28.53"
"64","000","00","029","2912","0392","535","306","229","28","563","939","0","59.96","32.59"
"64","000","00","029","2913","0000","491","222","269","27","518","824","0","62.86","26.94"
"64","000","00","029","2913","0393","491","222","269","27","518","824","0","62.86","26.94"
"64","000","00","029","2914","0000","1417","672","745","80","1497","2338","0","64.03","28.74"
"64","000","00","029","2914","0400","742","355","387","38","780","1195","0","65.27","29.71"
"64","000","00","029","2914","0401","675","317","358","42","717","1143","0","62.73","27.73"
"64","000","00","029","2915","0000","1550","750","800","76","1626","2918","0","55.72","25.7"
"64","000","00","029","2915","0402","711","386","325","38","749","1186","0","63.15","32.55"
"64","000","00","029","2915","0403","839","364","475","38","877","1732","0","50.64","21.02"
"64","000","00","030","0000","0000","17580","9062","8518","922","18502","31996","36695","57.83","28.32"
"64","000","00","030","3001","0000","1170","548","622","64","1234","2185","0","56.48","25.08"
"64","000","00","030","3001","0060","610","291","319","29","639","1060","0","60.28","27.45"
"64","000","00","030","3001","0061","560","257","303","35","595","1125","0","52.89","22.84"
"64","000","00","030","3002","0000","1394","651","743","51","1445","2338","0","61.8","27.84"
"64","000","00","030","3002","0062","647","297","350","34","681","1100","0","61.91","27.0"
"64","000","00","030","3002","0063","747","354","393","17","764","1238","0","61.71","28.59"
"64","000","00","030","3003","0000","940","453","487","27","967","1660","0","58.25","27.29"
"64","000","00","030","3003","0064","547","254","293","19","566","933","0","60.66","27.22"
"64","000","00","030","3003","0065","393","199","194","8","401","727","0","55.16","27.37"
"64","000","00","030","3004","0000","965","514","451","42","1007","1815","0","55.48","28.32"
"64","000","00","030","3004","0066","591","325","266","19","610","1071","0","56.96","30.35"
"64","000","00","030","3004","0067","374","189","185","23","397","744","0","53.36","25.4"
"64","000","00","030","3005","0000","740","352","388","28","768","1469","0","52.28","23.96"
"64","000","00","030","3005","0068","555","280","275","19","574","1100","0","52.18","25.45"
"64","000","00","030","3005","0069","185","72","113","9","194","369","0","52.57","19.51"
"64","000","00","030","3006","0000","626","338","288","33","659","1398","0","47.14","24.18"
"64","000","00","030","3006","0070","399","218","181","20","419","888","0","47.18","24.55"
"64","000","00","030","3006","0071","227","120","107","13","240","510","0","47.06","23.53"
"64","000","00","030","3007","0000","611","317","294","43","654","1042","0","62.76","30.42"
"64","000","00","030","3007","0072","611","317","294","43","654","1042","0","62.76","30.42"
"64","000","00","030","3008","0000","428","215","213","21","449","791","0","56.76","27.18"
"64","000","00","030","3008","0073","428","215","213","21","449","791","0","56.76","27.18"
"64","000","00","030","3009","0000","1148","610","538","92","1240","2157","0","57.49","28.28"
"64","000","00","030","3009","0074","530","290","240","51","581","939","0","61.87","30.88"
"64","000","00","030","3009","0075","618","320","298","41","659","1218","0","54.11","26.27"
"64","000","00","030","3010","0000","91","54","37","13","104","178","0","58.43","30.34"
"64","000","00","030","3010","0076","91","54","37","13","104","178","0","58.43","30.34"
"64","000","00","030","3011","0000","1133","573","560","57","1190","1971","0","60.38","29.07"
"64","000","00","030","3011","0077","569","255","314","28","597","946","0","63.11","26.96"
"64","000","00","030","3011","0078","564","318","246","29","593","1025","0","57.85","31.02"
"64","000","00","030","3012","0000","608","279","329","28","636","1040","0","61.15","26.83"
"64","000","00","030","3012","0079","608","279","329","28","636","1040","0","61.15","26.83"
"64","000","00","030","3013","0000","915","437","478","43","958","1563","0","61.29","27.96"
"64","000","00","030","3013","0080","563","275","288","25","588","900","0","65.33","30.56"
"64","000","00","030","3013","0081","352","162","190","18","370","663","0","55.81","24.43"
"64","000","00","030","3014","0000","1089","566","523","61","1150","2014","0","57.1","28.1"
"64","000","00","030","3014","0082","507","243","264","38","545","954","0","57.13","25.47"
"64","000","00","030","3014","0083","582","323","259","23","605","1060","0","57.08","30.47"
"64","000","00","030","3015","0000","1907","989","918","94","2001","3323","0","60.22","29.76"
"64","000","00","030","3015","0084","651","335","316","31","682","1110","0","61.44","30.18"
"64","000","00","030","3015","0085","592","310","282","43","635","1062","0","59.79","29.19"
"64","000","00","030","3015","0086","664","344","320","20","684","1151","0","59.43","29.89"
"64","000","00","030","3016","0000","1181","601","580","71","1252","2206","0","56.75","27.24"
"64","000","00","030","3016","0087","148","83","65","18","166","266","0","62.41","31.2"
"64","000","00","030","3016","0088","373","172","201","20","393","633","0","62.09","27.17"
"64","000","00","030","3016","0089","660","346","314","33","693","1307","0","53.02","26.47"
"64","000","00","030","3017","0000","413","268","145","18","431","754","0","57.16","35.54"
"64","000","00","030","3017","0090","413","268","145","18","431","754","0","57.16","35.54"
"64","000","00","030","3018","0000","715","515","200","62","777","1296","0","59.95","39.74"
"64","000","00","030","3018","0091","715","515","200","62","777","1296","0","59.95","39.74"
"64","000","00","030","3019","0000","403","228","175","13","416","839","0","49.58","27.18"
"64","000","00","030","3019","0092","403","228","175","13","416","839","0","49.58","27.18"
"64","000","00","030","3020","0000","753","404","349","39","792","1329","0","59.59","30.4"
"64","000","00","030","3020","0093","753","404","349","39","792","1329","0","59.59","30.4"
"64","000","00","030","3021","0000","350","150","200","22","372","628","0","59.24","23.89"
"64","000","00","030","3021","0094","350","150","200","22","372","628","0","59.24","23.89"
"64","000","00","031","0000","0000","18579","7983","10596","1171","19750","35311","39630","55.93","22.61"
"64","000","00","031","3101","0000","1351","610","741","83","1434","2613","0","54.88","23.34"
"64","000","00","031","3101","0095","637","290","347","57","694","1175","0","59.06","24.68"
"64","000","00","031","3101","0096","714","320","394","26","740","1438","0","51.46","22.25"
"64","000","00","031","3102","0000","1273","510","763","66","1339","2416","0","55.42","21.11"
"64","000","00","031","3102","0097","495","203","292","22","517","989","0","52.28","20.53"
"64","000","00","031","3102","0098","778","307","471","44","822","1427","0","57.6","21.51"
"64","000","00","031","3103","0000","1436","625","811","81","1517","2572","0","58.98","24.3"
"64","000","00","031","3103","0099","716","332","384","28","744","1309","0","56.84","25.36"
"64","000","00","031","3103","0100","720","293","427","53","773","1263","0","61.2","23.2"
"64","000","00","031","3104","0000","1169","475","694","61","1230","2061","0","59.68","23.05"
"64","000","00","031","3104","0101","583","239","344","29","612","997","0","61.38","23.97"
"64","000","00","031","3104","0102","586","236","350","32","618","1064","0","58.08","22.18"
"64","000","00","031","3105","0000","792","287","505","51","843","1498","0","56.28","19.16"
"64","000","00","031","3105","0103","792","287","505","51","843","1498","0","56.28","19.16"
"64","000","00","031","3106","0000","1153","459","694","114","1267","2150","0","58.93","21.35"
"64","000","00","031","3106","0104","598","244","354","63","661","1119","0","59.07","21.81"
"64","000","00","031","3106","0105","555","215","340","51","606","1031","0","58.78","20.85"
"64","000","00","031","3107","0000","1295","558","737","92","1387","2508","0","55.3","22.25"
"64","000","00","031","3107","0106","716","298","418","63","779","1437","0","54.21","20.74"
"64","000","00","031","3107","0107","579","260","319","29","608","1071","0","56.77","24.28"
"64","000","00","031","3108","0000","726","311","415","37","763","1462","0","52.19","21.27"
"64","000","00","031","3108","0108","377","157","220","16","393","687","0","57.21","22.85"
"64","000","00","031","3108","0109","349","154","195","21","370","775","0","47.74","19.87"
"64","000","00","031","3109","0000","649","307","342","54","703","1353","0","51.96","22.69"
"64","000","00","031","3109","0110","649","307","342","54","703","1353","0","51.96","22.69"
"64","000","00","031","3110","0000","591","307","284","30","621","1191","0","52.14","25.78"
"64","000","00","031","3110","0111","591","307","284","30","621","1191","0","52.14","25.78"
"64","000","00","031","3111","0000","1101","472","629","71","1172","2084","0","56.24","22.65"
"64","000","00","031","3111","0112","447","215","232","29","476","906","0","52.54","23.73"
"64","000","00","031","3111","0113","654","257","397","42","696","1178","0","59.08","21.82"
"64","000","00","031","3112","0000","623","265","358","20","643","1252","0","51.36","21.17"
"64","000","00","031","3112","0114","623","265","358","20","643","1252","0","51.36","21.17"
"64","000","00","031","3113","0000","838","302","536","52","890","1549","0","57.46","19.5"
"64","000","00","031","3113","0115","838","302","536","52","890","1549","0","57.46","19.5"
"64","000","00","031","3114","0000","1145","496","649","67","1212","2204","0","54.99","22.5"
"64","000","00","031","3114","0116","539","242","297","35","574","1088","0","52.76","22.24"
"64","000","00","031","3114","0117","606","254","352","32","638","1116","0","57.17","22.76"
"64","000","00","031","3115","0000","977","443","534","66","1043","1793","0","58.17","24.71"
"64","000","00","031","3115","0118","501","221","280","25","526","977","0","53.84","22.62"
"64","000","00","031","3115","0119","476","222","254","41","517","816","0","63.36","27.21"
"64","000","00","031","3116","0000","984","426","558","61","1045","1898","0","55.06","22.44"
"64","000","00","031","3116","0120","472","197","275","19","491","955","0","51.41","20.63"
"64","000","00","031","3116","0121","512","229","283","42","554","943","0","58.75","24.28"
"64","000","00","031","3117","0000","729","300","429","32","761","1371","0","55.51","21.88"
"64","000","00","031","3117","0122","729","300","429","32","761","1371","0","55.51","21.88"
"64","000","00","031","3118","0000","1037","481","556","49","1086","1834","0","59.21","26.23"
"64","000","00","031","3118","0123","493","241","252","29","522","919","0","56.8","26.22"
"64","000","00","031","3118","0124","544","240","304","20","564","915","0","61.64","26.23"
"64","000","00","031","3119","0000","710","349","361","84","794","1502","0","52.86","23.24"
"64","000","00","031","3119","0125","419","200","219","50","469","828","0","56.64","24.15"
"64","000","00","031","3119","0126","291","149","142","34","325","674","0","48.22","22.11"
"64","000","00","032","0000","0000","5066","2314","2752","465","5531","11501","12984","48.09","20.12"
"64","000","00","032","3201","0000","374","205","169","18","392","760","0","51.58","26.97"
"64","000","00","032","3201","0020","374","205","169","18","392","760","0","51.58","26.97"
"64","000","00","032","3202","0000","279","134","145","29","308","666","0","46.25","20.12"
"64","000","00","032","3202","0021","279","134","145","29","308","666","0","46.25","20.12"
"64","000","00","032","3203","0000","381","172","209","31","412","704","0","58.52","24.43"
"64","000","00","032","3203","0022","381","172","209","31","412","704","0","58.52","24.43"
"64","000","00","032","3204","0000","477","228","249","37","514","1003","0","51.25","22.73"
"64","000","00","032","3204","0023","477","228","249","37","514","1003","0","51.25","22.73"
"64","000","00","032","3205","0000","578","251","327","90","668","1382","0","48.34","18.16"
"64","000","00","032","3205","0024","578","251","327","90","668","1382","0","48.34","18.16"
"64","000","00","032","3206","0000","356","168","188","63","419","986","0","42.49","17.04"
"64","000","00","032","3206","0025","356","168","188","63","419","986","0","42.49","17.04"
"64","000","00","032","3207","0000","510","236","274","36","546","1046","0","52.2","22.56"
"64","000","00","032","3207","0026","510","236","274","36","546","1046","0","52.2","22.56"
"64","000","00","032","3208","0000","350","198","152","34","384","812","0","47.29","24.38"
"64","000","00","032","3208","0027","350","198","152","34","384","812","0","47.29","24.38"
"64","000","00","032","3209","0000","625","229","396","38","663","1431","0","46.33","16.0"
"64","000","00","032","3209","0028","625","229","396","38","663","1431","0","46.33","16.0"
"64","000","00","032","3210","0000","448","188","260","40","488","912","0","53.51","20.61"
"64","000","00","032","3210","0029","448","188","260","40","488","912","0","53.51","20.61"
"64","000","00","032","3211","0000","556","242","314","35","591","1472","0","40.15","16.44"
"64","000","00","032","3211","0030","556","242","314","35","591","1472","0","40.15","16.44"
"64","000","00","032","3212","0000","132","63","69","14","146","327","0","44.65","19.27"
"64","000","00","032","3212","0031","132","63","69","14","146","327","0","44.65","19.27"
"64","000","00","033","0000","0000","2523","1133","1390","202","2725","5417","6051","50.3","20.92"
"64","000","00","033","3301","0000","178","64","114","4","182","472","0","38.56","13.56"
"64","000","00","033","3301","0013","178","64","114","4","182","472","0","38.56","13.56"
"64","000","00","033","3302","0000","516","178","338","42","558","882","0","63.27","20.18"
"64","000","00","033","3302","0014","516","178","338","42","558","882","0","63.27","20.18"
"64","000","00","033","3303","0000","345","150","195","24","369","668","0","55.24","22.46"
"64","000","00","033","3303","0015","345","150","195","24","369","668","0","55.24","22.46"
"64","000","00","033","3304","0000","716","308","408","84","800","1581","0","50.6","19.48"
"64","000","00","033","3304","0016","716","308","408","84","800","1581","0","50.6","19.48"
"64","000","00","033","3305","0000","229","150","79","7","236","673","0","35.07","22.29"
"64","000","00","033","3305","0017","229","150","79","7","236","673","0","35.07","22.29"
"64","000","00","033","3306","0000","271","126","145","27","298","607","0","49.09","20.76"
"64","000","00","033","3306","0018","271","126","145","27","298","607","0","49.09","20.76"
"64","000","00","033","3307","0000","268","157","111","14","282","534","0","52.81","29.4"
"64","000","00","033","3307","0019","268","157","111","14","282","534","0","52.81","29.4"
"64","000","00","034","0000","0000","4782","2294","2488","296","5078","10607","11828","47.87","21.63"
"64","000","00","034","3401","0000","308","164","144","21","329","640","0","51.41","25.63"
"64","000","00","034","3401","0032","308","164","144","21","329","640","0","51.41","25.63"
"64","000","00","034","3402","0000","312","145","167","21","333","696","0","47.84","20.83"
"64","000","00","034","3402","0033","312","145","167","21","333","696","0","47.84","20.83"
"64","000","00","034","3403","0000","498","290","208","35","533","1284","0","41.51","22.59"
"64","000","00","034","3403","0034","498","290","208","35","533","1284","0","41.51","22.59"
"64","000","00","034","3404","0000","653","291","362","54","707","1509","0","46.85","19.28"
"64","000","00","034","3404","0035","429","184","245","31","460","1027","0","44.79","17.92"
"64","000","00","034","3404","0036","224","107","117","23","247","482","0","51.24","22.2"
"64","000","00","034","3405","0000","842","390","452","69","911","1627","0","55.99","23.97"
"64","000","00","034","3405","0037","842","390","452","69","911","1627","0","55.99","23.97"
"64","000","00","034","3406","0000","734","328","406","23","757","1630","0","46.44","20.12"
"64","000","00","034","3406","0038","734","328","406","23","757","1630","0","46.44","20.12"
"64","000","00","034","3407","0000","634","313","321","41","675","1261","0","53.53","24.82"
"64","000","00","034","3407","0041","634","313","321","41","675","1261","0","53.53","24.82"
"64","000","00","034","3408","0000","801","373","428","32","833","1960","0","42.5","19.03"
"64","000","00","034","3408","0039","402","226","176","15","417","973","0","42.86","23.23"
"64","000","00","034","3408","0040","399","147","252","17","416","987","0","42.15","14.89"
"64","000","00","035","0000","0000","6060","3104","2956","457","6517","13002","14465","50.12","23.87"
"64","000","00","035","3501","0000","420","207","213","44","464","969","0","47.88","21.36"
"64","000","00","035","3501","0042","420","207","213","44","464","969","0","47.88","21.36"
"64","000","00","035","3502","0000","292","175","117","11","303","652","0","46.47","26.84"
"64","000","00","035","3502","0043","292","175","117","11","303","652","0","46.47","26.84"
"64","000","00","035","3503","0000","475","244","231","39","514","961","0","53.49","25.39"
"64","000","00","035","3503","0044","475","244","231","39","514","961","0","53.49","25.39"
"64","000","00","035","3504","0000","204","89","115","8","212","426","0","49.77","20.89"
"64","000","00","035","3504","0045","204","89","115","8","212","426","0","49.77","20.89"
"64","000","00","035","3505","0000","168","72","96","16","184","398","0","46.23","18.09"
"64","000","00","035","3505","0046","168","72","96","16","184","398","0","46.23","18.09"
"64","000","00","035","3506","0000","225","97","128","16","241","508","0","47.44","19.09"
"64","000","00","035","3506","0047","225","97","128","16","241","508","0","47.44","19.09"
"64","000","00","035","3507","0000","543","235","308","34","577","980","0","58.88","23.98"
"64","000","00","035","3507","0048","543","235","308","34","577","980","0","58.88","23.98"
"64","000","00","035","3508","0000","504","249","255","39","543","1225","0","44.33","20.33"
"64","000","00","035","3508","0049","504","249","255","39","543","1225","0","44.33","20.33"
"64","000","00","035","3509","0000","884","470","414","80","964","1722","0","55.98","27.29"
"64","000","00","035","3509","0050","884","470","414","80","964","1722","0","55.98","27.29"
"64","000","00","035","3510","0000","260","128","132","16","276","560","0","49.29","22.86"
"64","000","00","035","3510","0051","260","128","132","16","276","560","0","49.29","22.86"
"64","000","00","035","3511","0000","361","205","156","21","382","801","0","47.69","25.59"
"64","000","00","035","3511","0052","361","205","156","21","382","801","0","47.69","25.59"
"64","000","00","035","3512","0000","205","104","101","18","223","423","0","52.72","24.59"
"64","000","00","035","3512","0053","205","104","101","18","223","423","0","52.72","24.59"
"64","000","00","035","3513","0000","220","113","107","18","238","497","0","47.89","22.74"
"64","000","00","035","3513","0054","220","113","107","18","238","497","0","47.89","22.74"
"64","000","00","035","3514","0000","313","162","151","22","335","677","0","49.48","23.93"
"64","000","00","035","3514","0055","313","162","151","22","335","677","0","49.48","23.93"
"64","000","00","035","3515","0000","220","127","93","12","232","593","0","39.12","21.42"
"64","000","00","035","3515","0056","220","127","93","12","232","593","0","39.12","21.42"
"64","000","00","035","3516","0000","259","184","75","30","289","597","0","48.41","30.82"
"64","000","00","035","3516","0057","259","184","75","30","289","597","0","48.41","30.82"
"64","000","00","035","3517","0000","160","81","79","3","163","343","0","47.52","23.62"
"64","000","00","035","3517","0058","160","81","79","3","163","343","0","47.52","23.62"
"64","000","00","035","3518","0000","347","162","185","30","377","670","0","56.27","24.18"
"64","000","00","035","3518","0059","347","162","185","30","377","670","0","56.27","24.18"
"64","000","00","036","0000","0000","1075","337","738","47","1122","1615","1999","69.47","20.87"
"64","000","00","036","3601","0000","473","138","335","21","494","726","0","68.04","19.01"
"64","000","00","036","3601","0129","473","138","335","21","494","726","0","68.04","19.01"
"64","000","00","036","3602","0000","259","97","162","13","272","382","0","71.2","25.39"
"64","000","00","036","3602","0128","259","97","162","13","272","382","0","71.2","25.39"
"64","000","00","036","3603","0000","343","102","241","13","356","507","0","70.22","20.12"
"64","000","00","036","3603","0127","343","102","241","13","356","507","0","70.22","20.12"
"64","000","00","037","0000","0000","1837","548","1289","89","1926","3498","4310","55.06","15.67"
"64","000","00","037","3701","0000","373","88","285","14","387","783","0","49.43","11.24"
"64","000","00","037","3701","0005","373","88","285","14","387","783","0","49.43","11.24"
"64","000","00","037","3702","0000","243","68","175","17","260","472","0","55.08","14.41"
"64","000","00","037","3702","0008","243","68","175","17","260","472","0","55.08","14.41"
"64","000","00","037","3703","0000","390","133","257","26","416","612","0","67.97","21.73"
"64","000","00","037","3703","0007","390","133","257","26","416","612","0","67.97","21.73"
"64","000","00","037","3704","0000","264","90","174","7","271","632","0","42.88","14.24"
"64","000","00","037","3704","0006","264","90","174","7","271","632","0","42.88","14.24"
"64","000","00","037","3705","0000","112","30","82","5","117","223","0","52.47","13.45"
"64","000","00","037","3705","0004","112","30","82","5","117","223","0","52.47","13.45"
"64","000","00","037","3706","0000","184","47","137","9","193","279","0","69.18","16.85"
"64","000","00","037","3706","0003","184","47","137","9","193","279","0","69.18","16.85"
"64","000","00","037","3707","0000","161","52","109","11","172","233","0","73.82","22.32"
"64","000","00","037","3707","0002","161","52","109","11","172","233","0","73.82","22.32"
"64","000","00","037","3708","0000","110","40","70","0","110","264","0","41.67","15.15"
"64","000","00","037","3708","0001","110","40","70","0","110","264","0","41.67","15.15"
"64","000","00","038","0000","0000","1427","495","932","108","1535","2424","3143","63.33","20.42"
"64","000","00","038","3801","0000","724","241","483","58","782","1326","0","58.97","18.17"
"64","000","00","038","3801","0009","345","120","225","15","360","741","0","48.58","16.19"
"64","000","00","038","3801","0010","379","121","258","43","422","585","0","72.14","20.68"
"64","000","00","038","3802","0000","431","109","322","39","470","609","0","77.18","17.9"
"64","000","00","038","3802","0011","431","109","322","39","470","609","0","77.18","17.9"
"64","000","00","038","3803","0000","272","145","127","11","283","489","0","57.87","29.65"
"64","000","00","038","3803","0012","272","145","127","11","283","489","0","57.87","29.65"
"10","004","00","000","0000","0000","241030","89171","151859","11356","252386","445051","556307","56.71","20.04"
"10","004","00","001","0000","0000","76813","30388","46425","3079","79892","137129","186411","58.26","22.16"
"10","004","00","001","0101","0000","3477","1628","1849","104","3581","5988","0","59.8","27.19"
"10","004","00","001","0101","0041","736","293","443","21","757","1301","0","58.19","22.52"
"10","004","00","001","0101","0042","1031","453","578","25","1056","1798","0","58.73","25.19"
"10","004","00","001","0101","0043","822","569","253","31","853","1427","0","59.78","39.87"
"10","004","00","001","0101","0044","888","313","575","27","915","1462","0","62.59","21.41"
"10","004","00","001","0102","0000","5584","2141","3443","139","5723","9417","0","60.77","22.74"
"10","004","00","001","0102","0001","839","321","518","19","858","1319","0","65.05","24.34"
"10","004","00","001","0102","0002","792","328","464","17","809","1321","0","61.24","24.83"
"10","004","00","001","0102","0003","771","268","503","29","800","1272","0","62.89","21.07"
"10","004","00","001","0102","0004","824","288","536","24","848","1467","0","57.81","19.63"
"10","004","00","001","0102","0005","694","290","404","21","715","1226","0","58.32","23.65"
"10","004","00","001","0102","0006","789","311","478","18","807","1412","0","57.15","22.03"
"10","004","00","001","0102","0007","875","335","540","11","886","1400","0","63.29","23.93"
"10","004","00","001","0103","0000","5794","2440","3354","145","5939","10185","0","58.31","23.96"
"10","004","00","001","0103","0008","860","338","522","21","881","1415","0","62.26","23.89"
"10","004","00","001","0103","0009","790","309","481","16","806","1361","0","59.22","22.7"
"10","004","00","001","0103","0010","815","337","478","18","833","1515","0","54.98","22.24"
"10","004","00","001","0103","0011","870","370","500","27","897","1495","0","60.0","24.75"
"10","004","00","001","0103","0012","817","348","469","26","843","1417","0","59.49","24.56"
"10","004","00","001","0103","0013","870","386","484","19","889","1548","0","57.43","24.94"
"10","004","00","001","0103","0014","772","352","420","18","790","1434","0","55.09","24.55"
"10","004","00","001","0104","0000","3814","1527","2287","131","3945","6515","0","60.55","23.44"
"10","004","00","001","0104","0015","785","279","506","30","815","1385","0","58.84","20.14"
"10","004","00","001","0104","0016","770","293","477","28","798","1247","0","63.99","23.5"
"10","004","00","001","0104","0017","778","341","437","21","799","1373","0","58.19","24.84"
"10","004","00","001","0104","0018","835","382","453","24","859","1345","0","63.87","28.4"
"10","004","00","001","0104","0019","646","232","414","28","674","1165","0","57.85","19.91"
"10","004","00","001","0105","0000","1443","605","838","68","1511","2376","0","63.59","25.46"
"10","004","00","001","0105","0020","716","298","418","38","754","1164","0","64.78","25.6"
"10","004","00","001","0105","0021","727","307","420","30","757","1212","0","62.46","25.33"
"10","004","00","001","0106","0000","1533","467","1066","64","1597","3083","0","51.8","15.15"
"10","004","00","001","0106","0022","732","225","507","27","759","1507","0","50.36","14.93"
"10","004","00","001","0106","0023","801","242","559","37","838","1576","0","53.17","15.36"
"10","004","00","001","0107","0000","3316","1160","2156","162","3478","6111","0","56.91","18.98"
"10","004","00","001","0107","0056","758","240","518","30","788","1477","0","53.35","16.25"
"10","004","00","001","0107","0057","935","342","593","48","983","1611","0","61.02","21.23"
"10","004","00","001","0107","0058","864","313","551","46","910","1555","0","58.52","20.13"
"10","004","00","001","0107","0059","759","265","494","38","797","1468","0","54.29","18.05"
"10","004","00","001","0108","0000","4936","1700","3236","299","5235","8856","0","59.11","19.2"
"10","004","00","001","0108","0060","858","282","576","40","898","1509","0","59.51","18.69"
"10","004","00","001","0108","0061","850","322","528","41","891","1602","0","55.62","20.1"
"10","004","00","001","0108","0062","810","258","552","55","865","1448","0","59.74","17.82"
"10","004","00","001","0108","0063","754","251","503","48","802","1318","0","60.85","19.04"
"10","004","00","001","0108","0064","951","367","584","51","1002","1634","0","61.32","22.46"
"10","004","00","001","0108","0065","713","220","493","64","777","1345","0","57.77","16.36"
"10","004","00","001","0109","0000","2883","1046","1837","116","2999","5746","0","52.19","18.2"
"10","004","00","001","0109","0069","833","285","548","30","863","1483","0","58.19","19.22"
"10","004","00","001","0109","0070","709","244","465","39","748","1332","0","56.16","18.32"
"10","004","00","001","0109","0071","745","297","448","24","769","1482","0","51.89","20.04"
"10","004","00","001","0109","0072","596","220","376","23","619","1449","0","42.72","15.18"
"10","004","00","001","0110","0000","2975","1054","1921","120","3095","5703","0","54.27","18.48"
"10","004","00","001","0110","0073","683","242","441","34","717","1319","0","54.36","18.35"
"10","004","00","001","0110","0074","694","234","460","32","726","1332","0","54.5","17.57"
"10","004","00","001","0110","0075","735","284","451","23","758","1412","0","53.68","20.11"
"10","004","00","001","0110","0076","863","294","569","31","894","1640","0","54.51","17.93"
"10","004","00","001","0111","0000","3703","1390","2313","196","3899","6849","0","56.93","20.29"
"10","004","00","001","0111","0077","710","264","446","46","756","1323","0","57.14","19.95"
"10","004","00","001","0111","0078","813","325","488","38","851","1428","0","59.59","22.76"
"10","004","00","001","0111","0079","856","282","574","46","902","1533","0","58.84","18.4"
"10","004","00","001","0111","0080","697","262","435","24","721","1346","0","53.57","19.47"
"10","004","00","001","0111","0081","627","257","370","42","669","1219","0","54.88","21.08"
"10","004","00","001","0112","0000","2457","939","1518","93","2550","4458","0","57.2","21.06"
"10","004","00","001","0112","0086","794","306","488","39","833","1383","0","60.23","22.13"
"10","004","00","001","0112","0087","879","350","529","34","913","1569","0","58.19","22.31"
"10","004","00","001","0112","0088","784","283","501","20","804","1506","0","53.39","18.79"
"10","004","00","001","0113","0000","1077","466","611","61","1138","1951","0","58.33","23.89"
"10","004","00","001","0113","0089","483","211","272","24","507","877","0","57.81","24.06"
"10","004","00","001","0113","0090","594","255","339","37","631","1074","0","58.75","23.74"
"10","004","00","001","0114","0000","1432","642","790","68","1500","2425","0","61.86","26.47"
"10","004","00","001","0114","0091","671","288","383","36","707","1089","0","64.92","26.45"
"10","004","00","001","0114","0092","761","354","407","32","793","1336","0","59.36","26.5"
"10","004","00","001","0115","0000","1257","539","718","66","1323","2143","0","61.74","25.15"
"10","004","00","001","0115","0094","591","231","360","37","628","937","0","67.02","24.65"
"10","004","00","001","0115","0095","666","308","358","29","695","1206","0","57.63","25.54"
"10","004","00","001","0116","0000","674","343","331","44","718","1205","0","59.59","28.46"
"10","004","00","001","0116","0096","674","343","331","44","718","1205","0","59.59","28.46"
"10","004","00","001","0117","0000","892","424","468","52","944","1585","0","59.56","26.75"
"10","004","00","001","0117","0098","504","233","271","30","534","917","0","58.23","25.41"
"10","004","00","001","0117","0099","388","191","197","22","410","668","0","61.38","28.59"
"10","004","00","001","0118","0000","1041","499","542","59","1100","1914","0","57.47","26.07"
"10","004","00","001","0118","0102","559","266","293","46","605","977","0","61.92","27.23"
"10","004","00","001","0118","0103","482","233","249","13","495","937","0","52.83","24.87"
"10","004","00","001","0119","0000","967","393","574","63","1030","1718","0","59.95","22.88"
"10","004","00","001","0119","0097","967","393","574","63","1030","1718","0","59.95","22.88"
"10","004","00","001","0120","0000","866","418","448","72","938","1606","0","58.41","26.03"
"10","004","00","001","0120","0100","447","228","219","24","471","824","0","57.16","27.67"
"10","004","00","001","0120","0101","419","190","229","48","467","782","0","59.72","24.3"
"10","004","00","001","0121","0000","3325","1375","1950","89","3414","6176","0","55.28","22.26"
"10","004","00","001","0121","0030","717","271","446","20","737","1196","0","61.62","22.66"
"10","004","00","001","0121","0031","723","252","471","21","744","1235","0","60.24","20.4"
"10","004","00","001","0121","0032","678","260","418","11","689","1204","0","57.23","21.59"
"10","004","00","001","0121","0033","778","308","470","25","803","1308","0","61.39","23.55"
"10","004","00","001","0121","0034","429","284","145","12","441","1233","0","35.77","23.03"
"10","004","00","001","0122","0000","3023","1184","1839","151","3174","5664","0","56.04","20.9"
"10","004","00","001","0122","0082","853","337","516","45","898","1466","0","61.26","22.99"
"10","004","00","001","0122","0083","609","262","347","26","635","1147","0","55.36","22.84"
"10","004","00","001","0122","0084","722","266","456","38","760","1529","0","49.71","17.4"
"10","004","00","001","0122","0085","839","319","520","42","881","1522","0","57.88","20.96"
"10","004","00","001","0123","0000","568","223","345","37","605","1058","0","57.18","21.08"
"10","004","00","001","0123","0093","568","223","345","37","605","1058","0","57.18","21.08"
"10","004","00","001","0124","0000","2319","813","1506","70","2389","3738","0","63.91","21.75"
"10","004","00","001","0124","0049","699","267","432","27","726","1181","0","61.47","22.61"
"10","004","00","001","0124","0050","844","298","546","21","865","1329","0","65.09","22.42"
"10","004","00","001","0124","0051","776","248","528","22","798","1228","0","64.98","20.2"
"10","004","00","001","0125","0000","3303","1325","1978","104","3407","5989","0","56.89","22.12"
"10","004","00","001","0125","0052","839","338","501","37","876","1552","0","56.44","21.78"
"10","004","00","001","0125","0053","874","347","527","20","894","1480","0","60.41","23.45"
"10","004","00","001","0125","0054","809","319","490","15","824","1487","0","55.41","21.45"
"10","004","00","001","0125","0055","781","321","460","32","813","1470","0","55.31","21.84"
"10","004","00","001","0126","0000","1910","703","1207","104","2014","3204","0","62.86","21.94"
"10","004","00","001","0126","0066","615","220","395","25","640","958","0","66.81","22.96"
"10","004","00","001","0126","0067","675","241","434","29","704","1112","0","63.31","21.67"
"10","004","00","001","0126","0068","620","242","378","50","670","1134","0","59.08","21.34"
"10","004","00","001","0127","0000","3105","1487","1618","109","3214","5749","0","55.91","25.87"
"10","004","00","001","0127","0024","798","353","445","27","825","1464","0","56.35","24.11"
"10","004","00","001","0127","0025","803","344","459","17","820","1428","0","57.42","24.09"
"10","004","00","001","0127","0026","708","316","392","18","726","1442","0","50.35","21.91"
"10","004","00","001","0127","0027","796","474","322","47","843","1415","0","59.58","33.5"
"10","004","00","001","0128","0000","1739","753","986","52","1791","3417","0","52.41","22.04"
"10","004","00","001","0128","0028","827","359","468","21","848","1666","0","50.9","21.55"
"10","004","00","001","0128","0029","912","394","518","31","943","1751","0","53.85","22.5"
"10","004","00","001","0129","0000","1982","717","1265","66","2048","3312","0","61.84","21.65"
"10","004","00","001","0129","0035","659","231","428","17","676","1129","0","59.88","20.46"
"10","004","00","001","0129","0036","649","226","423","12","661","1069","0","61.83","21.14"
"10","004","00","001","0129","0037","674","260","414","37","711","1114","0","63.82","23.34"
"10","004","00","001","0130","0000","2025","732","1293","66","2091","3265","0","64.04","22.42"
"10","004","00","001","0130","0038","673","220","453","22","695","1103","0","63.01","19.95"
"10","004","00","001","0130","0039","648","231","417","22","670","1029","0","65.11","22.45"
"10","004","00","001","0130","0040","704","281","423","22","726","1133","0","64.08","24.8"
"10","004","00","001","0131","0000","3393","1255","2138","109","3502","5723","0","61.19","21.93"
"10","004","00","001","0131","0045","831","310","521","30","861","1342","0","64.16","23.1"
"10","004","00","001","0131","0046","875","323","552","29","904","1480","0","61.08","21.82"
"10","004","00","001","0131","0047","911","345","566","18","929","1645","0","56.47","20.97"
"10","004","00","001","0131","0048","776","277","499","32","808","1256","0","64.33","22.05"
"10","004","00","002","0000","0000","40754","13976","26778","1936","42690","78794","96358","54.18","17.74"
"10","004","00","002","0201","0000","143","54","89","12","155","309","0","50.16","17.48"
"10","004","00","002","0201","0104","143","54","89","12","155","309","0","50.16","17.48"
"10","004","00","002","0202","0000","191","73","118","23","214","416","0","51.44","17.55"
"10","004","00","002","0202","0105","191","73","118","23","214","416","0","51.44","17.55"
"10","004","00","002","0203","0000","198","70","128","6","204","386","0","52.85","18.13"
"10","004","00","002","0203","0106","198","70","128","6","204","386","0","52.85","18.13"
"10","004","00","002","0204","0000","1127","384","743","44","1171","2225","0","52.63","17.26"
"10","004","00","002","0204","0107","458","170","288","29","487","950","0","51.26","17.89"
"10","004","00","002","0204","0108","669","214","455","15","684","1275","0","53.65","16.78"
"10","004","00","002","0205","0000","1723","609","1114","92","1815","3283","0","55.28","18.55"
"10","004","00","002","0205","0116","693","240","453","35","728","1292","0","56.35","18.58"
"10","004","00","002","0205","0117","544","181","363","20","564","1111","0","50.77","16.29"
"10","004","00","002","0205","0118","486","188","298","37","523","880","0","59.43","21.36"
"10","004","00","002","0206","0000","4673","1556","3117","197","4870","9177","0","53.07","16.96"
"10","004","00","002","0206","0109","626","222","404","31","657","1213","0","54.16","18.3"
"10","004","00","002","0206","0110","832","243","589","34","866","1548","0","55.94","15.7"
"10","004","00","002","0206","0111","611","189","422","20","631","1246","0","50.64","15.17"
"10","004","00","002","0206","0112","541","195","346","34","575","1252","0","45.93","15.58"
"10","004","00","002","0206","0113","692","208","484","28","720","1359","0","52.98","15.31"
"10","004","00","002","0206","0114","649","261","388","27","676","1255","0","53.86","20.8"
"10","004","00","002","0206","0115","722","238","484","23","745","1304","0","57.13","18.25"
"10","004","00","002","0207","0000","2429","764","1665","131","2560","4569","0","56.03","16.72"
"10","004","00","002","0207","0121","561","177","384","48","609","1126","0","54.09","15.72"
"10","004","00","002","0207","0122","563","191","372","31","594","1073","0","55.36","17.8"
"10","004","00","002","0207","0123","655","209","446","40","695","1215","0","57.2","17.2"
"10","004","00","002","0207","0124","650","187","463","12","662","1155","0","57.32","16.19"
"10","004","00","002","0208","0000","376","154","222","20","396","704","0","56.25","21.88"
"10","004","00","002","0208","0128","376","154","222","20","396","704","0","56.25","21.88"
"10","004","00","002","0209","0000","1360","452","908","72","1432","3048","0","46.98","14.83"
"10","004","00","002","0209","0129","356","108","248","26","382","951","0","40.17","11.36"
"10","004","00","002","0209","0130","535","171","364","29","564","984","0","57.32","17.38"
"10","004","00","002","0209","0131","469","173","296","17","486","1113","0","43.67","15.54"
"10","004","00","002","0210","0000","784","281","503","47","831","1357","0","61.24","20.71"
"10","004","00","002","0210","0132","337","111","226","21","358","595","0","60.17","18.66"
"10","004","00","002","0210","0133","447","170","277","26","473","762","0","62.07","22.31"
"10","004","00","002","0211","0000","798","288","510","42","840","1400","0","60.0","20.57"
"10","004","00","002","0211","0142","410","150","260","30","440","715","0","61.54","20.98"
"10","004","00","002","0211","0143","388","138","250","12","400","685","0","58.39","20.15"
"10","004","00","002","0212","0000","1902","627","1275","89","1991","3875","0","51.38","16.18"
"10","004","00","002","0212","0136","616","198","418","26","642","1310","0","49.01","15.11"
"10","004","00","002","0212","0137","671","206","465","35","706","1434","0","49.23","14.37"
"10","004","00","002","0212","0138","615","223","392","28","643","1131","0","56.85","19.72"
"10","004","00","002","0213","0000","1723","594","1129","80","1803","3317","0","54.36","17.91"
"10","004","00","002","0213","0139","510","170","340","21","531","967","0","54.91","17.58"
"10","004","00","002","0213","0140","586","187","399","28","614","1196","0","51.34","15.64"
"10","004","00","002","0213","0141","627","237","390","31","658","1154","0","57.02","20.54"
"10","004","00","002","0214","0000","3710","1262","2448","137","3847","7555","0","50.92","16.7"
"10","004","00","002","0214","0149","631","222","409","15","646","1248","0","51.76","17.79"
"10","004","00","002","0214","0150","554","229","325","21","575","1263","0","45.53","18.13"
"10","004","00","002","0214","0151","595","187","408","21","616","1232","0","50.0","15.18"
"10","004","00","002","0214","0152","522","164","358","24","546","1143","0","47.77","14.35"
"10","004","00","002","0214","0153","809","277","532","26","835","1529","0","54.61","18.12"
"10","004","00","002","0214","0154","599","183","416","30","629","1140","0","55.18","16.05"
"10","004","00","002","0215","0000","3176","1100","2076","176","3352","6204","0","54.03","17.73"
"10","004","00","002","0215","0156","633","222","411","25","658","1345","0","48.92","16.51"
"10","004","00","002","0215","0157","698","253","445","41","739","1381","0","53.51","18.32"
"10","004","00","002","0215","0158","721","256","465","41","762","1379","0","55.26","18.56"
"10","004","00","002","0215","0159","562","198","364","45","607","1033","0","58.76","19.17"
"10","004","00","002","0215","0160","562","171","391","24","586","1066","0","54.97","16.04"
"10","004","00","002","0216","0000","2366","841","1525","100","2466","4350","0","56.69","19.33"
"10","004","00","002","0216","0169","596","230","366","28","624","1083","0","57.62","21.24"
"10","004","00","002","0216","0170","581","194","387","27","608","1102","0","55.17","17.6"
"10","004","00","002","0216","0171","587","215","372","20","607","1068","0","56.84","20.13"
"10","004","00","002","0216","0172","602","202","400","25","627","1097","0","57.16","18.41"
"10","004","00","002","0217","0000","992","357","635","36","1028","1871","0","54.94","19.08"
"10","004","00","002","0217","0173","491","169","322","14","505","962","0","52.49","17.57"
"10","004","00","002","0217","0174","501","188","313","22","523","909","0","57.54","20.68"
"10","004","00","002","0218","0000","282","109","173","20","302","603","0","50.08","18.08"
"10","004","00","002","0218","0175","282","109","173","20","302","603","0","50.08","18.08"
"10","004","00","002","0219","0000","5334","1897","3437","242","5576","10396","0","53.64","18.25"
"10","004","00","002","0219","0161","507","184","323","49","556","938","0","59.28","19.62"
"10","004","00","002","0219","0162","553","192","361","36","589","952","0","61.87","20.17"
"10","004","00","002","0219","0163","851","270","581","32","883","1468","0","60.15","18.39"
"10","004","00","002","0219","0164","944","432","512","33","977","1915","0","51.02","22.56"
"10","004","00","002","0219","0165","611","195","416","30","641","1220","0","52.54","15.98"
"10","004","00","002","0219","0166","520","187","333","15","535","1166","0","45.88","16.04"
"10","004","00","002","0219","0167","704","228","476","27","731","1492","0","48.99","15.28"
"10","004","00","002","0219","0168","644","209","435","20","664","1245","0","53.33","16.79"
"10","004","00","002","0220","0000","957","355","602","60","1017","1727","0","58.89","20.56"
"10","004","00","002","0220","0125","454","163","291","34","488","852","0","57.28","19.13"
"10","004","00","002","0220","0126","503","192","311","26","529","875","0","60.46","21.94"
"10","004","00","002","0221","0000","1067","372","695","55","1122","1914","0","58.62","19.44"
"10","004","00","002","0221","0119","373","137","236","22","395","670","0","58.96","20.45"
"10","004","00","002","0221","0120","694","235","459","33","727","1244","0","58.44","18.89"
"10","004","00","002","0222","0000","630","216","414","24","654","1070","0","61.12","20.19"
"10","004","00","002","0222","0127","630","216","414","24","654","1070","0","61.12","20.19"
"10","004","00","002","0223","0000","3648","1123","2525","173","3821","6892","0","55.44","16.29"
"10","004","00","002","0223","0144","692","206","486","29","721","1352","0","53.33","15.24"
"10","004","00","002","0223","0145","764","231","533","42","806","1407","0","57.29","16.42"
"10","004","00","002","0223","0146","715","236","479","32","747","1362","0","54.85","17.33"
"10","004","00","002","0223","0147","738","225","513","29","767","1330","0","57.67","16.92"
"10","004","00","002","0223","0148","739","225","514","41","780","1441","0","54.13","15.61"
"10","004","00","002","0224","0000","823","314","509","34","857","1576","0","54.38","19.92"
"10","004","00","002","0224","0134","414","155","259","18","432","763","0","56.62","20.31"
"10","004","00","002","0224","0135","409","159","250","16","425","813","0","52.28","19.56"
"10","004","00","002","0225","0000","342","124","218","24","366","570","0","64.21","21.75"
"10","004","00","002","0225","0155","342","124","218","24","366","570","0","64.21","21.75"
"10","004","00","003","0000","0000","15565","5618","9947","787","16352","28894","33106","56.59","19.44"
"10","004","00","003","0301","0000","632","128","504","29","661","1139","0","58.03","11.24"
"10","004","00","003","0301","0194","632","128","504","29","661","1139","0","58.03","11.24"
"10","004","00","003","0302","0000","482","174","308","14","496","861","0","57.61","20.21"
"10","004","00","003","0302","0195","482","174","308","14","496","861","0","57.61","20.21"
"10","004","00","003","0303","0000","2131","756","1375","84","2215","4271","0","51.86","17.7"
"10","004","00","003","0303","0196","544","189","355","21","565","1093","0","51.69","17.29"
"10","004","00","003","0303","0197","480","164","316","25","505","978","0","51.64","16.77"
"10","004","00","003","0303","0198","502","175","327","21","523","1040","0","50.29","16.83"
"10","004","00","003","0303","0199","605","228","377","17","622","1160","0","53.62","19.66"
"10","004","00","003","0304","0000","1079","364","715","54","1133","1965","0","57.66","18.52"
"10","004","00","003","0304","0184","518","157","361","20","538","948","0","56.75","16.56"
"10","004","00","003","0304","0185","561","207","354","34","595","1017","0","58.51","20.35"
"10","004","00","003","0305","0000","1805","675","1130","95","1900","3320","0","57.23","20.33"
"10","004","00","003","0305","0186","694","224","470","27","721","1176","0","61.31","19.05"
"10","004","00","003","0305","0187","648","251","397","51","699","1122","0","62.3","22.37"
"10","004","00","003","0305","0188","463","200","263","17","480","1022","0","46.97","19.57"
"10","004","00","003","0306","0000","960","324","636","42","1002","1829","0","54.78","17.71"
"10","004","00","003","0306","0182","521","155","366","21","542","924","0","58.66","16.77"
"10","004","00","003","0306","0183","439","169","270","21","460","905","0","50.83","18.67"
"10","004","00","003","0307","0000","1447","508","939","69","1516","2526","0","60.02","20.11"
"10","004","00","003","0307","0179","497","167","330","32","529","935","0","56.58","17.86"
"10","004","00","003","0307","0180","416","133","283","20","436","753","0","57.9","17.66"
"10","004","00","003","0307","0181","534","208","326","17","551","838","0","65.75","24.82"
"10","004","00","003","0308","0000","570","193","377","21","591","983","0","60.12","19.63"
"10","004","00","003","0308","0176","570","193","377","21","591","983","0","60.12","19.63"
"10","004","00","003","0309","0000","348","146","202","23","371","597","0","62.14","24.46"
"10","004","00","003","0309","0177","348","146","202","23","371","597","0","62.14","24.46"
"10","004","00","003","0310","0000","580","174","406","20","600","1070","0","56.07","16.26"
"10","004","00","003","0310","0178","580","174","406","20","600","1070","0","56.07","16.26"
"10","004","00","003","0311","0000","1031","392","639","46","1077","1832","0","58.79","21.4"
"10","004","00","003","0311","0200","555","220","335","23","578","950","0","60.84","23.16"
"10","004","00","003","0311","0201","476","172","304","23","499","882","0","56.58","19.5"
"10","004","00","003","0312","0000","1311","493","818","80","1391","2493","0","55.8","19.78"
"10","004","00","003","0312","0202","699","263","436","40","739","1281","0","57.69","20.53"
"10","004","00","003","0312","0203","612","230","382","40","652","1212","0","53.8","18.98"
"10","004","00","003","0313","0000","455","153","302","30","485","1013","0","47.88","15.1"
"10","004","00","003","0313","0204","455","153","302","30","485","1013","0","47.88","15.1"
"10","004","00","003","0314","0000","379","175","204","24","403","630","0","63.97","27.78"
"10","004","00","003","0314","0205","379","175","204","24","403","630","0","63.97","27.78"
"10","004","00","003","0315","0000","643","238","405","37","680","1144","0","59.44","20.8"
"10","004","00","003","0315","0193","643","238","405","37","680","1144","0","59.44","20.8"
"10","004","00","003","0316","0000","675","267","408","38","713","1429","0","49.9","18.68"
"10","004","00","003","0316","0189","675","267","408","38","713","1429","0","49.9","18.68"
"10","004","00","003","0317","0000","279","130","149","28","307","451","0","68.07","28.82"
"10","004","00","003","0317","0190","279","130","149","28","307","451","0","68.07","28.82"
"10","004","00","003","0318","0000","393","181","212","21","414","724","0","57.18","25.0"
"10","004","00","003","0318","0191","393","181","212","21","414","724","0","57.18","25.0"
"10","004","00","003","0319","0000","365","147","218","32","397","617","0","64.34","23.82"
"10","004","00","003","0319","0192","365","147","218","32","397","617","0","64.34","23.82"
"10","004","00","004","0000","0000","13352","4766","8586","735","14087","24712","28659","57.0","19.29"
"10","004","00","004","0401","0000","287","103","184","21","308","480","0","64.17","21.46"
"10","004","00","004","0401","0206","287","103","184","21","308","480","0","64.17","21.46"
"10","004","00","004","0402","0000","1076","349","727","61","1137","1923","0","59.13","18.15"
"10","004","00","004","0402","0207","507","177","330","36","543","903","0","60.13","19.6"
"10","004","00","004","0402","0208","569","172","397","25","594","1020","0","58.24","16.86"
"10","004","00","004","0403","0000","376","134","242","15","391","705","0","55.46","19.01"
"10","004","00","004","0403","0209","376","134","242","15","391","705","0","55.46","19.01"
"10","004","00","004","0404","0000","1949","677","1272","100","2049","3618","0","56.63","18.71"
"10","004","00","004","0404","0210","566","193","373","19","585","1056","0","55.4","18.28"
"10","004","00","004","0404","0211","667","235","432","35","702","1275","0","55.06","18.43"
"10","004","00","004","0404","0212","716","249","467","46","762","1287","0","59.21","19.35"
"10","004","00","004","0405","0000","543","226","317","29","572","1046","0","54.68","21.61"
"10","004","00","004","0405","0214","543","226","317","29","572","1046","0","54.68","21.61"
"10","004","00","004","0406","0000","447","157","290","21","468","771","0","60.7","20.36"
"10","004","00","004","0406","0213","447","157","290","21","468","771","0","60.7","20.36"
"10","004","00","004","0407","0000","564","193","371","41","605","1030","0","58.74","18.74"
"10","004","00","004","0407","0215","564","193","371","41","605","1030","0","58.74","18.74"
"10","004","00","004","0408","0000","1857","621","1236","82","1939","3653","0","53.08","17.0"
"10","004","00","004","0408","0216","658","211","447","32","690","1208","0","57.12","17.47"
"10","004","00","004","0408","0217","512","145","367","21","533","1095","0","48.68","13.24"
"10","004","00","004","0408","0218","687","265","422","29","716","1350","0","53.04","19.63"
"10","004","00","004","0409","0000","707","241","466","41","748","1362","0","54.92","17.69"
"10","004","00","004","0409","0220","707","241","466","41","748","1362","0","54.92","17.69"
"10","004","00","004","0410","0000","245","107","138","24","269","551","0","48.82","19.42"
"10","004","00","004","0410","0222","245","107","138","24","269","551","0","48.82","19.42"
"10","004","00","004","0411","0000","300","106","194","19","319","572","0","55.77","18.53"
"10","004","00","004","0411","0224","300","106","194","19","319","572","0","55.77","18.53"
"10","004","00","004","0412","0000","486","155","331","23","509","943","0","53.98","16.44"
"10","004","00","004","0412","0225","486","155","331","23","509","943","0","53.98","16.44"
"10","004","00","004","0413","0000","186","90","96","8","194","461","0","42.08","19.52"
"10","004","00","004","0413","0223","186","90","96","8","194","461","0","42.08","19.52"
"10","004","00","004","0414","0000","441","193","248","32","473","808","0","58.54","23.89"
"10","004","00","004","0414","0226","441","193","248","32","473","808","0","58.54","23.89"
"10","004","00","004","0415","0000","1064","358","706","55","1119","1826","0","61.28","19.61"
"10","004","00","004","0415","0227","556","178","378","26","582","923","0","63.06","19.28"
"10","004","00","004","0415","0228","508","180","328","29","537","903","0","59.47","19.93"
"10","004","00","004","0416","0000","492","195","297","26","518","824","0","62.86","23.67"
"10","004","00","004","0416","0230","492","195","297","26","518","824","0","62.86","23.67"
"10","004","00","004","0417","0000","341","114","227","23","364","559","0","65.12","20.39"
"10","004","00","004","0417","0231","341","114","227","23","364","559","0","65.12","20.39"
"10","004","00","004","0418","0000","499","192","307","35","534","854","0","62.53","22.48"
"10","004","00","004","0418","0232","499","192","307","35","534","854","0","62.53","22.48"
"10","004","00","004","0419","0000","509","190","319","27","536","846","0","63.36","22.46"
"10","004","00","004","0419","0219","509","190","319","27","536","846","0","63.36","22.46"
"10","004","00","004","0420","0000","441","160","281","18","459","903","0","50.83","17.72"
"10","004","00","004","0420","0221","441","160","281","18","459","903","0","50.83","17.72"
"10","004","00","004","0421","0000","542","205","337","34","576","977","0","58.96","20.98"
"10","004","00","004","0421","0229","542","205","337","34","576","977","0","58.96","20.98"
"10","004","00","005","0000","0000","34221","12177","22044","1607","35828","63511","77604","56.41","19.17"
"10","004","00","005","0501","0000","737","258","479","37","774","1272","0","60.85","20.28"
"10","004","00","005","0501","0245","737","258","479","37","774","1272","0","60.85","20.28"
"10","004","00","005","0502","0000","493","181","312","23","516","851","0","60.63","21.27"
"10","004","00","005","0502","0244","493","181","312","23","516","851","0","60.63","21.27"
"10","004","00","005","0503","0000","2250","824","1426","124","2374","3993","0","59.45","20.64"
"10","004","00","005","0503","0241","771","297","474","52","823","1444","0","56.99","20.57"
"10","004","00","005","0503","0242","788","283","505","49","837","1347","0","62.14","21.01"
"10","004","00","005","0503","0243","691","244","447","23","714","1202","0","59.4","20.3"
"10","004","00","005","0504","0000","2911","1090","1821","132","3043","5202","0","58.5","20.95"
"10","004","00","005","0504","0250","724","283","441","31","755","1402","0","53.85","20.19"
"10","004","00","005","0504","0251","667","243","424","40","707","1183","0","59.76","20.54"
"10","004","00","005","0504","0252","747","284","463","29","776","1282","0","60.53","22.15"
"10","004","00","005","0504","0253","773","280","493","32","805","1335","0","60.3","20.97"
"10","004","00","005","0505","0000","1628","597","1031","80","1708","2835","0","60.25","21.06"
"10","004","00","005","0505","0246","699","238","461","35","734","1275","0","57.57","18.67"
"10","004","00","005","0505","0247","929","359","570","45","974","1560","0","62.44","23.01"
"10","004","00","005","0506","0000","2533","888","1645","126","2659","4714","0","56.41","18.84"
"10","004","00","005","0506","0238","948","357","591","49","997","1719","0","58.0","20.77"
"10","004","00","005","0506","0239","687","229","458","36","723","1162","0","62.22","19.71"
"10","004","00","005","0506","0240","898","302","596","41","939","1833","0","51.23","16.48"
"10","004","00","005","0507","0000","1520","514","1006","77","1597","2898","0","55.11","17.74"
"10","004","00","005","0507","0233","691","301","390","33","724","1393","0","51.97","21.61"
"10","004","00","005","0507","0234","829","213","616","44","873","1505","0","58.01","14.15"
"10","004","00","005","0508","0000","1597","546","1051","67","1664","3140","0","52.99","17.39"
"10","004","00","005","0508","0258","587","216","371","28","615","1193","0","51.55","18.11"
"10","004","00","005","0508","0259","1010","330","680","39","1049","1947","0","53.88","16.95"
"10","004","00","005","0509","0000","628","235","393","49","677","1125","0","60.18","20.89"
"10","004","00","005","0509","0260","628","235","393","49","677","1125","0","60.18","20.89"
"10","004","00","005","0510","0000","1560","580","980","55","1615","2783","0","58.03","20.84"
"10","004","00","005","0510","0261","588","222","366","23","611","1050","0","58.19","21.14"
"10","004","00","005","0510","0262","972","358","614","32","1004","1733","0","57.93","20.66"
"10","004","00","005","0511","0000","1327","429","898","69","1396","2346","0","59.51","18.29"
"10","004","00","005","0511","0263","724","238","486","38","762","1284","0","59.35","18.54"
"10","004","00","005","0511","0264","603","191","412","31","634","1062","0","59.7","17.98"
"10","004","00","005","0512","0000","833","293","540","50","883","1547","0","57.08","18.94"
"10","004","00","005","0512","0265","833","293","540","50","883","1547","0","57.08","18.94"
"10","004","00","005","0513","0000","1292","485","807","69","1361","2197","0","61.95","22.08"
"10","004","00","005","0513","0256","635","242","393","37","672","1082","0","62.11","22.37"
"10","004","00","005","0513","0257","657","243","414","32","689","1115","0","61.79","21.79"
"10","004","00","005","0514","0000","2528","934","1594","123","2651","5072","0","52.27","18.41"
"10","004","00","005","0514","0270","576","203","373","25","601","1058","0","56.81","19.19"
"10","004","00","005","0514","0271","513","198","315","18","531","1220","0","43.52","16.23"
"10","004","00","005","0514","0272","713","277","436","39","752","1333","0","56.41","20.78"
"10","004","00","005","0514","0273","726","256","470","41","767","1461","0","52.5","17.52"
"10","004","00","005","0515","0000","1640","583","1057","84","1724","3233","0","53.33","18.03"
"10","004","00","005","0515","0277","706","253","453","36","742","1495","0","49.63","16.92"
"10","004","00","005","0515","0278","405","123","282","28","433","752","0","57.58","16.36"
"10","004","00","005","0515","0279","529","207","322","20","549","986","0","55.68","20.99"
"10","004","00","005","0516","0000","2831","924","1907","93","2924","5896","0","49.59","15.67"
"10","004","00","005","0516","0266","728","220","508","25","753","1494","0","50.4","14.73"
"10","004","00","005","0516","0267","761","237","524","27","788","1634","0","48.23","14.5"
"10","004","00","005","0516","0268","675","246","429","12","687","1444","0","47.58","17.04"
"10","004","00","005","0516","0269","667","221","446","29","696","1324","0","52.57","16.69"
"10","004","00","005","0517","0000","1880","673","1207","65","1945","3370","0","57.72","19.97"
"10","004","00","005","0517","0254","896","350","546","39","935","1493","0","62.63","23.44"
"10","004","00","005","0517","0255","984","323","661","26","1010","1877","0","53.81","17.21"
"10","004","00","005","0518","0000","1629","597","1032","82","1711","2876","0","59.49","20.76"
"10","004","00","005","0518","0248","677","266","411","48","725","1147","0","63.21","23.19"
"10","004","00","005","0518","0249","952","331","621","34","986","1729","0","57.03","19.14"
"10","004","00","005","0519","0000","2335","817","1518","113","2448","4123","0","59.37","19.82"
"10","004","00","005","0519","0235","728","261","467","35","763","1188","0","64.23","21.97"
"10","004","00","005","0519","0236","684","245","439","47","731","1267","0","57.7","19.34"
"10","004","00","005","0519","0237","923","311","612","31","954","1668","0","57.19","18.65"
"10","004","00","005","0520","0000","2069","729","1340","89","2158","4038","0","53.44","18.05"
"10","004","00","005","0520","0274","748","295","453","28","776","1429","0","54.3","20.64"
"10","004","00","005","0520","0275","698","236","462","18","716","1506","0","47.54","15.67"
"10","004","00","005","0520","0276","623","198","425","43","666","1103","0","60.38","17.95"
"10","004","00","006","0000","0000","24592","9188","15404","1173","25765","45790","56957","56.27","20.07"
"10","004","00","006","0601","0000","544","205","339","40","584","1080","0","54.07","18.98"
"10","004","00","006","0601","0280","544","205","339","40","584","1080","0","54.07","18.98"
"10","004","00","006","0602","0000","904","396","508","59","963","1799","0","53.53","22.01"
"10","004","00","006","0602","0288","435","199","236","33","468","824","0","56.8","24.15"
"10","004","00","006","0602","0289","469","197","272","26","495","975","0","50.77","20.21"
"10","004","00","006","0603","0000","961","405","556","52","1013","1841","0","55.02","22.0"
"10","004","00","006","0603","0281","448","183","265","24","472","887","0","53.21","20.63"
"10","004","00","006","0603","0282","513","222","291","28","541","954","0","56.71","23.27"
"10","004","00","006","0604","0000","1431","668","763","85","1516","2743","0","55.27","24.35"
"10","004","00","006","0604","0291","792","350","442","53","845","1477","0","57.21","23.7"
"10","004","00","006","0604","0292","639","318","321","32","671","1266","0","53.0","25.12"
"10","004","00","006","0605","0000","917","403","514","49","966","1765","0","54.73","22.83"
"10","004","00","006","0605","0286","495","229","266","30","525","891","0","58.92","25.7"
"10","004","00","006","0605","0287","422","174","248","19","441","874","0","50.46","19.91"
"10","004","00","006","0606","0000","460","218","242","30","490","847","0","57.85","25.74"
"10","004","00","006","0606","0290","460","218","242","30","490","847","0","57.85","25.74"
"10","004","00","006","0607","0000","1753","639","1114","84","1837","3232","0","56.84","19.77"
"10","004","00","006","0607","0283","545","215","330","26","571","1003","0","56.93","21.44"
"10","004","00","006","0607","0284","575","202","373","30","605","1106","0","54.7","18.26"
"10","004","00","006","0607","0285","633","222","411","28","661","1123","0","58.86","19.77"
"10","004","00","006","0608","0000","2716","900","1816","181","2897","5237","0","55.32","17.19"
"10","004","00","006","0608","0305","736","163","573","48","784","1302","0","60.22","12.52"
"10","004","00","006","0608","0306","733","276","457","53","786","1410","0","55.74","19.57"
"10","004","00","006","0608","0307","651","260","391","45","696","1267","0","54.93","20.52"
"10","004","00","006","0608","0308","596","201","395","35","631","1258","0","50.16","15.98"
"10","004","00","006","0609","0000","1071","538","533","67","1138","2092","0","54.4","25.72"
"10","004","00","006","0609","0293","520","257","263","46","566","1029","0","55.0","24.98"
"10","004","00","006","0609","0294","551","281","270","21","572","1063","0","53.81","26.43"
"10","004","00","006","0610","0000","1344","435","909","52","1396","2500","0","55.84","17.4"
"10","004","00","006","0610","0295","568","176","392","20","588","1055","0","55.73","16.68"
"10","004","00","006","0610","0296","776","259","517","32","808","1445","0","55.92","17.92"
"10","004","00","006","0611","0000","2458","819","1639","73","2531","4382","0","57.76","18.69"
"10","004","00","006","0611","0311","659","223","436","22","681","1157","0","58.86","19.27"
"10","004","00","006","0611","0312","556","212","344","22","578","1089","0","53.08","19.47"
"10","004","00","006","0611","0313","646","207","439","15","661","1160","0","56.98","17.84"
"10","004","00","006","0611","0314","597","177","420","14","611","976","0","62.6","18.14"
"10","004","00","006","0612","0000","761","282","479","26","787","1486","0","52.96","18.98"
"10","004","00","006","0612","0303","761","282","479","26","787","1486","0","52.96","18.98"
"10","004","00","006","0613","0000","624","241","383","46","670","1067","0","62.79","22.59"
"10","004","00","006","0613","0304","624","241","383","46","670","1067","0","62.79","22.59"
"10","004","00","006","0614","0000","2108","749","1359","68","2176","3519","0","61.84","21.28"
"10","004","00","006","0614","0297","848","293","555","22","870","1413","0","61.57","20.74"
"10","004","00","006","0614","0298","597","231","366","26","623","971","0","64.16","23.79"
"10","004","00","006","0614","0299","663","225","438","20","683","1135","0","60.18","19.82"
"10","004","00","006","0615","0000","2281","826","1455","89","2370","4188","0","56.59","19.72"
"10","004","00","006","0615","0300","665","225","440","24","689","1269","0","54.29","17.73"
"10","004","00","006","0615","0301","682","260","422","31","713","1257","0","56.72","20.68"
"10","004","00","006","0615","0302","934","341","593","34","968","1662","0","58.24","20.52"
"10","004","00","006","0616","0000","2873","1007","1866","121","2994","5339","0","56.08","18.86"
"10","004","00","006","0616","0315","775","312","463","36","811","1443","0","56.2","21.62"
"10","004","00","006","0616","0316","639","229","410","23","662","1247","0","53.09","18.36"
"10","004","00","006","0616","0317","759","253","506","27","786","1411","0","55.71","17.93"
"10","004","00","006","0616","0318","700","213","487","35","735","1238","0","59.37","17.21"
"10","004","00","006","0617","0000","1386","457","929","51","1437","2673","0","53.76","17.1"
"10","004","00","006","0617","0309","610","215","395","22","632","1217","0","51.93","17.67"
"10","004","00","006","0617","0310","776","242","534","29","805","1456","0","55.29","16.62"
"10","004","00","007","0000","0000","9665","3394","6271","538","10203","17293","20043","59.0","19.63"
"10","004","00","007","0701","0000","357","125","232","23","380","534","0","71.16","23.41"
"10","004","00","007","0701","0320","357","125","232","23","380","534","0","71.16","23.41"
"10","004","00","007","0702","0000","232","87","145","12","244","417","0","58.51","20.86"
"10","004","00","007","0702","0319","232","87","145","12","244","417","0","58.51","20.86"
"10","004","00","007","0703","0000","543","170","373","23","566","963","0","58.77","17.65"
"10","004","00","007","0703","0321","543","170","373","23","566","963","0","58.77","17.65"
"10","004","00","007","0704","0000","256","96","160","15","271","418","0","64.83","22.97"
"10","004","00","007","0704","0322","256","96","160","15","271","418","0","64.83","22.97"
"10","004","00","007","0705","0000","1317","452","865","87","1404","2666","0","52.66","16.95"
"10","004","00","007","0705","0323","679","217","462","45","724","1312","0","55.18","16.54"
"10","004","00","007","0705","0324","638","235","403","42","680","1354","0","50.22","17.36"
"10","004","00","007","0706","0000","903","319","584","58","961","1582","0","60.75","20.16"
"10","004","00","007","0706","0325","440","169","271","32","472","785","0","60.13","21.53"
"10","004","00","007","0706","0326","463","150","313","26","489","797","0","61.36","18.82"
"10","004","00","007","0707","0000","370","118","252","24","394","623","0","63.24","18.94"
"10","004","00","007","0707","0327","370","118","252","24","394","623","0","63.24","18.94"
"10","004","00","007","0708","0000","413","163","250","32","445","759","0","58.63","21.48"
"10","004","00","007","0708","0328","413","163","250","32","445","759","0","58.63","21.48"
"10","004","00","007","0709","0000","1247","387","860","72","1319","2401","0","54.94","16.12"
"10","004","00","007","0709","0329","601","196","405","46","647","1272","0","50.86","15.41"
"10","004","00","007","0709","0330","646","191","455","26","672","1129","0","59.52","16.92"
"10","004","00","007","0710","0000","918","374","544","54","972","1552","0","62.63","24.1"
"10","004","00","007","0710","0331","423","164","259","21","444","713","0","62.27","23.0"
"10","004","00","007","0710","0332","495","210","285","33","528","839","0","62.93","25.03"
"10","004","00","007","0711","0000","2488","865","1623","103","2591","4276","0","60.59","20.23"
"10","004","00","007","0711","0333","710","231","479","32","742","1123","0","66.07","20.57"
"10","004","00","007","0711","0334","572","195","377","20","592","981","0","60.35","19.88"
"10","004","00","007","0711","0335","633","250","383","25","658","1078","0","61.04","23.19"
"10","004","00","007","0711","0336","573","189","384","26","599","1094","0","54.75","17.28"
"10","004","00","007","0712","0000","621","238","383","35","656","1102","0","59.53","21.6"
"10","004","00","007","0712","0337","621","238","383","35","656","1102","0","59.53","21.6"
"10","004","00","008","0000","0000","6301","2181","4120","427","6728","11346","13013","59.3","19.22"
"10","004","00","008","0801","0000","1944","659","1285","125","2069","3404","0","60.78","19.36"
"10","004","00","008","0801","0338","701","240","461","52","753","1231","0","61.17","19.5"
"10","004","00","008","0801","0339","583","192","391","44","627","1041","0","60.23","18.44"
"10","004","00","008","0801","0340","660","227","433","29","689","1132","0","60.87","20.05"
"10","004","00","008","0802","0000","491","174","317","36","527","859","0","61.35","20.26"
"10","004","00","008","0802","0341","491","174","317","36","527","859","0","61.35","20.26"
"10","004","00","008","0803","0000","103","33","70","15","118","204","0","57.84","16.18"
"10","004","00","008","0803","0342","103","33","70","15","118","204","0","57.84","16.18"
"10","004","00","008","0804","0000","94","46","48","8","102","222","0","45.95","20.72"
"10","004","00","008","0804","0343","94","46","48","8","102","222","0","45.95","20.72"
"10","004","00","008","0805","0000","197","85","112","22","219","338","0","64.79","25.15"
"10","004","00","008","0805","0344","197","85","112","22","219","338","0","64.79","25.15"
"10","004","00","008","0806","0000","470","156","314","23","493","916","0","53.82","17.03"
"10","004","00","008","0806","0345","470","156","314","23","493","916","0","53.82","17.03"
"10","004","00","008","0807","0000","224","79","145","8","232","463","0","50.11","17.06"
"10","004","00","008","0807","0348","224","79","145","8","232","463","0","50.11","17.06"
"10","004","00","008","0808","0000","541","202","339","50","591","978","0","60.43","20.65"
"10","004","00","008","0808","0349","404","138","266","39","443","690","0","64.2","20.0"
"10","004","00","008","0808","0350","137","64","73","11","148","288","0","51.39","22.22"
"10","004","00","008","0809","0000","920","304","616","60","980","1553","0","63.1","19.58"
"10","004","00","008","0809","0351","412","142","270","30","442","685","0","64.53","20.73"
"10","004","00","008","0809","0352","508","162","346","30","538","868","0","61.98","18.66"
"10","004","00","008","0810","0000","908","301","607","58","966","1561","0","61.88","19.28"
"10","004","00","008","0810","0353","908","301","607","58","966","1561","0","61.88","19.28"
"10","004","00","008","0811","0000","409","142","267","22","431","848","0","50.83","16.75"
"10","004","00","008","0811","0346","225","75","150","14","239","573","0","41.71","13.09"
"10","004","00","008","0811","0347","184","67","117","8","192","275","0","69.82","24.36"
"10","004","00","009","0000","0000","4430","1630","2800","241","4671","8180","9352","57.1","19.93"
"10","004","00","009","0901","0000","594","231","363","11","605","1158","0","52.25","19.95"
"10","004","00","009","0901","0354","594","231","363","11","605","1158","0","52.25","19.95"
"10","004","00","009","0902","0000","693","245","448","49","742","1238","0","59.94","19.79"
"10","004","00","009","0902","0355","693","245","448","49","742","1238","0","59.94","19.79"
"10","004","00","009","0903","0000","1388","460","928","90","1478","2584","0","57.2","17.8"
"10","004","00","009","0903","0357","520","182","338","26","546","931","0","58.65","19.55"
"10","004","00","009","0903","0358","868","278","590","64","932","1653","0","56.38","16.82"
"10","004","00","009","0904","0000","457","173","284","30","487","845","0","57.63","20.47"
"10","004","00","009","0904","0359","457","173","284","30","487","845","0","57.63","20.47"
"10","004","00","009","0905","0000","208","89","119","12","220","384","0","57.29","23.18"
"10","004","00","009","0905","0360","208","89","119","12","220","384","0","57.29","23.18"
"10","004","00","009","0906","0000","431","165","266","14","445","763","0","58.32","21.63"
"10","004","00","009","0906","0361","431","165","266","14","445","763","0","58.32","21.63"
"10","004","00","009","0907","0000","324","119","205","16","340","580","0","58.62","20.52"
"10","004","00","009","0907","0356","324","119","205","16","340","580","0","58.62","20.52"
"10","004","00","009","0908","0000","177","76","101","10","187","333","0","56.16","22.82"
"10","004","00","009","0908","0362","177","76","101","10","187","333","0","56.16","22.82"
"10","004","00","009","0909","0000","158","72","86","9","167","295","0","56.61","24.41"
"10","004","00","009","0909","0363","158","72","86","9","167","295","0","56.61","24.41"
"10","004","00","010","0000","0000","7278","2789","4489","371","7649","12973","14681","58.96","21.5"
"10","004","00","010","1001","0000","1445","563","882","55","1500","2595","0","57.8","21.7"
"10","004","00","010","1001","0364","643","255","388","29","672","1158","0","58.03","22.02"
"10","004","00","010","1001","0365","802","308","494","26","828","1437","0","57.62","21.43"
"10","004","00","010","1002","0000","1057","384","673","45","1102","1900","0","58.0","20.21"
"10","004","00","010","1002","0368","1057","384","673","45","1102","1900","0","58.0","20.21"
"10","004","00","010","1003","0000","522","179","343","30","552","1056","0","52.27","16.95"
"10","004","00","010","1003","0369","522","179","343","30","552","1056","0","52.27","16.95"
"10","004","00","010","1004","0000","705","281","424","52","757","1205","0","62.82","23.32"
"10","004","00","010","1004","0370","705","281","424","52","757","1205","0","62.82","23.32"
"10","004","00","010","1005","0000","486","186","300","31","517","846","0","61.11","21.99"
"10","004","00","010","1005","0372","486","186","300","31","517","846","0","61.11","21.99"
"10","004","00","010","1006","0000","411","143","268","32","443","766","0","57.83","18.67"
"10","004","00","010","1006","0371","411","143","268","32","443","766","0","57.83","18.67"
"10","004","00","010","1007","0000","347","158","189","12","359","554","0","64.8","28.52"
"10","004","00","010","1007","0375","347","158","189","12","359","554","0","64.8","28.52"
"10","004","00","010","1008","0000","471","176","295","24","495","804","0","61.57","21.89"
"10","004","00","010","1008","0373","471","176","295","24","495","804","0","61.57","21.89"
"10","004","00","010","1009","0000","357","137","220","17","374","607","0","61.61","22.57"
"10","004","00","010","1009","0374","357","137","220","17","374","607","0","61.61","22.57"
"10","004","00","010","1010","0000","1477","582","895","73","1550","2640","0","58.71","22.05"
"10","004","00","010","1010","0366","797","311","486","41","838","1470","0","57.01","21.16"
"10","004","00","010","1010","0367","680","271","409","32","712","1170","0","60.85","23.16"
"10","004","00","011","0000","0000","2872","1108","1764","207","3079","5068","5638","60.75","21.86"
"10","004","00","011","1101","0000","531","194","337","42","573","879","0","65.19","22.07"
"10","004","00","011","1101","0376","531","194","337","42","573","879","0","65.19","22.07"
"10","004","00","011","1102","0000","410","154","256","28","438","683","0","64.13","22.55"
"10","004","00","011","1102","0377","410","154","256","28","438","683","0","64.13","22.55"
"10","004","00","011","1103","0000","343","133","210","25","368","604","0","60.93","22.02"
"10","004","00","011","1103","0378","343","133","210","25","368","604","0","60.93","22.02"
"10","004","00","011","1104","0000","797","285","512","61","858","1406","0","61.02","20.27"
"10","004","00","011","1104","0381","797","285","512","61","858","1406","0","61.02","20.27"
"10","004","00","011","1105","0000","302","146","156","23","325","615","0","52.85","23.74"
"10","004","00","011","1105","0379","183","69","114","16","199","339","0","58.7","20.35"
"10","004","00","011","1105","0380","119","77","42","7","126","276","0","45.65","27.9"
"10","004","00","011","1106","0000","489","196","293","28","517","881","0","58.68","22.25"
"10","004","00","011","1106","0382","271","108","163","18","289","462","0","62.55","23.38"
"10","004","00","011","1106","0383","218","88","130","10","228","419","0","54.42","21.0"
"10","004","00","012","0000","0000","3345","1322","2023","171","3516","7364","9683","47.75","17.95"
"10","004","00","012","1201","0000","272","106","166","20","292","599","0","48.75","17.7"
"10","004","00","012","1201","0386","102","45","57","11","113","225","0","50.22","20.0"
"10","004","00","012","1201","0387","170","61","109","9","179","374","0","47.86","16.31"
"10","004","00","012","1202","0000","397","136","261","11","408","831","0","49.1","16.37"
"10","004","00","012","1202","0384","208","71","137","7","215","474","0","45.36","14.98"
"10","004","00","012","1202","0385","189","65","124","4","193","357","0","54.06","18.21"
"10","004","00","012","1203","0000","562","203","359","22","584","1263","0","46.24","16.07"
"10","004","00","012","1203","0388","332","115","217","6","338","773","0","43.73","14.88"
"10","004","00","012","1203","0389","230","88","142","16","246","490","0","50.2","17.96"
"10","004","00","012","1204","0000","361","131","230","47","408","613","0","66.56","21.37"
"10","004","00","012","1204","0392","361","131","230","47","408","613","0","66.56","21.37"
"10","004","00","012","1205","0000","504","178","326","17","521","1191","0","43.74","14.95"
"10","004","00","012","1205","0390","181","72","109","8","189","531","0","35.59","13.56"
"10","004","00","012","1205","0391","323","106","217","9","332","660","0","50.3","16.06"
"10","004","00","012","1206","0000","627","284","343","26","653","1294","0","50.46","21.95"
"10","004","00","012","1206","0393","270","128","142","6","276","593","0","46.54","21.59"
"10","004","00","012","1206","0394","280","109","171","13","293","575","0","50.96","18.96"
"10","004","00","012","1206","0395","77","47","30","7","84","126","0","66.67","37.3"
"10","004","00","012","1207","0000","622","284","338","28","650","1573","0","41.32","18.05"
"10","004","00","012","1207","0396","213","81","132","8","221","499","0","44.29","16.23"
"10","004","00","012","1207","0397","241","116","125","10","251","785","0","31.97","14.78"
"10","004","00","012","1207","0398","168","87","81","10","178","289","0","61.59","30.1"
"10","004","00","013","0000","0000","1842","634","1208","84","1926","3997","4802","48.19","15.86"
"10","004","00","013","1301","0000","671","209","462","42","713","1385","0","51.48","15.09"
"10","004","00","013","1301","0399","363","97","266","26","389","672","0","57.89","14.43"
"10","004","00","013","1301","0400","308","112","196","16","324","713","0","45.44","15.71"
"10","004","00","013","1302","0000","332","107","225","12","344","727","0","47.32","14.72"
"10","004","00","013","1302","0403","332","107","225","12","344","727","0","47.32","14.72"
"10","004","00","013","1303","0000","170","64","106","9","179","395","0","45.32","16.2"
"10","004","00","013","1303","0404","170","64","106","9","179","395","0","45.32","16.2"
"10","004","00","013","1304","0000","669","254","415","21","690","1490","0","46.31","17.05"
"10","004","00","013","1304","0401","228","93","135","6","234","594","0","39.39","15.66"
"10","004","00","013","1304","0402","441","161","280","15","456","896","0","50.89","17.97"
"10","005","00","000","0000","0000","249832","97041","152791","13709","263541","461580","549798","57.1","21.02"
"10","005","00","001","0000","0000","41221","13675","27546","1839","43060","74249","88300","57.99","18.42"
"10","005","00","001","0101","0000","600","200","400","30","630","1087","0","57.96","18.4"
"10","005","00","001","0101","0001","600","200","400","30","630","1087","0","57.96","18.4"
"10","005","00","001","0102","0000","2338","565","1773","110","2448","4075","0","60.07","13.87"
"10","005","00","001","0102","0049","611","12","599","33","644","1003","0","64.21","1.2"
"10","005","00","001","0102","0050","565","189","376","17","582","1000","0","58.2","18.9"
"10","005","00","001","0102","0051","569","183","386","21","590","1047","0","56.35","17.48"
"10","005","00","001","0102","0052","593","181","412","39","632","1025","0","61.66","17.66"
"10","005","00","001","0103","0000","550","171","379","21","571","1018","0","56.09","16.8"
"10","005","00","001","0103","0002","550","171","379","21","571","1018","0","56.09","16.8"
"10","005","00","001","0104","0000","1286","400","886","63","1349","2234","0","60.38","17.91"
"10","005","00","001","0104","0009","633","185","448","26","659","1115","0","59.1","16.59"
"10","005","00","001","0104","0010","653","215","438","37","690","1119","0","61.66","19.21"
"10","005","00","001","0105","0000","2098","679","1419","100","2198","3685","0","59.65","18.43"
"10","005","00","001","0105","0011","667","238","429","31","698","1132","0","61.66","21.02"
"10","005","00","001","0105","0012","707","220","487","35","742","1289","0","57.56","17.07"
"10","005","00","001","0105","0013","724","221","503","34","758","1264","0","59.97","17.48"
"10","005","00","001","0106","0000","2121","708","1413","103","2224","3702","0","60.08","19.12"
"10","005","00","001","0106","0006","696","236","460","28","724","1203","0","60.18","19.62"
"10","005","00","001","0106","0007","745","232","513","34","779","1306","0","59.65","17.76"
"10","005","00","001","0106","0008","680","240","440","41","721","1193","0","60.44","20.12"
"10","005","00","001","0107","0000","1800","575","1225","100","1900","3358","0","56.58","17.12"
"10","005","00","001","0107","0003","620","200","420","29","649","1156","0","56.14","17.3"
"10","005","00","001","0107","0004","582","188","394","30","612","1118","0","54.74","16.82"
"10","005","00","001","0107","0005","598","187","411","41","639","1084","0","58.95","17.25"
"10","005","00","001","0108","0000","474","146","328","20","494","870","0","56.78","16.78"
"10","005","00","001","0108","0014","474","146","328","20","494","870","0","56.78","16.78"
"10","005","00","001","0109","0000","1658","577","1081","75","1733","3163","0","54.79","18.24"
"10","005","00","001","0109","0015","486","151","335","29","515","1008","0","51.09","14.98"
"10","005","00","001","0109","0016","550","190","360","22","572","1078","0","53.06","17.63"
"10","005","00","001","0109","0017","622","236","386","24","646","1077","0","59.98","21.91"
"10","005","00","001","0110","0000","473","181","292","30","503","894","0","56.26","20.25"
"10","005","00","001","0110","0019","473","181","292","30","503","894","0","56.26","20.25"
"10","005","00","001","0111","0000","285","113","172","18","303","522","0","58.05","21.65"
"10","005","00","001","0111","0020","285","113","172","18","303","522","0","58.05","21.65"
"10","005","00","001","0112","0000","499","170","329","18","517","880","0","58.75","19.32"
"10","005","00","001","0112","0018","499","170","329","18","517","880","0","58.75","19.32"
"10","005","00","001","0113","0000","2321","787","1534","89","2410","3964","0","60.8","19.85"
"10","005","00","001","0113","0024","680","215","465","34","714","1272","0","56.13","16.9"
"10","005","00","001","0113","0025","694","238","456","19","713","1112","0","64.12","21.4"
"10","005","00","001","0113","0026","522","184","338","23","545","813","0","67.04","22.63"
"10","005","00","001","0113","0027","425","150","275","13","438","767","0","57.11","19.56"
"10","005","00","001","0114","0000","815","307","508","53","868","1376","0","63.08","22.31"
"10","005","00","001","0114","0021","815","307","508","53","868","1376","0","63.08","22.31"
"10","005","00","001","0115","0000","945","307","638","32","977","1597","0","61.18","19.22"
"10","005","00","001","0115","0031","359","97","262","6","365","607","0","60.13","15.98"
"10","005","00","001","0115","0032","586","210","376","26","612","990","0","61.82","21.21"
"10","005","00","001","0116","0000","2780","846","1934","124","2904","5087","0","57.09","16.63"
"10","005","00","001","0116","0033","640","157","483","29","669","1230","0","54.39","12.76"
"10","005","00","001","0116","0034","769","257","512","28","797","1372","0","58.09","18.73"
"10","005","00","001","0116","0035","677","214","463","36","713","1213","0","58.78","17.64"
"10","005","00","001","0116","0036","694","218","476","31","725","1272","0","57.0","17.14"
"10","005","00","001","0117","0000","1751","572","1179","58","1809","3157","0","57.3","18.12"
"10","005","00","001","0117","0028","563","181","382","21","584","1010","0","57.82","17.92"
"10","005","00","001","0117","0029","648","204","444","21","669","1182","0","56.6","17.26"
"10","005","00","001","0117","0030","540","187","353","16","556","965","0","57.62","19.38"
"10","005","00","001","0118","0000","1942","642","1300","83","2025","3496","0","57.92","18.36"
"10","005","00","001","0118","0037","722","250","472","35","757","1221","0","62.0","20.48"
"10","005","00","001","0118","0038","614","205","409","30","644","1104","0","58.33","18.57"
"10","005","00","001","0118","0039","606","187","419","18","624","1171","0","53.29","15.97"
"10","005","00","001","0119","0000","2295","958","1337","104","2399","4135","0","58.02","23.17"
"10","005","00","001","0119","0040","751","244","507","36","787","1392","0","56.54","17.53"
"10","005","00","001","0119","0041","766","444","322","35","801","1356","0","59.07","32.74"
"10","005","00","001","0119","0042","778","270","508","33","811","1387","0","58.47","19.47"
"10","005","00","001","0120","0000","616","228","388","31","647","1180","0","54.83","19.32"
"10","005","00","001","0120","0063","616","228","388","31","647","1180","0","54.83","19.32"
"10","005","00","001","0121","0000","2064","677","1387","94","2158","3644","0","59.22","18.58"
"10","005","00","001","0121","0057","666","187","479","27","693","1125","0","61.6","16.62"
"10","005","00","001","0121","0058","666","256","410","30","696","1241","0","56.08","20.63"
"10","005","00","001","0121","0059","732","234","498","37","769","1278","0","60.17","18.31"
"10","005","00","001","0122","0000","2716","815","1901","96","2812","5200","0","54.08","15.67"
"10","005","00","001","0122","0053","595","182","413","18","613","1130","0","54.25","16.11"
"10","005","00","001","0122","0054","639","183","456","15","654","1146","0","57.07","15.97"
"10","005","00","001","0122","0055","796","244","552","33","829","1432","0","57.89","17.04"
"10","005","00","001","0122","0056","686","206","480","30","716","1492","0","47.99","13.81"
"10","005","00","001","0123","0000","1337","452","885","73","1410","2472","0","57.04","18.28"
"10","005","00","001","0123","0022","727","243","484","33","760","1391","0","54.64","17.47"
"10","005","00","001","0123","0023","610","209","401","40","650","1081","0","60.13","19.33"
"10","005","00","001","0124","0000","835","296","539","36","871","1665","0","52.31","17.78"
"10","005","00","001","0124","0066","403","145","258","23","426","796","0","53.52","18.22"
"10","005","00","001","0124","0067","432","151","281","13","445","869","0","51.21","17.38"
"10","005","00","001","0125","0000","1912","688","1224","84","1996","3412","0","58.5","20.16"
"10","005","00","001","0125","0043","648","242","406","30","678","1206","0","56.22","20.07"
"10","005","00","001","0125","0044","614","219","395","26","640","1004","0","63.75","21.81"
"10","005","00","001","0125","0045","650","227","423","28","678","1202","0","56.41","18.89"
"10","005","00","001","0126","0000","1759","594","1165","79","1838","2900","0","63.38","20.48"
"10","005","00","001","0126","0046","613","203","410","28","641","1052","0","60.93","19.3"
"10","005","00","001","0126","0047","517","177","340","26","543","873","0","62.2","20.27"
"10","005","00","001","0126","0048","629","214","415","25","654","975","0","67.08","21.95"
"10","005","00","001","0127","0000","1101","421","680","42","1143","1984","0","57.61","21.22"
"10","005","00","001","0127","0064","620","252","368","17","637","1072","0","59.42","23.51"
"10","005","00","001","0127","0065","481","169","312","25","506","912","0","55.48","18.53"
"10","005","00","001","0128","0000","1850","600","1250","73","1923","3492","0","55.07","17.18"
"10","005","00","001","0128","0060","707","201","506","20","727","1293","0","56.23","15.55"
"10","005","00","001","0128","0061","686","222","464","26","712","1342","0","53.06","16.54"
"10","005","00","001","0128","0062","457","177","280","27","484","857","0","56.48","20.65"
"10","005","00","002","0000","0000","21180","10084","11096","1352","22532","38890","45367","57.94","25.93"
"10","005","00","002","0201","0000","1234","551","683","80","1314","2219","0","59.22","24.83"
"10","005","00","002","0201","0183","490","220","270","34","524","873","0","60.02","25.2"
"10","005","00","002","0201","0184","744","331","413","46","790","1346","0","58.69","24.59"
"10","005","00","002","0202","0000","945","440","505","41","986","1566","0","62.96","28.1"
"10","005","00","002","0202","0185","604","264","340","30","634","951","0","66.67","27.76"
"10","005","00","002","0202","0186","341","176","165","11","352","615","0","57.24","28.62"
"10","005","00","002","0203","0000","517","278","239","42","559","878","0","63.67","31.66"
"10","005","00","002","0203","0187","517","278","239","42","559","878","0","63.67","31.66"
"10","005","00","002","0204","0000","866","439","427","59","925","1543","0","59.95","28.45"
"10","005","00","002","0204","0188","443","209","234","34","477","767","0","62.19","27.25"
"10","005","00","002","0204","0189","423","230","193","25","448","776","0","57.73","29.64"
"10","005","00","002","0205","0000","634","343","291","36","670","1231","0","54.43","27.86"
"10","005","00","002","0205","0190","634","343","291","36","670","1231","0","54.43","27.86"
"10","005","00","002","0206","0000","1109","503","606","62","1171","1995","0","58.7","25.21"
"10","005","00","002","0206","0191","656","292","364","38","694","1145","0","60.61","25.5"
"10","005","00","002","0206","0192","453","211","242","24","477","850","0","56.12","24.82"
"10","005","00","002","0207","0000","535","290","245","51","586","1052","0","55.7","27.57"
"10","005","00","002","0207","0193","535","290","245","51","586","1052","0","55.7","27.57"
"10","005","00","002","0208","0000","1244","628","616","72","1316","2250","0","58.49","27.91"
"10","005","00","002","0208","0194","605","284","321","34","639","1114","0","57.36","25.49"
"10","005","00","002","0208","0195","639","344","295","38","677","1136","0","59.6","30.28"
"10","005","00","002","0209","0000","2184","978","1206","120","2304","3922","0","58.75","24.94"
"10","005","00","002","0209","0196","640","274","366","43","683","1194","0","57.2","22.95"
"10","005","00","002","0209","0197","863","380","483","45","908","1579","0","57.5","24.07"
"10","005","00","002","0209","0198","681","324","357","32","713","1149","0","62.05","28.2"
"10","005","00","002","0210","0000","1165","559","606","63","1228","2158","0","56.9","25.9"
"10","005","00","002","0210","0199","604","302","302","39","643","1057","0","60.83","28.57"
"10","005","00","002","0210","0200","561","257","304","24","585","1101","0","53.13","23.34"
"10","005","00","002","0211","0000","415","206","209","35","450","912","0","49.34","22.59"
"10","005","00","002","0211","0201","415","206","209","35","450","912","0","49.34","22.59"
"10","005","00","002","0212","0000","353","188","165","15","368","652","0","56.44","28.83"
"10","005","00","002","0212","0202","353","188","165","15","368","652","0","56.44","28.83"
"10","005","00","002","0213","0000","734","361","373","52","786","1348","0","58.31","26.78"
"10","005","00","002","0213","0203","734","361","373","52","786","1348","0","58.31","26.78"
"10","005","00","002","0214","0000","698","361","337","30","728","1395","0","52.19","25.88"
"10","005","00","002","0214","0204","361","219","142","21","382","733","0","52.11","29.88"
"10","005","00","002","0214","0205","337","142","195","9","346","662","0","52.27","21.45"
"10","005","00","002","0215","0000","995","457","538","71","1066","1803","0","59.12","25.35"
"10","005","00","002","0215","0206","484","220","264","35","519","893","0","58.12","24.64"
"10","005","00","002","0215","0207","511","237","274","36","547","910","0","60.11","26.04"
"10","005","00","002","0216","0000","655","313","342","55","710","1270","0","55.91","24.65"
"10","005","00","002","0216","0208","655","313","342","55","710","1270","0","55.91","24.65"
"10","005","00","002","0217","0000","279","130","149","18","297","545","0","54.5","23.85"
"10","005","00","002","0217","0209","279","130","149","18","297","545","0","54.5","23.85"
"10","005","00","002","0218","0000","448","182","266","55","503","792","0","63.51","22.98"
"10","005","00","002","0218","0210","448","182","266","55","503","792","0","63.51","22.98"
"10","005","00","002","0219","0000","1332","622","710","71","1403","2316","0","60.58","26.86"
"10","005","00","002","0219","0218","626","276","350","27","653","1082","0","60.35","25.51"
"10","005","00","002","0219","0219","706","346","360","44","750","1234","0","60.78","28.04"
"10","005","00","002","0220","0000","795","383","412","47","842","1609","0","52.33","23.8"
"10","005","00","002","0220","0212","360","179","181","13","373","827","0","45.1","21.64"
"10","005","00","002","0220","0213","435","204","231","34","469","782","0","59.97","26.09"
"10","005","00","002","0221","0000","855","401","454","56","911","1634","0","55.75","24.54"
"10","005","00","002","0221","0214","408","190","218","33","441","788","0","55.96","24.11"
"10","005","00","002","0221","0215","447","211","236","23","470","846","0","55.56","24.94"
"10","005","00","002","0222","0000","978","418","560","78","1056","1771","0","59.63","23.6"
"10","005","00","002","0222","0216","469","198","271","36","505","828","0","60.99","23.91"
"10","005","00","002","0222","0217","509","220","289","42","551","943","0","58.43","23.33"
"10","005","00","002","0223","0000","390","192","198","28","418","726","0","57.58","26.45"
"10","005","00","002","0223","0211","390","192","198","28","418","726","0","57.58","26.45"
"10","005","00","002","0224","0000","740","318","422","50","790","1434","0","55.09","22.18"
"10","005","00","002","0224","0220","740","318","422","50","790","1434","0","55.09","22.18"
"10","005","00","002","0225","0000","1080","543","537","65","1145","1869","0","61.26","29.05"
"10","005","00","002","0225","0221","541","253","288","35","576","987","0","58.36","25.63"
"10","005","00","002","0225","0222","539","290","249","30","569","882","0","64.51","32.88"
"10","005","00","003","0000","0000","15126","6886","8240","1096","16222","29709","34122","54.6","23.18"
"10","005","00","003","0301","0000","608","287","321","58","666","1142","0","58.32","25.13"
"10","005","00","003","0301","0149","608","287","321","58","666","1142","0","58.32","25.13"
"10","005","00","003","0302","0000","1121","513","608","65","1186","1952","0","60.76","26.28"
"10","005","00","003","0302","0150","544","284","260","35","579","884","0","65.5","32.13"
"10","005","00","003","0302","0151","577","229","348","30","607","1068","0","56.84","21.44"
"10","005","00","003","0303","0000","1110","512","598","62","1172","1868","0","62.74","27.41"
"10","005","00","003","0303","0152","586","290","296","23","609","1009","0","60.36","28.74"
"10","005","00","003","0303","0153","524","222","302","39","563","859","0","65.54","25.84"
"10","005","00","003","0304","0000","860","393","467","63","923","1551","0","59.51","25.34"
"10","005","00","003","0304","0157","469","216","253","42","511","761","0","67.15","28.38"
"10","005","00","003","0304","0158","391","177","214","21","412","790","0","52.15","22.41"
"10","005","00","003","0305","0000","363","175","188","45","408","686","0","59.48","25.51"
"10","005","00","003","0305","0156","363","175","188","45","408","686","0","59.48","25.51"
"10","005","00","003","0306","0000","1350","603","747","124","1474","2709","0","54.41","22.26"
"10","005","00","003","0306","0159","495","217","278","39","534","966","0","55.28","22.46"
"10","005","00","003","0306","0160","459","212","247","47","506","972","0","52.06","21.81"
"10","005","00","003","0306","0161","396","174","222","38","434","771","0","56.29","22.57"
"10","005","00","003","0307","0000","348","160","188","17","365","684","0","53.36","23.39"
"10","005","00","003","0307","0168","348","160","188","17","365","684","0","53.36","23.39"
"10","005","00","003","0308","0000","417","185","232","30","447","943","0","47.4","19.62"
"10","005","00","003","0308","0169","417","185","232","30","447","943","0","47.4","19.62"
"10","005","00","003","0309","0000","438","203","235","42","480","790","0","60.76","25.7"
"10","005","00","003","0309","0170","438","203","235","42","480","790","0","60.76","25.7"
"10","005","00","003","0310","0000","302","160","142","8","310","673","0","46.06","23.77"
"10","005","00","003","0310","0171","302","160","142","8","310","673","0","46.06","23.77"
"10","005","00","003","0311","0000","600","258","342","58","658","1232","0","53.41","20.94"
"10","005","00","003","0311","0172","600","258","342","58","658","1232","0","53.41","20.94"
"10","005","00","003","0312","0000","710","313","397","48","758","1286","0","58.94","24.34"
"10","005","00","003","0312","0173","710","313","397","48","758","1286","0","58.94","24.34"
"10","005","00","003","0313","0000","719","354","365","55","774","1418","0","54.58","24.96"
"10","005","00","003","0313","0174","352","159","193","32","384","649","0","59.17","24.5"
"10","005","00","003","0313","0175","367","195","172","23","390","769","0","50.72","25.36"
"10","005","00","003","0314","0000","896","382","514","51","947","1836","0","51.58","20.81"
"10","005","00","003","0314","0162","346","161","185","16","362","758","0","47.76","21.24"
"10","005","00","003","0314","0163","550","221","329","35","585","1078","0","54.27","20.5"
"10","005","00","003","0315","0000","188","88","100","15","203","459","0","44.23","19.17"
"10","005","00","003","0315","0164","188","88","100","15","203","459","0","44.23","19.17"
"10","005","00","003","0316","0000","413","159","254","36","449","894","0","50.22","17.79"
"10","005","00","003","0316","0165","413","159","254","36","449","894","0","50.22","17.79"
"10","005","00","003","0317","0000","153","59","94","6","159","402","0","39.55","14.68"
"10","005","00","003","0317","0166","153","59","94","6","159","402","0","39.55","14.68"
"10","005","00","003","0318","0000","406","174","232","30","436","802","0","54.36","21.7"
"10","005","00","003","0318","0167","406","174","232","30","436","802","0","54.36","21.7"
"10","005","00","003","0319","0000","1109","496","613","98","1207","2286","0","52.8","21.7"
"10","005","00","003","0319","0176","579","244","335","52","631","1148","0","54.97","21.25"
"10","005","00","003","0319","0177","530","252","278","46","576","1138","0","50.62","22.14"
"10","005","00","003","0320","0000","544","280","264","38","582","1121","0","51.92","24.98"
"10","005","00","003","0320","0178","544","280","264","38","582","1121","0","51.92","24.98"
"10","005","00","003","0321","0000","406","176","230","24","430","769","0","55.92","22.89"
"10","005","00","003","0321","0179","406","176","230","24","430","769","0","55.92","22.89"
"10","005","00","003","0322","0000","687","318","369","51","738","1415","0","52.16","22.47"
"10","005","00","003","0322","0180","287","136","151","13","300","616","0","48.7","22.08"
"10","005","00","003","0322","0181","400","182","218","38","438","799","0","54.82","22.78"
"10","005","00","003","0323","0000","362","173","189","23","385","743","0","51.82","23.28"
"10","005","00","003","0323","0182","362","173","189","23","385","743","0","51.82","23.28"
"10","005","00","003","0324","0000","1016","465","551","49","1065","2048","0","52.0","22.71"
"10","005","00","003","0324","0154","579","261","318","32","611","1040","0","58.75","25.1"
"10","005","00","003","0324","0155","437","204","233","17","454","1008","0","45.04","20.24"
"10","005","00","004","0000","0000","36858","15174","21684","1759","38617","68528","86056","56.35","22.14"
"10","005","00","004","0401","0000","1085","455","630","54","1139","1912","0","59.57","23.8"
"10","005","00","004","0401","0270","622","285","337","28","650","1086","0","59.85","26.24"
"10","005","00","004","0401","0271","463","170","293","26","489","826","0","59.2","20.58"
"10","005","00","004","0402","0000","1838","799","1039","79","1917","3302","0","58.06","24.2"
"10","005","00","004","0402","0272","538","245","293","23","561","1051","0","53.38","23.31"
"10","005","00","004","0402","0273","715","268","447","21","736","1235","0","59.6","21.7"
"10","005","00","004","0402","0274","585","286","299","35","620","1016","0","61.02","28.15"
"10","005","00","004","0403","0000","1373","626","747","73","1446","2773","0","52.15","22.57"
"10","005","00","004","0403","0275","754","344","410","46","800","1472","0","54.35","23.37"
"10","005","00","004","0403","0276","619","282","337","27","646","1301","0","49.65","21.68"
"10","005","00","004","0404","0000","2324","954","1370","72","2396","4519","0","53.02","21.11"
"10","005","00","004","0404","0277","761","314","447","25","786","1544","0","50.91","20.34"
"10","005","00","004","0404","0278","808","321","487","22","830","1512","0","54.89","21.23"
"10","005","00","004","0404","0279","755","319","436","25","780","1463","0","53.32","21.8"
"10","005","00","004","0405","0000","2953","1134","1819","105","3058","5258","0","58.16","21.57"
"10","005","00","004","0405","0280","550","236","314","23","573","1073","0","53.4","21.99"
"10","005","00","004","0405","0281","811","302","509","28","839","1453","0","57.74","20.78"
"10","005","00","004","0405","0282","731","290","441","26","757","1245","0","60.8","23.29"
"10","005","00","004","0405","0283","861","306","555","28","889","1487","0","59.78","20.58"
"10","005","00","004","0406","0000","1882","741","1141","81","1963","3445","0","56.98","21.51"
"10","005","00","004","0406","0284","572","178","394","30","602","1018","0","59.14","17.49"
"10","005","00","004","0406","0285","634","267","367","25","659","1105","0","59.64","24.16"
"10","005","00","004","0406","0286","676","296","380","26","702","1322","0","53.1","22.39"
"10","005","00","004","0407","0000","1940","748","1192","96","2036","3343","0","60.9","22.38"
"10","005","00","004","0407","0287","635","244","391","25","660","1140","0","57.89","21.4"
"10","005","00","004","0407","0288","625","223","402","30","655","1067","0","61.39","20.9"
"10","005","00","004","0407","0289","680","281","399","41","721","1136","0","63.47","24.74"
"10","005","00","004","0408","0000","1615","725","890","111","1726","3237","0","53.32","22.4"
"10","005","00","004","0408","0290","620","250","370","35","655","1253","0","52.27","19.95"
"10","005","00","004","0408","0291","475","220","255","39","514","963","0","53.37","22.85"
"10","005","00","004","0408","0292","520","255","265","37","557","1021","0","54.55","24.98"
"10","005","00","004","0409","0000","1169","471","698","71","1240","2111","0","58.74","22.31"
"10","005","00","004","0409","0297","525","229","296","36","561","989","0","56.72","23.15"
"10","005","00","004","0409","0298","644","242","402","35","679","1122","0","60.52","21.57"
"10","005","00","004","0410","0000","2306","889","1417","100","2406","4607","0","52.22","19.3"
"10","005","00","004","0410","0299","491","198","293","32","523","1111","0","47.07","17.82"
"10","005","00","004","0410","0300","587","231","356","31","618","1036","0","59.65","22.3"
"10","005","00","004","0410","0301","540","191","349","20","560","1112","0","50.36","17.18"
"10","005","00","004","0410","0302","688","269","419","17","705","1348","0","52.3","19.96"
"10","005","00","004","0411","0000","618","253","365","40","658","1059","0","62.13","23.89"
"10","005","00","004","0411","0306","618","253","365","40","658","1059","0","62.13","23.89"
"10","005","00","004","0412","0000","1595","706","889","88","1683","2834","0","59.39","24.91"
"10","005","00","004","0412","0307","492","229","263","29","521","869","0","59.95","26.35"
"10","005","00","004","0412","0308","423","179","244","29","452","800","0","56.5","22.38"
"10","005","00","004","0412","0309","680","298","382","30","710","1165","0","60.94","25.58"
"10","005","00","004","0413","0000","802","347","455","45","847","1468","0","57.7","23.64"
"10","005","00","004","0413","0310","435","192","243","28","463","791","0","58.53","24.27"
"10","005","00","004","0413","0311","367","155","212","17","384","677","0","56.72","22.9"
"10","005","00","004","0414","0000","1121","464","657","57","1178","1988","0","59.26","23.34"
"10","005","00","004","0414","0312","481","212","269","38","519","797","0","65.12","26.6"
"10","005","00","004","0414","0313","640","252","388","19","659","1191","0","55.33","21.16"
"10","005","00","004","0415","0000","523","222","301","17","540","1027","0","52.58","21.62"
"10","005","00","004","0415","0314","523","222","301","17","540","1027","0","52.58","21.62"
"10","005","00","004","0416","0000","2072","842","1230","110","2182","3935","0","55.45","21.4"
"10","005","00","004","0416","0315","750","298","452","44","794","1341","0","59.21","22.22"
"10","005","00","004","0416","0316","666","277","389","37","703","1378","0","51.02","20.1"
"10","005","00","004","0416","0317","656","267","389","29","685","1216","0","56.33","21.96"
"10","005","00","004","0417","0000","1125","476","649","49","1174","2108","0","55.69","22.58"
"10","005","00","004","0417","0318","813","322","491","26","839","1570","0","53.44","20.51"
"10","005","00","004","0417","0319","312","154","158","23","335","538","0","62.27","28.62"
"10","005","00","004","0418","0000","535","191","344","22","557","1166","0","47.77","16.38"
"10","005","00","004","0418","0320","535","191","344","22","557","1166","0","47.77","16.38"
"10","005","00","004","0419","0000","2095","792","1303","101","2196","4119","0","53.31","19.23"
"10","005","00","004","0419","0321","768","214","554","23","791","1488","0","53.16","14.38"
"10","005","00","004","0419","0322","704","302","402","36","740","1449","0","51.07","20.84"
"10","005","00","004","0419","0323","623","276","347","42","665","1182","0","56.26","23.35"
"10","005","00","004","0420","0000","1164","534","630","80","1244","2158","0","57.65","24.75"
"10","005","00","004","0420","0324","621","283","338","50","671","1175","0","57.11","24.09"
"10","005","00","004","0420","0325","543","251","292","30","573","983","0","58.29","25.53"
"10","005","00","004","0421","0000","2009","887","1122","104","2113","3715","0","56.88","23.88"
"10","005","00","004","0421","0326","293","112","181","16","309","492","0","62.8","22.76"
"10","005","00","004","0421","0327","591","255","336","32","623","1074","0","58.01","23.74"
"10","005","00","004","0421","0328","450","246","204","29","479","852","0","56.22","28.87"
"10","005","00","004","0421","0329","675","274","401","27","702","1297","0","54.12","21.13"
"10","005","00","004","0422","0000","525","221","304","34","559","1028","0","54.38","21.5"
"10","005","00","004","0422","0330","525","221","304","34","559","1028","0","54.38","21.5"
"10","005","00","004","0423","0000","1742","736","1006","83","1825","3111","0","58.66","23.66"
"10","005","00","004","0423","0303","641","321","320","11","652","1114","0","58.53","28.82"
"10","005","00","004","0423","0304","633","252","381","41","674","1119","0","60.23","22.52"
"10","005","00","004","0423","0305","468","163","305","31","499","878","0","56.83","18.56"
"10","005","00","004","0424","0000","1208","451","757","32","1240","2109","0","58.8","21.38"
"10","005","00","004","0424","0295","721","265","456","25","746","1293","0","57.7","20.49"
"10","005","00","004","0424","0296","487","186","301","7","494","816","0","60.54","22.79"
"10","005","00","004","0425","0000","1239","510","729","55","1294","2196","0","58.93","23.22"
"10","005","00","004","0425","0293","663","259","404","30","693","1154","0","60.05","22.44"
"10","005","00","004","0425","0294","576","251","325","25","601","1042","0","57.68","24.09"
"10","005","00","005","0000","0000","45357","16346","29011","2129","47486","83617","103007","56.79","19.55"
"10","005","00","005","0501","0000","1169","448","721","65","1234","2207","0","55.91","20.3"
"10","005","00","005","0501","0331","467","195","272","30","497","915","0","54.32","21.31"
"10","005","00","005","0501","0332","702","253","449","35","737","1292","0","57.04","19.58"
"10","005","00","005","0502","0000","949","344","605","38","987","1763","0","55.98","19.51"
"10","005","00","005","0502","0333","527","192","335","26","553","928","0","59.59","20.69"
"10","005","00","005","0502","0334","422","152","270","12","434","835","0","51.98","18.2"
"10","005","00","005","0503","0000","1501","583","918","81","1582","2988","0","52.95","19.51"
"10","005","00","005","0503","0335","559","218","341","28","587","1070","0","54.86","20.37"
"10","005","00","005","0503","0336","437","153","284","21","458","879","0","52.1","17.41"
"10","005","00","005","0503","0337","505","212","293","32","537","1039","0","51.68","20.4"
"10","005","00","005","0504","0000","1913","666","1247","113","2026","3716","0","54.52","17.92"
"10","005","00","005","0504","0338","618","230","388","41","659","1129","0","58.37","20.37"
"10","005","00","005","0504","0339","554","215","339","20","574","1041","0","55.14","20.65"
"10","005","00","005","0504","0340","741","221","520","52","793","1546","0","51.29","14.29"
"10","005","00","005","0505","0000","2283","813","1470","99","2382","4361","0","54.62","18.64"
"10","005","00","005","0505","0341","556","199","357","30","586","935","0","62.67","21.28"
"10","005","00","005","0505","0342","587","221","366","30","617","1180","0","52.29","18.73"
"10","005","00","005","0505","0343","744","239","505","27","771","1499","0","51.43","15.94"
"10","005","00","005","0505","0344","396","154","242","12","408","747","0","54.62","20.62"
"10","005","00","005","0506","0000","1365","451","914","76","1441","2599","0","55.44","17.35"
"10","005","00","005","0506","0345","740","236","504","28","768","1406","0","54.62","16.79"
"10","005","00","005","0506","0346","625","215","410","48","673","1193","0","56.41","18.02"
"10","005","00","005","0507","0000","526","212","314","32","558","948","0","58.86","22.36"
"10","005","00","005","0507","0347","526","212","314","32","558","948","0","58.86","22.36"
"10","005","00","005","0508","0000","1776","619","1157","71","1847","3297","0","56.02","18.77"
"10","005","00","005","0508","0348","442","144","298","26","468","869","0","53.86","16.57"
"10","005","00","005","0508","0349","639","212","427","27","666","1142","0","58.32","18.56"
"10","005","00","005","0508","0350","695","263","432","18","713","1286","0","55.44","20.45"
"10","005","00","005","0509","0000","1790","584","1206","85","1875","3105","0","60.39","18.81"
"10","005","00","005","0509","0351","511","172","339","29","540","903","0","59.8","19.05"
"10","005","00","005","0509","0352","703","218","485","35","738","1186","0","62.23","18.38"
"10","005","00","005","0509","0353","576","194","382","21","597","1016","0","58.76","19.09"
"10","005","00","005","0510","0000","891","346","545","38","929","1536","0","60.48","22.53"
"10","005","00","005","0510","0357","506","187","319","14","520","890","0","58.43","21.01"
"10","005","00","005","0510","0358","385","159","226","24","409","646","0","63.31","24.61"
"10","005","00","005","0511","0000","444","160","284","20","464","947","0","49.0","16.9"
"10","005","00","005","0511","0356","444","160","284","20","464","947","0","49.0","16.9"
"10","005","00","005","0512","0000","624","222","402","47","671","1030","0","65.15","21.55"
"10","005","00","005","0512","0363","624","222","402","47","671","1030","0","65.15","21.55"
"10","005","00","005","0513","0000","1037","365","672","32","1069","1968","0","54.32","18.55"
"10","005","00","005","0513","0384","565","202","363","19","584","1121","0","52.1","18.02"
"10","005","00","005","0513","0385","472","163","309","13","485","847","0","57.26","19.24"
"10","005","00","005","0514","0000","1761","596","1165","66","1827","3454","0","52.9","17.26"
"10","005","00","005","0514","0388","805","260","545","32","837","1655","0","50.57","15.71"
"10","005","00","005","0514","0389","956","336","620","34","990","1799","0","55.03","18.68"
"10","005","00","005","0515","0000","2254","820","1434","76","2330","3884","0","59.99","21.11"
"10","005","00","005","0515","0367","771","252","519","26","797","1326","0","60.11","19.0"
"10","005","00","005","0515","0368","775","267","508","28","803","1270","0","63.23","21.02"
"10","005","00","005","0515","0369","708","301","407","22","730","1288","0","56.68","23.37"
"10","005","00","005","0516","0000","2098","711","1387","71","2169","3830","0","56.63","18.56"
"10","005","00","005","0516","0364","741","247","494","35","776","1338","0","58.0","18.46"
"10","005","00","005","0516","0365","766","265","501","17","783","1450","0","54.0","18.28"
"10","005","00","005","0516","0366","591","199","392","19","610","1042","0","58.54","19.1"
"10","005","00","005","0517","0000","1654","573","1081","59","1713","3125","0","54.82","18.34"
"10","005","00","005","0517","0376","877","313","564","25","902","1551","0","58.16","20.18"
"10","005","00","005","0517","0377","777","260","517","34","811","1574","0","51.52","16.52"
"10","005","00","005","0518","0000","2040","749","1291","76","2116","3984","0","53.11","18.8"
"10","005","00","005","0518","0390","638","218","420","25","663","1141","0","58.11","19.11"
"10","005","00","005","0518","0391","752","283","469","31","783","1431","0","54.72","19.78"
"10","005","00","005","0518","0392","650","248","402","20","670","1412","0","47.45","17.56"
"10","005","00","005","0519","0000","763","325","438","49","812","1344","0","60.42","24.18"
"10","005","00","005","0519","0395","763","325","438","49","812","1344","0","60.42","24.18"
"10","005","00","005","0520","0000","922","339","583","60","982","1990","0","49.35","17.04"
"10","005","00","005","0520","0359","539","185","354","43","582","975","0","59.69","18.97"
"10","005","00","005","0520","0360","383","154","229","17","400","1015","0","39.41","15.17"
"10","005","00","005","0521","0000","1450","551","899","104","1554","2542","0","61.13","21.68"
"10","005","00","005","0521","0361","817","314","503","48","865","1399","0","61.83","22.44"
"10","005","00","005","0521","0362","633","237","396","56","689","1143","0","60.28","20.73"
"10","005","00","005","0522","0000","808","288","520","35","843","1363","0","61.85","21.13"
"10","005","00","005","0522","0396","808","288","520","35","843","1363","0","61.85","21.13"
"10","005","00","005","0523","0000","1420","488","932","85","1505","2595","0","58.0","18.81"
"10","005","00","005","0523","0398","671","240","431","47","718","1182","0","60.74","20.3"
"10","005","00","005","0523","0399","749","248","501","38","787","1413","0","55.7","17.55"
"10","005","00","005","0524","0000","546","171","375","32","578","898","0","64.37","19.04"
"10","005","00","005","0524","0397","546","171","375","32","578","898","0","64.37","19.04"
"10","005","00","005","0525","0000","1237","447","790","76","1313","2171","0","60.48","20.59"
"10","005","00","005","0525","0400","585","216","369","32","617","991","0","62.26","21.8"
"10","005","00","005","0525","0401","652","231","421","44","696","1180","0","58.98","19.58"
"10","005","00","005","0526","0000","1121","420","701","49","1170","2048","0","57.13","20.51"
"10","005","00","005","0526","0386","574","220","354","26","600","993","0","60.42","22.16"
"10","005","00","005","0526","0387","547","200","347","23","570","1055","0","54.03","18.96"
"10","005","00","005","0527","0000","1242","464","778","65","1307","2319","0","56.36","20.01"
"10","005","00","005","0527","0393","531","202","329","34","565","1074","0","52.61","18.81"
"10","005","00","005","0527","0394","711","262","449","31","742","1245","0","59.6","21.04"
"10","005","00","005","0528","0000","2008","713","1295","109","2117","3507","0","60.36","20.33"
"10","005","00","005","0528","0378","688","263","425","43","731","1262","0","57.92","20.84"
"10","005","00","005","0528","0379","654","219","435","36","690","1171","0","58.92","18.7"
"10","005","00","005","0528","0380","666","231","435","30","696","1074","0","64.8","21.51"
"10","005","00","005","0529","0000","1993","709","1284","86","2079","3586","0","57.98","19.77"
"10","005","00","005","0529","0381","662","246","416","31","693","1141","0","60.74","21.56"
"10","005","00","005","0529","0382","707","264","443","25","732","1259","0","58.14","20.97"
"10","005","00","005","0529","0383","624","199","425","30","654","1186","0","55.14","16.78"
"10","005","00","005","0530","0000","1074","394","680","54","1128","2022","0","55.79","19.49"
"10","005","00","005","0530","0354","535","205","330","27","562","985","0","57.06","20.81"
"10","005","00","005","0530","0355","539","189","350","27","566","1037","0","54.58","18.23"
"10","005","00","005","0531","0000","1434","614","820","59","1493","2523","0","59.18","24.34"
"10","005","00","005","0531","0370","701","355","346","37","738","1243","0","59.37","28.56"
"10","005","00","005","0531","0371","733","259","474","22","755","1280","0","58.98","20.23"
"10","005","00","005","0532","0000","1792","651","1141","71","1863","3377","0","55.17","19.28"
"10","005","00","005","0532","0372","872","321","551","40","912","1618","0","56.37","19.84"
"10","005","00","005","0532","0373","920","330","590","31","951","1759","0","54.06","18.76"
"10","005","00","005","0533","0000","1472","510","962","50","1522","2590","0","58.76","19.69"
"10","005","00","005","0533","0374","719","217","502","35","754","1264","0","59.65","17.17"
"10","005","00","005","0533","0375","753","293","460","15","768","1326","0","57.92","22.1"
"10","005","00","006","0000","0000","16081","7316","8765","1096","17177","30948","36332","55.5","23.64"
"10","005","00","006","0601","0000","849","404","445","58","907","1473","0","61.58","27.43"
"10","005","00","006","0601","0223","325","141","184","23","348","590","0","58.98","23.9"
"10","005","00","006","0601","0224","524","263","261","35","559","883","0","63.31","29.78"
"10","005","00","006","0602","0000","478","230","248","27","505","793","0","63.68","29.0"
"10","005","00","006","0602","0225","478","230","248","27","505","793","0","63.68","29.0"
"10","005","00","006","0603","0000","765","377","388","45","810","1324","0","61.18","28.47"
"10","005","00","006","0603","0226","427","206","221","15","442","732","0","60.38","28.14"
"10","005","00","006","0603","0227","338","171","167","30","368","592","0","62.16","28.89"
"10","005","00","006","0604","0000","2300","1005","1295","132","2432","4218","0","57.66","23.83"
"10","005","00","006","0604","0228","632","265","367","32","664","1113","0","59.66","23.81"
"10","005","00","006","0604","0229","644","286","358","33","677","1195","0","56.65","23.93"
"10","005","00","006","0604","0230","576","243","333","42","618","997","0","61.99","24.37"
"10","005","00","006","0604","0231","448","211","237","25","473","913","0","51.81","23.11"
"10","005","00","006","0605","0000","1200","535","665","76","1276","2304","0","55.38","23.22"
"10","005","00","006","0605","0246","594","260","334","32","626","1107","0","56.55","23.49"
"10","005","00","006","0605","0247","606","275","331","44","650","1197","0","54.3","22.97"
"10","005","00","006","0606","0000","797","302","495","54","851","1216","0","69.98","24.84"
"10","005","00","006","0606","0236","797","302","495","54","851","1216","0","69.98","24.84"
"10","005","00","006","0607","0000","506","223","283","27","533","977","0","54.55","22.82"
"10","005","00","006","0607","0237","506","223","283","27","533","977","0","54.55","22.82"
"10","005","00","006","0608","0000","1374","629","745","103","1477","2704","0","54.62","23.26"
"10","005","00","006","0608","0238","442","203","239","35","477","943","0","50.58","21.53"
"10","005","00","006","0608","0239","486","226","260","40","526","910","0","57.8","24.84"
"10","005","00","006","0608","0240","446","200","246","28","474","851","0","55.7","23.5"
"10","005","00","006","0609","0000","794","354","440","54","848","1375","0","61.67","25.75"
"10","005","00","006","0609","0241","439","206","233","20","459","725","0","63.31","28.41"
"10","005","00","006","0609","0242","355","148","207","34","389","650","0","59.85","22.77"
"10","005","00","006","0610","0000","344","173","171","24","368","706","0","52.12","24.5"
"10","005","00","006","0610","0243","344","173","171","24","368","706","0","52.12","24.5"
"10","005","00","006","0611","0000","734","336","398","57","791","1489","0","53.12","22.57"
"10","005","00","006","0611","0232","314","145","169","25","339","641","0","52.89","22.62"
"10","005","00","006","0611","0233","420","191","229","32","452","848","0","53.3","22.52"
"10","005","00","006","0612","0000","741","348","393","72","813","1549","0","52.49","22.47"
"10","005","00","006","0612","0244","400","178","222","37","437","748","0","58.42","23.8"
"10","005","00","006","0612","0245","341","170","171","35","376","801","0","46.94","21.22"
"10","005","00","006","0613","0000","649","290","359","52","701","1264","0","55.46","22.94"
"10","005","00","006","0613","0234","649","290","359","52","701","1264","0","55.46","22.94"
"10","005","00","006","0614","0000","468","226","242","38","506","965","0","52.44","23.42"
"10","005","00","006","0614","0235","468","226","242","38","506","965","0","52.44","23.42"
"10","005","00","006","0615","0000","498","192","306","32","530","1036","0","51.16","18.53"
"10","005","00","006","0615","0248","498","192","306","32","530","1036","0","51.16","18.53"
"10","005","00","006","0616","0000","408","192","216","28","436","913","0","47.75","21.03"
"10","005","00","006","0616","0249","408","192","216","28","436","913","0","47.75","21.03"
"10","005","00","006","0617","0000","409","209","200","31","440","719","0","61.2","29.07"
"10","005","00","006","0617","0250","409","209","200","31","440","719","0","61.2","29.07"
"10","005","00","006","0618","0000","549","260","289","50","599","1037","0","57.76","25.07"
"10","005","00","006","0618","0251","549","260","289","50","599","1037","0","57.76","25.07"
"10","005","00","006","0619","0000","295","145","150","14","309","601","0","51.41","24.13"
"10","005","00","006","0619","0252","295","145","150","14","309","601","0","51.41","24.13"
"10","005","00","006","0620","0000","554","266","288","32","586","1269","0","46.18","20.96"
"10","005","00","006","0620","0253","554","266","288","32","586","1269","0","46.18","20.96"
"10","005","00","006","0621","0000","354","161","193","25","379","735","0","51.56","21.9"
"10","005","00","006","0621","0254","354","161","193","25","379","735","0","51.56","21.9"
"10","005","00","006","0622","0000","472","214","258","34","506","1047","0","48.33","20.44"
"10","005","00","006","0622","0255","138","67","71","13","151","422","0","35.78","15.88"
"10","005","00","006","0622","0256","334","147","187","21","355","625","0","56.8","23.52"
"10","005","00","006","0623","0000","543","245","298","31","574","1234","0","46.52","19.85"
"10","005","00","006","0623","0257","543","245","298","31","574","1234","0","46.52","19.85"
"10","005","00","007","0000","0000","8423","3658","4765","383","8806","14772","16818","59.61","24.76"
"10","005","00","007","0701","0000","456","187","269","16","472","745","0","63.36","25.1"
"10","005","00","007","0701","0445","456","187","269","16","472","745","0","63.36","25.1"
"10","005","00","007","0702","0000","795","327","468","26","821","1528","0","53.73","21.4"
"10","005","00","007","0702","0446","425","176","249","9","434","783","0","55.43","22.48"
"10","005","00","007","0702","0447","370","151","219","17","387","745","0","51.95","20.27"
"10","005","00","007","0703","0000","1247","536","711","66","1313","2079","0","63.16","25.78"
"10","005","00","007","0703","0451","513","204","309","28","541","865","0","62.54","23.58"
"10","005","00","007","0703","0452","501","230","271","25","526","828","0","63.53","27.78"
"10","005","00","007","0703","0453","233","102","131","13","246","386","0","63.73","26.42"
"10","005","00","007","0704","0000","526","244","282","15","541","999","0","54.15","24.42"
"10","005","00","007","0704","0448","526","244","282","15","541","999","0","54.15","24.42"
"10","005","00","007","0705","0000","443","180","263","27","470","757","0","62.09","23.78"
"10","005","00","007","0705","0449","393","167","226","27","420","671","0","62.59","24.89"
"10","005","00","007","0705","0459","50","13","37","0","50","86","0","58.14","15.12"
"10","005","00","007","0706","0000","517","202","315","10","527","940","0","56.06","21.49"
"10","005","00","007","0706","0460","517","202","315","10","527","940","0","56.06","21.49"
"10","005","00","007","0707","0000","1125","488","637","55","1180","1978","0","59.66","24.67"
"10","005","00","007","0707","0442","569","233","336","28","597","961","0","62.12","24.25"
"10","005","00","007","0707","0443","556","255","301","27","583","1017","0","57.33","25.07"
"10","005","00","007","0708","0000","668","304","364","38","706","1095","0","64.47","27.76"
"10","005","00","007","0708","0444","668","304","364","38","706","1095","0","64.47","27.76"
"10","005","00","007","0709","0000","1309","593","716","64","1373","2209","0","62.15","26.84"
"10","005","00","007","0709","0454","414","189","225","30","444","688","0","64.53","27.47"
"10","005","00","007","0709","0455","479","233","246","15","494","792","0","62.37","29.42"
"10","005","00","007","0709","0456","416","171","245","19","435","729","0","59.67","23.46"
"10","005","00","007","0710","0000","460","207","253","33","493","734","0","67.17","28.2"
"10","005","00","007","0710","0450","460","207","253","33","493","734","0","67.17","28.2"
"10","005","00","007","0711","0000","877","390","487","33","910","1708","0","53.28","22.83"
"10","005","00","007","0711","0457","521","249","272","24","545","1093","0","49.86","22.78"
"10","005","00","007","0711","0458","356","141","215","9","365","615","0","59.35","22.93"
"10","005","00","008","0000","0000","6384","2284","4100","402","6786","12653","14521","53.63","18.05"
"10","005","00","008","0801","0000","841","271","570","54","895","1625","0","55.08","16.68"
"10","005","00","008","0801","0420","380","115","265","28","408","744","0","54.84","15.46"
"10","005","00","008","0801","0421","461","156","305","26","487","881","0","55.28","17.71"
"10","005","00","008","0802","0000","309","108","201","29","338","596","0","56.71","18.12"
"10","005","00","008","0802","0422","309","108","201","29","338","596","0","56.71","18.12"
"10","005","00","008","0803","0000","919","268","651","55","974","1790","0","54.41","14.97"
"10","005","00","008","0803","0424","431","130","301","28","459","867","0","52.94","14.99"
"10","005","00","008","0803","0425","488","138","350","27","515","923","0","55.8","14.95"
"10","005","00","008","0804","0000","691","272","419","45","736","1395","0","52.76","19.5"
"10","005","00","008","0804","0426","691","272","419","45","736","1395","0","52.76","19.5"
"10","005","00","008","0805","0000","198","80","118","13","211","561","0","37.61","14.26"
"10","005","00","008","0805","0427","198","80","118","13","211","561","0","37.61","14.26"
"10","005","00","008","0806","0000","601","202","399","52","653","1260","0","51.83","16.03"
"10","005","00","008","0806","0423","601","202","399","52","653","1260","0","51.83","16.03"
"10","005","00","008","0807","0000","360","133","227","15","375","638","0","58.78","20.85"
"10","005","00","008","0807","0428","360","133","227","15","375","638","0","58.78","20.85"
"10","005","00","008","0808","0000","740","289","451","40","780","1495","0","52.17","19.33"
"10","005","00","008","0808","0431","342","131","211","20","362","652","0","55.52","20.09"
"10","005","00","008","0808","0432","398","158","240","20","418","843","0","49.58","18.74"
"10","005","00","008","0809","0000","388","164","224","24","412","754","0","54.64","21.75"
"10","005","00","008","0809","0429","388","164","224","24","412","754","0","54.64","21.75"
"10","005","00","008","0810","0000","244","84","160","7","251","501","0","50.1","16.77"
"10","005","00","008","0810","0430","244","84","160","7","251","501","0","50.1","16.77"
"10","005","00","008","0811","0000","550","206","344","32","582","1020","0","57.06","20.2"
"10","005","00","008","0811","0433","550","206","344","32","582","1020","0","57.06","20.2"
"10","005","00","008","0812","0000","543","207","336","36","579","1018","0","56.88","20.33"
"10","005","00","008","0812","0434","543","207","336","36","579","1018","0","56.88","20.33"
"10","005","00","009","0000","0000","15678","5861","9817","994","16672","28318","33327","58.87","20.7"
"10","005","00","009","0901","0000","999","398","601","50","1049","1581","0","66.35","25.17"
"10","005","00","009","0901","0068","499","202","297","25","524","789","0","66.41","25.6"
"10","005","00","009","0901","0069","500","196","304","25","525","792","0","66.29","24.75"
"10","005","00","009","0902","0000","1431","513","918","78","1509","2372","0","63.62","21.63"
"10","005","00","009","0902","0070","672","235","437","49","721","1117","0","64.55","21.04"
"10","005","00","009","0902","0071","759","278","481","29","788","1255","0","62.79","22.15"
"10","005","00","009","0903","0000","1968","780","1188","99","2067","3413","0","60.56","22.85"
"10","005","00","009","0903","0072","653","251","402","30","683","1141","0","59.86","22.0"
"10","005","00","009","0903","0073","648","261","387","39","687","1172","0","58.62","22.27"
"10","005","00","009","0903","0074","667","268","399","30","697","1100","0","63.36","24.36"
"10","005","00","009","0904","0000","510","202","308","45","555","964","0","57.57","20.95"
"10","005","00","009","0904","0079","510","202","308","45","555","964","0","57.57","20.95"
"10","005","00","009","0905","0000","1075","428","647","72","1147","2313","0","49.59","18.5"
"10","005","00","009","0905","0075","616","212","404","37","653","1232","0","53.0","17.21"
"10","005","00","009","0905","0076","459","216","243","35","494","1081","0","45.7","19.98"
"10","005","00","009","0906","0000","1338","477","861","72","1410","2331","0","60.49","20.46"
"10","005","00","009","0906","0077","746","256","490","33","779","1250","0","62.32","20.48"
"10","005","00","009","0906","0078","592","221","371","39","631","1081","0","58.37","20.44"
"10","005","00","009","0907","0000","809","302","507","61","870","1507","0","57.73","20.04"
"10","005","00","009","0907","0084","405","145","260","27","432","719","0","60.08","20.17"
"10","005","00","009","0907","0085","404","157","247","34","438","788","0","55.58","19.92"
"10","005","00","009","0908","0000","580","209","371","50","630","1038","0","60.69","20.13"
"10","005","00","009","0908","0080","580","209","371","50","630","1038","0","60.69","20.13"
"10","005","00","009","0909","0000","1080","407","673","70","1150","2031","0","56.62","20.04"
"10","005","00","009","0909","0082","462","164","298","35","497","865","0","57.46","18.96"
"10","005","00","009","0909","0083","618","243","375","35","653","1166","0","56.0","20.84"
"10","005","00","009","0910","0000","180","58","122","23","203","303","0","67.0","19.14"
"10","005","00","009","0910","0086","180","58","122","23","203","303","0","67.0","19.14"
"10","005","00","009","0911","0000","211","94","117","17","228","360","0","63.33","26.11"
"10","005","00","009","0911","0081","211","94","117","17","228","360","0","63.33","26.11"
"10","005","00","009","0912","0000","1260","495","765","70","1330","2255","0","58.98","21.95"
"10","005","00","009","0912","0087","760","297","463","36","796","1322","0","60.21","22.47"
"10","005","00","009","0912","0088","500","198","302","34","534","933","0","57.23","21.22"
"10","005","00","009","0913","0000","737","274","463","53","790","1455","0","54.3","18.83"
"10","005","00","009","0913","0089","737","274","463","53","790","1455","0","54.3","18.83"
"10","005","00","009","0914","0000","948","349","599","54","1002","1615","0","62.04","21.61"
"10","005","00","009","0914","0090","948","349","599","54","1002","1615","0","62.04","21.61"
"10","005","00","009","0915","0000","760","266","494","47","807","1451","0","55.62","18.33"
"10","005","00","009","0915","0091","760","266","494","47","807","1451","0","55.62","18.33"
"10","005","00","009","0916","0000","681","231","450","56","737","1317","0","55.96","17.54"
"10","005","00","009","0916","0093","681","231","450","56","737","1317","0","55.96","17.54"
"10","005","00","009","0917","0000","819","276","543","63","882","1462","0","60.33","18.88"
"10","005","00","009","0917","0092","819","276","543","63","882","1462","0","60.33","18.88"
"10","005","00","009","0918","0000","128","45","83","3","131","221","0","59.28","20.36"
"10","005","00","009","0918","0094","128","45","83","3","131","221","0","59.28","20.36"
"10","005","00","009","0919","0000","164","57","107","11","175","329","0","53.19","17.33"
"10","005","00","009","0919","0095","164","57","107","11","175","329","0","53.19","17.33"
"10","005","00","010","0000","0000","8198","2919","5279","467","8665","15424","17922","56.18","18.93"
"10","005","00","010","1001","0000","562","143","419","35","597","1029","0","58.02","13.9"
"10","005","00","010","1001","0114","562","143","419","35","597","1029","0","58.02","13.9"
"10","005","00","010","1002","0000","2571","920","1651","111","2682","4463","0","60.09","20.61"
"10","005","00","010","1002","0108","521","156","365","27","548","887","0","61.78","17.59"
"10","005","00","010","1002","0109","607","187","420","25","632","1052","0","60.08","17.78"
"10","005","00","010","1002","0110","799","240","559","29","828","1347","0","61.47","17.82"
"10","005","00","010","1002","0111","644","337","307","30","674","1177","0","57.26","28.63"
"10","005","00","010","1003","0000","939","310","629","53","992","1655","0","59.94","18.73"
"10","005","00","010","1003","0115","500","150","350","25","525","905","0","58.01","16.57"
"10","005","00","010","1003","0116","439","160","279","28","467","750","0","62.27","21.33"
"10","005","00","010","1004","0000","651","248","403","37","688","1268","0","54.26","19.56"
"10","005","00","010","1004","0112","651","248","403","37","688","1268","0","54.26","19.56"
"10","005","00","010","1005","0000","539","185","354","48","587","1185","0","49.54","15.61"
"10","005","00","010","1005","0113","539","185","354","48","587","1185","0","49.54","15.61"
"10","005","00","010","1006","0000","523","172","351","30","553","1080","0","51.2","15.93"
"10","005","00","010","1006","0117","523","172","351","30","553","1080","0","51.2","15.93"
"10","005","00","010","1007","0000","1610","660","950","100","1710","3186","0","53.67","20.72"
"10","005","00","010","1007","0118","574","251","323","33","607","1108","0","54.78","22.65"
"10","005","00","010","1007","0119","431","185","246","26","457","862","0","53.02","21.46"
"10","005","00","010","1007","0120","605","224","381","41","646","1216","0","53.13","18.42"
"10","005","00","010","1008","0000","282","100","182","22","304","588","0","51.7","17.01"
"10","005","00","010","1008","0121","282","100","182","22","304","588","0","51.7","17.01"
"10","005","00","010","1009","0000","213","81","132","22","235","429","0","54.78","18.88"
"10","005","00","010","1009","0122","213","81","132","22","235","429","0","54.78","18.88"
"10","005","00","010","1010","0000","308","100","208","9","317","541","0","58.6","18.48"
"10","005","00","010","1010","0123","308","100","208","9","317","541","0","58.6","18.48"
"10","005","00","011","0000","0000","4046","1507","2539","305","4351","8784","10130","49.53","17.16"
"10","005","00","011","1101","0000","586","217","369","55","641","1155","0","55.5","18.79"
"10","005","00","011","1101","0411","586","217","369","55","641","1155","0","55.5","18.79"
"10","005","00","011","1102","0000","337","117","220","39","376","650","0","57.85","18.0"
"10","005","00","011","1102","0412","337","117","220","39","376","650","0","57.85","18.0"
"10","005","00","011","1103","0000","647","250","397","53","700","1353","0","51.74","18.48"
"10","005","00","011","1103","0413","647","250","397","53","700","1353","0","51.74","18.48"
"10","005","00","011","1104","0000","330","126","204","25","355","813","0","43.67","15.5"
"10","005","00","011","1104","0414","330","126","204","25","355","813","0","43.67","15.5"
"10","005","00","011","1105","0000","335","137","198","29","364","837","0","43.49","16.37"
"10","005","00","011","1105","0415","335","137","198","29","364","837","0","43.49","16.37"
"10","005","00","011","1106","0000","528","157","371","45","573","1093","0","52.42","14.36"
"10","005","00","011","1106","0416","528","157","371","45","573","1093","0","52.42","14.36"
"10","005","00","011","1107","0000","544","231","313","29","573","1048","0","54.68","22.04"
"10","005","00","011","1107","0417","544","231","313","29","573","1048","0","54.68","22.04"
"10","005","00","011","1108","0000","426","169","257","22","448","872","0","51.38","19.38"
"10","005","00","011","1108","0418","426","169","257","22","448","872","0","51.38","19.38"
"10","005","00","011","1109","0000","313","103","210","8","321","963","0","33.33","10.7"
"10","005","00","011","1109","0419","313","103","210","8","321","963","0","33.33","10.7"
"10","005","00","012","0000","0000","5841","2284","3557","288","6129","9390","10711","65.27","24.32"
"10","005","00","012","1201","0000","1649","822","827","75","1724","2503","0","68.88","32.84"
"10","005","00","012","1201","0096","851","549","302","43","894","1335","0","66.97","41.12"
"10","005","00","012","1201","0097","798","273","525","32","830","1168","0","71.06","23.37"
"10","005","00","012","1202","0000","1086","425","661","39","1125","1851","0","60.78","22.96"
"10","005","00","012","1202","0103","488","208","280","17","505","844","0","59.83","24.64"
"10","005","00","012","1202","0104","598","217","381","22","620","1007","0","61.57","21.55"
"10","005","00","012","1203","0000","441","129","312","21","462","725","0","63.72","17.79"
"10","005","00","012","1203","0100","441","129","312","21","462","725","0","63.72","17.79"
"10","005","00","012","1204","0000","1117","388","729","61","1178","1710","0","68.89","22.69"
"10","005","00","012","1204","0098","495","166","329","25","520","792","0","65.66","20.96"
"10","005","00","012","1204","0099","622","222","400","36","658","918","0","71.68","24.18"
"10","005","00","012","1205","0000","525","182","343","32","557","899","0","61.96","20.24"
"10","005","00","012","1205","0101","525","182","343","32","557","899","0","61.96","20.24"
"10","005","00","012","1206","0000","177","50","127","9","186","369","0","50.41","13.55"
"10","005","00","012","1206","0102","177","50","127","9","186","369","0","50.41","13.55"
"10","005","00","012","1207","0000","621","204","417","37","658","1005","0","65.47","20.3"
"10","005","00","012","1207","0105","478","150","328","23","501","794","0","63.1","18.89"
"10","005","00","012","1207","0106","143","54","89","14","157","211","0","74.41","25.59"
"10","005","00","012","1208","0000","225","84","141","14","239","328","0","72.87","25.61"
"10","005","00","012","1208","0107","225","84","141","14","239","328","0","72.87","25.61"
"10","005","00","013","0000","0000","7821","2653","5168","354","8175","13889","16277","58.86","19.1"
"10","005","00","013","1301","0000","2336","744","1592","109","2445","4132","0","59.17","18.01"
"10","005","00","013","1301","0124","494","165","329","30","524","853","0","61.43","19.34"
"10","005","00","013","1301","0125","595","179","416","21","616","983","0","62.67","18.21"
"10","005","00","013","1301","0126","607","199","408","41","648","1080","0","60.0","18.43"
"10","005","00","013","1301","0127","640","201","439","17","657","1216","0","54.03","16.53"
"10","005","00","013","1302","0000","991","325","666","27","1018","1825","0","55.78","17.81"
"10","005","00","013","1302","0132","511","179","332","16","527","991","0","53.18","18.06"
"10","005","00","013","1302","0133","480","146","334","11","491","834","0","58.87","17.51"
"10","005","00","013","1303","0000","772","273","499","58","830","1371","0","60.54","19.91"
"10","005","00","013","1303","0134","342","110","232","28","370","622","0","59.49","17.68"
"10","005","00","013","1303","0135","430","163","267","30","460","749","0","61.42","21.76"
"10","005","00","013","1304","0000","1856","608","1248","64","1920","3395","0","56.55","17.91"
"10","005","00","013","1304","0128","576","181","395","28","604","1017","0","59.39","17.8"
"10","005","00","013","1304","0129","615","200","415","17","632","1180","0","53.56","16.95"
"10","005","00","013","1304","0130","665","227","438","19","684","1198","0","57.1","18.95"
"10","005","00","013","1305","0000","954","332","622","42","996","1451","0","68.64","22.88"
"10","005","00","013","1305","0136","441","139","302","19","460","692","0","66.47","20.09"
"10","005","00","013","1305","0137","513","193","320","23","536","759","0","70.62","25.43"
"10","005","00","013","1306","0000","229","83","146","14","243","417","0","58.27","19.9"
"10","005","00","013","1306","0131","229","83","146","14","243","417","0","58.27","19.9"
"10","005","00","013","1307","0000","683","288","395","40","723","1298","0","55.7","22.19"
"10","005","00","013","1307","0138","313","130","183","23","336","629","0","53.42","20.67"
"10","005","00","013","1307","0139","370","158","212","17","387","669","0","57.85","23.62"
"10","005","00","014","0000","0000","3334","1213","2121","218","3552","6382","7072","55.66","19.01"
"10","005","00","014","1401","0000","310","94","216","24","334","601","0","55.57","15.64"
"10","005","00","014","1401","0140","310","94","216","24","334","601","0","55.57","15.64"
"10","005","00","014","1402","0000","325","107","218","16","341","566","0","60.25","18.9"
"10","005","00","014","1402","0141","325","107","218","16","341","566","0","60.25","18.9"
"10","005","00","014","1403","0000","456","163","293","37","493","843","0","58.48","19.34"
"10","005","00","014","1403","0142","456","163","293","37","493","843","0","58.48","19.34"
"10","005","00","014","1404","0000","323","125","198","23","346","648","0","53.4","19.29"
"10","005","00","014","1404","0143","323","125","198","23","346","648","0","53.4","19.29"
"10","005","00","014","1405","0000","286","105","181","10","296","515","0","57.48","20.39"
"10","005","00","014","1405","0146","286","105","181","10","296","515","0","57.48","20.39"
"10","005","00","014","1406","0000","242","94","148","8","250","461","0","54.23","20.39"
"10","005","00","014","1406","0145","242","94","148","8","250","461","0","54.23","20.39"
"10","005","00","014","1407","0000","462","174","288","15","477","936","0","50.96","18.59"
"10","005","00","014","1407","0144","462","174","288","15","477","936","0","50.96","18.59"
"10","005","00","014","1408","0000","563","202","361","53","616","1141","0","53.99","17.7"
"10","005","00","014","1408","0147","563","202","361","53","616","1141","0","53.99","17.7"
"10","005","00","014","1409","0000","367","149","218","32","399","671","0","59.46","22.21"
"10","005","00","014","1409","0148","367","149","218","32","399","671","0","59.46","22.21"
"10","005","00","015","0000","0000","5960","2281","3679","467","6427","11027","12728","58.28","20.69"
"10","005","00","015","1501","0000","1206","413","793","92","1298","2060","0","63.01","20.05"
"10","005","00","015","1501","0258","709","257","452","60","769","1171","0","65.67","21.95"
"10","005","00","015","1501","0259","497","156","341","32","529","889","0","59.51","17.55"
"10","005","00","015","1502","0000","217","67","150","20","237","479","0","49.48","13.99"
"10","005","00","015","1502","0260","217","67","150","20","237","479","0","49.48","13.99"
"10","005","00","015","1503","0000","573","207","366","29","602","1024","0","58.79","20.21"
"10","005","00","015","1503","0261","573","207","366","29","602","1024","0","58.79","20.21"
"10","005","00","015","1504","0000","1686","644","1042","141","1827","3442","0","53.08","18.71"
"10","005","00","015","1504","0262","601","248","353","55","656","1214","0","54.04","20.43"
"10","005","00","015","1504","0263","534","185","349","28","562","1071","0","52.47","17.27"
"10","005","00","015","1504","0264","551","211","340","58","609","1157","0","52.64","18.24"
"10","005","00","015","1505","0000","280","103","177","17","297","512","0","58.01","20.12"
"10","005","00","015","1505","0265","280","103","177","17","297","512","0","58.01","20.12"
"10","005","00","015","1506","0000","296","103","193","14","310","491","0","63.14","20.98"
"10","005","00","015","1506","0266","296","103","193","14","310","491","0","63.14","20.98"
"10","005","00","015","1507","0000","725","296","429","42","767","1272","0","60.3","23.27"
"10","005","00","015","1507","0267","725","296","429","42","767","1272","0","60.3","23.27"
"10","005","00","015","1508","0000","420","175","245","34","454","785","0","57.83","22.29"
"10","005","00","015","1508","0268","420","175","245","34","454","785","0","57.83","22.29"
"10","005","00","015","1509","0000","557","273","284","78","635","962","0","66.01","28.38"
"10","005","00","015","1509","0269","557","273","284","78","635","962","0","66.01","28.38"
"10","005","00","016","0000","0000","3173","1147","2026","220","3393","5852","6662","57.98","19.6"
"10","005","00","016","1601","0000","1220","452","768","71","1291","2201","0","58.66","20.54"
"10","005","00","016","1601","0402","567","181","386","30","597","996","0","59.94","18.17"
"10","005","00","016","1601","0403","653","271","382","41","694","1205","0","57.59","22.49"
"10","005","00","016","1602","0000","357","117","240","30","387","635","0","60.94","18.43"
"10","005","00","016","1602","0404","357","117","240","30","387","635","0","60.94","18.43"
"10","005","00","016","1603","0000","465","138","327","32","497","862","0","57.66","16.01"
"10","005","00","016","1603","0405","465","138","327","32","497","862","0","57.66","16.01"
"10","005","00","016","1604","0000","107","46","61","11","118","238","0","49.58","19.33"
"10","005","00","016","1604","0406","107","46","61","11","118","238","0","49.58","19.33"
"10","005","00","016","1605","0000","272","115","157","24","296","541","0","54.71","21.26"
"10","005","00","016","1605","0407","272","115","157","24","296","541","0","54.71","21.26"
"10","005","00","016","1606","0000","280","104","176","23","303","578","0","52.42","17.99"
"10","005","00","016","1606","0408","280","104","176","23","303","578","0","52.42","17.99"
"10","005","00","016","1607","0000","260","96","164","19","279","405","0","68.89","23.7"
"10","005","00","016","1607","0409","260","96","164","19","279","405","0","68.89","23.7"
"10","005","00","016","1608","0000","212","79","133","10","222","392","0","56.63","20.15"
"10","005","00","016","1608","0410","212","79","133","10","222","392","0","56.63","20.15"
"10","005","00","017","0000","0000","1915","675","1240","138","2053","3968","4370","51.74","17.01"
"10","005","00","017","1701","0000","126","34","92","6","132","328","0","40.24","10.37"
"10","005","00","017","1701","0435","126","34","92","6","132","328","0","40.24","10.37"
"10","005","00","017","1702","0000","230","81","149","22","252","565","0","44.6","14.34"
"10","005","00","017","1702","0436","230","81","149","22","252","565","0","44.6","14.34"
"10","005","00","017","1703","0000","483","177","306","39","522","911","0","57.3","19.43"
"10","005","00","017","1703","0437","483","177","306","39","522","911","0","57.3","19.43"
"10","005","00","017","1704","0000","255","108","147","18","273","568","0","48.06","19.01"
"10","005","00","017","1704","0438","255","108","147","18","273","568","0","48.06","19.01"
"10","005","00","017","1705","0000","318","106","212","25","343","580","0","59.14","18.28"
"10","005","00","017","1705","0439","318","106","212","25","343","580","0","59.14","18.28"
"10","005","00","017","1706","0000","163","58","105","10","173","333","0","51.95","17.42"
"10","005","00","017","1706","0440","163","58","105","10","173","333","0","51.95","17.42"
"10","005","00","017","1707","0000","340","111","229","18","358","683","0","52.42","16.25"
"10","005","00","017","1707","0441","340","111","229","18","358","683","0","52.42","16.25"
"10","005","00","018","0000","0000","3236","1078","2158","202","3438","5180","6076","66.37","20.81"
"10","005","00","018","1801","0000","148","44","104","11","159","325","0","48.92","13.54"
"10","005","00","018","1801","0461","148","44","104","11","159","325","0","48.92","13.54"
"10","005","00","018","1802","0000","729","259","470","47","776","1150","0","67.48","22.52"
"10","005","00","018","1802","0462","274","99","175","15","289","484","0","59.71","20.45"
"10","005","00","018","1802","0463","455","160","295","32","487","666","0","73.12","24.02"
"10","005","00","018","1803","0000","526","165","361","40","566","907","0","62.4","18.19"
"10","005","00","018","1803","0464","356","115","241","34","390","574","0","67.94","20.03"
"10","005","00","018","1803","0465","170","50","120","6","176","333","0","52.85","15.02"
"10","005","00","018","1804","0000","334","77","257","11","345","495","0","69.7","15.56"
"10","005","00","018","1804","0466","334","77","257","11","345","495","0","69.7","15.56"
"10","005","00","018","1805","0000","361","175","186","34","395","544","0","72.61","32.17"
"10","005","00","018","1805","0467","361","175","186","34","395","544","0","72.61","32.17"
"10","005","00","018","1806","0000","241","89","152","17","258","500","0","51.6","17.8"
"10","005","00","018","1806","0468","241","89","152","17","258","500","0","51.6","17.8"
"10","005","00","018","1807","0000","443","159","284","37","480","670","0","71.64","23.73"
"10","005","00","018","1807","0469","443","159","284","37","480","670","0","71.64","23.73"
"10","005","00","018","1808","0000","454","110","344","5","459","589","0","77.93","18.68"
"10","005","00","018","1808","0470","454","110","344","5","459","589","0","77.93","18.68"
"10","007","00","000","0000","0000","584504","263529","320975","32937","617441","1066994","1278437","57.87","24.7"
"10","007","00","001","0000","0000","110750","49902","60848","5319","116069","190995","232709","60.77","26.13"
"10","007","00","001","0101","0000","807","364","443","35","842","1295","0","65.02","28.11"
"10","007","00","001","0101","0117","416","184","232","14","430","662","0","64.95","27.79"
"10","007","00","001","0101","0118","391","180","211","21","412","633","0","65.09","28.44"
"10","007","00","001","0102","0000","2977","1326","1651","136","3113","5001","0","62.25","26.51"
"10","007","00","001","0102","0125","729","304","425","46","775","1263","0","61.36","24.07"
"10","007","00","001","0102","0126","773","349","424","33","806","1268","0","63.56","27.52"
"10","007","00","001","0102","0127","733","345","388","37","770","1258","0","61.21","27.42"
"10","007","00","001","0102","0128","742","328","414","20","762","1212","0","62.87","27.06"
"10","007","00","001","0103","0000","966","448","518","43","1009","1656","0","60.93","27.05"
"10","007","00","001","0103","0112","468","207","261","17","485","781","0","62.1","26.5"
"10","007","00","001","0103","0113","498","241","257","26","524","875","0","59.89","27.54"
"10","007","00","001","0104","0000","472","240","232","18","490","816","0","60.05","29.41"
"10","007","00","001","0104","0114","472","240","232","18","490","816","0","60.05","29.41"
"10","007","00","001","0105","0000","864","423","441","55","919","1414","0","64.99","29.92"
"10","007","00","001","0105","0115","416","217","199","26","442","687","0","64.34","31.59"
"10","007","00","001","0105","0116","448","206","242","29","477","727","0","65.61","28.34"
"10","007","00","001","0106","0000","1045","488","557","46","1091","1759","0","62.02","27.74"
"10","007","00","001","0106","0119","572","264","308","18","590","906","0","65.12","29.14"
"10","007","00","001","0106","0120","473","224","249","28","501","853","0","58.73","26.26"
"10","007","00","001","0107","0000","2403","1045","1358","118","2521","3986","0","63.25","26.22"
"10","007","00","001","0107","0121","609","273","336","36","645","1027","0","62.8","26.58"
"10","007","00","001","0107","0122","607","233","374","33","640","993","0","64.45","23.46"
"10","007","00","001","0107","0123","494","242","252","32","526","848","0","62.03","28.54"
"10","007","00","001","0107","0124","693","297","396","17","710","1118","0","63.51","26.57"
"10","007","00","001","0108","0000","2926","1301","1625","93","3019","5156","0","58.55","25.23"
"10","007","00","001","0108","0106","690","339","351","7","697","1156","0","60.29","29.33"
"10","007","00","001","0108","0107","721","336","385","37","758","1235","0","61.38","27.21"
"10","007","00","001","0108","0108","743","311","432","37","780","1376","0","56.69","22.6"
"10","007","00","001","0108","0109","772","315","457","12","784","1389","0","56.44","22.68"
"10","007","00","001","0109","0000","1072","482","590","53","1125","1705","0","65.98","28.27"
"10","007","00","001","0109","0110","534","245","289","28","562","846","0","66.43","28.96"
"10","007","00","001","0109","0111","538","237","301","25","563","859","0","65.54","27.59"
"10","007","00","001","0110","0000","1055","465","590","43","1098","1883","0","58.31","24.69"
"10","007","00","001","0110","0104","519","223","296","18","537","975","0","55.08","22.87"
"10","007","00","001","0110","0105","536","242","294","25","561","908","0","61.78","26.65"
"10","007","00","001","0111","0000","478","209","269","26","504","773","0","65.2","27.04"
"10","007","00","001","0111","0103","478","209","269","26","504","773","0","65.2","27.04"
"10","007","00","001","0112","0000","836","421","415","48","884","1420","0","62.25","29.65"
"10","007","00","001","0112","0101","422","219","203","28","450","692","0","65.03","31.65"
"10","007","00","001","0112","0102","414","202","212","20","434","728","0","59.62","27.75"
"10","007","00","001","0113","0000","545","280","265","35","580","893","0","64.95","31.35"
"10","007","00","001","0113","0099","545","280","265","35","580","893","0","64.95","31.35"
"10","007","00","001","0114","0000","432","249","183","34","466","691","0","67.44","36.03"
"10","007","00","001","0114","0098","432","249","183","34","466","691","0","67.44","36.03"
"10","007","00","001","0115","0000","438","216","222","21","459","733","0","62.62","29.47"
"10","007","00","001","0115","0100","438","216","222","21","459","733","0","62.62","29.47"
"10","007","00","001","0116","0000","543","303","240","35","578","910","0","63.52","33.3"
"10","007","00","001","0116","0054","543","303","240","35","578","910","0","63.52","33.3"
"10","007","00","001","0117","0000","484","254","230","20","504","771","0","65.37","32.94"
"10","007","00","001","0117","0051","484","254","230","20","504","771","0","65.37","32.94"
"10","007","00","001","0118","0000","503","270","233","39","542","868","0","62.44","31.11"
"10","007","00","001","0118","0052","503","270","233","39","542","868","0","62.44","31.11"
"10","007","00","001","0119","0000","650","322","328","38","688","1135","0","60.62","28.37"
"10","007","00","001","0119","0053","650","322","328","38","688","1135","0","60.62","28.37"
"10","007","00","001","0120","0000","2083","1131","952","82","2165","3360","0","64.43","33.66"
"10","007","00","001","0120","0056","647","314","333","31","678","1077","0","62.95","29.16"
"10","007","00","001","0120","0057","798","334","464","29","827","1258","0","65.74","26.55"
"10","007","00","001","0120","0058","638","483","155","22","660","1025","0","64.39","47.12"
"10","007","00","001","0121","0000","2125","874","1251","121","2246","3648","0","61.57","23.96"
"10","007","00","001","0121","0059","713","301","412","35","748","1177","0","63.55","25.57"
"10","007","00","001","0121","0060","679","280","399","44","723","1262","0","57.29","22.19"
"10","007","00","001","0121","0061","733","293","440","42","775","1209","0","64.1","24.23"
"10","007","00","001","0122","0000","663","307","356","49","712","1203","0","59.19","25.52"
"10","007","00","001","0122","0065","663","307","356","49","712","1203","0","59.19","25.52"
"10","007","00","001","0123","0000","1843","858","985","89","1932","3145","0","61.43","27.28"
"10","007","00","001","0123","0062","629","290","339","30","659","1041","0","63.3","27.86"
"10","007","00","001","0123","0063","644","355","289","34","678","1075","0","63.07","33.02"
"10","007","00","001","0123","0064","570","213","357","25","595","1029","0","57.82","20.7"
"10","007","00","001","0124","0000","2241","995","1246","111","2352","4157","0","56.58","23.94"
"10","007","00","001","0124","0066","558","242","316","33","591","1014","0","58.28","23.87"
"10","007","00","001","0124","0067","619","272","347","28","647","1069","0","60.52","25.44"
"10","007","00","001","0124","0068","496","233","263","25","521","969","0","53.77","24.05"
"10","007","00","001","0124","0069","568","248","320","25","593","1105","0","53.67","22.44"
"10","007","00","001","0125","0000","626","343","283","20","646","1004","0","64.34","34.16"
"10","007","00","001","0125","0055","626","343","283","20","646","1004","0","64.34","34.16"
"10","007","00","001","0126","0000","2005","983","1022","109","2114","3496","0","60.47","28.12"
"10","007","00","001","0126","0090","672","338","334","33","705","1201","0","58.7","28.14"
"10","007","00","001","0126","0091","639","328","311","37","676","1057","0","63.95","31.03"
"10","007","00","001","0126","0092","694","317","377","39","733","1238","0","59.21","25.61"
"10","007","00","001","0127","0000","1197","549","648","89","1286","2130","0","60.38","25.77"
"10","007","00","001","0127","0088","638","293","345","45","683","1153","0","59.24","25.41"
"10","007","00","001","0127","0089","559","256","303","44","603","977","0","61.72","26.2"
"10","007","00","001","0128","0000","1039","451","588","61","1100","1799","0","61.15","25.07"
"10","007","00","001","0128","0086","450","215","235","27","477","799","0","59.7","26.91"
"10","007","00","001","0128","0087","589","236","353","34","623","1000","0","62.3","23.6"
"10","007","00","001","0129","0000","1822","823","999","75","1897","3091","0","61.37","26.63"
"10","007","00","001","0129","0083","524","235","289","28","552","890","0","62.02","26.4"
"10","007","00","001","0129","0084","693","309","384","21","714","1104","0","64.67","27.99"
"10","007","00","001","0129","0085","605","279","326","26","631","1097","0","57.52","25.43"
"10","007","00","001","0130","0000","1978","837","1141","100","2078","3297","0","63.03","25.39"
"10","007","00","001","0130","0093","722","306","416","25","747","1210","0","61.74","25.29"
"10","007","00","001","0130","0094","599","249","350","39","638","1026","0","62.18","24.27"
"10","007","00","001","0130","0095","657","282","375","36","693","1061","0","65.32","26.58"
"10","007","00","001","0131","0000","2477","1095","1382","174","2651","4213","0","62.92","25.99"
"10","007","00","001","0131","0070","603","237","366","31","634","981","0","64.63","24.16"
"10","007","00","001","0131","0071","655","302","353","40","695","1095","0","63.47","27.58"
"10","007","00","001","0131","0072","658","274","384","18","676","1087","0","62.19","25.21"
"10","007","00","001","0131","0073","561","282","279","85","646","1050","0","61.52","26.86"
"10","007","00","001","0132","0000","1423","629","794","100","1523","2545","0","59.84","24.72"
"10","007","00","001","0132","0001","509","230","279","34","543","871","0","62.34","26.41"
"10","007","00","001","0132","0002","334","150","184","34","368","751","0","49.0","19.97"
"10","007","00","001","0132","0003","580","249","331","32","612","923","0","66.31","26.98"
"10","007","00","001","0133","0000","1431","639","792","65","1496","2477","0","60.4","25.8"
"10","007","00","001","0133","0096","693","327","366","34","727","1213","0","59.93","26.96"
"10","007","00","001","0133","0097","738","312","426","31","769","1264","0","60.84","24.68"
"10","007","00","001","0134","0000","918","439","479","49","967","1558","0","62.07","28.18"
"10","007","00","001","0134","0004","458","235","223","27","485","779","0","62.26","30.17"
"10","007","00","001","0134","0005","460","204","256","22","482","779","0","61.87","26.19"
"10","007","00","001","0135","0000","578","277","301","21","599","1027","0","58.33","26.97"
"10","007","00","001","0135","0010","578","277","301","21","599","1027","0","58.33","26.97"
"10","007","00","001","0136","0000","690","315","375","32","722","1249","0","57.81","25.22"
"10","007","00","001","0136","0011","690","315","375","32","722","1249","0","57.81","25.22"
"10","007","00","001","0137","0000","1105","480","625","55","1160","1814","0","63.95","26.46"
"10","007","00","001","0137","0008","466","182","284","35","501","767","0","65.32","23.73"
"10","007","00","001","0137","0009","639","298","341","20","659","1047","0","62.94","28.46"
"10","007","00","001","0138","0000","844","398","446","44","888","1469","0","60.45","27.09"
"10","007","00","001","0138","0006","411","194","217","23","434","720","0","60.28","26.94"
"10","007","00","001","0138","0007","433","204","229","21","454","749","0","60.61","27.24"
"10","007","00","001","0139","0000","4396","2044","2352","163","4559","7563","0","60.28","27.03"
"10","007","00","001","0139","0035","572","245","327","21","593","1045","0","56.75","23.44"
"10","007","00","001","0139","0036","629","277","352","15","644","1097","0","58.71","25.25"
"10","007","00","001","0139","0037","672","312","360","27","699","1190","0","58.74","26.22"
"10","007","00","001","0139","0038","672","309","363","22","694","1106","0","62.75","27.94"
"10","007","00","001","0139","0039","645","292","353","19","664","1097","0","60.53","26.62"
"10","007","00","001","0139","0040","617","319","298","31","648","1048","0","61.83","30.44"
"10","007","00","001","0139","0041","589","290","299","28","617","980","0","62.96","29.59"
"10","007","00","001","0140","0000","897","444","453","47","944","1516","0","62.27","29.29"
"10","007","00","001","0140","0042","432","212","220","19","451","707","0","63.79","29.99"
"10","007","00","001","0140","0043","465","232","233","28","493","809","0","60.94","28.68"
"10","007","00","001","0141","0000","2789","1193","1596","116","2905","4896","0","59.33","24.37"
"10","007","00","001","0141","0025","672","279","393","27","699","1207","0","57.91","23.12"
"10","007","00","001","0141","0026","671","284","387","31","702","1161","0","60.47","24.46"
"10","007","00","001","0141","0027","651","333","318","15","666","1166","0","57.12","28.56"
"10","007","00","001","0141","0028","795","297","498","43","838","1362","0","61.53","21.81"
"10","007","00","001","0142","0000","4162","1898","2264","154","4316","7131","0","60.52","26.62"
"10","007","00","001","0142","0029","735","347","388","31","766","1236","0","61.97","28.07"
"10","007","00","001","0142","0030","617","283","334","27","644","1065","0","60.47","26.57"
"10","007","00","001","0142","0031","698","319","379","30","728","1199","0","60.72","26.61"
"10","007","00","001","0142","0032","720","328","392","26","746","1233","0","60.5","26.6"
"10","007","00","001","0142","0033","707","304","403","17","724","1245","0","58.15","24.42"
"10","007","00","001","0142","0034","685","317","368","23","708","1153","0","61.41","27.49"
"10","007","00","001","0143","0000","1633","737","896","89","1722","2928","0","58.81","25.17"
"10","007","00","001","0143","0045","484","229","255","34","518","901","0","57.49","25.42"
"10","007","00","001","0143","0046","529","232","297","24","553","951","0","58.15","24.4"
"10","007","00","001","0143","0047","620","276","344","31","651","1076","0","60.5","25.65"
"10","007","00","001","0144","0000","1694","826","868","80","1774","2932","0","60.5","28.17"
"10","007","00","001","0144","0048","569","282","287","20","589","1022","0","57.63","27.59"
"10","007","00","001","0144","0049","511","253","258","37","548","894","0","61.3","28.3"
"10","007","00","001","0144","0050","614","291","323","23","637","1016","0","62.7","28.64"
"10","007","00","001","0145","0000","845","398","447","27","872","1409","0","61.89","28.25"
"10","007","00","001","0145","0014","470","230","240","16","486","766","0","63.45","30.03"
"10","007","00","001","0145","0015","375","168","207","11","386","643","0","60.03","26.13"
"10","007","00","001","0146","0000","1190","465","725","69","1259","2552","0","49.33","18.22"
"10","007","00","001","0146","0016","702","246","456","47","749","1251","0","59.87","19.66"
"10","007","00","001","0146","0017","488","219","269","22","510","1301","0","39.2","16.83"
"10","007","00","001","0147","0000","5075","2294","2781","173","5248","8589","0","61.1","26.71"
"10","007","00","001","0147","0018","745","330","415","24","769","1280","0","60.08","25.78"
"10","007","00","001","0147","0019","696","305","391","31","727","1179","0","61.66","25.87"
"10","007","00","001","0147","0020","662","273","389","31","693","1168","0","59.33","23.37"
"10","007","00","001","0147","0021","692","364","328","26","718","1218","0","58.95","29.89"
"10","007","00","001","0147","0022","868","359","509","18","886","1351","0","65.58","26.57"
"10","007","00","001","0147","0023","705","362","343","26","731","1204","0","60.71","30.07"
"10","007","00","001","0147","0024","707","301","406","17","724","1189","0","60.89","25.32"
"10","007","00","001","0148","0000","1345","554","791","69","1414","2305","0","61.34","24.03"
"10","007","00","001","0148","0012","643","271","372","38","681","1136","0","59.95","23.86"
"10","007","00","001","0148","0013","702","283","419","31","733","1169","0","62.7","24.21"
"10","007","00","001","0149","0000","599","292","307","38","637","1008","0","63.19","28.97"
"10","007","00","001","0149","0044","599","292","307","38","637","1008","0","63.19","28.97"
"10","007","00","001","0150","0000","1814","810","1004","103","1917","3262","0","58.77","24.83"
"10","007","00","001","0150","0177","574","265","309","43","617","1002","0","61.58","26.45"
"10","007","00","001","0150","0178","626","264","362","28","654","1148","0","56.97","23.0"
"10","007","00","001","0150","0179","614","281","333","32","646","1112","0","58.09","25.27"
"10","007","00","001","0151","0000","988","456","532","61","1049","1685","0","62.26","27.06"
"10","007","00","001","0151","0153","479","205","274","27","506","800","0","63.25","25.63"
"10","007","00","001","0151","0154","509","251","258","34","543","885","0","61.36","28.36"
"10","007","00","001","0152","0000","1126","494","632","31","1157","1903","0","60.8","25.96"
"10","007","00","001","0152","0174","534","239","295","15","549","930","0","59.03","25.7"
"10","007","00","001","0152","0175","592","255","337","16","608","973","0","62.49","26.21"
"10","007","00","001","0153","0000","1878","873","1005","74","1952","3282","0","59.48","26.6"
"10","007","00","001","0153","0155","617","275","342","22","639","1000","0","63.9","27.5"
"10","007","00","001","0153","0156","641","312","329","26","667","1159","0","57.55","26.92"
"10","007","00","001","0153","0157","620","286","334","26","646","1123","0","57.52","25.47"
"10","007","00","001","0154","0000","1680","764","916","126","1806","2908","0","62.1","26.27"
"10","007","00","001","0154","0158","550","271","279","43","593","907","0","65.38","29.88"
"10","007","00","001","0154","0159","532","220","312","41","573","989","0","57.94","22.24"
"10","007","00","001","0154","0160","598","273","325","42","640","1012","0","63.24","26.98"
"10","007","00","001","0155","0000","3802","1762","2040","188","3990","6789","0","58.77","25.95"
"10","007","00","001","0155","0168","587","267","320","31","618","1120","0","55.18","23.84"
"10","007","00","001","0155","0169","664","289","375","27","691","1269","0","54.45","22.77"
"10","007","00","001","0155","0170","683","322","361","31","714","1159","0","61.6","27.78"
"10","007","00","001","0155","0171","683","336","347","43","726","1184","0","61.32","28.38"
"10","007","00","001","0155","0172","611","286","325","25","636","1089","0","58.4","26.26"
"10","007","00","001","0155","0173","574","262","312","31","605","968","0","62.5","27.07"
"10","007","00","001","0156","0000","1399","648","751","63","1462","2485","0","58.83","26.08"
"10","007","00","001","0156","0151","744","351","393","38","782","1372","0","57.0","25.58"
"10","007","00","001","0156","0152","655","297","358","25","680","1113","0","61.1","26.68"
"10","007","00","001","0157","0000","605","265","340","18","623","1184","0","52.62","22.38"
"10","007","00","001","0157","0176","605","265","340","18","623","1184","0","52.62","22.38"
"10","007","00","001","0158","0000","1462","689","773","101","1563","2445","0","63.93","28.18"
"10","007","00","001","0158","0165","466","222","244","37","503","770","0","65.32","28.83"
"10","007","00","001","0158","0166","530","260","270","27","557","889","0","62.65","29.25"
"10","007","00","001","0158","0167","466","207","259","37","503","786","0","63.99","26.34"
"10","007","00","001","0159","0000","744","291","453","52","796","1249","0","63.73","23.3"
"10","007","00","001","0159","0133","744","291","453","52","796","1249","0","63.73","23.3"
"10","007","00","001","0160","0000","536","236","300","39","575","924","0","62.23","25.54"
"10","007","00","001","0160","0129","536","236","300","39","575","924","0","62.23","25.54"
"10","007","00","001","0161","0000","1807","818","989","91","1898","2873","0","66.06","28.47"
"10","007","00","001","0161","0130","573","267","306","29","602","939","0","64.11","28.43"
"10","007","00","001","0161","0131","610","302","308","37","647","953","0","67.89","31.69"
"10","007","00","001","0161","0132","624","249","375","25","649","981","0","66.16","25.38"
"10","007","00","001","0162","0000","4740","1867","2873","212","4952","8267","0","59.9","22.58"
"10","007","00","001","0162","0137","705","279","426","31","736","1156","0","63.67","24.13"
"10","007","00","001","0162","0138","724","288","436","21","745","1291","0","57.71","22.31"
"10","007","00","001","0162","0139","653","253","400","23","676","1139","0","59.35","22.21"
"10","007","00","001","0162","0140","660","251","409","41","701","1125","0","62.31","22.31"
"10","007","00","001","0162","0141","684","235","449","40","724","1258","0","57.55","18.68"
"10","007","00","001","0162","0142","644","282","362","24","668","1123","0","59.48","25.11"
"10","007","00","001","0162","0143","670","279","391","32","702","1175","0","59.74","23.74"
"10","007","00","001","0163","0000","1365","624","741","93","1458","2378","0","61.31","26.24"
"10","007","00","001","0163","0134","481","235","246","36","517","817","0","63.28","28.76"
"10","007","00","001","0163","0135","492","229","263","42","534","872","0","61.24","26.26"
"10","007","00","001","0163","0136","392","160","232","15","407","689","0","59.07","23.22"
"10","007","00","001","0164","0000","2339","1025","1314","117","2456","4160","0","59.04","24.64"
"10","007","00","001","0164","0147","544","236","308","25","569","1003","0","56.73","23.53"
"10","007","00","001","0164","0148","512","228","284","20","532","915","0","58.14","24.92"
"10","007","00","001","0164","0149","634","276","358","34","668","1158","0","57.69","23.83"
"10","007","00","001","0164","0150","649","285","364","38","687","1084","0","63.38","26.29"
"10","007","00","001","0165","0000","1623","726","897","59","1682","2631","0","63.93","27.59"
"10","007","00","001","0165","0144","549","258","291","24","573","862","0","66.47","29.93"
"10","007","00","001","0165","0145","510","244","266","18","528","872","0","60.55","27.98"
"10","007","00","001","0165","0146","564","224","340","17","581","897","0","64.77","24.97"
"10","007","00","001","0166","0000","642","281","361","27","669","1161","0","57.62","24.2"
"10","007","00","001","0166","0184","642","281","361","27","669","1161","0","57.62","24.2"
"10","007","00","001","0167","0000","717","353","364","48","765","1276","0","59.95","27.66"
"10","007","00","001","0167","0183","717","353","364","48","765","1276","0","59.95","27.66"
"10","007","00","001","0168","0000","441","238","203","23","464","823","0","56.38","28.92"
"10","007","00","001","0168","0182","441","238","203","23","464","823","0","56.38","28.92"
"10","007","00","001","0169","0000","606","243","363","24","630","907","0","69.46","26.79"
"10","007","00","001","0169","0180","606","243","363","24","630","907","0","69.46","26.79"
"10","007","00","001","0170","0000","643","286","357","40","683","1112","0","61.42","25.72"
"10","007","00","001","0170","0181","643","286","357","40","683","1112","0","61.42","25.72"
"10","007","00","001","0171","0000","2437","973","1464","95","2532","4367","0","57.98","22.28"
"10","007","00","001","0171","0161","560","214","346","10","570","1033","0","55.18","20.72"
"10","007","00","001","0171","0162","556","269","287","27","583","1116","0","52.24","24.1"
"10","007","00","001","0171","0163","687","231","456","29","716","1154","0","62.05","20.02"
"10","007","00","001","0171","0164","634","259","375","29","663","1064","0","62.31","24.34"
"10","007","00","001","0172","0000","3082","1365","1717","120","3202","5370","0","59.63","25.42"
"10","007","00","001","0172","0074","723","323","400","33","756","1252","0","60.38","25.8"
"10","007","00","001","0172","0075","613","296","317","24","637","1113","0","57.23","26.59"
"10","007","00","001","0172","0076","612","267","345","21","633","1009","0","62.74","26.46"
"10","007","00","001","0172","0077","552","233","319","29","581","999","0","58.16","23.32"
"10","007","00","001","0172","0078","582","246","336","13","595","997","0","59.68","24.67"
"10","007","00","001","0173","0000","3065","1141","1924","107","3172","5178","0","61.26","22.04"
"10","007","00","001","0173","0079","715","272","443","31","746","1145","0","65.15","23.76"
"10","007","00","001","0173","0080","721","313","408","17","738","1227","0","60.15","25.51"
"10","007","00","001","0173","0081","731","309","422","27","758","1208","0","62.75","25.58"
"10","007","00","001","0173","0082","898","247","651","32","930","1598","0","58.2","15.46"
"10","007","00","002","0000","0000","39113","18762","20351","2215","41328","70505","86762","58.62","26.61"
"10","007","00","002","0201","0000","691","380","311","37","728","1140","0","63.86","33.33"
"10","007","00","002","0201","0243","691","380","311","37","728","1140","0","63.86","33.33"
"10","007","00","002","0202","0000","290","154","136","19","309","511","0","60.47","30.14"
"10","007","00","002","0202","0244","290","154","136","19","309","511","0","60.47","30.14"
"10","007","00","002","0203","0000","425","217","208","23","448","857","0","52.28","25.32"
"10","007","00","002","0203","0245","425","217","208","23","448","857","0","52.28","25.32"
"10","007","00","002","0204","0000","569","273","296","42","611","946","0","64.59","28.86"
"10","007","00","002","0204","0246","569","273","296","42","611","946","0","64.59","28.86"
"10","007","00","002","0205","0000","4225","2080","2145","241","4466","7584","0","58.89","27.43"
"10","007","00","002","0205","0302","640","362","278","50","690","1299","0","53.12","27.87"
"10","007","00","002","0205","0303","766","364","402","41","807","1298","0","62.17","28.04"
"10","007","00","002","0205","0304","807","374","433","41","848","1458","0","58.16","25.65"
"10","007","00","002","0205","0305","664","339","325","33","697","1138","0","61.25","29.79"
"10","007","00","002","0205","0306","637","314","323","41","678","1170","0","57.95","26.84"
"10","007","00","002","0205","0307","711","327","384","35","746","1221","0","61.1","26.78"
"10","007","00","002","0206","0000","2808","1335","1473","134","2942","5161","0","57.0","25.87"
"10","007","00","002","0206","0298","692","296","396","41","733","1227","0","59.74","24.12"
"10","007","00","002","0206","0299","687","324","363","29","716","1187","0","60.32","27.3"
"10","007","00","002","0206","0300","708","372","336","26","734","1296","0","56.64","28.7"
"10","007","00","002","0206","0301","721","343","378","38","759","1451","0","52.31","23.64"
"10","007","00","002","0207","0000","2699","1381","1318","137","2836","4946","0","57.34","27.92"
"10","007","00","002","0207","0247","545","306","239","23","568","945","0","60.11","32.38"
"10","007","00","002","0207","0248","635","326","309","26","661","1097","0","60.26","29.72"
"10","007","00","002","0207","0249","725","350","375","27","752","1479","0","50.85","23.66"
"10","007","00","002","0207","0250","794","399","395","61","855","1425","0","60.0","28.0"
"10","007","00","002","0208","0000","2441","1269","1172","118","2559","4335","0","59.03","29.27"
"10","007","00","002","0208","0253","621","346","275","41","662","1047","0","63.23","33.05"
"10","007","00","002","0208","0254","601","337","264","19","620","1097","0","56.52","30.72"
"10","007","00","002","0208","0255","560","274","286","36","596","1030","0","57.86","26.6"
"10","007","00","002","0208","0256","659","312","347","22","681","1161","0","58.66","26.87"
"10","007","00","002","0209","0000","307","151","156","35","342","540","0","63.33","27.96"
"10","007","00","002","0209","0257","307","151","156","35","342","540","0","63.33","27.96"
"10","007","00","002","0210","0000","524","298","226","38","562","880","0","63.86","33.86"
"10","007","00","002","0210","0251","524","298","226","38","562","880","0","63.86","33.86"
"10","007","00","002","0211","0000","642","345","297","30","672","1183","0","56.8","29.16"
"10","007","00","002","0211","0252","642","345","297","30","672","1183","0","56.8","29.16"
"10","007","00","002","0212","0000","642","310","332","28","670","1127","0","59.45","27.51"
"10","007","00","002","0212","0262","642","310","332","28","670","1127","0","59.45","27.51"
"10","007","00","002","0213","0000","725","350","375","37","762","1178","0","64.69","29.71"
"10","007","00","002","0213","0263","725","350","375","37","762","1178","0","64.69","29.71"
"10","007","00","002","0214","0000","163","85","78","6","169","284","0","59.51","29.93"
"10","007","00","002","0214","0264","163","85","78","6","169","284","0","59.51","29.93"
"10","007","00","002","0215","0000","424","322","102","15","439","659","0","66.62","48.86"
"10","007","00","002","0215","0266","424","322","102","15","439","659","0","66.62","48.86"
"10","007","00","002","0216","0000","334","176","158","16","350","584","0","59.93","30.14"
"10","007","00","002","0216","0265","334","176","158","16","350","584","0","59.93","30.14"
"10","007","00","002","0217","0000","555","324","231","13","568","915","0","62.08","35.41"
"10","007","00","002","0217","0267","555","324","231","13","568","915","0","62.08","35.41"
"10","007","00","002","0218","0000","1341","690","651","84","1425","2208","0","64.54","31.25"
"10","007","00","002","0218","0268","650","352","298","41","691","1079","0","64.04","32.62"
"10","007","00","002","0218","0269","691","338","353","43","734","1129","0","65.01","29.94"
"10","007","00","002","0219","0000","2003","830","1173","163","2166","3820","0","56.7","21.73"
"10","007","00","002","0219","0286","743","322","421","74","817","1505","0","54.29","21.4"
"10","007","00","002","0219","0287","571","233","338","36","607","1092","0","55.59","21.34"
"10","007","00","002","0219","0288","689","275","414","53","742","1223","0","60.67","22.49"
"10","007","00","002","0220","0000","1321","525","796","80","1401","2575","0","54.41","20.39"
"10","007","00","002","0220","0289","748","288","460","34","782","1572","0","49.75","18.32"
"10","007","00","002","0220","0290","573","237","336","46","619","1003","0","61.71","23.63"
"10","007","00","002","0221","0000","2301","925","1376","100","2401","4070","0","58.99","22.73"
"10","007","00","002","0221","0295","844","346","498","45","889","1397","0","63.64","24.77"
"10","007","00","002","0221","0296","672","240","432","35","707","1229","0","57.53","19.53"
"10","007","00","002","0221","0297","785","339","446","20","805","1444","0","55.75","23.48"
"10","007","00","002","0222","0000","2322","1017","1305","86","2408","4152","0","58.0","24.49"
"10","007","00","002","0222","0291","538","221","317","21","559","933","0","59.91","23.69"
"10","007","00","002","0222","0292","648","320","328","15","663","1093","0","60.66","29.28"
"10","007","00","002","0222","0293","501","215","286","16","517","907","0","57.0","23.7"
"10","007","00","002","0222","0294","635","261","374","34","669","1219","0","54.88","21.41"
"10","007","00","002","0223","0000","1769","765","1004","86","1855","3167","0","58.57","24.16"
"10","007","00","002","0223","0278","536","218","318","20","556","984","0","56.5","22.15"
"10","007","00","002","0223","0279","618","253","365","35","653","1018","0","64.15","24.85"
"10","007","00","002","0223","0280","615","294","321","31","646","1165","0","55.45","25.24"
"10","007","00","002","0224","0000","1115","491","624","67","1182","2181","0","54.2","22.51"
"10","007","00","002","0224","0281","583","257","326","35","618","1161","0","53.23","22.14"
"10","007","00","002","0224","0282","532","234","298","32","564","1020","0","55.29","22.94"
"10","007","00","002","0225","0000","1739","816","923","126","1865","3066","0","60.83","26.61"
"10","007","00","002","0225","0283","570","275","295","46","616","1068","0","57.68","25.75"
"10","007","00","002","0225","0284","598","285","313","39","637","1024","0","62.21","27.83"
"10","007","00","002","0225","0285","571","256","315","41","612","974","0","62.83","26.28"
"10","007","00","002","0226","0000","1824","913","911","137","1961","3557","0","55.13","25.67"
"10","007","00","002","0226","0272","573","296","277","59","632","1137","0","55.58","26.03"
"10","007","00","002","0226","0273","623","306","317","40","663","1195","0","55.48","25.61"
"10","007","00","002","0226","0274","628","311","317","38","666","1225","0","54.37","25.39"
"10","007","00","002","0227","0000","1018","448","570","76","1094","1979","0","55.28","22.64"
"10","007","00","002","0227","0270","667","280","387","44","711","1273","0","55.85","22.0"
"10","007","00","002","0227","0271","351","168","183","32","383","706","0","54.25","23.8"
"10","007","00","002","0228","0000","1382","677","705","105","1487","2438","0","60.99","27.77"
"10","007","00","002","0228","0275","584","261","323","46","630","957","0","65.83","27.27"
"10","007","00","002","0228","0276","379","181","198","29","408","758","0","53.83","23.88"
"10","007","00","002","0228","0277","419","235","184","30","449","723","0","62.1","32.5"
"10","007","00","002","0229","0000","2514","1215","1299","136","2650","4462","0","59.39","27.23"
"10","007","00","002","0229","0258","621","302","319","26","647","1135","0","57.0","26.61"
"10","007","00","002","0229","0259","634","287","347","41","675","1155","0","58.44","24.85"
"10","007","00","002","0229","0260","673","316","357","28","701","1127","0","62.2","28.04"
"10","007","00","002","0229","0261","586","310","276","41","627","1045","0","60.0","29.67"
"10","007","00","003","0000","0000","41003","17982","23021","2066","43069","75286","90786","57.21","23.88"
"10","007","00","003","0301","0000","3134","1368","1766","132","3266","6061","0","53.89","22.57"
"10","007","00","003","0301","0373","706","335","371","38","744","1341","0","55.48","24.98"
"10","007","00","003","0301","0374","735","332","403","39","774","1480","0","52.3","22.43"
"10","007","00","003","0301","0375","850","350","500","28","878","1529","0","57.42","22.89"
"10","007","00","003","0301","0376","843","351","492","27","870","1711","0","50.85","20.51"
"10","007","00","003","0302","0000","2467","1014","1453","114","2581","4313","0","59.84","23.51"
"10","007","00","003","0302","0377","591","271","320","26","617","1057","0","58.37","25.64"
"10","007","00","003","0302","0378","599","281","318","20","619","1032","0","59.98","27.23"
"10","007","00","003","0302","0379","576","251","325","33","609","1015","0","60.0","24.73"
"10","007","00","003","0302","0380","701","211","490","35","736","1209","0","60.88","17.45"
"10","007","00","003","0303","0000","236","107","129","15","251","430","0","58.37","24.88"
"10","007","00","003","0303","0381","236","107","129","15","251","430","0","58.37","24.88"
"10","007","00","003","0304","0000","1024","437","587","44","1068","1822","0","58.62","23.98"
"10","007","00","003","0304","0382","463","218","245","19","482","856","0","56.31","25.47"
"10","007","00","003","0304","0383","561","219","342","25","586","966","0","60.66","22.67"
"10","007","00","003","0305","0000","1771","788","983","72","1843","3242","0","56.85","24.31"
"10","007","00","003","0305","0384","581","257","324","14","595","1059","0","56.19","24.27"
"10","007","00","003","0305","0385","614","280","334","27","641","1117","0","57.39","25.07"
"10","007","00","003","0305","0386","576","251","325","31","607","1066","0","56.94","23.55"
"10","007","00","003","0306","0000","1417","597","820","70","1487","2780","0","53.49","21.47"
"10","007","00","003","0306","0387","652","285","367","28","680","1252","0","54.31","22.76"
"10","007","00","003","0306","0388","765","312","453","42","807","1528","0","52.81","20.42"
"10","007","00","003","0307","0000","922","426","496","61","983","1680","0","58.51","25.36"
"10","007","00","003","0307","0389","465","228","237","31","496","826","0","60.05","27.6"
"10","007","00","003","0307","0390","457","198","259","30","487","854","0","57.03","23.19"
"10","007","00","003","0308","0000","498","224","274","23","521","860","0","60.58","26.05"
"10","007","00","003","0308","0429","498","224","274","23","521","860","0","60.58","26.05"
"10","007","00","003","0309","0000","1173","487","686","57","1230","2152","0","57.16","22.63"
"10","007","00","003","0309","0391","715","299","416","34","749","1387","0","54.0","21.56"
"10","007","00","003","0309","0392","458","188","270","23","481","765","0","62.88","24.58"
"10","007","00","003","0310","0000","1499","614","885","92","1591","2834","0","56.14","21.67"
"10","007","00","003","0310","0393","711","292","419","43","754","1438","0","52.43","20.31"
"10","007","00","003","0310","0394","788","322","466","49","837","1396","0","59.96","23.07"
"10","007","00","003","0311","0000","862","355","507","42","904","1467","0","61.62","24.2"
"10","007","00","003","0311","0395","374","156","218","14","388","658","0","58.97","23.71"
"10","007","00","003","0311","0396","488","199","289","28","516","809","0","63.78","24.6"
"10","007","00","003","0312","0000","947","413","534","37","984","1820","0","54.07","22.69"
"10","007","00","003","0312","0397","483","213","270","15","498","932","0","53.43","22.85"
"10","007","00","003","0312","0398","464","200","264","22","486","888","0","54.73","22.52"
"10","007","00","003","0313","0000","1259","524","735","59","1318","2221","0","59.34","23.59"
"10","007","00","003","0313","0399","669","295","374","32","701","1144","0","61.28","25.79"
"10","007","00","003","0313","0400","590","229","361","27","617","1077","0","57.29","21.26"
"10","007","00","003","0314","0000","679","326","353","39","718","1349","0","53.22","24.17"
"10","007","00","003","0314","0401","679","326","353","39","718","1349","0","53.22","24.17"
"10","007","00","003","0315","0000","2808","1224","1584","107","2915","5134","0","56.78","23.84"
"10","007","00","003","0315","0402","691","306","385","33","724","1155","0","62.68","26.49"
"10","007","00","003","0315","0403","678","302","376","19","697","1253","0","55.63","24.1"
"10","007","00","003","0315","0404","659","270","389","32","691","1252","0","55.19","21.57"
"10","007","00","003","0315","0405","780","346","434","23","803","1474","0","54.48","23.47"
"10","007","00","003","0316","0000","1111","500","611","63","1174","1910","0","61.47","26.18"
"10","007","00","003","0316","0408","594","260","334","29","623","999","0","62.36","26.03"
"10","007","00","003","0316","0409","517","240","277","34","551","911","0","60.48","26.34"
"10","007","00","003","0317","0000","1442","637","805","66","1508","2632","0","57.29","24.2"
"10","007","00","003","0317","0412","736","309","427","31","767","1308","0","58.64","23.62"
"10","007","00","003","0317","0413","706","328","378","35","741","1324","0","55.97","24.77"
"10","007","00","003","0318","0000","1099","516","583","57","1156","1972","0","58.62","26.17"
"10","007","00","003","0318","0410","573","284","289","20","593","1005","0","59.0","28.26"
"10","007","00","003","0318","0411","526","232","294","37","563","967","0","58.22","23.99"
"10","007","00","003","0319","0000","1861","780","1081","125","1986","3437","0","57.78","22.69"
"10","007","00","003","0319","0414","611","256","355","49","660","1102","0","59.89","23.23"
"10","007","00","003","0319","0415","585","251","334","36","621","1124","0","55.25","22.33"
"10","007","00","003","0319","0416","665","273","392","40","705","1211","0","58.22","22.54"
"10","007","00","003","0320","0000","564","273","291","33","597","884","0","67.53","30.88"
"10","007","00","003","0320","0417","564","273","291","33","597","884","0","67.53","30.88"
"10","007","00","003","0321","0000","1302","582","720","90","1392","2419","0","57.54","24.06"
"10","007","00","003","0321","0418","602","281","321","50","652","1119","0","58.27","25.11"
"10","007","00","003","0321","0419","700","301","399","40","740","1300","0","56.92","23.15"
"10","007","00","003","0322","0000","1292","594","698","58","1350","2317","0","58.26","25.64"
"10","007","00","003","0322","0420","570","276","294","33","603","1104","0","54.62","25.0"
"10","007","00","003","0322","0421","722","318","404","25","747","1213","0","61.58","26.22"
"10","007","00","003","0323","0000","561","268","293","29","590","1127","0","52.35","23.78"
"10","007","00","003","0323","0422","561","268","293","29","590","1127","0","52.35","23.78"
"10","007","00","003","0324","0000","1641","742","899","75","1716","2864","0","59.92","25.91"
"10","007","00","003","0324","0423","500","216","284","26","526","919","0","57.24","23.5"
"10","007","00","003","0324","0424","570","283","287","28","598","987","0","60.59","28.67"
"10","007","00","003","0324","0425","571","243","328","21","592","958","0","61.8","25.37"
"10","007","00","003","0325","0000","2332","907","1425","90","2422","4228","0","57.28","21.45"
"10","007","00","003","0325","0426","765","279","486","30","795","1362","0","58.37","20.48"
"10","007","00","003","0325","0427","783","312","471","33","816","1461","0","55.85","21.36"
"10","007","00","003","0325","0428","784","316","468","27","811","1405","0","57.72","22.49"
"10","007","00","003","0326","0000","940","391","549","71","1011","1746","0","57.9","22.39"
"10","007","00","003","0326","0430","477","178","299","23","500","875","0","57.14","20.34"
"10","007","00","003","0326","0431","463","213","250","48","511","871","0","58.67","24.45"
"10","007","00","003","0327","0000","528","214","314","26","554","883","0","62.74","24.24"
"10","007","00","003","0327","0432","528","214","314","26","554","883","0","62.74","24.24"
"10","007","00","003","0328","0000","645","337","308","35","680","1224","0","55.56","27.53"
"10","007","00","003","0328","0433","645","337","308","35","680","1224","0","55.56","27.53"
"10","007","00","003","0329","0000","1080","476","604","69","1149","2031","0","56.57","23.44"
"10","007","00","003","0329","0434","573","248","325","30","603","1075","0","56.09","23.07"
"10","007","00","003","0329","0435","507","228","279","39","546","956","0","57.11","23.85"
"10","007","00","003","0330","0000","1654","773","881","94","1748","3071","0","56.92","25.17"
"10","007","00","003","0330","0436","547","259","288","35","582","1037","0","56.12","24.98"
"10","007","00","003","0330","0437","563","253","310","22","585","1011","0","57.86","25.02"
"10","007","00","003","0330","0438","544","261","283","37","581","1023","0","56.79","25.51"
"10","007","00","003","0331","0000","858","451","407","58","916","1632","0","56.13","27.63"
"10","007","00","003","0331","0439","376","201","175","22","398","719","0","55.35","27.96"
"10","007","00","003","0331","0440","482","250","232","36","518","913","0","56.74","27.38"
"10","007","00","003","0332","0000","1397","637","760","63","1460","2744","0","53.21","23.21"
"10","007","00","003","0332","0406","692","332","360","31","723","1396","0","51.79","23.78"
"10","007","00","003","0332","0407","705","305","400","32","737","1348","0","54.67","22.63"
"10","007","00","004","0000","0000","7961","3468","4493","497","8458","14065","16872","60.14","24.66"
"10","007","00","004","0401","0000","1285","478","807","51","1336","2237","0","59.72","21.37"
"10","007","00","004","0401","0469","603","243","360","23","626","1071","0","58.45","22.69"
"10","007","00","004","0401","0470","682","235","447","28","710","1166","0","60.89","20.15"
"10","007","00","004","0402","0000","708","281","427","49","757","1269","0","59.65","22.14"
"10","007","00","004","0402","0471","708","281","427","49","757","1269","0","59.65","22.14"
"10","007","00","004","0403","0000","1276","559","717","100","1376","2266","0","60.72","24.67"
"10","007","00","004","0403","0472","619","265","354","35","654","1138","0","57.47","23.29"
"10","007","00","004","0403","0473","657","294","363","65","722","1128","0","64.01","26.06"
"10","007","00","004","0404","0000","724","303","421","53","777","1275","0","60.94","23.76"
"10","007","00","004","0404","0474","724","303","421","53","777","1275","0","60.94","23.76"
"10","007","00","004","0405","0000","675","296","379","33","708","1187","0","59.65","24.94"
"10","007","00","004","0405","0475","675","296","379","33","708","1187","0","59.65","24.94"
"10","007","00","004","0406","0000","1086","626","460","88","1174","1929","0","60.86","32.45"
"10","007","00","004","0406","0476","562","269","293","44","606","991","0","61.15","27.14"
"10","007","00","004","0406","0477","524","357","167","44","568","938","0","60.55","38.06"
"10","007","00","004","0407","0000","1370","596","774","78","1448","2561","0","56.54","23.27"
"10","007","00","004","0407","0478","654","286","368","36","690","1276","0","54.08","22.41"
"10","007","00","004","0407","0479","716","310","406","42","758","1285","0","58.99","24.12"
"10","007","00","004","0408","0000","837","329","508","45","882","1341","0","65.77","24.53"
"10","007","00","004","0408","0480","837","329","508","45","882","1341","0","65.77","24.53"
"10","007","00","005","0000","0000","16272","7149","9123","1026","17298","30407","37062","56.89","23.51"
"10","007","00","005","0501","0000","854","414","440","54","908","1700","0","53.41","24.35"
"10","007","00","005","0501","0456","443","234","209","35","478","854","0","55.97","27.4"
"10","007","00","005","0501","0457","411","180","231","19","430","846","0","50.83","21.28"
"10","007","00","005","0502","0000","563","321","242","54","617","1143","0","53.98","28.08"
"10","007","00","005","0502","0458","563","321","242","54","617","1143","0","53.98","28.08"
"10","007","00","005","0503","0000","730","331","399","50","780","1317","0","59.23","25.13"
"10","007","00","005","0503","0463","730","331","399","50","780","1317","0","59.23","25.13"
"10","007","00","005","0504","0000","999","472","527","73","1072","1912","0","56.07","24.69"
"10","007","00","005","0504","0447","475","226","249","37","512","904","0","56.64","25.0"
"10","007","00","005","0504","0448","524","246","278","36","560","1008","0","55.56","24.4"
"10","007","00","005","0505","0000","1110","484","626","87","1197","1993","0","60.06","24.28"
"10","007","00","005","0505","0453","597","274","323","55","652","1085","0","60.09","25.25"
"10","007","00","005","0505","0454","513","210","303","32","545","908","0","60.02","23.13"
"10","007","00","005","0506","0000","728","310","418","40","768","1264","0","60.76","24.53"
"10","007","00","005","0506","0455","728","310","418","40","768","1264","0","60.76","24.53"
"10","007","00","005","0507","0000","1018","470","548","46","1064","1839","0","57.86","25.56"
"10","007","00","005","0507","0443","547","251","296","23","570","966","0","59.01","25.98"
"10","007","00","005","0507","0444","471","219","252","23","494","873","0","56.59","25.09"
"10","007","00","005","0508","0000","866","317","549","118","984","1687","0","58.33","18.79"
"10","007","00","005","0508","0445","410","154","256","82","492","812","0","60.59","18.97"
"10","007","00","005","0508","0446","456","163","293","36","492","875","0","56.23","18.63"
"10","007","00","005","0509","0000","1382","573","809","86","1468","2640","0","55.61","21.7"
"10","007","00","005","0509","0449","642","241","401","42","684","1154","0","59.27","20.88"
"10","007","00","005","0509","0450","740","332","408","44","784","1486","0","52.76","22.34"
"10","007","00","005","0510","0000","2763","1182","1581","134","2897","5139","0","56.37","23.0"
"10","007","00","005","0510","0459","736","323","413","28","764","1357","0","56.3","23.8"
"10","007","00","005","0510","0460","709","288","421","42","751","1349","0","55.67","21.35"
"10","007","00","005","0510","0461","644","270","374","39","683","1154","0","59.19","23.4"
"10","007","00","005","0510","0462","674","301","373","25","699","1279","0","54.65","23.53"
"10","007","00","005","0511","0000","1109","452","657","61","1170","2182","0","53.62","20.71"
"10","007","00","005","0511","0451","571","224","347","39","610","1095","0","55.71","20.46"
"10","007","00","005","0511","0452","538","228","310","22","560","1087","0","51.52","20.98"
"10","007","00","005","0512","0000","1305","555","750","50","1355","2348","0","57.71","23.64"
"10","007","00","005","0512","0441","615","260","355","19","634","1182","0","53.64","22.0"
"10","007","00","005","0512","0442","690","295","395","31","721","1166","0","61.84","25.3"
"10","007","00","005","0513","0000","1726","763","963","73","1799","3020","0","59.57","25.26"
"10","007","00","005","0513","0464","584","274","310","25","609","990","0","61.52","27.68"
"10","007","00","005","0513","0465","489","215","274","18","507","852","0","59.51","25.23"
"10","007","00","005","0513","0466","653","274","379","30","683","1178","0","57.98","23.26"
"10","007","00","005","0514","0000","1119","505","614","100","1219","2223","0","54.84","22.72"
"10","007","00","005","0514","0467","517","253","264","50","567","1088","0","52.11","23.25"
"10","007","00","005","0514","0468","602","252","350","50","652","1135","0","57.44","22.2"
"10","007","00","006","0000","0000","20436","10101","10335","1342","21778","39745","47166","54.79","25.41"
"10","007","00","006","0601","0000","770","380","390","34","804","1492","0","53.89","25.47"
"10","007","00","006","0601","0319","770","380","390","34","804","1492","0","53.89","25.47"
"10","007","00","006","0602","0000","666","321","345","33","699","1458","0","47.94","22.02"
"10","007","00","006","0602","0318","666","321","345","33","699","1458","0","47.94","22.02"
"10","007","00","006","0603","0000","632","280","352","32","664","1251","0","53.08","22.38"
"10","007","00","006","0603","0313","632","280","352","32","664","1251","0","53.08","22.38"
"10","007","00","006","0604","0000","732","337","395","41","773","1464","0","52.8","23.02"
"10","007","00","006","0604","0312","732","337","395","41","773","1464","0","52.8","23.02"
"10","007","00","006","0605","0000","582","319","263","58","640","1166","0","54.89","27.36"
"10","007","00","006","0605","0311","582","319","263","58","640","1166","0","54.89","27.36"
"10","007","00","006","0606","0000","623","309","314","46","669","1256","0","53.26","24.6"
"10","007","00","006","0606","0310","623","309","314","46","669","1256","0","53.26","24.6"
"10","007","00","006","0607","0000","704","369","335","39","743","1363","0","54.51","27.07"
"10","007","00","006","0607","0308","704","369","335","39","743","1363","0","54.51","27.07"
"10","007","00","006","0608","0000","447","207","240","25","472","821","0","57.49","25.21"
"10","007","00","006","0608","0309","447","207","240","25","472","821","0","57.49","25.21"
"10","007","00","006","0609","0000","1200","581","619","63","1263","2425","0","52.08","23.96"
"10","007","00","006","0609","0314","749","350","399","33","782","1465","0","53.38","23.89"
"10","007","00","006","0609","0315","451","231","220","30","481","960","0","50.1","24.06"
"10","007","00","006","0610","0000","1401","994","407","78","1479","2688","0","55.02","36.98"
"10","007","00","006","0610","0316","675","336","339","45","720","1323","0","54.42","25.4"
"10","007","00","006","0610","0317","726","658","68","33","759","1365","0","55.6","48.21"
"10","007","00","006","0611","0000","1248","579","669","69","1317","2477","0","53.17","23.38"
"10","007","00","006","0611","0324","542","248","294","32","574","1085","0","52.9","22.86"
"10","007","00","006","0611","0325","706","331","375","37","743","1392","0","53.38","23.78"
"10","007","00","006","0612","0000","667","310","357","37","704","1216","0","57.89","25.49"
"10","007","00","006","0612","0331","667","310","357","37","704","1216","0","57.89","25.49"
"10","007","00","006","0613","0000","546","300","246","46","592","1063","0","55.69","28.22"
"10","007","00","006","0613","0332","546","300","246","46","592","1063","0","55.69","28.22"
"10","007","00","006","0614","0000","1177","551","626","109","1286","2229","0","57.69","24.72"
"10","007","00","006","0614","0339","628","302","326","46","674","1079","0","62.47","27.99"
"10","007","00","006","0614","0340","549","249","300","63","612","1150","0","53.22","21.65"
"10","007","00","006","0615","0000","1019","469","550","63","1082","1921","0","56.32","24.41"
"10","007","00","006","0615","0337","531","221","310","29","560","926","0","60.48","23.87"
"10","007","00","006","0615","0338","488","248","240","34","522","995","0","52.46","24.92"
"10","007","00","006","0616","0000","1205","505","700","100","1305","2305","0","56.62","21.91"
"10","007","00","006","0616","0335","531","233","298","30","561","994","0","56.44","23.44"
"10","007","00","006","0616","0336","674","272","402","70","744","1311","0","56.75","20.75"
"10","007","00","006","0617","0000","569","227","342","38","607","1287","0","47.16","17.64"
"10","007","00","006","0617","0334","569","227","342","38","607","1287","0","47.16","17.64"
"10","007","00","006","0618","0000","651","288","363","55","706","1306","0","54.06","22.05"
"10","007","00","006","0618","0333","651","288","363","55","706","1306","0","54.06","22.05"
"10","007","00","006","0619","0000","2104","1100","1004","107","2211","3672","0","60.21","29.96"
"10","007","00","006","0619","0326","727","356","371","46","773","1316","0","58.74","27.05"
"10","007","00","006","0619","0327","722","449","273","33","755","1255","0","60.16","35.78"
"10","007","00","006","0619","0328","655","295","360","28","683","1101","0","62.03","26.79"
"10","007","00","006","0620","0000","1276","613","663","122","1398","2560","0","54.61","23.95"
"10","007","00","006","0620","0329","604","304","300","55","659","1167","0","56.47","26.05"
"10","007","00","006","0620","0330","672","309","363","67","739","1393","0","53.05","22.18"
"10","007","00","006","0621","0000","1183","553","630","81","1264","2383","0","53.04","23.21"
"10","007","00","006","0621","0322","488","227","261","37","525","1043","0","50.34","21.76"
"10","007","00","006","0621","0323","695","326","369","44","739","1340","0","55.15","24.33"
"10","007","00","006","0622","0000","1034","509","525","66","1100","1942","0","56.64","26.21"
"10","007","00","006","0622","0320","446","229","217","17","463","888","0","52.14","25.79"
"10","007","00","006","0622","0321","588","280","308","49","637","1054","0","60.44","26.57"
"10","007","00","007","0000","0000","18422","8386","10036","965","19387","32394","39300","59.85","25.89"
"10","007","00","007","0701","0000","999","477","522","68","1067","1686","0","63.29","28.29"
"10","007","00","007","0701","0341","631","301","330","39","670","1066","0","62.85","28.24"
"10","007","00","007","0701","0342","368","176","192","29","397","620","0","64.03","28.39"
"10","007","00","007","0702","0000","1154","577","577","40","1194","2072","0","57.63","27.85"
"10","007","00","007","0702","0343","446","220","226","11","457","876","0","52.17","25.11"
"10","007","00","007","0702","0344","708","357","351","29","737","1196","0","61.62","29.85"
"10","007","00","007","0703","0000","1473","678","795","77","1550","2642","0","58.67","25.66"
"10","007","00","007","0703","0345","758","356","402","34","792","1369","0","57.85","26.0"
"10","007","00","007","0703","0346","715","322","393","43","758","1273","0","59.54","25.29"
"10","007","00","007","0704","0000","1095","457","638","36","1131","1888","0","59.9","24.21"
"10","007","00","007","0704","0348","558","229","329","18","576","967","0","59.57","23.68"
"10","007","00","007","0704","0349","537","228","309","18","555","921","0","60.26","24.76"
"10","007","00","007","0705","0000","775","294","481","32","807","1433","0","56.32","20.52"
"10","007","00","007","0705","0347","775","294","481","32","807","1433","0","56.32","20.52"
"10","007","00","007","0706","0000","2243","1026","1217","121","2364","3910","0","60.46","26.24"
"10","007","00","007","0706","0350","413","201","212","21","434","689","0","62.99","29.17"
"10","007","00","007","0706","0351","397","174","223","24","421","688","0","61.19","25.29"
"10","007","00","007","0706","0352","750","360","390","35","785","1252","0","62.7","28.75"
"10","007","00","007","0706","0353","683","291","392","41","724","1281","0","56.52","22.72"
"10","007","00","007","0707","0000","1744","749","995","75","1819","3211","0","56.65","23.33"
"10","007","00","007","0707","0354","415","168","247","23","438","754","0","58.09","22.28"
"10","007","00","007","0707","0355","570","275","295","25","595","1024","0","58.11","26.86"
"10","007","00","007","0707","0356","759","306","453","27","786","1433","0","54.85","21.35"
"10","007","00","007","0708","0000","1361","625","736","71","1432","2261","0","63.33","27.64"
"10","007","00","007","0708","0357","846","378","468","39","885","1366","0","64.79","27.67"
"10","007","00","007","0708","0358","515","247","268","32","547","895","0","61.12","27.6"
"10","007","00","007","0709","0000","719","326","393","39","758","1386","0","54.69","23.52"
"10","007","00","007","0709","0359","719","326","393","39","758","1386","0","54.69","23.52"
"10","007","00","007","0710","0000","2659","1210","1449","155","2814","4454","0","63.18","27.17"
"10","007","00","007","0710","0360","499","246","253","46","545","896","0","60.83","27.46"
"10","007","00","007","0710","0361","508","233","275","28","536","804","0","66.67","28.98"
"10","007","00","007","0710","0362","496","212","284","25","521","827","0","63.0","25.63"
"10","007","00","007","0710","0363","565","256","309","27","592","996","0","59.44","25.7"
"10","007","00","007","0710","0364","591","263","328","29","620","931","0","66.6","28.25"
"10","007","00","007","0711","0000","1118","503","615","66","1184","1944","0","60.91","25.87"
"10","007","00","007","0711","0365","386","184","202","27","413","715","0","57.76","25.73"
"10","007","00","007","0711","0366","732","319","413","39","771","1229","0","62.73","25.96"
"10","007","00","007","0712","0000","927","415","512","54","981","1701","0","57.67","24.4"
"10","007","00","007","0712","0367","439","193","246","26","465","890","0","52.25","21.69"
"10","007","00","007","0712","0368","488","222","266","28","516","811","0","63.63","27.37"
"10","007","00","007","0713","0000","995","473","522","45","1040","1717","0","60.57","27.55"
"10","007","00","007","0713","0369","472","211","261","20","492","786","0","62.6","26.84"
"10","007","00","007","0713","0370","523","262","261","25","548","931","0","58.86","28.14"
"10","007","00","007","0714","0000","1160","576","584","86","1246","2089","0","59.65","27.57"
"10","007","00","007","0714","0371","711","321","390","59","770","1265","0","60.87","25.38"
"10","007","00","007","0714","0372","449","255","194","27","476","824","0","57.77","30.95"
"10","007","00","008","0000","0000","21769","9653","12116","1418","23187","38924","45922","59.57","24.8"
"10","007","00","008","0801","0000","1818","796","1022","87","1905","3257","0","58.49","24.44"
"10","007","00","008","0801","0185","505","225","280","42","547","901","0","60.71","24.97"
"10","007","00","008","0801","0186","620","274","346","31","651","1042","0","62.48","26.3"
"10","007","00","008","0801","0187","693","297","396","14","707","1314","0","53.81","22.6"
"10","007","00","008","0802","0000","1032","476","556","63","1095","1827","0","59.93","26.05"
"10","007","00","008","0802","0188","481","208","273","24","505","808","0","62.5","25.74"
"10","007","00","008","0802","0189","551","268","283","39","590","1019","0","57.9","26.3"
"10","007","00","008","0803","0000","1319","599","720","135","1454","2384","0","60.99","25.13"
"10","007","00","008","0803","0190","637","324","313","75","712","1144","0","62.24","28.32"
"10","007","00","008","0803","0191","682","275","407","60","742","1240","0","59.84","22.18"
"10","007","00","008","0804","0000","651","291","360","51","702","1095","0","64.11","26.58"
"10","007","00","008","0804","0193","651","291","360","51","702","1095","0","64.11","26.58"
"10","007","00","008","0805","0000","815","353","462","67","882","1425","0","61.89","24.77"
"10","007","00","008","0805","0192","815","353","462","67","882","1425","0","61.89","24.77"
"10","007","00","008","0806","0000","1089","500","589","58","1147","1892","0","60.62","26.43"
"10","007","00","008","0806","0194","525","236","289","26","551","910","0","60.55","25.93"
"10","007","00","008","0806","0195","564","264","300","32","596","982","0","60.69","26.88"
"10","007","00","008","0807","0000","478","217","261","30","508","764","0","66.49","28.4"
"10","007","00","008","0807","0198","478","217","261","30","508","764","0","66.49","28.4"
"10","007","00","008","0808","0000","974","446","528","33","1007","1770","0","56.89","25.2"
"10","007","00","008","0808","0196","609","271","338","13","622","1070","0","58.13","25.33"
"10","007","00","008","0808","0197","365","175","190","20","385","700","0","55.0","25.0"
"10","007","00","008","0809","0000","2779","1136","1643","145","2924","4967","0","58.87","22.87"
"10","007","00","008","0809","0207","610","246","364","30","640","1169","0","54.75","21.04"
"10","007","00","008","0809","0208","736","329","407","32","768","1274","0","60.28","25.82"
"10","007","00","008","0809","0209","757","272","485","38","795","1280","0","62.11","21.25"
"10","007","00","008","0809","0210","676","289","387","45","721","1244","0","57.96","23.23"
"10","007","00","008","0810","0000","1709","733","976","103","1812","3038","0","59.64","24.13"
"10","007","00","008","0810","0199","567","253","314","40","607","953","0","63.69","26.55"
"10","007","00","008","0810","0200","538","213","325","19","557","974","0","57.19","21.87"
"10","007","00","008","0810","0201","604","267","337","44","648","1111","0","58.33","24.03"
"10","007","00","008","0811","0000","2511","1015","1496","168","2679","4576","0","58.54","22.18"
"10","007","00","008","0811","0202","621","215","406","53","674","1101","0","61.22","19.53"
"10","007","00","008","0811","0203","575","228","347","43","618","1110","0","55.68","20.54"
"10","007","00","008","0811","0204","685","292","393","51","736","1262","0","58.32","23.14"
"10","007","00","008","0811","0205","630","280","350","21","651","1103","0","59.02","25.39"
"10","007","00","008","0812","0000","649","306","343","111","760","1347","0","56.42","22.72"
"10","007","00","008","0812","0206","649","306","343","111","760","1347","0","56.42","22.72"
"10","007","00","008","0813","0000","1861","906","955","110","1971","3312","0","59.51","27.36"
"10","007","00","008","0813","0211","639","370","269","45","684","1159","0","59.02","31.92"
"10","007","00","008","0813","0212","630","265","365","30","660","1042","0","63.34","25.43"
"10","007","00","008","0813","0213","592","271","321","35","627","1111","0","56.44","24.39"
"10","007","00","008","0814","0000","533","229","304","39","572","893","0","64.05","25.64"
"10","007","00","008","0814","0214","533","229","304","39","572","893","0","64.05","25.64"
"10","007","00","008","0815","0000","525","220","305","43","568","953","0","59.6","23.08"
"10","007","00","008","0815","0215","525","220","305","43","568","953","0","59.6","23.08"
"10","007","00","008","0816","0000","1097","525","572","72","1169","1912","0","61.14","27.46"
"10","007","00","008","0816","0216","526","258","268","32","558","987","0","56.53","26.14"
"10","007","00","008","0816","0217","571","267","304","40","611","925","0","66.05","28.86"
"10","007","00","008","0817","0000","1032","520","512","67","1099","1906","0","57.66","27.28"
"10","007","00","008","0817","0218","516","318","198","38","554","951","0","58.25","33.44"
"10","007","00","008","0817","0219","516","202","314","29","545","955","0","57.07","21.15"
"10","007","00","008","0818","0000","897","385","512","36","933","1606","0","58.09","23.97"
"10","007","00","008","0818","0220","489","193","296","20","509","895","0","56.87","21.56"
"10","007","00","008","0818","0221","408","192","216","16","424","711","0","59.63","27.0"
"10","007","00","009","0000","0000","10725","4761","5964","775","11500","20408","23594","56.35","23.33"
"10","007","00","009","0901","0000","932","400","532","68","1000","1752","0","57.08","22.83"
"10","007","00","009","0901","0222","511","226","285","29","540","958","0","56.37","23.59"
"10","007","00","009","0901","0223","421","174","247","39","460","794","0","57.93","21.91"
"10","007","00","009","0902","0000","678","281","397","75","753","1415","0","53.22","19.86"
"10","007","00","009","0902","0224","678","281","397","75","753","1415","0","53.22","19.86"
"10","007","00","009","0903","0000","983","416","567","64","1047","1758","0","59.56","23.66"
"10","007","00","009","0903","0225","545","244","301","28","573","927","0","61.81","26.32"
"10","007","00","009","0903","0226","438","172","266","36","474","831","0","57.04","20.7"
"10","007","00","009","0904","0000","1256","515","741","93","1349","2465","0","54.73","20.89"
"10","007","00","009","0904","0228","626","273","353","40","666","1227","0","54.28","22.25"
"10","007","00","009","0904","0229","630","242","388","53","683","1238","0","55.17","19.55"
"10","007","00","009","0905","0000","1286","569","717","104","1390","2351","0","59.12","24.2"
"10","007","00","009","0905","0230","719","310","409","72","791","1362","0","58.08","22.76"
"10","007","00","009","0905","0231","567","259","308","32","599","989","0","60.57","26.19"
"10","007","00","009","0906","0000","998","417","581","76","1074","1661","0","64.66","25.11"
"10","007","00","009","0906","0232","629","261","368","43","672","1054","0","63.76","24.76"
"10","007","00","009","0906","0233","369","156","213","33","402","607","0","66.23","25.7"
"10","007","00","009","0907","0000","510","228","282","26","536","882","0","60.77","25.85"
"10","007","00","009","0907","0234","510","228","282","26","536","882","0","60.77","25.85"
"10","007","00","009","0908","0000","527","217","310","36","563","1143","0","49.26","18.99"
"10","007","00","009","0908","0235","527","217","310","36","563","1143","0","49.26","18.99"
"10","007","00","009","0909","0000","328","141","187","16","344","661","0","52.04","21.33"
"10","007","00","009","0909","0236","328","141","187","16","344","661","0","52.04","21.33"
"10","007","00","009","0910","0000","866","446","420","26","892","1685","0","52.94","26.47"
"10","007","00","009","0910","0237","430","226","204","9","439","838","0","52.39","26.97"
"10","007","00","009","0910","0238","436","220","216","17","453","847","0","53.48","25.97"
"10","007","00","009","0911","0000","547","218","329","45","592","987","0","59.98","22.09"
"10","007","00","009","0911","0239","547","218","329","45","592","987","0","59.98","22.09"
"10","007","00","009","0912","0000","603","297","306","50","653","1217","0","53.66","24.4"
"10","007","00","009","0912","0240","603","297","306","50","653","1217","0","53.66","24.4"
"10","007","00","009","0913","0000","411","200","211","42","453","865","0","52.37","23.12"
"10","007","00","009","0913","0241","411","200","211","42","453","865","0","52.37","23.12"
"10","007","00","009","0914","0000","481","263","218","39","520","996","0","52.21","26.41"
"10","007","00","009","0914","0242","481","263","218","39","520","996","0","52.21","26.41"
"10","007","00","009","0915","0000","319","153","166","15","334","570","0","58.6","26.84"
"10","007","00","009","0915","0227","319","153","166","15","334","570","0","58.6","26.84"
"10","007","00","010","0000","0000","55727","24024","31703","2545","58272","102028","124755","57.11","23.55"
"10","007","00","010","1001","0000","589","266","323","29","618","1063","0","58.14","25.02"
"10","007","00","010","1001","0504","589","266","323","29","618","1063","0","58.14","25.02"
"10","007","00","010","1002","0000","1558","836","722","70","1628","2788","0","58.39","29.99"
"10","007","00","010","1002","0505","506","408","98","14","520","925","0","56.22","44.11"
"10","007","00","010","1002","0506","524","218","306","33","557","947","0","58.82","23.02"
"10","007","00","010","1002","0507","528","210","318","23","551","916","0","60.15","22.93"
"10","007","00","010","1003","0000","1742","705","1037","88","1830","3174","0","57.66","22.21"
"10","007","00","010","1003","0528","475","208","267","14","489","867","0","56.4","23.99"
"10","007","00","010","1003","0529","647","243","404","29","676","1201","0","56.29","20.23"
"10","007","00","010","1003","0530","620","254","366","45","665","1106","0","60.13","22.97"
"10","007","00","010","1004","0000","1455","615","840","83","1538","2588","0","59.43","23.76"
"10","007","00","010","1004","0531","479","218","261","29","508","845","0","60.12","25.8"
"10","007","00","010","1004","0532","501","208","293","26","527","894","0","58.95","23.27"
"10","007","00","010","1004","0533","475","189","286","28","503","849","0","59.25","22.26"
"10","007","00","010","1005","0000","462","240","222","11","473","747","0","63.32","32.13"
"10","007","00","010","1005","0534","462","240","222","11","473","747","0","63.32","32.13"
"10","007","00","010","1006","0000","1513","649","864","77","1590","2824","0","56.3","22.98"
"10","007","00","010","1006","0535","525","234","291","30","555","884","0","62.78","26.47"
"10","007","00","010","1006","0536","457","170","287","21","478","900","0","53.11","18.89"
"10","007","00","010","1006","0537","531","245","286","26","557","1040","0","53.56","23.56"
"10","007","00","010","1007","0000","474","224","250","15","489","831","0","58.84","26.96"
"10","007","00","010","1007","0538","474","224","250","15","489","831","0","58.84","26.96"
"10","007","00","010","1008","0000","379","194","185","17","396","591","0","67.01","32.83"
"10","007","00","010","1008","0539","379","194","185","17","396","591","0","67.01","32.83"
"10","007","00","010","1009","0000","1010","435","575","35","1045","1849","0","56.52","23.53"
"10","007","00","010","1009","0508","459","193","266","22","481","862","0","55.8","22.39"
"10","007","00","010","1009","0509","551","242","309","13","564","987","0","57.14","24.52"
"10","007","00","010","1010","0000","3130","1386","1744","134","3264","5677","0","57.5","24.41"
"10","007","00","010","1010","0510","567","257","310","34","601","1085","0","55.39","23.69"
"10","007","00","010","1010","0511","618","265","353","21","639","1110","0","57.57","23.87"
"10","007","00","010","1010","0512","565","239","326","16","581","1095","0","53.06","21.83"
"10","007","00","010","1010","0513","761","355","406","27","788","1278","0","61.66","27.78"
"10","007","00","010","1010","0514","619","270","349","36","655","1109","0","59.06","24.35"
"10","007","00","010","1011","0000","1293","565","728","47","1340","2487","0","53.88","22.72"
"10","007","00","010","1011","0561","607","282","325","25","632","1131","0","55.88","24.93"
"10","007","00","010","1011","0562","686","283","403","22","708","1356","0","52.21","20.87"
"10","007","00","010","1012","0000","2396","1076","1320","97","2493","4191","0","59.48","25.67"
"10","007","00","010","1012","0563","736","345","391","35","771","1370","0","56.28","25.18"
"10","007","00","010","1012","0564","617","299","318","23","640","1090","0","58.72","27.43"
"10","007","00","010","1012","0565","520","233","287","16","536","821","0","65.29","28.38"
"10","007","00","010","1012","0566","523","199","324","23","546","910","0","60.0","21.87"
"10","007","00","010","1013","0000","2797","1173","1624","109","2906","4993","0","58.2","23.49"
"10","007","00","010","1013","0567","653","249","404","37","690","1203","0","57.36","20.7"
"10","007","00","010","1013","0568","758","337","421","24","782","1378","0","56.75","24.46"
"10","007","00","010","1013","0569","751","305","446","26","777","1352","0","57.47","22.56"
"10","007","00","010","1013","0570","635","282","353","22","657","1060","0","61.98","26.6"
"10","007","00","010","1014","0000","2420","943","1477","114","2534","4559","0","55.58","20.68"
"10","007","00","010","1014","0571","691","287","404","32","723","1317","0","54.9","21.79"
"10","007","00","010","1014","0572","591","252","339","26","617","1120","0","55.09","22.5"
"10","007","00","010","1014","0573","529","169","360","30","559","1025","0","54.54","16.49"
"10","007","00","010","1014","0574","609","235","374","26","635","1097","0","57.89","21.42"
"10","007","00","010","1015","0000","935","409","526","50","985","1696","0","58.08","24.12"
"10","007","00","010","1015","0575","492","217","275","27","519","859","0","60.42","25.26"
"10","007","00","010","1015","0576","443","192","251","23","466","837","0","55.68","22.94"
"10","007","00","010","1016","0000","1239","561","678","70","1309","2163","0","60.52","25.94"
"10","007","00","010","1016","0577","651","282","369","34","685","1090","0","62.84","25.87"
"10","007","00","010","1016","0578","588","279","309","36","624","1073","0","58.15","26.0"
"10","007","00","010","1017","0000","1407","592","815","44","1451","2625","0","55.28","22.55"
"10","007","00","010","1017","0540","688","307","381","27","715","1330","0","53.76","23.08"
"10","007","00","010","1017","0541","719","285","434","17","736","1295","0","56.83","22.01"
"10","007","00","010","1018","0000","3362","1397","1965","139","3501","6205","0","56.42","22.51"
"10","007","00","010","1018","0545","664","277","387","26","690","1176","0","58.67","23.55"
"10","007","00","010","1018","0546","431","171","260","8","439","867","0","50.63","19.72"
"10","007","00","010","1018","0547","592","252","340","31","623","1121","0","55.58","22.48"
"10","007","00","010","1018","0548","610","233","377","24","634","1190","0","53.28","19.58"
"10","007","00","010","1018","0549","538","228","310","27","565","945","0","59.79","24.13"
"10","007","00","010","1018","0550","527","236","291","23","550","906","0","60.71","26.05"
"10","007","00","010","1019","0000","1644","689","955","76","1720","2876","0","59.81","23.96"
"10","007","00","010","1019","0551","568","263","305","29","597","978","0","61.04","26.89"
"10","007","00","010","1019","0552","528","197","331","26","554","949","0","58.38","20.76"
"10","007","00","010","1019","0553","548","229","319","21","569","949","0","59.96","24.13"
"10","007","00","010","1020","0000","1042","490","552","73","1115","1931","0","57.74","25.38"
"10","007","00","010","1020","0515","560","256","304","45","605","1055","0","57.35","24.27"
"10","007","00","010","1020","0516","482","234","248","28","510","876","0","58.22","26.71"
"10","007","00","010","1021","0000","1193","537","656","56","1249","2301","0","54.28","23.34"
"10","007","00","010","1021","0517","534","246","288","25","559","1115","0","50.13","22.06"
"10","007","00","010","1021","0518","659","291","368","31","690","1186","0","58.18","24.54"
"10","007","00","010","1022","0000","1746","670","1076","77","1823","3195","0","57.06","20.97"
"10","007","00","010","1022","0519","579","223","356","25","604","995","0","60.7","22.41"
"10","007","00","010","1022","0520","541","213","328","21","562","999","0","56.26","21.32"
"10","007","00","010","1022","0521","626","234","392","31","657","1201","0","54.7","19.48"
"10","007","00","010","1023","0000","1207","485","722","44","1251","2428","0","51.52","19.98"
"10","007","00","010","1023","0522","627","237","390","23","650","1342","0","48.44","17.66"
"10","007","00","010","1023","0523","580","248","332","21","601","1086","0","55.34","22.84"
"10","007","00","010","1024","0000","2076","867","1209","80","2156","3624","0","59.49","23.92"
"10","007","00","010","1024","0524","438","195","243","20","458","854","0","53.63","22.83"
"10","007","00","010","1024","0525","586","232","354","23","609","1064","0","57.24","21.8"
"10","007","00","010","1024","0526","514","229","285","14","528","879","0","60.07","26.05"
"10","007","00","010","1024","0527","538","211","327","23","561","827","0","67.84","25.51"
"10","007","00","010","1025","0000","1243","454","789","51","1294","2440","0","53.03","18.61"
"10","007","00","010","1025","0481","549","178","371","24","573","1087","0","52.71","16.38"
"10","007","00","010","1025","0482","694","276","418","27","721","1353","0","53.29","20.4"
"10","007","00","010","1026","0000","1248","614","634","58","1306","2641","0","49.45","23.25"
"10","007","00","010","1026","0483","613","367","246","43","656","1313","0","49.96","27.95"
"10","007","00","010","1026","0484","635","247","388","15","650","1328","0","48.95","18.6"
"10","007","00","010","1027","0000","1508","679","829","77","1585","2786","0","56.89","24.37"
"10","007","00","010","1027","0485","582","271","311","21","603","1055","0","57.16","25.69"
"10","007","00","010","1027","0486","499","215","284","32","531","959","0","55.37","22.42"
"10","007","00","010","1027","0487","427","193","234","24","451","772","0","58.42","25.0"
"10","007","00","010","1028","0000","867","435","432","44","911","1685","0","54.07","25.82"
"10","007","00","010","1028","0488","483","242","241","33","516","831","0","62.09","29.12"
"10","007","00","010","1028","0489","384","193","191","11","395","854","0","46.25","22.6"
"10","007","00","010","1029","0000","508","245","263","33","541","1190","0","45.46","20.59"
"10","007","00","010","1029","0490","508","245","263","33","541","1190","0","45.46","20.59"
"10","007","00","010","1030","0000","380","138","242","19","399","726","0","54.96","19.01"
"10","007","00","010","1030","0491","380","138","242","19","399","726","0","54.96","19.01"
"10","007","00","010","1031","0000","1022","480","542","70","1092","1984","0","55.04","24.19"
"10","007","00","010","1031","0492","598","277","321","35","633","1124","0","56.32","24.64"
"10","007","00","010","1031","0493","424","203","221","35","459","860","0","53.37","23.6"
"10","007","00","010","1032","0000","1246","527","719","78","1324","2197","0","60.26","23.99"
"10","007","00","010","1032","0494","645","280","365","36","681","1122","0","60.7","24.96"
"10","007","00","010","1032","0495","601","247","354","42","643","1075","0","59.81","22.98"
"10","007","00","010","1033","0000","1016","459","557","66","1082","1960","0","55.2","23.42"
"10","007","00","010","1033","0496","509","230","279","41","550","993","0","55.39","23.16"
"10","007","00","010","1033","0497","507","229","278","25","532","967","0","55.02","23.68"
"10","007","00","010","1034","0000","975","433","542","67","1042","1812","0","57.51","23.9"
"10","007","00","010","1034","0498","545","262","283","38","583","1008","0","57.84","25.99"
"10","007","00","010","1034","0499","430","171","259","29","459","804","0","57.09","21.27"
"10","007","00","010","1035","0000","928","405","523","46","974","1752","0","55.59","23.12"
"10","007","00","010","1035","0500","465","195","270","20","485","867","0","55.94","22.49"
"10","007","00","010","1035","0501","463","210","253","26","489","885","0","55.25","23.73"
"10","007","00","010","1036","0000","1204","516","688","37","1241","2352","0","52.76","21.94"
"10","007","00","010","1036","0502","536","220","316","14","550","1097","0","50.14","20.05"
"10","007","00","010","1036","0503","668","296","372","23","691","1255","0","55.06","23.59"
"10","007","00","010","1037","0000","1606","690","916","67","1673","2818","0","59.37","24.49"
"10","007","00","010","1037","0554","544","230","314","26","570","1006","0","56.66","22.86"
"10","007","00","010","1037","0555","502","222","280","26","528","889","0","59.39","24.97"
"10","007","00","010","1037","0556","560","238","322","15","575","923","0","62.3","25.79"
"10","007","00","010","1038","0000","1346","545","801","56","1402","2284","0","61.38","23.86"
"10","007","00","010","1038","0557","714","261","453","33","747","1209","0","61.79","21.59"
"10","007","00","010","1038","0558","632","284","348","23","655","1075","0","60.93","26.42"
"10","007","00","010","1039","0000","1478","703","775","53","1531","2381","0","64.3","29.53"
"10","007","00","010","1039","0559","808","388","420","26","834","1342","0","62.15","28.91"
"10","007","00","010","1039","0560","670","315","355","27","697","1039","0","67.08","30.32"
"10","007","00","010","1040","0000","854","184","670","27","881","1388","0","63.47","13.26"
"10","007","00","010","1040","0544","854","184","670","27","881","1388","0","63.47","13.26"
"10","007","00","010","1041","0000","1229","513","716","61","1290","2226","0","57.95","23.05"
"10","007","00","010","1041","0542","683","295","388","34","717","1283","0","55.88","22.99"
"10","007","00","010","1041","0543","546","218","328","27","573","943","0","60.76","23.12"
"10","007","00","011","0000","0000","25107","10763","14344","1310","26417","45147","55412","58.51","23.84"
"10","007","00","011","1101","0000","656","316","340","27","683","1221","0","55.94","25.88"
"10","007","00","011","1101","0640","656","316","340","27","683","1221","0","55.94","25.88"
"10","007","00","011","1102","0000","385","162","223","24","409","638","0","64.11","25.39"
"10","007","00","011","1102","0641","385","162","223","24","409","638","0","64.11","25.39"
"10","007","00","011","1103","0000","1036","413","623","43","1079","1785","0","60.45","23.14"
"10","007","00","011","1103","0642","469","211","258","21","490","817","0","59.98","25.83"
"10","007","00","011","1103","0643","567","202","365","22","589","968","0","60.85","20.87"
"10","007","00","011","1104","0000","285","117","168","12","297","448","0","66.29","26.12"
"10","007","00","011","1104","0644","285","117","168","12","297","448","0","66.29","26.12"
"10","007","00","011","1105","0000","1862","734","1128","71","1933","3275","0","59.02","22.41"
"10","007","00","011","1105","0654","586","245","341","21","607","1072","0","56.62","22.85"
"10","007","00","011","1105","0655","646","261","385","23","669","1113","0","60.11","23.45"
"10","007","00","011","1105","0656","630","228","402","27","657","1090","0","60.28","20.92"
"10","007","00","011","1106","0000","1252","474","778","67","1319","2145","0","61.49","22.1"
"10","007","00","011","1106","0657","702","284","418","26","728","1193","0","61.02","23.81"
"10","007","00","011","1106","0658","550","190","360","41","591","952","0","62.08","19.96"
"10","007","00","011","1107","0000","1942","782","1160","79","2021","3387","0","59.67","23.09"
"10","007","00","011","1107","0659","655","278","377","27","682","1172","0","58.19","23.72"
"10","007","00","011","1107","0660","566","231","335","26","592","1027","0","57.64","22.49"
"10","007","00","011","1107","0661","721","273","448","26","747","1188","0","62.88","22.98"
"10","007","00","011","1108","0000","725","332","393","46","771","1403","0","54.95","23.66"
"10","007","00","011","1108","0662","725","332","393","46","771","1403","0","54.95","23.66"
"10","007","00","011","1109","0000","1575","662","913","96","1671","3033","0","55.09","21.83"
"10","007","00","011","1109","0663","681","308","373","50","731","1397","0","52.33","22.05"
"10","007","00","011","1109","0664","894","354","540","46","940","1636","0","57.46","21.64"
"10","007","00","011","1110","0000","1402","595","807","77","1479","2512","0","58.88","23.69"
"10","007","00","011","1110","0665","733","306","427","45","778","1298","0","59.94","23.57"
"10","007","00","011","1110","0666","669","289","380","32","701","1214","0","57.74","23.81"
"10","007","00","011","1111","0000","1321","529","792","63","1384","2265","0","61.1","23.36"
"10","007","00","011","1111","0667","748","295","453","31","779","1297","0","60.06","22.74"
"10","007","00","011","1111","0668","573","234","339","32","605","968","0","62.5","24.17"
"10","007","00","011","1112","0000","479","206","273","30","509","839","0","60.67","24.55"
"10","007","00","011","1112","0669","479","206","273","30","509","839","0","60.67","24.55"
"10","007","00","011","1113","0000","982","443","539","44","1026","1805","0","56.84","24.54"
"10","007","00","011","1113","0670","528","228","300","29","557","907","0","61.41","25.14"
"10","007","00","011","1113","0671","454","215","239","15","469","898","0","52.23","23.94"
"10","007","00","011","1114","0000","1303","573","730","78","1381","2345","0","58.89","24.43"
"10","007","00","011","1114","0649","648","288","360","35","683","1146","0","59.6","25.13"
"10","007","00","011","1114","0650","655","285","370","43","698","1199","0","58.22","23.77"
"10","007","00","011","1115","0000","478","233","245","22","500","851","0","58.75","27.38"
"10","007","00","011","1115","0653","478","233","245","22","500","851","0","58.75","27.38"
"10","007","00","011","1116","0000","806","389","417","61","867","1365","0","63.52","28.5"
"10","007","00","011","1116","0681","806","389","417","61","867","1365","0","63.52","28.5"
"10","007","00","011","1117","0000","1060","507","553","53","1113","1859","0","59.87","27.27"
"10","007","00","011","1117","0651","492","250","242","33","525","895","0","58.66","27.93"
"10","007","00","011","1117","0652","568","257","311","20","588","964","0","61.0","26.66"
"10","007","00","011","1118","0000","2558","1089","1469","95","2653","4689","0","56.58","23.22"
"10","007","00","011","1118","0645","607","265","342","22","629","1123","0","56.01","23.6"
"10","007","00","011","1118","0646","636","270","366","26","662","1166","0","56.78","23.16"
"10","007","00","011","1118","0647","607","259","348","30","637","1151","0","55.34","22.5"
"10","007","00","011","1118","0648","708","295","413","17","725","1249","0","58.05","23.62"
"10","007","00","011","1119","0000","431","193","238","18","449","650","0","69.08","29.69"
"10","007","00","011","1119","0672","431","193","238","18","449","650","0","69.08","29.69"
"10","007","00","011","1120","0000","686","271","415","54","740","1279","0","57.86","21.19"
"10","007","00","011","1120","0673","686","271","415","54","740","1279","0","57.86","21.19"
"10","007","00","011","1121","0000","446","211","235","31","477","730","0","65.34","28.9"
"10","007","00","011","1121","0674","446","211","235","31","477","730","0","65.34","28.9"
"10","007","00","011","1122","0000","795","316","479","38","833","1407","0","59.2","22.46"
"10","007","00","011","1122","0675","795","316","479","38","833","1407","0","59.2","22.46"
"10","007","00","011","1123","0000","600","297","303","47","647","1273","0","50.82","23.33"
"10","007","00","011","1123","0676","600","297","303","47","647","1273","0","50.82","23.33"
"10","007","00","011","1124","0000","1075","474","601","74","1149","2201","0","52.2","21.54"
"10","007","00","011","1124","0679","491","230","261","37","528","1052","0","50.19","21.86"
"10","007","00","011","1124","0680","584","244","340","37","621","1149","0","54.05","21.24"
"10","007","00","011","1125","0000","967","445","522","60","1027","1742","0","58.96","25.55"
"10","007","00","011","1125","0677","525","250","275","21","546","988","0","55.26","25.3"
"10","007","00","011","1125","0678","442","195","247","39","481","754","0","63.79","25.86"
"10","007","00","012","0000","0000","19340","8539","10801","1180","20520","35391","41599","57.98","24.13"
"10","007","00","012","1201","0000","433","215","218","46","479","854","0","56.09","25.18"
"10","007","00","012","1201","0742","433","215","218","46","479","854","0","56.09","25.18"
"10","007","00","012","1202","0000","503","211","292","34","537","1138","0","47.19","18.54"
"10","007","00","012","1202","0743","462","197","265","30","492","963","0","51.09","20.46"
"10","007","00","012","1202","0744","41","14","27","4","45","175","0","25.71","8.0"
"10","007","00","012","1203","0000","375","168","207","23","398","739","0","53.86","22.73"
"10","007","00","012","1203","0745","375","168","207","23","398","739","0","53.86","22.73"
"10","007","00","012","1204","0000","852","371","481","54","906","1567","0","57.82","23.68"
"10","007","00","012","1204","0746","435","188","247","18","453","826","0","54.84","22.76"
"10","007","00","012","1204","0747","417","183","234","36","453","741","0","61.13","24.7"
"10","007","00","012","1205","0000","636","168","468","37","673","1507","0","44.66","11.15"
"10","007","00","012","1205","0748","237","86","151","9","246","506","0","48.62","17.0"
"10","007","00","012","1205","0749","399","82","317","28","427","1001","0","42.66","8.19"
"10","007","00","012","1206","0000","699","322","377","53","752","1281","0","58.7","25.14"
"10","007","00","012","1206","0750","699","322","377","53","752","1281","0","58.7","25.14"
"10","007","00","012","1207","0000","1003","469","534","54","1057","1757","0","60.16","26.69"
"10","007","00","012","1207","0753","499","247","252","24","523","844","0","61.97","29.27"
"10","007","00","012","1207","0754","504","222","282","30","534","913","0","58.49","24.32"
"10","007","00","012","1208","0000","383","179","204","22","405","613","0","66.07","29.2"
"10","007","00","012","1208","0755","383","179","204","22","405","613","0","66.07","29.2"
"10","007","00","012","1209","0000","2013","835","1178","98","2111","3351","0","63.0","24.92"
"10","007","00","012","1209","0756","780","332","448","41","821","1382","0","59.41","24.02"
"10","007","00","012","1209","0757","639","237","402","34","673","1034","0","65.09","22.92"
"10","007","00","012","1209","0758","594","266","328","23","617","935","0","65.99","28.45"
"10","007","00","012","1210","0000","1356","590","766","63","1419","2401","0","59.1","24.57"
"10","007","00","012","1210","0759","728","317","411","30","758","1301","0","58.26","24.37"
"10","007","00","012","1210","0760","628","273","355","33","661","1100","0","60.09","24.82"
"10","007","00","012","1211","0000","621","272","349","36","657","1071","0","61.34","25.4"
"10","007","00","012","1211","0761","621","272","349","36","657","1071","0","61.34","25.4"
"10","007","00","012","1212","0000","689","312","377","37","726","1163","0","62.42","26.83"
"10","007","00","012","1212","0762","689","312","377","37","726","1163","0","62.42","26.83"
"10","007","00","012","1213","0000","1199","501","698","63","1262","1964","0","64.26","25.51"
"10","007","00","012","1213","0763","504","219","285","36","540","809","0","66.75","27.07"
"10","007","00","012","1213","0764","695","282","413","27","722","1155","0","62.51","24.42"
"10","007","00","012","1214","0000","1314","590","724","67","1381","2362","0","58.47","24.98"
"10","007","00","012","1214","0751","566","254","312","34","600","1035","0","57.97","24.54"
"10","007","00","012","1214","0752","748","336","412","33","781","1327","0","58.85","25.32"
"10","007","00","012","1215","0000","880","438","442","37","917","1606","0","57.1","27.27"
"10","007","00","012","1215","0766","476","239","237","17","493","870","0","56.67","27.47"
"10","007","00","012","1215","0767","404","199","205","20","424","736","0","57.61","27.04"
"10","007","00","012","1216","0000","657","273","384","41","698","1335","0","52.28","20.45"
"10","007","00","012","1216","0768","657","273","384","41","698","1335","0","52.28","20.45"
"10","007","00","012","1217","0000","926","433","493","71","997","1774","0","56.2","24.41"
"10","007","00","012","1217","0769","471","212","259","31","502","876","0","57.31","24.2"
"10","007","00","012","1217","0770","455","221","234","40","495","898","0","55.12","24.61"
"10","007","00","012","1218","0000","2283","957","1326","136","2419","4224","0","57.27","22.66"
"10","007","00","012","1218","0771","733","309","424","27","760","1298","0","58.55","23.81"
"10","007","00","012","1218","0772","759","344","415","58","817","1451","0","56.31","23.71"
"10","007","00","012","1218","0773","791","304","487","51","842","1475","0","57.08","20.61"
"10","007","00","012","1219","0000","687","341","346","52","739","1270","0","58.19","26.85"
"10","007","00","012","1219","0765","687","341","346","52","739","1270","0","58.19","26.85"
"10","007","00","012","1220","0000","783","399","384","64","847","1576","0","53.74","25.32"
"10","007","00","012","1220","0774","374","173","201","31","405","766","0","52.87","22.58"
"10","007","00","012","1220","0775","409","226","183","33","442","810","0","54.57","27.9"
"10","007","00","012","1221","0000","528","247","281","43","571","953","0","59.92","25.92"
"10","007","00","012","1221","0776","528","247","281","43","571","953","0","59.92","25.92"
"10","007","00","012","1222","0000","520","248","272","49","569","885","0","64.29","28.02"
"10","007","00","012","1222","0777","520","248","272","49","569","885","0","64.29","28.02"
"10","007","00","013","0000","0000","17713","7869","9844","978","18691","31492","36907","59.35","24.99"
"10","007","00","013","1301","0000","1895","809","1086","91","1986","3152","0","63.01","25.67"
"10","007","00","013","1301","0579","866","364","502","41","907","1426","0","63.6","25.53"
"10","007","00","013","1301","0580","1029","445","584","50","1079","1726","0","62.51","25.78"
"10","007","00","013","1302","0000","893","416","477","62","955","1542","0","61.93","26.98"
"10","007","00","013","1302","0581","462","204","258","44","506","797","0","63.49","25.6"
"10","007","00","013","1302","0582","431","212","219","18","449","745","0","60.27","28.46"
"10","007","00","013","1303","0000","786","342","444","49","835","1426","0","58.56","23.98"
"10","007","00","013","1303","0585","786","342","444","49","835","1426","0","58.56","23.98"
"10","007","00","013","1304","0000","657","265","392","35","692","1125","0","61.51","23.56"
"10","007","00","013","1304","0583","657","265","392","35","692","1125","0","61.51","23.56"
"10","007","00","013","1305","0000","611","267","344","28","639","1161","0","55.04","23.0"
"10","007","00","013","1305","0591","611","267","344","28","639","1161","0","55.04","23.0"
"10","007","00","013","1306","0000","1583","671","912","54","1637","2813","0","58.19","23.85"
"10","007","00","013","1306","0594","792","346","446","32","824","1412","0","58.36","24.5"
"10","007","00","013","1306","0595","791","325","466","22","813","1401","0","58.03","23.2"
"10","007","00","013","1307","0000","1700","935","765","110","1810","3028","0","59.78","30.88"
"10","007","00","013","1307","0597","570","260","310","35","605","996","0","60.74","26.1"
"10","007","00","013","1307","0598","567","455","112","44","611","1047","0","58.36","43.46"
"10","007","00","013","1307","0599","563","220","343","31","594","985","0","60.3","22.34"
"10","007","00","013","1308","0000","1358","585","773","75","1433","2494","0","57.46","23.46"
"10","007","00","013","1308","0604","686","327","359","31","717","1189","0","60.3","27.5"
"10","007","00","013","1308","0605","672","258","414","44","716","1305","0","54.87","19.77"
"10","007","00","013","1309","0000","819","358","461","53","872","1486","0","58.68","24.09"
"10","007","00","013","1309","0584","819","358","461","53","872","1486","0","58.68","24.09"
"10","007","00","013","1310","0000","817","352","465","65","882","1478","0","59.68","23.82"
"10","007","00","013","1310","0588","817","352","465","65","882","1478","0","59.68","23.82"
"10","007","00","013","1311","0000","788","326","462","47","835","1395","0","59.86","23.37"
"10","007","00","013","1311","0596","788","326","462","47","835","1395","0","59.86","23.37"
"10","007","00","013","1312","0000","1089","472","617","63","1152","2001","0","57.57","23.59"
"10","007","00","013","1312","0586","488","197","291","36","524","824","0","63.59","23.91"
"10","007","00","013","1312","0587","601","275","326","27","628","1177","0","53.36","23.36"
"10","007","00","013","1313","0000","924","410","514","51","975","1591","0","61.28","25.77"
"10","007","00","013","1313","0589","407","158","249","20","427","779","0","54.81","20.28"
"10","007","00","013","1313","0590","517","252","265","31","548","812","0","67.49","31.03"
"10","007","00","013","1314","0000","1350","599","751","65","1415","2497","0","56.67","23.99"
"10","007","00","013","1314","0592","660","291","369","25","685","1238","0","55.33","23.51"
"10","007","00","013","1314","0593","690","308","382","40","730","1259","0","57.98","24.46"
"10","007","00","013","1315","0000","1309","545","764","67","1376","2254","0","61.05","24.18"
"10","007","00","013","1315","0600","626","296","330","38","664","1054","0","63.0","28.08"
"10","007","00","013","1315","0601","683","249","434","29","712","1200","0","59.33","20.75"
"10","007","00","013","1316","0000","1134","517","617","63","1197","2049","0","58.42","25.23"
"10","007","00","013","1316","0602","578","258","320","41","619","1003","0","61.71","25.72"
"10","007","00","013","1316","0603","556","259","297","22","578","1046","0","55.26","24.76"
"10","007","00","014","0000","0000","15850","6447","9403","1014","16864","28026","32517","60.17","23.0"
"10","007","00","014","1401","0000","1029","431","598","63","1092","1712","0","63.79","25.18"
"10","007","00","014","1401","0682","563","237","326","36","599","958","0","62.53","24.74"
"10","007","00","014","1401","0683","466","194","272","27","493","754","0","65.38","25.73"
"10","007","00","014","1402","0000","959","403","556","50","1009","1563","0","64.56","25.78"
"10","007","00","014","1402","0684","478","189","289","24","502","757","0","66.31","24.97"
"10","007","00","014","1402","0685","481","214","267","26","507","806","0","62.9","26.55"
"10","007","00","014","1403","0000","721","259","462","44","765","1280","0","59.77","20.23"
"10","007","00","014","1403","0686","721","259","462","44","765","1280","0","59.77","20.23"
"10","007","00","014","1404","0000","532","215","317","25","557","928","0","60.02","23.17"
"10","007","00","014","1404","0687","532","215","317","25","557","928","0","60.02","23.17"
"10","007","00","014","1405","0000","1050","413","637","69","1119","1710","0","65.44","24.15"
"10","007","00","014","1405","0688","553","227","326","39","592","895","0","66.15","25.36"
"10","007","00","014","1405","0689","497","186","311","30","527","815","0","64.66","22.82"
"10","007","00","014","1406","0000","537","252","285","23","560","957","0","58.52","26.33"
"10","007","00","014","1406","0690","537","252","285","23","560","957","0","58.52","26.33"
"10","007","00","014","1407","0000","729","318","411","63","792","1338","0","59.19","23.77"
"10","007","00","014","1407","0691","729","318","411","63","792","1338","0","59.19","23.77"
"10","007","00","014","1408","0000","611","245","366","32","643","1106","0","58.14","22.15"
"10","007","00","014","1408","0692","611","245","366","32","643","1106","0","58.14","22.15"
"10","007","00","014","1409","0000","406","175","231","21","427","690","0","61.88","25.36"
"10","007","00","014","1409","0693","406","175","231","21","427","690","0","61.88","25.36"
"10","007","00","014","1410","0000","672","257","415","30","702","1230","0","57.07","20.89"
"10","007","00","014","1410","0694","672","257","415","30","702","1230","0","57.07","20.89"
"10","007","00","014","1411","0000","1006","397","609","57","1063","1744","0","60.95","22.76"
"10","007","00","014","1411","0695","473","181","292","27","500","847","0","59.03","21.37"
"10","007","00","014","1411","0696","533","216","317","30","563","897","0","62.76","24.08"
"10","007","00","014","1412","0000","1175","476","699","78","1253","2062","0","60.77","23.08"
"10","007","00","014","1412","0697","492","211","281","41","533","882","0","60.43","23.92"
"10","007","00","014","1412","0698","683","265","418","37","720","1180","0","61.02","22.46"
"10","007","00","014","1413","0000","654","285","369","51","705","1215","0","58.02","23.46"
"10","007","00","014","1413","0699","654","285","369","51","705","1215","0","58.02","23.46"
"10","007","00","014","1414","0000","266","84","182","16","282","422","0","66.82","19.91"
"10","007","00","014","1414","0700","266","84","182","16","282","422","0","66.82","19.91"
"10","007","00","014","1415","0000","595","252","343","29","624","1106","0","56.42","22.78"
"10","007","00","014","1415","0701","595","252","343","29","624","1106","0","56.42","22.78"
"10","007","00","014","1416","0000","541","222","319","31","572","874","0","65.45","25.4"
"10","007","00","014","1416","0702","541","222","319","31","572","874","0","65.45","25.4"
"10","007","00","014","1417","0000","803","358","445","63","866","1445","0","59.93","24.78"
"10","007","00","014","1417","0703","803","358","445","63","866","1445","0","59.93","24.78"
"10","007","00","014","1418","0000","445","145","300","41","486","875","0","55.54","16.57"
"10","007","00","014","1418","0704","445","145","300","41","486","875","0","55.54","16.57"
"10","007","00","014","1419","0000","806","334","472","59","865","1522","0","56.83","21.94"
"10","007","00","014","1419","0705","418","174","244","32","450","837","0","53.76","20.79"
"10","007","00","014","1419","0706","388","160","228","27","415","685","0","60.58","23.36"
"10","007","00","014","1420","0000","871","364","507","98","969","1531","0","63.29","23.78"
"10","007","00","014","1420","0707","427","170","257","41","468","733","0","63.85","23.19"
"10","007","00","014","1420","0708","444","194","250","57","501","798","0","62.78","24.31"
"10","007","00","014","1421","0000","761","291","470","40","801","1381","0","58.0","21.07"
"10","007","00","014","1421","0709","761","291","470","40","801","1381","0","58.0","21.07"
"10","007","00","014","1422","0000","681","271","410","31","712","1335","0","53.33","20.3"
"10","007","00","014","1422","0710","681","271","410","31","712","1335","0","53.33","20.3"
"10","007","00","015","0000","0000","17260","7892","9368","1150","18410","29642","34739","62.11","26.62"
"10","007","00","015","1501","0000","2073","938","1135","126","2199","3604","0","61.02","26.03"
"10","007","00","015","1501","0711","670","317","353","46","716","1139","0","62.86","27.83"
"10","007","00","015","1501","0712","673","318","355","43","716","1217","0","58.83","26.13"
"10","007","00","015","1501","0713","730","303","427","37","767","1248","0","61.46","24.28"
"10","007","00","015","1502","0000","761","369","392","47","808","1248","0","64.74","29.57"
"10","007","00","015","1502","0714","761","369","392","47","808","1248","0","64.74","29.57"
"10","007","00","015","1503","0000","932","402","530","48","980","1541","0","63.6","26.09"
"10","007","00","015","1503","0715","540","219","321","29","569","916","0","62.12","23.91"
"10","007","00","015","1503","0716","392","183","209","19","411","625","0","65.76","29.28"
"10","007","00","015","1504","0000","675","297","378","53","728","1271","0","57.28","23.37"
"10","007","00","015","1504","0717","675","297","378","53","728","1271","0","57.28","23.37"
"10","007","00","015","1505","0000","1043","484","559","84","1127","1740","0","64.77","27.82"
"10","007","00","015","1505","0718","365","170","195","26","391","608","0","64.31","27.96"
"10","007","00","015","1505","0719","678","314","364","58","736","1132","0","65.02","27.74"
"10","007","00","015","1506","0000","1152","519","633","82","1234","1953","0","63.18","26.57"
"10","007","00","015","1506","0720","591","262","329","49","640","1027","0","62.32","25.51"
"10","007","00","015","1506","0721","561","257","304","33","594","926","0","64.15","27.75"
"10","007","00","015","1507","0000","848","384","464","60","908","1438","0","63.14","26.7"
"10","007","00","015","1507","0722","441","200","241","41","482","778","0","61.95","25.71"
"10","007","00","015","1507","0723","407","184","223","19","426","660","0","64.55","27.88"
"10","007","00","015","1508","0000","1164","534","630","49","1213","2019","0","60.08","26.45"
"10","007","00","015","1508","0726","590","261","329","23","613","985","0","62.23","26.5"
"10","007","00","015","1508","0727","574","273","301","26","600","1034","0","58.03","26.4"
"10","007","00","015","1509","0000","1351","623","728","90","1441","2321","0","62.09","26.84"
"10","007","00","015","1509","0724","779","324","455","64","843","1330","0","63.38","24.36"
"10","007","00","015","1509","0725","572","299","273","26","598","991","0","60.34","30.17"
"10","007","00","015","1510","0000","367","167","200","33","400","612","0","65.36","27.29"
"10","007","00","015","1510","0728","367","167","200","33","400","612","0","65.36","27.29"
"10","007","00","015","1511","0000","735","314","421","54","789","1236","0","63.83","25.4"
"10","007","00","015","1511","0729","735","314","421","54","789","1236","0","63.83","25.4"
"10","007","00","015","1512","0000","921","415","506","70","991","1513","0","65.5","27.43"
"10","007","00","015","1512","0730","455","211","244","39","494","775","0","63.74","27.23"
"10","007","00","015","1512","0731","466","204","262","31","497","738","0","67.34","27.64"
"10","007","00","015","1513","0000","597","278","319","41","638","1036","0","61.58","26.83"
"10","007","00","015","1513","0732","597","278","319","41","638","1036","0","61.58","26.83"
"10","007","00","015","1514","0000","513","250","263","48","561","975","0","57.54","25.64"
"10","007","00","015","1514","0733","513","250","263","48","561","975","0","57.54","25.64"
"10","007","00","015","1515","0000","793","375","418","42","835","1348","0","61.94","27.82"
"10","007","00","015","1515","0736","404","191","213","22","426","689","0","61.83","27.72"
"10","007","00","015","1515","0737","389","184","205","20","409","659","0","62.06","27.92"
"10","007","00","015","1516","0000","1054","492","562","75","1129","1824","0","61.9","26.97"
"10","007","00","015","1516","0734","495","226","269","38","533","885","0","60.23","25.54"
"10","007","00","015","1516","0735","559","266","293","37","596","939","0","63.47","28.33"
"10","007","00","015","1517","0000","833","399","434","65","898","1352","0","66.42","29.51"
"10","007","00","015","1517","0739","833","399","434","65","898","1352","0","66.42","29.51"
"10","007","00","015","1518","0000","483","224","259","28","511","910","0","56.15","24.62"
"10","007","00","015","1518","0738","483","224","259","28","511","910","0","56.15","24.62"
"10","007","00","015","1519","0000","424","223","201","27","451","759","0","59.42","29.38"
"10","007","00","015","1519","0740","424","223","201","27","451","759","0","59.42","29.38"
"10","007","00","015","1520","0000","541","205","336","28","569","942","0","60.4","21.76"
"10","007","00","015","1520","0741","541","205","336","28","569","942","0","60.4","21.76"
"10","007","00","016","0000","0000","17706","8051","9655","967","18673","31239","37055","59.77","25.77"
"10","007","00","016","1601","0000","518","233","285","35","553","792","0","69.82","29.42"
"10","007","00","016","1601","0616","518","233","285","35","553","792","0","69.82","29.42"
"10","007","00","016","1602","0000","918","422","496","40","958","1516","0","63.19","27.84"
"10","007","00","016","1602","0617","427","207","220","21","448","695","0","64.46","29.78"
"10","007","00","016","1602","0618","491","215","276","19","510","821","0","62.12","26.19"
"10","007","00","016","1603","0000","1102","447","655","59","1161","1904","0","60.98","23.48"
"10","007","00","016","1603","0619","632","248","384","39","671","1064","0","63.06","23.31"
"10","007","00","016","1603","0620","470","199","271","20","490","840","0","58.33","23.69"
"10","007","00","016","1604","0000","1176","559","617","48","1224","2127","0","57.55","26.28"
"10","007","00","016","1604","0621","543","287","256","26","569","1079","0","52.73","26.6"
"10","007","00","016","1604","0622","633","272","361","22","655","1048","0","62.5","25.95"
"10","007","00","016","1605","0000","1081","464","617","49","1130","1758","0","64.28","26.39"
"10","007","00","016","1605","0623","596","256","340","31","627","960","0","65.31","26.67"
"10","007","00","016","1605","0624","485","208","277","18","503","798","0","63.03","26.07"
"10","007","00","016","1606","0000","876","360","516","38","914","1458","0","62.69","24.69"
"10","007","00","016","1606","0625","512","217","295","17","529","796","0","66.46","27.26"
"10","007","00","016","1606","0626","364","143","221","21","385","662","0","58.16","21.6"
"10","007","00","016","1607","0000","582","279","303","27","609","1040","0","58.56","26.83"
"10","007","00","016","1607","0627","582","279","303","27","609","1040","0","58.56","26.83"
"10","007","00","016","1608","0000","560","241","319","30","590","1025","0","57.56","23.51"
"10","007","00","016","1608","0628","560","241","319","30","590","1025","0","57.56","23.51"
"10","007","00","016","1609","0000","1548","644","904","82","1630","2593","0","62.86","24.84"
"10","007","00","016","1609","0629","842","345","497","35","877","1357","0","64.63","25.42"
"10","007","00","016","1609","0630","706","299","407","47","753","1236","0","60.92","24.19"
"10","007","00","016","1610","0000","812","415","397","48","860","1393","0","61.74","29.79"
"10","007","00","016","1610","0611","396","198","198","24","420","659","0","63.73","30.05"
"10","007","00","016","1610","0612","416","217","199","24","440","734","0","59.95","29.56"
"10","007","00","016","1611","0000","612","260","352","56","668","1255","0","53.23","20.72"
"10","007","00","016","1611","0606","612","260","352","56","668","1255","0","53.23","20.72"
"10","007","00","016","1612","0000","941","604","337","68","1009","1648","0","61.23","36.65"
"10","007","00","016","1612","0609","428","195","233","29","457","724","0","63.12","26.93"
"10","007","00","016","1612","0610","513","409","104","39","552","924","0","59.74","44.26"
"10","007","00","016","1613","0000","1071","511","560","63","1134","1915","0","59.22","26.68"
"10","007","00","016","1613","0607","516","260","256","34","550","889","0","61.87","29.25"
"10","007","00","016","1613","0608","555","251","304","29","584","1026","0","56.92","24.46"
"10","007","00","016","1614","0000","893","387","506","40","933","1606","0","58.09","24.1"
"10","007","00","016","1614","0613","364","171","193","13","377","758","0","49.74","22.56"
"10","007","00","016","1614","0614","529","216","313","27","556","848","0","65.57","25.47"
"10","007","00","016","1615","0000","708","313","395","58","766","1404","0","54.56","22.29"
"10","007","00","016","1615","0615","708","313","395","58","766","1404","0","54.56","22.29"
"10","007","00","016","1616","0000","483","216","267","23","506","871","0","58.09","24.8"
"10","007","00","016","1616","0631","483","216","267","23","506","871","0","58.09","24.8"
"10","007","00","016","1617","0000","367","153","214","24","391","706","0","55.38","21.67"
"10","007","00","016","1617","0632","367","153","214","24","391","706","0","55.38","21.67"
"10","007","00","016","1618","0000","472","232","240","27","499","770","0","64.81","30.13"
"10","007","00","016","1618","0633","472","232","240","27","499","770","0","64.81","30.13"
"10","007","00","016","1619","0000","428","184","244","16","444","669","0","66.37","27.5"
"10","007","00","016","1619","0634","428","184","244","16","444","669","0","66.37","27.5"
"10","007","00","016","1620","0000","479","194","285","30","509","862","0","59.05","22.51"
"10","007","00","016","1620","0635","479","194","285","30","509","862","0","59.05","22.51"
"10","007","00","016","1621","0000","453","181","272","26","479","847","0","56.55","21.37"
"10","007","00","016","1621","0636","453","181","272","26","479","847","0","56.55","21.37"
"10","007","00","016","1622","0000","405","171","234","30","435","668","0","65.12","25.6"
"10","007","00","016","1622","0637","405","171","234","30","435","668","0","65.12","25.6"
"10","007","00","016","1623","0000","555","232","323","21","576","1073","0","53.68","21.62"
"10","007","00","016","1623","0638","555","232","323","21","576","1073","0","53.68","21.62"
"10","007","00","016","1624","0000","666","349","317","29","695","1339","0","51.9","26.06"
"10","007","00","016","1624","0639","666","349","317","29","695","1339","0","51.9","26.06"
"10","007","00","017","0000","0000","20106","9417","10689","1046","21152","36306","42917","58.26","25.94"
"10","007","00","017","1701","0000","1517","756","761","61","1578","2765","0","57.07","27.34"
"10","007","00","017","1701","0778","453","265","188","18","471","791","0","59.54","33.5"
"10","007","00","017","1701","0779","535","232","303","26","561","984","0","57.01","23.58"
"10","007","00","017","1701","0780","529","259","270","17","546","990","0","55.15","26.16"
"10","007","00","017","1702","0000","762","358","404","54","816","1478","0","55.21","24.22"
"10","007","00","017","1702","0785","409","194","215","19","428","753","0","56.84","25.76"
"10","007","00","017","1702","0786","353","164","189","35","388","725","0","53.52","22.62"
"10","007","00","017","1703","0000","650","336","314","33","683","1165","0","58.63","28.84"
"10","007","00","017","1703","0805","650","336","314","33","683","1165","0","58.63","28.84"
"10","007","00","017","1704","0000","2599","1455","1144","119","2718","4546","0","59.79","32.01"
"10","007","00","017","1704","0781","600","279","321","32","632","1016","0","62.2","27.46"
"10","007","00","017","1704","0782","632","547","85","27","659","1091","0","60.4","50.14"
"10","007","00","017","1704","0783","705","324","381","40","745","1236","0","60.28","26.21"
"10","007","00","017","1704","0784","662","305","357","20","682","1203","0","56.69","25.35"
"10","007","00","017","1705","0000","540","258","282","23","563","933","0","60.34","27.65"
"10","007","00","017","1705","0790","540","258","282","23","563","933","0","60.34","27.65"
"10","007","00","017","1706","0000","607","244","363","24","631","1092","0","57.78","22.34"
"10","007","00","017","1706","0812","607","244","363","24","631","1092","0","57.78","22.34"
"10","007","00","017","1707","0000","1533","656","877","63","1596","2698","0","59.15","24.31"
"10","007","00","017","1707","0798","398","169","229","13","411","688","0","59.74","24.56"
"10","007","00","017","1707","0799","478","223","255","22","500","870","0","57.47","25.63"
"10","007","00","017","1707","0800","657","264","393","28","685","1140","0","60.09","23.16"
"10","007","00","017","1708","0000","1139","529","610","62","1201","2066","0","58.13","25.61"
"10","007","00","017","1708","0791","580","264","316","28","608","990","0","61.41","26.67"
"10","007","00","017","1708","0792","559","265","294","34","593","1076","0","55.11","24.63"
"10","007","00","017","1709","0000","434","176","258","24","458","724","0","63.26","24.31"
"10","007","00","017","1709","0807","434","176","258","24","458","724","0","63.26","24.31"
"10","007","00","017","1710","0000","535","224","311","22","557","937","0","59.45","23.91"
"10","007","00","017","1710","0803","535","224","311","22","557","937","0","59.45","23.91"
"10","007","00","017","1711","0000","887","427","460","62","949","1645","0","57.69","25.96"
"10","007","00","017","1711","0796","422","208","214","35","457","750","0","60.93","27.73"
"10","007","00","017","1711","0797","465","219","246","27","492","895","0","54.97","24.47"
"10","007","00","017","1712","0000","566","250","316","41","607","992","0","61.19","25.2"
"10","007","00","017","1712","0811","566","250","316","41","607","992","0","61.19","25.2"
"10","007","00","017","1713","0000","764","297","467","30","794","1266","0","62.72","23.46"
"10","007","00","017","1713","0802","764","297","467","30","794","1266","0","62.72","23.46"
"10","007","00","017","1714","0000","815","356","459","34","849","1414","0","60.04","25.18"
"10","007","00","017","1714","0793","445","197","248","17","462","742","0","62.26","26.55"
"10","007","00","017","1714","0794","370","159","211","17","387","672","0","57.59","23.66"
"10","007","00","017","1715","0000","565","208","357","27","592","1015","0","58.33","20.49"
"10","007","00","017","1715","0808","565","208","357","27","592","1015","0","58.33","20.49"
"10","007","00","017","1716","0000","550","246","304","33","583","985","0","59.19","24.97"
"10","007","00","017","1716","0801","550","246","304","33","583","985","0","59.19","24.97"
"10","007","00","017","1717","0000","598","266","332","29","627","1235","0","50.77","21.54"
"10","007","00","017","1717","0795","598","266","332","29","627","1235","0","50.77","21.54"
"10","007","00","017","1718","0000","483","245","238","31","514","828","0","62.08","29.59"
"10","007","00","017","1718","0813","483","245","238","31","514","828","0","62.08","29.59"
"10","007","00","017","1719","0000","928","469","459","56","984","1611","0","61.08","29.11"
"10","007","00","017","1719","0788","364","192","172","21","385","562","0","68.51","34.16"
"10","007","00","017","1719","0789","564","277","287","35","599","1049","0","57.1","26.41"
"10","007","00","017","1720","0000","563","252","311","30","593","986","0","60.14","25.56"
"10","007","00","017","1720","0806","563","252","311","30","593","986","0","60.14","25.56"
"10","007","00","017","1721","0000","738","350","388","53","791","1506","0","52.52","23.24"
"10","007","00","017","1721","0814","394","192","202","35","429","787","0","54.51","24.4"
"10","007","00","017","1721","0815","344","158","186","18","362","719","0","50.35","21.97"
"10","007","00","017","1722","0000","582","279","303","43","625","1023","0","61.09","27.27"
"10","007","00","017","1722","0787","582","279","303","43","625","1023","0","61.09","27.27"
"10","007","00","017","1723","0000","663","252","411","29","692","1219","0","56.77","20.67"
"10","007","00","017","1723","0804","663","252","411","29","692","1219","0","56.77","20.67"
"10","007","00","017","1724","0000","1088","528","560","63","1151","2177","0","52.87","24.25"
"10","007","00","017","1724","0809","551","253","298","21","572","1116","0","51.25","22.67"
"10","007","00","017","1724","0810","537","275","262","42","579","1061","0","54.57","25.92"
"10","007","00","018","0000","0000","7693","3741","3952","480","8173","13339","15193","61.27","28.05"
"10","007","00","018","1801","0000","455","190","265","22","477","871","0","54.76","21.81"
"10","007","00","018","1801","0818","455","190","265","22","477","871","0","54.76","21.81"
"10","007","00","018","1802","0000","536","267","269","37","573","953","0","60.13","28.02"
"10","007","00","018","1802","0819","536","267","269","37","573","953","0","60.13","28.02"
"10","007","00","018","1803","0000","322","153","169","24","346","624","0","55.45","24.52"
"10","007","00","018","1803","0820","322","153","169","24","346","624","0","55.45","24.52"
"10","007","00","018","1804","0000","396","192","204","35","431","645","0","66.82","29.77"
"10","007","00","018","1804","0821","396","192","204","35","431","645","0","66.82","29.77"
"10","007","00","018","1805","0000","584","284","300","46","630","943","0","66.81","30.12"
"10","007","00","018","1805","0823","584","284","300","46","630","943","0","66.81","30.12"
"10","007","00","018","1806","0000","610","248","362","33","643","986","0","65.21","25.15"
"10","007","00","018","1806","0822","610","248","362","33","643","986","0","65.21","25.15"
"10","007","00","018","1807","0000","545","251","294","10","555","831","0","66.79","30.2"
"10","007","00","018","1807","0825","545","251","294","10","555","831","0","66.79","30.2"
"10","007","00","018","1808","0000","278","121","157","12","290","455","0","63.74","26.59"
"10","007","00","018","1808","0824","278","121","157","12","290","455","0","63.74","26.59"
"10","007","00","018","1809","0000","582","377","205","23","605","1013","0","59.72","37.22"
"10","007","00","018","1809","0827","582","377","205","23","605","1013","0","59.72","37.22"
"10","007","00","018","1810","0000","492","262","230","29","521","831","0","62.7","31.53"
"10","007","00","018","1810","0826","492","262","230","29","521","831","0","62.7","31.53"
"10","007","00","018","1811","0000","460","238","222","47","507","796","0","63.69","29.9"
"10","007","00","018","1811","0828","460","238","222","47","507","796","0","63.69","29.9"
"10","007","00","018","1812","0000","422","179","243","39","461","781","0","59.03","22.92"
"10","007","00","018","1812","0829","422","179","243","39","461","781","0","59.03","22.92"
"10","007","00","018","1813","0000","355","174","181","18","373","692","0","53.9","25.14"
"10","007","00","018","1813","0830","355","174","181","18","373","692","0","53.9","25.14"
"10","007","00","018","1814","0000","359","157","202","16","375","635","0","59.06","24.72"
"10","007","00","018","1814","0831","359","157","202","16","375","635","0","59.06","24.72"
"10","007","00","018","1815","0000","309","149","160","24","333","566","0","58.83","26.33"
"10","007","00","018","1815","0832","309","149","160","24","333","566","0","58.83","26.33"
"10","007","00","018","1816","0000","592","316","276","28","620","1028","0","60.31","30.74"
"10","007","00","018","1816","0816","592","316","276","28","620","1028","0","60.31","30.74"
"10","007","00","018","1817","0000","396","183","213","37","433","689","0","62.84","26.56"
"10","007","00","018","1817","0817","396","183","213","37","433","689","0","62.84","26.56"
"10","007","00","019","0000","0000","15425","6964","8461","870","16295","27593","33335","59.05","25.24"
"10","007","00","019","1901","0000","1043","443","600","44","1087","1790","0","60.73","24.75"
"10","007","00","019","1901","0844","497","212","285","20","517","833","0","62.06","25.45"
"10","007","00","019","1901","0845","546","231","315","24","570","957","0","59.56","24.14"
"10","007","00","019","1902","0000","426","185","241","20","446","783","0","56.96","23.63"
"10","007","00","019","1902","0846","426","185","241","20","446","783","0","56.96","23.63"
"10","007","00","019","1903","0000","304","164","140","18","322","573","0","56.2","28.62"
"10","007","00","019","1903","0847","304","164","140","18","322","573","0","56.2","28.62"
"10","007","00","019","1904","0000","379","188","191","20","399","672","0","59.38","27.98"
"10","007","00","019","1904","0848","379","188","191","20","399","672","0","59.38","27.98"
"10","007","00","019","1905","0000","746","368","378","43","789","1442","0","54.72","25.52"
"10","007","00","019","1905","0849","361","187","174","21","382","695","0","54.96","26.91"
"10","007","00","019","1905","0850","385","181","204","22","407","747","0","54.48","24.23"
"10","007","00","019","1906","0000","779","314","465","43","822","1305","0","62.99","24.06"
"10","007","00","019","1906","0851","400","159","241","17","417","643","0","64.85","24.73"
"10","007","00","019","1906","0852","379","155","224","26","405","662","0","61.18","23.41"
"10","007","00","019","1907","0000","1294","491","803","80","1374","2206","0","62.28","22.26"
"10","007","00","019","1907","0853","661","219","442","38","699","1085","0","64.42","20.18"
"10","007","00","019","1907","0854","633","272","361","42","675","1121","0","60.21","24.26"
"10","007","00","019","1908","0000","1636","693","943","80","1716","3017","0","56.88","22.97"
"10","007","00","019","1908","0855","483","219","264","26","509","830","0","61.33","26.39"
"10","007","00","019","1908","0856","516","203","313","30","546","975","0","56.0","20.82"
"10","007","00","019","1908","0857","637","271","366","24","661","1212","0","54.54","22.36"
"10","007","00","019","1909","0000","746","346","400","40","786","1302","0","60.37","26.57"
"10","007","00","019","1909","0858","746","346","400","40","786","1302","0","60.37","26.57"
"10","007","00","019","1910","0000","2613","1217","1396","130","2743","4597","0","59.67","26.47"
"10","007","00","019","1910","0838","648","289","359","32","680","1124","0","60.5","25.71"
"10","007","00","019","1910","0839","641","284","357","34","675","1096","0","61.59","25.91"
"10","007","00","019","1910","0840","720","340","380","22","742","1213","0","61.17","28.03"
"10","007","00","019","1910","0841","604","304","300","42","646","1164","0","55.5","26.12"
"10","007","00","019","1911","0000","869","382","487","51","920","1608","0","57.21","23.76"
"10","007","00","019","1911","0842","396","177","219","26","422","730","0","57.81","24.25"
"10","007","00","019","1911","0843","473","205","268","25","498","878","0","56.72","23.35"
"10","007","00","019","1912","0000","1520","741","779","92","1612","2649","0","60.85","27.97"
"10","007","00","019","1912","0833","498","252","246","31","529","925","0","57.19","27.24"
"10","007","00","019","1912","0834","495","232","263","34","529","869","0","60.87","26.7"
"10","007","00","019","1912","0835","527","257","270","27","554","855","0","64.8","30.06"
"10","007","00","019","1913","0000","1115","542","573","72","1187","1893","0","62.7","28.63"
"10","007","00","019","1913","0836","650","303","347","25","675","1065","0","63.38","28.45"
"10","007","00","019","1913","0837","465","239","226","47","512","828","0","61.84","28.86"
"10","007","00","019","1914","0000","981","449","532","72","1053","1994","0","52.81","22.52"
"10","007","00","019","1914","0859","519","253","266","27","546","1077","0","50.7","23.49"
"10","007","00","019","1914","0860","462","196","266","45","507","917","0","55.29","21.37"
"10","007","00","019","1915","0000","974","441","533","65","1039","1762","0","58.97","25.03"
"10","007","00","019","1915","0861","445","195","250","29","474","825","0","57.45","23.64"
"10","007","00","019","1915","0862","529","246","283","36","565","937","0","60.3","26.25"
"10","007","00","020","0000","0000","21458","9219","12239","1387","22845","42976","50709","53.16","21.45"
"10","007","00","020","2001","0000","1161","522","639","83","1244","2148","0","57.91","24.3"
"10","007","00","020","2001","0945","487","212","275","33","520","892","0","58.3","23.77"
"10","007","00","020","2001","0946","674","310","364","50","724","1256","0","57.64","24.68"
"10","007","00","020","2002","0000","1764","718","1046","107","1871","3201","0","58.45","22.43"
"10","007","00","020","2002","0947","550","231","319","30","580","1043","0","55.61","22.15"
"10","007","00","020","2002","0948","617","257","360","34","651","1076","0","60.5","23.88"
"10","007","00","020","2002","0949","597","230","367","43","640","1082","0","59.15","21.26"
"10","007","00","020","2003","0000","743","332","411","37","780","1427","0","54.66","23.27"
"10","007","00","020","2003","0950","743","332","411","37","780","1427","0","54.66","23.27"
"10","007","00","020","2004","0000","1517","733","784","89","1606","3040","0","52.83","24.11"
"10","007","00","020","2004","0951","496","267","229","29","525","1030","0","50.97","25.92"
"10","007","00","020","2004","0952","496","246","250","47","543","1033","0","52.57","23.81"
"10","007","00","020","2004","0953","525","220","305","13","538","977","0","55.07","22.52"
"10","007","00","020","2005","0000","820","333","487","52","872","1658","0","52.59","20.08"
"10","007","00","020","2005","0954","333","135","198","20","353","683","0","51.68","19.77"
"10","007","00","020","2005","0955","487","198","289","32","519","975","0","53.23","20.31"
"10","007","00","020","2006","0000","556","297","259","49","605","1336","0","45.28","22.23"
"10","007","00","020","2006","0956","556","297","259","49","605","1336","0","45.28","22.23"
"10","007","00","020","2007","0000","454","221","233","34","488","1019","0","47.89","21.69"
"10","007","00","020","2007","0957","454","221","233","34","488","1019","0","47.89","21.69"
"10","007","00","020","2008","0000","409","169","240","37","446","1003","0","44.47","16.85"
"10","007","00","020","2008","0958","409","169","240","37","446","1003","0","44.47","16.85"
"10","007","00","020","2009","0000","622","241","381","35","657","1151","0","57.08","20.94"
"10","007","00","020","2009","0959","622","241","381","35","657","1151","0","57.08","20.94"
"10","007","00","020","2010","0000","836","362","474","76","912","1598","0","57.07","22.65"
"10","007","00","020","2010","0960","836","362","474","76","912","1598","0","57.07","22.65"
"10","007","00","020","2011","0000","1715","708","1007","86","1801","3259","0","55.26","21.72"
"10","007","00","020","2011","0961","747","291","456","45","792","1488","0","53.23","19.56"
"10","007","00","020","2011","0962","968","417","551","41","1009","1771","0","56.97","23.55"
"10","007","00","020","2012","0000","1295","553","742","70","1365","2540","0","53.74","21.77"
"10","007","00","020","2012","0942","301","149","152","17","318","731","0","43.5","20.38"
"10","007","00","020","2012","0943","557","228","329","36","593","1025","0","57.85","22.24"
"10","007","00","020","2012","0944","437","176","261","17","454","784","0","57.91","22.45"
"10","007","00","020","2013","0000","542","239","303","46","588","1360","0","43.24","17.57"
"10","007","00","020","2013","0963","542","239","303","46","588","1360","0","43.24","17.57"
"10","007","00","020","2014","0000","723","291","432","48","771","1613","0","47.8","18.04"
"10","007","00","020","2014","0964","723","291","432","48","771","1613","0","47.8","18.04"
"10","007","00","020","2015","0000","592","244","348","49","641","1228","0","52.2","19.87"
"10","007","00","020","2015","0965","592","244","348","49","641","1228","0","52.2","19.87"
"10","007","00","020","2016","0000","428","155","273","16","444","771","0","57.59","20.1"
"10","007","00","020","2016","0966","428","155","273","16","444","771","0","57.59","20.1"
"10","007","00","020","2017","0000","791","337","454","27","818","1519","0","53.85","22.19"
"10","007","00","020","2017","0967","487","211","276","26","513","858","0","59.79","24.59"
"10","007","00","020","2017","0968","304","126","178","1","305","661","0","46.14","19.06"
"10","007","00","020","2018","0000","571","278","293","63","634","1268","0","50.0","21.92"
"10","007","00","020","2018","0969","571","278","293","63","634","1268","0","50.0","21.92"
"10","007","00","020","2019","0000","532","232","300","17","549","1081","0","50.79","21.46"
"10","007","00","020","2019","0970","532","232","300","17","549","1081","0","50.79","21.46"
"10","007","00","020","2020","0000","1765","730","1035","119","1884","3659","0","51.49","19.95"
"10","007","00","020","2020","0971","587","241","346","18","605","1213","0","49.88","19.87"
"10","007","00","020","2020","0972","696","271","425","49","745","1328","0","56.1","20.41"
"10","007","00","020","2020","0973","482","218","264","52","534","1118","0","47.76","19.5"
"10","007","00","020","2021","0000","449","187","262","31","480","972","0","49.38","19.24"
"10","007","00","020","2021","0975","449","187","262","31","480","972","0","49.38","19.24"
"10","007","00","020","2022","0000","500","225","275","35","535","1157","0","46.24","19.45"
"10","007","00","020","2022","0974","500","225","275","35","535","1157","0","46.24","19.45"
"10","007","00","020","2023","0000","463","201","262","31","494","902","0","54.77","22.28"
"10","007","00","020","2023","0976","463","201","262","31","494","902","0","54.77","22.28"
"10","007","00","020","2024","0000","759","352","407","51","810","1273","0","63.63","27.65"
"10","007","00","020","2024","0977","759","352","407","51","810","1273","0","63.63","27.65"
"10","007","00","020","2025","0000","564","112","452","26","590","1087","0","54.28","10.3"
"10","007","00","020","2025","0978","564","112","452","26","590","1087","0","54.28","10.3"
"10","007","00","020","2026","0000","550","274","276","54","604","987","0","61.2","27.76"
"10","007","00","020","2026","0979","550","274","276","54","604","987","0","61.2","27.76"
"10","007","00","020","2027","0000","337","173","164","19","356","719","0","49.51","24.06"
"10","007","00","020","2027","0980","337","173","164","19","356","719","0","49.51","24.06"
"10","007","00","021","0000","0000","13186","5934","7252","703","13889","23179","27346","59.92","25.6"
"10","007","00","021","2101","0000","648","284","364","29","677","1284","0","52.73","22.12"
"10","007","00","021","2101","0863","648","284","364","29","677","1284","0","52.73","22.12"
"10","007","00","021","2102","0000","574","229","345","36","610","874","0","69.79","26.2"
"10","007","00","021","2102","0873","574","229","345","36","610","874","0","69.79","26.2"
"10","007","00","021","2103","0000","1503","554","949","81","1584","2562","0","61.83","21.62"
"10","007","00","021","2103","0871","802","294","508","43","845","1376","0","61.41","21.37"
"10","007","00","021","2103","0872","701","260","441","38","739","1186","0","62.31","21.92"
"10","007","00","021","2104","0000","637","261","376","47","684","1079","0","63.39","24.19"
"10","007","00","021","2104","0882","637","261","376","47","684","1079","0","63.39","24.19"
"10","007","00","021","2105","0000","397","180","217","21","418","760","0","55.0","23.68"
"10","007","00","021","2105","0886","397","180","217","21","418","760","0","55.0","23.68"
"10","007","00","021","2106","0000","664","333","331","42","706","1084","0","65.13","30.72"
"10","007","00","021","2106","0887","664","333","331","42","706","1084","0","65.13","30.72"
"10","007","00","021","2107","0000","622","266","356","30","652","1198","0","54.42","22.2"
"10","007","00","021","2107","0884","622","266","356","30","652","1198","0","54.42","22.2"
"10","007","00","021","2108","0000","333","167","166","23","356","621","0","57.33","26.89"
"10","007","00","021","2108","0885","333","167","166","23","356","621","0","57.33","26.89"
"10","007","00","021","2109","0000","734","364","370","47","781","1336","0","58.46","27.25"
"10","007","00","021","2109","0883","734","364","370","47","781","1336","0","58.46","27.25"
"10","007","00","021","2110","0000","719","364","355","32","751","1337","0","56.17","27.23"
"10","007","00","021","2110","0870","719","364","355","32","751","1337","0","56.17","27.23"
"10","007","00","021","2111","0000","885","406","479","57","942","1555","0","60.58","26.11"
"10","007","00","021","2111","0868","359","169","190","25","384","680","0","56.47","24.85"
"10","007","00","021","2111","0869","526","237","289","32","558","875","0","63.77","27.09"
"10","007","00","021","2112","0000","700","322","378","33","733","1187","0","61.75","27.13"
"10","007","00","021","2112","0864","700","322","378","33","733","1187","0","61.75","27.13"
"10","007","00","021","2113","0000","1015","435","580","59","1074","1729","0","62.12","25.16"
"10","007","00","021","2113","0865","613","279","334","33","646","1033","0","62.54","27.01"
"10","007","00","021","2113","0866","402","156","246","26","428","696","0","61.49","22.41"
"10","007","00","021","2114","0000","587","256","331","19","606","938","0","64.61","27.29"
"10","007","00","021","2114","0878","587","256","331","19","606","938","0","64.61","27.29"
"10","007","00","021","2115","0000","545","243","302","25","570","880","0","64.77","27.61"
"10","007","00","021","2115","0879","545","243","302","25","570","880","0","64.77","27.61"
"10","007","00","021","2116","0000","727","380","347","38","765","1396","0","54.8","27.22"
"10","007","00","021","2116","0880","407","196","211","25","432","804","0","53.73","24.38"
"10","007","00","021","2116","0881","320","184","136","13","333","592","0","56.25","31.08"
"10","007","00","021","2117","0000","904","418","486","40","944","1606","0","58.78","26.03"
"10","007","00","021","2117","0874","352","170","182","19","371","647","0","57.34","26.28"
"10","007","00","021","2117","0875","552","248","304","21","573","959","0","59.75","25.86"
"10","007","00","021","2118","0000","138","71","67","9","147","263","0","55.89","27.0"
"10","007","00","021","2118","0876","138","71","67","9","147","263","0","55.89","27.0"
"10","007","00","021","2119","0000","322","166","156","16","338","618","0","54.69","26.86"
"10","007","00","021","2119","0877","322","166","156","16","338","618","0","54.69","26.86"
"10","007","00","021","2120","0000","532","235","297","19","551","872","0","63.19","26.95"
"10","007","00","021","2120","0867","532","235","297","19","551","872","0","63.19","26.95"
"10","007","00","022","0000","0000","13257","5962","7295","903","14160","25677","30536","55.15","23.22"
"10","007","00","022","2201","0000","1201","516","685","77","1278","2468","0","51.78","20.91"
"10","007","00","022","2201","0888","548","253","295","34","582","1178","0","49.41","21.48"
"10","007","00","022","2201","0889","653","263","390","43","696","1290","0","53.95","20.39"
"10","007","00","022","2202","0000","917","438","479","51","968","1756","0","55.13","24.94"
"10","007","00","022","2202","0890","509","246","263","31","540","973","0","55.5","25.28"
"10","007","00","022","2202","0891","408","192","216","20","428","783","0","54.66","24.52"
"10","007","00","022","2203","0000","877","428","449","66","943","1632","0","57.78","26.23"
"10","007","00","022","2203","0892","388","177","211","30","418","733","0","57.03","24.15"
"10","007","00","022","2203","0893","489","251","238","36","525","899","0","58.4","27.92"
"10","007","00","022","2204","0000","1181","452","729","77","1258","2321","0","54.2","19.47"
"10","007","00","022","2204","0894","507","201","306","38","545","965","0","56.48","20.83"
"10","007","00","022","2204","0895","674","251","423","39","713","1356","0","52.58","18.51"
"10","007","00","022","2205","0000","648","281","367","47","695","1265","0","54.94","22.21"
"10","007","00","022","2205","0896","648","281","367","47","695","1265","0","54.94","22.21"
"10","007","00","022","2206","0000","847","372","475","74","921","1582","0","58.22","23.51"
"10","007","00","022","2206","0897","497","206","291","42","539","877","0","61.46","23.49"
"10","007","00","022","2206","0898","350","166","184","32","382","705","0","54.18","23.55"
"10","007","00","022","2207","0000","1839","783","1056","113","1952","3285","0","59.42","23.84"
"10","007","00","022","2207","0899","632","276","356","28","660","1062","0","62.15","25.99"
"10","007","00","022","2207","0900","705","284","421","41","746","1300","0","57.38","21.85"
"10","007","00","022","2207","0901","502","223","279","44","546","923","0","59.15","24.16"
"10","007","00","022","2208","0000","1163","445","718","52","1215","2188","0","55.53","20.34"
"10","007","00","022","2208","0902","543","223","320","18","561","1085","0","51.71","20.55"
"10","007","00","022","2208","0903","620","222","398","34","654","1103","0","59.29","20.13"
"10","007","00","022","2209","0000","371","162","209","15","386","735","0","52.52","22.04"
"10","007","00","022","2209","0904","371","162","209","15","386","735","0","52.52","22.04"
"10","007","00","022","2210","0000","292","141","151","25","317","574","0","55.23","24.56"
"10","007","00","022","2210","0905","292","141","151","25","317","574","0","55.23","24.56"
"10","007","00","022","2211","0000","743","315","428","59","802","1504","0","53.32","20.94"
"10","007","00","022","2211","0906","356","142","214","32","388","767","0","50.59","18.51"
"10","007","00","022","2211","0907","387","173","214","27","414","737","0","56.17","23.47"
"10","007","00","022","2212","0000","483","294","189","44","527","1058","0","49.81","27.79"
"10","007","00","022","2212","0908","483","294","189","44","527","1058","0","49.81","27.79"
"10","007","00","022","2213","0000","374","190","184","53","427","826","0","51.69","23.0"
"10","007","00","022","2213","0909","374","190","184","53","427","826","0","51.69","23.0"
"10","007","00","022","2214","0000","521","246","275","39","560","1082","0","51.76","22.74"
"10","007","00","022","2214","0910","521","246","275","39","560","1082","0","51.76","22.74"
"10","007","00","022","2215","0000","775","362","413","47","822","1448","0","56.77","25.0"
"10","007","00","022","2215","0911","414","201","213","35","449","737","0","60.92","27.27"
"10","007","00","022","2215","0912","361","161","200","12","373","711","0","52.46","22.64"
"10","007","00","022","2216","0000","550","296","254","47","597","1043","0","57.24","28.38"
"10","007","00","022","2216","0913","550","296","254","47","597","1043","0","57.24","28.38"
"10","007","00","022","2217","0000","475","241","234","17","492","910","0","54.07","26.48"
"10","007","00","022","2217","0914","475","241","234","17","492","910","0","54.07","26.48"
"10","007","00","023","0000","0000","13657","6731","6926","1081","14738","29291","33549","50.32","22.98"
"10","007","00","023","2301","0000","302","159","143","38","340","940","0","36.17","16.91"
"10","007","00","023","2301","0998","302","159","143","38","340","940","0","36.17","16.91"
"10","007","00","023","2302","0000","155","88","67","17","172","403","0","42.68","21.84"
"10","007","00","023","2302","0999","155","88","67","17","172","403","0","42.68","21.84"
"10","007","00","023","2303","0000","352","166","186","29","381","756","0","50.4","21.96"
"10","007","00","023","2303","1000","352","166","186","29","381","756","0","50.4","21.96"
"10","007","00","023","2304","0000","162","91","71","17","179","548","0","32.66","16.61"
"10","007","00","023","2304","1001","162","91","71","17","179","548","0","32.66","16.61"
"10","007","00","023","2305","0000","486","205","281","39","525","997","0","52.66","20.56"
"10","007","00","023","2305","1002","486","205","281","39","525","997","0","52.66","20.56"
"10","007","00","023","2306","0000","975","498","477","67","1042","2159","0","48.26","23.07"
"10","007","00","023","2306","1003","561","285","276","38","599","1300","0","46.08","21.92"
"10","007","00","023","2306","1004","414","213","201","29","443","859","0","51.57","24.8"
"10","007","00","023","2307","0000","660","308","352","33","693","1370","0","50.58","22.48"
"10","007","00","023","2307","1005","362","148","214","13","375","734","0","51.09","20.16"
"10","007","00","023","2307","1006","298","160","138","20","318","636","0","50.0","25.16"
"10","007","00","023","2308","0000","185","93","92","14","199","470","0","42.34","19.79"
"10","007","00","023","2308","1022","185","93","92","14","199","470","0","42.34","19.79"
"10","007","00","023","2309","0000","274","142","132","22","296","668","0","44.31","21.26"
"10","007","00","023","2309","1008","274","142","132","22","296","668","0","44.31","21.26"
"10","007","00","023","2310","0000","352","158","194","26","378","744","0","50.81","21.24"
"10","007","00","023","2310","1009","352","158","194","26","378","744","0","50.81","21.24"
"10","007","00","023","2311","0000","436","201","235","56","492","1026","0","47.95","19.59"
"10","007","00","023","2311","1010","436","201","235","56","492","1026","0","47.95","19.59"
"10","007","00","023","2312","0000","247","115","132","7","254","586","0","43.34","19.62"
"10","007","00","023","2312","1011","247","115","132","7","254","586","0","43.34","19.62"
"10","007","00","023","2313","0000","298","150","148","17","315","593","0","53.12","25.3"
"10","007","00","023","2313","1012","298","150","148","17","315","593","0","53.12","25.3"
"10","007","00","023","2314","0000","363","216","147","40","403","808","0","49.88","26.73"
"10","007","00","023","2314","1007","363","216","147","40","403","808","0","49.88","26.73"
"10","007","00","023","2315","0000","1048","543","505","91","1139","2131","0","53.45","25.48"
"10","007","00","023","2315","1013","528","298","230","49","577","1071","0","53.87","27.82"
"10","007","00","023","2315","1014","520","245","275","42","562","1060","0","53.02","23.11"
"10","007","00","023","2316","0000","363","200","163","16","379","708","0","53.53","28.25"
"10","007","00","023","2316","1015","363","200","163","16","379","708","0","53.53","28.25"
"10","007","00","023","2317","0000","324","169","155","46","370","735","0","50.34","22.99"
"10","007","00","023","2317","1016","324","169","155","46","370","735","0","50.34","22.99"
"10","007","00","023","2318","0000","312","166","146","46","358","674","0","53.12","24.63"
"10","007","00","023","2318","1019","312","166","146","46","358","674","0","53.12","24.63"
"10","007","00","023","2319","0000","598","322","276","54","652","1300","0","50.15","24.77"
"10","007","00","023","2319","1017","310","170","140","27","337","571","0","59.02","29.77"
"10","007","00","023","2319","1018","288","152","136","27","315","729","0","43.21","20.85"
"10","007","00","023","2320","0000","957","556","401","76","1033","1652","0","62.53","33.66"
"10","007","00","023","2320","1020","497","307","190","41","538","846","0","63.59","36.29"
"10","007","00","023","2320","1021","460","249","211","35","495","806","0","61.41","30.89"
"10","007","00","023","2321","0000","714","305","409","52","766","1441","0","53.16","21.17"
"10","007","00","023","2321","1023","578","244","334","36","614","1124","0","54.63","21.71"
"10","007","00","023","2321","1024","136","61","75","16","152","317","0","47.95","19.24"
"10","007","00","023","2322","0000","442","200","242","37","479","1086","0","44.11","18.42"
"10","007","00","023","2322","1028","442","200","242","37","479","1086","0","44.11","18.42"
"10","007","00","023","2323","0000","916","435","481","62","978","2125","0","46.02","20.47"
"10","007","00","023","2323","1025","473","230","243","34","507","1158","0","43.78","19.86"
"10","007","00","023","2323","1026","443","205","238","28","471","967","0","48.71","21.2"
"10","007","00","023","2324","0000","380","156","224","34","414","762","0","54.33","20.47"
"10","007","00","023","2324","1027","380","156","224","34","414","762","0","54.33","20.47"
"10","007","00","023","2325","0000","607","265","342","27","634","1400","0","45.29","18.93"
"10","007","00","023","2325","1029","352","146","206","16","368","747","0","49.26","19.54"
"10","007","00","023","2325","1030","255","119","136","11","266","653","0","40.74","18.22"
"10","007","00","023","2326","0000","1749","824","925","118","1867","3209","0","58.18","25.68"
"10","007","00","023","2326","1031","486","228","258","38","524","872","0","60.09","26.15"
"10","007","00","023","2326","1032","713","333","380","32","745","1235","0","60.32","26.96"
"10","007","00","023","2326","1033","550","263","287","48","598","1102","0","54.26","23.87"
"10","007","00","024","0000","0000","5385","2427","2958","407","5792","14713","16781","39.37","16.5"
"10","007","00","024","2401","0000","398","208","190","35","433","1104","0","39.22","18.84"
"10","007","00","024","2401","0982","398","208","190","35","433","1104","0","39.22","18.84"
"10","007","00","024","2402","0000","406","177","229","30","436","1092","0","39.93","16.21"
"10","007","00","024","2402","0986","168","61","107","17","185","518","0","35.71","11.78"
"10","007","00","024","2402","0987","238","116","122","13","251","574","0","43.73","20.21"
"10","007","00","024","2403","0000","577","226","351","36","613","1312","0","46.72","17.23"
"10","007","00","024","2403","0984","577","226","351","36","613","1312","0","46.72","17.23"
"10","007","00","024","2404","0000","325","128","197","43","368","853","0","43.14","15.01"
"10","007","00","024","2404","0985","325","128","197","43","368","853","0","43.14","15.01"
"10","007","00","024","2405","0000","504","214","290","39","543","964","0","56.33","22.2"
"10","007","00","024","2405","0983","504","214","290","39","543","964","0","56.33","22.2"
"10","007","00","024","2406","0000","402","158","244","21","423","1103","0","38.35","14.32"
"10","007","00","024","2406","0993","402","158","244","21","423","1103","0","38.35","14.32"
"10","007","00","024","2407","0000","454","193","261","20","474","1288","0","36.8","14.98"
"10","007","00","024","2407","0981","454","193","261","20","474","1288","0","36.8","14.98"
"10","007","00","024","2408","0000","253","117","136","19","272","702","0","38.75","16.67"
"10","007","00","024","2408","0988","253","117","136","19","272","702","0","38.75","16.67"
"10","007","00","024","2409","0000","222","115","107","10","232","686","0","33.82","16.76"
"10","007","00","024","2409","0996","222","115","107","10","232","686","0","33.82","16.76"
"10","007","00","024","2410","0000","308","155","153","34","342","1069","0","31.99","14.5"
"10","007","00","024","2410","0989","106","52","54","15","121","376","0","32.18","13.83"
"10","007","00","024","2410","0990","202","103","99","19","221","693","0","31.89","14.86"
"10","007","00","024","2411","0000","300","156","144","21","321","899","0","35.71","17.35"
"10","007","00","024","2411","0997","300","156","144","21","321","899","0","35.71","17.35"
"10","007","00","024","2412","0000","401","181","220","24","425","1192","0","35.65","15.18"
"10","007","00","024","2412","0994","401","181","220","24","425","1192","0","35.65","15.18"
"10","007","00","024","2413","0000","329","132","197","32","361","917","0","39.37","14.39"
"10","007","00","024","2413","0995","329","132","197","32","361","917","0","39.37","14.39"
"10","007","00","024","2414","0000","356","170","186","29","385","877","0","43.9","19.38"
"10","007","00","024","2414","0991","356","170","186","29","385","877","0","43.9","19.38"
"10","007","00","024","2415","0000","150","97","53","14","164","655","0","25.04","14.81"
"10","007","00","024","2415","0992","150","97","53","14","164","655","0","25.04","14.81"
"10","007","00","025","0000","0000","6607","3075","3532","465","7072","12821","15117","55.16","23.98"
"10","007","00","025","2501","0000","619","267","352","58","677","1168","0","57.96","22.86"
"10","007","00","025","2501","1034","619","267","352","58","677","1168","0","57.96","22.86"
"10","007","00","025","2502","0000","1090","464","626","74","1164","1925","0","60.47","24.1"
"10","007","00","025","2502","1035","538","232","306","27","565","965","0","58.55","24.04"
"10","007","00","025","2502","1036","552","232","320","47","599","960","0","62.4","24.17"
"10","007","00","025","2503","0000","440","195","245","45","485","743","0","65.28","26.24"
"10","007","00","025","2503","1037","440","195","245","45","485","743","0","65.28","26.24"
"10","007","00","025","2504","0000","315","135","180","25","340","751","0","45.27","17.98"
"10","007","00","025","2504","1038","315","135","180","25","340","751","0","45.27","17.98"
"10","007","00","025","2505","0000","716","353","363","27","743","1525","0","48.72","23.15"
"10","007","00","025","2505","1039","373","166","207","14","387","792","0","48.86","20.96"
"10","007","00","025","2505","1040","343","187","156","13","356","733","0","48.57","25.51"
"10","007","00","025","2506","0000","345","190","155","18","363","657","0","55.25","28.92"
"10","007","00","025","2506","1041","345","190","155","18","363","657","0","55.25","28.92"
"10","007","00","025","2507","0000","555","243","312","29","584","1063","0","54.94","22.86"
"10","007","00","025","2507","1042","555","243","312","29","584","1063","0","54.94","22.86"
"10","007","00","025","2508","0000","594","277","317","48","642","1114","0","57.63","24.87"
"10","007","00","025","2508","1043","594","277","317","48","642","1114","0","57.63","24.87"
"10","007","00","025","2509","0000","318","151","167","26","344","506","0","67.98","29.84"
"10","007","00","025","2509","1044","318","151","167","26","344","506","0","67.98","29.84"
"10","007","00","025","2510","0000","392","181","211","36","428","823","0","52.0","21.99"
"10","007","00","025","2510","1045","392","181","211","36","428","823","0","52.0","21.99"
"10","007","00","025","2511","0000","328","169","159","21","349","654","0","53.36","25.84"
"10","007","00","025","2511","1046","328","169","159","21","349","654","0","53.36","25.84"
"10","007","00","025","2512","0000","257","123","134","17","274","577","0","47.49","21.32"
"10","007","00","025","2512","1047","257","123","134","17","274","577","0","47.49","21.32"
"10","007","00","025","2513","0000","401","201","200","20","421","772","0","54.53","26.04"
"10","007","00","025","2513","1048","401","201","200","20","421","772","0","54.53","26.04"
"10","007","00","025","2514","0000","237","126","111","21","258","543","0","47.51","23.2"
"10","007","00","025","2514","1049","237","126","111","21","258","543","0","47.51","23.2"
"10","007","00","026","0000","0000","12576","6310","6266","828","13404","25405","29797","52.76","24.84"
"10","007","00","026","2601","0000","911","453","458","55","966","1839","0","52.53","24.63"
"10","007","00","026","2601","0915","403","194","209","34","437","778","0","56.17","24.94"
"10","007","00","026","2601","0916","508","259","249","21","529","1061","0","49.86","24.41"
"10","007","00","026","2602","0000","607","284","323","55","662","1409","0","46.98","20.16"
"10","007","00","026","2602","0925","607","284","323","55","662","1409","0","46.98","20.16"
"10","007","00","026","2603","0000","513","239","274","40","553","1157","0","47.8","20.66"
"10","007","00","026","2603","0930","513","239","274","40","553","1157","0","47.8","20.66"
"10","007","00","026","2604","0000","796","426","370","39","835","1490","0","56.04","28.59"
"10","007","00","026","2604","0941","796","426","370","39","835","1490","0","56.04","28.59"
"10","007","00","026","2605","0000","323","171","152","24","347","701","0","49.5","24.39"
"10","007","00","026","2605","0917","323","171","152","24","347","701","0","49.5","24.39"
"10","007","00","026","2606","0000","761","378","383","53","814","1506","0","54.05","25.1"
"10","007","00","026","2606","0926","410","191","219","16","426","792","0","53.79","24.12"
"10","007","00","026","2606","0927","351","187","164","37","388","714","0","54.34","26.19"
"10","007","00","026","2607","0000","418","208","210","30","448","843","0","53.14","24.67"
"10","007","00","026","2607","0936","418","208","210","30","448","843","0","53.14","24.67"
"10","007","00","026","2608","0000","516","286","230","29","545","879","0","62.0","32.54"
"10","007","00","026","2608","0918","516","286","230","29","545","879","0","62.0","32.54"
"10","007","00","026","2609","0000","920","467","453","65","985","2071","0","47.56","22.55"
"10","007","00","026","2609","0928","508","247","261","35","543","1109","0","48.96","22.27"
"10","007","00","026","2609","0929","412","220","192","30","442","962","0","45.95","22.87"
"10","007","00","026","2610","0000","291","170","121","12","303","711","0","42.62","23.91"
"10","007","00","026","2610","0937","291","170","121","12","303","711","0","42.62","23.91"
"10","007","00","026","2611","0000","892","444","448","48","940","1532","0","61.36","28.98"
"10","007","00","026","2611","0919","403","206","197","28","431","654","0","65.9","31.5"
"10","007","00","026","2611","0920","489","238","251","20","509","878","0","57.97","27.11"
"10","007","00","026","2612","0000","923","452","471","52","975","1839","0","53.02","24.58"
"10","007","00","026","2612","0931","466","234","232","29","495","952","0","52.0","24.58"
"10","007","00","026","2612","0932","457","218","239","23","480","887","0","54.11","24.58"
"10","007","00","026","2613","0000","432","225","207","43","475","851","0","55.82","26.44"
"10","007","00","026","2613","0938","432","225","207","43","475","851","0","55.82","26.44"
"10","007","00","026","2614","0000","1011","475","536","67","1078","1813","0","59.46","26.2"
"10","007","00","026","2614","0921","542","242","300","38","580","942","0","61.57","25.69"
"10","007","00","026","2614","0922","469","233","236","29","498","871","0","57.18","26.75"
"10","007","00","026","2615","0000","794","422","372","81","875","1876","0","46.64","22.49"
"10","007","00","026","2615","0933","345","182","163","41","386","866","0","44.57","21.02"
"10","007","00","026","2615","0934","449","240","209","40","489","1010","0","48.42","23.76"
"10","007","00","026","2616","0000","578","246","332","46","624","1247","0","50.04","19.73"
"10","007","00","026","2616","0940","578","246","332","46","624","1247","0","50.04","19.73"
"10","007","00","026","2617","0000","1016","504","512","53","1069","1905","0","56.12","26.46"
"10","007","00","026","2617","0923","532","270","262","25","557","1047","0","53.2","25.79"
"10","007","00","026","2617","0924","484","234","250","28","512","858","0","59.67","27.27"
"10","007","00","026","2618","0000","416","200","216","13","429","853","0","50.29","23.45"
"10","007","00","026","2618","0935","416","200","216","13","429","853","0","50.29","23.45"
"10","007","00","026","2619","0000","458","260","198","23","481","883","0","54.47","29.45"
"10","007","00","026","2619","0939","458","260","198","23","481","883","0","54.47","29.45"
"10","008","00","000","0000","0000","237025","98462","138563","12379","249404","427089","497876","58.4","23.05"
"10","008","00","001","0000","0000","49133","20281","28852","2236","51369","84328","99538","60.92","24.05"
"10","008","00","001","0101","0000","540","248","292","23","563","927","0","60.73","26.75"
"10","008","00","001","0101","0001","540","248","292","23","563","927","0","60.73","26.75"
"10","008","00","001","0102","0000","906","390","516","49","955","1440","0","66.32","27.08"
"10","008","00","001","0102","0002","431","176","255","24","455","667","0","68.22","26.39"
"10","008","00","001","0102","0003","475","214","261","25","500","773","0","64.68","27.68"
"10","008","00","001","0103","0000","493","208","285","29","522","818","0","63.81","25.43"
"10","008","00","001","0103","0004","493","208","285","29","522","818","0","63.81","25.43"
"10","008","00","001","0104","0000","351","170","181","11","362","525","0","68.95","32.38"
"10","008","00","001","0104","0005","351","170","181","11","362","525","0","68.95","32.38"
"10","008","00","001","0105","0000","370","174","196","16","386","575","0","67.13","30.26"
"10","008","00","001","0105","0006","370","174","196","16","386","575","0","67.13","30.26"
"10","008","00","001","0106","0000","243","167","76","12","255","368","0","69.29","45.38"
"10","008","00","001","0106","0007","243","167","76","12","255","368","0","69.29","45.38"
"10","008","00","001","0107","0000","593","231","362","40","633","956","0","66.21","24.16"
"10","008","00","001","0107","0008","593","231","362","40","633","956","0","66.21","24.16"
"10","008","00","001","0108","0000","1629","728","901","68","1697","2632","0","64.48","27.66"
"10","008","00","001","0108","0058","844","403","441","49","893","1387","0","64.38","29.06"
"10","008","00","001","0108","0059","785","325","460","19","804","1245","0","64.58","26.1"
"10","008","00","001","0109","0000","4133","1716","2417","190","4323","7018","0","61.6","24.45"
"10","008","00","001","0109","0060","668","290","378","25","693","1199","0","57.8","24.19"
"10","008","00","001","0109","0061","759","327","432","40","799","1288","0","62.03","25.39"
"10","008","00","001","0109","0062","588","260","328","36","624","1040","0","60.0","25.0"
"10","008","00","001","0109","0063","636","268","368","31","667","1070","0","62.34","25.05"
"10","008","00","001","0109","0064","787","317","470","34","821","1299","0","63.2","24.4"
"10","008","00","001","0109","0065","695","254","441","24","719","1122","0","64.08","22.64"
"10","008","00","001","0110","0000","2495","993","1502","108","2603","4543","0","57.3","21.86"
"10","008","00","001","0110","0032","761","297","464","34","795","1356","0","58.63","21.9"
"10","008","00","001","0110","0033","742","307","435","40","782","1373","0","56.96","22.36"
"10","008","00","001","0110","0034","786","317","469","29","815","1452","0","56.13","21.83"
"10","008","00","001","0110","0035","206","72","134","5","211","362","0","58.29","19.89"
"10","008","00","001","0111","0000","224","92","132","15","239","389","0","61.44","23.65"
"10","008","00","001","0111","0036","224","92","132","15","239","389","0","61.44","23.65"
"10","008","00","001","0112","0000","3488","1589","1899","202","3690","5992","0","61.58","26.52"
"10","008","00","001","0112","0022","528","225","303","26","554","960","0","57.71","23.44"
"10","008","00","001","0112","0023","526","219","307","33","559","906","0","61.7","24.17"
"10","008","00","001","0112","0024","563","244","319","39","602","957","0","62.9","25.5"
"10","008","00","001","0112","0025","609","351","258","46","655","997","0","65.7","35.21"
"10","008","00","001","0112","0026","608","275","333","27","635","1008","0","63.0","27.28"
"10","008","00","001","0112","0027","654","275","379","31","685","1164","0","58.85","23.63"
"10","008","00","001","0113","0000","1142","524","618","65","1207","2045","0","59.02","25.62"
"10","008","00","001","0113","0028","336","146","190","15","351","587","0","59.8","24.87"
"10","008","00","001","0113","0029","391","192","199","32","423","734","0","57.63","26.16"
"10","008","00","001","0113","0030","415","186","229","18","433","724","0","59.81","25.69"
"10","008","00","001","0114","0000","583","244","339","20","603","1003","0","60.12","24.33"
"10","008","00","001","0114","0031","583","244","339","20","603","1003","0","60.12","24.33"
"10","008","00","001","0115","0000","3140","1199","1941","114","3254","5426","0","59.97","22.1"
"10","008","00","001","0115","0009","658","273","385","19","677","1245","0","54.38","21.93"
"10","008","00","001","0115","0010","844","288","556","26","870","1484","0","58.63","19.41"
"10","008","00","001","0115","0011","751","281","470","32","783","1191","0","65.74","23.59"
"10","008","00","001","0115","0012","887","357","530","37","924","1506","0","61.35","23.71"
"10","008","00","001","0116","0000","1717","715","1002","89","1806","2790","0","64.73","25.63"
"10","008","00","001","0116","0013","646","250","396","33","679","1070","0","63.46","23.36"
"10","008","00","001","0116","0014","400","160","240","26","426","670","0","63.58","23.88"
"10","008","00","001","0116","0015","671","305","366","30","701","1050","0","66.76","29.05"
"10","008","00","001","0117","0000","1125","458","667","53","1178","2106","0","55.94","21.75"
"10","008","00","001","0117","0016","594","189","405","26","620","1122","0","55.26","16.84"
"10","008","00","001","0117","0017","531","269","262","27","558","984","0","56.71","27.34"
"10","008","00","001","0118","0000","2619","1227","1392","129","2748","4411","0","62.3","27.82"
"10","008","00","001","0118","0018","683","252","431","21","704","1062","0","66.29","23.73"
"10","008","00","001","0118","0019","612","250","362","35","647","1053","0","61.44","23.74"
"10","008","00","001","0118","0020","662","421","241","40","702","1104","0","63.59","38.13"
"10","008","00","001","0118","0021","662","304","358","33","695","1192","0","58.31","25.5"
"10","008","00","001","0119","0000","1013","412","601","50","1063","1930","0","55.08","21.35"
"10","008","00","001","0119","0083","508","228","280","33","541","950","0","56.95","24.0"
"10","008","00","001","0119","0084","505","184","321","17","522","980","0","53.27","18.78"
"10","008","00","001","0120","0000","370","175","195","30","400","790","0","50.63","22.15"
"10","008","00","001","0120","0081","370","175","195","30","400","790","0","50.63","22.15"
"10","008","00","001","0121","0000","296","148","148","12","308","647","0","47.6","22.87"
"10","008","00","001","0121","0082","296","148","148","12","308","647","0","47.6","22.87"
"10","008","00","001","0122","0000","541","298","243","57","598","1122","0","53.3","26.56"
"10","008","00","001","0122","0080","541","298","243","57","598","1122","0","53.3","26.56"
"10","008","00","001","0123","0000","3006","1264","1742","119","3125","5362","0","58.28","23.57"
"10","008","00","001","0123","0066","805","357","448","40","845","1414","0","59.76","25.25"
"10","008","00","001","0123","0067","646","263","383","32","678","1121","0","60.48","23.46"
"10","008","00","001","0123","0068","809","347","462","20","829","1434","0","57.81","24.2"
"10","008","00","001","0123","0069","746","297","449","27","773","1393","0","55.49","21.32"
"10","008","00","001","0124","0000","2612","1125","1487","88","2700","4907","0","55.02","22.93"
"10","008","00","001","0124","0070","601","270","331","17","618","1059","0","58.36","25.5"
"10","008","00","001","0124","0071","687","297","390","23","710","1218","0","58.29","24.38"
"10","008","00","001","0124","0072","672","303","369","16","688","1293","0","53.21","23.43"
"10","008","00","001","0124","0073","652","255","397","32","684","1337","0","51.16","19.07"
"10","008","00","001","0125","0000","1632","769","863","85","1717","2859","0","60.06","26.9"
"10","008","00","001","0125","0074","522","244","278","29","551","876","0","62.9","27.85"
"10","008","00","001","0125","0075","542","259","283","29","571","971","0","58.81","26.67"
"10","008","00","001","0125","0076","568","266","302","27","595","1012","0","58.79","26.28"
"10","008","00","001","0126","0000","1701","768","933","92","1793","2999","0","59.79","25.61"
"10","008","00","001","0126","0077","519","223","296","33","552","973","0","56.73","22.92"
"10","008","00","001","0126","0078","591","264","327","35","626","1002","0","62.48","26.35"
"10","008","00","001","0126","0079","591","281","310","24","615","1024","0","60.06","27.44"
"10","008","00","001","0127","0000","3769","1266","2503","134","3903","5880","0","66.38","21.53"
"10","008","00","001","0127","0039","571","231","340","27","598","921","0","64.93","25.08"
"10","008","00","001","0127","0040","605","209","396","22","627","892","0","70.29","23.43"
"10","008","00","001","0127","0041","674","202","472","25","699","1050","0","66.57","19.24"
"10","008","00","001","0127","0042","668","226","442","20","688","1078","0","63.82","20.96"
"10","008","00","001","0127","0043","649","189","460","18","667","1078","0","61.87","17.53"
"10","008","00","001","0127","0044","602","209","393","22","624","861","0","72.47","24.27"
"10","008","00","001","0128","0000","1489","596","893","60","1549","2365","0","65.5","25.2"
"10","008","00","001","0128","0037","796","320","476","37","833","1276","0","65.28","25.08"
"10","008","00","001","0128","0038","693","276","417","23","716","1089","0","65.75","25.34"
"10","008","00","001","0129","0000","3955","1446","2509","159","4114","6589","0","62.44","21.95"
"10","008","00","001","0129","0045","688","254","434","46","734","1221","0","60.11","20.8"
"10","008","00","001","0129","0046","634","261","373","33","667","1105","0","60.36","23.62"
"10","008","00","001","0129","0047","741","279","462","17","758","1230","0","61.63","22.68"
"10","008","00","001","0129","0048","652","226","426","23","675","1092","0","61.81","20.7"
"10","008","00","001","0129","0049","807","239","568","18","825","1286","0","64.15","18.58"
"10","008","00","001","0129","0050","433","187","246","22","455","655","0","69.47","28.55"
"10","008","00","001","0130","0000","867","402","465","43","910","1439","0","63.24","27.94"
"10","008","00","001","0130","0051","448","206","242","26","474","719","0","65.92","28.65"
"10","008","00","001","0130","0052","419","196","223","17","436","720","0","60.56","27.22"
"10","008","00","001","0131","0000","497","119","378","16","513","848","0","60.5","14.03"
"10","008","00","001","0131","0057","497","119","378","16","513","848","0","60.5","14.03"
"10","008","00","001","0132","0000","637","157","480","25","662","1108","0","59.75","14.17"
"10","008","00","001","0132","0054","273","64","209","10","283","492","0","57.52","13.01"
"10","008","00","001","0132","0055","364","93","271","15","379","616","0","61.53","15.1"
"10","008","00","001","0133","0000","622","145","477","20","642","1010","0","63.56","14.36"
"10","008","00","001","0133","0056","622","145","477","20","642","1010","0","63.56","14.36"
"10","008","00","001","0134","0000","335","118","217","13","348","509","0","68.37","23.18"
"10","008","00","001","0134","0053","335","118","217","13","348","509","0","68.37","23.18"
"10","008","00","002","0000","0000","38111","14608","23503","1896","40007","68763","80408","58.18","21.24"
"10","008","00","002","0201","0000","1526","622","904","84","1610","2676","0","60.16","23.24"
"10","008","00","002","0201","0085","483","192","291","24","507","828","0","61.23","23.19"
"10","008","00","002","0201","0086","460","187","273","34","494","786","0","62.85","23.79"
"10","008","00","002","0201","0087","583","243","340","26","609","1062","0","57.34","22.88"
"10","008","00","002","0202","0000","620","206","414","26","646","838","0","77.09","24.58"
"10","008","00","002","0202","0105","620","206","414","26","646","838","0","77.09","24.58"
"10","008","00","002","0203","0000","1665","682","983","79","1744","3107","0","56.13","21.95"
"10","008","00","002","0203","0102","497","191","306","14","511","901","0","56.71","21.2"
"10","008","00","002","0203","0103","524","246","278","29","553","997","0","55.47","24.67"
"10","008","00","002","0203","0104","644","245","399","36","680","1209","0","56.24","20.26"
"10","008","00","002","0204","0000","1368","508","860","48","1416","2489","0","56.89","20.41"
"10","008","00","002","0204","0106","598","227","371","22","620","1226","0","50.57","18.52"
"10","008","00","002","0204","0107","770","281","489","26","796","1263","0","63.02","22.25"
"10","008","00","002","0205","0000","1180","455","725","68","1248","2233","0","55.89","20.38"
"10","008","00","002","0205","0121","616","237","379","30","646","1133","0","57.02","20.92"
"10","008","00","002","0205","0122","564","218","346","38","602","1100","0","54.73","19.82"
"10","008","00","002","0206","0000","645","285","360","20","665","1023","0","65.0","27.86"
"10","008","00","002","0206","0126","645","285","360","20","665","1023","0","65.0","27.86"
"10","008","00","002","0207","0000","1939","726","1213","122","2061","3705","0","55.63","19.6"
"10","008","00","002","0207","0123","641","235","406","36","677","1155","0","58.61","20.35"
"10","008","00","002","0207","0124","641","242","399","37","678","1254","0","54.07","19.3"
"10","008","00","002","0207","0125","657","249","408","49","706","1296","0","54.48","19.21"
"10","008","00","002","0208","0000","3230","1236","1994","150","3380","5777","0","58.51","21.4"
"10","008","00","002","0208","0127","464","165","299","15","479","964","0","49.69","17.12"
"10","008","00","002","0208","0128","554","222","332","28","582","986","0","59.03","22.52"
"10","008","00","002","0208","0129","592","196","396","23","615","1016","0","60.53","19.29"
"10","008","00","002","0208","0130","502","211","291","35","537","898","0","59.8","23.5"
"10","008","00","002","0208","0131","572","231","341","31","603","980","0","61.53","23.57"
"10","008","00","002","0208","0132","546","211","335","18","564","933","0","60.45","22.62"
"10","008","00","002","0209","0000","624","263","361","28","652","929","0","70.18","28.31"
"10","008","00","002","0209","0133","624","263","361","28","652","929","0","70.18","28.31"
"10","008","00","002","0210","0000","3968","1480","2488","178","4146","7458","0","55.59","19.84"
"10","008","00","002","0210","0090","696","268","428","29","725","1282","0","56.55","20.9"
"10","008","00","002","0210","0091","479","160","319","18","497","859","0","57.86","18.63"
"10","008","00","002","0210","0092","704","263","441","41","745","1288","0","57.84","20.42"
"10","008","00","002","0210","0093","737","274","463","21","758","1330","0","56.99","20.6"
"10","008","00","002","0210","0094","729","277","452","43","772","1416","0","54.52","19.56"
"10","008","00","002","0210","0095","623","238","385","26","649","1283","0","50.58","18.55"
"10","008","00","002","0211","0000","2071","788","1283","114","2185","3815","0","57.27","20.66"
"10","008","00","002","0211","0096","652","226","426","50","702","1151","0","60.99","19.64"
"10","008","00","002","0211","0097","610","236","374","25","635","1193","0","53.23","19.78"
"10","008","00","002","0211","0098","809","326","483","39","848","1471","0","57.65","22.16"
"10","008","00","002","0212","0000","508","202","306","32","540","1044","0","51.72","19.35"
"10","008","00","002","0212","0099","508","202","306","32","540","1044","0","51.72","19.35"
"10","008","00","002","0213","0000","625","248","377","47","672","1122","0","59.89","22.1"
"10","008","00","002","0213","0100","625","248","377","47","672","1122","0","59.89","22.1"
"10","008","00","002","0214","0000","698","213","485","33","731","1129","0","64.75","18.87"
"10","008","00","002","0214","0101","698","213","485","33","731","1129","0","64.75","18.87"
"10","008","00","002","0215","0000","567","210","357","23","590","1032","0","57.17","20.35"
"10","008","00","002","0215","0134","567","210","357","23","590","1032","0","57.17","20.35"
"10","008","00","002","0216","0000","149","45","104","10","159","315","0","50.48","14.29"
"10","008","00","002","0216","0135","149","45","104","10","159","315","0","50.48","14.29"
"10","008","00","002","0217","0000","706","283","423","35","741","1363","0","54.37","20.76"
"10","008","00","002","0217","0136","706","283","423","35","741","1363","0","54.37","20.76"
"10","008","00","002","0218","0000","810","324","486","60","870","1430","0","60.84","22.66"
"10","008","00","002","0218","0137","410","157","253","31","441","725","0","60.83","21.66"
"10","008","00","002","0218","0138","400","167","233","29","429","705","0","60.85","23.69"
"10","008","00","002","0219","0000","977","399","578","44","1021","1683","0","60.67","23.71"
"10","008","00","002","0219","0139","465","213","252","22","487","751","0","64.85","28.36"
"10","008","00","002","0219","0140","512","186","326","22","534","932","0","57.3","19.96"
"10","008","00","002","0220","0000","737","296","441","45","782","1332","0","58.71","22.22"
"10","008","00","002","0220","0141","539","205","334","28","567","956","0","59.31","21.44"
"10","008","00","002","0220","0142","198","91","107","17","215","376","0","57.18","24.2"
"10","008","00","002","0221","0000","382","93","289","26","408","682","0","59.82","13.64"
"10","008","00","002","0221","0143","382","93","289","26","408","682","0","59.82","13.64"
"10","008","00","002","0222","0000","613","155","458","37","650","990","0","65.66","15.66"
"10","008","00","002","0222","0144","613","155","458","37","650","990","0","65.66","15.66"
"10","008","00","002","0223","0000","624","228","396","41","665","1170","0","56.84","19.49"
"10","008","00","002","0223","0147","624","228","396","41","665","1170","0","56.84","19.49"
"10","008","00","002","0224","0000","353","133","220","14","367","604","0","60.76","22.02"
"10","008","00","002","0224","0148","353","133","220","14","367","604","0","60.76","22.02"
"10","008","00","002","0225","0000","532","228","304","26","558","999","0","55.86","22.82"
"10","008","00","002","0225","0149","532","228","304","26","558","999","0","55.86","22.82"
"10","008","00","002","0226","0000","1506","598","908","65","1571","2791","0","56.29","21.43"
"10","008","00","002","0226","0150","479","189","290","12","491","923","0","53.2","20.48"
"10","008","00","002","0226","0151","515","190","325","23","538","887","0","60.65","21.42"
"10","008","00","002","0226","0152","512","219","293","30","542","981","0","55.25","22.32"
"10","008","00","002","0227","0000","920","419","501","67","987","1630","0","60.55","25.71"
"10","008","00","002","0227","0116","397","214","183","36","433","725","0","59.72","29.52"
"10","008","00","002","0227","0117","523","205","318","31","554","905","0","61.22","22.65"
"10","008","00","002","0228","0000","1317","519","798","96","1413","2588","0","54.6","20.05"
"10","008","00","002","0228","0118","606","242","364","40","646","1179","0","54.79","20.53"
"10","008","00","002","0228","0119","464","159","305","33","497","944","0","52.65","16.84"
"10","008","00","002","0228","0120","247","118","129","23","270","465","0","58.06","25.38"
"10","008","00","002","0229","0000","772","326","446","53","825","1622","0","50.86","20.1"
"10","008","00","002","0229","0145","634","251","383","44","678","1324","0","51.21","18.96"
"10","008","00","002","0229","0146","138","75","63","9","147","298","0","49.33","25.17"
"10","008","00","002","0230","0000","1955","744","1211","82","2037","3227","0","63.12","23.06"
"10","008","00","002","0230","0108","610","232","378","29","639","1045","0","61.15","22.2"
"10","008","00","002","0230","0109","679","258","421","23","702","1120","0","62.68","23.04"
"10","008","00","002","0230","0110","666","254","412","30","696","1062","0","65.54","23.92"
"10","008","00","002","0231","0000","1505","565","940","49","1554","2616","0","59.4","21.6"
"10","008","00","002","0231","0088","722","297","425","27","749","1201","0","62.36","24.73"
"10","008","00","002","0231","0089","783","268","515","22","805","1415","0","56.89","18.94"
"10","008","00","002","0232","0000","1782","672","1110","61","1843","3179","0","57.97","21.14"
"10","008","00","002","0232","0111","576","212","364","27","603","1022","0","59.0","20.74"
"10","008","00","002","0232","0112","587","239","348","15","602","1051","0","57.28","22.74"
"10","008","00","002","0232","0113","619","221","398","19","638","1106","0","57.69","19.98"
"10","008","00","002","0233","0000","1237","457","780","33","1270","2165","0","58.66","21.11"
"10","008","00","002","0233","0114","621","220","401","14","635","1098","0","57.83","20.04"
"10","008","00","002","0233","0115","616","237","379","19","635","1067","0","59.51","22.21"
"10","008","00","003","0000","0000","46469","19594","26875","1925","48394","82922","97223","58.36","23.63"
"10","008","00","003","0301","0000","1220","515","705","32","1252","2125","0","58.92","24.24"
"10","008","00","003","0301","0153","603","267","336","19","622","998","0","62.32","26.75"
"10","008","00","003","0301","0154","617","248","369","13","630","1127","0","55.9","22.01"
"10","008","00","003","0302","0000","1168","484","684","56","1224","2077","0","58.93","23.3"
"10","008","00","003","0302","0158","521","218","303","23","544","936","0","58.12","23.29"
"10","008","00","003","0302","0159","647","266","381","33","680","1141","0","59.6","23.31"
"10","008","00","003","0303","0000","703","332","371","14","717","1121","0","63.96","29.62"
"10","008","00","003","0303","0161","703","332","371","14","717","1121","0","63.96","29.62"
"10","008","00","003","0304","0000","3656","1485","2171","164","3820","6455","0","59.18","23.01"
"10","008","00","003","0304","0164","679","291","388","26","705","1267","0","55.64","22.97"
"10","008","00","003","0304","0165","677","234","443","45","722","1214","0","59.47","19.28"
"10","008","00","003","0304","0166","715","305","410","38","753","1259","0","59.81","24.23"
"10","008","00","003","0304","0167","853","350","503","24","877","1442","0","60.82","24.27"
"10","008","00","003","0304","0168","732","305","427","31","763","1273","0","59.94","23.96"
"10","008","00","003","0305","0000","4291","1552","2739","142","4433","7422","0","59.73","20.91"
"10","008","00","003","0305","0169","622","229","393","26","648","1145","0","56.59","20.0"
"10","008","00","003","0305","0170","703","244","459","17","720","1279","0","56.29","19.08"
"10","008","00","003","0305","0171","643","231","412","18","661","1158","0","57.08","19.95"
"10","008","00","003","0305","0172","856","269","587","19","875","1335","0","65.54","20.15"
"10","008","00","003","0305","0173","719","283","436","27","746","1178","0","63.33","24.02"
"10","008","00","003","0305","0174","748","296","452","35","783","1327","0","59.01","22.31"
"10","008","00","003","0306","0000","3571","1660","1911","122","3693","6403","0","57.68","25.93"
"10","008","00","003","0306","0208","795","374","421","39","834","1466","0","56.89","25.51"
"10","008","00","003","0306","0209","660","260","400","20","680","1180","0","57.63","22.03"
"10","008","00","003","0306","0210","604","404","200","12","616","1006","0","61.23","40.16"
"10","008","00","003","0306","0211","495","211","284","17","512","1000","0","51.2","21.1"
"10","008","00","003","0306","0212","665","253","412","26","691","1128","0","61.26","22.43"
"10","008","00","003","0306","0213","352","158","194","8","360","623","0","57.78","25.36"
"10","008","00","003","0307","0000","2972","1222","1750","155","3127","6046","0","51.72","20.21"
"10","008","00","003","0307","0190","609","219","390","21","630","1395","0","45.16","15.7"
"10","008","00","003","0307","0191","656","257","399","30","686","1101","0","62.31","23.34"
"10","008","00","003","0307","0192","674","302","372","30","704","1297","0","54.28","23.28"
"10","008","00","003","0307","0193","404","180","224","19","423","877","0","48.23","20.52"
"10","008","00","003","0307","0194","629","264","365","55","684","1376","0","49.71","19.19"
"10","008","00","003","0308","0000","2409","1072","1337","110","2519","4066","0","61.95","26.36"
"10","008","00","003","0308","0195","631","260","371","24","655","1008","0","64.98","25.79"
"10","008","00","003","0308","0196","647","271","376","27","674","1080","0","62.41","25.09"
"10","008","00","003","0308","0197","543","254","289","32","575","1017","0","56.54","24.98"
"10","008","00","003","0308","0198","588","287","301","27","615","961","0","64.0","29.86"
"10","008","00","003","0309","0000","2320","949","1371","107","2427","4392","0","55.26","21.61"
"10","008","00","003","0309","0181","531","241","290","21","552","1048","0","52.67","23.0"
"10","008","00","003","0309","0182","552","223","329","30","582","1009","0","57.68","22.1"
"10","008","00","003","0309","0183","585","229","356","32","617","1138","0","54.22","20.12"
"10","008","00","003","0309","0184","652","256","396","24","676","1197","0","56.47","21.39"
"10","008","00","003","0310","0000","1397","477","920","51","1448","2423","0","59.76","19.69"
"10","008","00","003","0310","0185","780","270","510","26","806","1364","0","59.09","19.79"
"10","008","00","003","0310","0186","617","207","410","25","642","1059","0","60.62","19.55"
"10","008","00","003","0311","0000","1654","802","852","83","1737","2944","0","59.0","27.24"
"10","008","00","003","0311","0187","638","275","363","25","663","1108","0","59.84","24.82"
"10","008","00","003","0311","0188","479","309","170","28","507","879","0","57.68","35.15"
"10","008","00","003","0311","0189","537","218","319","30","567","957","0","59.25","22.78"
"10","008","00","003","0312","0000","1789","685","1104","63","1852","3143","0","58.92","21.79"
"10","008","00","003","0312","0178","604","231","373","19","623","1121","0","55.58","20.61"
"10","008","00","003","0312","0179","591","221","370","30","621","1043","0","59.54","21.19"
"10","008","00","003","0312","0180","594","233","361","14","608","979","0","62.1","23.8"
"10","008","00","003","0313","0000","2024","820","1204","80","2104","3524","0","59.7","23.27"
"10","008","00","003","0313","0199","677","285","392","35","712","1160","0","61.38","24.57"
"10","008","00","003","0313","0200","654","256","398","15","669","1121","0","59.68","22.84"
"10","008","00","003","0313","0201","693","279","414","30","723","1243","0","58.17","22.45"
"10","008","00","003","0314","0000","1671","846","825","76","1747","2919","0","59.85","28.98"
"10","008","00","003","0314","0205","570","300","270","33","603","923","0","65.33","32.5"
"10","008","00","003","0314","0206","510","253","257","24","534","970","0","55.05","26.08"
"10","008","00","003","0314","0207","591","293","298","19","610","1026","0","59.45","28.56"
"10","008","00","003","0315","0000","789","325","464","18","807","1518","0","53.16","21.41"
"10","008","00","003","0315","0204","789","325","464","18","807","1518","0","53.16","21.41"
"10","008","00","003","0316","0000","1401","648","753","49","1450","2255","0","64.3","28.74"
"10","008","00","003","0316","0202","567","263","304","12","579","932","0","62.12","28.22"
"10","008","00","003","0316","0203","834","385","449","37","871","1323","0","65.84","29.1"
"10","008","00","003","0317","0000","1007","499","508","78","1085","1953","0","55.56","25.55"
"10","008","00","003","0317","0214","383","190","193","40","423","707","0","59.83","26.87"
"10","008","00","003","0317","0215","385","199","186","19","404","719","0","56.19","27.68"
"10","008","00","003","0317","0216","239","110","129","19","258","527","0","48.96","20.87"
"10","008","00","003","0318","0000","1198","555","643","69","1267","2052","0","61.74","27.05"
"10","008","00","003","0318","0217","674","308","366","40","714","1183","0","60.36","26.04"
"10","008","00","003","0318","0218","524","247","277","29","553","869","0","63.64","28.42"
"10","008","00","003","0319","0000","2261","1063","1198","88","2349","4114","0","57.1","25.84"
"10","008","00","003","0319","0219","579","281","298","17","596","1132","0","52.65","24.82"
"10","008","00","003","0319","0220","546","268","278","28","574","949","0","60.48","28.24"
"10","008","00","003","0319","0221","570","246","324","17","587","965","0","60.83","25.49"
"10","008","00","003","0319","0222","566","268","298","26","592","1068","0","55.43","25.09"
"10","008","00","003","0320","0000","860","362","498","36","896","1659","0","54.01","21.82"
"10","008","00","003","0320","0224","341","136","205","13","354","642","0","55.14","21.18"
"10","008","00","003","0320","0225","519","226","293","23","542","1017","0","53.29","22.22"
"10","008","00","003","0321","0000","604","273","331","32","636","1024","0","62.11","26.66"
"10","008","00","003","0321","0223","604","273","331","32","636","1024","0","62.11","26.66"
"10","008","00","003","0322","0000","1288","509","779","62","1350","2276","0","59.31","22.36"
"10","008","00","003","0322","0227","642","264","378","38","680","1170","0","58.12","22.56"
"10","008","00","003","0322","0228","646","245","401","24","670","1106","0","60.58","22.15"
"10","008","00","003","0323","0000","605","228","377","23","628","1092","0","57.51","20.88"
"10","008","00","003","0323","0226","605","228","377","23","628","1092","0","57.51","20.88"
"10","008","00","003","0324","0000","425","179","246","21","446","705","0","63.26","25.39"
"10","008","00","003","0324","0160","425","179","246","21","446","705","0","63.26","25.39"
"10","008","00","003","0325","0000","1358","616","742","47","1405","2278","0","61.68","27.04"
"10","008","00","003","0325","0162","564","253","311","18","582","877","0","66.36","28.85"
"10","008","00","003","0325","0163","794","363","431","29","823","1401","0","58.74","25.91"
"10","008","00","003","0326","0000","2089","666","1423","75","2164","3796","0","57.01","17.54"
"10","008","00","003","0326","0155","750","278","472","19","769","1401","0","54.89","19.84"
"10","008","00","003","0326","0156","609","284","325","20","629","1110","0","56.67","25.59"
"10","008","00","003","0326","0157","730","104","626","36","766","1285","0","59.61","8.09"
"10","008","00","003","0327","0000","1739","770","969","72","1811","3140","0","57.68","24.52"
"10","008","00","003","0327","0175","589","222","367","29","618","1000","0","61.8","22.2"
"10","008","00","003","0327","0176","595","248","347","23","618","1257","0","49.16","19.73"
"10","008","00","003","0327","0177","555","300","255","20","575","883","0","65.12","33.98"
"10","008","00","004","0000","0000","24971","10910","14061","1442","26413","47034","54689","56.16","23.2"
"10","008","00","004","0401","0000","1179","512","667","67","1246","2020","0","61.68","25.35"
"10","008","00","004","0401","0229","671","290","381","37","708","1170","0","60.51","24.79"
"10","008","00","004","0401","0230","508","222","286","30","538","850","0","63.29","26.12"
"10","008","00","004","0402","0000","321","148","173","22","343","621","0","55.23","23.83"
"10","008","00","004","0402","0231","321","148","173","22","343","621","0","55.23","23.83"
"10","008","00","004","0403","0000","2343","961","1382","161","2504","4505","0","55.58","21.33"
"10","008","00","004","0403","0232","483","207","276","30","513","905","0","56.69","22.87"
"10","008","00","004","0403","0233","513","215","298","45","558","1099","0","50.77","19.56"
"10","008","00","004","0403","0234","607","216","391","44","651","1214","0","53.62","17.79"
"10","008","00","004","0403","0235","740","323","417","42","782","1287","0","60.76","25.1"
"10","008","00","004","0404","0000","1961","806","1155","116","2077","3587","0","57.9","22.47"
"10","008","00","004","0404","0236","654","274","380","42","696","1191","0","58.44","23.01"
"10","008","00","004","0404","0237","592","263","329","49","641","1118","0","57.33","23.52"
"10","008","00","004","0404","0238","715","269","446","25","740","1278","0","57.9","21.05"
"10","008","00","004","0405","0000","983","443","540","57","1040","1715","0","60.64","25.83"
"10","008","00","004","0405","0270","458","195","263","38","496","793","0","62.55","24.59"
"10","008","00","004","0405","0271","525","248","277","19","544","922","0","59.0","26.9"
"10","008","00","004","0406","0000","668","264","404","28","696","1193","0","58.34","22.13"
"10","008","00","004","0406","0244","304","130","174","17","321","511","0","62.82","25.44"
"10","008","00","004","0406","0245","364","134","230","11","375","682","0","54.99","19.65"
"10","008","00","004","0407","0000","1949","844","1105","112","2061","3710","0","55.55","22.75"
"10","008","00","004","0407","0241","704","302","402","39","743","1308","0","56.8","23.09"
"10","008","00","004","0407","0242","695","285","410","43","738","1358","0","54.34","20.99"
"10","008","00","004","0407","0243","550","257","293","30","580","1044","0","55.56","24.62"
"10","008","00","004","0408","0000","521","277","244","24","545","989","0","55.11","28.01"
"10","008","00","004","0408","0246","521","277","244","24","545","989","0","55.11","28.01"
"10","008","00","004","0409","0000","737","326","411","36","773","1378","0","56.1","23.66"
"10","008","00","004","0409","0247","737","326","411","36","773","1378","0","56.1","23.66"
"10","008","00","004","0410","0000","424","159","265","23","447","875","0","51.09","18.17"
"10","008","00","004","0410","0272","179","80","99","17","196","366","0","53.55","21.86"
"10","008","00","004","0410","0273","245","79","166","6","251","509","0","49.31","15.52"
"10","008","00","004","0411","0000","1552","730","822","71","1623","2882","0","56.32","25.33"
"10","008","00","004","0411","0260","729","324","405","37","766","1320","0","58.03","24.55"
"10","008","00","004","0411","0261","521","238","283","20","541","967","0","55.95","24.61"
"10","008","00","004","0411","0262","302","168","134","14","316","595","0","53.11","28.24"
"10","008","00","004","0412","0000","801","361","440","55","856","1729","0","49.51","20.88"
"10","008","00","004","0412","0258","413","171","242","21","434","908","0","47.8","18.83"
"10","008","00","004","0412","0259","388","190","198","34","422","821","0","51.4","23.14"
"10","008","00","004","0413","0000","446","210","236","34","480","859","0","55.88","24.45"
"10","008","00","004","0413","0263","446","210","236","34","480","859","0","55.88","24.45"
"10","008","00","004","0414","0000","2731","1204","1527","135","2866","4873","0","58.81","24.71"
"10","008","00","004","0414","0251","785","316","469","37","822","1437","0","57.2","21.99"
"10","008","00","004","0414","0252","746","291","455","38","784","1286","0","60.96","22.63"
"10","008","00","004","0414","0253","621","358","263","37","658","1080","0","60.93","33.15"
"10","008","00","004","0414","0254","579","239","340","23","602","1070","0","56.26","22.34"
"10","008","00","004","0415","0000","952","440","512","72","1024","1845","0","55.5","23.85"
"10","008","00","004","0415","0264","611","281","330","40","651","1196","0","54.43","23.49"
"10","008","00","004","0415","0265","341","159","182","32","373","649","0","57.47","24.5"
"10","008","00","004","0416","0000","738","333","405","30","768","1341","0","57.27","24.83"
"10","008","00","004","0416","0266","738","333","405","30","768","1341","0","57.27","24.83"
"10","008","00","004","0417","0000","611","286","325","39","650","1222","0","53.19","23.4"
"10","008","00","004","0417","0267","611","286","325","39","650","1222","0","53.19","23.4"
"10","008","00","004","0418","0000","332","151","181","18","350","602","0","58.14","25.08"
"10","008","00","004","0418","0268","332","151","181","18","350","602","0","58.14","25.08"
"10","008","00","004","0419","0000","207","84","123","9","216","430","0","50.23","19.53"
"10","008","00","004","0419","0250","207","84","123","9","216","430","0","50.23","19.53"
"10","008","00","004","0420","0000","330","147","183","16","346","617","0","56.08","23.82"
"10","008","00","004","0420","0269","330","147","183","16","346","617","0","56.08","23.82"
"10","008","00","004","0421","0000","344","123","221","20","364","599","0","60.77","20.53"
"10","008","00","004","0421","0274","106","32","74","5","111","193","0","57.51","16.58"
"10","008","00","004","0421","0275","238","91","147","15","253","406","0","62.32","22.41"
"10","008","00","004","0422","0000","347","172","175","27","374","802","0","46.63","21.45"
"10","008","00","004","0422","0276","235","114","121","19","254","495","0","51.31","23.03"
"10","008","00","004","0422","0277","112","58","54","8","120","307","0","39.09","18.89"
"10","008","00","004","0423","0000","285","122","163","29","314","577","0","54.42","21.14"
"10","008","00","004","0423","0279","285","122","163","29","314","577","0","54.42","21.14"
"10","008","00","004","0424","0000","224","92","132","15","239","440","0","54.32","20.91"
"10","008","00","004","0424","0278","224","92","132","15","239","440","0","54.32","20.91"
"10","008","00","004","0425","0000","326","155","171","36","362","889","0","40.72","17.44"
"10","008","00","004","0425","0280","187","95","92","27","214","486","0","44.03","19.55"
"10","008","00","004","0425","0281","139","60","79","9","148","403","0","36.72","14.89"
"10","008","00","004","0426","0000","379","175","204","28","407","696","0","58.48","25.14"
"10","008","00","004","0426","0248","109","42","67","6","115","217","0","53.0","19.35"
"10","008","00","004","0426","0249","270","133","137","22","292","479","0","60.96","27.77"
"10","008","00","004","0427","0000","2016","846","1170","86","2102","3642","0","57.72","23.23"
"10","008","00","004","0427","0255","727","272","455","30","757","1295","0","58.46","21.0"
"10","008","00","004","0427","0256","583","270","313","24","607","1047","0","57.98","25.79"
"10","008","00","004","0427","0257","706","304","402","32","738","1300","0","56.77","23.38"
"10","008","00","004","0428","0000","1264","539","725","76","1340","2396","0","55.93","22.5"
"10","008","00","004","0428","0239","640","262","378","36","676","1153","0","58.63","22.72"
"10","008","00","004","0428","0240","624","277","347","40","664","1243","0","53.42","22.28"
"10","008","00","005","0000","0000","5364","2235","3129","275","5639","9611","10871","58.67","23.25"
"10","008","00","005","0501","0000","639","239","400","26","665","1070","0","62.15","22.34"
"10","008","00","005","0501","0282","639","239","400","26","665","1070","0","62.15","22.34"
"10","008","00","005","0502","0000","539","209","330","23","562","918","0","61.22","22.77"
"10","008","00","005","0502","0283","539","209","330","23","562","918","0","61.22","22.77"
"10","008","00","005","0503","0000","340","142","198","17","357","581","0","61.45","24.44"
"10","008","00","005","0503","0284","340","142","198","17","357","581","0","61.45","24.44"
"10","008","00","005","0504","0000","687","328","359","32","719","1194","0","60.22","27.47"
"10","008","00","005","0504","0285","687","328","359","32","719","1194","0","60.22","27.47"
"10","008","00","005","0505","0000","209","96","113","16","225","488","0","46.11","19.67"
"10","008","00","005","0505","0286","209","96","113","16","225","488","0","46.11","19.67"
"10","008","00","005","0506","0000","289","126","163","24","313","504","0","62.1","25.0"
"10","008","00","005","0506","0287","289","126","163","24","313","504","0","62.1","25.0"
"10","008","00","005","0507","0000","535","229","306","30","565","910","0","62.09","25.16"
"10","008","00","005","0507","0288","535","229","306","30","565","910","0","62.09","25.16"
"10","008","00","005","0508","0000","850","366","484","48","898","1482","0","60.59","24.7"
"10","008","00","005","0508","0289","458","186","272","30","488","773","0","63.13","24.06"
"10","008","00","005","0508","0290","392","180","212","18","410","709","0","57.83","25.39"
"10","008","00","005","0509","0000","547","220","327","18","565","960","0","58.85","22.92"
"10","008","00","005","0509","0291","547","220","327","18","565","960","0","58.85","22.92"
"10","008","00","005","0510","0000","271","111","160","8","279","582","0","47.94","19.07"
"10","008","00","005","0510","0294","271","111","160","8","279","582","0","47.94","19.07"
"10","008","00","005","0511","0000","458","169","289","33","491","922","0","53.25","18.33"
"10","008","00","005","0511","0292","261","99","162","17","278","503","0","55.27","19.68"
"10","008","00","005","0511","0293","197","70","127","16","213","419","0","50.84","16.71"
"10","008","00","006","0000","0000","19146","8870","10276","1131","20277","33408","38376","60.7","26.55"
"10","008","00","006","0601","0000","701","302","399","31","732","1050","0","69.71","28.76"
"10","008","00","006","0601","0295","701","302","399","31","732","1050","0","69.71","28.76"
"10","008","00","006","0602","0000","2015","910","1105","101","2116","3405","0","62.14","26.73"
"10","008","00","006","0602","0296","531","237","294","31","562","920","0","61.09","25.76"
"10","008","00","006","0602","0297","449","218","231","29","478","727","0","65.75","29.99"
"10","008","00","006","0602","0298","536","235","301","13","549","861","0","63.76","27.29"
"10","008","00","006","0602","0299","499","220","279","28","527","897","0","58.75","24.53"
"10","008","00","006","0603","0000","1279","574","705","70","1349","2239","0","60.25","25.64"
"10","008","00","006","0603","0300","615","282","333","36","651","1055","0","61.71","26.73"
"10","008","00","006","0603","0301","664","292","372","34","698","1184","0","58.95","24.66"
"10","008","00","006","0604","0000","897","395","502","47","944","1564","0","60.36","25.26"
"10","008","00","006","0604","0302","426","202","224","20","446","783","0","56.96","25.8"
"10","008","00","006","0604","0303","471","193","278","27","498","781","0","63.76","24.71"
"10","008","00","006","0605","0000","538","244","294","38","576","1015","0","56.75","24.04"
"10","008","00","006","0605","0305","538","244","294","38","576","1015","0","56.75","24.04"
"10","008","00","006","0606","0000","531","259","272","33","564","977","0","57.73","26.51"
"10","008","00","006","0606","0304","531","259","272","33","564","977","0","57.73","26.51"
"10","008","00","006","0607","0000","2470","1161","1309","113","2583","4234","0","61.01","27.42"
"10","008","00","006","0607","0306","553","254","299","16","569","914","0","62.25","27.79"
"10","008","00","006","0607","0307","624","291","333","11","635","1028","0","61.77","28.31"
"10","008","00","006","0607","0308","591","285","306","32","623","1018","0","61.2","28.0"
"10","008","00","006","0607","0309","702","331","371","54","756","1274","0","59.34","25.98"
"10","008","00","006","0608","0000","981","480","501","67","1048","1650","0","63.52","29.09"
"10","008","00","006","0608","0310","426","226","200","30","456","755","0","60.4","29.93"
"10","008","00","006","0608","0311","555","254","301","37","592","895","0","66.15","28.38"
"10","008","00","006","0609","0000","513","264","249","41","554","951","0","58.25","27.76"
"10","008","00","006","0609","0313","513","264","249","41","554","951","0","58.25","27.76"
"10","008","00","006","0610","0000","694","328","366","36","730","1261","0","57.89","26.01"
"10","008","00","006","0610","0314","694","328","366","36","730","1261","0","57.89","26.01"
"10","008","00","006","0611","0000","1072","571","501","59","1131","1829","0","61.84","31.22"
"10","008","00","006","0611","0316","555","318","237","31","586","962","0","60.91","33.06"
"10","008","00","006","0611","0317","517","253","264","28","545","867","0","62.86","29.18"
"10","008","00","006","0612","0000","534","273","261","35","569","930","0","61.18","29.35"
"10","008","00","006","0612","0318","534","273","261","35","569","930","0","61.18","29.35"
"10","008","00","006","0613","0000","411","195","216","34","445","768","0","57.94","25.39"
"10","008","00","006","0613","0315","411","195","216","34","445","768","0","57.94","25.39"
"10","008","00","006","0614","0000","528","262","266","36","564","931","0","60.58","28.14"
"10","008","00","006","0614","0321","528","262","266","36","564","931","0","60.58","28.14"
"10","008","00","006","0615","0000","626","309","317","53","679","1171","0","57.98","26.39"
"10","008","00","006","0615","0319","353","165","188","39","392","641","0","61.15","25.74"
"10","008","00","006","0615","0320","273","144","129","14","287","530","0","54.15","27.17"
"10","008","00","006","0616","0000","907","435","472","61","968","1570","0","61.66","27.71"
"10","008","00","006","0616","0322","635","285","350","36","671","1127","0","59.54","25.29"
"10","008","00","006","0616","0323","272","150","122","25","297","443","0","67.04","33.86"
"10","008","00","006","0617","0000","878","416","462","55","933","1491","0","62.58","27.9"
"10","008","00","006","0617","0324","507","242","265","31","538","870","0","61.84","27.82"
"10","008","00","006","0617","0325","371","174","197","24","395","621","0","63.61","28.02"
"10","008","00","006","0618","0000","629","295","334","28","657","1179","0","55.73","25.02"
"10","008","00","006","0618","0326","629","295","334","28","657","1179","0","55.73","25.02"
"10","008","00","006","0619","0000","563","216","347","35","598","876","0","68.26","24.66"
"10","008","00","006","0619","0328","563","216","347","35","598","876","0","68.26","24.66"
"10","008","00","006","0620","0000","517","195","322","41","558","881","0","63.34","22.13"
"10","008","00","006","0620","0327","517","195","322","41","558","881","0","63.34","22.13"
"10","008","00","006","0621","0000","445","199","246","33","478","783","0","61.05","25.42"
"10","008","00","006","0621","0329","445","199","246","33","478","783","0","61.05","25.42"
"10","008","00","006","0622","0000","914","413","501","60","974","1761","0","55.31","23.45"
"10","008","00","006","0622","0330","405","167","238","21","426","778","0","54.76","21.47"
"10","008","00","006","0622","0331","509","246","263","39","548","983","0","55.75","25.03"
"10","008","00","006","0623","0000","503","174","329","24","527","892","0","59.08","19.51"
"10","008","00","006","0623","0312","503","174","329","24","527","892","0","59.08","19.51"
"10","008","00","007","0000","0000","8230","3428","4802","490","8720","15941","17698","54.7","21.5"
"10","008","00","007","0701","0000","975","406","569","52","1027","1874","0","54.8","21.66"
"10","008","00","007","0701","0332","467","177","290","17","484","934","0","51.82","18.95"
"10","008","00","007","0701","0333","508","229","279","35","543","940","0","57.77","24.36"
"10","008","00","007","0702","0000","673","244","429","40","713","1430","0","49.86","17.06"
"10","008","00","007","0702","0348","356","126","230","18","374","713","0","52.45","17.67"
"10","008","00","007","0702","0349","317","118","199","22","339","717","0","47.28","16.46"
"10","008","00","007","0703","0000","651","280","371","36","687","1303","0","52.72","21.49"
"10","008","00","007","0703","0334","439","183","256","19","458","852","0","53.76","21.48"
"10","008","00","007","0703","0335","212","97","115","17","229","451","0","50.78","21.51"
"10","008","00","007","0704","0000","1138","409","729","71","1209","1952","0","61.94","20.95"
"10","008","00","007","0704","0336","470","180","290","27","497","810","0","61.36","22.22"
"10","008","00","007","0704","0337","668","229","439","44","712","1142","0","62.35","20.05"
"10","008","00","007","0705","0000","547","235","312","31","578","1045","0","55.31","22.49"
"10","008","00","007","0705","0342","284","122","162","15","299","578","0","51.73","21.11"
"10","008","00","007","0705","0343","263","113","150","16","279","467","0","59.74","24.2"
"10","008","00","007","0706","0000","787","317","470","42","829","1507","0","55.01","21.04"
"10","008","00","007","0706","0345","376","171","205","19","395","740","0","53.38","23.11"
"10","008","00","007","0706","0346","411","146","265","23","434","767","0","56.58","19.04"
"10","008","00","007","0707","0000","502","210","292","32","534","909","0","58.75","23.1"
"10","008","00","007","0707","0347","502","210","292","32","534","909","0","58.75","23.1"
"10","008","00","007","0708","0000","324","132","192","23","347","622","0","55.79","21.22"
"10","008","00","007","0708","0344","324","132","192","23","347","622","0","55.79","21.22"
"10","008","00","007","0709","0000","699","309","390","46","745","1392","0","53.52","22.2"
"10","008","00","007","0709","0340","442","203","239","24","466","811","0","57.46","25.03"
"10","008","00","007","0709","0341","257","106","151","22","279","581","0","48.02","18.24"
"10","008","00","007","0710","0000","864","346","518","43","907","1650","0","54.97","20.97"
"10","008","00","007","0710","0338","373","143","230","11","384","766","0","50.13","18.67"
"10","008","00","007","0710","0339","491","203","288","32","523","884","0","59.16","22.96"
"10","008","00","007","0711","0000","383","188","195","32","415","794","0","52.27","23.68"
"10","008","00","007","0711","0350","383","188","195","32","415","794","0","52.27","23.68"
"10","008","00","007","0712","0000","369","188","181","20","389","726","0","53.58","25.9"
"10","008","00","007","0712","0351","369","188","181","20","389","726","0","53.58","25.9"
"10","008","00","007","0713","0000","318","164","154","22","340","737","0","46.13","22.25"
"10","008","00","007","0713","0352","318","164","154","22","340","737","0","46.13","22.25"
"10","008","00","008","0000","0000","7209","3227","3982","469","7678","13181","14734","58.25","24.48"
"10","008","00","008","0801","0000","487","246","241","21","508","822","0","61.8","29.93"
"10","008","00","008","0801","0353","487","246","241","21","508","822","0","61.8","29.93"
"10","008","00","008","0802","0000","240","106","134","11","251","474","0","52.95","22.36"
"10","008","00","008","0802","0354","149","69","80","6","155","253","0","61.26","27.27"
"10","008","00","008","0802","0355","91","37","54","5","96","221","0","43.44","16.74"
"10","008","00","008","0803","0000","383","181","202","24","407","780","0","52.18","23.21"
"10","008","00","008","0803","0356","165","74","91","5","170","353","0","48.16","20.96"
"10","008","00","008","0803","0357","218","107","111","19","237","427","0","55.5","25.06"
"10","008","00","008","0804","0000","378","170","208","25","403","661","0","60.97","25.72"
"10","008","00","008","0804","0360","378","170","208","25","403","661","0","60.97","25.72"
"10","008","00","008","0805","0000","369","152","217","28","397","713","0","55.68","21.32"
"10","008","00","008","0805","0358","221","98","123","10","231","406","0","56.9","24.14"
"10","008","00","008","0805","0359","148","54","94","18","166","307","0","54.07","17.59"
"10","008","00","008","0806","0000","972","432","540","57","1029","1727","0","59.58","25.01"
"10","008","00","008","0806","0362","544","246","298","29","573","973","0","58.89","25.28"
"10","008","00","008","0806","0363","428","186","242","28","456","754","0","60.48","24.67"
"10","008","00","008","0807","0000","182","85","97","11","193","290","0","66.55","29.31"
"10","008","00","008","0807","0361","182","85","97","11","193","290","0","66.55","29.31"
"10","008","00","008","0808","0000","351","138","213","17","368","662","0","55.59","20.85"
"10","008","00","008","0808","0364","351","138","213","17","368","662","0","55.59","20.85"
"10","008","00","008","0809","0000","232","114","118","11","243","490","0","49.59","23.27"
"10","008","00","008","0809","0365","232","114","118","11","243","490","0","49.59","23.27"
"10","008","00","008","0810","0000","707","267","440","46","753","1325","0","56.83","20.15"
"10","008","00","008","0810","0366","159","83","76","18","177","335","0","52.84","24.78"
"10","008","00","008","0810","0367","548","184","364","28","576","990","0","58.18","18.59"
"10","008","00","008","0811","0000","650","288","362","37","687","1075","0","63.91","26.79"
"10","008","00","008","0811","0368","285","117","168","17","302","461","0","65.51","25.38"
"10","008","00","008","0811","0369","365","171","194","20","385","614","0","62.7","27.85"
"10","008","00","008","0812","0000","484","223","261","27","511","895","0","57.09","24.92"
"10","008","00","008","0812","0370","484","223","261","27","511","895","0","57.09","24.92"
"10","008","00","008","0813","0000","364","177","187","40","404","682","0","59.24","25.95"
"10","008","00","008","0813","0372","364","177","187","40","404","682","0","59.24","25.95"
"10","008","00","008","0814","0000","367","156","211","32","399","643","0","62.05","24.26"
"10","008","00","008","0814","0374","367","156","211","32","399","643","0","62.05","24.26"
"10","008","00","008","0815","0000","250","99","151","17","267","528","0","50.57","18.75"
"10","008","00","008","0815","0376","250","99","151","17","267","528","0","50.57","18.75"
"10","008","00","008","0816","0000","240","114","126","28","268","465","0","57.63","24.52"
"10","008","00","008","0816","0371","240","114","126","28","268","465","0","57.63","24.52"
"10","008","00","008","0817","0000","273","129","144","14","287","459","0","62.53","28.1"
"10","008","00","008","0817","0375","273","129","144","14","287","459","0","62.53","28.1"
"10","008","00","008","0818","0000","280","150","130","23","303","490","0","61.84","30.61"
"10","008","00","008","0818","0373","280","150","130","23","303","490","0","61.84","30.61"
"10","008","00","009","0000","0000","7229","3070","4159","455","7684","13958","15823","55.05","21.99"
"10","008","00","009","0901","0000","844","335","509","51","895","1580","0","56.65","21.2"
"10","008","00","009","0901","0379","367","147","220","21","388","720","0","53.89","20.42"
"10","008","00","009","0901","0380","477","188","289","30","507","860","0","58.95","21.86"
"10","008","00","009","0902","0000","1103","501","602","83","1186","2020","0","58.71","24.8"
"10","008","00","009","0902","0377","508","239","269","29","537","922","0","58.24","25.92"
"10","008","00","009","0902","0378","595","262","333","54","649","1098","0","59.11","23.86"
"10","008","00","009","0903","0000","465","217","248","35","500","1017","0","49.16","21.34"
"10","008","00","009","0903","0394","254","131","123","22","276","578","0","47.75","22.66"
"10","008","00","009","0903","0395","211","86","125","13","224","439","0","51.03","19.59"
"10","008","00","009","0904","0000","735","326","409","44","779","1386","0","56.2","23.52"
"10","008","00","009","0904","0387","432","170","262","22","454","841","0","53.98","20.21"
"10","008","00","009","0904","0388","156","90","66","14","170","270","0","62.96","33.33"
"10","008","00","009","0904","0389","147","66","81","8","155","275","0","56.36","24.0"
"10","008","00","009","0905","0000","535","244","291","26","561","1088","0","51.56","22.43"
"10","008","00","009","0905","0381","253","120","133","15","268","514","0","52.14","23.35"
"10","008","00","009","0905","0382","282","124","158","11","293","574","0","51.05","21.6"
"10","008","00","009","0906","0000","639","277","362","42","681","1249","0","54.52","22.18"
"10","008","00","009","0906","0383","639","277","362","42","681","1249","0","54.52","22.18"
"10","008","00","009","0907","0000","553","249","304","27","580","992","0","58.47","25.1"
"10","008","00","009","0907","0384","186","82","104","10","196","293","0","66.89","27.99"
"10","008","00","009","0907","0385","268","113","155","13","281","513","0","54.78","22.03"
"10","008","00","009","0907","0386","99","54","45","4","103","186","0","55.38","29.03"
"10","008","00","009","0908","0000","318","142","176","18","336","674","0","49.85","21.07"
"10","008","00","009","0908","0390","127","48","79","10","137","282","0","48.58","17.02"
"10","008","00","009","0908","0391","191","94","97","8","199","392","0","50.77","23.98"
"10","008","00","009","0909","0000","376","133","243","34","410","732","0","56.01","18.17"
"10","008","00","009","0909","0392","285","101","184","26","311","556","0","55.94","18.17"
"10","008","00","009","0909","0393","91","32","59","8","99","176","0","56.25","18.18"
"10","008","00","009","0910","0000","472","153","319","22","494","844","0","58.53","18.13"
"10","008","00","009","0910","0396","472","153","319","22","494","844","0","58.53","18.13"
"10","008","00","009","0911","0000","475","195","280","23","498","942","0","52.87","20.7"
"10","008","00","009","0911","0398","184","65","119","7","191","405","0","47.16","16.05"
"10","008","00","009","0911","0399","291","130","161","16","307","537","0","57.17","24.21"
"10","008","00","009","0912","0000","269","112","157","21","290","566","0","51.24","19.79"
"10","008","00","009","0912","0400","175","79","96","11","186","335","0","55.52","23.58"
"10","008","00","009","0912","0401","94","33","61","10","104","231","0","45.02","14.29"
"10","008","00","009","0913","0000","445","186","259","29","474","868","0","54.61","21.43"
"10","008","00","009","0913","0397","445","186","259","29","474","868","0","54.61","21.43"
"10","008","00","010","0000","0000","9048","3596","5452","528","9576","16597","18699","57.7","21.67"
"10","008","00","010","1001","0000","976","420","556","47","1023","1700","0","60.18","24.71"
"10","008","00","010","1001","0402","572","257","315","31","603","964","0","62.55","26.66"
"10","008","00","010","1001","0403","404","163","241","16","420","736","0","57.07","22.15"
"10","008","00","010","1002","0000","990","391","599","48","1038","1765","0","58.81","22.15"
"10","008","00","010","1002","0404","442","176","266","35","477","801","0","59.55","21.97"
"10","008","00","010","1002","0405","548","215","333","13","561","964","0","58.2","22.3"
"10","008","00","010","1003","0000","374","147","227","16","390","686","0","56.85","21.43"
"10","008","00","010","1003","0406","374","147","227","16","390","686","0","56.85","21.43"
"10","008","00","010","1004","0000","959","377","582","41","1000","1880","0","53.19","20.05"
"10","008","00","010","1004","0411","560","206","354","22","582","1012","0","57.51","20.36"
"10","008","00","010","1004","0412","399","171","228","19","418","868","0","48.16","19.7"
"10","008","00","010","1005","0000","677","264","413","69","746","1391","0","53.63","18.98"
"10","008","00","010","1005","0407","333","137","196","29","362","661","0","54.77","20.73"
"10","008","00","010","1005","0408","344","127","217","40","384","730","0","52.6","17.4"
"10","008","00","010","1006","0000","413","169","244","14","427","706","0","60.48","23.94"
"10","008","00","010","1006","0410","413","169","244","14","427","706","0","60.48","23.94"
"10","008","00","010","1007","0000","1048","355","693","53","1101","1855","0","59.35","19.14"
"10","008","00","010","1007","0413","544","162","382","19","563","918","0","61.33","17.65"
"10","008","00","010","1007","0414","504","193","311","34","538","937","0","57.42","20.6"
"10","008","00","010","1008","0000","525","286","239","36","561","815","0","68.83","35.09"
"10","008","00","010","1008","0415","525","286","239","36","561","815","0","68.83","35.09"
"10","008","00","010","1009","0000","652","247","405","32","684","1134","0","60.32","21.78"
"10","008","00","010","1009","0416","652","247","405","32","684","1134","0","60.32","21.78"
"10","008","00","010","1010","0000","839","335","504","55","894","1543","0","57.94","21.71"
"10","008","00","010","1010","0418","614","239","375","37","651","1095","0","59.45","21.83"
"10","008","00","010","1010","0419","225","96","129","18","243","448","0","54.24","21.43"
"10","008","00","010","1011","0000","813","282","531","63","876","1634","0","53.61","17.26"
"10","008","00","010","1011","0420","531","179","352","44","575","1064","0","54.04","16.82"
"10","008","00","010","1011","0421","282","103","179","19","301","570","0","52.81","18.07"
"10","008","00","010","1012","0000","381","155","226","18","399","714","0","55.88","21.71"
"10","008","00","010","1012","0417","381","155","226","18","399","714","0","55.88","21.71"
"10","008","00","010","1013","0000","401","168","233","36","437","774","0","56.46","21.71"
"10","008","00","010","1013","0409","401","168","233","36","437","774","0","56.46","21.71"
"10","008","00","011","0000","0000","8238","3390","4848","458","8696","15458","17582","56.26","21.93"
"10","008","00","011","1101","0000","404","152","252","19","423","757","0","55.88","20.08"
"10","008","00","011","1101","0422","404","152","252","19","423","757","0","55.88","20.08"
"10","008","00","011","1102","0000","295","116","179","6","301","480","0","62.71","24.17"
"10","008","00","011","1102","0427","295","116","179","6","301","480","0","62.71","24.17"
"10","008","00","011","1103","0000","838","391","447","53","891","1553","0","57.37","25.18"
"10","008","00","011","1103","0423","288","135","153","26","314","554","0","56.68","24.37"
"10","008","00","011","1103","0424","550","256","294","27","577","999","0","57.76","25.63"
"10","008","00","011","1104","0000","319","122","197","13","332","616","0","53.9","19.81"
"10","008","00","011","1104","0425","319","122","197","13","332","616","0","53.9","19.81"
"10","008","00","011","1105","0000","512","188","324","17","529","875","0","60.46","21.49"
"10","008","00","011","1105","0426","512","188","324","17","529","875","0","60.46","21.49"
"10","008","00","011","1106","0000","571","229","342","20","591","1004","0","58.86","22.81"
"10","008","00","011","1106","0430","571","229","342","20","591","1004","0","58.86","22.81"
"10","008","00","011","1107","0000","610","240","370","35","645","998","0","64.63","24.05"
"10","008","00","011","1107","0433","610","240","370","35","645","998","0","64.63","24.05"
"10","008","00","011","1108","0000","764","324","440","48","812","1389","0","58.46","23.33"
"10","008","00","011","1108","0434","414","187","227","29","443","800","0","55.38","23.38"
"10","008","00","011","1108","0435","350","137","213","19","369","589","0","62.65","23.26"
"10","008","00","011","1109","0000","609","222","387","29","638","1217","0","52.42","18.24"
"10","008","00","011","1109","0437","609","222","387","29","638","1217","0","52.42","18.24"
"10","008","00","011","1110","0000","232","107","125","18","250","450","0","55.56","23.78"
"10","008","00","011","1110","0428","232","107","125","18","250","450","0","55.56","23.78"
"10","008","00","011","1111","0000","316","140","176","40","356","643","0","55.37","21.77"
"10","008","00","011","1111","0429","316","140","176","40","356","643","0","55.37","21.77"
"10","008","00","011","1112","0000","75","32","43","4","79","205","0","38.54","15.61"
"10","008","00","011","1112","0438","75","32","43","4","79","205","0","38.54","15.61"
"10","008","00","011","1113","0000","191","71","120","18","209","330","0","63.33","21.52"
"10","008","00","011","1113","0439","191","71","120","18","209","330","0","63.33","21.52"
"10","008","00","011","1114","0000","563","196","367","24","587","1100","0","53.36","17.82"
"10","008","00","011","1114","0440","563","196","367","24","587","1100","0","53.36","17.82"
"10","008","00","011","1115","0000","439","175","264","29","468","887","0","52.76","19.73"
"10","008","00","011","1115","0436","439","175","264","29","468","887","0","52.76","19.73"
"10","008","00","011","1116","0000","139","68","71","6","145","318","0","45.6","21.38"
"10","008","00","011","1116","0442","139","68","71","6","145","318","0","45.6","21.38"
"10","008","00","011","1117","0000","409","211","198","49","458","818","0","55.99","25.79"
"10","008","00","011","1117","0443","409","211","198","49","458","818","0","55.99","25.79"
"10","008","00","011","1118","0000","93","41","52","7","100","275","0","36.36","14.91"
"10","008","00","011","1118","0441","93","41","52","7","100","275","0","36.36","14.91"
"10","008","00","011","1119","0000","859","365","494","23","882","1543","0","57.16","23.66"
"10","008","00","011","1119","0431","394","167","227","15","409","741","0","55.2","22.54"
"10","008","00","011","1119","0432","465","198","267","8","473","802","0","58.98","24.69"
"10","008","00","012","0000","0000","7093","2855","4238","704","7797","13299","16281","58.63","21.47"
"10","008","00","012","1201","0000","638","235","403","128","766","1203","0","63.67","19.53"
"10","008","00","012","1201","0459","516","181","335","122","638","929","0","68.68","19.48"
"10","008","00","012","1201","0460","122","54","68","6","128","274","0","46.72","19.71"
"10","008","00","012","1202","0000","591","152","439","43","634","900","0","70.44","16.89"
"10","008","00","012","1202","0461","591","152","439","43","634","900","0","70.44","16.89"
"10","008","00","012","1203","0000","335","116","219","30","365","560","0","65.18","20.71"
"10","008","00","012","1203","0463","335","116","219","30","365","560","0","65.18","20.71"
"10","008","00","012","1204","0000","783","446","337","77","860","1530","0","56.21","29.15"
"10","008","00","012","1204","0444","613","385","228","70","683","1201","0","56.87","32.06"
"10","008","00","012","1204","0445","170","61","109","7","177","329","0","53.8","18.54"
"10","008","00","012","1205","0000","266","120","146","15","281","516","0","54.46","23.26"
"10","008","00","012","1205","0446","266","120","146","15","281","516","0","54.46","23.26"
"10","008","00","012","1206","0000","357","166","191","18","375","745","0","50.34","22.28"
"10","008","00","012","1206","0447","190","91","99","16","206","424","0","48.58","21.46"
"10","008","00","012","1206","0448","167","75","92","2","169","321","0","52.65","23.36"
"10","008","00","012","1207","0000","407","159","248","17","424","1376","0","30.81","11.56"
"10","008","00","012","1207","0451","407","159","248","17","424","1376","0","30.81","11.56"
"10","008","00","012","1208","0000","821","360","461","65","886","1509","0","58.71","23.86"
"10","008","00","012","1208","0452","471","198","273","23","494","979","0","50.46","20.22"
"10","008","00","012","1208","0453","350","162","188","42","392","530","0","73.96","30.57"
"10","008","00","012","1209","0000","719","298","421","43","762","1425","0","53.47","20.91"
"10","008","00","012","1209","0454","473","199","274","33","506","961","0","52.65","20.71"
"10","008","00","012","1209","0455","246","99","147","10","256","464","0","55.17","21.34"
"10","008","00","012","1210","0000","366","157","209","32","398","666","0","59.76","23.57"
"10","008","00","012","1210","0456","281","123","158","27","308","517","0","59.57","23.79"
"10","008","00","012","1210","0457","85","34","51","5","90","149","0","60.4","22.82"
"10","008","00","012","1211","0000","646","242","404","118","764","1020","0","74.9","23.73"
"10","008","00","012","1211","0458","646","242","404","118","764","1020","0","74.9","23.73"
"10","008","00","012","1212","0000","422","123","299","29","451","617","0","73.1","19.94"
"10","008","00","012","1212","0462","422","123","299","29","451","617","0","73.1","19.94"
"10","008","00","012","1213","0000","359","125","234","73","432","584","0","73.97","21.4"
"10","008","00","012","1213","0450","359","125","234","73","432","584","0","73.97","21.4"
"10","008","00","012","1214","0000","383","156","227","16","399","648","0","61.57","24.07"
"10","008","00","012","1214","0449","383","156","227","16","399","648","0","61.57","24.07"
"10","008","00","013","0000","0000","6784","2398","4386","370","7154","12589","15954","56.83","19.05"
"10","008","00","013","1301","0000","341","123","218","17","358","763","0","46.92","16.12"
"10","008","00","013","1301","0484","341","123","218","17","358","763","0","46.92","16.12"
"10","008","00","013","1302","0000","543","110","433","35","578","889","0","65.02","12.37"
"10","008","00","013","1302","0485","543","110","433","35","578","889","0","65.02","12.37"
"10","008","00","013","1303","0000","662","191","471","52","714","1119","0","63.81","17.07"
"10","008","00","013","1303","0486","403","116","287","37","440","672","0","65.48","17.26"
"10","008","00","013","1303","0487","259","75","184","15","274","447","0","61.3","16.78"
"10","008","00","013","1304","0000","299","65","234","6","305","409","0","74.57","15.89"
"10","008","00","013","1304","0488","299","65","234","6","305","409","0","74.57","15.89"
"10","008","00","013","1305","0000","361","85","276","19","380","509","0","74.66","16.7"
"10","008","00","013","1305","0477","361","85","276","19","380","509","0","74.66","16.7"
"10","008","00","013","1306","0000","451","142","309","24","475","769","0","61.77","18.47"
"10","008","00","013","1306","0474","229","80","149","20","249","384","0","64.84","20.83"
"10","008","00","013","1306","0475","60","16","44","2","62","121","0","51.24","13.22"
"10","008","00","013","1306","0476","162","46","116","2","164","264","0","62.12","17.42"
"10","008","00","013","1307","0000","218","80","138","6","224","597","0","37.52","13.4"
"10","008","00","013","1307","0473","218","80","138","6","224","597","0","37.52","13.4"
"10","008","00","013","1308","0000","527","161","366","34","561","1151","0","48.74","13.99"
"10","008","00","013","1308","0480","271","75","196","22","293","613","0","47.8","12.23"
"10","008","00","013","1308","0481","181","67","114","9","190","404","0","47.03","16.58"
"10","008","00","013","1308","0482","75","19","56","3","78","134","0","58.21","14.18"
"10","008","00","013","1309","0000","914","460","454","29","943","1665","0","56.64","27.63"
"10","008","00","013","1309","0466","453","310","143","9","462","900","0","51.33","34.44"
"10","008","00","013","1309","0467","285","80","205","13","298","460","0","64.78","17.39"
"10","008","00","013","1309","0468","176","70","106","7","183","305","0","60.0","22.95"
"10","008","00","013","1310","0000","666","429","237","32","698","1269","0","55.0","33.81"
"10","008","00","013","1310","0464","525","368","157","23","548","973","0","56.32","37.82"
"10","008","00","013","1310","0465","141","61","80","9","150","296","0","50.68","20.61"
"10","008","00","013","1311","0000","520","121","399","3","523","952","0","54.94","12.71"
"10","008","00","013","1311","0470","520","121","399","3","523","952","0","54.94","12.71"
"10","008","00","013","1312","0000","299","112","187","4","303","679","0","44.62","16.49"
"10","008","00","013","1312","0471","299","112","187","4","303","679","0","44.62","16.49"
"10","008","00","013","1313","0000","360","119","241","44","404","630","0","64.13","18.89"
"10","008","00","013","1313","0483","360","119","241","44","404","630","0","64.13","18.89"
"10","008","00","013","1314","0000","19","2","17","1","20","58","0","34.48","3.45"
"10","008","00","013","1314","0469","19","2","17","1","20","58","0","34.48","3.45"
"10","008","00","013","1315","0000","278","97","181","21","299","507","0","58.97","19.13"
"10","008","00","013","1315","0478","188","48","140","19","207","338","0","61.24","14.2"
"10","008","00","013","1315","0479","90","49","41","2","92","169","0","54.44","28.99"
"10","008","00","013","1316","0000","326","101","225","43","369","623","0","59.23","16.21"
"10","008","00","013","1316","0472","326","101","225","43","369","623","0","59.23","16.21"
"10","009","00","000","0000","0000","289754","139350","150404","17607","307361","584480","687195","52.59","23.84"
"10","009","00","001","0000","0000","49890","21383","28507","2164","52054","89761","108487","57.99","23.82"
"10","009","00","001","0101","0000","819","351","468","48","867","1415","0","61.27","24.81"
"10","009","00","001","0101","0431","819","351","468","48","867","1415","0","61.27","24.81"
"10","009","00","001","0102","0000","640","315","325","32","672","1101","0","61.04","28.61"
"10","009","00","001","0102","0432","640","315","325","32","672","1101","0","61.04","28.61"
"10","009","00","001","0103","0000","364","185","179","10","374","644","0","58.07","28.73"
"10","009","00","001","0103","0411","364","185","179","10","374","644","0","58.07","28.73"
"10","009","00","001","0104","0000","332","161","171","23","355","617","0","57.54","26.09"
"10","009","00","001","0104","0412","332","161","171","23","355","617","0","57.54","26.09"
"10","009","00","001","0105","0000","478","221","257","26","504","764","0","65.97","28.93"
"10","009","00","001","0105","0413","478","221","257","26","504","764","0","65.97","28.93"
"10","009","00","001","0106","0000","474","231","243","20","494","784","0","63.01","29.46"
"10","009","00","001","0106","0414","474","231","243","20","494","784","0","63.01","29.46"
"10","009","00","001","0107","0000","428","216","212","19","447","760","0","58.82","28.42"
"10","009","00","001","0107","0415","428","216","212","19","447","760","0","58.82","28.42"
"10","009","00","001","0108","0000","2625","1029","1596","86","2711","4634","0","58.5","22.21"
"10","009","00","001","0108","0422","856","330","526","19","875","1529","0","57.23","21.58"
"10","009","00","001","0108","0423","766","306","460","36","802","1335","0","60.07","22.92"
"10","009","00","001","0108","0424","1003","393","610","31","1034","1770","0","58.42","22.2"
"10","009","00","001","0109","0000","1739","742","997","57","1796","3236","0","55.5","22.93"
"10","009","00","001","0109","0433","915","394","521","31","946","1648","0","57.4","23.91"
"10","009","00","001","0109","0434","824","348","476","26","850","1588","0","53.53","21.91"
"10","009","00","001","0110","0000","1638","634","1004","55","1693","2765","0","61.23","22.93"
"10","009","00","001","0110","0427","701","293","408","20","721","1193","0","60.44","24.56"
"10","009","00","001","0110","0428","937","341","596","35","972","1572","0","61.83","21.69"
"10","009","00","001","0111","0000","1028","460","568","35","1063","1747","0","60.85","26.33"
"10","009","00","001","0111","0449","1028","460","568","35","1063","1747","0","60.85","26.33"
"10","009","00","001","0112","0000","1963","801","1162","68","2031","3513","0","57.81","22.8"
"10","009","00","001","0112","0444","618","267","351","20","638","1097","0","58.16","24.34"
"10","009","00","001","0112","0445","719","276","443","27","746","1262","0","59.11","21.87"
"10","009","00","001","0112","0446","626","258","368","21","647","1154","0","56.07","22.36"
"10","009","00","001","0113","0000","2324","885","1439","99","2423","4188","0","57.86","21.13"
"10","009","00","001","0113","0439","844","318","526","39","883","1421","0","62.14","22.38"
"10","009","00","001","0113","0440","691","270","421","34","725","1261","0","57.49","21.41"
"10","009","00","001","0113","0441","789","297","492","26","815","1506","0","54.12","19.72"
"10","009","00","001","0114","0000","1150","498","652","51","1201","2329","0","51.57","21.38"
"10","009","00","001","0114","0437","576","227","349","25","601","1187","0","50.63","19.12"
"10","009","00","001","0114","0438","574","271","303","26","600","1142","0","52.54","23.73"
"10","009","00","001","0115","0000","412","170","242","19","431","669","0","64.42","25.41"
"10","009","00","001","0115","0453","412","170","242","19","431","669","0","64.42","25.41"
"10","009","00","001","0116","0000","1198","479","719","45","1243","2202","0","56.45","21.75"
"10","009","00","001","0116","0454","419","183","236","23","442","752","0","58.78","24.34"
"10","009","00","001","0116","0455","779","296","483","22","801","1450","0","55.24","20.41"
"10","009","00","001","0117","0000","309","165","144","16","325","555","0","58.56","29.73"
"10","009","00","001","0117","0456","309","165","144","16","325","555","0","58.56","29.73"
"10","009","00","001","0118","0000","1327","531","796","57","1384","2414","0","57.33","22.0"
"10","009","00","001","0118","0451","601","233","368","28","629","1112","0","56.56","20.95"
"10","009","00","001","0118","0452","726","298","428","29","755","1302","0","57.99","22.89"
"10","009","00","001","0119","0000","790","347","443","32","822","1418","0","57.97","24.47"
"10","009","00","001","0119","0450","790","347","443","32","822","1418","0","57.97","24.47"
"10","009","00","001","0120","0000","1279","526","753","59","1338","2397","0","55.82","21.94"
"10","009","00","001","0120","0457","735","296","439","41","776","1470","0","52.79","20.14"
"10","009","00","001","0120","0458","544","230","314","18","562","927","0","60.63","24.81"
"10","009","00","001","0121","0000","841","368","473","72","913","1748","0","52.23","21.05"
"10","009","00","001","0121","0466","841","368","473","72","913","1748","0","52.23","21.05"
"10","009","00","001","0122","0000","3027","1288","1739","110","3137","5306","0","59.12","24.27"
"10","009","00","001","0122","0462","811","301","510","29","840","1412","0","59.49","21.32"
"10","009","00","001","0122","0463","808","358","450","35","843","1354","0","62.26","26.44"
"10","009","00","001","0122","0464","709","330","379","33","742","1267","0","58.56","26.05"
"10","009","00","001","0122","0465","699","299","400","13","712","1273","0","55.93","23.49"
"10","009","00","001","0123","0000","2866","1221","1645","129","2995","5374","0","55.73","22.72"
"10","009","00","001","0123","0459","1072","432","640","40","1112","1893","0","58.74","22.82"
"10","009","00","001","0123","0460","942","439","503","52","994","1708","0","58.2","25.7"
"10","009","00","001","0123","0461","852","350","502","37","889","1773","0","50.14","19.74"
"10","009","00","001","0124","0000","1025","509","516","70","1095","1813","0","60.4","28.08"
"10","009","00","001","0124","0472","410","212","198","29","439","702","0","62.54","30.2"
"10","009","00","001","0124","0473","615","297","318","41","656","1111","0","59.05","26.73"
"10","009","00","001","0125","0000","546","278","268","27","573","1123","0","51.02","24.76"
"10","009","00","001","0125","0474","546","278","268","27","573","1123","0","51.02","24.76"
"10","009","00","001","0126","0000","2425","1071","1354","122","2547","4406","0","57.81","24.31"
"10","009","00","001","0126","0467","686","319","367","49","735","1238","0","59.37","25.77"
"10","009","00","001","0126","0468","856","381","475","34","890","1648","0","54.0","23.12"
"10","009","00","001","0126","0469","883","371","512","39","922","1520","0","60.66","24.41"
"10","009","00","001","0127","0000","584","309","275","21","605","1087","0","55.66","28.43"
"10","009","00","001","0127","0470","584","309","275","21","605","1087","0","55.66","28.43"
"10","009","00","001","0128","0000","1017","454","563","68","1085","1904","0","56.99","23.84"
"10","009","00","001","0128","0471","1017","454","563","68","1085","1904","0","56.99","23.84"
"10","009","00","001","0129","0000","1657","790","867","96","1753","3095","0","56.64","25.53"
"10","009","00","001","0129","0477","559","288","271","39","598","1023","0","58.46","28.15"
"10","009","00","001","0129","0478","1098","502","596","57","1155","2072","0","55.74","24.23"
"10","009","00","001","0130","0000","1529","717","812","76","1605","2932","0","54.74","24.45"
"10","009","00","001","0130","0475","598","263","335","33","631","1146","0","55.06","22.95"
"10","009","00","001","0130","0476","931","454","477","43","974","1786","0","54.54","25.42"
"10","009","00","001","0131","0000","593","354","239","30","623","1128","0","55.23","31.38"
"10","009","00","001","0131","0479","593","354","239","30","623","1128","0","55.23","31.38"
"10","009","00","001","0132","0000","1458","580","878","37","1495","2345","0","63.75","24.73"
"10","009","00","001","0132","0418","766","309","457","23","789","1255","0","62.87","24.62"
"10","009","00","001","0132","0419","692","271","421","14","706","1090","0","64.77","24.86"
"10","009","00","001","0133","0000","2056","816","1240","87","2143","3710","0","57.76","21.99"
"10","009","00","001","0133","0416","1089","417","672","48","1137","1881","0","60.45","22.17"
"10","009","00","001","0133","0417","967","399","568","39","1006","1829","0","55.0","21.82"
"10","009","00","001","0134","0000","1619","645","974","54","1673","2814","0","59.45","22.92"
"10","009","00","001","0134","0435","812","323","489","20","832","1392","0","59.77","23.2"
"10","009","00","001","0134","0436","807","322","485","34","841","1422","0","59.14","22.64"
"10","009","00","001","0135","0000","1291","510","781","61","1352","2286","0","59.14","22.31"
"10","009","00","001","0135","0447","485","195","290","28","513","847","0","60.57","23.02"
"10","009","00","001","0135","0448","806","315","491","33","839","1439","0","58.3","21.89"
"10","009","00","001","0136","0000","1260","531","729","59","1319","2204","0","59.85","24.09"
"10","009","00","001","0136","0429","556","251","305","21","577","1009","0","57.19","24.88"
"10","009","00","001","0136","0430","704","280","424","38","742","1195","0","62.09","23.43"
"10","009","00","001","0137","0000","1884","816","1068","72","1956","3479","0","56.22","23.46"
"10","009","00","001","0137","0425","742","324","418","21","763","1308","0","58.33","24.77"
"10","009","00","001","0137","0426","1142","492","650","51","1193","2171","0","54.95","22.66"
"10","009","00","001","0138","0000","1557","664","893","68","1625","2576","0","63.08","25.78"
"10","009","00","001","0138","0442","730","322","408","25","755","1214","0","62.19","26.52"
"10","009","00","001","0138","0443","827","342","485","43","870","1362","0","63.88","25.11"
"10","009","00","001","0139","0000","1338","515","823","48","1386","2279","0","60.82","22.6"
"10","009","00","001","0139","0420","651","277","374","24","675","1103","0","61.2","25.11"
"10","009","00","001","0139","0421","687","238","449","24","711","1176","0","60.46","20.24"
"10","009","00","002","0000","0000","20773","9624","11149","1198","21971","38138","44608","57.61","25.23"
"10","009","00","002","0201","0000","678","316","362","29","707","1166","0","60.63","27.1"
"10","009","00","002","0201","0498","678","316","362","29","707","1166","0","60.63","27.1"
"10","009","00","002","0202","0000","1284","543","741","37","1321","2110","0","62.61","25.73"
"10","009","00","002","0202","0499","694","300","394","22","716","1135","0","63.08","26.43"
"10","009","00","002","0202","0500","590","243","347","15","605","975","0","62.05","24.92"
"10","009","00","002","0203","0000","1184","541","643","66","1250","2228","0","56.1","24.28"
"10","009","00","002","0203","0503","710","303","407","37","747","1321","0","56.55","22.94"
"10","009","00","002","0203","0504","474","238","236","29","503","907","0","55.46","26.24"
"10","009","00","002","0204","0000","869","343","526","54","923","1473","0","62.66","23.29"
"10","009","00","002","0204","0505","869","343","526","54","923","1473","0","62.66","23.29"
"10","009","00","002","0205","0000","768","369","399","34","802","1277","0","62.8","28.9"
"10","009","00","002","0205","0506","768","369","399","34","802","1277","0","62.8","28.9"
"10","009","00","002","0206","0000","1474","741","733","81","1555","2673","0","58.17","27.72"
"10","009","00","002","0206","0514","613","300","313","33","646","1042","0","62.0","28.79"
"10","009","00","002","0206","0515","861","441","420","48","909","1631","0","55.73","27.04"
"10","009","00","002","0207","0000","713","362","351","54","767","1333","0","57.54","27.16"
"10","009","00","002","0207","0507","713","362","351","54","767","1333","0","57.54","27.16"
"10","009","00","002","0208","0000","407","209","198","25","432","777","0","55.6","26.9"
"10","009","00","002","0208","0508","407","209","198","25","432","777","0","55.6","26.9"
"10","009","00","002","0209","0000","466","200","266","29","495","899","0","55.06","22.25"
"10","009","00","002","0209","0510","466","200","266","29","495","899","0","55.06","22.25"
"10","009","00","002","0210","0000","314","172","142","21","335","688","0","48.69","25.0"
"10","009","00","002","0210","0511","314","172","142","21","335","688","0","48.69","25.0"
"10","009","00","002","0211","0000","573","266","307","26","599","1147","0","52.22","23.19"
"10","009","00","002","0211","0512","573","266","307","26","599","1147","0","52.22","23.19"
"10","009","00","002","0212","0000","904","360","544","64","968","1709","0","56.64","21.06"
"10","009","00","002","0212","0513","904","360","544","64","968","1709","0","56.64","21.06"
"10","009","00","002","0213","0000","528","253","275","29","557","981","0","56.78","25.79"
"10","009","00","002","0213","0525","528","253","275","29","557","981","0","56.78","25.79"
"10","009","00","002","0214","0000","1408","677","731","106","1514","2715","0","55.76","24.94"
"10","009","00","002","0214","0526","531","274","257","34","565","1129","0","50.04","24.27"
"10","009","00","002","0214","0527","877","403","474","72","949","1586","0","59.84","25.41"
"10","009","00","002","0215","0000","1206","577","629","63","1269","2227","0","56.98","25.91"
"10","009","00","002","0215","0528","719","362","357","49","768","1243","0","61.79","29.12"
"10","009","00","002","0215","0529","487","215","272","14","501","984","0","50.91","21.85"
"10","009","00","002","0216","0000","1869","834","1035","89","1958","3266","0","59.95","25.54"
"10","009","00","002","0216","0516","979","429","550","55","1034","1702","0","60.75","25.21"
"10","009","00","002","0216","0517","890","405","485","34","924","1564","0","59.08","25.9"
"10","009","00","002","0217","0000","421","210","211","18","439","897","0","48.94","23.41"
"10","009","00","002","0217","0520","421","210","211","18","439","897","0","48.94","23.41"
"10","009","00","002","0218","0000","416","183","233","26","442","803","0","55.04","22.79"
"10","009","00","002","0218","0521","416","183","233","26","442","803","0","55.04","22.79"
"10","009","00","002","0219","0000","468","207","261","37","505","866","0","58.31","23.9"
"10","009","00","002","0219","0522","468","207","261","37","505","866","0","58.31","23.9"
"10","009","00","002","0220","0000","818","388","430","68","886","1523","0","58.17","25.48"
"10","009","00","002","0220","0523","465","232","233","38","503","852","0","59.04","27.23"
"10","009","00","002","0220","0524","353","156","197","30","383","671","0","57.08","23.25"
"10","009","00","002","0221","0000","783","417","366","71","854","1507","0","56.67","27.67"
"10","009","00","002","0221","0530","783","417","366","71","854","1507","0","56.67","27.67"
"10","009","00","002","0222","0000","454","237","217","31","485","877","0","55.3","27.02"
"10","009","00","002","0222","0509","454","237","217","31","485","877","0","55.3","27.02"
"10","009","00","002","0223","0000","1615","692","923","68","1683","2810","0","59.89","24.63"
"10","009","00","002","0223","0501","848","350","498","30","878","1459","0","60.18","23.99"
"10","009","00","002","0223","0502","767","342","425","38","805","1351","0","59.59","25.31"
"10","009","00","002","0224","0000","1153","527","626","72","1225","2186","0","56.04","24.11"
"10","009","00","002","0224","0518","413","198","215","29","442","910","0","48.57","21.76"
"10","009","00","002","0224","0519","740","329","411","43","783","1276","0","61.36","25.78"
"10","009","00","003","0000","0000","30159","13438","16721","1428","31587","58167","70892","54.3","23.1"
"10","009","00","003","0301","0000","532","251","281","40","572","941","0","60.79","26.67"
"10","009","00","003","0301","0117","532","251","281","40","572","941","0","60.79","26.67"
"10","009","00","003","0302","0000","842","375","467","46","888","1675","0","53.01","22.39"
"10","009","00","003","0302","0111","433","197","236","17","450","785","0","57.32","25.1"
"10","009","00","003","0302","0112","409","178","231","29","438","890","0","49.21","20.0"
"10","009","00","003","0303","0000","1436","600","836","60","1496","2605","0","57.43","23.03"
"10","009","00","003","0303","0109","713","287","426","31","744","1347","0","55.23","21.31"
"10","009","00","003","0303","0110","723","313","410","29","752","1258","0","59.78","24.88"
"10","009","00","003","0304","0000","1651","740","911","60","1711","2844","0","60.16","26.02"
"10","009","00","003","0304","0113","812","366","446","27","839","1413","0","59.38","25.9"
"10","009","00","003","0304","0114","839","374","465","33","872","1431","0","60.94","26.14"
"10","009","00","003","0305","0000","1250","484","766","69","1319","2549","0","51.75","18.99"
"10","009","00","003","0305","0115","621","261","360","41","662","1224","0","54.08","21.32"
"10","009","00","003","0305","0116","629","223","406","28","657","1325","0","49.58","16.83"
"10","009","00","003","0306","0000","1705","668","1037","50","1755","3254","0","53.93","20.53"
"10","009","00","003","0306","0118","860","346","514","24","884","1613","0","54.8","21.45"
"10","009","00","003","0306","0119","845","322","523","26","871","1641","0","53.08","19.62"
"10","009","00","003","0307","0000","857","375","482","31","888","1438","0","61.75","26.08"
"10","009","00","003","0307","0123","857","375","482","31","888","1438","0","61.75","26.08"
"10","009","00","003","0308","0000","2508","997","1511","79","2587","4295","0","60.23","23.21"
"10","009","00","003","0308","0124","779","310","469","18","797","1361","0","58.56","22.78"
"10","009","00","003","0308","0125","830","324","506","33","863","1444","0","59.76","22.44"
"10","009","00","003","0308","0126","899","363","536","28","927","1490","0","62.21","24.36"
"10","009","00","003","0309","0000","1275","577","698","53","1328","2274","0","58.4","25.37"
"10","009","00","003","0309","0127","801","330","471","32","833","1307","0","63.73","25.25"
"10","009","00","003","0309","0128","474","247","227","21","495","967","0","51.19","25.54"
"10","009","00","003","0310","0000","2124","942","1182","60","2184","3745","0","58.32","25.15"
"10","009","00","003","0310","0129","994","397","597","32","1026","1865","0","55.01","21.29"
"10","009","00","003","0310","0130","1130","545","585","28","1158","1880","0","61.6","28.99"
"10","009","00","003","0311","0000","1077","503","574","44","1121","2000","0","56.05","25.15"
"10","009","00","003","0311","0131","567","255","312","31","598","1099","0","54.41","23.2"
"10","009","00","003","0311","0132","510","248","262","13","523","901","0","58.05","27.52"
"10","009","00","003","0312","0000","596","261","335","26","622","1120","0","55.54","23.3"
"10","009","00","003","0312","0133","596","261","335","26","622","1120","0","55.54","23.3"
"10","009","00","003","0313","0000","588","249","339","51","639","1272","0","50.24","19.58"
"10","009","00","003","0313","0154","588","249","339","51","639","1272","0","50.24","19.58"
"10","009","00","003","0314","0000","400","182","218","23","423","851","0","49.71","21.39"
"10","009","00","003","0314","0153","400","182","218","23","423","851","0","49.71","21.39"
"10","009","00","003","0315","0000","669","313","356","54","723","1549","0","46.68","20.21"
"10","009","00","003","0315","0152","669","313","356","54","723","1549","0","46.68","20.21"
"10","009","00","003","0316","0000","670","312","358","43","713","1509","0","47.25","20.68"
"10","009","00","003","0316","0150","670","312","358","43","713","1509","0","47.25","20.68"
"10","009","00","003","0317","0000","339","192","147","33","372","855","0","43.51","22.46"
"10","009","00","003","0317","0151","339","192","147","33","372","855","0","43.51","22.46"
"10","009","00","003","0318","0000","1367","711","656","58","1425","2668","0","53.41","26.65"
"10","009","00","003","0318","0135","739","378","361","39","778","1420","0","54.79","26.62"
"10","009","00","003","0318","0136","628","333","295","19","647","1248","0","51.84","26.68"
"10","009","00","003","0319","0000","425","185","240","24","449","799","0","56.2","23.15"
"10","009","00","003","0319","0137","425","185","240","24","449","799","0","56.2","23.15"
"10","009","00","003","0320","0000","818","393","425","72","890","1760","0","50.57","22.33"
"10","009","00","003","0320","0138","411","194","217","38","449","836","0","53.71","23.21"
"10","009","00","003","0320","0139","407","199","208","34","441","924","0","47.73","21.54"
"10","009","00","003","0321","0000","712","301","411","28","740","1648","0","44.9","18.26"
"10","009","00","003","0321","0140","712","301","411","28","740","1648","0","44.9","18.26"
"10","009","00","003","0322","0000","1460","738","722","106","1566","3162","0","49.53","23.34"
"10","009","00","003","0322","0141","718","372","346","66","784","1616","0","48.51","23.02"
"10","009","00","003","0322","0142","742","366","376","40","782","1546","0","50.58","23.67"
"10","009","00","003","0323","0000","1182","541","641","48","1230","2361","0","52.1","22.91"
"10","009","00","003","0323","0143","646","250","396","31","677","1283","0","52.77","19.49"
"10","009","00","003","0323","0144","536","291","245","17","553","1078","0","51.3","26.99"
"10","009","00","003","0324","0000","1254","650","604","55","1309","2597","0","50.4","25.03"
"10","009","00","003","0324","0145","632","344","288","30","662","1313","0","50.42","26.2"
"10","009","00","003","0324","0146","622","306","316","25","647","1284","0","50.39","23.83"
"10","009","00","003","0325","0000","681","324","357","47","728","1356","0","53.69","23.89"
"10","009","00","003","0325","0147","681","324","357","47","728","1356","0","53.69","23.89"
"10","009","00","003","0326","0000","819","336","483","43","862","1504","0","57.31","22.34"
"10","009","00","003","0326","0148","819","336","483","43","862","1504","0","57.31","22.34"
"10","009","00","003","0327","0000","248","89","159","12","260","545","0","47.71","16.33"
"10","009","00","003","0327","0134","248","89","159","12","260","545","0","47.71","16.33"
"10","009","00","003","0328","0000","2126","880","1246","87","2213","3767","0","58.75","23.36"
"10","009","00","003","0328","0120","685","262","423","30","715","1200","0","59.58","21.83"
"10","009","00","003","0328","0121","732","331","401","32","764","1294","0","59.04","25.58"
"10","009","00","003","0328","0122","709","287","422","25","734","1273","0","57.66","22.55"
"10","009","00","003","0329","0000","548","269","279","26","574","1224","0","46.9","21.98"
"10","009","00","003","0329","0149","548","269","279","26","574","1224","0","46.9","21.98"
"10","009","00","004","0000","0000","19646","9923","9723","1117","20763","38142","46135","54.44","26.02"
"10","009","00","004","0401","0000","797","413","384","41","838","1590","0","52.7","25.97"
"10","009","00","004","0401","0340","797","413","384","41","838","1590","0","52.7","25.97"
"10","009","00","004","0402","0000","937","498","439","30","967","1741","0","55.54","28.6"
"10","009","00","004","0402","0341","937","498","439","30","967","1741","0","55.54","28.6"
"10","009","00","004","0403","0000","1302","591","711","63","1365","2120","0","64.39","27.88"
"10","009","00","004","0403","0342","684","302","382","29","713","1080","0","66.02","27.96"
"10","009","00","004","0403","0343","618","289","329","34","652","1040","0","62.69","27.79"
"10","009","00","004","0404","0000","1633","730","903","58","1691","2971","0","56.92","24.57"
"10","009","00","004","0404","0344","772","342","430","24","796","1346","0","59.14","25.41"
"10","009","00","004","0404","0345","861","388","473","34","895","1625","0","55.08","23.88"
"10","009","00","004","0405","0000","230","113","117","8","238","354","0","67.23","31.92"
"10","009","00","004","0405","0346","230","113","117","8","238","354","0","67.23","31.92"
"10","009","00","004","0406","0000","306","157","149","22","328","580","0","56.55","27.07"
"10","009","00","004","0406","0347","306","157","149","22","328","580","0","56.55","27.07"
"10","009","00","004","0407","0000","343","166","177","32","375","591","0","63.45","28.09"
"10","009","00","004","0407","0348","343","166","177","32","375","591","0","63.45","28.09"
"10","009","00","004","0408","0000","583","287","296","39","622","1050","0","59.24","27.33"
"10","009","00","004","0408","0349","583","287","296","39","622","1050","0","59.24","27.33"
"10","009","00","004","0409","0000","1495","666","829","80","1575","2749","0","57.29","24.23"
"10","009","00","004","0409","0350","678","288","390","38","716","1147","0","62.42","25.11"
"10","009","00","004","0409","0351","817","378","439","42","859","1602","0","53.62","23.6"
"10","009","00","004","0410","0000","2264","1081","1183","96","2360","4335","0","54.44","24.94"
"10","009","00","004","0410","0352","737","367","370","44","781","1452","0","53.79","25.28"
"10","009","00","004","0410","0353","857","392","465","38","895","1578","0","56.72","24.84"
"10","009","00","004","0410","0354","670","322","348","14","684","1305","0","52.41","24.67"
"10","009","00","004","0411","0000","635","360","275","43","678","1327","0","51.09","27.13"
"10","009","00","004","0411","0355","635","360","275","43","678","1327","0","51.09","27.13"
"10","009","00","004","0412","0000","768","396","372","45","813","1516","0","53.63","26.12"
"10","009","00","004","0412","0356","768","396","372","45","813","1516","0","53.63","26.12"
"10","009","00","004","0413","0000","498","243","255","45","543","983","0","55.24","24.72"
"10","009","00","004","0413","0369","498","243","255","45","543","983","0","55.24","24.72"
"10","009","00","004","0414","0000","519","253","266","36","555","1014","0","54.73","24.95"
"10","009","00","004","0414","0370","519","253","266","36","555","1014","0","54.73","24.95"
"10","009","00","004","0415","0000","865","479","386","87","952","1805","0","52.74","26.54"
"10","009","00","004","0415","0371","421","240","181","58","479","939","0","51.01","25.56"
"10","009","00","004","0415","0372","444","239","205","29","473","866","0","54.62","27.6"
"10","009","00","004","0416","0000","700","376","324","40","740","1486","0","49.8","25.3"
"10","009","00","004","0416","0373","700","376","324","40","740","1486","0","49.8","25.3"
"10","009","00","004","0417","0000","714","402","312","38","752","1616","0","46.53","24.88"
"10","009","00","004","0417","0357","366","207","159","27","393","828","0","47.46","25.0"
"10","009","00","004","0417","0358","348","195","153","11","359","788","0","45.56","24.75"
"10","009","00","004","0418","0000","428","235","193","34","462","863","0","53.53","27.23"
"10","009","00","004","0418","0359","428","235","193","34","462","863","0","53.53","27.23"
"10","009","00","004","0419","0000","491","292","199","32","523","984","0","53.15","29.67"
"10","009","00","004","0419","0360","491","292","199","32","523","984","0","53.15","29.67"
"10","009","00","004","0420","0000","447","217","230","26","473","870","0","54.37","24.94"
"10","009","00","004","0420","0362","447","217","230","26","473","870","0","54.37","24.94"
"10","009","00","004","0421","0000","744","428","316","75","819","1514","0","54.1","28.27"
"10","009","00","004","0421","0361","744","428","316","75","819","1514","0","54.1","28.27"
"10","009","00","004","0422","0000","544","311","233","23","567","971","0","58.39","32.03"
"10","009","00","004","0422","0363","544","311","233","23","567","971","0","58.39","32.03"
"10","009","00","004","0423","0000","421","180","241","34","455","823","0","55.29","21.87"
"10","009","00","004","0423","0366","421","180","241","34","455","823","0","55.29","21.87"
"10","009","00","004","0424","0000","354","186","168","20","374","726","0","51.52","25.62"
"10","009","00","004","0424","0365","354","186","168","20","374","726","0","51.52","25.62"
"10","009","00","004","0425","0000","605","309","296","21","626","1304","0","48.01","23.7"
"10","009","00","004","0425","0364","605","309","296","21","626","1304","0","48.01","23.7"
"10","009","00","004","0426","0000","374","200","174","12","386","886","0","43.57","22.57"
"10","009","00","004","0426","0367","374","200","174","12","386","886","0","43.57","22.57"
"10","009","00","004","0427","0000","649","354","295","37","686","1373","0","49.96","25.78"
"10","009","00","004","0427","0368","649","354","295","37","686","1373","0","49.96","25.78"
"10","009","00","005","0000","0000","12089","5972","6117","855","12944","24412","28827","53.02","24.46"
"10","009","00","005","0501","0000","489","238","251","29","518","809","0","64.03","29.42"
"10","009","00","005","0501","0080","489","238","251","29","518","809","0","64.03","29.42"
"10","009","00","005","0502","0000","461","204","257","36","497","896","0","55.47","22.77"
"10","009","00","005","0502","0081","461","204","257","36","497","896","0","55.47","22.77"
"10","009","00","005","0503","0000","822","378","444","52","874","1389","0","62.92","27.21"
"10","009","00","005","0503","0082","379","197","182","23","402","687","0","58.52","28.68"
"10","009","00","005","0503","0083","443","181","262","29","472","702","0","67.24","25.78"
"10","009","00","005","0504","0000","620","248","372","24","644","1032","0","62.4","24.03"
"10","009","00","005","0504","0084","620","248","372","24","644","1032","0","62.4","24.03"
"10","009","00","005","0505","0000","547","281","266","62","609","1124","0","54.18","25.0"
"10","009","00","005","0505","0085","339","186","153","41","380","697","0","54.52","26.69"
"10","009","00","005","0505","0086","208","95","113","21","229","427","0","53.63","22.25"
"10","009","00","005","0506","0000","700","345","355","33","733","1430","0","51.26","24.13"
"10","009","00","005","0506","0089","286","143","143","8","294","634","0","46.37","22.56"
"10","009","00","005","0506","0090","414","202","212","25","439","796","0","55.15","25.38"
"10","009","00","005","0507","0000","576","290","286","47","623","1321","0","47.16","21.95"
"10","009","00","005","0507","0091","309","168","141","25","334","745","0","44.83","22.55"
"10","009","00","005","0507","0092","267","122","145","22","289","576","0","50.17","21.18"
"10","009","00","005","0508","0000","560","272","288","43","603","1277","0","47.22","21.3"
"10","009","00","005","0508","0093","325","153","172","36","361","743","0","48.59","20.59"
"10","009","00","005","0508","0094","235","119","116","7","242","534","0","45.32","22.28"
"10","009","00","005","0509","0000","436","219","217","29","465","843","0","55.16","25.98"
"10","009","00","005","0509","0099","436","219","217","29","465","843","0","55.16","25.98"
"10","009","00","005","0510","0000","1503","679","824","54","1557","2734","0","56.95","24.84"
"10","009","00","005","0510","0087","784","336","448","39","823","1451","0","56.72","23.16"
"10","009","00","005","0510","0088","719","343","376","15","734","1283","0","57.21","26.73"
"10","009","00","005","0511","0000","932","510","422","55","987","1864","0","52.95","27.36"
"10","009","00","005","0511","0100","463","271","192","34","497","916","0","54.26","29.59"
"10","009","00","005","0511","0101","469","239","230","21","490","948","0","51.69","25.21"
"10","009","00","005","0512","0000","918","469","449","77","995","1774","0","56.09","26.44"
"10","009","00","005","0512","0102","476","231","245","31","507","914","0","55.47","25.27"
"10","009","00","005","0512","0103","442","238","204","46","488","860","0","56.74","27.67"
"10","009","00","005","0513","0000","389","208","181","25","414","896","0","46.21","23.21"
"10","009","00","005","0513","0106","389","208","181","25","414","896","0","46.21","23.21"
"10","009","00","005","0514","0000","822","444","378","73","895","1804","0","49.61","24.61"
"10","009","00","005","0514","0104","433","236","197","38","471","929","0","50.7","25.4"
"10","009","00","005","0514","0105","389","208","181","35","424","875","0","48.46","23.77"
"10","009","00","005","0515","0000","993","492","501","107","1100","2276","0","48.33","21.62"
"10","009","00","005","0515","0095","490","251","239","58","548","1199","0","45.7","20.93"
"10","009","00","005","0515","0096","503","241","262","49","552","1077","0","51.25","22.38"
"10","009","00","005","0516","0000","695","370","325","51","746","1503","0","49.63","24.62"
"10","009","00","005","0516","0097","351","175","176","22","373","819","0","45.54","21.37"
"10","009","00","005","0516","0098","344","195","149","29","373","684","0","54.53","28.51"
"10","009","00","005","0517","0000","626","325","301","58","684","1440","0","47.5","22.57"
"10","009","00","005","0517","0107","315","165","150","33","348","757","0","45.97","21.8"
"10","009","00","005","0517","0108","311","160","151","25","336","683","0","49.19","23.43"
"10","009","00","006","0000","0000","17590","8945","8645","1134","18724","33958","39975","55.14","26.34"
"10","009","00","006","0601","0000","391","218","173","35","426","724","0","58.84","30.11"
"10","009","00","006","0601","0256","391","218","173","35","426","724","0","58.84","30.11"
"10","009","00","006","0602","0000","395","225","170","36","431","688","0","62.65","32.7"
"10","009","00","006","0602","0257","395","225","170","36","431","688","0","62.65","32.7"
"10","009","00","006","0603","0000","240","127","113","29","269","452","0","59.51","28.1"
"10","009","00","006","0603","0258","240","127","113","29","269","452","0","59.51","28.1"
"10","009","00","006","0604","0000","470","237","233","48","518","866","0","59.82","27.37"
"10","009","00","006","0604","0259","470","237","233","48","518","866","0","59.82","27.37"
"10","009","00","006","0605","0000","166","91","75","13","179","336","0","53.27","27.08"
"10","009","00","006","0605","0260","166","91","75","13","179","336","0","53.27","27.08"
"10","009","00","006","0606","0000","201","98","103","15","216","395","0","54.68","24.81"
"10","009","00","006","0606","0261","201","98","103","15","216","395","0","54.68","24.81"
"10","009","00","006","0607","0000","226","121","105","15","241","376","0","64.1","32.18"
"10","009","00","006","0607","0262","226","121","105","15","241","376","0","64.1","32.18"
"10","009","00","006","0608","0000","528","249","279","25","553","950","0","58.21","26.21"
"10","009","00","006","0608","0263","528","249","279","25","553","950","0","58.21","26.21"
"10","009","00","006","0609","0000","295","149","146","28","323","512","0","63.09","29.1"
"10","009","00","006","0609","0264","295","149","146","28","323","512","0","63.09","29.1"
"10","009","00","006","0610","0000","191","100","91","12","203","324","0","62.65","30.86"
"10","009","00","006","0610","0265","191","100","91","12","203","324","0","62.65","30.86"
"10","009","00","006","0611","0000","296","155","141","14","310","546","0","56.78","28.39"
"10","009","00","006","0611","0266","296","155","141","14","310","546","0","56.78","28.39"
"10","009","00","006","0612","0000","650","316","334","53","703","1184","0","59.38","26.69"
"10","009","00","006","0612","0267","259","137","122","11","270","433","0","62.36","31.64"
"10","009","00","006","0612","0268","391","179","212","42","433","751","0","57.66","23.83"
"10","009","00","006","0613","0000","263","123","140","10","273","442","0","61.76","27.83"
"10","009","00","006","0613","0269","263","123","140","10","273","442","0","61.76","27.83"
"10","009","00","006","0614","0000","2688","1326","1362","166","2854","4912","0","58.1","27.0"
"10","009","00","006","0614","0270","630","329","301","43","673","1151","0","58.47","28.58"
"10","009","00","006","0614","0271","695","339","356","33","728","1224","0","59.48","27.7"
"10","009","00","006","0614","0272","650","315","335","40","690","1211","0","56.98","26.01"
"10","009","00","006","0614","0273","713","343","370","50","763","1326","0","57.54","25.87"
"10","009","00","006","0615","0000","1045","491","554","61","1106","1721","0","64.26","28.53"
"10","009","00","006","0615","0274","453","213","240","27","480","744","0","64.52","28.63"
"10","009","00","006","0615","0275","592","278","314","34","626","977","0","64.07","28.45"
"10","009","00","006","0616","0000","3388","1530","1858","194","3582","6230","0","57.5","24.56"
"10","009","00","006","0616","0278","761","336","425","31","792","1364","0","58.06","24.63"
"10","009","00","006","0616","0279","630","326","304","46","676","1123","0","60.2","29.03"
"10","009","00","006","0616","0280","794","325","469","32","826","1451","0","56.93","22.4"
"10","009","00","006","0616","0281","654","299","355","43","697","1162","0","59.98","25.73"
"10","009","00","006","0616","0282","549","244","305","42","591","1130","0","52.3","21.59"
"10","009","00","006","0617","0000","575","313","262","32","607","1149","0","52.83","27.24"
"10","009","00","006","0617","0283","575","313","262","32","607","1149","0","52.83","27.24"
"10","009","00","006","0618","0000","341","146","195","15","356","809","0","44.0","18.05"
"10","009","00","006","0618","0287","341","146","195","15","356","809","0","44.0","18.05"
"10","009","00","006","0619","0000","612","354","258","44","656","1397","0","46.96","25.34"
"10","009","00","006","0619","0288","612","354","258","44","656","1397","0","46.96","25.34"
"10","009","00","006","0620","0000","483","276","207","47","530","1145","0","46.29","24.1"
"10","009","00","006","0620","0289","483","276","207","47","530","1145","0","46.29","24.1"
"10","009","00","006","0621","0000","506","275","231","36","542","966","0","56.11","28.47"
"10","009","00","006","0621","0284","224","107","117","21","245","533","0","45.97","20.08"
"10","009","00","006","0621","0285","282","168","114","15","297","433","0","68.59","38.8"
"10","009","00","006","0622","0000","285","158","127","32","317","828","0","38.29","19.08"
"10","009","00","006","0622","0290","285","158","127","32","317","828","0","38.29","19.08"
"10","009","00","006","0623","0000","211","126","85","16","227","557","0","40.75","22.62"
"10","009","00","006","0623","0291","211","126","85","16","227","557","0","40.75","22.62"
"10","009","00","006","0624","0000","734","411","323","54","788","1637","0","48.14","25.11"
"10","009","00","006","0624","0292","471","278","193","31","502","1060","0","47.36","26.23"
"10","009","00","006","0624","0293","263","133","130","23","286","577","0","49.57","23.05"
"10","009","00","006","0625","0000","1506","825","681","66","1572","2981","0","52.73","27.68"
"10","009","00","006","0625","0294","394","265","129","22","416","931","0","44.68","28.46"
"10","009","00","006","0625","0295","532","267","265","28","560","1018","0","55.01","26.23"
"10","009","00","006","0625","0296","580","293","287","16","596","1032","0","57.75","28.39"
"10","009","00","006","0626","0000","525","313","212","25","550","960","0","57.29","32.6"
"10","009","00","006","0626","0276","525","313","212","25","550","960","0","57.29","32.6"
"10","009","00","006","0627","0000","196","99","97","5","201","494","0","40.69","20.04"
"10","009","00","006","0627","0277","196","99","97","5","201","494","0","40.69","20.04"
"10","009","00","006","0628","0000","183","93","90","8","191","377","0","50.66","24.67"
"10","009","00","006","0628","0286","183","93","90","8","191","377","0","50.66","24.67"
"10","009","00","007","0000","0000","13851","6473","7378","916","14767","27477","31464","53.74","23.56"
"10","009","00","007","0701","0000","611","298","313","47","658","1255","0","52.43","23.75"
"10","009","00","007","0701","0539","611","298","313","47","658","1255","0","52.43","23.75"
"10","009","00","007","0702","0000","612","261","351","41","653","1078","0","60.58","24.21"
"10","009","00","007","0702","0540","612","261","351","41","653","1078","0","60.58","24.21"
"10","009","00","007","0703","0000","623","271","352","61","684","1169","0","58.51","23.18"
"10","009","00","007","0703","0538","623","271","352","61","684","1169","0","58.51","23.18"
"10","009","00","007","0704","0000","718","345","373","51","769","1426","0","53.93","24.19"
"10","009","00","007","0704","0536","605","286","319","48","653","1122","0","58.2","25.49"
"10","009","00","007","0704","0537","113","59","54","3","116","304","0","38.16","19.41"
"10","009","00","007","0705","0000","1541","716","825","83","1624","3074","0","52.83","23.29"
"10","009","00","007","0705","0534","682","311","371","36","718","1302","0","55.15","23.89"
"10","009","00","007","0705","0535","859","405","454","47","906","1772","0","51.13","22.86"
"10","009","00","007","0706","0000","799","387","412","44","843","1517","0","55.57","25.51"
"10","009","00","007","0706","0533","799","387","412","44","843","1517","0","55.57","25.51"
"10","009","00","007","0707","0000","1079","496","583","80","1159","2120","0","54.67","23.4"
"10","009","00","007","0707","0531","593","250","343","38","631","1126","0","56.04","22.2"
"10","009","00","007","0707","0532","486","246","240","42","528","994","0","53.12","24.75"
"10","009","00","007","0708","0000","311","138","173","10","321","734","0","43.73","18.8"
"10","009","00","007","0708","0554","311","138","173","10","321","734","0","43.73","18.8"
"10","009","00","007","0709","0000","117","63","54","3","120","285","0","42.11","22.11"
"10","009","00","007","0709","0553","117","63","54","3","120","285","0","42.11","22.11"
"10","009","00","007","0710","0000","1092","493","599","76","1168","2138","0","54.63","23.06"
"10","009","00","007","0710","0547","472","214","258","41","513","998","0","51.4","21.44"
"10","009","00","007","0710","0548","620","279","341","35","655","1140","0","57.46","24.47"
"10","009","00","007","0711","0000","594","308","286","44","638","1150","0","55.48","26.78"
"10","009","00","007","0711","0555","594","308","286","44","638","1150","0","55.48","26.78"
"10","009","00","007","0712","0000","611","297","314","22","633","1233","0","51.34","24.09"
"10","009","00","007","0712","0552","611","297","314","22","633","1233","0","51.34","24.09"
"10","009","00","007","0713","0000","232","118","114","8","240","453","0","52.98","26.05"
"10","009","00","007","0713","0556","232","118","114","8","240","453","0","52.98","26.05"
"10","009","00","007","0714","0000","253","118","135","26","279","571","0","48.86","20.67"
"10","009","00","007","0714","0557","253","118","135","26","279","571","0","48.86","20.67"
"10","009","00","007","0715","0000","1052","533","519","63","1115","2058","0","54.18","25.9"
"10","009","00","007","0715","0549","561","297","264","40","601","1102","0","54.54","26.95"
"10","009","00","007","0715","0550","491","236","255","23","514","956","0","53.77","24.69"
"10","009","00","007","0716","0000","373","204","169","22","395","695","0","56.83","29.35"
"10","009","00","007","0716","0551","373","204","169","22","395","695","0","56.83","29.35"
"10","009","00","007","0717","0000","1050","427","623","92","1142","2243","0","50.91","19.04"
"10","009","00","007","0717","0541","428","168","260","43","471","943","0","49.95","17.82"
"10","009","00","007","0717","0542","622","259","363","49","671","1300","0","51.62","19.92"
"10","009","00","007","0718","0000","1061","458","603","69","1130","2108","0","53.61","21.73"
"10","009","00","007","0718","0543","476","206","270","28","504","964","0","52.28","21.37"
"10","009","00","007","0718","0544","585","252","333","41","626","1144","0","54.72","22.03"
"10","009","00","007","0719","0000","752","342","410","48","800","1482","0","53.98","23.08"
"10","009","00","007","0719","0545","752","342","410","48","800","1482","0","53.98","23.08"
"10","009","00","007","0720","0000","370","200","170","26","396","688","0","57.56","29.07"
"10","009","00","007","0720","0546","370","200","170","26","396","688","0","57.56","29.07"
"10","009","00","008","0000","0000","8198","4160","4038","508","8706","16509","19083","52.73","25.2"
"10","009","00","008","0801","0000","386","210","176","21","407","750","0","54.27","28.0"
"10","009","00","008","0801","0480","386","210","176","21","407","750","0","54.27","28.0"
"10","009","00","008","0802","0000","1107","538","569","66","1173","2095","0","55.99","25.68"
"10","009","00","008","0802","0484","766","387","379","44","810","1495","0","54.18","25.89"
"10","009","00","008","0802","0485","341","151","190","22","363","600","0","60.5","25.17"
"10","009","00","008","0803","0000","561","272","289","42","603","1004","0","60.06","27.09"
"10","009","00","008","0803","0486","561","272","289","42","603","1004","0","60.06","27.09"
"10","009","00","008","0804","0000","401","244","157","12","413","948","0","43.57","25.74"
"10","009","00","008","0804","0487","401","244","157","12","413","948","0","43.57","25.74"
"10","009","00","008","0805","0000","883","424","459","57","940","1895","0","49.6","22.37"
"10","009","00","008","0805","0489","653","324","329","44","697","1430","0","48.74","22.66"
"10","009","00","008","0805","0490","230","100","130","13","243","465","0","52.26","21.51"
"10","009","00","008","0806","0000","870","445","425","40","910","1781","0","51.09","24.99"
"10","009","00","008","0806","0491","639","304","335","24","663","1307","0","50.73","23.26"
"10","009","00","008","0806","0492","231","141","90","16","247","474","0","52.11","29.75"
"10","009","00","008","0807","0000","794","306","488","37","831","1539","0","54.0","19.88"
"10","009","00","008","0807","0488","794","306","488","37","831","1539","0","54.0","19.88"
"10","009","00","008","0808","0000","668","356","312","66","734","1220","0","60.16","29.18"
"10","009","00","008","0808","0493","668","356","312","66","734","1220","0","60.16","29.18"
"10","009","00","008","0809","0000","369","215","154","17","386","719","0","53.69","29.9"
"10","009","00","008","0809","0481","369","215","154","17","386","719","0","53.69","29.9"
"10","009","00","008","0810","0000","302","139","163","20","322","603","0","53.4","23.05"
"10","009","00","008","0810","0482","302","139","163","20","322","603","0","53.4","23.05"
"10","009","00","008","0811","0000","496","281","215","39","535","1106","0","48.37","25.41"
"10","009","00","008","0811","0483","496","281","215","39","535","1106","0","48.37","25.41"
"10","009","00","008","0812","0000","369","180","189","19","388","733","0","52.93","24.56"
"10","009","00","008","0812","0494","369","180","189","19","388","733","0","52.93","24.56"
"10","009","00","008","0813","0000","363","194","169","22","385","681","0","56.53","28.49"
"10","009","00","008","0813","0495","363","194","169","22","385","681","0","56.53","28.49"
"10","009","00","008","0814","0000","305","180","125","16","321","712","0","45.08","25.28"
"10","009","00","008","0814","0496","305","180","125","16","321","712","0","45.08","25.28"
"10","009","00","008","0815","0000","324","176","148","34","358","723","0","49.52","24.34"
"10","009","00","008","0815","0497","324","176","148","34","358","723","0","49.52","24.34"
"10","009","00","009","0000","0000","12837","6611","6226","908","13745","24570","28727","55.94","26.91"
"10","009","00","009","0901","0000","2218","1111","1107","111","2329","4079","0","57.1","27.24"
"10","009","00","009","0901","0374","826","400","426","28","854","1507","0","56.67","26.54"
"10","009","00","009","0901","0375","686","329","357","33","719","1300","0","55.31","25.31"
"10","009","00","009","0901","0376","706","382","324","50","756","1272","0","59.43","30.03"
"10","009","00","009","0902","0000","429","244","185","37","466","861","0","54.12","28.34"
"10","009","00","009","0902","0377","429","244","185","37","466","861","0","54.12","28.34"
"10","009","00","009","0903","0000","746","401","345","45","791","1565","0","50.54","25.62"
"10","009","00","009","0903","0378","746","401","345","45","791","1565","0","50.54","25.62"
"10","009","00","009","0904","0000","600","345","255","35","635","1213","0","52.35","28.44"
"10","009","00","009","0904","0379","309","174","135","15","324","577","0","56.15","30.16"
"10","009","00","009","0904","0380","291","171","120","20","311","636","0","48.9","26.89"
"10","009","00","009","0905","0000","538","312","226","50","588","1110","0","52.97","28.11"
"10","009","00","009","0905","0381","538","312","226","50","588","1110","0","52.97","28.11"
"10","009","00","009","0906","0000","1083","576","507","72","1155","1958","0","58.99","29.42"
"10","009","00","009","0906","0382","561","296","265","32","593","973","0","60.95","30.42"
"10","009","00","009","0906","0383","522","280","242","40","562","985","0","57.06","28.43"
"10","009","00","009","0907","0000","1607","783","824","145","1752","2991","0","58.58","26.18"
"10","009","00","009","0907","0384","936","440","496","82","1018","1707","0","59.64","25.78"
"10","009","00","009","0907","0385","671","343","328","63","734","1284","0","57.17","26.71"
"10","009","00","009","0908","0000","716","351","365","26","742","1293","0","57.39","27.15"
"10","009","00","009","0908","0386","716","351","365","26","742","1293","0","57.39","27.15"
"10","009","00","009","0909","0000","584","295","289","27","611","1165","0","52.45","25.32"
"10","009","00","009","0909","0389","584","295","289","27","611","1165","0","52.45","25.32"
"10","009","00","009","0910","0000","1048","552","496","94","1142","1940","0","58.87","28.45"
"10","009","00","009","0910","0387","475","224","251","35","510","900","0","56.67","24.89"
"10","009","00","009","0910","0388","573","328","245","59","632","1040","0","60.77","31.54"
"10","009","00","009","0911","0000","972","466","506","76","1048","1756","0","59.68","26.54"
"10","009","00","009","0911","0390","467","246","221","34","501","871","0","57.52","28.24"
"10","009","00","009","0911","0391","505","220","285","42","547","885","0","61.81","24.86"
"10","009","00","009","0912","0000","682","353","329","52","734","1489","0","49.29","23.71"
"10","009","00","009","0912","0392","682","353","329","52","734","1489","0","49.29","23.71"
"10","009","00","009","0913","0000","630","328","302","61","691","1347","0","51.3","24.35"
"10","009","00","009","0913","0393","630","328","302","61","691","1347","0","51.3","24.35"
"10","009","00","009","0914","0000","984","494","490","77","1061","1803","0","58.85","27.4"
"10","009","00","009","0914","0394","620","322","298","47","667","1150","0","58.0","28.0"
"10","009","00","009","0914","0395","364","172","192","30","394","653","0","60.34","26.34"
"10","009","00","010","0000","0000","8171","3758","4413","670","8841","15551","18089","56.85","24.17"
"10","009","00","010","1001","0000","608","249","359","49","657","1036","0","63.42","24.03"
"10","009","00","010","1001","0396","608","249","359","49","657","1036","0","63.42","24.03"
"10","009","00","010","1002","0000","1879","812","1067","128","2007","3652","0","54.96","22.23"
"10","009","00","010","1002","0397","797","362","435","42","839","1490","0","56.31","24.3"
"10","009","00","010","1002","0398","760","306","454","44","804","1491","0","53.92","20.52"
"10","009","00","010","1002","0399","322","144","178","42","364","671","0","54.25","21.46"
"10","009","00","010","1003","0000","1189","574","615","109","1298","2187","0","59.35","26.25"
"10","009","00","010","1003","0400","776","353","423","75","851","1436","0","59.26","24.58"
"10","009","00","010","1003","0401","413","221","192","34","447","751","0","59.52","29.43"
"10","009","00","010","1004","0000","281","129","152","20","301","535","0","56.26","24.11"
"10","009","00","010","1004","0402","281","129","152","20","301","535","0","56.26","24.11"
"10","009","00","010","1005","0000","359","164","195","38","397","811","0","48.95","20.22"
"10","009","00","010","1005","0403","359","164","195","38","397","811","0","48.95","20.22"
"10","009","00","010","1006","0000","1368","640","728","110","1478","2625","0","56.3","24.38"
"10","009","00","010","1006","0404","711","347","364","59","770","1339","0","57.51","25.91"
"10","009","00","010","1006","0405","657","293","364","51","708","1286","0","55.05","22.78"
"10","009","00","010","1007","0000","323","167","156","34","357","646","0","55.26","25.85"
"10","009","00","010","1007","0406","323","167","156","34","357","646","0","55.26","25.85"
"10","009","00","010","1008","0000","583","254","329","68","651","1158","0","56.22","21.93"
"10","009","00","010","1008","0407","583","254","329","68","651","1158","0","56.22","21.93"
"10","009","00","010","1009","0000","583","252","331","39","622","1090","0","57.06","23.12"
"10","009","00","010","1009","0408","583","252","331","39","622","1090","0","57.06","23.12"
"10","009","00","010","1010","0000","998","517","481","75","1073","1811","0","59.25","28.55"
"10","009","00","010","1010","0409","539","296","243","47","586","950","0","61.68","31.16"
"10","009","00","010","1010","0410","459","221","238","28","487","861","0","56.56","25.67"
"10","009","00","011","0000","0000","10889","6007","4882","647","11536","23367","26906","49.37","25.71"
"10","009","00","011","1101","0000","672","362","310","24","696","1463","0","47.57","24.74"
"10","009","00","011","1101","0317","672","362","310","24","696","1463","0","47.57","24.74"
"10","009","00","011","1102","0000","798","400","398","33","831","1738","0","47.81","23.01"
"10","009","00","011","1102","0318","798","400","398","33","831","1738","0","47.81","23.01"
"10","009","00","011","1103","0000","755","438","317","75","830","1643","0","50.52","26.66"
"10","009","00","011","1103","0319","256","136","120","46","302","625","0","48.32","21.76"
"10","009","00","011","1103","0320","499","302","197","29","528","1018","0","51.87","29.67"
"10","009","00","011","1104","0000","590","331","259","36","626","1496","0","41.84","22.13"
"10","009","00","011","1104","0321","204","117","87","5","209","448","0","46.65","26.12"
"10","009","00","011","1104","0322","386","214","172","31","417","1048","0","39.79","20.42"
"10","009","00","011","1105","0000","589","299","290","51","640","1161","0","55.12","25.75"
"10","009","00","011","1105","0323","589","299","290","51","640","1161","0","55.12","25.75"
"10","009","00","011","1106","0000","1010","524","486","60","1070","1840","0","58.15","28.48"
"10","009","00","011","1106","0324","540","282","258","21","561","991","0","56.61","28.46"
"10","009","00","011","1106","0325","470","242","228","39","509","849","0","59.95","28.5"
"10","009","00","011","1107","0000","428","216","212","22","450","890","0","50.56","24.27"
"10","009","00","011","1107","0326","428","216","212","22","450","890","0","50.56","24.27"
"10","009","00","011","1108","0000","471","298","173","15","486","891","0","54.55","33.45"
"10","009","00","011","1108","0328","471","298","173","15","486","891","0","54.55","33.45"
"10","009","00","011","1109","0000","345","195","150","13","358","757","0","47.29","25.76"
"10","009","00","011","1109","0329","345","195","150","13","358","757","0","47.29","25.76"
"10","009","00","011","1110","0000","690","405","285","49","739","1497","0","49.37","27.05"
"10","009","00","011","1110","0330","690","405","285","49","739","1497","0","49.37","27.05"
"10","009","00","011","1111","0000","927","541","386","44","971","1857","0","52.29","29.13"
"10","009","00","011","1111","0331","547","344","203","21","568","1171","0","48.51","29.38"
"10","009","00","011","1111","0332","380","197","183","23","403","686","0","58.75","28.72"
"10","009","00","011","1112","0000","360","195","165","27","387","864","0","44.79","22.57"
"10","009","00","011","1112","0333","360","195","165","27","387","864","0","44.79","22.57"
"10","009","00","011","1113","0000","886","474","412","55","941","1769","0","53.19","26.79"
"10","009","00","011","1113","0334","579","276","303","40","619","1073","0","57.69","25.72"
"10","009","00","011","1113","0335","307","198","109","15","322","696","0","46.26","28.45"
"10","009","00","011","1114","0000","463","250","213","35","498","1271","0","39.18","19.67"
"10","009","00","011","1114","0336","463","250","213","35","498","1271","0","39.18","19.67"
"10","009","00","011","1115","0000","392","227","165","23","415","912","0","45.5","24.89"
"10","009","00","011","1115","0337","392","227","165","23","415","912","0","45.5","24.89"
"10","009","00","011","1116","0000","398","242","156","19","417","861","0","48.43","28.11"
"10","009","00","011","1116","0338","398","242","156","19","417","861","0","48.43","28.11"
"10","009","00","011","1117","0000","426","227","199","35","461","1030","0","44.76","22.04"
"10","009","00","011","1117","0339","426","227","199","35","461","1030","0","44.76","22.04"
"10","009","00","011","1118","0000","689","383","306","31","720","1427","0","50.46","26.84"
"10","009","00","011","1118","0327","689","383","306","31","720","1427","0","50.46","26.84"
"10","009","00","012","0000","0000","9781","4948","4833","665","10446","21050","24427","49.62","23.51"
"10","009","00","012","1201","0000","616","294","322","43","659","1176","0","56.04","25.0"
"10","009","00","012","1201","0297","616","294","322","43","659","1176","0","56.04","25.0"
"10","009","00","012","1202","0000","714","348","366","45","759","1439","0","52.74","24.18"
"10","009","00","012","1202","0298","714","348","366","45","759","1439","0","52.74","24.18"
"10","009","00","012","1203","0000","1270","528","742","63","1333","2286","0","58.31","23.1"
"10","009","00","012","1203","0299","591","248","343","30","621","1027","0","60.47","24.15"
"10","009","00","012","1203","0300","679","280","399","33","712","1259","0","56.55","22.24"
"10","009","00","012","1204","0000","927","530","397","52","979","2056","0","47.62","25.78"
"10","009","00","012","1204","0301","474","287","187","32","506","1058","0","47.83","27.13"
"10","009","00","012","1204","0302","453","243","210","20","473","998","0","47.39","24.35"
"10","009","00","012","1205","0000","987","542","445","51","1038","2023","0","51.31","26.79"
"10","009","00","012","1205","0303","456","237","219","23","479","968","0","49.48","24.48"
"10","009","00","012","1205","0304","531","305","226","28","559","1055","0","52.99","28.91"
"10","009","00","012","1206","0000","597","330","267","40","637","1315","0","48.44","25.1"
"10","009","00","012","1206","0305","597","330","267","40","637","1315","0","48.44","25.1"
"10","009","00","012","1207","0000","861","443","418","76","937","2024","0","46.29","21.89"
"10","009","00","012","1207","0306","321","154","167","26","347","1027","0","33.79","15.0"
"10","009","00","012","1207","0307","540","289","251","50","590","997","0","59.18","28.99"
"10","009","00","012","1208","0000","394","163","231","31","425","807","0","52.66","20.2"
"10","009","00","012","1208","0308","394","163","231","31","425","807","0","52.66","20.2"
"10","009","00","012","1209","0000","624","304","320","49","673","1502","0","44.81","20.24"
"10","009","00","012","1209","0309","282","143","139","11","293","698","0","41.98","20.49"
"10","009","00","012","1209","0310","342","161","181","38","380","804","0","47.26","20.02"
"10","009","00","012","1210","0000","793","418","375","54","847","1753","0","48.32","23.84"
"10","009","00","012","1210","0311","433","230","203","27","460","867","0","53.06","26.53"
"10","009","00","012","1210","0312","360","188","172","27","387","886","0","43.68","21.22"
"10","009","00","012","1211","0000","555","263","292","63","618","1476","0","41.87","17.82"
"10","009","00","012","1211","0313","555","263","292","63","618","1476","0","41.87","17.82"
"10","009","00","012","1212","0000","388","193","195","23","411","1159","0","35.46","16.65"
"10","009","00","012","1212","0314","388","193","195","23","411","1159","0","35.46","16.65"
"10","009","00","012","1213","0000","642","372","270","54","696","1220","0","57.05","30.49"
"10","009","00","012","1213","0315","642","372","270","54","696","1220","0","57.05","30.49"
"10","009","00","012","1214","0000","413","220","193","21","434","814","0","53.32","27.03"
"10","009","00","012","1214","0316","413","220","193","21","434","814","0","53.32","27.03"
"10","009","00","013","0000","0000","17072","7504","9568","1258","18330","37119","46004","49.38","20.22"
"10","009","00","013","1301","0000","1790","726","1064","147","1937","4029","0","48.08","18.02"
"10","009","00","013","1301","0005","553","232","321","58","611","1340","0","45.6","17.31"
"10","009","00","013","1301","0006","512","226","286","41","553","1138","0","48.59","19.86"
"10","009","00","013","1301","0007","725","268","457","48","773","1551","0","49.84","17.28"
"10","009","00","013","1302","0000","3178","1341","1837","188","3366","6988","0","48.17","19.19"
"10","009","00","013","1302","0001","622","263","359","44","666","1497","0","44.49","17.57"
"10","009","00","013","1302","0002","824","357","467","48","872","1738","0","50.17","20.54"
"10","009","00","013","1302","0003","906","392","514","51","957","1921","0","49.82","20.41"
"10","009","00","013","1302","0004","826","329","497","45","871","1832","0","47.54","17.96"
"10","009","00","013","1303","0000","798","390","408","43","841","1909","0","44.05","20.43"
"10","009","00","013","1303","0008","289","128","161","23","312","715","0","43.64","17.9"
"10","009","00","013","1303","0009","509","262","247","20","529","1194","0","44.3","21.94"
"10","009","00","013","1304","0000","1052","492","560","64","1116","2581","0","43.24","19.06"
"10","009","00","013","1304","0010","460","202","258","29","489","1023","0","47.8","19.75"
"10","009","00","013","1304","0011","592","290","302","35","627","1558","0","40.24","18.61"
"10","009","00","013","1305","0000","1175","526","649","94","1269","2559","0","49.59","20.55"
"10","009","00","013","1305","0019","571","234","337","51","622","1230","0","50.57","19.02"
"10","009","00","013","1305","0020","604","292","312","43","647","1329","0","48.68","21.97"
"10","009","00","013","1306","0000","1331","535","796","109","1440","2959","0","48.67","18.08"
"10","009","00","013","1306","0014","623","250","373","48","671","1363","0","49.23","18.34"
"10","009","00","013","1306","0015","708","285","423","61","769","1596","0","48.18","17.86"
"10","009","00","013","1307","0000","863","377","486","44","907","2170","0","41.8","17.37"
"10","009","00","013","1307","0012","468","218","250","19","487","1187","0","41.03","18.37"
"10","009","00","013","1307","0013","395","159","236","25","420","983","0","42.73","16.17"
"10","009","00","013","1308","0000","820","385","435","70","890","2002","0","44.46","19.23"
"10","009","00","013","1308","0017","404","174","230","34","438","964","0","45.44","18.05"
"10","009","00","013","1308","0018","416","211","205","36","452","1038","0","43.55","20.33"
"10","009","00","013","1309","0000","1907","819","1088","205","2112","3841","0","54.99","21.32"
"10","009","00","013","1309","0021","547","210","337","59","606","1129","0","53.68","18.6"
"10","009","00","013","1309","0022","628","280","348","67","695","1241","0","56.0","22.56"
"10","009","00","013","1309","0023","732","329","403","79","811","1471","0","55.13","22.37"
"10","009","00","013","1310","0000","572","286","286","64","636","1107","0","57.45","25.84"
"10","009","00","013","1310","0024","572","286","286","64","636","1107","0","57.45","25.84"
"10","009","00","013","1311","0000","1679","772","907","105","1784","3391","0","52.61","22.77"
"10","009","00","013","1311","0025","846","397","449","54","900","1636","0","55.01","24.27"
"10","009","00","013","1311","0026","833","375","458","51","884","1755","0","50.37","21.37"
"10","009","00","013","1312","0000","1113","497","616","55","1168","2114","0","55.25","23.51"
"10","009","00","013","1312","0027","622","256","366","26","648","1158","0","55.96","22.11"
"10","009","00","013","1312","0028","491","241","250","29","520","956","0","54.39","25.21"
"10","009","00","013","1313","0000","794","358","436","70","864","1469","0","58.82","24.37"
"10","009","00","013","1313","0016","794","358","436","70","864","1469","0","58.82","24.37"
"10","009","00","014","0000","0000","6202","3163","3039","459","6661","13239","14845","50.31","23.89"
"10","009","00","014","1401","0000","830","347","483","49","879","1533","0","57.34","22.64"
"10","009","00","014","1401","0055","830","347","483","49","879","1533","0","57.34","22.64"
"10","009","00","014","1402","0000","677","333","344","45","722","1203","0","60.02","27.68"
"10","009","00","014","1402","0056","677","333","344","45","722","1203","0","60.02","27.68"
"10","009","00","014","1403","0000","737","413","324","59","796","1624","0","49.01","25.43"
"10","009","00","014","1403","0053","379","224","155","21","400","896","0","44.64","25.0"
"10","009","00","014","1403","0054","358","189","169","38","396","728","0","54.4","25.96"
"10","009","00","014","1404","0000","308","156","152","18","326","540","0","60.37","28.89"
"10","009","00","014","1404","0052","308","156","152","18","326","540","0","60.37","28.89"
"10","009","00","014","1405","0000","518","271","247","37","555","1207","0","45.98","22.45"
"10","009","00","014","1405","0051","518","271","247","37","555","1207","0","45.98","22.45"
"10","009","00","014","1406","0000","310","140","170","19","329","546","0","60.26","25.64"
"10","009","00","014","1406","0058","310","140","170","19","329","546","0","60.26","25.64"
"10","009","00","014","1407","0000","366","210","156","30","396","817","0","48.47","25.7"
"10","009","00","014","1407","0057","366","210","156","30","396","817","0","48.47","25.7"
"10","009","00","014","1408","0000","353","204","149","26","379","856","0","44.28","23.83"
"10","009","00","014","1408","0060","353","204","149","26","379","856","0","44.28","23.83"
"10","009","00","014","1409","0000","390","209","181","48","438","853","0","51.35","24.5"
"10","009","00","014","1409","0059","390","209","181","48","438","853","0","51.35","24.5"
"10","009","00","014","1410","0000","904","466","438","67","971","1945","0","49.92","23.96"
"10","009","00","014","1410","0061","417","221","196","32","449","923","0","48.65","23.94"
"10","009","00","014","1410","0062","487","245","242","35","522","1022","0","51.08","23.97"
"10","009","00","014","1411","0000","408","203","205","33","441","1087","0","40.57","18.68"
"10","009","00","014","1411","0065","408","203","205","33","441","1087","0","40.57","18.68"
"10","009","00","014","1412","0000","401","211","190","28","429","1028","0","41.73","20.53"
"10","009","00","014","1412","0063","234","115","119","13","247","634","0","38.96","18.14"
"10","009","00","014","1412","0064","167","96","71","15","182","394","0","46.19","24.37"
"10","009","00","015","0000","0000","5685","2827","2858","310","5995","11381","12992","52.68","24.84"
"10","009","00","015","1501","0000","1048","511","537","61","1109","1916","0","57.88","26.67"
"10","009","00","015","1501","0066","486","223","263","36","522","923","0","56.55","24.16"
"10","009","00","015","1501","0067","562","288","274","25","587","993","0","59.11","29.0"
"10","009","00","015","1502","0000","735","353","382","23","758","1450","0","52.28","24.34"
"10","009","00","015","1502","0068","382","178","204","13","395","748","0","52.81","23.8"
"10","009","00","015","1502","0069","353","175","178","10","363","702","0","51.71","24.93"
"10","009","00","015","1503","0000","791","392","399","26","817","1508","0","54.18","25.99"
"10","009","00","015","1503","0070","397","194","203","12","409","752","0","54.39","25.8"
"10","009","00","015","1503","0071","394","198","196","14","408","756","0","53.97","26.19"
"10","009","00","015","1504","0000","581","333","248","37","618","1207","0","51.2","27.59"
"10","009","00","015","1504","0074","219","121","98","21","240","470","0","51.06","25.74"
"10","009","00","015","1504","0075","362","212","150","16","378","737","0","51.29","28.77"
"10","009","00","015","1505","0000","747","325","422","35","782","1524","0","51.31","21.33"
"10","009","00","015","1505","0072","254","109","145","6","260","490","0","53.06","22.24"
"10","009","00","015","1505","0073","493","216","277","29","522","1034","0","50.48","20.89"
"10","009","00","015","1506","0000","406","208","198","31","437","878","0","49.77","23.69"
"10","009","00","015","1506","0076","406","208","198","31","437","878","0","49.77","23.69"
"10","009","00","015","1507","0000","361","157","204","29","390","778","0","50.13","20.18"
"10","009","00","015","1507","0077","361","157","204","29","390","778","0","50.13","20.18"
"10","009","00","015","1508","0000","610","295","315","33","643","1224","0","52.53","24.1"
"10","009","00","015","1508","0078","610","295","315","33","643","1224","0","52.53","24.1"
"10","009","00","015","1509","0000","406","253","153","35","441","896","0","49.22","28.24"
"10","009","00","015","1509","0079","406","253","153","35","441","896","0","49.22","28.24"
"10","009","00","016","0000","0000","9092","4206","4886","681","9773","21125","23824","46.26","19.91"
"10","009","00","016","1601","0000","653","252","401","36","689","1238","0","55.65","20.36"
"10","009","00","016","1601","0029","653","252","401","36","689","1238","0","55.65","20.36"
"10","009","00","016","1602","0000","541","240","301","50","591","1098","0","53.83","21.86"
"10","009","00","016","1602","0031","541","240","301","50","591","1098","0","53.83","21.86"
"10","009","00","016","1603","0000","490","210","280","26","516","1091","0","47.3","19.25"
"10","009","00","016","1603","0030","490","210","280","26","516","1091","0","47.3","19.25"
"10","009","00","016","1604","0000","896","410","486","56","952","2073","0","45.92","19.78"
"10","009","00","016","1604","0032","428","185","243","28","456","1048","0","43.51","17.65"
"10","009","00","016","1604","0033","468","225","243","28","496","1025","0","48.39","21.95"
"10","009","00","016","1605","0000","617","308","309","32","649","1460","0","44.45","21.1"
"10","009","00","016","1605","0035","617","308","309","32","649","1460","0","44.45","21.1"
"10","009","00","016","1606","0000","610","299","311","71","681","1890","0","36.03","15.82"
"10","009","00","016","1606","0036","388","187","201","53","441","1180","0","37.37","15.85"
"10","009","00","016","1606","0037","222","112","110","18","240","710","0","33.8","15.77"
"10","009","00","016","1607","0000","252","140","112","12","264","620","0","42.58","22.58"
"10","009","00","016","1607","0038","252","140","112","12","264","620","0","42.58","22.58"
"10","009","00","016","1608","0000","253","128","125","29","282","687","0","41.05","18.63"
"10","009","00","016","1608","0040","253","128","125","29","282","687","0","41.05","18.63"
"10","009","00","016","1609","0000","200","115","85","14","214","449","0","47.66","25.61"
"10","009","00","016","1609","0039","200","115","85","14","214","449","0","47.66","25.61"
"10","009","00","016","1610","0000","407","198","209","25","432","850","0","50.82","23.29"
"10","009","00","016","1610","0034","407","198","209","25","432","850","0","50.82","23.29"
"10","009","00","016","1611","0000","703","303","400","49","752","1514","0","49.67","20.01"
"10","009","00","016","1611","0043","499","213","286","33","532","1042","0","51.06","20.44"
"10","009","00","016","1611","0044","204","90","114","16","220","472","0","46.61","19.07"
"10","009","00","016","1612","0000","567","223","344","33","600","1409","0","42.58","15.83"
"10","009","00","016","1612","0045","567","223","344","33","600","1409","0","42.58","15.83"
"10","009","00","016","1613","0000","1353","673","680","145","1498","3067","0","48.84","21.94"
"10","009","00","016","1613","0046","513","258","255","53","566","1061","0","53.35","24.32"
"10","009","00","016","1613","0047","405","189","216","29","434","993","0","43.71","19.03"
"10","009","00","016","1613","0048","435","226","209","63","498","1013","0","49.16","22.31"
"10","009","00","016","1614","0000","821","350","471","52","873","1849","0","47.21","18.93"
"10","009","00","016","1614","0049","580","244","336","29","609","1233","0","49.39","19.79"
"10","009","00","016","1614","0050","241","106","135","23","264","616","0","42.86","17.21"
"10","009","00","016","1615","0000","729","357","372","51","780","1830","0","42.62","19.51"
"10","009","00","016","1615","0041","532","285","247","39","571","1247","0","45.79","22.85"
"10","009","00","016","1615","0042","197","72","125","12","209","583","0","35.85","12.35"
"10","009","00","017","0000","0000","9480","4961","4519","676","10156","22830","25784","44.49","21.73"
"10","009","00","017","1701","0000","1554","791","763","81","1635","3349","0","48.82","23.62"
"10","009","00","017","1701","0180","431","212","219","30","461","915","0","50.38","23.17"
"10","009","00","017","1701","0181","596","290","306","21","617","1284","0","48.05","22.59"
"10","009","00","017","1701","0182","527","289","238","30","557","1150","0","48.43","25.13"
"10","009","00","017","1702","0000","668","357","311","65","733","1534","0","47.78","23.27"
"10","009","00","017","1702","0183","311","170","141","32","343","744","0","46.1","22.85"
"10","009","00","017","1702","0184","357","187","170","33","390","790","0","49.37","23.67"
"10","009","00","017","1703","0000","583","311","272","45","628","1356","0","46.31","22.94"
"10","009","00","017","1703","0185","583","311","272","45","628","1356","0","46.31","22.94"
"10","009","00","017","1704","0000","334","200","134","26","360","739","0","48.71","27.06"
"10","009","00","017","1704","0186","334","200","134","26","360","739","0","48.71","27.06"
"10","009","00","017","1705","0000","367","165","202","32","399","965","0","41.35","17.1"
"10","009","00","017","1705","0187","367","165","202","32","399","965","0","41.35","17.1"
"10","009","00","017","1706","0000","431","243","188","34","465","1080","0","43.06","22.5"
"10","009","00","017","1706","0188","431","243","188","34","465","1080","0","43.06","22.5"
"10","009","00","017","1707","0000","360","202","158","33","393","948","0","41.46","21.31"
"10","009","00","017","1707","0189","360","202","158","33","393","948","0","41.46","21.31"
"10","009","00","017","1708","0000","232","134","98","15","247","762","0","32.41","17.59"
"10","009","00","017","1708","0190","232","134","98","15","247","762","0","32.41","17.59"
"10","009","00","017","1709","0000","256","123","133","19","275","582","0","47.25","21.13"
"10","009","00","017","1709","0191","256","123","133","19","275","582","0","47.25","21.13"
"10","009","00","017","1710","0000","328","154","174","15","343","865","0","39.65","17.8"
"10","009","00","017","1710","0192","328","154","174","15","343","865","0","39.65","17.8"
"10","009","00","017","1711","0000","89","52","37","2","91","362","0","25.14","14.36"
"10","009","00","017","1711","0193","89","52","37","2","91","362","0","25.14","14.36"
"10","009","00","017","1712","0000","448","231","217","23","471","1162","0","40.53","19.88"
"10","009","00","017","1712","0194","448","231","217","23","471","1162","0","40.53","19.88"
"10","009","00","017","1713","0000","686","340","346","25","711","1527","0","46.56","22.27"
"10","009","00","017","1713","0195","686","340","346","25","711","1527","0","46.56","22.27"
"10","009","00","017","1714","0000","439","234","205","51","490","1006","0","48.71","23.26"
"10","009","00","017","1714","0196","439","234","205","51","490","1006","0","48.71","23.26"
"10","009","00","017","1715","0000","374","200","174","18","392","855","0","45.85","23.39"
"10","009","00","017","1715","0197","374","200","174","18","392","855","0","45.85","23.39"
"10","009","00","017","1716","0000","500","265","235","59","559","1181","0","47.33","22.44"
"10","009","00","017","1716","0198","500","265","235","59","559","1181","0","47.33","22.44"
"10","009","00","017","1717","0000","327","173","154","23","350","864","0","40.51","20.02"
"10","009","00","017","1717","0199","327","173","154","23","350","864","0","40.51","20.02"
"10","009","00","017","1718","0000","603","331","272","45","648","1545","0","41.94","21.42"
"10","009","00","017","1718","0200","250","135","115","25","275","667","0","41.23","20.24"
"10","009","00","017","1718","0201","353","196","157","20","373","878","0","42.48","22.32"
"10","009","00","017","1719","0000","201","118","83","8","209","610","0","34.26","19.34"
"10","009","00","017","1719","0202","201","118","83","8","209","610","0","34.26","19.34"
"10","009","00","017","1720","0000","363","167","196","37","400","837","0","47.79","19.95"
"10","009","00","017","1720","0203","363","167","196","37","400","837","0","47.79","19.95"
"10","009","00","017","1721","0000","337","170","167","20","357","701","0","50.93","24.25"
"10","009","00","017","1721","0204","337","170","167","20","357","701","0","50.93","24.25"
"10","009","00","018","0000","0000","7936","4104","3832","574","8510","20983","23317","40.56","19.56"
"10","009","00","018","1801","0000","821","413","408","47","868","1758","0","49.37","23.49"
"10","009","00","018","1801","0155","456","217","239","31","487","1082","0","45.01","20.06"
"10","009","00","018","1801","0156","365","196","169","16","381","676","0","56.36","28.99"
"10","009","00","018","1802","0000","257","140","117","5","262","650","0","40.31","21.54"
"10","009","00","018","1802","0160","257","140","117","5","262","650","0","40.31","21.54"
"10","009","00","018","1803","0000","424","215","209","12","436","969","0","44.99","22.19"
"10","009","00","018","1803","0161","424","215","209","12","436","969","0","44.99","22.19"
"10","009","00","018","1804","0000","351","209","142","26","377","925","0","40.76","22.59"
"10","009","00","018","1804","0162","351","209","142","26","377","925","0","40.76","22.59"
"10","009","00","018","1805","0000","1062","499","563","105","1167","2291","0","50.94","21.78"
"10","009","00","018","1805","0157","420","178","242","16","436","862","0","50.58","20.65"
"10","009","00","018","1805","0158","181","117","64","17","198","477","0","41.51","24.53"
"10","009","00","018","1805","0159","461","204","257","72","533","952","0","55.99","21.43"
"10","009","00","018","1806","0000","457","228","229","33","490","1219","0","40.2","18.7"
"10","009","00","018","1806","0165","457","228","229","33","490","1219","0","40.2","18.7"
"10","009","00","018","1807","0000","245","150","95","15","260","759","0","34.26","19.76"
"10","009","00","018","1807","0164","245","150","95","15","260","759","0","34.26","19.76"
"10","009","00","018","1808","0000","389","194","195","20","409","914","0","44.75","21.23"
"10","009","00","018","1808","0163","389","194","195","20","409","914","0","44.75","21.23"
"10","009","00","018","1809","0000","282","130","152","19","301","876","0","34.36","14.84"
"10","009","00","018","1809","0169","282","130","152","19","301","876","0","34.36","14.84"
"10","009","00","018","1810","0000","131","68","63","8","139","360","0","38.61","18.89"
"10","009","00","018","1810","0170","131","68","63","8","139","360","0","38.61","18.89"
"10","009","00","018","1811","0000","244","139","105","10","254","773","0","32.86","17.98"
"10","009","00","018","1811","0167","244","139","105","10","254","773","0","32.86","17.98"
"10","009","00","018","1812","0000","302","145","157","24","326","937","0","34.79","15.47"
"10","009","00","018","1812","0166","302","145","157","24","326","937","0","34.79","15.47"
"10","009","00","018","1813","0000","522","257","265","37","559","1718","0","32.54","14.96"
"10","009","00","018","1813","0171","249","136","113","24","273","885","0","30.85","15.37"
"10","009","00","018","1813","0172","273","121","152","13","286","833","0","34.33","14.53"
"10","009","00","018","1814","0000","305","164","141","29","334","785","0","42.55","20.89"
"10","009","00","018","1814","0173","305","164","141","29","334","785","0","42.55","20.89"
"10","009","00","018","1815","0000","309","128","181","30","339","705","0","48.09","18.16"
"10","009","00","018","1815","0174","309","128","181","30","339","705","0","48.09","18.16"
"10","009","00","018","1816","0000","334","203","131","26","360","927","0","38.83","21.9"
"10","009","00","018","1816","0175","334","203","131","26","360","927","0","38.83","21.9"
"10","009","00","018","1817","0000","383","226","157","26","409","1071","0","38.19","21.1"
"10","009","00","018","1817","0177","383","226","157","26","409","1071","0","38.19","21.1"
"10","009","00","018","1818","0000","284","153","131","18","302","1022","0","29.55","14.97"
"10","009","00","018","1818","0178","284","153","131","18","302","1022","0","29.55","14.97"
"10","009","00","018","1819","0000","281","131","150","23","304","711","0","42.76","18.42"
"10","009","00","018","1819","0179","281","131","150","23","304","711","0","42.76","18.42"
"10","009","00","018","1820","0000","197","102","95","28","225","555","0","40.54","18.38"
"10","009","00","018","1820","0168","197","102","95","28","225","555","0","40.54","18.38"
"10","009","00","018","1821","0000","356","210","146","33","389","1058","0","36.77","19.85"
"10","009","00","018","1821","0176","356","210","146","33","389","1058","0","36.77","19.85"
"10","009","00","019","0000","0000","10875","5904","4971","824","11699","24193","27383","48.36","24.4"
"10","009","00","019","1901","0000","602","292","310","64","666","1225","0","54.37","23.84"
"10","009","00","019","1901","0206","602","292","310","64","666","1225","0","54.37","23.84"
"10","009","00","019","1902","0000","400","128","272","47","447","1134","0","39.42","11.29"
"10","009","00","019","1902","0205","400","128","272","47","447","1134","0","39.42","11.29"
"10","009","00","019","1903","0000","251","109","142","33","284","647","0","43.89","16.85"
"10","009","00","019","1903","0207","251","109","142","33","284","647","0","43.89","16.85"
"10","009","00","019","1904","0000","394","228","166","39","433","900","0","48.11","25.33"
"10","009","00","019","1904","0209","394","228","166","39","433","900","0","48.11","25.33"
"10","009","00","019","1905","0000","350","196","154","19","369","709","0","52.05","27.64"
"10","009","00","019","1905","0208","350","196","154","19","369","709","0","52.05","27.64"
"10","009","00","019","1906","0000","465","269","196","41","506","1011","0","50.05","26.61"
"10","009","00","019","1906","0210","465","269","196","41","506","1011","0","50.05","26.61"
"10","009","00","019","1907","0000","593","330","263","28","621","1437","0","43.22","22.96"
"10","009","00","019","1907","0211","593","330","263","28","621","1437","0","43.22","22.96"
"10","009","00","019","1908","0000","763","414","349","35","798","2041","0","39.1","20.28"
"10","009","00","019","1908","0212","287","180","107","7","294","848","0","34.67","21.23"
"10","009","00","019","1908","0213","476","234","242","28","504","1193","0","42.25","19.61"
"10","009","00","019","1909","0000","619","316","303","44","663","1574","0","42.12","20.08"
"10","009","00","019","1909","0214","274","149","125","18","292","759","0","38.47","19.63"
"10","009","00","019","1909","0215","345","167","178","26","371","815","0","45.52","20.49"
"10","009","00","019","1910","0000","670","348","322","59","729","1460","0","49.93","23.84"
"10","009","00","019","1910","0216","670","348","322","59","729","1460","0","49.93","23.84"
"10","009","00","019","1911","0000","216","136","80","6","222","556","0","39.93","24.46"
"10","009","00","019","1911","0217","216","136","80","6","222","556","0","39.93","24.46"
"10","009","00","019","1912","0000","673","340","333","44","717","1532","0","46.8","22.19"
"10","009","00","019","1912","0218","673","340","333","44","717","1532","0","46.8","22.19"
"10","009","00","019","1913","0000","397","195","202","15","412","847","0","48.64","23.02"
"10","009","00","019","1913","0219","397","195","202","15","412","847","0","48.64","23.02"
"10","009","00","019","1914","0000","954","632","322","77","1031","1882","0","54.78","33.58"
"10","009","00","019","1914","0220","168","106","62","14","182","374","0","48.66","28.34"
"10","009","00","019","1914","0221","786","526","260","63","849","1508","0","56.3","34.88"
"10","009","00","019","1915","0000","493","249","244","40","533","951","0","56.05","26.18"
"10","009","00","019","1915","0222","493","249","244","40","533","951","0","56.05","26.18"
"10","009","00","019","1916","0000","420","245","175","17","437","1006","0","43.44","24.35"
"10","009","00","019","1916","0228","420","245","175","17","437","1006","0","43.44","24.35"
"10","009","00","019","1917","0000","467","222","245","43","510","952","0","53.57","23.32"
"10","009","00","019","1917","0226","467","222","245","43","510","952","0","53.57","23.32"
"10","009","00","019","1918","0000","364","220","144","28","392","720","0","54.44","30.56"
"10","009","00","019","1918","0227","364","220","144","28","392","720","0","54.44","30.56"
"10","009","00","019","1919","0000","962","523","439","87","1049","1789","0","58.64","29.23"
"10","009","00","019","1919","0223","478","303","175","55","533","910","0","58.57","33.3"
"10","009","00","019","1919","0224","484","220","264","32","516","879","0","58.7","25.03"
"10","009","00","019","1920","0000","564","373","191","45","609","1213","0","50.21","30.75"
"10","009","00","019","1920","0225","564","373","191","45","609","1213","0","50.21","30.75"
"10","009","00","019","1921","0000","258","139","119","13","271","607","0","44.65","22.9"
"10","009","00","019","1921","0229","258","139","119","13","271","607","0","44.65","22.9"
"10","009","00","020","0000","0000","9538","5439","4099","615","10153","22508","25426","45.11","24.16"
"10","009","00","020","2001","0000","1015","571","444","42","1057","2242","0","47.15","25.47"
"10","009","00","020","2001","0230","585","351","234","27","612","1355","0","45.17","25.9"
"10","009","00","020","2001","0231","430","220","210","15","445","887","0","50.17","24.8"
"10","009","00","020","2002","0000","1018","526","492","51","1069","1997","0","53.53","26.34"
"10","009","00","020","2002","0232","651","324","327","36","687","1234","0","55.67","26.26"
"10","009","00","020","2002","0233","367","202","165","15","382","763","0","50.07","26.47"
"10","009","00","020","2003","0000","461","261","200","42","503","1022","0","49.22","25.54"
"10","009","00","020","2003","0253","461","261","200","42","503","1022","0","49.22","25.54"
"10","009","00","020","2004","0000","501","270","231","30","531","1191","0","44.58","22.67"
"10","009","00","020","2004","0254","501","270","231","30","531","1191","0","44.58","22.67"
"10","009","00","020","2005","0000","462","269","193","43","505","1006","0","50.2","26.74"
"10","009","00","020","2005","0240","462","269","193","43","505","1006","0","50.2","26.74"
"10","009","00","020","2006","0000","269","132","137","10","279","651","0","42.86","20.28"
"10","009","00","020","2006","0241","269","132","137","10","279","651","0","42.86","20.28"
"10","009","00","020","2007","0000","244","135","109","11","255","607","0","42.01","22.24"
"10","009","00","020","2007","0242","244","135","109","11","255","607","0","42.01","22.24"
"10","009","00","020","2008","0000","402","222","180","36","438","1033","0","42.4","21.49"
"10","009","00","020","2008","0243","402","222","180","36","438","1033","0","42.4","21.49"
"10","009","00","020","2009","0000","202","104","98","12","214","631","0","33.91","16.48"
"10","009","00","020","2009","0244","202","104","98","12","214","631","0","33.91","16.48"
"10","009","00","020","2010","0000","393","243","150","25","418","961","0","43.5","25.29"
"10","009","00","020","2010","0245","393","243","150","25","418","961","0","43.5","25.29"
"10","009","00","020","2011","0000","290","191","99","26","316","721","0","43.83","26.49"
"10","009","00","020","2011","0234","290","191","99","26","316","721","0","43.83","26.49"
"10","009","00","020","2012","0000","250","133","117","11","261","647","0","40.34","20.56"
"10","009","00","020","2012","0235","250","133","117","11","261","647","0","40.34","20.56"
"10","009","00","020","2013","0000","441","264","177","13","454","1081","0","42.0","24.42"
"10","009","00","020","2013","0238","441","264","177","13","454","1081","0","42.0","24.42"
"10","009","00","020","2014","0000","414","226","188","34","448","989","0","45.3","22.85"
"10","009","00","020","2014","0236","414","226","188","34","448","989","0","45.3","22.85"
"10","009","00","020","2015","0000","345","214","131","16","361","837","0","43.13","25.57"
"10","009","00","020","2015","0237","345","214","131","16","361","837","0","43.13","25.57"
"10","009","00","020","2016","0000","398","231","167","35","433","951","0","45.53","24.29"
"10","009","00","020","2016","0246","398","231","167","35","433","951","0","45.53","24.29"
"10","009","00","020","2017","0000","357","230","127","18","375","838","0","44.75","27.45"
"10","009","00","020","2017","0247","357","230","127","18","375","838","0","44.75","27.45"
"10","009","00","020","2018","0000","456","255","201","49","505","1055","0","47.87","24.17"
"10","009","00","020","2018","0248","456","255","201","49","505","1055","0","47.87","24.17"
"10","009","00","020","2019","0000","188","116","72","11","199","512","0","38.87","22.66"
"10","009","00","020","2019","0249","188","116","72","11","199","512","0","38.87","22.66"
"10","009","00","020","2020","0000","260","164","96","13","273","671","0","40.69","24.44"
"10","009","00","020","2020","0250","260","164","96","13","273","671","0","40.69","24.44"
"10","009","00","020","2021","0000","211","139","72","14","225","693","0","32.47","20.06"
"10","009","00","020","2021","0251","211","139","72","14","225","693","0","32.47","20.06"
"10","009","00","020","2022","0000","236","145","91","17","253","689","0","36.72","21.04"
"10","009","00","020","2022","0252","236","145","91","17","253","689","0","36.72","21.04"
"10","009","00","020","2023","0000","334","196","138","18","352","704","0","50.0","27.84"
"10","009","00","020","2023","0239","334","196","138","18","352","704","0","50.0","27.84"
"10","009","00","020","2024","0000","391","202","189","38","429","779","0","55.07","25.93"
"10","009","00","020","2024","0255","391","202","189","38","429","779","0","55.07","25.93"
"10","010","00","000","0000","0000","214823","110830","103993","13483","228306","442775","507780","51.56","25.03"
"10","010","00","001","0000","0000","16231","8074","8157","833","17064","31568","38048","54.05","25.58"
"10","010","00","001","0101","0000","1200","567","633","77","1277","2286","0","55.86","24.8"
"10","010","00","001","0101","0001","633","307","326","50","683","1210","0","56.45","25.37"
"10","010","00","001","0101","0002","567","260","307","27","594","1076","0","55.2","24.16"
"10","010","00","001","0102","0000","239","139","100","15","254","488","0","52.05","28.48"
"10","010","00","001","0102","0003","239","139","100","15","254","488","0","52.05","28.48"
"10","010","00","001","0103","0000","733","411","322","41","774","1475","0","52.47","27.86"
"10","010","00","001","0103","0004","733","411","322","41","774","1475","0","52.47","27.86"
"10","010","00","001","0104","0000","799","380","419","31","830","1673","0","49.61","22.71"
"10","010","00","001","0104","0005","380","179","201","7","387","790","0","48.99","22.66"
"10","010","00","001","0104","0006","419","201","218","24","443","883","0","50.17","22.76"
"10","010","00","001","0105","0000","535","262","273","34","569","1147","0","49.61","22.84"
"10","010","00","001","0105","0007","372","174","198","30","402","758","0","53.03","22.96"
"10","010","00","001","0105","0008","163","88","75","4","167","389","0","42.93","22.62"
"10","010","00","001","0106","0000","487","255","232","33","520","1101","0","47.23","23.16"
"10","010","00","001","0106","0009","487","255","232","33","520","1101","0","47.23","23.16"
"10","010","00","001","0107","0000","431","177","254","11","442","853","0","51.82","20.75"
"10","010","00","001","0107","0010","431","177","254","11","442","853","0","51.82","20.75"
"10","010","00","001","0108","0000","873","420","453","24","897","1692","0","53.01","24.82"
"10","010","00","001","0108","0014","448","227","221","15","463","913","0","50.71","24.86"
"10","010","00","001","0108","0015","425","193","232","9","434","779","0","55.71","24.78"
"10","010","00","001","0109","0000","652","150","502","58","710","1278","0","55.56","11.74"
"10","010","00","001","0109","0016","652","150","502","58","710","1278","0","55.56","11.74"
"10","010","00","001","0110","0000","1178","570","608","48","1226","2392","0","51.25","23.83"
"10","010","00","001","0110","0017","393","202","191","20","413","819","0","50.43","24.66"
"10","010","00","001","0110","0018","785","368","417","28","813","1573","0","51.68","23.39"
"10","010","00","001","0111","0000","398","201","197","18","416","726","0","57.3","27.69"
"10","010","00","001","0111","0019","251","127","124","14","265","481","0","55.09","26.4"
"10","010","00","001","0111","0020","147","74","73","4","151","245","0","61.63","30.2"
"10","010","00","001","0112","0000","316","179","137","13","329","575","0","57.22","31.13"
"10","010","00","001","0112","0021","178","106","72","10","188","317","0","59.31","33.44"
"10","010","00","001","0112","0022","138","73","65","3","141","258","0","54.65","28.29"
"10","010","00","001","0113","0000","1829","969","860","76","1905","3333","0","57.16","29.07"
"10","010","00","001","0113","0023","296","153","143","37","333","611","0","54.5","25.04"
"10","010","00","001","0113","0024","868","475","393","26","894","1526","0","58.58","31.13"
"10","010","00","001","0113","0025","665","341","324","13","678","1196","0","56.69","28.51"
"10","010","00","001","0114","0000","2332","1217","1115","137","2469","4467","0","55.27","27.24"
"10","010","00","001","0114","0026","789","437","352","52","841","1536","0","54.75","28.45"
"10","010","00","001","0114","0027","789","398","391","41","830","1481","0","56.04","26.87"
"10","010","00","001","0114","0028","754","382","372","44","798","1450","0","55.03","26.34"
"10","010","00","001","0115","0000","970","546","424","30","1000","1829","0","54.67","29.85"
"10","010","00","001","0115","0029","427","233","194","16","443","840","0","52.74","27.74"
"10","010","00","001","0115","0030","543","313","230","14","557","989","0","56.32","31.65"
"10","010","00","001","0116","0000","1601","847","754","105","1706","3040","0","56.12","27.86"
"10","010","00","001","0116","0031","791","424","367","57","848","1529","0","55.46","27.73"
"10","010","00","001","0116","0032","810","423","387","48","858","1511","0","56.78","27.99"
"10","010","00","001","0117","0000","323","185","138","30","353","697","0","50.65","26.54"
"10","010","00","001","0117","0033","323","185","138","30","353","697","0","50.65","26.54"
"10","010","00","001","0118","0000","1335","599","736","52","1387","2516","0","55.13","23.81"
"10","010","00","001","0118","0011","88","53","35","5","93","224","0","41.52","23.66"
"10","010","00","001","0118","0012","302","158","144","20","322","662","0","48.64","23.87"
"10","010","00","001","0118","0013","945","388","557","27","972","1630","0","59.63","23.8"
"10","010","00","002","0000","0000","17473","8989","8484","1049","18522","35191","42143","52.63","25.54"
"10","010","00","002","0201","0000","1007","484","523","56","1063","1938","0","54.85","24.97"
"10","010","00","002","0201","0233","615","269","346","32","647","1183","0","54.69","22.74"
"10","010","00","002","0201","0234","392","215","177","24","416","755","0","55.1","28.48"
"10","010","00","002","0202","0000","1262","577","685","74","1336","2331","0","57.31","24.75"
"10","010","00","002","0202","0235","652","297","355","30","682","1253","0","54.43","23.7"
"10","010","00","002","0202","0236","610","280","330","44","654","1078","0","60.67","25.97"
"10","010","00","002","0203","0000","640","347","293","45","685","1117","0","61.32","31.07"
"10","010","00","002","0203","0237","640","347","293","45","685","1117","0","61.32","31.07"
"10","010","00","002","0204","0000","221","124","97","15","236","387","0","60.98","32.04"
"10","010","00","002","0204","0238","221","124","97","15","236","387","0","60.98","32.04"
"10","010","00","002","0205","0000","339","188","151","20","359","633","0","56.71","29.7"
"10","010","00","002","0205","0239","339","188","151","20","359","633","0","56.71","29.7"
"10","010","00","002","0206","0000","346","191","155","21","367","650","0","56.46","29.38"
"10","010","00","002","0206","0240","346","191","155","21","367","650","0","56.46","29.38"
"10","010","00","002","0207","0000","494","236","258","31","525","825","0","63.64","28.61"
"10","010","00","002","0207","0241","494","236","258","31","525","825","0","63.64","28.61"
"10","010","00","002","0208","0000","941","455","486","66","1007","1750","0","57.54","26.0"
"10","010","00","002","0208","0242","429","218","211","26","455","810","0","56.17","26.91"
"10","010","00","002","0208","0243","512","237","275","40","552","940","0","58.72","25.21"
"10","010","00","002","0209","0000","1206","644","562","57","1263","2510","0","50.32","25.66"
"10","010","00","002","0209","0244","466","241","225","29","495","905","0","54.7","26.63"
"10","010","00","002","0209","0245","740","403","337","28","768","1605","0","47.85","25.11"
"10","010","00","002","0210","0000","2312","1139","1173","113","2425","4193","0","57.83","27.16"
"10","010","00","002","0210","0246","816","408","408","35","851","1479","0","57.54","27.59"
"10","010","00","002","0210","0247","680","348","332","34","714","1218","0","58.62","28.57"
"10","010","00","002","0210","0248","816","383","433","44","860","1496","0","57.49","25.6"
"10","010","00","002","0211","0000","369","192","177","26","395","667","0","59.22","28.79"
"10","010","00","002","0211","0249","369","192","177","26","395","667","0","59.22","28.79"
"10","010","00","002","0212","0000","238","119","119","15","253","627","0","40.35","18.98"
"10","010","00","002","0212","0250","238","119","119","15","253","627","0","40.35","18.98"
"10","010","00","002","0213","0000","379","186","193","21","400","791","0","50.57","23.51"
"10","010","00","002","0213","0251","379","186","193","21","400","791","0","50.57","23.51"
"10","010","00","002","0214","0000","526","290","236","47","573","1034","0","55.42","28.05"
"10","010","00","002","0214","0252","526","290","236","47","573","1034","0","55.42","28.05"
"10","010","00","002","0215","0000","811","415","396","25","836","1710","0","48.89","24.27"
"10","010","00","002","0215","0253","811","415","396","25","836","1710","0","48.89","24.27"
"10","010","00","002","0216","0000","1455","716","739","77","1532","3218","0","47.61","22.25"
"10","010","00","002","0216","0254","787","373","414","35","822","1671","0","49.19","22.32"
"10","010","00","002","0216","0255","668","343","325","42","710","1547","0","45.9","22.17"
"10","010","00","002","0217","0000","1342","627","715","66","1408","2904","0","48.48","21.59"
"10","010","00","002","0217","0256","625","313","312","43","668","1602","0","41.7","19.54"
"10","010","00","002","0217","0257","717","314","403","23","740","1302","0","56.84","24.12"
"10","010","00","002","0218","0000","350","174","176","28","378","740","0","51.08","23.51"
"10","010","00","002","0218","0258","350","174","176","28","378","740","0","51.08","23.51"
"10","010","00","002","0219","0000","580","305","275","44","624","1054","0","59.2","28.94"
"10","010","00","002","0219","0259","580","305","275","44","624","1054","0","59.2","28.94"
"10","010","00","002","0220","0000","390","218","172","13","403","907","0","44.43","24.04"
"10","010","00","002","0220","0260","390","218","172","13","403","907","0","44.43","24.04"
"10","010","00","002","0221","0000","136","84","52","14","150","251","0","59.76","33.47"
"10","010","00","002","0221","0262","136","84","52","14","150","251","0","59.76","33.47"
"10","010","00","002","0222","0000","304","203","101","20","324","720","0","45.0","28.19"
"10","010","00","002","0222","0261","304","203","101","20","324","720","0","45.0","28.19"
"10","010","00","002","0223","0000","294","180","114","44","338","767","0","44.07","23.47"
"10","010","00","002","0223","0263","294","180","114","44","338","767","0","44.07","23.47"
"10","010","00","002","0224","0000","364","184","180","29","393","702","0","55.98","26.21"
"10","010","00","002","0224","0264","364","184","180","29","393","702","0","55.98","26.21"
"10","010","00","002","0225","0000","458","268","190","45","503","1038","0","48.46","25.82"
"10","010","00","002","0225","0265","458","268","190","45","503","1038","0","48.46","25.82"
"10","010","00","002","0226","0000","470","297","173","19","489","1228","0","39.82","24.19"
"10","010","00","002","0226","0266","470","297","173","19","489","1228","0","39.82","24.19"
"10","010","00","002","0227","0000","239","146","93","18","257","499","0","51.5","29.26"
"10","010","00","002","0227","0267","239","146","93","18","257","499","0","51.5","29.26"
"10","010","00","003","0000","0000","11194","5637","5557","756","11950","23965","26846","49.86","23.52"
"10","010","00","003","0301","0000","281","141","140","25","306","614","0","49.84","22.96"
"10","010","00","003","0301","0325","281","141","140","25","306","614","0","49.84","22.96"
"10","010","00","003","0302","0000","158","78","80","12","170","372","0","45.7","20.97"
"10","010","00","003","0302","0326","158","78","80","12","170","372","0","45.7","20.97"
"10","010","00","003","0303","0000","1060","524","536","100","1160","2112","0","54.92","24.81"
"10","010","00","003","0303","0327","468","211","257","46","514","914","0","56.24","23.09"
"10","010","00","003","0303","0328","592","313","279","54","646","1198","0","53.92","26.13"
"10","010","00","003","0304","0000","491","244","247","38","529","1113","0","47.53","21.92"
"10","010","00","003","0304","0329","491","244","247","38","529","1113","0","47.53","21.92"
"10","010","00","003","0305","0000","863","435","428","51","914","1681","0","54.37","25.88"
"10","010","00","003","0305","0330","511","266","245","40","551","992","0","55.54","26.81"
"10","010","00","003","0305","0331","352","169","183","11","363","689","0","52.69","24.53"
"10","010","00","003","0306","0000","431","218","213","44","475","882","0","53.85","24.72"
"10","010","00","003","0306","0332","431","218","213","44","475","882","0","53.85","24.72"
"10","010","00","003","0307","0000","357","148","209","28","385","731","0","52.67","20.25"
"10","010","00","003","0307","0333","357","148","209","28","385","731","0","52.67","20.25"
"10","010","00","003","0308","0000","408","154","254","24","432","779","0","55.46","19.77"
"10","010","00","003","0308","0334","408","154","254","24","432","779","0","55.46","19.77"
"10","010","00","003","0309","0000","435","232","203","24","459","953","0","48.16","24.34"
"10","010","00","003","0309","0349","435","232","203","24","459","953","0","48.16","24.34"
"10","010","00","003","0310","0000","660","360","300","38","698","1292","0","54.02","27.86"
"10","010","00","003","0310","0350","660","360","300","38","698","1292","0","54.02","27.86"
"10","010","00","003","0311","0000","1169","558","611","58","1227","2371","0","51.75","23.53"
"10","010","00","003","0311","0351","565","267","298","40","605","1127","0","53.68","23.69"
"10","010","00","003","0311","0352","604","291","313","18","622","1244","0","50.0","23.39"
"10","010","00","003","0312","0000","502","237","265","21","523","1106","0","47.29","21.43"
"10","010","00","003","0312","0353","502","237","265","21","523","1106","0","47.29","21.43"
"10","010","00","003","0313","0000","533","224","309","25","558","1145","0","48.73","19.56"
"10","010","00","003","0313","0342","533","224","309","25","558","1145","0","48.73","19.56"
"10","010","00","003","0314","0000","864","445","419","49","913","1894","0","48.2","23.5"
"10","010","00","003","0314","0343","435","223","212","21","456","936","0","48.72","23.82"
"10","010","00","003","0314","0344","429","222","207","28","457","958","0","47.7","23.17"
"10","010","00","003","0315","0000","139","77","62","9","148","298","0","49.66","25.84"
"10","010","00","003","0315","0345","139","77","62","9","148","298","0","49.66","25.84"
"10","010","00","003","0316","0000","233","115","118","21","254","428","0","59.35","26.87"
"10","010","00","003","0316","0346","233","115","118","21","254","428","0","59.35","26.87"
"10","010","00","003","0317","0000","111","51","60","6","117","295","0","39.66","17.29"
"10","010","00","003","0317","0347","52","23","29","4","56","121","0","46.28","19.01"
"10","010","00","003","0317","0348","59","28","31","2","61","174","0","35.06","16.09"
"10","010","00","003","0318","0000","315","129","186","27","342","762","0","44.88","16.93"
"10","010","00","003","0318","0335","315","129","186","27","342","762","0","44.88","16.93"
"10","010","00","003","0319","0000","528","297","231","31","559","1184","0","47.21","25.08"
"10","010","00","003","0319","0336","528","297","231","31","559","1184","0","47.21","25.08"
"10","010","00","003","0320","0000","556","319","237","26","582","1351","0","43.08","23.61"
"10","010","00","003","0320","0338","556","319","237","26","582","1351","0","43.08","23.61"
"10","010","00","003","0321","0000","549","323","226","33","582","1423","0","40.9","22.7"
"10","010","00","003","0321","0337","549","323","226","33","582","1423","0","40.9","22.7"
"10","010","00","003","0322","0000","239","141","98","15","254","518","0","49.03","27.22"
"10","010","00","003","0322","0339","137","78","59","3","140","275","0","50.91","28.36"
"10","010","00","003","0322","0340","102","63","39","12","114","243","0","46.91","25.93"
"10","010","00","003","0323","0000","312","187","125","51","363","661","0","54.92","28.29"
"10","010","00","003","0323","0341","312","187","125","51","363","661","0","54.92","28.29"
"10","010","00","004","0000","0000","13438","6763","6675","784","14222","26922","30954","52.83","25.12"
"10","010","00","004","0401","0000","262","144","118","11","273","483","0","56.52","29.81"
"10","010","00","004","0401","0169","262","144","118","11","273","483","0","56.52","29.81"
"10","010","00","004","0402","0000","1002","510","492","34","1036","1823","0","56.83","27.98"
"10","010","00","004","0402","0170","1002","510","492","34","1036","1823","0","56.83","27.98"
"10","010","00","004","0403","0000","530","252","278","17","547","955","0","57.28","26.39"
"10","010","00","004","0403","0171","530","252","278","17","547","955","0","57.28","26.39"
"10","010","00","004","0404","0000","3106","1507","1599","182","3288","5874","0","55.98","25.66"
"10","010","00","004","0404","0172","727","365","362","34","761","1436","0","52.99","25.42"
"10","010","00","004","0404","0173","736","359","377","54","790","1390","0","56.83","25.83"
"10","010","00","004","0404","0174","806","412","394","56","862","1512","0","57.01","27.25"
"10","010","00","004","0404","0175","837","371","466","38","875","1536","0","56.97","24.15"
"10","010","00","004","0405","0000","555","258","297","33","588","1165","0","50.47","22.15"
"10","010","00","004","0405","0176","555","258","297","33","588","1165","0","50.47","22.15"
"10","010","00","004","0406","0000","974","471","503","58","1032","1730","0","59.65","27.23"
"10","010","00","004","0406","0177","974","471","503","58","1032","1730","0","59.65","27.23"
"10","010","00","004","0407","0000","275","161","114","14","289","602","0","48.01","26.74"
"10","010","00","004","0407","0178","275","161","114","14","289","602","0","48.01","26.74"
"10","010","00","004","0408","0000","339","197","142","24","363","716","0","50.7","27.51"
"10","010","00","004","0408","0179","339","197","142","24","363","716","0","50.7","27.51"
"10","010","00","004","0409","0000","256","172","84","12","268","625","0","42.88","27.52"
"10","010","00","004","0409","0180","256","172","84","12","268","625","0","42.88","27.52"
"10","010","00","004","0410","0000","72","29","43","3","75","193","0","38.86","15.03"
"10","010","00","004","0410","0181","72","29","43","3","75","193","0","38.86","15.03"
"10","010","00","004","0411","0000","728","374","354","45","773","1642","0","47.08","22.78"
"10","010","00","004","0411","0182","728","374","354","45","773","1642","0","47.08","22.78"
"10","010","00","004","0412","0000","729","365","364","44","773","1465","0","52.76","24.91"
"10","010","00","004","0412","0183","729","365","364","44","773","1465","0","52.76","24.91"
"10","010","00","004","0413","0000","531","287","244","47","578","1289","0","44.84","22.27"
"10","010","00","004","0413","0184","381","196","185","35","416","928","0","44.83","21.12"
"10","010","00","004","0413","0185","150","91","59","12","162","361","0","44.88","25.21"
"10","010","00","004","0414","0000","383","190","193","17","400","814","0","49.14","23.34"
"10","010","00","004","0414","0186","383","190","193","17","400","814","0","49.14","23.34"
"10","010","00","004","0415","0000","757","413","344","20","777","1579","0","49.21","26.16"
"10","010","00","004","0415","0187","757","413","344","20","777","1579","0","49.21","26.16"
"10","010","00","004","0416","0000","1005","492","513","59","1064","2041","0","52.13","24.11"
"10","010","00","004","0416","0188","1005","492","513","59","1064","2041","0","52.13","24.11"
"10","010","00","004","0417","0000","443","238","205","35","478","931","0","51.34","25.56"
"10","010","00","004","0417","0189","443","238","205","35","478","931","0","51.34","25.56"
"10","010","00","004","0418","0000","328","167","161","32","360","675","0","53.33","24.74"
"10","010","00","004","0418","0190","328","167","161","32","360","675","0","53.33","24.74"
"10","010","00","004","0419","0000","309","145","164","29","338","655","0","51.6","22.14"
"10","010","00","004","0419","0191","309","145","164","29","338","655","0","51.6","22.14"
"10","010","00","004","0420","0000","390","173","217","30","420","833","0","50.42","20.77"
"10","010","00","004","0420","0192","390","173","217","30","420","833","0","50.42","20.77"
"10","010","00","004","0421","0000","464","218","246","38","502","832","0","60.34","26.2"
"10","010","00","004","0421","0193","464","218","246","38","502","832","0","60.34","26.2"
"10","010","00","005","0000","0000","31106","16033","15073","1892","32998","61209","71327","53.91","26.19"
"10","010","00","005","0501","0000","1218","578","640","60","1278","2297","0","55.64","25.16"
"10","010","00","005","0501","0093","715","339","376","34","749","1267","0","59.12","26.76"
"10","010","00","005","0501","0094","503","239","264","26","529","1030","0","51.36","23.2"
"10","010","00","005","0502","0000","891","423","468","65","956","1590","0","60.13","26.6"
"10","010","00","005","0502","0095","891","423","468","65","956","1590","0","60.13","26.6"
"10","010","00","005","0503","0000","1793","938","855","67","1860","3391","0","54.85","27.66"
"10","010","00","005","0503","0096","848","429","419","24","872","1673","0","52.12","25.64"
"10","010","00","005","0503","0097","945","509","436","43","988","1718","0","57.51","29.63"
"10","010","00","005","0504","0000","1128","594","534","89","1217","2140","0","56.87","27.76"
"10","010","00","005","0504","0098","580","319","261","42","622","1040","0","59.81","30.67"
"10","010","00","005","0504","0099","548","275","273","47","595","1100","0","54.09","25.0"
"10","010","00","005","0505","0000","773","446","327","38","811","1559","0","52.02","28.61"
"10","010","00","005","0505","0100","773","446","327","38","811","1559","0","52.02","28.61"
"10","010","00","005","0506","0000","888","429","459","63","951","1862","0","51.07","23.04"
"10","010","00","005","0506","0101","888","429","459","63","951","1862","0","51.07","23.04"
"10","010","00","005","0507","0000","760","390","370","48","808","1435","0","56.31","27.18"
"10","010","00","005","0507","0102","760","390","370","48","808","1435","0","56.31","27.18"
"10","010","00","005","0508","0000","843","500","343","82","925","1751","0","52.83","28.56"
"10","010","00","005","0508","0103","843","500","343","82","925","1751","0","52.83","28.56"
"10","010","00","005","0509","0000","491","247","244","43","534","933","0","57.23","26.47"
"10","010","00","005","0509","0104","491","247","244","43","534","933","0","57.23","26.47"
"10","010","00","005","0510","0000","486","272","214","31","517","827","0","62.52","32.89"
"10","010","00","005","0510","0105","486","272","214","31","517","827","0","62.52","32.89"
"10","010","00","005","0511","0000","420","267","153","22","442","843","0","52.43","31.67"
"10","010","00","005","0511","0106","420","267","153","22","442","843","0","52.43","31.67"
"10","010","00","005","0512","0000","1064","499","565","58","1122","2159","0","51.97","23.11"
"10","010","00","005","0512","0107","889","421","468","49","938","1774","0","52.87","23.73"
"10","010","00","005","0512","0108","175","78","97","9","184","385","0","47.79","20.26"
"10","010","00","005","0513","0000","739","353","386","36","775","1306","0","59.34","27.03"
"10","010","00","005","0513","0109","739","353","386","36","775","1306","0","59.34","27.03"
"10","010","00","005","0514","0000","293","169","124","27","320","535","0","59.81","31.59"
"10","010","00","005","0514","0110","293","169","124","27","320","535","0","59.81","31.59"
"10","010","00","005","0515","0000","575","326","249","46","621","1055","0","58.86","30.9"
"10","010","00","005","0515","0111","575","326","249","46","621","1055","0","58.86","30.9"
"10","010","00","005","0516","0000","908","483","425","61","969","1875","0","51.68","25.76"
"10","010","00","005","0516","0127","908","483","425","61","969","1875","0","51.68","25.76"
"10","010","00","005","0517","0000","1402","707","695","83","1485","2746","0","54.08","25.75"
"10","010","00","005","0517","0128","698","350","348","34","732","1305","0","56.09","26.82"
"10","010","00","005","0517","0129","704","357","347","49","753","1441","0","52.26","24.77"
"10","010","00","005","0518","0000","1059","590","469","62","1121","2004","0","55.94","29.44"
"10","010","00","005","0518","0132","1059","590","469","62","1121","2004","0","55.94","29.44"
"10","010","00","005","0519","0000","1233","546","687","74","1307","2430","0","53.79","22.47"
"10","010","00","005","0519","0133","663","276","387","45","708","1354","0","52.29","20.38"
"10","010","00","005","0519","0134","570","270","300","29","599","1076","0","55.67","25.09"
"10","010","00","005","0520","0000","1805","1002","803","133","1938","3606","0","53.74","27.79"
"10","010","00","005","0520","0135","844","516","328","87","931","1629","0","57.15","31.68"
"10","010","00","005","0520","0136","961","486","475","46","1007","1977","0","50.94","24.58"
"10","010","00","005","0521","0000","654","370","284","52","706","1295","0","54.52","28.57"
"10","010","00","005","0521","0137","654","370","284","52","706","1295","0","54.52","28.57"
"10","010","00","005","0522","0000","2504","1281","1223","144","2648","5171","0","51.21","24.77"
"10","010","00","005","0522","0112","770","402","368","38","808","1476","0","54.74","27.24"
"10","010","00","005","0522","0113","759","369","390","41","800","1583","0","50.54","23.31"
"10","010","00","005","0522","0114","339","177","162","25","364","758","0","48.02","23.35"
"10","010","00","005","0522","0115","636","333","303","40","676","1354","0","49.93","24.59"
"10","010","00","005","0523","0000","1267","581","686","81","1348","2377","0","56.71","24.44"
"10","010","00","005","0523","0116","657","289","368","41","698","1202","0","58.07","24.04"
"10","010","00","005","0523","0117","610","292","318","40","650","1175","0","55.32","24.85"
"10","010","00","005","0524","0000","1127","585","542","84","1211","2371","0","51.08","24.67"
"10","010","00","005","0524","0122","463","258","205","40","503","1019","0","49.36","25.32"
"10","010","00","005","0524","0123","664","327","337","44","708","1352","0","52.37","24.19"
"10","010","00","005","0525","0000","1316","698","618","64","1380","2563","0","53.84","27.23"
"10","010","00","005","0525","0124","858","470","388","48","906","1620","0","55.93","29.01"
"10","010","00","005","0525","0125","458","228","230","16","474","943","0","50.27","24.18"
"10","010","00","005","0526","0000","763","388","375","45","808","1720","0","46.98","22.56"
"10","010","00","005","0526","0126","763","388","375","45","808","1720","0","46.98","22.56"
"10","010","00","005","0527","0000","1523","825","698","94","1617","2973","0","54.39","27.75"
"10","010","00","005","0527","0130","738","405","333","46","784","1413","0","55.48","28.66"
"10","010","00","005","0527","0131","785","420","365","48","833","1560","0","53.4","26.92"
"10","010","00","005","0528","0000","3183","1546","1637","140","3323","6395","0","51.96","24.18"
"10","010","00","005","0528","0118","689","327","362","38","727","1423","0","51.09","22.98"
"10","010","00","005","0528","0119","815","357","458","37","852","1612","0","52.85","22.15"
"10","010","00","005","0528","0120","917","463","454","25","942","1695","0","55.58","27.32"
"10","010","00","005","0528","0121","762","399","363","40","802","1665","0","48.17","23.96"
"10","010","00","006","0000","0000","6470","3716","2754","430","6900","13105","14670","52.65","28.36"
"10","010","00","006","0601","0000","705","387","318","62","767","1318","0","58.19","29.36"
"10","010","00","006","0601","0194","705","387","318","62","767","1318","0","58.19","29.36"
"10","010","00","006","0602","0000","371","194","177","29","400","677","0","59.08","28.66"
"10","010","00","006","0602","0195","371","194","177","29","400","677","0","59.08","28.66"
"10","010","00","006","0603","0000","361","209","152","21","382","690","0","55.36","30.29"
"10","010","00","006","0603","0196","210","123","87","9","219","417","0","52.52","29.5"
"10","010","00","006","0603","0197","151","86","65","12","163","273","0","59.71","31.5"
"10","010","00","006","0604","0000","448","251","197","24","472","1003","0","47.06","25.02"
"10","010","00","006","0604","0210","448","251","197","24","472","1003","0","47.06","25.02"
"10","010","00","006","0605","0000","304","177","127","21","325","701","0","46.36","25.25"
"10","010","00","006","0605","0209","304","177","127","21","325","701","0","46.36","25.25"
"10","010","00","006","0606","0000","424","259","165","14","438","786","0","55.73","32.95"
"10","010","00","006","0606","0203","424","259","165","14","438","786","0","55.73","32.95"
"10","010","00","006","0607","0000","361","211","150","38","399","807","0","49.44","26.15"
"10","010","00","006","0607","0204","361","211","150","38","399","807","0","49.44","26.15"
"10","010","00","006","0608","0000","498","305","193","12","510","1168","0","43.66","26.11"
"10","010","00","006","0608","0205","498","305","193","12","510","1168","0","43.66","26.11"
"10","010","00","006","0609","0000","548","332","216","50","598","1052","0","56.84","31.56"
"10","010","00","006","0609","0206","548","332","216","50","598","1052","0","56.84","31.56"
"10","010","00","006","0610","0000","459","256","203","45","504","953","0","52.89","26.86"
"10","010","00","006","0610","0207","262","163","99","25","287","565","0","50.8","28.85"
"10","010","00","006","0610","0208","197","93","104","20","217","388","0","55.93","23.97"
"10","010","00","006","0611","0000","667","370","297","49","716","1294","0","55.33","28.59"
"10","010","00","006","0611","0198","496","268","228","40","536","908","0","59.03","29.52"
"10","010","00","006","0611","0199","171","102","69","9","180","386","0","46.63","26.42"
"10","010","00","006","0612","0000","551","316","235","27","578","1039","0","55.63","30.41"
"10","010","00","006","0612","0200","551","316","235","27","578","1039","0","55.63","30.41"
"10","010","00","006","0613","0000","311","185","126","26","337","708","0","47.6","26.13"
"10","010","00","006","0613","0201","311","185","126","26","337","708","0","47.6","26.13"
"10","010","00","006","0614","0000","462","264","198","12","474","909","0","52.15","29.04"
"10","010","00","006","0614","0202","462","264","198","12","474","909","0","52.15","29.04"
"10","010","00","007","0000","0000","14195","8171","6024","892","15087","27342","31755","55.18","29.88"
"10","010","00","007","0701","0000","1274","636","638","71","1345","2203","0","61.05","28.87"
"10","010","00","007","0701","0138","575","293","282","27","602","1087","0","55.38","26.95"
"10","010","00","007","0701","0139","699","343","356","44","743","1116","0","66.58","30.73"
"10","010","00","007","0702","0000","798","441","357","56","854","1567","0","54.5","28.14"
"10","010","00","007","0702","0140","388","211","177","24","412","740","0","55.68","28.51"
"10","010","00","007","0702","0141","410","230","180","32","442","827","0","53.45","27.81"
"10","010","00","007","0703","0000","863","488","375","56","919","1472","0","62.43","33.15"
"10","010","00","007","0703","0142","413","221","192","28","441","704","0","62.64","31.39"
"10","010","00","007","0703","0143","450","267","183","28","478","768","0","62.24","34.77"
"10","010","00","007","0704","0000","877","433","444","51","928","1611","0","57.6","26.88"
"10","010","00","007","0704","0144","441","221","220","21","462","761","0","60.71","29.04"
"10","010","00","007","0704","0145","436","212","224","30","466","850","0","54.82","24.94"
"10","010","00","007","0705","0000","682","390","292","38","720","1327","0","54.26","29.39"
"10","010","00","007","0705","0146","682","390","292","38","720","1327","0","54.26","29.39"
"10","010","00","007","0706","0000","814","483","331","77","891","1572","0","56.68","30.73"
"10","010","00","007","0706","0147","391","234","157","34","425","756","0","56.22","30.95"
"10","010","00","007","0706","0148","423","249","174","43","466","816","0","57.11","30.51"
"10","010","00","007","0707","0000","834","514","320","48","882","1609","0","54.82","31.95"
"10","010","00","007","0707","0149","336","204","132","22","358","667","0","53.67","30.58"
"10","010","00","007","0707","0150","498","310","188","26","524","942","0","55.63","32.91"
"10","010","00","007","0708","0000","413","215","198","31","444","918","0","48.37","23.42"
"10","010","00","007","0708","0151","413","215","198","31","444","918","0","48.37","23.42"
"10","010","00","007","0709","0000","261","156","105","7","268","554","0","48.38","28.16"
"10","010","00","007","0709","0152","261","156","105","7","268","554","0","48.38","28.16"
"10","010","00","007","0710","0000","466","314","152","22","488","929","0","52.53","33.8"
"10","010","00","007","0710","0153","466","314","152","22","488","929","0","52.53","33.8"
"10","010","00","007","0711","0000","191","125","66","16","207","487","0","42.51","25.67"
"10","010","00","007","0711","0154","191","125","66","16","207","487","0","42.51","25.67"
"10","010","00","007","0712","0000","244","129","115","26","270","487","0","55.44","26.49"
"10","010","00","007","0712","0155","244","129","115","26","270","487","0","55.44","26.49"
"10","010","00","007","0713","0000","866","561","305","64","930","1681","0","55.32","33.37"
"10","010","00","007","0713","0156","411","283","128","34","445","836","0","53.23","33.85"
"10","010","00","007","0713","0157","455","278","177","30","485","845","0","57.4","32.9"
"10","010","00","007","0714","0000","844","540","304","53","897","1587","0","56.52","34.03"
"10","010","00","007","0714","0158","442","294","148","27","469","834","0","56.24","35.25"
"10","010","00","007","0714","0159","402","246","156","26","428","753","0","56.84","32.67"
"10","010","00","007","0715","0000","669","393","276","39","708","1328","0","53.31","29.59"
"10","010","00","007","0715","0160","669","393","276","39","708","1328","0","53.31","29.59"
"10","010","00","007","0716","0000","799","427","372","44","843","1400","0","60.21","30.5"
"10","010","00","007","0716","0163","799","427","372","44","843","1400","0","60.21","30.5"
"10","010","00","007","0717","0000","585","312","273","39","624","1043","0","59.83","29.91"
"10","010","00","007","0717","0162","585","312","273","39","624","1043","0","59.83","29.91"
"10","010","00","007","0718","0000","536","301","235","23","559","969","0","57.69","31.06"
"10","010","00","007","0718","0161","536","301","235","23","559","969","0","57.69","31.06"
"10","010","00","007","0719","0000","398","253","145","23","421","1017","0","41.4","24.88"
"10","010","00","007","0719","0164","398","253","145","23","421","1017","0","41.4","24.88"
"10","010","00","007","0720","0000","528","309","219","30","558","1132","0","49.29","27.3"
"10","010","00","007","0720","0165","528","309","219","30","558","1132","0","49.29","27.3"
"10","010","00","007","0721","0000","514","295","219","31","545","1037","0","52.56","28.45"
"10","010","00","007","0721","0166","514","295","219","31","545","1037","0","52.56","28.45"
"10","010","00","007","0722","0000","304","187","117","29","333","563","0","59.15","33.21"
"10","010","00","007","0722","0167","304","187","117","29","333","563","0","59.15","33.21"
"10","010","00","007","0723","0000","435","269","166","18","453","849","0","53.36","31.68"
"10","010","00","007","0723","0168","435","269","166","18","453","849","0","53.36","31.68"
"10","010","00","008","0000","0000","8457","4734","3723","612","9069","20821","23049","43.56","22.74"
"10","010","00","008","0801","0000","506","278","228","24","530","1165","0","45.49","23.86"
"10","010","00","008","0801","0268","506","278","228","24","530","1165","0","45.49","23.86"
"10","010","00","008","0802","0000","293","144","149","18","311","825","0","37.7","17.45"
"10","010","00","008","0802","0269","293","144","149","18","311","825","0","37.7","17.45"
"10","010","00","008","0803","0000","369","222","147","26","395","850","0","46.47","26.12"
"10","010","00","008","0803","0270","369","222","147","26","395","850","0","46.47","26.12"
"10","010","00","008","0804","0000","120","52","68","13","133","222","0","59.91","23.42"
"10","010","00","008","0804","0271","120","52","68","13","133","222","0","59.91","23.42"
"10","010","00","008","0805","0000","573","316","257","29","602","1216","0","49.51","25.99"
"10","010","00","008","0805","0272","573","316","257","29","602","1216","0","49.51","25.99"
"10","010","00","008","0806","0000","445","240","205","40","485","1200","0","40.42","20.0"
"10","010","00","008","0806","0273","445","240","205","40","485","1200","0","40.42","20.0"
"10","010","00","008","0807","0000","385","212","173","32","417","877","0","47.55","24.17"
"10","010","00","008","0807","0274","385","212","173","32","417","877","0","47.55","24.17"
"10","010","00","008","0808","0000","255","147","108","24","279","644","0","43.32","22.83"
"10","010","00","008","0808","0275","255","147","108","24","279","644","0","43.32","22.83"
"10","010","00","008","0809","0000","277","151","126","10","287","761","0","37.71","19.84"
"10","010","00","008","0809","0276","222","117","105","10","232","594","0","39.06","19.7"
"10","010","00","008","0809","0277","55","34","21","0","55","167","0","32.93","20.36"
"10","010","00","008","0810","0000","276","184","92","26","302","714","0","42.3","25.77"
"10","010","00","008","0810","0283","276","184","92","26","302","714","0","42.3","25.77"
"10","010","00","008","0811","0000","504","273","231","43","547","1051","0","52.05","25.98"
"10","010","00","008","0811","0284","504","273","231","43","547","1051","0","52.05","25.98"
"10","010","00","008","0812","0000","439","246","193","49","488","934","0","52.25","26.34"
"10","010","00","008","0812","0285","439","246","193","49","488","934","0","52.25","26.34"
"10","010","00","008","0813","0000","485","272","213","34","519","1044","0","49.71","26.05"
"10","010","00","008","0813","0286","485","272","213","34","519","1044","0","49.71","26.05"
"10","010","00","008","0814","0000","635","337","298","34","669","1476","0","45.33","22.83"
"10","010","00","008","0814","0287","635","337","298","34","669","1476","0","45.33","22.83"
"10","010","00","008","0815","0000","232","146","86","11","243","618","0","39.32","23.62"
"10","010","00","008","0815","0288","232","146","86","11","243","618","0","39.32","23.62"
"10","010","00","008","0816","0000","133","79","54","28","161","478","0","33.68","16.53"
"10","010","00","008","0816","0289","133","79","54","28","161","478","0","33.68","16.53"
"10","010","00","008","0817","0000","213","125","88","22","235","642","0","36.6","19.47"
"10","010","00","008","0817","0290","213","125","88","22","235","642","0","36.6","19.47"
"10","010","00","008","0818","0000","296","151","145","11","307","883","0","34.77","17.1"
"10","010","00","008","0818","0291","296","151","145","11","307","883","0","34.77","17.1"
"10","010","00","008","0819","0000","636","390","246","34","670","1391","0","48.17","28.04"
"10","010","00","008","0819","0278","86","67","19","0","86","204","0","42.16","32.84"
"10","010","00","008","0819","0279","105","83","22","3","108","234","0","46.15","35.47"
"10","010","00","008","0819","0280","139","87","52","3","142","361","0","39.34","24.1"
"10","010","00","008","0819","0281","306","153","153","28","334","592","0","56.42","25.84"
"10","010","00","008","0820","0000","289","160","129","29","318","619","0","51.37","25.85"
"10","010","00","008","0820","0282","289","160","129","29","318","619","0","51.37","25.85"
"10","010","00","008","0821","0000","193","83","110","7","200","739","0","27.06","11.23"
"10","010","00","008","0821","0292","193","83","110","7","200","739","0","27.06","11.23"
"10","010","00","008","0822","0000","205","123","82","17","222","554","0","40.07","22.2"
"10","010","00","008","0822","0293","205","123","82","17","222","554","0","40.07","22.2"
"10","010","00","008","0823","0000","219","132","87","17","236","649","0","36.36","20.34"
"10","010","00","008","0823","0294","219","132","87","17","236","649","0","36.36","20.34"
"10","010","00","008","0824","0000","274","151","123","18","292","689","0","42.38","21.92"
"10","010","00","008","0824","0295","274","151","123","18","292","689","0","42.38","21.92"
"10","010","00","008","0825","0000","205","120","85","16","221","580","0","38.1","20.69"
"10","010","00","008","0825","0296","168","98","70","14","182","455","0","40.0","21.54"
"10","010","00","008","0825","0297","37","22","15","2","39","125","0","31.2","17.6"
"10","010","00","009","0000","0000","8413","4475","3938","693","9106","21915","24658","41.55","20.42"
"10","010","00","009","0901","0000","799","406","393","81","880","1915","0","45.95","21.2"
"10","010","00","009","0901","0298","799","406","393","81","880","1915","0","45.95","21.2"
"10","010","00","009","0902","0000","338","204","134","38","376","938","0","40.09","21.75"
"10","010","00","009","0902","0299","338","204","134","38","376","938","0","40.09","21.75"
"10","010","00","009","0903","0000","394","185","209","19","413","1366","0","30.23","13.54"
"10","010","00","009","0903","0300","394","185","209","19","413","1366","0","30.23","13.54"
"10","010","00","009","0904","0000","653","306","347","5","658","1676","0","39.26","18.26"
"10","010","00","009","0904","0301","653","306","347","5","658","1676","0","39.26","18.26"
"10","010","00","009","0905","0000","423","226","197","49","472","1151","0","41.01","19.64"
"10","010","00","009","0905","0302","423","226","197","49","472","1151","0","41.01","19.64"
"10","010","00","009","0906","0000","269","157","112","54","323","716","0","45.11","21.93"
"10","010","00","009","0906","0303","269","157","112","54","323","716","0","45.11","21.93"
"10","010","00","009","0907","0000","140","82","58","12","152","387","0","39.28","21.19"
"10","010","00","009","0907","0304","140","82","58","12","152","387","0","39.28","21.19"
"10","010","00","009","0908","0000","228","95","133","13","241","864","0","27.89","11.0"
"10","010","00","009","0908","0305","228","95","133","13","241","864","0","27.89","11.0"
"10","010","00","009","0909","0000","306","170","136","12","318","910","0","34.95","18.68"
"10","010","00","009","0909","0306","306","170","136","12","318","910","0","34.95","18.68"
"10","010","00","009","0910","0000","271","160","111","13","284","760","0","37.37","21.05"
"10","010","00","009","0910","0307","271","160","111","13","284","760","0","37.37","21.05"
"10","010","00","009","0911","0000","156","78","78","13","169","378","0","44.71","20.63"
"10","010","00","009","0911","0308","83","46","37","6","89","166","0","53.61","27.71"
"10","010","00","009","0911","0309","73","32","41","7","80","212","0","37.74","15.09"
"10","010","00","009","0912","0000","318","165","153","26","344","993","0","34.64","16.62"
"10","010","00","009","0912","0310","318","165","153","26","344","993","0","34.64","16.62"
"10","010","00","009","0913","0000","523","262","261","47","570","1226","0","46.49","21.37"
"10","010","00","009","0913","0314","523","262","261","47","570","1226","0","46.49","21.37"
"10","010","00","009","0914","0000","343","185","158","32","375","843","0","44.48","21.95"
"10","010","00","009","0914","0315","343","185","158","32","375","843","0","44.48","21.95"
"10","010","00","009","0915","0000","295","110","185","17","312","693","0","45.02","15.87"
"10","010","00","009","0915","0316","295","110","185","17","312","693","0","45.02","15.87"
"10","010","00","009","0916","0000","381","202","179","34","415","839","0","49.46","24.08"
"10","010","00","009","0916","0317","381","202","179","34","415","839","0","49.46","24.08"
"10","010","00","009","0917","0000","289","165","124","15","304","684","0","44.44","24.12"
"10","010","00","009","0917","0318","169","94","75","10","179","363","0","49.31","25.9"
"10","010","00","009","0917","0319","120","71","49","5","125","321","0","38.94","22.12"
"10","010","00","009","0918","0000","555","320","235","46","601","1083","0","55.49","29.55"
"10","010","00","009","0918","0320","555","320","235","46","601","1083","0","55.49","29.55"
"10","010","00","009","0919","0000","398","254","144","26","424","901","0","47.06","28.19"
"10","010","00","009","0919","0321","398","254","144","26","424","901","0","47.06","28.19"
"10","010","00","009","0920","0000","404","212","192","29","433","1216","0","35.61","17.43"
"10","010","00","009","0920","0322","404","212","192","29","433","1216","0","35.61","17.43"
"10","010","00","009","0921","0000","387","265","122","33","420","789","0","53.23","33.59"
"10","010","00","009","0921","0323","239","145","94","20","259","418","0","61.96","34.69"
"10","010","00","009","0921","0324","148","120","28","13","161","371","0","43.4","32.35"
"10","010","00","009","0922","0000","115","55","60","6","121","306","0","39.54","17.97"
"10","010","00","009","0922","0311","115","55","60","6","121","306","0","39.54","17.97"
"10","010","00","009","0923","0000","428","211","217","73","501","1281","0","39.11","16.47"
"10","010","00","009","0923","0312","355","175","180","56","411","1046","0","39.29","16.73"
"10","010","00","009","0923","0313","73","36","37","17","90","235","0","38.3","15.32"
"10","010","00","010","0000","0000","8147","4412","3735","523","8670","16647","18297","52.08","26.5"
"10","010","00","010","1001","0000","342","193","149","31","373","705","0","52.91","27.38"
"10","010","00","010","1001","0354","217","116","101","21","238","482","0","49.38","24.07"
"10","010","00","010","1001","0355","125","77","48","10","135","223","0","60.54","34.53"
"10","010","00","010","1002","0000","801","428","373","52","853","1529","0","55.79","27.99"
"10","010","00","010","1002","0356","801","428","373","52","853","1529","0","55.79","27.99"
"10","010","00","010","1003","0000","634","338","296","46","680","1175","0","57.87","28.77"
"10","010","00","010","1003","0357","634","338","296","46","680","1175","0","57.87","28.77"
"10","010","00","010","1004","0000","520","258","262","31","551","886","0","62.19","29.12"
"10","010","00","010","1004","0358","520","258","262","31","551","886","0","62.19","29.12"
"10","010","00","010","1005","0000","317","174","143","23","340","743","0","45.76","23.42"
"10","010","00","010","1005","0359","317","174","143","23","340","743","0","45.76","23.42"
"10","010","00","010","1006","0000","653","390","263","39","692","1236","0","55.99","31.55"
"10","010","00","010","1006","0360","653","390","263","39","692","1236","0","55.99","31.55"
"10","010","00","010","1007","0000","190","95","95","4","194","377","0","51.46","25.2"
"10","010","00","010","1007","0361","190","95","95","4","194","377","0","51.46","25.2"
"10","010","00","010","1008","0000","201","96","105","17","218","440","0","49.55","21.82"
"10","010","00","010","1008","0362","144","73","71","14","158","338","0","46.75","21.6"
"10","010","00","010","1008","0363","57","23","34","3","60","102","0","58.82","22.55"
"10","010","00","010","1009","0000","339","180","159","20","359","763","0","47.05","23.59"
"10","010","00","010","1009","0364","339","180","159","20","359","763","0","47.05","23.59"
"10","010","00","010","1010","0000","235","133","102","19","254","429","0","59.21","31.0"
"10","010","00","010","1010","0365","235","133","102","19","254","429","0","59.21","31.0"
"10","010","00","010","1011","0000","203","95","108","14","217","427","0","50.82","22.25"
"10","010","00","010","1011","0366","203","95","108","14","217","427","0","50.82","22.25"
"10","010","00","010","1012","0000","311","178","133","31","342","607","0","56.34","29.32"
"10","010","00","010","1012","0367","311","178","133","31","342","607","0","56.34","29.32"
"10","010","00","010","1013","0000","701","361","340","25","726","1486","0","48.86","24.29"
"10","010","00","010","1013","0368","701","361","340","25","726","1486","0","48.86","24.29"
"10","010","00","010","1014","0000","450","226","224","30","480","835","0","57.49","27.07"
"10","010","00","010","1014","0369","450","226","224","30","480","835","0","57.49","27.07"
"10","010","00","010","1015","0000","326","190","136","31","357","816","0","43.75","23.28"
"10","010","00","010","1015","0370","326","190","136","31","357","816","0","43.75","23.28"
"10","010","00","010","1016","0000","362","199","163","30","392","833","0","47.06","23.89"
"10","010","00","010","1016","0371","362","199","163","30","392","833","0","47.06","23.89"
"10","010","00","010","1017","0000","205","103","102","11","216","433","0","49.88","23.79"
"10","010","00","010","1017","0372","205","103","102","11","216","433","0","49.88","23.79"
"10","010","00","010","1018","0000","253","109","144","4","257","558","0","46.06","19.53"
"10","010","00","010","1018","0373","253","109","144","4","257","558","0","46.06","19.53"
"10","010","00","010","1019","0000","366","216","150","21","387","742","0","52.16","29.11"
"10","010","00","010","1019","0374","302","179","123","20","322","602","0","53.49","29.73"
"10","010","00","010","1019","0375","64","37","27","1","65","140","0","46.43","26.43"
"10","010","00","010","1020","0000","171","108","63","15","186","393","0","47.33","27.48"
"10","010","00","010","1020","0376","171","108","63","15","186","393","0","47.33","27.48"
"10","010","00","010","1021","0000","282","156","126","18","300","585","0","51.28","26.67"
"10","010","00","010","1021","0377","282","156","126","18","300","585","0","51.28","26.67"
"10","010","00","010","1022","0000","285","186","99","11","296","649","0","45.61","28.66"
"10","010","00","010","1022","0378","205","127","78","7","212","526","0","40.3","24.14"
"10","010","00","010","1022","0379","80","59","21","4","84","123","0","68.29","47.97"
"10","010","00","011","0000","0000","6256","3491","2765","462","6718","13937","15422","48.2","25.05"
"10","010","00","011","1101","0000","226","147","79","22","248","522","0","47.51","28.16"
"10","010","00","011","1101","0034","226","147","79","22","248","522","0","47.51","28.16"
"10","010","00","011","1102","0000","291","193","98","19","310","563","0","55.06","34.28"
"10","010","00","011","1102","0035","291","193","98","19","310","563","0","55.06","34.28"
"10","010","00","011","1103","0000","599","287","312","54","653","1304","0","50.08","22.01"
"10","010","00","011","1103","0036","599","287","312","54","653","1304","0","50.08","22.01"
"10","010","00","011","1104","0000","637","310","327","34","671","1312","0","51.14","23.63"
"10","010","00","011","1104","0037","637","310","327","34","671","1312","0","51.14","23.63"
"10","010","00","011","1105","0000","246","127","119","7","253","738","0","34.28","17.21"
"10","010","00","011","1105","0038","141","82","59","2","143","320","0","44.69","25.63"
"10","010","00","011","1105","0039","105","45","60","5","110","418","0","26.32","10.77"
"10","010","00","011","1106","0000","435","259","176","39","474","1025","0","46.24","25.27"
"10","010","00","011","1106","0040","435","259","176","39","474","1025","0","46.24","25.27"
"10","010","00","011","1107","0000","184","116","68","15","199","451","0","44.12","25.72"
"10","010","00","011","1107","0041","184","116","68","15","199","451","0","44.12","25.72"
"10","010","00","011","1108","0000","417","254","163","38","455","830","0","54.82","30.6"
"10","010","00","011","1108","0042","417","254","163","38","455","830","0","54.82","30.6"
"10","010","00","011","1109","0000","474","293","181","24","498","1050","0","47.43","27.9"
"10","010","00","011","1109","0043","474","293","181","24","498","1050","0","47.43","27.9"
"10","010","00","011","1110","0000","378","172","206","29","407","972","0","41.87","17.7"
"10","010","00","011","1110","0044","378","172","206","29","407","972","0","41.87","17.7"
"10","010","00","011","1111","0000","422","236","186","27","449","962","0","46.67","24.53"
"10","010","00","011","1111","0045","422","236","186","27","449","962","0","46.67","24.53"
"10","010","00","011","1112","0000","454","285","169","41","495","940","0","52.66","30.32"
"10","010","00","011","1112","0046","327","197","130","29","356","678","0","52.51","29.06"
"10","010","00","011","1112","0047","127","88","39","12","139","262","0","53.05","33.59"
"10","010","00","011","1113","0000","466","250","216","41","507","1212","0","41.83","20.63"
"10","010","00","011","1113","0048","360","191","169","35","395","906","0","43.6","21.08"
"10","010","00","011","1113","0049","106","59","47","6","112","306","0","36.6","19.28"
"10","010","00","011","1114","0000","726","409","317","47","773","1435","0","53.87","28.5"
"10","010","00","011","1114","0050","526","297","229","36","562","1062","0","52.92","27.97"
"10","010","00","011","1114","0051","200","112","88","11","211","373","0","56.57","30.03"
"10","010","00","011","1115","0000","301","153","148","25","326","621","0","52.5","24.64"
"10","010","00","011","1115","0052","159","77","82","16","175","324","0","54.01","23.77"
"10","010","00","011","1115","0053","142","76","66","9","151","297","0","50.84","25.59"
"10","010","00","012","0000","0000","22235","11291","10944","1289","23524","43857","49406","53.64","25.75"
"10","010","00","012","1201","0000","1971","929","1042","108","2079","3971","0","52.35","23.39"
"10","010","00","012","1201","0054","496","224","272","21","517","1024","0","50.49","21.88"
"10","010","00","012","1201","0055","579","294","285","36","615","1015","0","60.59","28.97"
"10","010","00","012","1201","0056","896","411","485","51","947","1932","0","49.02","21.27"
"10","010","00","012","1202","0000","1385","688","697","73","1458","2475","0","58.91","27.8"
"10","010","00","012","1202","0057","659","338","321","31","690","1170","0","58.97","28.89"
"10","010","00","012","1202","0058","726","350","376","42","768","1305","0","58.85","26.82"
"10","010","00","012","1203","0000","906","519","387","55","961","1564","0","61.45","33.18"
"10","010","00","012","1203","0066","392","224","168","23","415","626","0","66.29","35.78"
"10","010","00","012","1203","0067","335","196","139","16","351","570","0","61.58","34.39"
"10","010","00","012","1203","0068","179","99","80","16","195","368","0","52.99","26.9"
"10","010","00","012","1204","0000","1026","522","504","97","1123","2102","0","53.43","24.83"
"10","010","00","012","1204","0069","488","261","227","53","541","1037","0","52.17","25.17"
"10","010","00","012","1204","0070","538","261","277","44","582","1065","0","54.65","24.51"
"10","010","00","012","1205","0000","434","256","178","75","509","802","0","63.47","31.92"
"10","010","00","012","1205","0071","434","256","178","75","509","802","0","63.47","31.92"
"10","010","00","012","1206","0000","741","363","378","45","786","1566","0","50.19","23.18"
"10","010","00","012","1206","0059","585","273","312","38","623","1242","0","50.16","21.98"
"10","010","00","012","1206","0060","156","90","66","7","163","324","0","50.31","27.78"
"10","010","00","012","1207","0000","908","435","473","59","967","1838","0","52.61","23.67"
"10","010","00","012","1207","0061","321","160","161","12","333","622","0","53.54","25.72"
"10","010","00","012","1207","0062","587","275","312","47","634","1216","0","52.14","22.62"
"10","010","00","012","1208","0000","1002","453","549","48","1050","1791","0","58.63","25.29"
"10","010","00","012","1208","0063","538","228","310","28","566","1020","0","55.49","22.35"
"10","010","00","012","1208","0064","464","225","239","20","484","771","0","62.78","29.18"
"10","010","00","012","1209","0000","255","72","183","22","277","441","0","62.81","16.33"
"10","010","00","012","1209","0065","255","72","183","22","277","441","0","62.81","16.33"
"10","010","00","012","1210","0000","346","149","197","26","372","641","0","58.03","23.24"
"10","010","00","012","1210","0074","346","149","197","26","372","641","0","58.03","23.24"
"10","010","00","012","1211","0000","231","96","135","16","247","408","0","60.54","23.53"
"10","010","00","012","1211","0075","231","96","135","16","247","408","0","60.54","23.53"
"10","010","00","012","1212","0000","689","390","299","50","739","1363","0","54.22","28.61"
"10","010","00","012","1212","0076","432","251","181","29","461","794","0","58.06","31.61"
"10","010","00","012","1212","0077","257","139","118","21","278","569","0","48.86","24.43"
"10","010","00","012","1213","0000","998","512","486","25","1023","1948","0","52.52","26.28"
"10","010","00","012","1213","0072","998","512","486","25","1023","1948","0","52.52","26.28"
"10","010","00","012","1214","0000","505","270","235","33","538","1028","0","52.33","26.26"
"10","010","00","012","1214","0073","505","270","235","33","538","1028","0","52.33","26.26"
"10","010","00","012","1215","0000","1065","553","512","47","1112","2035","0","54.64","27.17"
"10","010","00","012","1215","0080","1065","553","512","47","1112","2035","0","54.64","27.17"
"10","010","00","012","1216","0000","1007","563","444","67","1074","1987","0","54.05","28.33"
"10","010","00","012","1216","0081","1007","563","444","67","1074","1987","0","54.05","28.33"
"10","010","00","012","1217","0000","967","435","532","42","1009","1766","0","57.13","24.63"
"10","010","00","012","1217","0078","433","213","220","21","454","806","0","56.33","26.43"
"10","010","00","012","1217","0079","534","222","312","21","555","960","0","57.81","23.13"
"10","010","00","012","1218","0000","1987","1011","976","87","2074","4310","0","48.12","23.46"
"10","010","00","012","1218","0083","1084","571","513","47","1131","2208","0","51.22","25.86"
"10","010","00","012","1218","0084","903","440","463","40","943","2102","0","44.86","20.93"
"10","010","00","012","1219","0000","1491","765","726","79","1570","2980","0","52.68","25.67"
"10","010","00","012","1219","0085","630","328","302","33","663","1309","0","50.65","25.06"
"10","010","00","012","1219","0086","861","437","424","46","907","1671","0","54.28","26.15"
"10","010","00","012","1220","0000","968","518","450","58","1026","1919","0","53.47","26.99"
"10","010","00","012","1220","0089","968","518","450","58","1026","1919","0","53.47","26.99"
"10","010","00","012","1221","0000","876","466","410","40","916","1772","0","51.69","26.3"
"10","010","00","012","1221","0088","876","466","410","40","916","1772","0","51.69","26.3"
"10","010","00","012","1222","0000","398","196","202","21","419","912","0","45.94","21.49"
"10","010","00","012","1222","0090","398","196","202","21","419","912","0","45.94","21.49"
"10","010","00","012","1223","0000","489","252","237","24","513","992","0","51.71","25.4"
"10","010","00","012","1223","0091","489","252","237","24","513","992","0","51.71","25.4"
"10","010","00","012","1224","0000","541","314","227","40","581","1270","0","45.75","24.72"
"10","010","00","012","1224","0092","541","314","227","40","581","1270","0","45.75","24.72"
"10","010","00","012","1225","0000","627","323","304","20","647","1154","0","56.07","27.99"
"10","010","00","012","1225","0082","627","323","304","20","647","1154","0","56.07","27.99"
"10","010","00","012","1226","0000","422","241","181","32","454","822","0","55.23","29.32"
"10","010","00","012","1226","0087","422","241","181","32","454","822","0","55.23","29.32"
"10","010","00","013","0000","0000","17491","8874","8617","1105","18596","39139","44605","47.51","22.67"
"10","010","00","013","1301","0000","763","417","346","68","831","1809","0","45.94","23.05"
"10","010","00","013","1301","0392","763","417","346","68","831","1809","0","45.94","23.05"
"10","010","00","013","1302","0000","466","240","226","12","478","953","0","50.16","25.18"
"10","010","00","013","1302","0393","466","240","226","12","478","953","0","50.16","25.18"
"10","010","00","013","1303","0000","360","165","195","17","377","828","0","45.53","19.93"
"10","010","00","013","1303","0401","360","165","195","17","377","828","0","45.53","19.93"
"10","010","00","013","1304","0000","411","248","163","27","438","879","0","49.83","28.21"
"10","010","00","013","1304","0400","411","248","163","27","438","879","0","49.83","28.21"
"10","010","00","013","1305","0000","629","313","316","43","672","1441","0","46.63","21.72"
"10","010","00","013","1305","0394","629","313","316","43","672","1441","0","46.63","21.72"
"10","010","00","013","1306","0000","1217","627","590","73","1290","2834","0","45.52","22.12"
"10","010","00","013","1306","0380","430","204","226","14","444","1046","0","42.45","19.5"
"10","010","00","013","1306","0381","787","423","364","59","846","1788","0","47.32","23.66"
"10","010","00","013","1307","0000","1506","754","752","81","1587","3311","0","47.93","22.77"
"10","010","00","013","1307","0382","773","415","358","33","806","1730","0","46.59","23.99"
"10","010","00","013","1307","0383","733","339","394","48","781","1581","0","49.4","21.44"
"10","010","00","013","1308","0000","3240","1583","1657","145","3385","7060","0","47.95","22.42"
"10","010","00","013","1308","0384","651","312","339","31","682","1594","0","42.79","19.57"
"10","010","00","013","1308","0385","882","411","471","36","918","1801","0","50.97","22.82"
"10","010","00","013","1308","0386","882","444","438","47","929","1862","0","49.89","23.85"
"10","010","00","013","1308","0387","825","416","409","31","856","1803","0","47.48","23.07"
"10","010","00","013","1309","0000","2650","1350","1300","177","2827","5642","0","50.11","23.93"
"10","010","00","013","1309","0388","725","339","386","48","773","1481","0","52.19","22.89"
"10","010","00","013","1309","0389","688","351","337","42","730","1366","0","53.44","25.7"
"10","010","00","013","1309","0390","659","328","331","54","713","1599","0","44.59","20.51"
"10","010","00","013","1309","0391","578","332","246","33","611","1196","0","51.09","27.76"
"10","010","00","013","1310","0000","822","382","440","45","867","1882","0","46.07","20.3"
"10","010","00","013","1310","0395","822","382","440","45","867","1882","0","46.07","20.3"
"10","010","00","013","1311","0000","557","299","258","20","577","1470","0","39.25","20.34"
"10","010","00","013","1311","0396","557","299","258","20","577","1470","0","39.25","20.34"
"10","010","00","013","1312","0000","865","407","458","68","933","2121","0","43.99","19.19"
"10","010","00","013","1312","0397","697","331","366","57","754","1699","0","44.38","19.48"
"10","010","00","013","1312","0398","168","76","92","11","179","422","0","42.42","18.01"
"10","010","00","013","1313","0000","476","262","214","42","518","1030","0","50.29","25.44"
"10","010","00","013","1313","0399","476","262","214","42","518","1030","0","50.29","25.44"
"10","010","00","013","1314","0000","589","295","294","59","648","1177","0","55.06","25.06"
"10","010","00","013","1314","0402","450","217","233","50","500","881","0","56.75","24.63"
"10","010","00","013","1314","0403","139","78","61","9","148","296","0","50.0","26.35"
"10","010","00","013","1315","0000","415","214","201","64","479","979","0","48.93","21.86"
"10","010","00","013","1315","0404","415","214","201","64","479","979","0","48.93","21.86"
"10","010","00","013","1316","0000","769","380","389","39","808","1938","0","41.69","19.61"
"10","010","00","013","1316","0405","546","262","284","30","576","1268","0","45.43","20.66"
"10","010","00","013","1316","0406","223","118","105","9","232","670","0","34.63","17.61"
"10","010","00","013","1317","0000","290","144","146","15","305","741","0","41.16","19.43"
"10","010","00","013","1317","0409","290","144","146","15","305","741","0","41.16","19.43"
"10","010","00","013","1318","0000","459","238","221","25","484","1000","0","48.4","23.8"
"10","010","00","013","1318","0410","239","137","102","4","243","518","0","46.91","26.45"
"10","010","00","013","1318","0411","220","101","119","21","241","482","0","50.0","20.95"
"10","010","00","013","1319","0000","328","195","133","34","362","648","0","55.86","30.09"
"10","010","00","013","1319","0408","328","195","133","34","362","648","0","55.86","30.09"
"10","010","00","013","1320","0000","397","217","180","34","431","754","0","57.16","28.78"
"10","010","00","013","1320","0407","397","217","180","34","431","754","0","57.16","28.78"
"10","010","00","013","1321","0000","137","76","61","12","149","348","0","42.82","21.84"
"10","010","00","013","1321","0412","137","76","61","12","149","348","0","42.82","21.84"
"10","010","00","013","1322","0000","145","68","77","5","150","294","0","51.02","23.13"
"10","010","00","013","1322","0413","145","68","77","5","150","294","0","51.02","23.13"
"10","010","00","014","0000","0000","15472","7748","7724","976","16448","31228","35625","52.67","24.81"
"10","010","00","014","1401","0000","1359","680","679","52","1411","2522","0","55.95","26.96"
"10","010","00","014","1401","0414","697","353","344","31","728","1312","0","55.49","26.91"
"10","010","00","014","1401","0415","662","327","335","21","683","1210","0","56.45","27.02"
"10","010","00","014","1402","0000","1129","578","551","73","1202","2198","0","54.69","26.3"
"10","010","00","014","1402","0416","519","274","245","38","557","991","0","56.21","27.65"
"10","010","00","014","1402","0417","610","304","306","35","645","1207","0","53.44","25.19"
"10","010","00","014","1403","0000","334","187","147","14","348","752","0","46.28","24.87"
"10","010","00","014","1403","0418","334","187","147","14","348","752","0","46.28","24.87"
"10","010","00","014","1404","0000","461","265","196","36","497","833","0","59.66","31.81"
"10","010","00","014","1404","0419","461","265","196","36","497","833","0","59.66","31.81"
"10","010","00","014","1405","0000","645","371","274","49","694","1220","0","56.89","30.41"
"10","010","00","014","1405","0420","645","371","274","49","694","1220","0","56.89","30.41"
"10","010","00","014","1406","0000","359","187","172","14","373","616","0","60.55","30.36"
"10","010","00","014","1406","0421","359","187","172","14","373","616","0","60.55","30.36"
"10","010","00","014","1407","0000","487","242","245","45","532","1031","0","51.6","23.47"
"10","010","00","014","1407","0422","487","242","245","45","532","1031","0","51.6","23.47"
"10","010","00","014","1408","0000","2591","1245","1346","141","2732","5283","0","51.71","23.57"
"10","010","00","014","1408","0423","632","316","316","40","672","1292","0","52.01","24.46"
"10","010","00","014","1408","0424","1041","483","558","63","1104","1995","0","55.34","24.21"
"10","010","00","014","1408","0425","918","446","472","38","956","1996","0","47.9","22.34"
"10","010","00","014","1409","0000","703","327","376","57","760","1449","0","52.45","22.57"
"10","010","00","014","1409","0426","703","327","376","57","760","1449","0","52.45","22.57"
"10","010","00","014","1410","0000","721","348","373","33","754","1420","0","53.1","24.51"
"10","010","00","014","1410","0427","721","348","373","33","754","1420","0","53.1","24.51"
"10","010","00","014","1411","0000","861","451","410","41","902","1590","0","56.73","28.36"
"10","010","00","014","1411","0428","861","451","410","41","902","1590","0","56.73","28.36"
"10","010","00","014","1412","0000","814","411","403","65","879","1785","0","49.24","23.03"
"10","010","00","014","1412","0429","358","161","197","35","393","771","0","50.97","20.88"
"10","010","00","014","1412","0430","456","250","206","30","486","1014","0","47.93","24.65"
"10","010","00","014","1413","0000","299","143","156","20","319","641","0","49.77","22.31"
"10","010","00","014","1413","0433","299","143","156","20","319","641","0","49.77","22.31"
"10","010","00","014","1414","0000","482","238","244","16","498","1014","0","49.11","23.47"
"10","010","00","014","1414","0431","128","79","49","3","131","327","0","40.06","24.16"
"10","010","00","014","1414","0432","354","159","195","13","367","687","0","53.42","23.14"
"10","010","00","014","1415","0000","433","171","262","23","456","857","0","53.21","19.95"
"10","010","00","014","1415","0434","257","111","146","4","261","474","0","55.06","23.42"
"10","010","00","014","1415","0435","176","60","116","19","195","383","0","50.91","15.67"
"10","010","00","014","1416","0000","345","162","183","38","383","619","0","61.87","26.17"
"10","010","00","014","1416","0436","345","162","183","38","383","619","0","61.87","26.17"
"10","010","00","014","1417","0000","853","411","442","73","926","1782","0","51.96","23.06"
"10","010","00","014","1417","0437","93","49","44","9","102","214","0","47.66","22.9"
"10","010","00","014","1417","0438","760","362","398","64","824","1568","0","52.55","23.09"
"10","010","00","014","1418","0000","278","136","142","29","307","658","0","46.66","20.67"
"10","010","00","014","1418","0439","278","136","142","29","307","658","0","46.66","20.67"
"10","010","00","014","1419","0000","233","119","114","24","257","434","0","59.22","27.42"
"10","010","00","014","1419","0440","233","119","114","24","257","434","0","59.22","27.42"
"10","010","00","014","1420","0000","926","511","415","72","998","1898","0","52.58","26.92"
"10","010","00","014","1420","0441","477","273","204","41","518","917","0","56.49","29.77"
"10","010","00","014","1420","0442","449","238","211","31","480","981","0","48.93","24.26"
"10","010","00","014","1421","0000","377","181","196","30","407","897","0","45.37","20.18"
"10","010","00","014","1421","0443","341","164","177","29","370","789","0","46.89","20.79"
"10","010","00","014","1421","0444","36","17","19","1","37","108","0","34.26","15.74"
"10","010","00","014","1422","0000","72","56","16","3","75","235","0","31.91","23.83"
"10","010","00","014","1422","0445","72","56","16","3","75","235","0","31.91","23.83"
"10","010","00","014","1423","0000","418","208","210","10","428","781","0","54.8","26.63"
"10","010","00","014","1423","0446","145","68","77","3","148","331","0","44.71","20.54"
"10","010","00","014","1423","0447","273","140","133","7","280","450","0","62.22","31.11"
"10","010","00","014","1424","0000","292","120","172","18","310","713","0","43.48","16.83"
"10","010","00","014","1424","0448","195","84","111","7","202","462","0","43.72","18.18"
"10","010","00","014","1424","0449","97","36","61","11","108","251","0","43.03","14.34"
"10","010","00","015","0000","0000","8722","4342","4380","611","9333","17083","19303","54.63","25.42"
"10","010","00","015","1501","0000","1228","668","560","83","1311","2286","0","57.35","29.22"
"10","010","00","015","1501","0211","537","293","244","18","555","1041","0","53.31","28.15"
"10","010","00","015","1501","0212","691","375","316","65","756","1245","0","60.72","30.12"
"10","010","00","015","1502","0000","540","255","285","31","571","917","0","62.27","27.81"
"10","010","00","015","1502","0213","540","255","285","31","571","917","0","62.27","27.81"
"10","010","00","015","1503","0000","319","177","142","25","344","545","0","63.12","32.48"
"10","010","00","015","1503","0217","319","177","142","25","344","545","0","63.12","32.48"
"10","010","00","015","1504","0000","2100","1151","949","128","2228","4404","0","50.59","26.14"
"10","010","00","015","1504","0214","408","324","84","36","444","1189","0","37.34","27.25"
"10","010","00","015","1504","0215","740","386","354","50","790","1388","0","56.92","27.81"
"10","010","00","015","1504","0216","952","441","511","42","994","1827","0","54.41","24.14"
"10","010","00","015","1505","0000","171","107","64","12","183","407","0","44.96","26.29"
"10","010","00","015","1505","0218","171","107","64","12","183","407","0","44.96","26.29"
"10","010","00","015","1506","0000","305","100","205","27","332","526","0","63.12","19.01"
"10","010","00","015","1506","0223","305","100","205","27","332","526","0","63.12","19.01"
"10","010","00","015","1507","0000","171","95","76","18","189","372","0","50.81","25.54"
"10","010","00","015","1507","0224","171","95","76","18","189","372","0","50.81","25.54"
"10","010","00","015","1508","0000","355","183","172","25","380","636","0","59.75","28.77"
"10","010","00","015","1508","0219","355","183","172","25","380","636","0","59.75","28.77"
"10","010","00","015","1509","0000","868","446","422","64","932","1674","0","55.68","26.64"
"10","010","00","015","1509","0221","868","446","422","64","932","1674","0","55.68","26.64"
"10","010","00","015","1510","0000","311","168","143","29","340","576","0","59.03","29.17"
"10","010","00","015","1510","0220","311","168","143","29","340","576","0","59.03","29.17"
"10","010","00","015","1511","0000","384","171","213","11","395","858","0","46.04","19.93"
"10","010","00","015","1511","0222","384","171","213","11","395","858","0","46.04","19.93"
"10","010","00","015","1512","0000","237","121","116","21","258","506","0","50.99","23.91"
"10","010","00","015","1512","0225","237","121","116","21","258","506","0","50.99","23.91"
"10","010","00","015","1513","0000","134","73","61","13","147","293","0","50.17","24.91"
"10","010","00","015","1513","0228","134","73","61","13","147","293","0","50.17","24.91"
"10","010","00","015","1514","0000","283","100","183","26","309","433","0","71.36","23.09"
"10","010","00","015","1514","0226","283","100","183","26","309","433","0","71.36","23.09"
"10","010","00","015","1515","0000","428","146","282","25","453","712","0","63.62","20.51"
"10","010","00","015","1515","0229","428","146","282","25","453","712","0","63.62","20.51"
"10","010","00","015","1516","0000","343","134","209","30","373","602","0","61.96","22.26"
"10","010","00","015","1516","0230","343","134","209","30","373","602","0","61.96","22.26"
"10","010","00","015","1517","0000","388","160","228","27","415","932","0","44.53","17.17"
"10","010","00","015","1517","0231","233","95","138","18","251","515","0","48.74","18.45"
"10","010","00","015","1517","0232","155","65","90","9","164","417","0","39.33","15.59"
"10","010","00","015","1518","0000","157","87","70","16","173","404","0","42.82","21.53"
"10","010","00","015","1518","0227","157","87","70","16","173","404","0","42.82","21.53"
"10","010","00","016","0000","0000","5341","2438","2903","378","5719","10156","11470","56.31","24.01"
"10","010","00","016","1601","0000","659","290","369","51","710","1174","0","60.48","24.7"
"10","010","00","016","1601","0450","659","290","369","51","710","1174","0","60.48","24.7"
"10","010","00","016","1602","0000","272","132","140","10","282","449","0","62.81","29.4"
"10","010","00","016","1602","0451","272","132","140","10","282","449","0","62.81","29.4"
"10","010","00","016","1603","0000","674","319","355","45","719","1304","0","55.14","24.46"
"10","010","00","016","1603","0452","430","201","229","28","458","753","0","60.82","26.69"
"10","010","00","016","1603","0453","244","118","126","17","261","551","0","47.37","21.42"
"10","010","00","016","1604","0000","945","467","478","66","1011","1791","0","56.45","26.07"
"10","010","00","016","1604","0454","945","467","478","66","1011","1791","0","56.45","26.07"
"10","010","00","016","1605","0000","496","233","263","44","540","849","0","63.6","27.44"
"10","010","00","016","1605","0455","496","233","263","44","540","849","0","63.6","27.44"
"10","010","00","016","1606","0000","465","210","255","43","508","866","0","58.66","24.25"
"10","010","00","016","1606","0456","465","210","255","43","508","866","0","58.66","24.25"
"10","010","00","016","1607","0000","672","323","349","39","711","1244","0","57.15","25.96"
"10","010","00","016","1607","0457","412","139","273","28","440","800","0","55.0","17.38"
"10","010","00","016","1607","0458","260","184","76","11","271","444","0","61.04","41.44"
"10","010","00","016","1608","0000","251","105","146","16","267","635","0","42.05","16.54"
"10","010","00","016","1608","0459","251","105","146","16","267","635","0","42.05","16.54"
"10","010","00","016","1609","0000","487","187","300","36","523","961","0","54.42","19.46"
"10","010","00","016","1609","0460","137","63","74","7","144","319","0","45.14","19.75"
"10","010","00","016","1609","0461","350","124","226","29","379","642","0","59.03","19.31"
"10","010","00","016","1610","0000","217","101","116","19","236","509","0","46.37","19.84"
"10","010","00","016","1610","0462","217","101","116","19","236","509","0","46.37","19.84"
"10","010","00","016","1611","0000","203","71","132","9","212","374","0","56.68","18.98"
"10","010","00","016","1611","0463","91","26","65","1","92","162","0","56.79","16.05"
"10","010","00","016","1611","0464","112","45","67","8","120","212","0","56.6","21.23"
"10","010","00","017","0000","0000","2099","974","1125","104","2203","3999","4592","55.09","24.36"
"10","010","00","017","1701","0000","764","344","420","51","815","1468","0","55.52","23.43"
"10","010","00","017","1701","0465","764","344","420","51","815","1468","0","55.52","23.43"
"10","010","00","017","1702","0000","298","153","145","10","308","624","0","49.36","24.52"
"10","010","00","017","1702","0466","132","60","72","2","134","320","0","41.88","18.75"
"10","010","00","017","1702","0467","166","93","73","8","174","304","0","57.24","30.59"
"10","010","00","017","1703","0000","242","120","122","8","250","418","0","59.81","28.71"
"10","010","00","017","1703","0468","91","50","41","2","93","184","0","50.54","27.17"
"10","010","00","017","1703","0469","151","70","81","6","157","234","0","67.09","29.91"
"10","010","00","017","1704","0000","467","210","257","16","483","920","0","52.5","22.83"
"10","010","00","017","1704","0470","253","112","141","8","261","495","0","52.73","22.63"
"10","010","00","017","1704","0471","112","45","67","1","113","199","0","56.78","22.61"
"10","010","00","017","1704","0472","102","53","49","7","109","226","0","48.23","23.45"
"10","010","00","017","1705","0000","328","147","181","19","347","569","0","60.98","25.83"
"10","010","00","017","1705","0473","328","147","181","19","347","569","0","60.98","25.83"
"10","010","00","018","0000","0000","2083","668","1415","94","2177","4691","5610","46.41","14.24"
"10","010","00","018","1801","0000","179","66","113","8","187","371","0","50.4","17.79"
"10","010","00","018","1801","0474","179","66","113","8","187","371","0","50.4","17.79"
"10","010","00","018","1802","0000","83","25","58","3","86","197","0","43.65","12.69"
"10","010","00","018","1802","0475","83","25","58","3","86","197","0","43.65","12.69"
"10","010","00","018","1803","0000","74","29","45","1","75","152","0","49.34","19.08"
"10","010","00","018","1803","0476","74","29","45","1","75","152","0","49.34","19.08"
"10","010","00","018","1804","0000","96","45","51","3","99","303","0","32.67","14.85"
"10","010","00","018","1804","0477","75","35","40","3","78","231","0","33.77","15.15"
"10","010","00","018","1804","0478","21","10","11","0","21","72","0","29.17","13.89"
"10","010","00","018","1805","0000","152","44","108","11","163","306","0","53.27","14.38"
"10","010","00","018","1805","0480","152","44","108","11","163","306","0","53.27","14.38"
"10","010","00","018","1806","0000","131","45","86","3","134","311","0","43.09","14.47"
"10","010","00","018","1806","0479","131","45","86","3","134","311","0","43.09","14.47"
"10","010","00","018","1807","0000","435","110","325","19","454","827","0","54.9","13.3"
"10","010","00","018","1807","0482","435","110","325","19","454","827","0","54.9","13.3"
"10","010","00","018","1808","0000","438","152","286","13","451","970","0","46.49","15.67"
"10","010","00","018","1808","0481","438","152","286","13","451","970","0","46.49","15.67"
"10","010","00","018","1809","0000","125","34","91","1","126","238","0","52.94","14.29"
"10","010","00","018","1809","0483","125","34","91","1","126","238","0","52.94","14.29"
"10","010","00","018","1810","0000","126","29","97","9","135","479","0","28.18","6.05"
"10","010","00","018","1810","0484","126","29","97","9","135","479","0","28.18","6.05"
"10","010","00","018","1811","0000","101","28","73","7","108","291","0","37.11","9.62"
"10","010","00","018","1811","0485","101","28","73","7","108","291","0","37.11","9.62"
"10","010","00","018","1812","0000","143","61","82","16","159","246","0","64.63","24.8"
"10","010","00","018","1812","0486","143","61","82","16","159","246","0","64.63","24.8"
"10","013","00","000","0000","0000","357508","180402","177106","19822","377330","711720","826779","53.02","25.35"
"10","013","00","001","0000","0000","88023","40920","47103","3450","91473","170148","199807","53.76","24.05"
"10","013","00","001","0101","0000","400","212","188","20","420","713","0","58.91","29.73"
"10","013","00","001","0101","0004","400","212","188","20","420","713","0","58.91","29.73"
"10","013","00","001","0102","0000","142","82","60","3","145","249","0","58.23","32.93"
"10","013","00","001","0102","0007","142","82","60","3","145","249","0","58.23","32.93"
"10","013","00","001","0103","0000","161","104","57","5","166","294","0","56.46","35.37"
"10","013","00","001","0103","0002","161","104","57","5","166","294","0","56.46","35.37"
"10","013","00","001","0104","0000","326","190","136","4","330","582","0","56.7","32.65"
"10","013","00","001","0104","0003","326","190","136","4","330","582","0","56.7","32.65"
"10","013","00","001","0105","0000","275","113","162","9","284","455","0","62.42","24.84"
"10","013","00","001","0105","0006","275","113","162","9","284","455","0","62.42","24.84"
"10","013","00","001","0106","0000","127","76","51","2","129","237","0","54.43","32.07"
"10","013","00","001","0106","0001","127","76","51","2","129","237","0","54.43","32.07"
"10","013","00","001","0107","0000","307","281","26","14","321","572","0","56.12","49.13"
"10","013","00","001","0107","0005","307","281","26","14","321","572","0","56.12","49.13"
"10","013","00","001","0108","0000","427","211","216","23","450","713","0","63.11","29.59"
"10","013","00","001","0108","0010","427","211","216","23","450","713","0","63.11","29.59"
"10","013","00","001","0109","0000","353","202","151","21","374","573","0","65.27","35.25"
"10","013","00","001","0109","0011","353","202","151","21","374","573","0","65.27","35.25"
"10","013","00","001","0110","0000","275","149","126","6","281","409","0","68.7","36.43"
"10","013","00","001","0110","0013","275","149","126","6","281","409","0","68.7","36.43"
"10","013","00","001","0111","0000","193","128","65","8","201","297","0","67.68","43.1"
"10","013","00","001","0111","0012","193","128","65","8","201","297","0","67.68","43.1"
"10","013","00","001","0112","0000","1054","718","336","56","1110","2688","0","41.29","26.71"
"10","013","00","001","0112","0008","645","337","308","27","672","1315","0","51.1","25.63"
"10","013","00","001","0112","0009","409","381","28","29","438","1373","0","31.9","27.75"
"10","013","00","001","0113","0000","246","142","104","9","255","459","0","55.56","30.94"
"10","013","00","001","0113","0017","246","142","104","9","255","459","0","55.56","30.94"
"10","013","00","001","0114","0000","430","228","202","14","444","672","0","66.07","33.93"
"10","013","00","001","0114","0018","430","228","202","14","444","672","0","66.07","33.93"
"10","013","00","001","0115","0000","254","147","107","7","261","421","0","62.0","34.92"
"10","013","00","001","0115","0015","254","147","107","7","261","421","0","62.0","34.92"
"10","013","00","001","0116","0000","342","201","141","7","349","569","0","61.34","35.33"
"10","013","00","001","0116","0016","342","201","141","7","349","569","0","61.34","35.33"
"10","013","00","001","0117","0000","153","89","64","7","160","286","0","55.94","31.12"
"10","013","00","001","0117","0014","153","89","64","7","160","286","0","55.94","31.12"
"10","013","00","001","0118","0000","402","237","165","26","428","668","0","64.07","35.48"
"10","013","00","001","0118","0019","402","237","165","26","428","668","0","64.07","35.48"
"10","013","00","001","0119","0000","245","129","116","8","253","411","0","61.56","31.39"
"10","013","00","001","0119","0020","245","129","116","8","253","411","0","61.56","31.39"
"10","013","00","001","0120","0000","855","454","401","30","885","1554","0","56.95","29.21"
"10","013","00","001","0120","0021","430","248","182","15","445","768","0","57.94","32.29"
"10","013","00","001","0120","0022","425","206","219","15","440","786","0","55.98","26.21"
"10","013","00","001","0121","0000","511","264","247","23","534","890","0","60.0","29.66"
"10","013","00","001","0121","0023","511","264","247","23","534","890","0","60.0","29.66"
"10","013","00","001","0122","0000","1044","460","584","45","1089","1911","0","56.99","24.07"
"10","013","00","001","0122","0039","509","240","269","20","529","939","0","56.34","25.56"
"10","013","00","001","0122","0040","535","220","315","25","560","972","0","57.61","22.63"
"10","013","00","001","0123","0000","1445","671","774","43","1488","2517","0","59.12","26.66"
"10","013","00","001","0123","0034","748","334","414","16","764","1258","0","60.73","26.55"
"10","013","00","001","0123","0035","697","337","360","27","724","1259","0","57.51","26.77"
"10","013","00","001","0124","0000","1958","864","1094","71","2029","3556","0","57.06","24.3"
"10","013","00","001","0124","0036","573","234","339","24","597","1076","0","55.48","21.75"
"10","013","00","001","0124","0037","647","299","348","26","673","1162","0","57.92","25.73"
"10","013","00","001","0124","0038","738","331","407","21","759","1318","0","57.59","25.11"
"10","013","00","001","0125","0000","2148","948","1200","79","2227","4039","0","55.14","23.47"
"10","013","00","001","0125","0031","724","349","375","30","754","1297","0","58.13","26.91"
"10","013","00","001","0125","0032","736","302","434","18","754","1361","0","55.4","22.19"
"10","013","00","001","0125","0033","688","297","391","31","719","1381","0","52.06","21.51"
"10","013","00","001","0126","0000","5012","2123","2889","165","5177","9307","0","55.62","22.81"
"10","013","00","001","0126","0024","734","308","426","30","764","1353","0","56.47","22.76"
"10","013","00","001","0126","0025","723","301","422","19","742","1386","0","53.54","21.72"
"10","013","00","001","0126","0026","739","285","454","25","764","1413","0","54.07","20.17"
"10","013","00","001","0126","0027","663","309","354","27","690","1272","0","54.25","24.29"
"10","013","00","001","0126","0028","692","287","405","23","715","1287","0","55.56","22.3"
"10","013","00","001","0126","0029","759","304","455","24","783","1311","0","59.73","23.19"
"10","013","00","001","0126","0030","702","329","373","17","719","1285","0","55.95","25.6"
"10","013","00","001","0127","0000","717","425","292","52","769","1540","0","49.94","27.6"
"10","013","00","001","0127","0047","717","425","292","52","769","1540","0","49.94","27.6"
"10","013","00","001","0128","0000","572","322","250","25","597","1061","0","56.27","30.35"
"10","013","00","001","0128","0046","572","322","250","25","597","1061","0","56.27","30.35"
"10","013","00","001","0129","0000","596","350","246","9","605","1141","0","53.02","30.67"
"10","013","00","001","0129","0048","596","350","246","9","605","1141","0","53.02","30.67"
"10","013","00","001","0130","0000","3726","1658","2068","130","3856","7243","0","53.24","22.89"
"10","013","00","001","0130","0041","850","378","472","24","874","1535","0","56.94","24.63"
"10","013","00","001","0130","0042","663","287","376","31","694","1419","0","48.91","20.23"
"10","013","00","001","0130","0043","702","289","413","8","710","1398","0","50.79","20.67"
"10","013","00","001","0130","0044","720","353","367","38","758","1405","0","53.95","25.12"
"10","013","00","001","0130","0045","791","351","440","29","820","1486","0","55.18","23.62"
"10","013","00","001","0131","0000","2862","1380","1482","128","2990","5428","0","55.08","25.42"
"10","013","00","001","0131","0075","775","417","358","41","816","1485","0","54.95","28.08"
"10","013","00","001","0131","0076","742","376","366","33","775","1387","0","55.88","27.11"
"10","013","00","001","0131","0077","482","229","253","16","498","953","0","52.26","24.03"
"10","013","00","001","0131","0078","863","358","505","38","901","1603","0","56.21","22.33"
"10","013","00","001","0132","0000","299","188","111","14","313","535","0","58.5","35.14"
"10","013","00","001","0132","0079","299","188","111","14","313","535","0","58.5","35.14"
"10","013","00","001","0133","0000","1349","743","606","49","1398","2843","0","49.17","26.13"
"10","013","00","001","0133","0089","573","322","251","13","586","1215","0","48.23","26.5"
"10","013","00","001","0133","0090","776","421","355","36","812","1628","0","49.88","25.86"
"10","013","00","001","0134","0000","443","234","209","33","476","867","0","54.9","26.99"
"10","013","00","001","0134","0086","443","234","209","33","476","867","0","54.9","26.99"
"10","013","00","001","0135","0000","501","222","279","22","523","918","0","56.97","24.18"
"10","013","00","001","0135","0087","501","222","279","22","523","918","0","56.97","24.18"
"10","013","00","001","0136","0000","659","301","358","20","679","1209","0","56.16","24.9"
"10","013","00","001","0136","0091","659","301","358","20","679","1209","0","56.16","24.9"
"10","013","00","001","0137","0000","323","192","131","26","349","663","0","52.64","28.96"
"10","013","00","001","0137","0088","323","192","131","26","349","663","0","52.64","28.96"
"10","013","00","001","0138","0000","690","258","432","14","704","1110","0","63.42","23.24"
"10","013","00","001","0138","0092","690","258","432","14","704","1110","0","63.42","23.24"
"10","013","00","001","0139","0000","324","182","142","10","334","684","0","48.83","26.61"
"10","013","00","001","0139","0093","324","182","142","10","334","684","0","48.83","26.61"
"10","013","00","001","0140","0000","3607","1819","1788","133","3740","7190","0","52.02","25.3"
"10","013","00","001","0140","0094","618","348","270","23","641","1349","0","47.52","25.8"
"10","013","00","001","0140","0095","713","340","373","30","743","1457","0","51.0","23.34"
"10","013","00","001","0140","0096","739","322","417","26","765","1447","0","52.87","22.25"
"10","013","00","001","0140","0097","673","347","326","17","690","1354","0","50.96","25.63"
"10","013","00","001","0140","0098","864","462","402","37","901","1583","0","56.92","29.19"
"10","013","00","001","0141","0000","1260","634","626","47","1307","2503","0","52.22","25.33"
"10","013","00","001","0141","0072","668","388","280","22","690","1284","0","53.74","30.22"
"10","013","00","001","0141","0073","592","246","346","25","617","1219","0","50.62","20.18"
"10","013","00","001","0142","0000","826","418","408","57","883","1544","0","57.19","27.07"
"10","013","00","001","0142","0074","826","418","408","57","883","1544","0","57.19","27.07"
"10","013","00","001","0143","0000","1153","638","515","67","1220","2266","0","53.84","28.16"
"10","013","00","001","0143","0083","614","361","253","31","645","1227","0","52.57","29.42"
"10","013","00","001","0143","0084","539","277","262","36","575","1039","0","55.34","26.66"
"10","013","00","001","0144","0000","739","395","344","61","800","1485","0","53.87","26.6"
"10","013","00","001","0144","0085","739","395","344","61","800","1485","0","53.87","26.6"
"10","013","00","001","0145","0000","584","305","279","32","616","1119","0","55.05","27.26"
"10","013","00","001","0145","0080","584","305","279","32","616","1119","0","55.05","27.26"
"10","013","00","001","0146","0000","975","507","468","63","1038","1770","0","58.64","28.64"
"10","013","00","001","0146","0081","452","203","249","29","481","847","0","56.79","23.97"
"10","013","00","001","0146","0082","523","304","219","34","557","923","0","60.35","32.94"
"10","013","00","001","0147","0000","157","71","86","5","162","391","0","41.43","18.16"
"10","013","00","001","0147","0060","157","71","86","5","162","391","0","41.43","18.16"
"10","013","00","001","0148","0000","122","48","74","0","122","231","0","52.81","20.78"
"10","013","00","001","0148","0063","122","48","74","0","122","231","0","52.81","20.78"
"10","013","00","001","0149","0000","1033","550","483","56","1089","1998","0","54.5","27.53"
"10","013","00","001","0149","0064","491","265","226","30","521","945","0","55.13","28.04"
"10","013","00","001","0149","0065","542","285","257","26","568","1053","0","53.94","27.07"
"10","013","00","001","0150","0000","516","288","228","31","547","1043","0","52.44","27.61"
"10","013","00","001","0150","0066","516","288","228","31","547","1043","0","52.44","27.61"
"10","013","00","001","0151","0000","676","408","268","23","699","1205","0","58.01","33.86"
"10","013","00","001","0151","0071","676","408","268","23","699","1205","0","58.01","33.86"
"10","013","00","001","0153","0000","4333","1981","2352","155","4488","8175","0","54.9","24.23"
"10","013","00","001","0153","0052","667","281","386","24","691","1253","0","55.15","22.43"
"10","013","00","001","0153","0053","690","315","375","28","718","1315","0","54.6","23.95"
"10","013","00","001","0153","0054","696","330","366","30","726","1425","0","50.95","23.16"
"10","013","00","001","0153","0055","739","368","371","18","757","1423","0","53.2","25.86"
"10","013","00","001","0153","0056","772","334","438","29","801","1400","0","57.21","23.86"
"10","013","00","001","0153","0057","769","353","416","26","795","1359","0","58.5","25.97"
"10","013","00","001","0154","0000","1437","792","645","138","1575","2922","0","53.9","27.1"
"10","013","00","001","0154","0069","740","412","328","104","844","1468","0","57.49","28.07"
"10","013","00","001","0154","0070","697","380","317","34","731","1454","0","50.28","26.13"
"10","013","00","001","0155","0000","2026","878","1148","72","2098","3996","0","52.5","21.97"
"10","013","00","001","0155","0049","600","295","305","20","620","1247","0","49.72","23.66"
"10","013","00","001","0155","0050","706","287","419","30","736","1446","0","50.9","19.85"
"10","013","00","001","0155","0051","720","296","424","22","742","1303","0","56.95","22.72"
"10","013","00","001","0156","0000","984","589","395","39","1023","1937","0","52.81","30.41"
"10","013","00","001","0156","0067","538","336","202","22","560","1061","0","52.78","31.67"
"10","013","00","001","0156","0068","446","253","193","17","463","876","0","52.85","28.88"
"10","013","00","001","0157","0000","161","93","68","9","170","328","0","51.83","28.35"
"10","013","00","001","0157","0062","161","93","68","9","170","328","0","51.83","28.35"
"10","013","00","001","0158","0000","113","53","60","4","117","200","0","58.5","26.5"
"10","013","00","001","0158","0061","113","53","60","4","117","200","0","58.5","26.5"
"10","013","00","001","0159","0000","956","451","505","27","983","1722","0","57.08","26.19"
"10","013","00","001","0159","0122","462","231","231","11","473","853","0","55.45","27.08"
"10","013","00","001","0159","0123","494","220","274","16","510","869","0","58.69","25.32"
"10","013","00","001","0160","0000","2546","1092","1454","96","2642","4870","0","54.25","22.42"
"10","013","00","001","0160","0124","645","293","352","27","672","1169","0","57.49","25.06"
"10","013","00","001","0160","0125","571","265","306","21","592","1058","0","55.95","25.05"
"10","013","00","001","0160","0126","649","259","390","25","674","1344","0","50.15","19.27"
"10","013","00","001","0160","0127","681","275","406","23","704","1299","0","54.2","21.17"
"10","013","00","001","0161","0000","419","189","230","18","437","744","0","58.74","25.4"
"10","013","00","001","0161","0143","419","189","230","18","437","744","0","58.74","25.4"
"10","013","00","001","0162","0000","355","165","190","12","367","678","0","54.13","24.34"
"10","013","00","001","0162","0144","355","165","190","12","367","678","0","54.13","24.34"
"10","013","00","001","0163","0000","398","199","199","16","414","681","0","60.79","29.22"
"10","013","00","001","0163","0145","398","199","199","16","414","681","0","60.79","29.22"
"10","013","00","001","0164","0000","2402","935","1467","77","2479","4705","0","52.69","19.87"
"10","013","00","001","0164","0140","828","336","492","30","858","1491","0","57.55","22.54"
"10","013","00","001","0164","0141","670","276","394","24","694","1411","0","49.18","19.56"
"10","013","00","001","0164","0142","904","323","581","23","927","1803","0","51.41","17.91"
"10","013","00","001","0165","0000","2491","1053","1438","85","2576","5541","0","46.49","19.0"
"10","013","00","001","0165","0118","507","221","286","25","532","1683","0","31.61","13.13"
"10","013","00","001","0165","0119","758","298","460","16","774","1497","0","51.7","19.91"
"10","013","00","001","0165","0120","574","288","286","24","598","1129","0","52.97","25.51"
"10","013","00","001","0165","0121","652","246","406","20","672","1232","0","54.55","19.97"
"10","013","00","001","0166","0000","889","440","449","29","918","1920","0","47.81","22.92"
"10","013","00","001","0166","0113","400","195","205","16","416","821","0","50.67","23.75"
"10","013","00","001","0166","0114","489","245","244","13","502","1099","0","45.68","22.29"
"10","013","00","001","0167","0000","1168","542","626","48","1216","2327","0","52.26","23.29"
"10","013","00","001","0167","0128","596","287","309","25","621","1204","0","51.58","23.84"
"10","013","00","001","0167","0129","572","255","317","23","595","1123","0","52.98","22.71"
"10","013","00","001","0168","0000","1302","612","690","40","1342","2404","0","55.82","25.46"
"10","013","00","001","0168","0138","730","342","388","21","751","1289","0","58.26","26.53"
"10","013","00","001","0168","0139","572","270","302","19","591","1115","0","53.0","24.22"
"10","013","00","001","0169","0000","3163","1361","1802","100","3263","6072","0","53.74","22.41"
"10","013","00","001","0169","0133","575","274","301","24","599","1215","0","49.3","22.55"
"10","013","00","001","0169","0134","712","279","433","21","733","1370","0","53.5","20.36"
"10","013","00","001","0169","0135","641","288","353","21","662","1240","0","53.39","23.23"
"10","013","00","001","0169","0136","652","288","364","18","670","1168","0","57.36","24.66"
"10","013","00","001","0169","0137","583","232","351","16","599","1079","0","55.51","21.5"
"10","013","00","001","0170","0000","1220","585","635","51","1271","2172","0","58.52","26.93"
"10","013","00","001","0170","0148","584","287","297","32","616","1018","0","60.51","28.19"
"10","013","00","001","0170","0149","636","298","338","19","655","1154","0","56.76","25.82"
"10","013","00","001","0171","0000","1041","499","542","55","1096","2082","0","52.64","23.97"
"10","013","00","001","0171","0116","591","289","302","16","607","1167","0","52.01","24.76"
"10","013","00","001","0171","0117","450","210","240","39","489","915","0","53.44","22.95"
"10","013","00","001","0173","0000","5967","2223","3744","155","6122","11833","0","51.74","18.79"
"10","013","00","001","0173","0099","878","351","527","22","900","1707","0","52.72","20.56"
"10","013","00","001","0173","0100","796","314","482","20","816","1637","0","49.85","19.18"
"10","013","00","001","0173","0101","702","284","418","7","709","1459","0","48.59","19.47"
"10","013","00","001","0173","0102","915","318","597","32","947","1759","0","53.84","18.08"
"10","013","00","001","0173","0103","981","322","659","20","1001","1950","0","51.33","16.51"
"10","013","00","001","0173","0104","891","294","597","31","922","1729","0","53.33","17.0"
"10","013","00","001","0173","0105","804","340","464","23","827","1592","0","51.95","21.36"
"10","013","00","001","0174","0000","823","239","584","49","872","1688","0","51.66","14.16"
"10","013","00","001","0174","0115","823","239","584","49","872","1688","0","51.66","14.16"
"10","013","00","001","0175","0000","5671","2100","3571","186","5857","11483","0","51.01","18.29"
"10","013","00","001","0175","0106","697","272","425","28","725","1437","0","50.45","18.93"
"10","013","00","001","0175","0107","606","252","354","20","626","1204","0","51.99","20.93"
"10","013","00","001","0175","0108","687","258","429","24","711","1340","0","53.06","19.25"
"10","013","00","001","0175","0109","697","283","414","21","718","1322","0","54.31","21.41"
"10","013","00","001","0175","0110","731","254","477","25","756","1462","0","51.71","17.37"
"10","013","00","001","0175","0111","1543","535","1008","49","1592","3241","0","49.12","16.51"
"10","013","00","001","0175","0112","710","246","464","19","729","1477","0","49.36","16.66"
"10","013","00","001","0176","0000","626","321","305","30","656","1318","0","49.77","24.36"
"10","013","00","001","0176","0130","626","321","305","30","656","1318","0","49.77","24.36"
"10","013","00","001","0177","0000","487","265","222","32","519","865","0","60.0","30.64"
"10","013","00","001","0177","0131","487","265","222","32","519","865","0","60.0","30.64"
"10","013","00","001","0178","0000","531","292","239","14","545","1100","0","49.55","26.55"
"10","013","00","001","0178","0132","531","292","239","14","545","1100","0","49.55","26.55"
"10","013","00","001","0179","0000","521","219","302","29","550","954","0","57.65","22.96"
"10","013","00","001","0179","0147","521","219","302","29","550","954","0","57.65","22.96"
"10","013","00","001","0180","0000","719","391","328","21","740","1535","0","48.21","25.47"
"10","013","00","001","0180","0146","719","391","328","21","740","1535","0","48.21","25.47"
"10","013","00","001","0181","0000","1480","402","1078","51","1531","2867","0","53.4","14.02"
"10","013","00","001","0181","0058","693","167","526","23","716","1328","0","53.92","12.58"
"10","013","00","001","0181","0059","787","235","552","28","815","1539","0","52.96","15.27"
"10","013","00","002","0000","0000","23483","11749","11734","1123","24606","46444","53924","52.98","25.3"
"10","013","00","002","0201","0000","286","132","154","20","306","504","0","60.71","26.19"
"10","013","00","002","0201","0150","286","132","154","20","306","504","0","60.71","26.19"
"10","013","00","002","0202","0000","355","200","155","25","380","603","0","63.02","33.17"
"10","013","00","002","0202","0154","355","200","155","25","380","603","0","63.02","33.17"
"10","013","00","002","0203","0000","716","358","358","20","736","1245","0","59.12","28.76"
"10","013","00","002","0203","0170","716","358","358","20","736","1245","0","59.12","28.76"
"10","013","00","002","0204","0000","535","293","242","24","559","972","0","57.51","30.14"
"10","013","00","002","0204","0169","535","293","242","24","559","972","0","57.51","30.14"
"10","013","00","002","0205","0000","2289","1092","1197","91","2380","4759","0","50.01","22.95"
"10","013","00","002","0205","0151","787","379","408","39","826","1711","0","48.28","22.15"
"10","013","00","002","0205","0152","843","404","439","24","867","1634","0","53.06","24.72"
"10","013","00","002","0205","0153","659","309","350","28","687","1414","0","48.59","21.85"
"10","013","00","002","0206","0000","461","282","179","31","492","896","0","54.91","31.47"
"10","013","00","002","0206","0155","461","282","179","31","492","896","0","54.91","31.47"
"10","013","00","002","0207","0000","2756","1293","1463","128","2884","5309","0","54.32","24.35"
"10","013","00","002","0207","0156","640","293","347","37","677","1285","0","52.68","22.8"
"10","013","00","002","0207","0157","840","393","447","32","872","1744","0","50.0","22.53"
"10","013","00","002","0207","0158","588","275","313","31","619","1071","0","57.8","25.68"
"10","013","00","002","0207","0159","688","332","356","28","716","1209","0","59.22","27.46"
"10","013","00","002","0208","0000","3373","1594","1779","156","3529","6490","0","54.38","24.56"
"10","013","00","002","0208","0160","605","297","308","24","629","1159","0","54.27","25.63"
"10","013","00","002","0208","0161","636","292","344","33","669","1296","0","51.62","22.53"
"10","013","00","002","0208","0162","767","354","413","27","794","1466","0","54.16","24.15"
"10","013","00","002","0208","0163","616","306","310","38","654","1130","0","57.88","27.08"
"10","013","00","002","0208","0164","749","345","404","34","783","1439","0","54.41","23.97"
"10","013","00","002","0209","0000","1156","526","630","70","1226","2122","0","57.78","24.79"
"10","013","00","002","0209","0165","499","236","263","35","534","897","0","59.53","26.31"
"10","013","00","002","0209","0166","657","290","367","35","692","1225","0","56.49","23.67"
"10","013","00","002","0210","0000","733","404","329","30","763","1415","0","53.92","28.55"
"10","013","00","002","0210","0171","733","404","329","30","763","1415","0","53.92","28.55"
"10","013","00","002","0211","0000","1024","551","473","38","1062","2313","0","45.91","23.82"
"10","013","00","002","0211","0172","592","292","300","15","607","1255","0","48.37","23.27"
"10","013","00","002","0211","0173","432","259","173","23","455","1058","0","43.01","24.48"
"10","013","00","002","0212","0000","1175","596","579","58","1233","2270","0","54.32","26.26"
"10","013","00","002","0212","0174","592","294","298","26","618","1187","0","52.06","24.77"
"10","013","00","002","0212","0175","583","302","281","32","615","1083","0","56.79","27.89"
"10","013","00","002","0213","0000","3579","1693","1886","133","3712","7022","0","52.86","24.11"
"10","013","00","002","0213","0176","764","397","367","24","788","1590","0","49.56","24.97"
"10","013","00","002","0213","0177","818","370","448","34","852","1543","0","55.22","23.98"
"10","013","00","002","0213","0178","786","378","408","31","817","1631","0","50.09","23.18"
"10","013","00","002","0213","0179","602","254","348","26","628","1159","0","54.18","21.92"
"10","013","00","002","0213","0180","609","294","315","18","627","1099","0","57.05","26.75"
"10","013","00","002","0214","0000","561","276","285","34","595","1200","0","49.58","23.0"
"10","013","00","002","0214","0181","561","276","285","34","595","1200","0","49.58","23.0"
"10","013","00","002","0215","0000","674","326","348","32","706","1391","0","50.75","23.44"
"10","013","00","002","0215","0182","674","326","348","32","706","1391","0","50.75","23.44"
"10","013","00","002","0216","0000","491","200","291","30","521","881","0","59.14","22.7"
"10","013","00","002","0216","0183","491","200","291","30","521","881","0","59.14","22.7"
"10","013","00","002","0217","0000","191","95","96","19","210","454","0","46.26","20.93"
"10","013","00","002","0217","0184","191","95","96","19","210","454","0","46.26","20.93"
"10","013","00","002","0218","0000","766","466","300","46","812","1639","0","49.54","28.43"
"10","013","00","002","0218","0167","562","331","231","25","587","1158","0","50.69","28.58"
"10","013","00","002","0218","0168","204","135","69","21","225","481","0","46.78","28.07"
"10","013","00","002","0219","0000","838","439","399","61","899","1658","0","54.22","26.48"
"10","013","00","002","0219","0185","838","439","399","61","899","1658","0","54.22","26.48"
"10","013","00","002","0220","0000","851","525","326","35","886","1770","0","50.06","29.66"
"10","013","00","002","0220","0186","412","268","144","20","432","822","0","52.55","32.6"
"10","013","00","002","0220","0187","439","257","182","15","454","948","0","47.89","27.11"
"10","013","00","002","0221","0000","673","408","265","42","715","1531","0","46.7","26.65"
"10","013","00","002","0221","0188","496","290","206","28","524","1194","0","43.89","24.29"
"10","013","00","002","0221","0189","177","118","59","14","191","337","0","56.68","35.01"
"10","013","00","003","0000","0000","20087","10734","9353","1208","21295","39495","47654","53.92","27.18"
"10","013","00","003","0301","0000","1178","617","561","56","1234","2051","0","60.17","30.08"
"10","013","00","003","0301","0190","557","273","284","29","586","981","0","59.73","27.83"
"10","013","00","003","0301","0191","621","344","277","27","648","1070","0","60.56","32.15"
"10","013","00","003","0302","0000","322","174","148","26","348","527","0","66.03","33.02"
"10","013","00","003","0302","0192","322","174","148","26","348","527","0","66.03","33.02"
"10","013","00","003","0303","0000","236","121","115","13","249","395","0","63.04","30.63"
"10","013","00","003","0303","0193","236","121","115","13","249","395","0","63.04","30.63"
"10","013","00","003","0304","0000","314","146","168","25","339","659","0","51.44","22.15"
"10","013","00","003","0304","0194","314","146","168","25","339","659","0","51.44","22.15"
"10","013","00","003","0305","0000","268","130","138","17","285","513","0","55.56","25.34"
"10","013","00","003","0305","0195","268","130","138","17","285","513","0","55.56","25.34"
"10","013","00","003","0306","0000","367","183","184","27","394","695","0","56.69","26.33"
"10","013","00","003","0306","0203","367","183","184","27","394","695","0","56.69","26.33"
"10","013","00","003","0307","0000","903","500","403","54","957","1643","0","58.25","30.43"
"10","013","00","003","0307","0204","620","335","285","40","660","1076","0","61.34","31.13"
"10","013","00","003","0307","0205","283","165","118","14","297","567","0","52.38","29.1"
"10","013","00","003","0308","0000","450","275","175","22","472","806","0","58.56","34.12"
"10","013","00","003","0308","0206","450","275","175","22","472","806","0","58.56","34.12"
"10","013","00","003","0309","0000","638","318","320","51","689","1227","0","56.15","25.92"
"10","013","00","003","0309","0207","638","318","320","51","689","1227","0","56.15","25.92"
"10","013","00","003","0310","0000","306","168","138","20","326","599","0","54.42","28.05"
"10","013","00","003","0310","0208","306","168","138","20","326","599","0","54.42","28.05"
"10","013","00","003","0311","0000","552","302","250","35","587","1354","0","43.35","22.3"
"10","013","00","003","0311","0209","552","302","250","35","587","1354","0","43.35","22.3"
"10","013","00","003","0312","0000","916","502","414","111","1027","1841","0","55.78","27.27"
"10","013","00","003","0312","0210","355","212","143","37","392","734","0","53.41","28.88"
"10","013","00","003","0312","0211","561","290","271","74","635","1107","0","57.36","26.2"
"10","013","00","003","0313","0000","1300","722","578","123","1423","2812","0","50.6","25.68"
"10","013","00","003","0313","0212","541","291","250","58","599","1198","0","50.0","24.29"
"10","013","00","003","0313","0213","759","431","328","65","824","1614","0","51.05","26.7"
"10","013","00","003","0314","0000","884","476","408","68","952","1738","0","54.78","27.39"
"10","013","00","003","0314","0214","412","231","181","20","432","826","0","52.3","27.97"
"10","013","00","003","0314","0215","472","245","227","48","520","912","0","57.02","26.86"
"10","013","00","003","0315","0000","839","502","337","83","922","1636","0","56.36","30.68"
"10","013","00","003","0315","0216","209","127","82","18","227","432","0","52.55","29.4"
"10","013","00","003","0315","0217","630","375","255","65","695","1204","0","57.72","31.15"
"10","013","00","003","0316","0000","2734","1443","1291","102","2836","5318","0","53.33","27.13"
"10","013","00","003","0316","0218","696","366","330","37","733","1304","0","56.21","28.07"
"10","013","00","003","0316","0219","737","405","332","23","760","1317","0","57.71","30.75"
"10","013","00","003","0316","0220","687","336","351","22","709","1387","0","51.12","24.22"
"10","013","00","003","0316","0221","614","336","278","20","634","1310","0","48.4","25.65"
"10","013","00","003","0317","0000","945","582","363","57","1002","1994","0","50.25","29.19"
"10","013","00","003","0317","0222","599","371","228","30","629","1228","0","51.22","30.21"
"10","013","00","003","0317","0223","346","211","135","27","373","766","0","48.69","27.55"
"10","013","00","003","0318","0000","760","412","348","44","804","1578","0","50.95","26.11"
"10","013","00","003","0318","0224","454","249","205","26","480","823","0","58.32","30.26"
"10","013","00","003","0318","0225","306","163","143","18","324","755","0","42.91","21.59"
"10","013","00","003","0319","0000","4580","2362","2218","207","4787","8957","0","53.44","26.37"
"10","013","00","003","0319","0196","874","443","431","32","906","1732","0","52.31","25.58"
"10","013","00","003","0319","0197","918","451","467","35","953","1779","0","53.57","25.35"
"10","013","00","003","0319","0198","623","315","308","24","647","1270","0","50.94","24.8"
"10","013","00","003","0319","0199","674","365","309","23","697","1327","0","52.52","27.51"
"10","013","00","003","0319","0200","650","354","296","46","696","1242","0","56.04","28.5"
"10","013","00","003","0319","0201","841","434","407","47","888","1607","0","55.26","27.01"
"10","013","00","003","0320","0000","642","349","293","17","659","1305","0","50.5","26.74"
"10","013","00","003","0320","0202","642","349","293","17","659","1305","0","50.5","26.74"
"10","013","00","003","0321","0000","593","338","255","35","628","1094","0","57.4","30.9"
"10","013","00","003","0321","0226","593","338","255","35","628","1094","0","57.4","30.9"
"10","013","00","003","0322","0000","360","112","248","15","375","753","0","49.8","14.87"
"10","013","00","003","0322","0227","360","112","248","15","375","753","0","49.8","14.87"
"10","013","00","004","0000","0000","11635","5658","5977","631","12266","25661","30812","47.8","22.05"
"10","013","00","004","0401","0000","427","216","211","22","449","902","0","49.78","23.95"
"10","013","00","004","0401","0228","427","216","211","22","449","902","0","49.78","23.95"
"10","013","00","004","0402","0000","1123","530","593","67","1190","2249","0","52.91","23.57"
"10","013","00","004","0402","0229","519","256","263","35","554","969","0","57.17","26.42"
"10","013","00","004","0402","0230","604","274","330","32","636","1280","0","49.69","21.41"
"10","013","00","004","0403","0000","594","274","320","19","613","1133","0","54.1","24.18"
"10","013","00","004","0403","0231","594","274","320","19","613","1133","0","54.1","24.18"
"10","013","00","004","0404","0000","1886","832","1054","87","1973","4159","0","47.44","20.0"
"10","013","00","004","0404","0246","722","304","418","16","738","1505","0","49.04","20.2"
"10","013","00","004","0404","0247","482","237","245","38","520","1111","0","46.8","21.33"
"10","013","00","004","0404","0248","682","291","391","33","715","1543","0","46.34","18.86"
"10","013","00","004","0405","0000","1269","619","650","46","1315","3037","0","43.3","20.38"
"10","013","00","004","0405","0232","663","305","358","16","679","1552","0","43.75","19.65"
"10","013","00","004","0405","0233","606","314","292","30","636","1485","0","42.83","21.14"
"10","013","00","004","0406","0000","460","221","239","24","484","896","0","54.02","24.67"
"10","013","00","004","0406","0234","460","221","239","24","484","896","0","54.02","24.67"
"10","013","00","004","0407","0000","242","132","110","19","261","531","0","49.15","24.86"
"10","013","00","004","0407","0235","242","132","110","19","261","531","0","49.15","24.86"
"10","013","00","004","0408","0000","225","119","106","10","235","478","0","49.16","24.9"
"10","013","00","004","0408","0236","225","119","106","10","235","478","0","49.16","24.9"
"10","013","00","004","0409","0000","454","234","220","35","489","1020","0","47.94","22.94"
"10","013","00","004","0409","0237","454","234","220","35","489","1020","0","47.94","22.94"
"10","013","00","004","0410","0000","434","229","205","16","450","924","0","48.7","24.78"
"10","013","00","004","0410","0238","434","229","205","16","450","924","0","48.7","24.78"
"10","013","00","004","0411","0000","450","225","225","21","471","1079","0","43.65","20.85"
"10","013","00","004","0411","0239","450","225","225","21","471","1079","0","43.65","20.85"
"10","013","00","004","0412","0000","763","409","354","48","811","1588","0","51.07","25.76"
"10","013","00","004","0412","0240","341","188","153","14","355","775","0","45.81","24.26"
"10","013","00","004","0412","0241","422","221","201","34","456","813","0","56.09","27.18"
"10","013","00","004","0413","0000","946","444","502","77","1023","2214","0","46.21","20.05"
"10","013","00","004","0413","0242","493","236","257","35","528","1104","0","47.83","21.38"
"10","013","00","004","0413","0243","453","208","245","42","495","1110","0","44.59","18.74"
"10","013","00","004","0414","0000","529","285","244","45","574","1400","0","41.0","20.36"
"10","013","00","004","0414","0244","259","136","123","38","297","692","0","42.92","19.65"
"10","013","00","004","0414","0245","270","149","121","7","277","708","0","39.12","21.05"
"10","013","00","004","0415","0000","745","349","396","39","784","1672","0","46.89","20.87"
"10","013","00","004","0415","0249","325","147","178","15","340","828","0","41.06","17.75"
"10","013","00","004","0415","0250","420","202","218","24","444","844","0","52.61","23.93"
"10","013","00","004","0416","0000","595","300","295","33","628","1253","0","50.12","23.94"
"10","013","00","004","0416","0251","595","300","295","33","628","1253","0","50.12","23.94"
"10","013","00","004","0417","0000","493","240","253","23","516","1126","0","45.83","21.31"
"10","013","00","004","0417","0252","493","240","253","23","516","1126","0","45.83","21.31"
"10","013","00","005","0000","0000","22009","11585","10424","1308","23317","43478","50595","53.63","26.65"
"10","013","00","005","0501","0000","361","261","100","15","376","595","0","63.19","43.87"
"10","013","00","005","0501","0267","361","261","100","15","376","595","0","63.19","43.87"
"10","013","00","005","0502","0000","476","258","218","24","500","847","0","59.03","30.46"
"10","013","00","005","0502","0262","476","258","218","24","500","847","0","59.03","30.46"
"10","013","00","005","0503","0000","1731","848","883","94","1825","3458","0","52.78","24.52"
"10","013","00","005","0503","0263","575","263","312","26","601","1149","0","52.31","22.89"
"10","013","00","005","0503","0264","576","290","286","36","612","1131","0","54.11","25.64"
"10","013","00","005","0503","0265","580","295","285","32","612","1178","0","51.95","25.04"
"10","013","00","005","0504","0000","415","238","177","13","428","711","0","60.2","33.47"
"10","013","00","005","0504","0266","415","238","177","13","428","711","0","60.2","33.47"
"10","013","00","005","0505","0000","785","397","388","22","807","1403","0","57.52","28.3"
"10","013","00","005","0505","0268","785","397","388","22","807","1403","0","57.52","28.3"
"10","013","00","005","0506","0000","1191","599","592","50","1241","2252","0","55.11","26.6"
"10","013","00","005","0506","0269","549","272","277","25","574","1094","0","52.47","24.86"
"10","013","00","005","0506","0270","642","327","315","25","667","1158","0","57.6","28.24"
"10","013","00","005","0507","0000","1065","408","657","84","1149","2025","0","56.74","20.15"
"10","013","00","005","0507","0271","564","308","256","42","606","963","0","62.93","31.98"
"10","013","00","005","0507","0272","501","100","401","42","543","1062","0","51.13","9.42"
"10","013","00","005","0508","0000","849","433","416","45","894","1684","0","53.09","25.71"
"10","013","00","005","0508","0273","849","433","416","45","894","1684","0","53.09","25.71"
"10","013","00","005","0509","0000","1297","709","588","67","1364","2250","0","60.62","31.51"
"10","013","00","005","0509","0290","605","359","246","33","638","1023","0","62.37","35.09"
"10","013","00","005","0509","0291","692","350","342","34","726","1227","0","59.17","28.52"
"10","013","00","005","0510","0000","548","337","211","26","574","976","0","58.81","34.53"
"10","013","00","005","0510","0275","548","337","211","26","574","976","0","58.81","34.53"
"10","013","00","005","0511","0000","897","510","387","55","952","1860","0","51.18","27.42"
"10","013","00","005","0511","0276","522","280","242","38","560","1013","0","55.28","27.64"
"10","013","00","005","0511","0277","375","230","145","17","392","847","0","46.28","27.15"
"10","013","00","005","0512","0000","825","441","384","87","912","1570","0","58.09","28.09"
"10","013","00","005","0512","0278","825","441","384","87","912","1570","0","58.09","28.09"
"10","013","00","005","0513","0000","671","359","312","41","712","1411","0","50.46","25.44"
"10","013","00","005","0513","0279","671","359","312","41","712","1411","0","50.46","25.44"
"10","013","00","005","0514","0000","415","234","181","36","451","804","0","56.09","29.1"
"10","013","00","005","0514","0282","415","234","181","36","451","804","0","56.09","29.1"
"10","013","00","005","0515","0000","671","415","256","44","715","1284","0","55.69","32.32"
"10","013","00","005","0515","0283","671","415","256","44","715","1284","0","55.69","32.32"
"10","013","00","005","0516","0000","669","375","294","40","709","1430","0","49.58","26.22"
"10","013","00","005","0516","0284","669","375","294","40","709","1430","0","49.58","26.22"
"10","013","00","005","0517","0000","564","310","254","42","606","960","0","63.13","32.29"
"10","013","00","005","0517","0285","564","310","254","42","606","960","0","63.13","32.29"
"10","013","00","005","0518","0000","1064","586","478","75","1139","1944","0","58.59","30.14"
"10","013","00","005","0518","0286","453","252","201","31","484","786","0","61.58","32.06"
"10","013","00","005","0518","0287","611","334","277","44","655","1158","0","56.56","28.84"
"10","013","00","005","0519","0000","742","435","307","39","781","1666","0","46.88","26.11"
"10","013","00","005","0519","0289","742","435","307","39","781","1666","0","46.88","26.11"
"10","013","00","005","0520","0000","713","394","319","29","742","1647","0","45.05","23.92"
"10","013","00","005","0520","0288","713","394","319","29","742","1647","0","45.05","23.92"
"10","013","00","005","0521","0000","825","428","397","19","844","1702","0","49.59","25.15"
"10","013","00","005","0521","0274","825","428","397","19","844","1702","0","49.59","25.15"
"10","013","00","005","0522","0000","990","564","426","68","1058","2096","0","50.48","26.91"
"10","013","00","005","0522","0254","537","321","216","39","576","1147","0","50.22","27.99"
"10","013","00","005","0522","0255","453","243","210","29","482","949","0","50.79","25.61"
"10","013","00","005","0523","0000","558","246","312","33","591","1527","0","38.7","16.11"
"10","013","00","005","0523","0253","558","246","312","33","591","1527","0","38.7","16.11"
"10","013","00","005","0524","0000","550","317","233","57","607","1046","0","58.03","30.31"
"10","013","00","005","0524","0280","550","317","233","57","607","1046","0","58.03","30.31"
"10","013","00","005","0525","0000","932","434","498","40","972","2012","0","48.31","21.57"
"10","013","00","005","0525","0256","456","209","247","24","480","990","0","48.48","21.11"
"10","013","00","005","0525","0257","476","225","251","16","492","1022","0","48.14","22.02"
"10","013","00","005","0526","0000","686","375","311","27","713","1385","0","51.48","27.08"
"10","013","00","005","0526","0281","686","375","311","27","713","1385","0","51.48","27.08"
"10","013","00","005","0527","0000","537","163","374","38","575","1159","0","49.61","14.06"
"10","013","00","005","0527","0259","537","163","374","38","575","1159","0","49.61","14.06"
"10","013","00","005","0528","0000","459","258","201","46","505","837","0","60.33","30.82"
"10","013","00","005","0528","0260","459","258","201","46","505","837","0","60.33","30.82"
"10","013","00","005","0529","0000","329","153","176","41","370","545","0","67.89","28.07"
"10","013","00","005","0529","0258","329","153","176","41","370","545","0","67.89","28.07"
"10","013","00","005","0530","0000","194","100","94","11","205","392","0","52.3","25.51"
"10","013","00","005","0530","0261","194","100","94","11","205","392","0","52.3","25.51"
"10","013","00","006","0000","0000","13569","6734","6835","944","14513","26256","29714","55.27","25.65"
"10","013","00","006","0601","0000","1362","650","712","97","1459","2632","0","55.43","24.7"
"10","013","00","006","0601","0292","535","279","256","37","572","1018","0","56.19","27.41"
"10","013","00","006","0601","0293","827","371","456","60","887","1614","0","54.96","22.99"
"10","013","00","006","0602","0000","1852","788","1064","101","1953","3555","0","54.94","22.17"
"10","013","00","006","0602","0294","985","424","561","52","1037","1848","0","56.11","22.94"
"10","013","00","006","0602","0295","867","364","503","49","916","1707","0","53.66","21.32"
"10","013","00","006","0603","0000","1068","535","533","57","1125","1961","0","57.37","27.28"
"10","013","00","006","0603","0296","531","249","282","19","550","972","0","56.58","25.62"
"10","013","00","006","0603","0297","537","286","251","38","575","989","0","58.14","28.92"
"10","013","00","006","0604","0000","1267","635","632","75","1342","2548","0","52.67","24.92"
"10","013","00","006","0604","0298","402","202","200","43","445","735","0","60.54","27.48"
"10","013","00","006","0604","0299","865","433","432","32","897","1813","0","49.48","23.88"
"10","013","00","006","0605","0000","625","295","330","28","653","1073","0","60.86","27.49"
"10","013","00","006","0605","0300","625","295","330","28","653","1073","0","60.86","27.49"
"10","013","00","006","0606","0000","472","203","269","47","519","884","0","58.71","22.96"
"10","013","00","006","0606","0305","472","203","269","47","519","884","0","58.71","22.96"
"10","013","00","006","0607","0000","587","301","286","46","633","1090","0","58.07","27.61"
"10","013","00","006","0607","0306","587","301","286","46","633","1090","0","58.07","27.61"
"10","013","00","006","0608","0000","758","407","351","68","826","1492","0","55.36","27.28"
"10","013","00","006","0608","0304","758","407","351","68","826","1492","0","55.36","27.28"
"10","013","00","006","0609","0000","842","441","401","45","887","1654","0","53.63","26.66"
"10","013","00","006","0609","0301","842","441","401","45","887","1654","0","53.63","26.66"
"10","013","00","006","0610","0000","626","352","274","46","672","1205","0","55.77","29.21"
"10","013","00","006","0610","0302","626","352","274","46","672","1205","0","55.77","29.21"
"10","013","00","006","0611","0000","407","212","195","26","433","758","0","57.12","27.97"
"10","013","00","006","0611","0303","407","212","195","26","433","758","0","57.12","27.97"
"10","013","00","006","0612","0000","1195","624","571","81","1276","2401","0","53.14","25.99"
"10","013","00","006","0612","0311","641","367","274","65","706","1242","0","56.84","29.55"
"10","013","00","006","0612","0312","554","257","297","16","570","1159","0","49.18","22.17"
"10","013","00","006","0613","0000","922","479","443","86","1008","1770","0","56.95","27.06"
"10","013","00","006","0613","0308","428","232","196","41","469","845","0","55.5","27.46"
"10","013","00","006","0613","0309","494","247","247","45","539","925","0","58.27","26.7"
"10","013","00","006","0614","0000","647","316","331","49","696","1422","0","48.95","22.22"
"10","013","00","006","0614","0307","647","316","331","49","696","1422","0","48.95","22.22"
"10","013","00","006","0615","0000","562","362","200","66","628","1138","0","55.18","31.81"
"10","013","00","006","0615","0310","562","362","200","66","628","1138","0","55.18","31.81"
"10","013","00","006","0616","0000","377","134","243","26","403","673","0","59.88","19.91"
"10","013","00","006","0616","0313","377","134","243","26","403","673","0","59.88","19.91"
"10","013","00","007","0000","0000","5776","3089","2687","226","6002","9970","11068","60.2","30.98"
"10","013","00","007","0701","0000","1245","627","618","50","1295","2174","0","59.57","28.84"
"10","013","00","007","0701","0314","424","214","210","25","449","788","0","56.98","27.16"
"10","013","00","007","0701","0315","821","413","408","25","846","1386","0","61.04","29.8"
"10","013","00","007","0702","0000","568","273","295","26","594","957","0","62.07","28.53"
"10","013","00","007","0702","0316","568","273","295","26","594","957","0","62.07","28.53"
"10","013","00","007","0703","0000","904","516","388","56","960","1537","0","62.46","33.57"
"10","013","00","007","0703","0317","431","251","180","23","454","731","0","62.11","34.34"
"10","013","00","007","0703","0318","473","265","208","33","506","806","0","62.78","32.88"
"10","013","00","007","0704","0000","1437","770","667","50","1487","2547","0","58.38","30.23"
"10","013","00","007","0704","0319","644","370","274","15","659","1207","0","54.6","30.65"
"10","013","00","007","0704","0320","793","400","393","35","828","1340","0","61.79","29.85"
"10","013","00","007","0705","0000","739","432","307","26","765","1221","0","62.65","35.38"
"10","013","00","007","0705","0321","739","432","307","26","765","1221","0","62.65","35.38"
"10","013","00","007","0706","0000","499","265","234","5","504","851","0","59.22","31.14"
"10","013","00","007","0706","0322","499","265","234","5","504","851","0","59.22","31.14"
"10","013","00","007","0707","0000","384","206","178","13","397","683","0","58.13","30.16"
"10","013","00","007","0707","0323","384","206","178","13","397","683","0","58.13","30.16"
"10","013","00","008","0000","0000","9972","5803","4169","605","10577","19132","22095","55.28","30.33"
"10","013","00","008","0801","0000","807","482","325","33","840","1491","0","56.34","32.33"
"10","013","00","008","0801","0324","807","482","325","33","840","1491","0","56.34","32.33"
"10","013","00","008","0802","0000","716","446","270","36","752","1375","0","54.69","32.44"
"10","013","00","008","0802","0325","716","446","270","36","752","1375","0","54.69","32.44"
"10","013","00","008","0803","0000","844","476","368","34","878","1678","0","52.32","28.37"
"10","013","00","008","0803","0326","844","476","368","34","878","1678","0","52.32","28.37"
"10","013","00","008","0804","0000","562","305","257","27","589","1276","0","46.16","23.9"
"10","013","00","008","0804","0328","562","305","257","27","589","1276","0","46.16","23.9"
"10","013","00","008","0805","0000","633","352","281","54","687","1166","0","58.92","30.19"
"10","013","00","008","0805","0327","633","352","281","54","687","1166","0","58.92","30.19"
"10","013","00","008","0806","0000","806","476","330","44","850","1600","0","53.13","29.75"
"10","013","00","008","0806","0334","806","476","330","44","850","1600","0","53.13","29.75"
"10","013","00","008","0807","0000","982","571","411","61","1043","1792","0","58.2","31.86"
"10","013","00","008","0807","0336","982","571","411","61","1043","1792","0","58.2","31.86"
"10","013","00","008","0808","0000","652","368","284","34","686","1248","0","54.97","29.49"
"10","013","00","008","0808","0335","652","368","284","34","686","1248","0","54.97","29.49"
"10","013","00","008","0809","0000","778","430","348","43","821","1482","0","55.4","29.01"
"10","013","00","008","0809","0337","778","430","348","43","821","1482","0","55.4","29.01"
"10","013","00","008","0810","0000","2254","1429","825","176","2430","4414","0","55.05","32.37"
"10","013","00","008","0810","0331","363","216","147","42","405","649","0","62.4","33.28"
"10","013","00","008","0810","0332","1005","742","263","97","1102","1999","0","55.13","37.12"
"10","013","00","008","0810","0333","886","471","415","37","923","1766","0","52.27","26.67"
"10","013","00","008","0811","0000","938","468","470","63","1001","1610","0","62.17","29.07"
"10","013","00","008","0811","0329","571","298","273","33","604","1033","0","58.47","28.85"
"10","013","00","008","0811","0330","367","170","197","30","397","577","0","68.8","29.46"
"10","013","00","009","0000","0000","11661","6451","5210","646","12307","22128","26092","55.62","29.15"
"10","013","00","009","0901","0000","1639","903","736","67","1706","3032","0","56.27","29.78"
"10","013","00","009","0901","0338","883","496","387","36","919","1552","0","59.21","31.96"
"10","013","00","009","0901","0339","756","407","349","31","787","1480","0","53.18","27.5"
"10","013","00","009","0902","0000","656","354","302","20","676","1127","0","59.98","31.41"
"10","013","00","009","0902","0342","656","354","302","20","676","1127","0","59.98","31.41"
"10","013","00","009","0903","0000","467","268","199","30","497","845","0","58.82","31.72"
"10","013","00","009","0903","0343","467","268","199","30","497","845","0","58.82","31.72"
"10","013","00","009","0904","0000","644","347","297","37","681","1282","0","53.12","27.07"
"10","013","00","009","0904","0344","644","347","297","37","681","1282","0","53.12","27.07"
"10","013","00","009","0905","0000","1110","587","523","64","1174","2012","0","58.35","29.17"
"10","013","00","009","0905","0345","546","298","248","27","573","981","0","58.41","30.38"
"10","013","00","009","0905","0346","564","289","275","37","601","1031","0","58.29","28.03"
"10","013","00","009","0906","0000","750","450","300","49","799","1423","0","56.15","31.62"
"10","013","00","009","0906","0347","750","450","300","49","799","1423","0","56.15","31.62"
"10","013","00","009","0907","0000","681","401","280","26","707","1534","0","46.09","26.14"
"10","013","00","009","0907","0340","681","401","280","26","707","1534","0","46.09","26.14"
"10","013","00","009","0908","0000","812","459","353","42","854","1578","0","54.12","29.09"
"10","013","00","009","0908","0341","812","459","353","42","854","1578","0","54.12","29.09"
"10","013","00","009","0909","0000","832","487","345","52","884","1566","0","56.45","31.1"
"10","013","00","009","0909","0348","166","90","76","11","177","363","0","48.76","24.79"
"10","013","00","009","0909","0349","666","397","269","41","707","1203","0","58.77","33.0"
"10","013","00","009","0910","0000","1319","788","531","68","1387","2411","0","57.53","32.68"
"10","013","00","009","0910","0350","614","356","258","31","645","1027","0","62.8","34.66"
"10","013","00","009","0910","0351","705","432","273","37","742","1384","0","53.61","31.21"
"10","013","00","009","0911","0000","1061","472","589","74","1135","2034","0","55.8","23.21"
"10","013","00","009","0911","0352","777","404","373","49","826","1512","0","54.63","26.72"
"10","013","00","009","0911","0353","284","68","216","25","309","522","0","59.2","13.03"
"10","013","00","009","0912","0000","905","487","418","83","988","1829","0","54.02","26.63"
"10","013","00","009","0912","0354","416","211","205","42","458","822","0","55.72","25.67"
"10","013","00","009","0912","0355","489","276","213","41","530","1007","0","52.63","27.41"
"10","013","00","009","0913","0000","518","302","216","19","537","956","0","56.17","31.59"
"10","013","00","009","0913","0356","518","302","216","19","537","956","0","56.17","31.59"
"10","013","00","009","0914","0000","267","146","121","15","282","499","0","56.51","29.26"
"10","013","00","009","0914","0357","267","146","121","15","282","499","0","56.51","29.26"
"10","013","00","010","0000","0000","11032","5568","5464","731","11763","22402","25740","52.51","24.85"
"10","013","00","010","1001","0000","1476","793","683","100","1576","3148","0","50.06","25.19"
"10","013","00","010","1001","0370","714","357","357","30","744","1598","0","46.56","22.34"
"10","013","00","010","1001","0371","762","436","326","70","832","1550","0","53.68","28.13"
"10","013","00","010","1002","0000","1338","756","582","71","1409","2832","0","49.75","26.69"
"10","013","00","010","1002","0365","688","432","256","34","722","1367","0","52.82","31.6"
"10","013","00","010","1002","0366","650","324","326","37","687","1465","0","46.89","22.12"
"10","013","00","010","1003","0000","909","404","505","52","961","1850","0","51.95","21.84"
"10","013","00","010","1003","0358","479","198","281","28","507","951","0","53.31","20.82"
"10","013","00","010","1003","0359","430","206","224","24","454","899","0","50.5","22.91"
"10","013","00","010","1004","0000","1095","516","579","47","1142","2357","0","48.45","21.89"
"10","013","00","010","1004","0360","493","229","264","19","512","1116","0","45.88","20.52"
"10","013","00","010","1004","0361","602","287","315","28","630","1241","0","50.77","23.13"
"10","013","00","010","1005","0000","859","411","448","59","918","1732","0","53.0","23.73"
"10","013","00","010","1005","0362","374","190","184","30","404","770","0","52.47","24.68"
"10","013","00","010","1005","0363","485","221","264","29","514","962","0","53.43","22.97"
"10","013","00","010","1006","0000","587","258","329","51","638","1041","0","61.29","24.78"
"10","013","00","010","1006","0364","587","258","329","51","638","1041","0","61.29","24.78"
"10","013","00","010","1007","0000","829","440","389","31","860","1852","0","46.44","23.76"
"10","013","00","010","1007","0367","405","233","172","26","431","894","0","48.21","26.06"
"10","013","00","010","1007","0368","424","207","217","5","429","958","0","44.78","21.61"
"10","013","00","010","1008","0000","297","157","140","17","314","553","0","56.78","28.39"
"10","013","00","010","1008","0377","297","157","140","17","314","553","0","56.78","28.39"
"10","013","00","010","1009","0000","453","240","213","45","498","924","0","53.9","25.97"
"10","013","00","010","1009","0369","453","240","213","45","498","924","0","53.9","25.97"
"10","013","00","010","1010","0000","844","409","435","47","891","1619","0","55.03","25.26"
"10","013","00","010","1010","0376","844","409","435","47","891","1619","0","55.03","25.26"
"10","013","00","010","1011","0000","1805","922","883","157","1962","3510","0","55.9","26.27"
"10","013","00","010","1011","0372","554","269","285","52","606","1127","0","53.77","23.87"
"10","013","00","010","1011","0373","616","324","292","56","672","1150","0","58.43","28.17"
"10","013","00","010","1011","0374","635","329","306","49","684","1233","0","55.47","26.68"
"10","013","00","010","1012","0000","540","262","278","54","594","984","0","60.37","26.63"
"10","013","00","010","1012","0375","540","262","278","54","594","984","0","60.37","26.63"
"10","013","00","011","0000","0000","10609","6107","4502","740","11349","21697","24444","52.31","28.15"
"10","013","00","011","1101","0000","1054","651","403","45","1099","2138","0","51.4","30.45"
"10","013","00","011","1101","0378","529","315","214","28","557","883","0","63.08","35.67"
"10","013","00","011","1101","0379","525","336","189","17","542","1255","0","43.19","26.77"
"10","013","00","011","1102","0000","741","371","370","22","763","1278","0","59.7","29.03"
"10","013","00","011","1102","0380","741","371","370","22","763","1278","0","59.7","29.03"
"10","013","00","011","1103","0000","369","225","144","9","378","738","0","51.22","30.49"
"10","013","00","011","1103","0381","369","225","144","9","378","738","0","51.22","30.49"
"10","013","00","011","1104","0000","279","171","108","13","292","585","0","49.91","29.23"
"10","013","00","011","1104","0382","279","171","108","13","292","585","0","49.91","29.23"
"10","013","00","011","1105","0000","556","347","209","52","608","1012","0","60.08","34.29"
"10","013","00","011","1105","0383","556","347","209","52","608","1012","0","60.08","34.29"
"10","013","00","011","1106","0000","514","300","214","63","577","1148","0","50.26","26.13"
"10","013","00","011","1106","0384","514","300","214","63","577","1148","0","50.26","26.13"
"10","013","00","011","1107","0000","320","188","132","19","339","591","0","57.36","31.81"
"10","013","00","011","1107","0385","320","188","132","19","339","591","0","57.36","31.81"
"10","013","00","011","1108","0000","356","243","113","26","382","786","0","48.6","30.92"
"10","013","00","011","1108","0386","356","243","113","26","382","786","0","48.6","30.92"
"10","013","00","011","1109","0000","301","159","142","13","314","649","0","48.38","24.5"
"10","013","00","011","1109","0387","301","159","142","13","314","649","0","48.38","24.5"
"10","013","00","011","1110","0000","491","288","203","53","544","1229","0","44.26","23.43"
"10","013","00","011","1110","0388","491","288","203","53","544","1229","0","44.26","23.43"
"10","013","00","011","1111","0000","636","346","290","40","676","1446","0","46.75","23.93"
"10","013","00","011","1111","0389","636","346","290","40","676","1446","0","46.75","23.93"
"10","013","00","011","1112","0000","831","481","350","46","877","1821","0","48.16","26.41"
"10","013","00","011","1112","0390","377","250","127","14","391","899","0","43.49","27.81"
"10","013","00","011","1112","0391","454","231","223","32","486","922","0","52.71","25.05"
"10","013","00","011","1113","0000","566","342","224","39","605","1259","0","48.05","27.16"
"10","013","00","011","1113","0392","566","342","224","39","605","1259","0","48.05","27.16"
"10","013","00","011","1114","0000","474","280","194","16","490","1056","0","46.4","26.52"
"10","013","00","011","1114","0393","474","280","194","16","490","1056","0","46.4","26.52"
"10","013","00","011","1115","0000","566","264","302","56","622","1116","0","55.73","23.66"
"10","013","00","011","1115","0394","566","264","302","56","622","1116","0","55.73","23.66"
"10","013","00","011","1116","0000","523","296","227","52","575","1020","0","56.37","29.02"
"10","013","00","011","1116","0395","523","296","227","52","575","1020","0","56.37","29.02"
"10","013","00","011","1117","0000","529","308","221","51","580","1055","0","54.98","29.19"
"10","013","00","011","1117","0396","529","308","221","51","580","1055","0","54.98","29.19"
"10","013","00","011","1118","0000","659","404","255","55","714","1231","0","58.0","32.82"
"10","013","00","011","1118","0397","437","270","167","27","464","738","0","62.87","36.59"
"10","013","00","011","1118","0398","222","134","88","28","250","493","0","50.71","27.18"
"10","013","00","011","1119","0000","844","443","401","70","914","1539","0","59.39","28.78"
"10","013","00","011","1119","0399","844","443","401","70","914","1539","0","59.39","28.78"
"10","013","00","012","0000","0000","8920","5053","3867","621","9541","17945","20585","53.17","28.16"
"10","013","00","012","1201","0000","627","390","237","29","656","1239","0","52.95","31.48"
"10","013","00","012","1201","0400","627","390","237","29","656","1239","0","52.95","31.48"
"10","013","00","012","1202","0000","424","252","172","21","445","759","0","58.63","33.2"
"10","013","00","012","1202","0401","424","252","172","21","445","759","0","58.63","33.2"
"10","013","00","012","1203","0000","966","582","384","68","1034","1701","0","60.79","34.22"
"10","013","00","012","1203","0402","523","313","210","37","560","932","0","60.09","33.58"
"10","013","00","012","1203","0403","443","269","174","31","474","769","0","61.64","34.98"
"10","013","00","012","1204","0000","460","257","203","48","508","920","0","55.22","27.93"
"10","013","00","012","1204","0404","460","257","203","48","508","920","0","55.22","27.93"
"10","013","00","012","1205","0000","320","190","130","14","334","560","0","59.64","33.93"
"10","013","00","012","1205","0405","320","190","130","14","334","560","0","59.64","33.93"
"10","013","00","012","1206","0000","532","271","261","23","555","1120","0","49.55","24.2"
"10","013","00","012","1206","0406","532","271","261","23","555","1120","0","49.55","24.2"
"10","013","00","012","1207","0000","496","272","224","30","526","1048","0","50.19","25.95"
"10","013","00","012","1207","0407","496","272","224","30","526","1048","0","50.19","25.95"
"10","013","00","012","1208","0000","658","356","302","34","692","1438","0","48.12","24.76"
"10","013","00","012","1208","0408","658","356","302","34","692","1438","0","48.12","24.76"
"10","013","00","012","1209","0000","1086","658","428","89","1175","2027","0","57.97","32.46"
"10","013","00","012","1209","0411","545","335","210","41","586","1020","0","57.45","32.84"
"10","013","00","012","1209","0412","541","323","218","48","589","1007","0","58.49","32.08"
"10","013","00","012","1210","0000","759","415","344","85","844","1647","0","51.24","25.2"
"10","013","00","012","1210","0409","376","218","158","41","417","834","0","50.0","26.14"
"10","013","00","012","1210","0410","383","197","186","44","427","813","0","52.52","24.23"
"10","013","00","012","1211","0000","677","384","293","52","729","1648","0","44.24","23.3"
"10","013","00","012","1211","0413","677","384","293","52","729","1648","0","44.24","23.3"
"10","013","00","012","1212","0000","684","349","335","51","735","1437","0","51.15","24.29"
"10","013","00","012","1212","0414","684","349","335","51","735","1437","0","51.15","24.29"
"10","013","00","012","1213","0000","572","307","265","18","590","1228","0","48.05","25.0"
"10","013","00","012","1213","0415","572","307","265","18","590","1228","0","48.05","25.0"
"10","013","00","012","1214","0000","659","370","289","59","718","1173","0","61.21","31.54"
"10","013","00","012","1214","0416","362","187","175","30","392","597","0","65.66","31.32"
"10","013","00","012","1214","0417","297","183","114","29","326","576","0","56.6","31.77"
"10","013","00","013","0000","0000","22222","11532","10690","1185","23407","47558","54167","49.22","24.25"
"10","013","00","013","1301","0000","1842","906","936","59","1901","3979","0","47.78","22.77"
"10","013","00","013","1301","0418","594","298","296","21","615","1305","0","47.13","22.84"
"10","013","00","013","1301","0419","609","324","285","21","630","1287","0","48.95","25.17"
"10","013","00","013","1301","0420","639","284","355","17","656","1387","0","47.3","20.48"
"10","013","00","013","1302","0000","1471","803","668","79","1550","3145","0","49.28","25.53"
"10","013","00","013","1302","0421","699","400","299","46","745","1540","0","48.38","25.97"
"10","013","00","013","1302","0422","772","403","369","33","805","1605","0","50.16","25.11"
"10","013","00","013","1303","0000","631","338","293","48","679","1326","0","51.21","25.49"
"10","013","00","013","1303","0423","631","338","293","48","679","1326","0","51.21","25.49"
"10","013","00","013","1304","0000","296","152","144","39","335","591","0","56.68","25.72"
"10","013","00","013","1304","0424","296","152","144","39","335","591","0","56.68","25.72"
"10","013","00","013","1305","0000","1061","538","523","49","1110","2202","0","50.41","24.43"
"10","013","00","013","1305","0425","516","273","243","36","552","1123","0","49.15","24.31"
"10","013","00","013","1305","0426","545","265","280","13","558","1079","0","51.71","24.56"
"10","013","00","013","1306","0000","1412","667","745","87","1499","2733","0","54.85","24.41"
"10","013","00","013","1306","0427","736","365","371","44","780","1485","0","52.53","24.58"
"10","013","00","013","1306","0428","676","302","374","43","719","1248","0","57.61","24.2"
"10","013","00","013","1307","0000","2147","1128","1019","84","2231","4482","0","49.78","25.17"
"10","013","00","013","1307","0429","813","435","378","33","846","1569","0","53.92","27.72"
"10","013","00","013","1307","0430","674","343","331","38","712","1493","0","47.69","22.97"
"10","013","00","013","1307","0431","660","350","310","13","673","1420","0","47.39","24.65"
"10","013","00","013","1308","0000","1362","718","644","76","1438","2853","0","50.4","25.17"
"10","013","00","013","1308","0432","660","357","303","39","699","1334","0","52.4","26.76"
"10","013","00","013","1308","0433","702","361","341","37","739","1519","0","48.65","23.77"
"10","013","00","013","1309","0000","895","472","423","33","928","1672","0","55.5","28.23"
"10","013","00","013","1309","0434","402","211","191","19","421","784","0","53.7","26.91"
"10","013","00","013","1309","0435","493","261","232","14","507","888","0","57.09","29.39"
"10","013","00","013","1310","0000","846","484","362","36","882","1915","0","46.06","25.27"
"10","013","00","013","1310","0436","327","196","131","13","340","747","0","45.52","26.24"
"10","013","00","013","1310","0437","519","288","231","23","542","1168","0","46.4","24.66"
"10","013","00","013","1311","0000","908","490","418","53","961","1824","0","52.69","26.86"
"10","013","00","013","1311","0438","295","171","124","19","314","546","0","57.51","31.32"
"10","013","00","013","1311","0439","613","319","294","34","647","1278","0","50.63","24.96"
"10","013","00","013","1312","0000","1249","764","485","63","1312","2898","0","45.27","26.36"
"10","013","00","013","1312","0440","616","385","231","31","647","1348","0","48.0","28.56"
"10","013","00","013","1312","0441","633","379","254","32","665","1550","0","42.9","24.45"
"10","013","00","013","1313","0000","544","290","254","36","580","947","0","61.25","30.62"
"10","013","00","013","1313","0442","544","290","254","36","580","947","0","61.25","30.62"
"10","013","00","013","1314","0000","530","322","208","39","569","1097","0","51.87","29.35"
"10","013","00","013","1314","0443","530","322","208","39","569","1097","0","51.87","29.35"
"10","013","00","013","1315","0000","913","519","394","56","969","2381","0","40.7","21.8"
"10","013","00","013","1315","0444","441","265","176","34","475","1128","0","42.11","23.49"
"10","013","00","013","1315","0445","472","254","218","22","494","1253","0","39.43","20.27"
"10","013","00","013","1316","0000","667","404","263","23","690","1525","0","45.25","26.49"
"10","013","00","013","1316","0446","667","404","263","23","690","1525","0","45.25","26.49"
"10","013","00","013","1317","0000","1107","498","609","80","1187","2431","0","48.83","20.49"
"10","013","00","013","1317","0447","595","277","318","49","644","1215","0","53.0","22.8"
"10","013","00","013","1317","0448","512","221","291","31","543","1216","0","44.65","18.17"
"10","013","00","013","1318","0000","1085","371","714","59","1144","2379","0","48.09","15.59"
"10","013","00","013","1318","0449","607","256","351","25","632","1353","0","46.71","18.92"
"10","013","00","013","1318","0450","478","115","363","34","512","1026","0","49.9","11.21"
"10","013","00","013","1319","0000","395","202","193","28","423","862","0","49.07","23.43"
"10","013","00","013","1319","0451","395","202","193","28","423","862","0","49.07","23.43"
"10","013","00","013","1320","0000","808","417","391","44","852","1775","0","48.0","23.49"
"10","013","00","013","1320","0452","386","218","168","24","410","921","0","44.52","23.67"
"10","013","00","013","1320","0453","422","199","223","20","442","854","0","51.76","23.3"
"10","013","00","013","1321","0000","1054","558","496","59","1113","2434","0","45.73","22.93"
"10","013","00","013","1321","0454","541","292","249","38","579","1230","0","47.07","23.74"
"10","013","00","013","1321","0455","513","266","247","21","534","1204","0","44.35","22.09"
"10","013","00","013","1322","0000","572","299","273","22","594","1301","0","45.66","22.98"
"10","013","00","013","1322","0456","572","299","273","22","594","1301","0","45.66","22.98"
"10","013","00","013","1323","0000","427","192","235","33","460","806","0","57.07","23.82"
"10","013","00","013","1323","0457","427","192","235","33","460","806","0","57.07","23.82"
"10","013","00","014","0000","0000","8445","4570","3875","501","8946","15353","17181","58.27","29.77"
"10","013","00","014","1401","0000","794","435","359","46","840","1503","0","55.89","28.94"
"10","013","00","014","1401","0458","794","435","359","46","840","1503","0","55.89","28.94"
"10","013","00","014","1402","0000","526","281","245","32","558","899","0","62.07","31.26"
"10","013","00","014","1402","0459","526","281","245","32","558","899","0","62.07","31.26"
"10","013","00","014","1403","0000","438","229","209","19","457","716","0","63.83","31.98"
"10","013","00","014","1403","0460","438","229","209","19","457","716","0","63.83","31.98"
"10","013","00","014","1404","0000","363","205","158","23","386","581","0","66.44","35.28"
"10","013","00","014","1404","0461","363","205","158","23","386","581","0","66.44","35.28"
"10","013","00","014","1405","0000","707","376","331","34","741","1327","0","55.84","28.33"
"10","013","00","014","1405","0462","707","376","331","34","741","1327","0","55.84","28.33"
"10","013","00","014","1406","0000","587","332","255","40","627","997","0","62.89","33.3"
"10","013","00","014","1406","0463","587","332","255","40","627","997","0","62.89","33.3"
"10","013","00","014","1407","0000","367","209","158","18","385","649","0","59.32","32.2"
"10","013","00","014","1407","0464","367","209","158","18","385","649","0","59.32","32.2"
"10","013","00","014","1408","0000","333","180","153","16","349","476","0","73.32","37.82"
"10","013","00","014","1408","0465","333","180","153","16","349","476","0","73.32","37.82"
"10","013","00","014","1409","0000","1319","680","639","74","1393","2486","0","56.03","27.35"
"10","013","00","014","1409","0466","707","346","361","41","748","1259","0","59.41","27.48"
"10","013","00","014","1409","0467","612","334","278","33","645","1227","0","52.57","27.22"
"10","013","00","014","1410","0000","301","181","120","24","325","504","0","64.48","35.91"
"10","013","00","014","1410","0468","301","181","120","24","325","504","0","64.48","35.91"
"10","013","00","014","1411","0000","436","228","208","27","463","860","0","53.84","26.51"
"10","013","00","014","1411","0469","436","228","208","27","463","860","0","53.84","26.51"
"10","013","00","014","1412","0000","421","235","186","22","443","800","0","55.38","29.38"
"10","013","00","014","1412","0470","421","235","186","22","443","800","0","55.38","29.38"
"10","013","00","014","1413","0000","629","347","282","40","669","1134","0","58.99","30.6"
"10","013","00","014","1413","0471","629","347","282","40","669","1134","0","58.99","30.6"
"10","013","00","014","1414","0000","623","344","279","52","675","1229","0","54.92","27.99"
"10","013","00","014","1414","0472","623","344","279","52","675","1229","0","54.92","27.99"
"10","013","00","014","1415","0000","601","308","293","34","635","1192","0","53.27","25.84"
"10","013","00","014","1415","0473","601","308","293","34","635","1192","0","53.27","25.84"
"10","013","00","015","0000","0000","4362","2345","2017","284","4646","9033","10035","51.43","25.96"
"10","013","00","015","1501","0000","978","536","442","52","1030","2026","0","50.84","26.46"
"10","013","00","015","1501","0474","813","449","364","37","850","1712","0","49.65","26.23"
"10","013","00","015","1501","0475","165","87","78","15","180","314","0","57.32","27.71"
"10","013","00","015","1502","0000","569","306","263","32","601","1086","0","55.34","28.18"
"10","013","00","015","1502","0476","397","219","178","15","412","752","0","54.79","29.12"
"10","013","00","015","1502","0477","172","87","85","17","189","334","0","56.59","26.05"
"10","013","00","015","1503","0000","517","264","253","39","556","957","0","58.1","27.59"
"10","013","00","015","1503","0478","517","264","253","39","556","957","0","58.1","27.59"
"10","013","00","015","1504","0000","418","249","169","35","453","764","0","59.29","32.59"
"10","013","00","015","1504","0479","418","249","169","35","453","764","0","59.29","32.59"
"10","013","00","015","1505","0000","822","435","387","49","871","1752","0","49.71","24.83"
"10","013","00","015","1505","0480","200","111","89","16","216","373","0","57.91","29.76"
"10","013","00","015","1505","0481","309","168","141","14","323","678","0","47.64","24.78"
"10","013","00","015","1505","0482","313","156","157","19","332","701","0","47.36","22.25"
"10","013","00","015","1506","0000","545","254","291","40","585","1125","0","52.0","22.58"
"10","013","00","015","1506","0484","292","141","151","21","313","541","0","57.86","26.06"
"10","013","00","015","1506","0485","253","113","140","19","272","584","0","46.58","19.35"
"10","013","00","015","1507","0000","513","301","212","37","550","1323","0","41.57","22.75"
"10","013","00","015","1507","0483","513","301","212","37","550","1323","0","41.57","22.75"
"10","013","00","016","0000","0000","10923","5601","5322","735","11658","21394","24413","54.49","26.18"
"10","013","00","016","1601","0000","651","287","364","33","684","1213","0","56.39","23.66"
"10","013","00","016","1601","0486","651","287","364","33","684","1213","0","56.39","23.66"
"10","013","00","016","1602","0000","470","218","252","54","524","891","0","58.81","24.47"
"10","013","00","016","1602","0487","470","218","252","54","524","891","0","58.81","24.47"
"10","013","00","016","1603","0000","464","263","201","32","496","970","0","51.13","27.11"
"10","013","00","016","1603","0488","464","263","201","32","496","970","0","51.13","27.11"
"10","013","00","016","1604","0000","323","194","129","18","341","629","0","54.21","30.84"
"10","013","00","016","1604","0489","323","194","129","18","341","629","0","54.21","30.84"
"10","013","00","016","1605","0000","911","481","430","46","957","1614","0","59.29","29.8"
"10","013","00","016","1605","0490","475","253","222","23","498","840","0","59.29","30.12"
"10","013","00","016","1605","0491","436","228","208","23","459","774","0","59.3","29.46"
"10","013","00","016","1606","0000","2144","1123","1021","112","2256","4157","0","54.27","27.01"
"10","013","00","016","1606","0492","684","385","299","37","721","1379","0","52.28","27.92"
"10","013","00","016","1606","0493","833","418","415","27","860","1502","0","57.26","27.83"
"10","013","00","016","1606","0494","627","320","307","48","675","1276","0","52.9","25.08"
"10","013","00","016","1607","0000","1068","541","527","78","1146","1969","0","58.2","27.48"
"10","013","00","016","1607","0495","485","260","225","36","521","964","0","54.05","26.97"
"10","013","00","016","1607","0496","583","281","302","42","625","1005","0","62.19","27.96"
"10","013","00","016","1608","0000","814","428","386","38","852","1459","0","58.4","29.34"
"10","013","00","016","1608","0497","418","228","190","10","428","734","0","58.31","31.06"
"10","013","00","016","1608","0498","396","200","196","28","424","725","0","58.48","27.59"
"10","013","00","016","1609","0000","1093","584","509","78","1171","2113","0","55.42","27.64"
"10","013","00","016","1609","0499","514","287","227","39","553","1046","0","52.87","27.44"
"10","013","00","016","1609","0500","579","297","282","39","618","1067","0","57.92","27.84"
"10","013","00","016","1610","0000","259","164","95","27","286","718","0","39.83","22.84"
"10","013","00","016","1610","0501","259","164","95","27","286","718","0","39.83","22.84"
"10","013","00","016","1611","0000","384","179","205","41","425","903","0","47.07","19.82"
"10","013","00","016","1611","0502","384","179","205","41","425","903","0","47.07","19.82"
"10","013","00","016","1612","0000","368","188","180","23","391","959","0","40.77","19.6"
"10","013","00","016","1612","0506","368","188","180","23","391","959","0","40.77","19.6"
"10","013","00","016","1613","0000","224","130","94","16","240","427","0","56.21","30.44"
"10","013","00","016","1613","0507","224","130","94","16","240","427","0","56.21","30.44"
"10","013","00","016","1614","0000","1401","617","784","109","1510","2754","0","54.83","22.4"
"10","013","00","016","1614","0503","680","352","328","47","727","1387","0","52.42","25.38"
"10","013","00","016","1614","0504","721","265","456","62","783","1367","0","57.28","19.39"
"10","013","00","016","1615","0000","349","204","145","30","379","618","0","61.33","33.01"
"10","013","00","016","1615","0505","349","204","145","30","379","618","0","61.33","33.01"
"10","013","00","017","0000","0000","15283","8686","6597","1119","16402","30706","34961","53.42","28.29"
"10","013","00","017","1701","0000","917","518","399","63","980","1663","0","58.93","31.15"
"10","013","00","017","1701","0508","439","256","183","32","471","820","0","57.44","31.22"
"10","013","00","017","1701","0509","478","262","216","31","509","843","0","60.38","31.08"
"10","013","00","017","1702","0000","1317","682","635","71","1388","2532","0","54.82","26.94"
"10","013","00","017","1702","0510","607","332","275","36","643","1242","0","51.77","26.73"
"10","013","00","017","1702","0511","710","350","360","35","745","1290","0","57.75","27.13"
"10","013","00","017","1703","0000","1103","601","502","111","1214","2161","0","56.18","27.81"
"10","013","00","017","1703","0512","533","280","253","36","569","1073","0","53.03","26.1"
"10","013","00","017","1703","0513","570","321","249","75","645","1088","0","59.28","29.5"
"10","013","00","017","1704","0000","395","213","182","28","423","845","0","50.06","25.21"
"10","013","00","017","1704","0514","395","213","182","28","423","845","0","50.06","25.21"
"10","013","00","017","1705","0000","451","274","177","26","477","862","0","55.34","31.79"
"10","013","00","017","1705","0515","451","274","177","26","477","862","0","55.34","31.79"
"10","013","00","017","1706","0000","1090","566","524","110","1200","2292","0","52.36","24.69"
"10","013","00","017","1706","0516","541","293","248","48","589","1183","0","49.79","24.77"
"10","013","00","017","1706","0517","549","273","276","62","611","1109","0","55.09","24.62"
"10","013","00","017","1707","0000","1075","584","491","39","1114","2271","0","49.05","25.72"
"10","013","00","017","1707","0518","526","280","246","16","542","1119","0","48.44","25.02"
"10","013","00","017","1707","0519","549","304","245","23","572","1152","0","49.65","26.39"
"10","013","00","017","1708","0000","612","344","268","26","638","1240","0","51.45","27.74"
"10","013","00","017","1708","0522","612","344","268","26","638","1240","0","51.45","27.74"
"10","013","00","017","1709","0000","1076","644","432","57","1133","2194","0","51.64","29.35"
"10","013","00","017","1709","0523","498","300","198","11","509","1120","0","45.45","26.79"
"10","013","00","017","1709","0524","578","344","234","46","624","1074","0","58.1","32.03"
"10","013","00","017","1710","0000","754","470","284","60","814","1598","0","50.94","29.41"
"10","013","00","017","1710","0525","380","234","146","22","402","849","0","47.35","27.56"
"10","013","00","017","1710","0526","374","236","138","38","412","749","0","55.01","31.51"
"10","013","00","017","1711","0000","682","406","276","46","728","1416","0","51.41","28.67"
"10","013","00","017","1711","0527","682","406","276","46","728","1416","0","51.41","28.67"
"10","013","00","017","1712","0000","1089","556","533","73","1162","2134","0","54.45","26.05"
"10","013","00","017","1712","0520","547","259","288","28","575","1030","0","55.83","25.15"
"10","013","00","017","1712","0521","542","297","245","45","587","1104","0","53.17","26.9"
"10","013","00","017","1713","0000","1451","808","643","84","1535","2800","0","54.82","28.86"
"10","013","00","017","1713","0528","455","257","198","36","491","895","0","54.86","28.72"
"10","013","00","017","1713","0529","495","302","193","26","521","933","0","55.84","32.37"
"10","013","00","017","1713","0530","501","249","252","22","523","972","0","53.81","25.62"
"10","013","00","017","1714","0000","2092","1206","886","207","2299","4377","0","52.52","27.55"
"10","013","00","017","1714","0531","631","384","247","63","694","1454","0","47.73","26.41"
"10","013","00","017","1714","0532","878","471","407","87","965","1653","0","58.38","28.49"
"10","013","00","017","1714","0533","583","351","232","57","640","1270","0","50.39","27.64"
"10","013","00","017","1715","0000","1179","814","365","118","1297","2321","0","55.88","35.07"
"10","013","00","017","1715","0534","620","480","140","52","672","1123","0","59.84","42.74"
"10","013","00","017","1715","0535","559","334","225","66","625","1198","0","52.17","27.88"
"10","013","00","018","0000","0000","6220","3400","2820","359","6579","12270","15524","53.62","27.71"
"10","013","00","018","1801","0000","1154","583","571","68","1222","2234","0","54.7","26.1"
"10","013","00","018","1801","0536","583","300","283","25","608","1190","0","51.09","25.21"
"10","013","00","018","1801","0537","571","283","288","43","614","1044","0","58.81","27.11"
"10","013","00","018","1802","0000","1028","558","470","58","1086","2032","0","53.44","27.46"
"10","013","00","018","1802","0538","431","249","182","22","453","818","0","55.38","30.44"
"10","013","00","018","1802","0539","597","309","288","36","633","1214","0","52.14","25.45"
"10","013","00","018","1803","0000","688","344","344","36","724","1253","0","57.78","27.45"
"10","013","00","018","1803","0541","688","344","344","36","724","1253","0","57.78","27.45"
"10","013","00","018","1804","0000","654","359","295","21","675","1325","0","50.94","27.09"
"10","013","00","018","1804","0540","654","359","295","21","675","1325","0","50.94","27.09"
"10","013","00","018","1805","0000","499","284","215","39","538","1039","0","51.78","27.33"
"10","013","00","018","1805","0542","499","284","215","39","538","1039","0","51.78","27.33"
"10","013","00","018","1806","0000","749","446","303","38","787","1549","0","50.81","28.79"
"10","013","00","018","1806","0543","372","213","159","28","400","813","0","49.2","26.2"
"10","013","00","018","1806","0544","377","233","144","10","387","736","0","52.58","31.66"
"10","013","00","018","1807","0000","508","278","230","30","538","934","0","57.6","29.76"
"10","013","00","018","1807","0545","508","278","230","30","538","934","0","57.6","29.76"
"10","013","00","018","1808","0000","940","548","392","69","1009","1904","0","52.99","28.78"
"10","013","00","018","1808","0546","444","262","182","30","474","900","0","52.67","29.11"
"10","013","00","018","1808","0547","496","286","210","39","535","1004","0","53.29","28.49"
"10","013","00","019","0000","0000","8382","4800","3582","503","8885","15691","17842","56.62","30.59"
"10","013","00","019","1901","0000","820","454","366","48","868","1458","0","59.53","31.14"
"10","013","00","019","1901","0548","820","454","366","48","868","1458","0","59.53","31.14"
"10","013","00","019","1902","0000","907","501","406","46","953","1586","0","60.09","31.59"
"10","013","00","019","1902","0549","504","307","197","23","527","891","0","59.15","34.46"
"10","013","00","019","1902","0550","403","194","209","23","426","695","0","61.29","27.91"
"10","013","00","019","1903","0000","933","555","378","60","993","1634","0","60.77","33.97"
"10","013","00","019","1903","0555","474","295","179","37","511","841","0","60.76","35.08"
"10","013","00","019","1903","0556","459","260","199","23","482","793","0","60.78","32.79"
"10","013","00","019","1904","0000","437","243","194","26","463","725","0","63.86","33.52"
"10","013","00","019","1904","0554","437","243","194","26","463","725","0","63.86","33.52"
"10","013","00","019","1905","0000","1758","993","765","96","1854","3189","0","58.14","31.14"
"10","013","00","019","1905","0551","569","330","239","39","608","1015","0","59.9","32.51"
"10","013","00","019","1905","0552","653","367","286","33","686","1171","0","58.58","31.34"
"10","013","00","019","1905","0553","536","296","240","24","560","1003","0","55.83","29.51"
"10","013","00","019","1906","0000","837","513","324","57","894","1816","0","49.23","28.25"
"10","013","00","019","1906","0559","365","256","109","25","390","783","0","49.81","32.69"
"10","013","00","019","1906","0560","472","257","215","32","504","1033","0","48.79","24.88"
"10","013","00","019","1907","0000","647","371","276","36","683","1283","0","53.23","28.92"
"10","013","00","019","1907","0558","647","371","276","36","683","1283","0","53.23","28.92"
"10","013","00","019","1908","0000","523","280","243","28","551","919","0","59.96","30.47"
"10","013","00","019","1908","0557","523","280","243","28","551","919","0","59.96","30.47"
"10","013","00","019","1909","0000","986","576","410","88","1074","1959","0","54.82","29.4"
"10","013","00","019","1909","0561","594","345","249","55","649","1186","0","54.72","29.09"
"10","013","00","019","1909","0562","392","231","161","33","425","773","0","54.98","29.88"
"10","013","00","019","1910","0000","534","314","220","18","552","1122","0","49.2","27.99"
"10","013","00","019","1910","0563","534","314","220","18","552","1122","0","49.2","27.99"
"10","013","00","020","0000","0000","4800","2691","2109","321","5121","9479","10650","54.02","28.39"
"10","013","00","020","2001","0000","845","484","361","54","899","1666","0","53.96","29.05"
"10","013","00","020","2001","0564","428","235","193","32","460","872","0","52.75","26.95"
"10","013","00","020","2001","0565","417","249","168","22","439","794","0","55.29","31.36"
"10","013","00","020","2002","0000","532","301","231","31","563","962","0","58.52","31.29"
"10","013","00","020","2002","0566","532","301","231","31","563","962","0","58.52","31.29"
"10","013","00","020","2003","0000","267","151","116","12","279","466","0","59.87","32.4"
"10","013","00","020","2003","0569","267","151","116","12","279","466","0","59.87","32.4"
"10","013","00","020","2004","0000","395","152","243","21","416","708","0","58.76","21.47"
"10","013","00","020","2004","0570","395","152","243","21","416","708","0","58.76","21.47"
"10","013","00","020","2005","0000","526","290","236","56","582","1033","0","56.34","28.07"
"10","013","00","020","2005","0567","526","290","236","56","582","1033","0","56.34","28.07"
"10","013","00","020","2006","0000","490","290","200","32","522","1007","0","51.84","28.8"
"10","013","00","020","2006","0568","490","290","200","32","522","1007","0","51.84","28.8"
"10","013","00","020","2007","0000","553","310","243","38","591","1044","0","56.61","29.69"
"10","013","00","020","2007","0571","553","310","243","38","591","1044","0","56.61","29.69"
"10","013","00","020","2008","0000","460","299","161","23","483","1071","0","45.1","27.92"
"10","013","00","020","2008","0572","460","299","161","23","483","1071","0","45.1","27.92"
"10","013","00","020","2009","0000","476","272","204","30","506","979","0","51.69","27.78"
"10","013","00","020","2009","0573","476","272","204","30","506","979","0","51.69","27.78"
"10","013","00","020","2010","0000","256","142","114","24","280","543","0","51.57","26.15"
"10","013","00","020","2010","0574","256","142","114","24","280","543","0","51.57","26.15"
"10","013","00","021","0000","0000","8151","4645","3506","530","8681","17063","19172","50.88","27.22"
"10","013","00","021","2101","0000","654","355","299","33","687","1472","0","46.67","24.12"
"10","013","00","021","2101","0575","654","355","299","33","687","1472","0","46.67","24.12"
"10","013","00","021","2102","0000","586","341","245","48","634","1360","0","46.62","25.07"
"10","013","00","021","2102","0576","586","341","245","48","634","1360","0","46.62","25.07"
"10","013","00","021","2103","0000","440","264","176","29","469","804","0","58.33","32.84"
"10","013","00","021","2103","0577","440","264","176","29","469","804","0","58.33","32.84"
"10","013","00","021","2104","0000","871","476","395","39","910","1780","0","51.12","26.74"
"10","013","00","021","2104","0578","458","253","205","28","486","925","0","52.54","27.35"
"10","013","00","021","2104","0579","413","223","190","11","424","855","0","49.59","26.08"
"10","013","00","021","2105","0000","956","550","406","43","999","1988","0","50.25","27.67"
"10","013","00","021","2105","0580","467","267","200","27","494","981","0","50.36","27.22"
"10","013","00","021","2105","0581","489","283","206","16","505","1007","0","50.15","28.1"
"10","013","00","021","2106","0000","961","589","372","55","1016","2127","0","47.77","27.69"
"10","013","00","021","2106","0582","404","246","158","31","435","872","0","49.89","28.21"
"10","013","00","021","2106","0583","557","343","214","24","581","1255","0","46.29","27.33"
"10","013","00","021","2107","0000","503","317","186","47","550","995","0","55.28","31.86"
"10","013","00","021","2107","0584","503","317","186","47","550","995","0","55.28","31.86"
"10","013","00","021","2108","0000","324","188","136","11","335","734","0","45.64","25.61"
"10","013","00","021","2108","0585","324","188","136","11","335","734","0","45.64","25.61"
"10","013","00","021","2109","0000","520","274","246","27","547","1178","0","46.43","23.26"
"10","013","00","021","2109","0586","520","274","246","27","547","1178","0","46.43","23.26"
"10","013","00","021","2110","0000","521","330","191","38","559","1095","0","51.05","30.14"
"10","013","00","021","2110","0587","521","330","191","38","559","1095","0","51.05","30.14"
"10","013","00","021","2111","0000","589","285","304","61","650","1097","0","59.25","25.98"
"10","013","00","021","2111","0588","589","285","304","61","650","1097","0","59.25","25.98"
"10","013","00","021","2112","0000","1226","676","550","99","1325","2433","0","54.46","27.78"
"10","013","00","021","2112","0589","608","364","244","59","667","1273","0","52.4","28.59"
"10","013","00","021","2112","0590","618","312","306","40","658","1160","0","56.72","26.9"
"10","013","00","022","0000","0000","4420","2007","2413","336","4756","10706","12395","44.42","18.75"
"10","013","00","022","2201","0000","848","358","490","55","903","2083","0","43.35","17.19"
"10","013","00","022","2201","0591","438","203","235","26","464","1111","0","41.76","18.27"
"10","013","00","022","2201","0592","410","155","255","29","439","972","0","45.16","15.95"
"10","013","00","022","2202","0000","607","226","381","57","664","1278","0","51.96","17.68"
"10","013","00","022","2202","0593","607","226","381","57","664","1278","0","51.96","17.68"
"10","013","00","022","2203","0000","436","151","285","59","495","976","0","50.72","15.47"
"10","013","00","022","2203","0594","436","151","285","59","495","976","0","50.72","15.47"
"10","013","00","022","2204","0000","743","570","173","43","786","1658","0","47.41","34.38"
"10","013","00","022","2204","0595","743","570","173","43","786","1658","0","47.41","34.38"
"10","013","00","022","2205","0000","414","170","244","28","442","1146","0","38.57","14.83"
"10","013","00","022","2205","0596","414","170","244","28","442","1146","0","38.57","14.83"
"10","013","00","022","2206","0000","380","153","227","37","417","1079","0","38.65","14.18"
"10","013","00","022","2206","0597","380","153","227","37","417","1079","0","38.65","14.18"
"10","013","00","022","2207","0000","580","208","372","25","605","1613","0","37.51","12.9"
"10","013","00","022","2207","0598","580","208","372","25","605","1613","0","37.51","12.9"
"10","013","00","022","2208","0000","412","171","241","32","444","873","0","50.86","19.59"
"10","013","00","022","2208","0599","412","171","241","32","444","873","0","50.86","19.59"
"10","013","00","023","0000","0000","3115","1726","1389","178","3293","7595","8619","43.36","22.73"
"10","013","00","023","2301","0000","617","329","288","42","659","1347","0","48.92","24.42"
"10","013","00","023","2301","0602","230","119","111","13","243","491","0","49.49","24.24"
"10","013","00","023","2301","0603","387","210","177","29","416","856","0","48.6","24.53"
"10","013","00","023","2302","0000","260","166","94","3","263","554","0","47.47","29.96"
"10","013","00","023","2302","0604","260","166","94","3","263","554","0","47.47","29.96"
"10","013","00","023","2303","0000","228","133","95","16","244","647","0","37.71","20.56"
"10","013","00","023","2303","0601","228","133","95","16","244","647","0","37.71","20.56"
"10","013","00","023","2304","0000","286","165","121","24","310","737","0","42.06","22.39"
"10","013","00","023","2304","0600","286","165","121","24","310","737","0","42.06","22.39"
"10","013","00","023","2305","0000","140","54","86","5","145","388","0","37.37","13.92"
"10","013","00","023","2305","0605","140","54","86","5","145","388","0","37.37","13.92"
"10","013","00","023","2306","0000","385","205","180","14","399","922","0","43.28","22.23"
"10","013","00","023","2306","0606","385","205","180","14","399","922","0","43.28","22.23"
"10","013","00","023","2307","0000","439","268","171","17","456","1220","0","37.38","21.97"
"10","013","00","023","2307","0607","217","141","76","9","226","597","0","37.86","23.62"
"10","013","00","023","2307","0608","222","127","95","8","230","623","0","36.92","20.39"
"10","013","00","023","2308","0000","182","113","69","16","198","425","0","46.59","26.59"
"10","013","00","023","2308","0609","182","113","69","16","198","425","0","46.59","26.59"
"10","013","00","023","2309","0000","206","82","124","15","221","428","0","51.64","19.16"
"10","013","00","023","2309","0610","206","82","124","15","221","428","0","51.64","19.16"
"10","013","00","023","2310","0000","172","103","69","9","181","504","0","35.91","20.44"
"10","013","00","023","2310","0611","172","103","69","9","181","504","0","35.91","20.44"
"10","013","00","023","2311","0000","200","108","92","17","217","423","0","51.3","25.53"
"10","013","00","023","2311","0612","200","108","92","17","217","423","0","51.3","25.53"
"10","013","00","024","0000","0000","3042","1516","1526","127","3169","7206","8068","43.98","21.04"
"10","013","00","024","2401","0000","696","347","349","21","717","1575","0","45.52","22.03"
"10","013","00","024","2401","0613","696","347","349","21","717","1575","0","45.52","22.03"
"10","013","00","024","2402","0000","209","122","87","8","217","420","0","51.67","29.05"
"10","013","00","024","2402","0614","209","122","87","8","217","420","0","51.67","29.05"
"10","013","00","024","2403","0000","521","265","256","24","545","1302","0","41.86","20.35"
"10","013","00","024","2403","0616","521","265","256","24","545","1302","0","41.86","20.35"
"10","013","00","024","2404","0000","601","358","243","22","623","1314","0","47.41","27.25"
"10","013","00","024","2404","0617","601","358","243","22","623","1314","0","47.41","27.25"
"10","013","00","024","2405","0000","338","174","164","16","354","602","0","58.8","28.9"
"10","013","00","024","2405","0615","338","174","164","16","354","602","0","58.8","28.9"
"10","013","00","024","2406","0000","385","92","293","14","399","1308","0","30.5","7.03"
"10","013","00","024","2406","0618","385","92","293","14","399","1308","0","30.5","7.03"
"10","013","00","024","2407","0000","136","76","60","12","148","367","0","40.33","20.71"
"10","013","00","024","2407","0619","136","76","60","12","148","367","0","40.33","20.71"
"10","013","00","024","2408","0000","156","82","74","10","166","318","0","52.2","25.79"
"10","013","00","024","2408","0620","156","82","74","10","166","318","0","52.2","25.79"
"10","013","00","025","0000","0000","2459","1336","1123","132","2591","4856","5547","53.36","27.51"
"10","013","00","025","2501","0000","591","282","309","44","635","1032","0","61.53","27.33"
"10","013","00","025","2501","0621","343","157","186","24","367","604","0","60.76","25.99"
"10","013","00","025","2501","0622","248","125","123","20","268","428","0","62.62","29.21"
"10","013","00","025","2502","0000","1067","561","506","52","1119","1900","0","58.89","29.53"
"10","013","00","025","2502","0623","542","272","270","42","584","928","0","62.93","29.31"
"10","013","00","025","2502","0624","525","289","236","10","535","972","0","55.04","29.73"
"10","013","00","025","2503","0000","467","284","183","23","490","1041","0","47.07","27.28"
"10","013","00","025","2503","0625","467","284","183","23","490","1041","0","47.07","27.28"
"10","013","00","025","2504","0000","334","209","125","13","347","883","0","39.3","23.67"
"10","013","00","025","2504","0626","334","209","125","13","347","883","0","39.3","23.67"
"10","013","00","026","0000","0000","3231","1159","2072","244","3475","6373","7694","54.53","18.19"
"10","013","00","026","2601","0000","820","269","551","54","874","1448","0","60.36","18.58"
"10","013","00","026","2601","0630","820","269","551","54","874","1448","0","60.36","18.58"
"10","013","00","026","2602","0000","140","48","92","14","154","323","0","47.68","14.86"
"10","013","00","026","2602","0629","140","48","92","14","154","323","0","47.68","14.86"
"10","013","00","026","2603","0000","294","125","169","53","347","572","0","60.66","21.85"
"10","013","00","026","2603","0628","294","125","169","53","347","572","0","60.66","21.85"
"10","013","00","026","2604","0000","275","102","173","20","295","616","0","47.89","16.56"
"10","013","00","026","2604","0627","275","102","173","20","295","616","0","47.89","16.56"
"10","013","00","026","2605","0000","245","86","159","7","252","726","0","34.71","11.85"
"10","013","00","026","2605","0631","245","86","159","7","252","726","0","34.71","11.85"
"10","013","00","026","2606","0000","266","137","129","23","289","554","0","52.17","24.73"
"10","013","00","026","2606","0632","266","137","129","23","289","554","0","52.17","24.73"
"10","013","00","026","2607","0000","180","92","88","13","193","346","0","55.78","26.59"
"10","013","00","026","2607","0633","180","92","88","13","193","346","0","55.78","26.59"
"10","013","00","026","2608","0000","182","65","117","5","187","458","0","40.83","14.19"
"10","013","00","026","2608","0634","182","65","117","5","187","458","0","40.83","14.19"
"10","013","00","026","2609","0000","392","127","265","21","413","692","0","59.68","18.35"
"10","013","00","026","2609","0635","392","127","265","21","413","692","0","59.68","18.35"
"10","013","00","026","2610","0000","437","108","329","34","471","638","0","73.82","16.93"
"10","013","00","026","2610","0636","437","108","329","34","471","638","0","73.82","16.93"
"10","013","00","027","0000","0000","1585","477","1108","98","1683","2950","3376","57.05","16.17"
"10","013","00","027","2701","0000","669","169","500","36","705","1185","0","59.49","14.26"
"10","013","00","027","2701","0637","244","79","165","23","267","346","0","77.17","22.83"
"10","013","00","027","2701","0638","372","75","297","13","385","677","0","56.87","11.08"
"10","013","00","027","2701","0639","53","15","38","0","53","162","0","32.72","9.26"
"10","013","00","027","2702","0000","184","49","135","30","214","296","0","72.3","16.55"
"10","013","00","027","2702","0641","184","49","135","30","214","296","0","72.3","16.55"
"10","013","00","027","2703","0000","92","22","70","4","96","189","0","50.79","11.64"
"10","013","00","027","2703","0640","92","22","70","4","96","189","0","50.79","11.64"
"10","013","00","027","2704","0000","207","73","134","19","226","450","0","50.22","16.22"
"10","013","00","027","2704","0644","207","73","134","19","226","450","0","50.22","16.22"
"10","013","00","027","2705","0000","156","46","110","1","157","347","0","45.24","13.26"
"10","013","00","027","2705","0643","156","46","110","1","157","347","0","45.24","13.26"
"10","013","00","027","2706","0000","277","118","159","8","285","483","0","59.01","24.43"
"10","013","00","027","2706","0642","277","118","159","8","285","483","0","59.01","24.43"
"10","013","00","028","0000","0000","3304","1118","2186","201","3505","5663","6833","61.89","19.74"
"10","013","00","028","2801","0000","228","94","134","4","232","455","0","50.99","20.66"
"10","013","00","028","2801","0645","228","94","134","4","232","455","0","50.99","20.66"
"10","013","00","028","2802","0000","501","159","342","40","541","821","0","65.9","19.37"
"10","013","00","028","2802","0646","501","159","342","40","541","821","0","65.9","19.37"
"10","013","00","028","2803","0000","538","172","366","15","553","1057","0","52.32","16.27"
"10","013","00","028","2803","0650","538","172","366","15","553","1057","0","52.32","16.27"
"10","013","00","028","2804","0000","496","204","292","24","520","900","0","57.78","22.67"
"10","013","00","028","2804","0651","496","204","292","24","520","900","0","57.78","22.67"
"10","013","00","028","2805","0000","221","72","149","9","230","429","0","53.61","16.78"
"10","013","00","028","2805","0652","221","72","149","9","230","429","0","53.61","16.78"
"10","013","00","028","2806","0000","1320","417","903","109","1429","2001","0","71.41","20.84"
"10","013","00","028","2806","0647","417","172","245","48","465","635","0","73.23","27.09"
"10","013","00","028","2806","0648","491","135","356","30","521","695","0","74.96","19.42"
"10","013","00","028","2806","0649","412","110","302","31","443","671","0","66.02","16.39"
"10","013","00","029","0000","0000","2526","821","1705","243","2769","4344","5403","63.74","18.9"
"10","013","00","029","2901","0000","464","137","327","26","490","859","0","57.04","15.95"
"10","013","00","029","2901","0653","376","104","272","16","392","669","0","58.59","15.55"
"10","013","00","029","2901","0654","88","33","55","10","98","190","0","51.58","17.37"
"10","013","00","029","2902","0000","551","159","392","56","607","922","0","65.84","17.25"
"10","013","00","029","2902","0655","551","159","392","56","607","922","0","65.84","17.25"
"10","013","00","029","2903","0000","401","147","254","49","450","598","0","75.25","24.58"
"10","013","00","029","2903","0656","401","147","254","49","450","598","0","75.25","24.58"
"10","013","00","029","2904","0000","258","94","164","45","303","414","0","73.19","22.71"
"10","013","00","029","2904","0658","258","94","164","45","303","414","0","73.19","22.71"
"10","013","00","029","2905","0000","387","152","235","29","416","780","0","53.33","19.49"
"10","013","00","029","2905","0659","387","152","235","29","416","780","0","53.33","19.49"
"10","013","00","029","2906","0000","465","132","333","38","503","771","0","65.24","17.12"
"10","013","00","029","2906","0657","465","132","333","38","503","771","0","65.24","17.12"
"10","013","00","030","0000","0000","3391","901","2490","268","3659","6257","7445","58.48","14.4"
"10","013","00","030","3001","0000","525","139","386","85","610","917","0","66.52","15.16"
"10","013","00","030","3001","0660","525","139","386","85","610","917","0","66.52","15.16"
"10","013","00","030","3002","0000","271","81","190","6","277","577","0","48.01","14.04"
"10","013","00","030","3002","0661","187","56","131","6","193","361","0","53.46","15.51"
"10","013","00","030","3002","0662","84","25","59","0","84","216","0","38.89","11.57"
"10","013","00","030","3003","0000","481","100","381","37","518","725","0","71.45","13.79"
"10","013","00","030","3003","0663","315","60","255","21","336","445","0","75.51","13.48"
"10","013","00","030","3003","0664","166","40","126","16","182","280","0","65.0","14.29"
"10","013","00","030","3004","0000","605","159","446","43","648","1097","0","59.07","14.49"
"10","013","00","030","3004","0665","605","159","446","43","648","1097","0","59.07","14.49"
"10","013","00","030","3005","0000","516","103","413","44","560","840","0","66.67","12.26"
"10","013","00","030","3005","0666","516","103","413","44","560","840","0","66.67","12.26"
"10","013","00","030","3006","0000","436","124","312","18","454","889","0","51.07","13.95"
"10","013","00","030","3006","0667","436","124","312","18","454","889","0","51.07","13.95"
"10","013","00","030","3007","0000","557","195","362","35","592","1212","0","48.84","16.09"
"10","013","00","030","3007","0668","557","195","362","35","592","1212","0","48.84","16.09"
"10","013","00","031","0000","0000","1177","438","739","46","1223","3923","4903","31.18","11.16"
"10","013","00","031","3101","0000","228","78","150","5","233","909","0","25.63","8.58"
"10","013","00","031","3101","0669","228","78","150","5","233","909","0","25.63","8.58"
"10","013","00","031","3102","0000","220","102","118","15","235","663","0","35.44","15.38"
"10","013","00","031","3102","0670","220","102","118","15","235","663","0","35.44","15.38"
"10","013","00","031","3103","0000","46","16","30","0","46","304","0","15.13","5.26"
"10","013","00","031","3103","0671","46","16","30","0","46","304","0","15.13","5.26"
"10","013","00","031","3104","0000","369","133","236","16","385","928","0","41.49","14.33"
"10","013","00","031","3104","0672","369","133","236","16","385","928","0","41.49","14.33"
"10","013","00","031","3105","0000","190","67","123","8","198","641","0","30.89","10.45"
"10","013","00","031","3105","0673","190","67","123","8","198","641","0","30.89","10.45"
"10","013","00","031","3106","0000","124","42","82","2","126","478","0","26.36","8.79"
"10","013","00","031","3106","0674","124","42","82","2","126","478","0","26.36","8.79"
"10","013","00","032","0000","0000","1979","558","1421","109","2088","4230","5018","49.36","13.19"
"10","013","00","032","3201","0000","376","87","289","10","386","751","0","51.4","11.58"
"10","013","00","032","3201","0675","376","87","289","10","386","751","0","51.4","11.58"
"10","013","00","032","3202","0000","411","116","295","25","436","776","0","56.19","14.95"
"10","013","00","032","3202","0676","411","116","295","25","436","776","0","56.19","14.95"
"10","013","00","032","3203","0000","293","55","238","12","305","711","0","42.9","7.74"
"10","013","00","032","3203","0677","293","55","238","12","305","711","0","42.9","7.74"
"10","013","00","032","3204","0000","157","62","95","29","186","243","0","76.54","25.51"
"10","013","00","032","3204","0678","157","62","95","29","186","243","0","76.54","25.51"
"10","013","00","032","3205","0000","184","59","125","8","192","325","0","59.08","18.15"
"10","013","00","032","3205","0679","184","59","125","8","192","325","0","59.08","18.15"
"10","013","00","032","3206","0000","149","56","93","3","152","476","0","31.93","11.76"
"10","013","00","032","3206","0680","149","56","93","3","152","476","0","31.93","11.76"
"10","013","00","032","3207","0000","259","84","175","13","272","602","0","45.18","13.95"
"10","013","00","032","3207","0681","259","84","175","13","272","602","0","45.18","13.95"
"10","013","00","032","3208","0000","150","39","111","9","159","346","0","45.95","11.27"
"10","013","00","032","3208","0682","150","39","111","9","159","346","0","45.95","11.27"
"10","013","00","033","0000","0000","1715","624","1091","70","1785","4314","5003","41.38","14.46"
"10","013","00","033","3301","0000","767","254","513","39","806","1648","0","48.91","15.41"
"10","013","00","033","3301","0683","136","42","94","7","143","342","0","41.81","12.28"
"10","013","00","033","3301","0684","631","212","419","32","663","1306","0","50.77","16.23"
"10","013","00","033","3302","0000","164","51","113","5","169","693","0","24.39","7.36"
"10","013","00","033","3302","0685","164","51","113","5","169","693","0","24.39","7.36"
"10","013","00","033","3303","0000","168","81","87","7","175","437","0","40.05","18.54"
"10","013","00","033","3303","0686","168","81","87","7","175","437","0","40.05","18.54"
"10","013","00","033","3304","0000","191","70","121","9","200","392","0","51.02","17.86"
"10","013","00","033","3304","0687","191","70","121","9","200","392","0","51.02","17.86"
"10","013","00","033","3305","0000","296","116","180","6","302","593","0","50.93","19.56"
"10","013","00","033","3305","0688","296","116","180","6","302","593","0","50.93","19.56"
"10","013","00","033","3306","0000","129","52","77","4","133","551","0","24.14","9.44"
"10","013","00","033","3306","0689","129","52","77","4","133","551","0","24.14","9.44"
"10","002","00","000","0000","0000","204166","102924","101242","11719","215885","386089","455508","55.92","26.66"
"10","002","00","001","0000","0000","43042","20491","22551","2110","45152","79167","95747","57.03","25.88"
"10","002","00","001","0101","0000","1399","611","788","68","1467","2598","0","56.47","23.52"
"10","002","00","001","0101","0023","376","160","216","21","397","669","0","59.34","23.92"
"10","002","00","001","0101","0024","507","240","267","21","528","923","0","57.2","26.0"
"10","002","00","001","0101","0025","516","211","305","26","542","1006","0","53.88","20.97"
"10","002","00","001","0102","0000","834","352","482","34","868","1747","0","49.69","20.15"
"10","002","00","001","0102","0021","573","234","339","21","594","1282","0","46.33","18.25"
"10","002","00","001","0102","0022","261","118","143","13","274","465","0","58.92","25.38"
"10","002","00","001","0108","0000","1181","526","655","36","1217","2122","0","57.35","24.79"
"10","002","00","001","0108","0029","646","278","368","23","669","1143","0","58.53","24.32"
"10","002","00","001","0108","0030","535","248","287","13","548","979","0","55.98","25.33"
"10","002","00","001","0109","0000","649","328","321","41","690","1214","0","56.84","27.02"
"10","002","00","001","0109","0031","649","328","321","41","690","1214","0","56.84","27.02"
"10","002","00","001","0110","0000","1018","509","509","46","1064","1717","0","61.97","29.64"
"10","002","00","001","0110","0035","547","259","288","19","566","943","0","60.02","27.47"
"10","002","00","001","0110","0036","471","250","221","27","498","774","0","64.34","32.3"
"10","002","00","001","0111","0000","1084","441","643","59","1143","2036","0","56.14","21.66"
"10","002","00","001","0111","0033","528","224","304","29","557","946","0","58.88","23.68"
"10","002","00","001","0111","0034","556","217","339","30","586","1090","0","53.76","19.91"
"10","002","00","001","0112","0000","694","367","327","49","743","1283","0","57.91","28.6"
"10","002","00","001","0112","0032","694","367","327","49","743","1283","0","57.91","28.6"
"10","002","00","001","0113","0000","973","441","532","70","1043","1815","0","57.47","24.3"
"10","002","00","001","0113","0051","473","217","256","34","507","905","0","56.02","23.98"
"10","002","00","001","0113","0052","500","224","276","36","536","910","0","58.9","24.62"
"10","002","00","001","0114","0000","1218","558","660","60","1278","2214","0","57.72","25.2"
"10","002","00","001","0114","0046","607","272","335","24","631","1110","0","56.85","24.5"
"10","002","00","001","0114","0047","611","286","325","36","647","1104","0","58.61","25.91"
"10","002","00","001","0115","0000","1761","819","942","81","1842","3262","0","56.47","25.11"
"10","002","00","001","0115","0040","582","306","276","34","616","1084","0","56.83","28.23"
"10","002","00","001","0115","0041","569","249","320","27","596","1095","0","54.43","22.74"
"10","002","00","001","0115","0042","610","264","346","20","630","1083","0","58.17","24.38"
"10","002","00","001","0116","0000","702","382","320","33","735","1434","0","51.26","26.64"
"10","002","00","001","0116","0053","702","382","320","33","735","1434","0","51.26","26.64"
"10","002","00","001","0117","0000","941","452","489","36","977","1803","0","54.19","25.07"
"10","002","00","001","0117","0059","460","212","248","25","485","909","0","53.36","23.32"
"10","002","00","001","0117","0060","481","240","241","11","492","894","0","55.03","26.85"
"10","002","00","001","0118","0000","965","501","464","61","1026","1560","0","65.77","32.12"
"10","002","00","001","0118","0027","447","242","205","20","467","727","0","64.24","33.29"
"10","002","00","001","0118","0028","518","259","259","41","559","833","0","67.11","31.09"
"10","002","00","001","0119","0000","559","298","261","28","587","966","0","60.77","30.85"
"10","002","00","001","0119","0055","559","298","261","28","587","966","0","60.77","30.85"
"10","002","00","001","0121","0000","890","468","422","62","952","1595","0","59.69","29.34"
"10","002","00","001","0121","0056","388","220","168","27","415","711","0","58.37","30.94"
"10","002","00","001","0121","0057","502","248","254","35","537","884","0","60.75","28.05"
"10","002","00","001","0122","0000","730","366","364","36","766","1326","0","57.77","27.6"
"10","002","00","001","0122","0058","730","366","364","36","766","1326","0","57.77","27.6"
"10","002","00","001","0123","0000","587","313","274","49","636","1152","0","55.21","27.17"
"10","002","00","001","0123","0054","587","313","274","49","636","1152","0","55.21","27.17"
"10","002","00","001","0124","0000","1437","722","715","74","1511","2584","0","58.48","27.94"
"10","002","00","001","0124","0064","762","413","349","55","817","1454","0","56.19","28.4"
"10","002","00","001","0124","0065","675","309","366","19","694","1130","0","61.42","27.35"
"10","002","00","001","0125","0000","1062","539","523","49","1111","2025","0","54.86","26.62"
"10","002","00","001","0125","0066","511","241","270","18","529","1087","0","48.67","22.17"
"10","002","00","001","0125","0067","551","298","253","31","582","938","0","62.05","31.77"
"10","002","00","001","0126","0000","1201","650","551","51","1252","2237","0","55.97","29.06"
"10","002","00","001","0126","0068","697","362","335","26","723","1285","0","56.26","28.17"
"10","002","00","001","0126","0069","504","288","216","25","529","952","0","55.57","30.25"
"10","002","00","001","0127","0000","1674","860","814","112","1786","3123","0","57.19","27.54"
"10","002","00","001","0127","0070","537","281","256","36","573","948","0","60.44","29.64"
"10","002","00","001","0127","0071","575","285","290","34","609","1160","0","52.5","24.57"
"10","002","00","001","0127","0072","562","294","268","42","604","1015","0","59.51","28.97"
"10","002","00","001","0128","0000","649","354","295","38","687","1162","0","59.12","30.46"
"10","002","00","001","0128","0078","649","354","295","38","687","1162","0","59.12","30.46"
"10","002","00","001","0131","0000","487","262","225","31","518","959","0","54.01","27.32"
"10","002","00","001","0131","0075","487","262","225","31","518","959","0","54.01","27.32"
"10","002","00","001","0132","0000","1000","530","470","54","1054","1699","0","62.04","31.19"
"10","002","00","001","0132","0076","490","252","238","31","521","814","0","64.0","30.96"
"10","002","00","001","0132","0077","510","278","232","23","533","885","0","60.23","31.41"
"10","002","00","001","0134","0000","795","408","387","38","833","1388","0","60.01","29.39"
"10","002","00","001","0134","0073","252","117","135","12","264","424","0","62.26","27.59"
"10","002","00","001","0134","0074","543","291","252","26","569","964","0","59.02","30.19"
"10","002","00","001","0135","0000","1551","741","810","91","1642","2933","0","55.98","25.26"
"10","002","00","001","0135","0007","482","231","251","25","507","912","0","55.59","25.33"
"10","002","00","001","0135","0008","722","333","389","43","765","1335","0","57.3","24.94"
"10","002","00","001","0135","0009","347","177","170","23","370","686","0","53.94","25.8"
"10","002","00","001","0136","0000","1206","516","690","44","1250","2252","0","55.51","22.91"
"10","002","00","001","0136","0001","521","221","300","17","538","982","0","54.79","22.51"
"10","002","00","001","0136","0002","685","295","390","27","712","1270","0","56.06","23.23"
"10","002","00","001","0137","0000","885","419","466","32","917","1605","0","57.13","26.11"
"10","002","00","001","0137","0003","462","221","241","12","474","849","0","55.83","26.03"
"10","002","00","001","0137","0004","423","198","225","20","443","756","0","58.6","26.19"
"10","002","00","001","0138","0000","2409","1012","1397","84","2493","4269","0","58.4","23.71"
"10","002","00","001","0138","0010","805","341","464","22","827","1366","0","60.54","24.96"
"10","002","00","001","0138","0011","749","324","425","29","778","1363","0","57.08","23.77"
"10","002","00","001","0138","0012","855","347","508","33","888","1540","0","57.66","22.53"
"10","002","00","001","0139","0000","1611","759","852","71","1682","3045","0","55.24","24.93"
"10","002","00","001","0139","0015","493","253","240","23","516","900","0","57.33","28.11"
"10","002","00","001","0139","0016","490","207","283","22","512","980","0","52.24","21.12"
"10","002","00","001","0139","0017","628","299","329","26","654","1165","0","56.14","25.67"
"10","002","00","001","0140","0000","1464","660","804","56","1520","2695","0","56.4","24.49"
"10","002","00","001","0140","0018","489","184","305","19","508","904","0","56.19","20.35"
"10","002","00","001","0140","0019","445","224","221","20","465","813","0","57.2","27.55"
"10","002","00","001","0140","0020","530","252","278","17","547","978","0","55.93","25.77"
"10","002","00","001","0141","0000","1653","749","904","44","1697","3051","0","55.62","24.55"
"10","002","00","001","0141","0043","585","293","292","9","594","1108","0","53.61","26.44"
"10","002","00","001","0141","0044","481","208","273","13","494","848","0","58.25","24.53"
"10","002","00","001","0141","0045","587","248","339","22","609","1095","0","55.62","22.65"
"10","002","00","001","0142","0000","1746","773","973","95","1841","3156","0","58.33","24.49"
"10","002","00","001","0142","0048","614","275","339","37","651","1134","0","57.41","24.25"
"10","002","00","001","0142","0049","636","267","369","26","662","1146","0","57.77","23.3"
"10","002","00","001","0142","0050","496","231","265","32","528","876","0","60.27","26.37"
"10","002","00","001","0143","0000","1396","582","814","46","1442","2550","0","56.55","22.82"
"10","002","00","001","0143","0013","735","284","451","17","752","1341","0","56.08","21.18"
"10","002","00","001","0143","0014","661","298","363","29","690","1209","0","57.07","24.65"
"10","002","00","001","0144","0000","1006","428","578","55","1061","2000","0","53.05","21.4"
"10","002","00","001","0144","0005","533","227","306","29","562","1107","0","50.77","20.51"
"10","002","00","001","0144","0006","473","201","272","26","499","893","0","55.88","22.51"
"10","002","00","001","0145","0000","460","258","202","41","501","762","0","65.75","33.86"
"10","002","00","001","0145","0026","460","258","202","41","501","762","0","65.75","33.86"
"10","002","00","001","0146","0000","1456","669","787","84","1540","2915","0","52.83","22.95"
"10","002","00","001","0146","0061","607","280","327","33","640","1259","0","50.83","22.24"
"10","002","00","001","0146","0062","395","172","223","23","418","789","0","52.98","21.8"
"10","002","00","001","0146","0063","454","217","237","28","482","867","0","55.59","25.03"
"10","002","00","001","0147","0000","1709","868","841","71","1780","2913","0","61.11","29.8"
"10","002","00","001","0147","0037","566","313","253","26","592","968","0","61.16","32.33"
"10","002","00","001","0147","0038","548","259","289","25","573","926","0","61.88","27.97"
"10","002","00","001","0147","0039","595","296","299","20","615","1019","0","60.35","29.05"
"10","002","00","002","0000","0000","31727","15860","15867","1586","33313","57686","72457","57.75","27.49"
"10","002","00","002","0204","0000","795","436","359","26","821","1475","0","55.66","29.56"
"10","002","00","002","0204","0081","795","436","359","26","821","1475","0","55.66","29.56"
"10","002","00","002","0205","0000","1844","942","902","100","1944","3504","0","55.48","26.88"
"10","002","00","002","0205","0082","751","410","341","50","801","1466","0","54.64","27.97"
"10","002","00","002","0205","0083","580","268","312","25","605","1075","0","56.28","24.93"
"10","002","00","002","0205","0084","513","264","249","25","538","963","0","55.87","27.41"
"10","002","00","002","0206","0000","1378","748","630","76","1454","2677","0","54.31","27.94"
"10","002","00","002","0206","0085","770","433","337","48","818","1511","0","54.14","28.66"
"10","002","00","002","0206","0086","608","315","293","28","636","1166","0","54.55","27.02"
"10","002","00","002","0207","0000","1587","780","807","67","1654","3008","0","54.99","25.93"
"10","002","00","002","0207","0087","702","368","334","36","738","1273","0","57.97","28.91"
"10","002","00","002","0207","0088","885","412","473","31","916","1735","0","52.8","23.75"
"10","002","00","002","0208","0000","1277","622","655","76","1353","2324","0","58.22","26.76"
"10","002","00","002","0208","0089","801","383","418","46","847","1487","0","56.96","25.76"
"10","002","00","002","0208","0090","476","239","237","30","506","837","0","60.45","28.55"
"10","002","00","002","0209","0000","754","418","336","36","790","1312","0","60.21","31.86"
"10","002","00","002","0209","0091","754","418","336","36","790","1312","0","60.21","31.86"
"10","002","00","002","0210","0000","747","396","351","30","777","1502","0","51.73","26.36"
"10","002","00","002","0210","0092","747","396","351","30","777","1502","0","51.73","26.36"
"10","002","00","002","0211","0000","592","289","303","19","611","1138","0","53.69","25.4"
"10","002","00","002","0211","0093","592","289","303","19","611","1138","0","53.69","25.4"
"10","002","00","002","0216","0000","1926","974","952","115","2041","3681","0","55.45","26.46"
"10","002","00","002","0216","0096","593","334","259","35","628","1089","0","57.67","30.67"
"10","002","00","002","0216","0097","687","315","372","27","714","1304","0","54.75","24.16"
"10","002","00","002","0216","0098","646","325","321","53","699","1288","0","54.27","25.23"
"10","002","00","002","0217","0000","1571","780","791","88","1659","2850","0","58.21","27.37"
"10","002","00","002","0217","0102","779","408","371","58","837","1420","0","58.94","28.73"
"10","002","00","002","0217","0103","792","372","420","30","822","1430","0","57.48","26.01"
"10","002","00","002","0218","0000","1559","777","782","83","1642","2804","0","58.56","27.71"
"10","002","00","002","0218","0104","595","291","304","38","633","1075","0","58.88","27.07"
"10","002","00","002","0218","0105","504","245","259","28","532","879","0","60.52","27.87"
"10","002","00","002","0218","0106","460","241","219","17","477","850","0","56.12","28.35"
"10","002","00","002","0219","0000","1970","924","1046","84","2054","3623","0","56.69","25.5"
"10","002","00","002","0219","0111","771","359","412","34","805","1431","0","56.25","25.09"
"10","002","00","002","0219","0112","607","296","311","28","635","1109","0","57.26","26.69"
"10","002","00","002","0219","0113","592","269","323","22","614","1083","0","56.69","24.84"
"10","002","00","002","0220","0000","1499","768","731","63","1562","2692","0","58.02","28.53"
"10","002","00","002","0220","0114","791","407","384","27","818","1404","0","58.26","28.99"
"10","002","00","002","0220","0115","708","361","347","36","744","1288","0","57.76","28.03"
"10","002","00","002","0221","0000","522","266","256","25","547","1183","0","46.24","22.49"
"10","002","00","002","0221","0116","522","266","256","25","547","1183","0","46.24","22.49"
"10","002","00","002","0222","0000","1665","821","844","81","1746","2865","0","60.94","28.66"
"10","002","00","002","0222","0117","633","307","326","29","662","1105","0","59.91","27.78"
"10","002","00","002","0222","0118","584","286","298","23","607","987","0","61.5","28.98"
"10","002","00","002","0222","0119","448","228","220","29","477","773","0","61.71","29.5"
"10","002","00","002","0223","0000","1607","850","757","84","1691","2926","0","57.79","29.05"
"10","002","00","002","0223","0123","552","309","243","21","573","977","0","58.65","31.63"
"10","002","00","002","0223","0124","503","275","228","31","534","972","0","54.94","28.29"
"10","002","00","002","0223","0125","552","266","286","32","584","977","0","59.77","27.23"
"10","002","00","002","0224","0000","2016","952","1064","89","2105","3551","0","59.28","26.81"
"10","002","00","002","0224","0126","793","378","415","33","826","1398","0","59.08","27.04"
"10","002","00","002","0224","0127","552","275","277","23","575","1022","0","56.26","26.91"
"10","002","00","002","0224","0128","671","299","372","33","704","1131","0","62.25","26.44"
"10","002","00","002","0225","0000","2095","948","1147","80","2175","3431","0","63.39","27.63"
"10","002","00","002","0225","0120","837","374","463","32","869","1366","0","63.62","27.38"
"10","002","00","002","0225","0121","567","277","290","17","584","907","0","64.39","30.54"
"10","002","00","002","0225","0122","691","297","394","31","722","1158","0","62.35","25.65"
"10","002","00","002","0226","0000","2545","1233","1312","113","2658","4360","0","60.96","28.28"
"10","002","00","002","0226","0107","634","320","314","32","666","1111","0","59.95","28.8"
"10","002","00","002","0226","0108","681","318","363","31","712","1139","0","62.51","27.92"
"10","002","00","002","0226","0109","677","320","357","20","697","1130","0","61.68","28.32"
"10","002","00","002","0226","0110","553","275","278","30","583","980","0","59.49","28.06"
"10","002","00","002","0227","0000","1727","764","963","127","1854","2990","0","62.01","25.55"
"10","002","00","002","0227","0099","601","256","345","41","642","1036","0","61.97","24.71"
"10","002","00","002","0227","0100","574","239","335","42","616","969","0","63.57","24.66"
"10","002","00","002","0227","0101","552","269","283","44","596","985","0","60.51","27.31"
"10","002","00","002","0228","0000","774","445","329","35","809","1407","0","57.5","31.63"
"10","002","00","002","0228","0079","397","226","171","11","408","689","0","59.22","32.8"
"10","002","00","002","0228","0080","377","219","158","24","401","718","0","55.85","30.5"
"10","002","00","002","0229","0000","744","419","325","54","798","1373","0","58.12","30.52"
"10","002","00","002","0229","0095","744","419","325","54","798","1373","0","58.12","30.52"
"10","002","00","002","0230","0000","533","308","225","35","568","1010","0","56.24","30.5"
"10","002","00","002","0230","0094","533","308","225","35","568","1010","0","56.24","30.5"
"10","002","00","003","0000","0000","18369","9632","8737","1205","19574","34512","39785","56.72","27.91"
"10","002","00","003","0301","0000","1833","1005","828","111","1944","3364","0","57.79","29.88"
"10","002","00","003","0301","0129","636","335","301","41","677","1194","0","56.7","28.06"
"10","002","00","003","0301","0130","595","326","269","31","626","1128","0","55.5","28.9"
"10","002","00","003","0301","0131","602","344","258","39","641","1042","0","61.52","33.01"
"10","002","00","003","0302","0000","570","336","234","20","590","997","0","59.18","33.7"
"10","002","00","003","0302","0132","570","336","234","20","590","997","0","59.18","33.7"
"10","002","00","003","0303","0000","2021","1075","946","127","2148","3693","0","58.16","29.11"
"10","002","00","003","0303","0133","711","352","359","36","747","1303","0","57.33","27.01"
"10","002","00","003","0303","0134","707","377","330","54","761","1260","0","60.4","29.92"
"10","002","00","003","0303","0135","603","346","257","37","640","1130","0","56.64","30.62"
"10","002","00","003","0304","0000","474","277","197","38","512","910","0","56.26","30.44"
"10","002","00","003","0304","0136","294","162","132","25","319","559","0","57.07","28.98"
"10","002","00","003","0304","0137","180","115","65","13","193","351","0","54.99","32.76"
"10","002","00","003","0305","0000","695","374","321","55","750","1323","0","56.69","28.27"
"10","002","00","003","0305","0138","469","256","213","32","501","889","0","56.36","28.8"
"10","002","00","003","0305","0139","226","118","108","23","249","434","0","57.37","27.19"
"10","002","00","003","0307","0000","1645","851","794","106","1751","2945","0","59.46","28.9"
"10","002","00","003","0307","0140","483","241","242","19","502","835","0","60.12","28.86"
"10","002","00","003","0307","0141","532","286","246","34","566","975","0","58.05","29.33"
"10","002","00","003","0307","0142","630","324","306","53","683","1135","0","60.18","28.55"
"10","002","00","003","0308","0000","731","400","331","43","774","1257","0","61.58","31.82"
"10","002","00","003","0308","0143","484","269","215","28","512","788","0","64.97","34.14"
"10","002","00","003","0308","0144","247","131","116","15","262","469","0","55.86","27.93"
"10","002","00","003","0309","0000","1185","522","663","77","1262","2300","0","54.87","22.7"
"10","002","00","003","0309","0148","569","238","331","36","605","1146","0","52.79","20.77"
"10","002","00","003","0309","0149","616","284","332","41","657","1154","0","56.93","24.61"
"10","002","00","003","0310","0000","1287","657","630","81","1368","2398","0","57.05","27.4"
"10","002","00","003","0310","0150","460","246","214","20","480","908","0","52.86","27.09"
"10","002","00","003","0310","0151","347","159","188","18","365","656","0","55.64","24.24"
"10","002","00","003","0310","0152","480","252","228","43","523","834","0","62.71","30.22"
"10","002","00","003","0311","0000","580","261","319","36","616","1025","0","60.1","25.46"
"10","002","00","003","0311","0153","580","261","319","36","616","1025","0","60.1","25.46"
"10","002","00","003","0312","0000","258","150","108","10","268","455","0","58.9","32.97"
"10","002","00","003","0312","0154","258","150","108","10","268","455","0","58.9","32.97"
"10","002","00","003","0313","0000","293","174","119","20","313","535","0","58.5","32.52"
"10","002","00","003","0313","0155","293","174","119","20","313","535","0","58.5","32.52"
"10","002","00","003","0314","0000","333","169","164","18","351","536","0","65.49","31.53"
"10","002","00","003","0314","0156","333","169","164","18","351","536","0","65.49","31.53"
"10","002","00","003","0315","0000","263","113","150","14","277","451","0","61.42","25.06"
"10","002","00","003","0315","0157","263","113","150","14","277","451","0","61.42","25.06"
"10","002","00","003","0316","0000","304","171","133","30","334","593","0","56.32","28.84"
"10","002","00","003","0316","0158","304","171","133","30","334","593","0","56.32","28.84"
"10","002","00","003","0317","0000","245","121","124","12","257","441","0","58.28","27.44"
"10","002","00","003","0317","0159","245","121","124","12","257","441","0","58.28","27.44"
"10","002","00","003","0318","0000","526","252","274","23","549","954","0","57.55","26.42"
"10","002","00","003","0318","0160","526","252","274","23","549","954","0","57.55","26.42"
"10","002","00","003","0319","0000","495","279","216","29","524","952","0","55.04","29.31"
"10","002","00","003","0319","0161","495","279","216","29","524","952","0","55.04","29.31"
"10","002","00","003","0320","0000","545","304","241","47","592","1125","0","52.62","27.02"
"10","002","00","003","0320","0162","545","304","241","47","592","1125","0","52.62","27.02"
"10","002","00","003","0321","0000","699","355","344","60","759","1469","0","51.67","24.17"
"10","002","00","003","0321","0163","388","194","194","43","431","763","0","56.49","25.43"
"10","002","00","003","0321","0164","311","161","150","17","328","706","0","46.46","22.8"
"10","002","00","003","0322","0000","479","244","235","44","523","1068","0","48.97","22.85"
"10","002","00","003","0322","0165","479","244","235","44","523","1068","0","48.97","22.85"
"10","002","00","003","0323","0000","650","389","261","70","720","1240","0","58.06","31.37"
"10","002","00","003","0323","0166","358","197","161","31","389","666","0","58.41","29.58"
"10","002","00","003","0323","0167","292","192","100","39","331","574","0","57.67","33.45"
"10","002","00","003","0324","0000","141","71","70","7","148","351","0","42.17","20.23"
"10","002","00","003","0324","0168","141","71","70","7","148","351","0","42.17","20.23"
"10","002","00","003","0325","0000","373","208","165","33","406","717","0","56.62","29.01"
"10","002","00","003","0325","0169","373","208","165","33","406","717","0","56.62","29.01"
"10","002","00","003","0326","0000","246","156","90","16","262","596","0","43.96","26.17"
"10","002","00","003","0326","0170","158","96","62","5","163","373","0","43.7","25.74"
"10","002","00","003","0326","0171","88","60","28","11","99","223","0","44.39","26.91"
"10","002","00","003","0327","0000","1498","718","780","78","1576","2817","0","55.95","25.49"
"10","002","00","003","0327","0145","416","201","215","26","442","811","0","54.5","24.78"
"10","002","00","003","0327","0146","467","218","249","20","487","867","0","56.17","25.14"
"10","002","00","003","0327","0147","615","299","316","32","647","1139","0","56.8","26.25"
"10","002","00","004","0000","0000","12930","6302","6628","933","13863","25135","29173","55.15","25.07"
"10","002","00","004","0401","0000","103","55","48","9","112","292","0","38.36","18.84"
"10","002","00","004","0401","0172","103","55","48","9","112","292","0","38.36","18.84"
"10","002","00","004","0402","0000","347","175","172","27","374","688","0","54.36","25.44"
"10","002","00","004","0402","0173","347","175","172","27","374","688","0","54.36","25.44"
"10","002","00","004","0403","0000","417","231","186","37","454","879","0","51.65","26.28"
"10","002","00","004","0403","0175","417","231","186","37","454","879","0","51.65","26.28"
"10","002","00","004","0404","0000","184","83","101","21","205","335","0","61.19","24.78"
"10","002","00","004","0404","0176","184","83","101","21","205","335","0","61.19","24.78"
"10","002","00","004","0405","0000","676","352","324","62","738","1356","0","54.42","25.96"
"10","002","00","004","0405","0177","356","190","166","37","393","624","0","62.98","30.45"
"10","002","00","004","0405","0178","320","162","158","25","345","732","0","47.13","22.13"
"10","002","00","004","0406","0000","391","178","213","29","420","892","0","47.09","19.96"
"10","002","00","004","0406","0179","391","178","213","29","420","892","0","47.09","19.96"
"10","002","00","004","0407","0000","292","160","132","22","314","690","0","45.51","23.19"
"10","002","00","004","0407","0180","292","160","132","22","314","690","0","45.51","23.19"
"10","002","00","004","0408","0000","817","388","429","51","868","1578","0","55.01","24.59"
"10","002","00","004","0408","0181","431","222","209","25","456","842","0","54.16","26.37"
"10","002","00","004","0408","0182","386","166","220","26","412","736","0","55.98","22.55"
"10","002","00","004","0409","0000","651","337","314","42","693","1348","0","51.41","25.0"
"10","002","00","004","0409","0183","377","190","187","27","404","788","0","51.27","24.11"
"10","002","00","004","0409","0184","274","147","127","15","289","560","0","51.61","26.25"
"10","002","00","004","0410","0000","397","194","203","26","423","712","0","59.41","27.25"
"10","002","00","004","0410","0185","397","194","203","26","423","712","0","59.41","27.25"
"10","002","00","004","0411","0000","300","140","160","22","322","502","0","64.14","27.89"
"10","002","00","004","0411","0186","300","140","160","22","322","502","0","64.14","27.89"
"10","002","00","004","0412","0000","342","160","182","17","359","569","0","63.09","28.12"
"10","002","00","004","0412","0187","342","160","182","17","359","569","0","63.09","28.12"
"10","002","00","004","0413","0000","341","164","177","21","362","633","0","57.19","25.91"
"10","002","00","004","0413","0188","341","164","177","21","362","633","0","57.19","25.91"
"10","002","00","004","0414","0000","974","494","480","60","1034","2167","0","47.72","22.8"
"10","002","00","004","0414","0189","501","279","222","37","538","1132","0","47.53","24.65"
"10","002","00","004","0414","0190","473","215","258","23","496","1035","0","47.92","20.77"
"10","002","00","004","0415","0000","1104","534","570","64","1168","2019","0","57.85","26.45"
"10","002","00","004","0415","0191","481","242","239","24","505","847","0","59.62","28.57"
"10","002","00","004","0415","0192","623","292","331","40","663","1172","0","56.57","24.91"
"10","002","00","004","0416","0000","1069","474","595","43","1112","1971","0","56.42","24.05"
"10","002","00","004","0416","0193","463","225","238","19","482","896","0","53.79","25.11"
"10","002","00","004","0416","0194","606","249","357","24","630","1075","0","58.6","23.16"
"10","002","00","004","0417","0000","507","236","271","43","550","931","0","59.08","25.35"
"10","002","00","004","0417","0195","507","236","271","43","550","931","0","59.08","25.35"
"10","002","00","004","0418","0000","830","319","511","83","913","1730","0","52.77","18.44"
"10","002","00","004","0418","0196","512","217","295","50","562","1021","0","55.04","21.25"
"10","002","00","004","0418","0197","318","102","216","33","351","709","0","49.51","14.39"
"10","002","00","004","0419","0000","408","188","220","34","442","689","0","64.15","27.29"
"10","002","00","004","0419","0198","408","188","220","34","442","689","0","64.15","27.29"
"10","002","00","004","0420","0000","739","378","361","59","798","1374","0","58.08","27.51"
"10","002","00","004","0420","0199","351","173","178","32","383","615","0","62.28","28.13"
"10","002","00","004","0420","0200","388","205","183","27","415","759","0","54.68","27.01"
"10","002","00","004","0421","0000","523","274","249","41","564","917","0","61.5","29.88"
"10","002","00","004","0421","0201","523","274","249","41","564","917","0","61.5","29.88"
"10","002","00","004","0422","0000","549","298","251","58","607","1045","0","58.09","28.52"
"10","002","00","004","0422","0202","549","298","251","58","607","1045","0","58.09","28.52"
"10","002","00","004","0423","0000","600","321","279","35","635","1130","0","56.19","28.41"
"10","002","00","004","0423","0203","600","321","279","35","635","1130","0","56.19","28.41"
"10","002","00","004","0424","0000","369","169","200","27","396","688","0","57.56","24.56"
"10","002","00","004","0424","0174","369","169","200","27","396","688","0","57.56","24.56"
"10","002","00","005","0000","0000","16086","8420","7666","880","16966","31084","35668","54.58","27.09"
"10","002","00","005","0501","0000","782","408","374","53","835","1627","0","51.32","25.08"
"10","002","00","005","0501","0204","534","272","262","29","563","1122","0","50.18","24.24"
"10","002","00","005","0501","0205","248","136","112","24","272","505","0","53.86","26.93"
"10","002","00","005","0502","0000","996","538","458","52","1048","1959","0","53.5","27.46"
"10","002","00","005","0502","0206","500","281","219","20","520","988","0","52.63","28.44"
"10","002","00","005","0502","0207","496","257","239","32","528","971","0","54.38","26.47"
"10","002","00","005","0503","0000","1817","809","1008","85","1902","4033","0","47.16","20.06"
"10","002","00","005","0503","0208","585","261","324","39","624","1246","0","50.08","20.95"
"10","002","00","005","0503","0209","741","322","419","24","765","1655","0","46.22","19.46"
"10","002","00","005","0503","0210","491","226","265","22","513","1132","0","45.32","19.96"
"10","002","00","005","0504","0000","1343","664","679","59","1402","2559","0","54.79","25.95"
"10","002","00","005","0504","0211","428","223","205","16","444","783","0","56.7","28.48"
"10","002","00","005","0504","0212","472","230","242","27","499","928","0","53.77","24.78"
"10","002","00","005","0504","0213","443","211","232","16","459","848","0","54.13","24.88"
"10","002","00","005","0505","0000","396","238","158","31","427","663","0","64.4","35.9"
"10","002","00","005","0505","0214","396","238","158","31","427","663","0","64.4","35.9"
"10","002","00","005","0506","0000","773","443","330","51","824","1441","0","57.18","30.74"
"10","002","00","005","0506","0215","326","206","120","20","346","608","0","56.91","33.88"
"10","002","00","005","0506","0216","447","237","210","31","478","833","0","57.38","28.45"
"10","002","00","005","0507","0000","601","353","248","14","615","1233","0","49.88","28.63"
"10","002","00","005","0507","0217","601","353","248","14","615","1233","0","49.88","28.63"
"10","002","00","005","0508","0000","742","329","413","49","791","1429","0","55.35","23.02"
"10","002","00","005","0508","0218","453","165","288","29","482","854","0","56.44","19.32"
"10","002","00","005","0508","0219","289","164","125","20","309","575","0","53.74","28.52"
"10","002","00","005","0509","0000","1168","630","538","57","1225","2140","0","57.24","29.44"
"10","002","00","005","0509","0220","446","241","205","23","469","835","0","56.17","28.86"
"10","002","00","005","0509","0221","722","389","333","34","756","1305","0","57.93","29.81"
"10","002","00","005","0510","0000","1278","688","590","102","1380","2402","0","57.45","28.64"
"10","002","00","005","0510","0222","424","234","190","38","462","830","0","55.66","28.19"
"10","002","00","005","0510","0223","395","212","183","33","428","649","0","65.95","32.67"
"10","002","00","005","0510","0224","459","242","217","31","490","923","0","53.09","26.22"
"10","002","00","005","0511","0000","537","302","235","24","561","1177","0","47.66","25.66"
"10","002","00","005","0511","0225","537","302","235","24","561","1177","0","47.66","25.66"
"10","002","00","005","0512","0000","441","243","198","22","463","840","0","55.12","28.93"
"10","002","00","005","0512","0226","441","243","198","22","463","840","0","55.12","28.93"
"10","002","00","005","0513","0000","566","310","256","29","595","1051","0","56.61","29.5"
"10","002","00","005","0513","0227","566","310","256","29","595","1051","0","56.61","29.5"
"10","002","00","005","0514","0000","652","333","319","25","677","1339","0","50.56","24.87"
"10","002","00","005","0514","0228","652","333","319","25","677","1339","0","50.56","24.87"
"10","002","00","005","0515","0000","1430","733","697","72","1502","2508","0","59.89","29.23"
"10","002","00","005","0515","0229","679","311","368","33","712","1194","0","59.63","26.05"
"10","002","00","005","0515","0230","751","422","329","39","790","1314","0","60.12","32.12"
"10","002","00","005","0516","0000","1796","1010","786","99","1895","3311","0","57.23","30.5"
"10","002","00","005","0516","0231","603","325","278","21","624","1125","0","55.47","28.89"
"10","002","00","005","0516","0232","676","375","301","46","722","1207","0","59.82","31.07"
"10","002","00","005","0516","0233","517","310","207","32","549","979","0","56.08","31.66"
"10","002","00","005","0517","0000","543","273","270","43","586","954","0","61.43","28.62"
"10","002","00","005","0517","0234","543","273","270","43","586","954","0","61.43","28.62"
"10","002","00","005","0518","0000","225","116","109","13","238","418","0","56.94","27.75"
"10","002","00","005","0518","0235","225","116","109","13","238","418","0","56.94","27.75"
"10","002","00","006","0000","0000","11734","6448","5286","804","12538","21447","24315","58.46","30.06"
"10","002","00","006","0601","0000","1392","721","671","103","1495","2484","0","60.19","29.03"
"10","002","00","006","0601","0236","806","415","391","61","867","1435","0","60.42","28.92"
"10","002","00","006","0601","0237","586","306","280","42","628","1049","0","59.87","29.17"
"10","002","00","006","0602","0000","970","504","466","76","1046","1835","0","57.0","27.47"
"10","002","00","006","0602","0239","442","228","214","63","505","868","0","58.18","26.27"
"10","002","00","006","0602","0240","528","276","252","13","541","967","0","55.95","28.54"
"10","002","00","006","0603","0000","538","296","242","44","582","940","0","61.91","31.49"
"10","002","00","006","0603","0241","538","296","242","44","582","940","0","61.91","31.49"
"10","002","00","006","0604","0000","458","252","206","21","479","975","0","49.13","25.85"
"10","002","00","006","0604","0242","458","252","206","21","479","975","0","49.13","25.85"
"10","002","00","006","0605","0000","880","501","379","85","965","1605","0","60.12","31.21"
"10","002","00","006","0605","0243","454","255","199","44","498","797","0","62.48","31.99"
"10","002","00","006","0605","0244","426","246","180","41","467","808","0","57.8","30.45"
"10","002","00","006","0606","0000","814","487","327","54","868","1523","0","56.99","31.98"
"10","002","00","006","0606","0245","520","332","188","30","550","911","0","60.37","36.44"
"10","002","00","006","0606","0246","294","155","139","24","318","612","0","51.96","25.33"
"10","002","00","006","0607","0000","479","277","202","24","503","790","0","63.67","35.06"
"10","002","00","006","0607","0247","479","277","202","24","503","790","0","63.67","35.06"
"10","002","00","006","0608","0000","1314","745","569","95","1409","2338","0","60.27","31.86"
"10","002","00","006","0608","0248","495","274","221","34","529","878","0","60.25","31.21"
"10","002","00","006","0608","0249","457","271","186","30","487","723","0","67.36","37.48"
"10","002","00","006","0608","0250","362","200","162","31","393","737","0","53.32","27.14"
"10","002","00","006","0609","0000","871","456","415","40","911","1581","0","57.62","28.84"
"10","002","00","006","0609","0251","380","213","167","33","413","686","0","60.2","31.05"
"10","002","00","006","0609","0252","491","243","248","7","498","895","0","55.64","27.15"
"10","002","00","006","0610","0000","710","341","369","47","757","1237","0","61.2","27.57"
"10","002","00","006","0610","0253","710","341","369","47","757","1237","0","61.2","27.57"
"10","002","00","006","0611","0000","1207","730","477","65","1272","2241","0","56.76","32.57"
"10","002","00","006","0611","0254","618","319","299","33","651","1134","0","57.41","28.13"
"10","002","00","006","0611","0255","589","411","178","32","621","1107","0","56.1","37.13"
"10","002","00","006","0612","0000","607","341","266","34","641","1057","0","60.64","32.26"
"10","002","00","006","0612","0256","607","341","266","34","641","1057","0","60.64","32.26"
"10","002","00","006","0613","0000","878","469","409","72","950","1773","0","53.58","26.45"
"10","002","00","006","0613","0257","508","277","231","38","546","1051","0","51.95","26.36"
"10","002","00","006","0613","0258","370","192","178","34","404","722","0","55.96","26.59"
"10","002","00","006","0614","0000","616","328","288","44","660","1068","0","61.8","30.71"
"10","002","00","006","0614","0238","616","328","288","44","660","1068","0","61.8","30.71"
"10","002","00","007","0000","0000","14226","7425","6801","1088","15314","28131","32281","54.44","26.39"
"10","002","00","007","0701","0000","2801","1314","1487","144","2945","5648","0","52.14","23.26"
"10","002","00","007","0701","0259","701","336","365","25","726","1393","0","52.12","24.12"
"10","002","00","007","0701","0260","449","224","225","21","470","895","0","52.51","25.03"
"10","002","00","007","0701","0261","595","263","332","43","638","1231","0","51.83","21.36"
"10","002","00","007","0701","0262","543","247","296","24","567","1098","0","51.64","22.5"
"10","002","00","007","0701","0263","513","244","269","31","544","1031","0","52.76","23.67"
"10","002","00","007","0702","0000","949","534","415","167","1116","2198","0","50.77","24.29"
"10","002","00","007","0702","0264","420","272","148","137","557","1030","0","54.08","26.41"
"10","002","00","007","0702","0265","529","262","267","30","559","1168","0","47.86","22.43"
"10","002","00","007","0703","0000","848","460","388","69","917","1587","0","57.78","28.99"
"10","002","00","007","0703","0266","427","247","180","38","465","809","0","57.48","30.53"
"10","002","00","007","0703","0267","421","213","208","31","452","778","0","58.1","27.38"
"10","002","00","007","0704","0000","802","282","520","47","849","1465","0","57.95","19.25"
"10","002","00","007","0704","0268","802","282","520","47","849","1465","0","57.95","19.25"
"10","002","00","007","0705","0000","997","506","491","68","1065","1839","0","57.91","27.51"
"10","002","00","007","0705","0269","549","277","272","34","583","979","0","59.55","28.29"
"10","002","00","007","0705","0270","448","229","219","34","482","860","0","56.05","26.63"
"10","002","00","007","0706","0000","566","281","285","35","601","1205","0","49.88","23.32"
"10","002","00","007","0706","0271","566","281","285","35","601","1205","0","49.88","23.32"
"10","002","00","007","0707","0000","787","418","369","75","862","1494","0","57.7","27.98"
"10","002","00","007","0707","0272","557","286","271","57","614","1082","0","56.75","26.43"
"10","002","00","007","0707","0273","230","132","98","18","248","412","0","60.19","32.04"
"10","002","00","007","0708","0000","295","169","126","20","315","635","0","49.61","26.61"
"10","002","00","007","0708","0274","201","121","80","10","211","403","0","52.36","30.02"
"10","002","00","007","0708","0275","94","48","46","10","104","232","0","44.83","20.69"
"10","002","00","007","0709","0000","960","536","424","66","1026","1838","0","55.82","29.16"
"10","002","00","007","0709","0276","481","257","224","32","513","944","0","54.34","27.22"
"10","002","00","007","0709","0277","479","279","200","34","513","894","0","57.38","31.21"
"10","002","00","007","0710","0000","709","371","338","52","761","1356","0","56.12","27.36"
"10","002","00","007","0710","0278","709","371","338","52","761","1356","0","56.12","27.36"
"10","002","00","007","0711","0000","1253","719","534","106","1359","2295","0","59.22","31.33"
"10","002","00","007","0711","0279","427","237","190","32","459","780","0","58.85","30.38"
"10","002","00","007","0711","0280","536","306","230","53","589","932","0","63.2","32.83"
"10","002","00","007","0711","0281","290","176","114","21","311","583","0","53.34","30.19"
"10","002","00","007","0712","0000","1239","708","531","109","1348","2435","0","55.36","29.08"
"10","002","00","007","0712","0282","457","272","185","47","504","900","0","56.0","30.22"
"10","002","00","007","0712","0283","395","218","177","14","409","747","0","54.75","29.18"
"10","002","00","007","0712","0284","387","218","169","48","435","788","0","55.2","27.66"
"10","002","00","007","0713","0000","437","229","208","29","466","884","0","52.71","25.9"
"10","002","00","007","0713","0285","437","229","208","29","466","884","0","52.71","25.9"
"10","002","00","007","0714","0000","430","233","197","14","444","857","0","51.81","27.19"
"10","002","00","007","0714","0286","430","233","197","14","444","857","0","51.81","27.19"
"10","002","00","007","0715","0000","519","289","230","23","542","1016","0","53.35","28.44"
"10","002","00","007","0715","0287","519","289","230","23","542","1016","0","53.35","28.44"
"10","002","00","007","0716","0000","634","376","258","64","698","1379","0","50.62","27.27"
"10","002","00","007","0716","0288","298","168","130","28","326","690","0","47.25","24.35"
"10","002","00","007","0716","0289","336","208","128","36","372","689","0","53.99","30.19"
"10","002","00","008","0000","0000","23636","12475","11161","1144","24780","45405","52843","54.58","27.47"
"10","002","00","008","0801","0000","616","326","290","36","652","1217","0","53.57","26.79"
"10","002","00","008","0801","0312","616","326","290","36","652","1217","0","53.57","26.79"
"10","002","00","008","0802","0000","932","516","416","31","963","1624","0","59.3","31.77"
"10","002","00","008","0802","0290","466","259","207","20","486","807","0","60.22","32.09"
"10","002","00","008","0802","0291","466","257","209","11","477","817","0","58.38","31.46"
"10","002","00","008","0803","0000","634","342","292","29","663","1156","0","57.35","29.58"
"10","002","00","008","0803","0292","634","342","292","29","663","1156","0","57.35","29.58"
"10","002","00","008","0804","0000","466","261","205","18","484","892","0","54.26","29.26"
"10","002","00","008","0804","0293","466","261","205","18","484","892","0","54.26","29.26"
"10","002","00","008","0805","0000","502","277","225","27","529","897","0","58.97","30.88"
"10","002","00","008","0805","0294","502","277","225","27","529","897","0","58.97","30.88"
"10","002","00","008","0806","0000","805","433","372","33","838","1392","0","60.2","31.11"
"10","002","00","008","0806","0295","805","433","372","33","838","1392","0","60.2","31.11"
"10","002","00","008","0807","0000","1453","732","721","70","1523","2906","0","52.41","25.19"
"10","002","00","008","0807","0296","806","418","388","37","843","1471","0","57.31","28.42"
"10","002","00","008","0807","0297","647","314","333","33","680","1435","0","47.39","21.88"
"10","002","00","008","0808","0000","1581","774","807","57","1638","2975","0","55.06","26.02"
"10","002","00","008","0808","0298","761","386","375","31","792","1519","0","52.14","25.41"
"10","002","00","008","0808","0299","820","388","432","26","846","1456","0","58.1","26.65"
"10","002","00","008","0809","0000","394","218","176","13","407","694","0","58.65","31.41"
"10","002","00","008","0809","0301","394","218","176","13","407","694","0","58.65","31.41"
"10","002","00","008","0810","0000","410","236","174","28","438","711","0","61.6","33.19"
"10","002","00","008","0810","0300","410","236","174","28","438","711","0","61.6","33.19"
"10","002","00","008","0811","0000","940","477","463","35","975","1526","0","63.89","31.26"
"10","002","00","008","0811","0302","940","477","463","35","975","1526","0","63.89","31.26"
"10","002","00","008","0812","0000","510","287","223","15","525","884","0","59.39","32.47"
"10","002","00","008","0812","0303","510","287","223","15","525","884","0","59.39","32.47"
"10","002","00","008","0813","0000","674","379","295","45","719","1465","0","49.08","25.87"
"10","002","00","008","0813","0304","674","379","295","45","719","1465","0","49.08","25.87"
"10","002","00","008","0814","0000","275","171","104","15","290","488","0","59.43","35.04"
"10","002","00","008","0814","0305","275","171","104","15","290","488","0","59.43","35.04"
"10","002","00","008","0815","0000","2445","1276","1169","123","2568","4993","0","51.43","25.56"
"10","002","00","008","0815","0306","626","363","263","28","654","1218","0","53.69","29.8"
"10","002","00","008","0815","0307","632","312","320","31","663","1291","0","51.36","24.17"
"10","002","00","008","0815","0308","649","351","298","26","675","1324","0","50.98","26.51"
"10","002","00","008","0815","0309","538","250","288","38","576","1160","0","49.66","21.55"
"10","002","00","008","0816","0000","1508","810","698","79","1587","3000","0","52.9","27.0"
"10","002","00","008","0816","0310","634","325","309","36","670","1246","0","53.77","26.08"
"10","002","00","008","0816","0311","874","485","389","43","917","1754","0","52.28","27.65"
"10","002","00","008","0817","0000","2293","1201","1092","119","2412","4651","0","51.86","25.82"
"10","002","00","008","0817","0313","694","374","320","31","725","1495","0","48.49","25.02"
"10","002","00","008","0817","0314","483","251","232","28","511","937","0","54.54","26.79"
"10","002","00","008","0817","0315","560","292","268","28","588","1101","0","53.41","26.52"
"10","002","00","008","0817","0316","556","284","272","32","588","1118","0","52.59","25.4"
"10","002","00","008","0818","0000","2052","1032","1020","87","2139","3732","0","57.32","27.65"
"10","002","00","008","0818","0317","729","364","365","29","758","1301","0","58.26","27.98"
"10","002","00","008","0818","0318","647","306","341","26","673","1225","0","54.94","24.98"
"10","002","00","008","0818","0319","676","362","314","32","708","1206","0","58.71","30.02"
"10","002","00","008","0819","0000","1211","676","535","53","1264","2429","0","52.04","27.83"
"10","002","00","008","0819","0320","631","352","279","30","661","1278","0","51.72","27.54"
"10","002","00","008","0819","0321","580","324","256","23","603","1151","0","52.39","28.15"
"10","002","00","008","0820","0000","503","261","242","40","543","1094","0","49.63","23.86"
"10","002","00","008","0820","0322","503","261","242","40","543","1094","0","49.63","23.86"
"10","002","00","008","0821","0000","1259","668","591","89","1348","2494","0","54.05","26.78"
"10","002","00","008","0821","0323","662","373","289","47","709","1247","0","56.86","29.91"
"10","002","00","008","0821","0324","597","295","302","42","639","1247","0","51.24","23.66"
"10","002","00","008","0822","0000","919","473","446","49","968","1677","0","57.72","28.21"
"10","002","00","008","0822","0325","513","260","253","27","540","979","0","55.16","26.56"
"10","002","00","008","0822","0326","406","213","193","22","428","698","0","61.32","30.52"
"10","002","00","008","0823","0000","887","432","455","36","923","1726","0","53.48","25.03"
"10","002","00","008","0823","0327","887","432","455","36","923","1726","0","53.48","25.03"
"10","002","00","008","0824","0000","367","217","150","17","384","782","0","49.1","27.75"
"10","002","00","008","0824","0328","367","217","150","17","384","782","0","49.1","27.75"
"10","002","00","009","0000","0000","17979","9229","8750","944","18923","34892","39577","54.23","26.45"
"10","002","00","009","0901","0000","1013","551","462","64","1077","2020","0","53.32","27.28"
"10","002","00","009","0901","0329","516","252","264","43","559","1076","0","51.95","23.42"
"10","002","00","009","0901","0330","497","299","198","21","518","944","0","54.87","31.67"
"10","002","00","009","0902","0000","971","499","472","50","1021","1773","0","57.59","28.14"
"10","002","00","009","0902","0331","465","237","228","18","483","836","0","57.78","28.35"
"10","002","00","009","0902","0332","506","262","244","32","538","937","0","57.42","27.96"
"10","002","00","009","0903","0000","1299","656","643","59","1358","2525","0","53.78","25.98"
"10","002","00","009","0903","0333","653","328","325","18","671","1255","0","53.47","26.14"
"10","002","00","009","0903","0334","646","328","318","41","687","1270","0","54.09","25.83"
"10","002","00","009","0904","0000","790","394","396","40","830","1603","0","51.78","24.58"
"10","002","00","009","0904","0335","389","193","196","19","408","801","0","50.94","24.09"
"10","002","00","009","0904","0336","401","201","200","21","422","802","0","52.62","25.06"
"10","002","00","009","0905","0000","632","332","300","20","652","1306","0","49.92","25.42"
"10","002","00","009","0905","0337","632","332","300","20","652","1306","0","49.92","25.42"
"10","002","00","009","0906","0000","1283","616","667","61","1344","2506","0","53.63","24.58"
"10","002","00","009","0906","0338","590","274","316","42","632","1190","0","53.11","23.03"
"10","002","00","009","0906","0339","693","342","351","19","712","1316","0","54.1","25.99"
"10","002","00","009","0907","0000","952","459","493","40","992","1779","0","55.76","25.8"
"10","002","00","009","0907","0340","536","245","291","12","548","965","0","56.79","25.39"
"10","002","00","009","0907","0341","416","214","202","28","444","814","0","54.55","26.29"
"10","002","00","009","0908","0000","1900","894","1006","113","2013","3637","0","55.35","24.58"
"10","002","00","009","0908","0342","617","290","327","40","657","1254","0","52.39","23.13"
"10","002","00","009","0908","0343","573","278","295","37","610","1060","0","57.55","26.23"
"10","002","00","009","0908","0344","710","326","384","36","746","1323","0","56.39","24.64"
"10","002","00","009","0909","0000","1950","902","1048","92","2042","3591","0","56.86","25.12"
"10","002","00","009","0909","0348","523","247","276","16","539","924","0","58.33","26.73"
"10","002","00","009","0909","0349","535","256","279","28","563","933","0","60.34","27.44"
"10","002","00","009","0909","0350","510","200","310","22","532","986","0","53.96","20.28"
"10","002","00","009","0909","0351","382","199","183","26","408","748","0","54.55","26.6"
"10","002","00","009","0910","0000","1711","886","825","76","1787","3233","0","55.27","27.4"
"10","002","00","009","0910","0345","623","321","302","25","648","1120","0","57.86","28.66"
"10","002","00","009","0910","0346","466","237","229","20","486","893","0","54.42","26.54"
"10","002","00","009","0910","0347","622","328","294","31","653","1220","0","53.52","26.89"
"10","002","00","009","0911","0000","803","474","329","39","842","1550","0","54.32","30.58"
"10","002","00","009","0911","0352","803","474","329","39","842","1550","0","54.32","30.58"
"10","002","00","009","0912","0000","766","375","391","45","811","1435","0","56.52","26.13"
"10","002","00","009","0912","0353","344","193","151","21","365","629","0","58.03","30.68"
"10","002","00","009","0912","0354","422","182","240","24","446","806","0","55.33","22.58"
"10","002","00","009","0913","0000","1009","553","456","62","1071","2022","0","52.97","27.35"
"10","002","00","009","0913","0355","465","259","206","38","503","956","0","52.62","27.09"
"10","002","00","009","0913","0356","544","294","250","24","568","1066","0","53.28","27.58"
"10","002","00","009","0914","0000","1513","857","656","74","1587","3079","0","51.54","27.83"
"10","002","00","009","0914","0357","718","403","315","39","757","1513","0","50.03","26.64"
"10","002","00","009","0914","0358","795","454","341","35","830","1566","0","53.0","28.99"
"10","002","00","009","0915","0000","1387","781","606","109","1496","2833","0","52.81","27.57"
"10","002","00","009","0915","0359","456","263","193","48","504","894","0","56.38","29.42"
"10","002","00","009","0915","0360","549","317","232","40","589","1235","0","47.69","25.67"
"10","002","00","009","0915","0361","382","201","181","21","403","704","0","57.24","28.55"
"10","002","00","010","0000","0000","9525","5141","4384","602","10127","19051","21391","53.16","26.99"
"10","002","00","010","1001","0000","105","65","40","11","116","215","0","53.95","30.23"
"10","002","00","010","1001","0362","105","65","40","11","116","215","0","53.95","30.23"
"10","002","00","010","1002","0000","215","125","90","26","241","523","0","46.08","23.9"
"10","002","00","010","1002","0363","215","125","90","26","241","523","0","46.08","23.9"
"10","002","00","010","1003","0000","359","212","147","31","390","745","0","52.35","28.46"
"10","002","00","010","1003","0364","359","212","147","31","390","745","0","52.35","28.46"
"10","002","00","010","1004","0000","311","183","128","20","331","583","0","56.78","31.39"
"10","002","00","010","1004","0368","311","183","128","20","331","583","0","56.78","31.39"
"10","002","00","010","1005","0000","214","98","116","22","236","436","0","54.13","22.48"
"10","002","00","010","1005","0369","214","98","116","22","236","436","0","54.13","22.48"
"10","002","00","010","1006","0000","607","297","310","41","648","1224","0","52.94","24.26"
"10","002","00","010","1006","0370","607","297","310","41","648","1224","0","52.94","24.26"
"10","002","00","010","1007","0000","550","280","270","38","588","1151","0","51.09","24.33"
"10","002","00","010","1007","0371","550","280","270","38","588","1151","0","51.09","24.33"
"10","002","00","010","1008","0000","466","246","220","22","488","870","0","56.09","28.28"
"10","002","00","010","1008","0372","466","246","220","22","488","870","0","56.09","28.28"
"10","002","00","010","1009","0000","514","281","233","27","541","1284","0","42.13","21.88"
"10","002","00","010","1009","0373","514","281","233","27","541","1284","0","42.13","21.88"
"10","002","00","010","1010","0000","2162","1098","1064","107","2269","4286","0","52.94","25.62"
"10","002","00","010","1010","0375","740","374","366","41","781","1439","0","54.27","25.99"
"10","002","00","010","1010","0376","706","353","353","39","745","1445","0","51.56","24.43"
"10","002","00","010","1010","0377","716","371","345","27","743","1402","0","53.0","26.46"
"10","002","00","010","1011","0000","509","279","230","28","537","897","0","59.87","31.1"
"10","002","00","010","1011","0374","509","279","230","28","537","897","0","59.87","31.1"
"10","002","00","010","1012","0000","301","166","135","23","324","617","0","52.51","26.9"
"10","002","00","010","1012","0365","301","166","135","23","324","617","0","52.51","26.9"
"10","002","00","010","1013","0000","241","119","122","27","268","497","0","53.92","23.94"
"10","002","00","010","1013","0366","241","119","122","27","268","497","0","53.92","23.94"
"10","002","00","010","1014","0000","386","223","163","31","417","735","0","56.73","30.34"
"10","002","00","010","1014","0367","386","223","163","31","417","735","0","56.73","30.34"
"10","002","00","010","1015","0000","619","351","268","35","654","1230","0","53.17","28.54"
"10","002","00","010","1015","0378","619","351","268","35","654","1230","0","53.17","28.54"
"10","002","00","010","1016","0000","405","220","185","29","434","774","0","56.07","28.42"
"10","002","00","010","1016","0379","405","220","185","29","434","774","0","56.07","28.42"
"10","002","00","010","1017","0000","860","492","368","38","898","1563","0","57.45","31.48"
"10","002","00","010","1017","0380","461","246","215","21","482","827","0","58.28","29.75"
"10","002","00","010","1017","0381","399","246","153","17","416","736","0","56.52","33.42"
"10","002","00","010","1018","0000","701","406","295","46","747","1421","0","52.57","28.57"
"10","002","00","010","1018","0382","701","406","295","46","747","1421","0","52.57","28.57"
"10","002","00","011","0000","0000","2316","829","1487","244","2560","4935","6247","51.87","16.8"
"10","002","00","011","1101","0000","372","136","236","46","418","893","0","46.81","15.23"
"10","002","00","011","1101","0383","372","136","236","46","418","893","0","46.81","15.23"
"10","002","00","011","1102","0000","412","104","308","46","458","632","0","72.47","16.46"
"10","002","00","011","1102","0384","412","104","308","46","458","632","0","72.47","16.46"
"10","002","00","011","1103","0000","321","136","185","16","337","684","0","49.27","19.88"
"10","002","00","011","1103","0385","321","136","185","16","337","684","0","49.27","19.88"
"10","002","00","011","1104","0000","160","81","79","20","180","264","0","68.18","30.68"
"10","002","00","011","1104","0386","160","81","79","20","180","264","0","68.18","30.68"
"10","002","00","011","1105","0000","133","44","89","4","137","337","0","40.65","13.06"
"10","002","00","011","1105","0387","133","44","89","4","137","337","0","40.65","13.06"
"10","002","00","011","1106","0000","159","61","98","10","169","404","0","41.83","15.1"
"10","002","00","011","1106","0388","159","61","98","10","169","404","0","41.83","15.1"
"10","002","00","011","1107","0000","25","14","11","3","28","55","0","50.91","25.45"
"10","002","00","011","1107","0389","25","14","11","3","28","55","0","50.91","25.45"
"10","002","00","011","1108","0000","264","88","176","21","285","787","0","36.21","11.18"
"10","002","00","011","1108","0391","264","88","176","21","285","787","0","36.21","11.18"
"10","002","00","011","1109","0000","335","116","219","58","393","680","0","57.79","17.06"
"10","002","00","011","1109","0392","335","116","219","58","393","680","0","57.79","17.06"
"10","002","00","011","1110","0000","135","49","86","20","155","199","0","77.89","24.62"
"10","002","00","011","1110","0390","135","49","86","20","155","199","0","77.89","24.62"
"10","002","00","012","0000","0000","2596","672","1924","179","2775","4644","6024","59.75","14.47"
"10","002","00","012","1201","0000","604","138","466","19","623","1210","0","51.49","11.4"
"10","002","00","012","1201","0394","604","138","466","19","623","1210","0","51.49","11.4"
"10","002","00","012","1202","0000","576","120","456","65","641","962","0","66.63","12.47"
"10","002","00","012","1202","0395","576","120","456","65","641","962","0","66.63","12.47"
"10","002","00","012","1203","0000","228","72","156","10","238","444","0","53.6","16.22"
"10","002","00","012","1203","0393","228","72","156","10","238","444","0","53.6","16.22"
"10","002","00","012","1204","0000","170","43","127","3","173","411","0","42.09","10.46"
"10","002","00","012","1204","0396","170","43","127","3","173","411","0","42.09","10.46"
"10","002","00","012","1205","0000","290","86","204","20","310","447","0","69.35","19.24"
"10","002","00","012","1205","0397","290","86","204","20","310","447","0","69.35","19.24"
"10","002","00","012","1206","0000","342","105","237","29","371","475","0","78.11","22.11"
"10","002","00","012","1206","0398","342","105","237","29","371","475","0","78.11","22.11"
"10","002","00","012","1207","0000","386","108","278","33","419","695","0","60.29","15.54"
"10","002","00","012","1207","0399","386","108","278","33","419","695","0","60.29","15.54"
"10","015","00","000","0000","0000","137815","49349","88466","8716","146531","278059","328331","52.7","17.75"
"10","015","00","001","0000","0000","43993","15490","28503","1933","45926","84807","103798","54.15","18.27"
"10","015","00","001","0101","0000","714","260","454","22","736","1512","0","48.68","17.2"
"10","015","00","001","0101","0019","714","260","454","22","736","1512","0","48.68","17.2"
"10","015","00","001","0102","0000","1039","395","644","79","1118","1996","0","56.01","19.79"
"10","015","00","001","0102","0014","537","212","325","52","589","1071","0","55.0","19.79"
"10","015","00","001","0102","0015","502","183","319","27","529","925","0","57.19","19.78"
"10","015","00","001","0103","0000","240","83","157","9","249","442","0","56.33","18.78"
"10","015","00","001","0103","0023","240","83","157","9","249","442","0","56.33","18.78"
"10","015","00","001","0104","0000","288","122","166","24","312","566","0","55.12","21.55"
"10","015","00","001","0104","0029","288","122","166","24","312","566","0","55.12","21.55"
"10","015","00","001","0105","0000","311","125","186","17","328","565","0","58.05","22.12"
"10","015","00","001","0105","0031","311","125","186","17","328","565","0","58.05","22.12"
"10","015","00","001","0106","0000","1570","586","984","77","1647","2983","0","55.21","19.64"
"10","015","00","001","0106","0033","468","172","296","19","487","911","0","53.46","18.88"
"10","015","00","001","0106","0034","508","188","320","34","542","1029","0","52.67","18.27"
"10","015","00","001","0106","0035","594","226","368","24","618","1043","0","59.25","21.67"
"10","015","00","001","0107","0000","768","290","478","33","801","1840","0","43.53","15.76"
"10","015","00","001","0107","0052","475","175","300","25","500","1339","0","37.34","13.07"
"10","015","00","001","0107","0053","293","115","178","8","301","501","0","60.08","22.95"
"10","015","00","001","0108","0000","1800","653","1147","94","1894","3241","0","58.44","20.15"
"10","015","00","001","0108","0049","603","232","371","39","642","1022","0","62.82","22.7"
"10","015","00","001","0108","0050","604","222","382","36","640","1135","0","56.39","19.56"
"10","015","00","001","0108","0051","593","199","394","19","612","1084","0","56.46","18.36"
"10","015","00","001","0109","0000","858","290","568","16","874","1522","0","57.42","19.05"
"10","015","00","001","0109","0001","858","290","568","16","874","1522","0","57.42","19.05"
"10","015","00","001","0110","0000","921","274","647","62","983","2029","0","48.45","13.5"
"10","015","00","001","0110","0005","225","90","135","13","238","470","0","50.64","19.15"
"10","015","00","001","0110","0006","411","122","289","26","437","838","0","52.15","14.56"
"10","015","00","001","0110","0007","285","62","223","23","308","721","0","42.72","8.6"
"10","015","00","001","0112","0000","256","93","163","8","264","469","0","56.29","19.83"
"10","015","00","001","0112","0030","256","93","163","8","264","469","0","56.29","19.83"
"10","015","00","001","0113","0000","305","122","183","4","309","538","0","57.43","22.68"
"10","015","00","001","0113","0028","305","122","183","4","309","538","0","57.43","22.68"
"10","015","00","001","0114","0000","1928","731","1197","79","2007","3514","0","57.11","20.8"
"10","015","00","001","0114","0038","720","278","442","33","753","1331","0","56.57","20.89"
"10","015","00","001","0114","0039","683","271","412","24","707","1228","0","57.57","22.07"
"10","015","00","001","0114","0040","525","182","343","22","547","955","0","57.28","19.06"
"10","015","00","001","0115","0000","494","180","314","16","510","904","0","56.42","19.91"
"10","015","00","001","0115","0054","494","180","314","16","510","904","0","56.42","19.91"
"10","015","00","001","0116","0000","2613","935","1678","98","2711","5074","0","53.43","18.43"
"10","015","00","001","0116","0069","665","230","435","36","701","1410","0","49.72","16.31"
"10","015","00","001","0116","0070","677","245","432","18","695","1303","0","53.34","18.8"
"10","015","00","001","0116","0071","664","255","409","12","676","1256","0","53.82","20.3"
"10","015","00","001","0116","0072","607","205","402","32","639","1105","0","57.83","18.55"
"10","015","00","001","0117","0000","1982","600","1382","96","2078","3583","0","58.0","16.75"
"10","015","00","001","0117","0016","671","200","471","43","714","1141","0","62.58","17.53"
"10","015","00","001","0117","0017","604","186","418","16","620","1163","0","53.31","15.99"
"10","015","00","001","0117","0018","707","214","493","37","744","1279","0","58.17","16.73"
"10","015","00","001","0118","0000","1713","516","1197","57","1770","3181","0","55.64","16.22"
"10","015","00","001","0118","0002","631","194","437","20","651","1114","0","58.44","17.41"
"10","015","00","001","0118","0003","361","102","259","18","379","670","0","56.57","15.22"
"10","015","00","001","0118","0004","721","220","501","19","740","1397","0","52.97","15.75"
"10","015","00","001","0119","0000","558","224","334","27","585","1114","0","52.51","20.11"
"10","015","00","001","0119","0024","558","224","334","27","585","1114","0","52.51","20.11"
"10","015","00","001","0120","0000","342","144","198","15","357","577","0","61.87","24.96"
"10","015","00","001","0120","0026","342","144","198","15","357","577","0","61.87","24.96"
"10","015","00","001","0121","0000","1016","376","640","32","1048","1835","0","57.11","20.49"
"10","015","00","001","0121","0036","488","174","314","12","500","856","0","58.41","20.33"
"10","015","00","001","0121","0037","528","202","326","20","548","979","0","55.98","20.63"
"10","015","00","001","0122","0000","548","201","347","23","571","1192","0","47.9","16.86"
"10","015","00","001","0122","0056","548","201","347","23","571","1192","0","47.9","16.86"
"10","015","00","001","0123","0000","1358","525","833","51","1409","2766","0","50.94","18.98"
"10","015","00","001","0123","0062","641","241","400","20","661","1311","0","50.42","18.38"
"10","015","00","001","0123","0063","717","284","433","31","748","1455","0","51.41","19.52"
"10","015","00","001","0124","0000","936","316","620","38","974","1715","0","56.79","18.43"
"10","015","00","001","0124","0067","404","129","275","13","417","715","0","58.32","18.04"
"10","015","00","001","0124","0068","532","187","345","25","557","1000","0","55.7","18.7"
"10","015","00","001","0125","0000","508","206","302","25","533","918","0","58.06","22.44"
"10","015","00","001","0125","0008","508","206","302","25","533","918","0","58.06","22.44"
"10","015","00","001","0126","0000","320","123","197","14","334","615","0","54.31","20.0"
"10","015","00","001","0126","0020","320","123","197","14","334","615","0","54.31","20.0"
"10","015","00","001","0127","0000","275","82","193","16","291","559","0","52.06","14.67"
"10","015","00","001","0127","0022","275","82","193","16","291","559","0","52.06","14.67"
"10","015","00","001","0128","0000","475","205","270","20","495","810","0","61.11","25.31"
"10","015","00","001","0128","0027","475","205","270","20","495","810","0","61.11","25.31"
"10","015","00","001","0129","0000","1394","533","861","49","1443","2674","0","53.96","19.93"
"10","015","00","001","0129","0047","632","246","386","31","663","1184","0","56.0","20.78"
"10","015","00","001","0129","0048","762","287","475","18","780","1490","0","52.35","19.26"
"10","015","00","001","0130","0000","287","120","167","17","304","490","0","62.04","24.49"
"10","015","00","001","0130","0055","287","120","167","17","304","490","0","62.04","24.49"
"10","015","00","001","0131","0000","1043","382","661","55","1098","1975","0","55.59","19.34"
"10","015","00","001","0131","0060","523","183","340","22","545","993","0","54.88","18.43"
"10","015","00","001","0131","0061","520","199","321","33","553","982","0","56.31","20.26"
"10","015","00","001","0132","0000","587","216","371","24","611","1068","0","57.21","20.22"
"10","015","00","001","0132","0077","587","216","371","24","611","1068","0","57.21","20.22"
"10","015","00","001","0133","0000","1489","452","1037","72","1561","2942","0","53.06","15.36"
"10","015","00","001","0133","0009","785","241","544","28","813","1539","0","52.83","15.66"
"10","015","00","001","0133","0010","704","211","493","44","748","1403","0","53.31","15.04"
"10","015","00","001","0134","0000","357","152","205","12","369","606","0","60.89","25.08"
"10","015","00","001","0134","0021","357","152","205","12","369","606","0","60.89","25.08"
"10","015","00","001","0135","0000","224","70","154","13","237","416","0","56.97","16.83"
"10","015","00","001","0135","0025","224","70","154","13","237","416","0","56.97","16.83"
"10","015","00","001","0136","0000","396","145","251","20","416","816","0","50.98","17.77"
"10","015","00","001","0136","0032","396","145","251","20","416","816","0","50.98","17.77"
"10","015","00","001","0137","0000","2718","926","1792","120","2838","5217","0","54.4","17.75"
"10","015","00","001","0137","0043","743","253","490","36","779","1369","0","56.9","18.48"
"10","015","00","001","0137","0044","649","220","429","22","671","1435","0","46.76","15.33"
"10","015","00","001","0137","0045","617","202","415","23","640","1164","0","54.98","17.35"
"10","015","00","001","0137","0046","709","251","458","39","748","1249","0","59.89","20.1"
"10","015","00","001","0138","0000","1171","399","772","65","1236","2226","0","55.53","17.92"
"10","015","00","001","0138","0058","648","226","422","31","679","1267","0","53.59","17.84"
"10","015","00","001","0138","0059","523","173","350","34","557","959","0","58.08","18.04"
"10","015","00","001","0139","0000","414","148","266","22","436","869","0","50.17","17.03"
"10","015","00","001","0139","0057","414","148","266","22","436","869","0","50.17","17.03"
"10","015","00","001","0140","0000","654","250","404","27","681","1482","0","45.95","16.87"
"10","015","00","001","0140","0081","654","250","404","27","681","1482","0","45.95","16.87"
"10","015","00","001","0141","0000","2168","718","1450","99","2267","4183","0","54.2","17.16"
"10","015","00","001","0141","0073","542","203","339","18","560","1089","0","51.42","18.64"
"10","015","00","001","0141","0074","506","167","339","30","536","1043","0","51.39","16.01"
"10","015","00","001","0141","0075","606","193","413","16","622","1080","0","57.59","17.87"
"10","015","00","001","0141","0076","514","155","359","35","549","971","0","56.54","15.96"
"10","015","00","001","0142","0000","1234","431","803","55","1289","2498","0","51.6","17.25"
"10","015","00","001","0142","0041","617","215","402","27","644","1268","0","50.79","16.96"
"10","015","00","001","0142","0042","617","216","401","28","645","1230","0","52.44","17.56"
"10","015","00","001","0143","0000","1743","632","1111","63","1806","3727","0","48.46","16.96"
"10","015","00","001","0143","0064","523","190","333","17","540","1151","0","46.92","16.51"
"10","015","00","001","0143","0065","598","207","391","20","618","1237","0","49.96","16.73"
"10","015","00","001","0143","0066","622","235","387","26","648","1339","0","48.39","17.55"
"10","015","00","001","0144","0000","2095","643","1452","85","2180","4064","0","53.64","15.82"
"10","015","00","001","0144","0078","668","205","463","25","693","1379","0","50.25","14.87"
"10","015","00","001","0144","0079","691","205","486","30","721","1362","0","52.94","15.05"
"10","015","00","001","0144","0080","736","233","503","30","766","1323","0","57.9","17.61"
"10","015","00","001","0145","0000","1883","616","1267","83","1966","3494","0","56.27","17.63"
"10","015","00","001","0145","0011","550","198","352","17","567","1068","0","53.09","18.54"
"10","015","00","001","0145","0012","628","214","414","17","645","1167","0","55.27","18.34"
"10","015","00","001","0145","0013","705","204","501","49","754","1259","0","59.89","16.2"
"10","015","00","002","0000","0000","4998","1806","3192","387","5385","9676","10902","55.65","18.66"
"10","015","00","002","0201","0000","698","238","460","37","735","1192","0","61.66","19.97"
"10","015","00","002","0201","0195","698","238","460","37","735","1192","0","61.66","19.97"
"10","015","00","002","0202","0000","310","97","213","17","327","639","0","51.17","15.18"
"10","015","00","002","0202","0196","310","97","213","17","327","639","0","51.17","15.18"
"10","015","00","002","0203","0000","376","133","243","28","404","601","0","67.22","22.13"
"10","015","00","002","0203","0197","376","133","243","28","404","601","0","67.22","22.13"
"10","015","00","002","0204","0000","694","221","473","38","732","1137","0","64.38","19.44"
"10","015","00","002","0204","0198","694","221","473","38","732","1137","0","64.38","19.44"
"10","015","00","002","0205","0000","714","241","473","58","772","1352","0","57.1","17.83"
"10","015","00","002","0205","0199","380","142","238","39","419","742","0","56.47","19.14"
"10","015","00","002","0205","0200","334","99","235","19","353","610","0","57.87","16.23"
"10","015","00","002","0206","0000","217","94","123","42","259","513","0","50.49","18.32"
"10","015","00","002","0206","0201","153","77","76","39","192","295","0","65.08","26.1"
"10","015","00","002","0206","0202","64","17","47","3","67","218","0","30.73","7.8"
"10","015","00","002","0207","0000","575","220","355","36","611","1248","0","48.96","17.63"
"10","015","00","002","0207","0203","311","130","181","12","323","720","0","44.86","18.06"
"10","015","00","002","0207","0204","264","90","174","24","288","528","0","54.55","17.05"
"10","015","00","002","0208","0000","280","125","155","11","291","560","0","51.96","22.32"
"10","015","00","002","0208","0205","280","125","155","11","291","560","0","51.96","22.32"
"10","015","00","002","0209","0000","251","102","149","40","291","541","0","53.79","18.85"
"10","015","00","002","0209","0206","251","102","149","40","291","541","0","53.79","18.85"
"10","015","00","002","0210","0000","413","141","272","51","464","818","0","56.72","17.24"
"10","015","00","002","0210","0207","413","141","272","51","464","818","0","56.72","17.24"
"10","015","00","002","0211","0000","426","174","252","23","449","984","0","45.63","17.68"
"10","015","00","002","0211","0208","426","174","252","23","449","984","0","45.63","17.68"
"10","015","00","002","0212","0000","44","20","24","6","50","91","0","54.95","21.98"
"10","015","00","002","0212","0209","44","20","24","6","50","91","0","54.95","21.98"
"10","015","00","003","0000","0000","8867","3227","5640","960","9827","20650","24066","47.59","15.63"
"10","015","00","003","0301","0000","2637","915","1722","178","2815","5111","0","55.08","17.9"
"10","015","00","003","0301","0254","515","192","323","35","550","1008","0","54.56","19.05"
"10","015","00","003","0301","0255","518","171","347","40","558","939","0","59.42","18.21"
"10","015","00","003","0301","0256","604","207","397","54","658","1256","0","52.39","16.48"
"10","015","00","003","0301","0257","477","170","307","30","507","929","0","54.57","18.3"
"10","015","00","003","0301","0258","523","175","348","19","542","979","0","55.36","17.88"
"10","015","00","003","0302","0000","733","281","452","69","802","1619","0","49.54","17.36"
"10","015","00","003","0302","0260","387","143","244","33","420","847","0","49.59","16.88"
"10","015","00","003","0302","0261","346","138","208","36","382","772","0","49.48","17.88"
"10","015","00","003","0303","0000","533","184","349","64","597","1286","0","46.42","14.31"
"10","015","00","003","0303","0264","533","184","349","64","597","1286","0","46.42","14.31"
"10","015","00","003","0304","0000","495","171","324","44","539","1358","0","39.69","12.59"
"10","015","00","003","0304","0262","258","104","154","21","279","558","0","50.0","18.64"
"10","015","00","003","0304","0263","237","67","170","23","260","800","0","32.5","8.38"
"10","015","00","003","0305","0000","702","248","454","28","730","1244","0","58.68","19.94"
"10","015","00","003","0305","0259","702","248","454","28","730","1244","0","58.68","19.94"
"10","015","00","003","0306","0000","539","201","338","60","599","1246","0","48.07","16.13"
"10","015","00","003","0306","0265","539","201","338","60","599","1246","0","48.07","16.13"
"10","015","00","003","0307","0000","305","127","178","44","349","647","0","53.94","19.63"
"10","015","00","003","0307","0266","305","127","178","44","349","647","0","53.94","19.63"
"10","015","00","003","0308","0000","229","77","152","16","245","990","0","24.75","7.78"
"10","015","00","003","0308","0267","229","77","152","16","245","990","0","24.75","7.78"
"10","015","00","003","0309","0000","208","82","126","54","262","530","0","49.43","15.47"
"10","015","00","003","0309","0268","208","82","126","54","262","530","0","49.43","15.47"
"10","015","00","003","0310","0000","570","246","324","127","697","1536","0","45.38","16.02"
"10","015","00","003","0310","0269","329","135","194","48","377","979","0","38.51","13.79"
"10","015","00","003","0310","0270","241","111","130","79","320","557","0","57.45","19.93"
"10","015","00","003","0311","0000","478","178","300","87","565","1499","0","37.69","11.87"
"10","015","00","003","0311","0271","162","50","112","16","178","434","0","41.01","11.52"
"10","015","00","003","0311","0272","316","128","188","71","387","1065","0","36.34","12.02"
"10","015","00","003","0312","0000","397","125","272","68","465","866","0","53.7","14.43"
"10","015","00","003","0312","0273","397","125","272","68","465","866","0","53.7","14.43"
"10","015","00","003","0313","0000","292","100","192","49","341","769","0","44.34","13.0"
"10","015","00","003","0313","0274","292","100","192","49","341","769","0","44.34","13.0"
"10","015","00","003","0314","0000","344","136","208","28","372","869","0","42.81","15.65"
"10","015","00","003","0314","0275","344","136","208","28","372","869","0","42.81","15.65"
"10","015","00","003","0315","0000","405","156","249","44","449","1080","0","41.57","14.44"
"10","015","00","003","0315","0276","405","156","249","44","449","1080","0","41.57","14.44"
"10","015","00","004","0000","0000","8789","3203","5586","498","9287","17029","20112","54.54","18.81"
"10","015","00","004","0401","0000","677","275","402","23","700","1296","0","54.01","21.22"
"10","015","00","004","0401","0082","206","92","114","10","216","367","0","58.86","25.07"
"10","015","00","004","0401","0083","471","183","288","13","484","929","0","52.1","19.7"
"10","015","00","004","0402","0000","482","256","226","54","536","897","0","59.75","28.54"
"10","015","00","004","0402","0084","319","170","149","40","359","590","0","60.85","28.81"
"10","015","00","004","0402","0085","163","86","77","14","177","307","0","57.65","28.01"
"10","015","00","004","0403","0000","1251","477","774","82","1333","2428","0","54.9","19.65"
"10","015","00","004","0403","0086","151","55","96","10","161","260","0","61.92","21.15"
"10","015","00","004","0403","0087","661","269","392","58","719","1283","0","56.04","20.97"
"10","015","00","004","0403","0088","439","153","286","14","453","885","0","51.19","17.29"
"10","015","00","004","0404","0000","2009","684","1325","93","2102","3962","0","53.05","17.26"
"10","015","00","004","0404","0092","557","215","342","35","592","1163","0","50.9","18.49"
"10","015","00","004","0404","0093","810","238","572","34","844","1605","0","52.59","14.83"
"10","015","00","004","0404","0094","642","231","411","24","666","1194","0","55.78","19.35"
"10","015","00","004","0405","0000","531","174","357","25","556","979","0","56.79","17.77"
"10","015","00","004","0405","0095","531","174","357","25","556","979","0","56.79","17.77"
"10","015","00","004","0406","0000","1944","671","1273","76","2020","3719","0","54.32","18.04"
"10","015","00","004","0406","0096","795","273","522","33","828","1485","0","55.76","18.38"
"10","015","00","004","0406","0097","538","214","324","20","558","1070","0","52.15","20.0"
"10","015","00","004","0406","0098","611","184","427","23","634","1164","0","54.47","15.81"
"10","015","00","004","0407","0000","596","239","357","58","654","1249","0","52.36","19.14"
"10","015","00","004","0407","0099","421","166","255","47","468","880","0","53.18","18.86"
"10","015","00","004","0407","0100","175","73","102","11","186","369","0","50.41","19.78"
"10","015","00","004","0408","0000","1299","427","872","87","1386","2499","0","55.46","17.09"
"10","015","00","004","0408","0089","429","131","298","21","450","770","0","58.44","17.01"
"10","015","00","004","0408","0090","686","230","456","55","741","1363","0","54.37","16.87"
"10","015","00","004","0408","0091","184","66","118","11","195","366","0","53.28","18.03"
"10","015","00","005","0000","0000","36295","12483","23812","1811","38106","72116","83262","52.84","17.31"
"10","015","00","005","0501","0000","3774","1291","2483","134","3908","7071","0","55.27","18.26"
"10","015","00","005","0501","0147","586","230","356","24","610","1135","0","53.74","20.26"
"10","015","00","005","0501","0148","666","199","467","28","694","1223","0","56.75","16.27"
"10","015","00","005","0501","0149","683","226","457","19","702","1274","0","55.1","17.74"
"10","015","00","005","0501","0150","580","206","374","28","608","1124","0","54.09","18.33"
"10","015","00","005","0501","0151","628","215","413","21","649","1158","0","56.04","18.57"
"10","015","00","005","0501","0152","631","215","416","14","645","1157","0","55.75","18.58"
"10","015","00","005","0502","0000","2610","936","1674","77","2687","4926","0","54.55","19.0"
"10","015","00","005","0502","0153","680","227","453","20","700","1258","0","55.64","18.04"
"10","015","00","005","0502","0154","660","262","398","19","679","1257","0","54.02","20.84"
"10","015","00","005","0502","0155","626","198","428","26","652","1245","0","52.37","15.9"
"10","015","00","005","0502","0156","644","249","395","12","656","1166","0","56.26","21.36"
"10","015","00","005","0503","0000","1750","629","1121","88","1838","3739","0","49.16","16.82"
"10","015","00","005","0503","0119","566","142","424","16","582","1107","0","52.57","12.83"
"10","015","00","005","0503","0120","563","233","330","26","589","1179","0","49.96","19.76"
"10","015","00","005","0503","0121","621","254","367","46","667","1453","0","45.91","17.48"
"10","015","00","005","0504","0000","2153","736","1417","104","2257","4178","0","54.02","17.62"
"10","015","00","005","0504","0115","536","191","345","24","560","1059","0","52.88","18.04"
"10","015","00","005","0504","0116","522","158","364","25","547","983","0","55.65","16.07"
"10","015","00","005","0504","0117","537","181","356","28","565","1031","0","54.8","17.56"
"10","015","00","005","0504","0118","558","206","352","27","585","1105","0","52.94","18.64"
"10","015","00","005","0505","0000","3605","1175","2430","155","3760","6870","0","54.73","17.1"
"10","015","00","005","0505","0122","806","266","540","35","841","1432","0","58.73","18.58"
"10","015","00","005","0505","0123","698","225","473","32","730","1320","0","55.3","17.05"
"10","015","00","005","0505","0124","690","239","451","20","710","1356","0","52.36","17.63"
"10","015","00","005","0505","0125","650","219","431","31","681","1295","0","52.59","16.91"
"10","015","00","005","0505","0126","761","226","535","37","798","1467","0","54.4","15.41"
"10","015","00","005","0506","0000","2692","850","1842","95","2787","5242","0","53.17","16.22"
"10","015","00","005","0506","0127","769","260","509","24","793","1515","0","52.34","17.16"
"10","015","00","005","0506","0128","601","210","391","31","632","1063","0","59.45","19.76"
"10","015","00","005","0506","0129","569","163","406","15","584","1284","0","45.48","12.69"
"10","015","00","005","0506","0130","753","217","536","25","778","1380","0","56.38","15.72"
"10","015","00","005","0507","0000","1377","490","887","93","1470","2959","0","49.68","16.56"
"10","015","00","005","0507","0131","583","139","444","46","629","1297","0","48.5","10.72"
"10","015","00","005","0507","0132","794","351","443","47","841","1662","0","50.6","21.12"
"10","015","00","005","0508","0000","701","281","420","50","751","1563","0","48.05","17.98"
"10","015","00","005","0508","0133","701","281","420","50","751","1563","0","48.05","17.98"
"10","015","00","005","0509","0000","584","202","382","40","624","1288","0","48.45","15.68"
"10","015","00","005","0509","0134","584","202","382","40","624","1288","0","48.45","15.68"
"10","015","00","005","0510","0000","1423","510","913","95","1518","2845","0","53.36","17.93"
"10","015","00","005","0510","0135","480","177","303","37","517","907","0","57.0","19.51"
"10","015","00","005","0510","0136","435","148","287","39","474","917","0","51.69","16.14"
"10","015","00","005","0510","0137","508","185","323","19","527","1021","0","51.62","18.12"
"10","015","00","005","0511","0000","1698","577","1121","101","1799","3187","0","56.45","18.1"
"10","015","00","005","0511","0138","591","193","398","23","614","1033","0","59.44","18.68"
"10","015","00","005","0511","0139","521","181","340","37","558","966","0","57.76","18.74"
"10","015","00","005","0511","0140","586","203","383","41","627","1188","0","52.78","17.09"
"10","015","00","005","0512","0000","1973","724","1249","93","2066","4066","0","50.81","17.81"
"10","015","00","005","0512","0141","742","321","421","30","772","1480","0","52.16","21.69"
"10","015","00","005","0512","0142","645","200","445","31","676","1393","0","48.53","14.36"
"10","015","00","005","0512","0143","586","203","383","32","618","1193","0","51.8","17.02"
"10","015","00","005","0513","0000","1983","706","1277","134","2117","3961","0","53.45","17.82"
"10","015","00","005","0513","0144","685","222","463","23","708","1445","0","49.0","15.36"
"10","015","00","005","0513","0145","638","230","408","80","718","1301","0","55.19","17.68"
"10","015","00","005","0513","0146","660","254","406","31","691","1215","0","56.87","20.91"
"10","015","00","005","0514","0000","3100","1067","2033","167","3267","6041","0","54.08","17.66"
"10","015","00","005","0514","0157","681","233","448","37","718","1358","0","52.87","17.16"
"10","015","00","005","0514","0158","599","195","404","31","630","1214","0","51.89","16.06"
"10","015","00","005","0514","0159","580","176","404","40","620","1151","0","53.87","15.29"
"10","015","00","005","0514","0160","616","245","371","28","644","1157","0","55.66","21.18"
"10","015","00","005","0514","0161","624","218","406","31","655","1161","0","56.42","18.78"
"10","015","00","005","0515","0000","2655","842","1813","133","2788","5491","0","50.77","15.33"
"10","015","00","005","0515","0162","699","241","458","38","737","1304","0","56.52","18.48"
"10","015","00","005","0515","0163","682","198","484","37","719","1367","0","52.6","14.48"
"10","015","00","005","0515","0164","636","213","423","30","666","1411","0","47.2","15.1"
"10","015","00","005","0515","0165","638","190","448","28","666","1409","0","47.27","13.48"
"10","015","00","005","0516","0000","1118","421","697","89","1207","2338","0","51.63","18.01"
"10","015","00","005","0516","0166","507","207","300","30","537","1125","0","47.73","18.4"
"10","015","00","005","0516","0167","611","214","397","59","670","1213","0","55.23","17.64"
"10","015","00","005","0517","0000","2091","723","1368","112","2203","4415","0","49.9","16.38"
"10","015","00","005","0517","0168","596","199","397","28","624","1141","0","54.69","17.44"
"10","015","00","005","0517","0169","518","171","347","26","544","1156","0","47.06","14.79"
"10","015","00","005","0517","0170","538","177","361","29","567","1092","0","51.92","16.21"
"10","015","00","005","0517","0171","439","176","263","29","468","1026","0","45.61","17.15"
"10","015","00","005","0518","0000","1008","323","685","51","1059","1936","0","54.7","16.68"
"10","015","00","005","0518","0172","414","131","283","18","432","804","0","53.73","16.29"
"10","015","00","005","0518","0173","594","192","402","33","627","1132","0","55.39","16.96"
"10","015","00","006","0000","0000","8094","3200","4894","618","8712","15847","18006","54.98","20.19"
"10","015","00","006","0601","0000","201","80","121","17","218","357","0","61.06","22.41"
"10","015","00","006","0601","0175","201","80","121","17","218","357","0","61.06","22.41"
"10","015","00","006","0602","0000","488","185","303","29","517","1052","0","49.14","17.59"
"10","015","00","006","0602","0174","488","185","303","29","517","1052","0","49.14","17.59"
"10","015","00","006","0603","0000","980","398","582","86","1066","1897","0","56.19","20.98"
"10","015","00","006","0603","0176","468","189","279","51","519","1022","0","50.78","18.49"
"10","015","00","006","0603","0177","512","209","303","35","547","875","0","62.51","23.89"
"10","015","00","006","0604","0000","734","294","440","38","772","1399","0","55.18","21.02"
"10","015","00","006","0604","0178","397","162","235","26","423","691","0","61.22","23.44"
"10","015","00","006","0604","0179","337","132","205","12","349","708","0","49.29","18.64"
"10","015","00","006","0605","0000","435","176","259","39","474","894","0","53.02","19.69"
"10","015","00","006","0605","0180","435","176","259","39","474","894","0","53.02","19.69"
"10","015","00","006","0606","0000","416","151","265","22","438","695","0","63.02","21.73"
"10","015","00","006","0606","0183","416","151","265","22","438","695","0","63.02","21.73"
"10","015","00","006","0607","0000","724","214","510","59","783","1627","0","48.13","13.15"
"10","015","00","006","0607","0181","385","148","237","26","411","746","0","55.09","19.84"
"10","015","00","006","0607","0182","339","66","273","33","372","881","0","42.22","7.49"
"10","015","00","006","0608","0000","446","170","276","70","516","816","0","63.24","20.83"
"10","015","00","006","0608","0184","446","170","276","70","516","816","0","63.24","20.83"
"10","015","00","006","0609","0000","363","142","221","33","396","773","0","51.23","18.37"
"10","015","00","006","0609","0185","363","142","221","33","396","773","0","51.23","18.37"
"10","015","00","006","0610","0000","799","353","446","46","845","1436","0","58.84","24.58"
"10","015","00","006","0610","0186","555","262","293","32","587","1029","0","57.05","25.46"
"10","015","00","006","0610","0187","244","91","153","14","258","407","0","63.39","22.36"
"10","015","00","006","0611","0000","1332","567","765","82","1414","2549","0","55.47","22.24"
"10","015","00","006","0611","0188","613","239","374","38","651","1139","0","57.16","20.98"
"10","015","00","006","0611","0189","540","253","287","33","573","996","0","57.53","25.4"
"10","015","00","006","0611","0190","179","75","104","11","190","414","0","45.89","18.12"
"10","015","00","006","0612","0000","149","68","81","8","157","270","0","58.15","25.19"
"10","015","00","006","0612","0191","149","68","81","8","157","270","0","58.15","25.19"
"10","015","00","006","0613","0000","457","155","302","32","489","836","0","58.49","18.54"
"10","015","00","006","0613","0192","457","155","302","32","489","836","0","58.49","18.54"
"10","015","00","006","0614","0000","277","117","160","39","316","739","0","42.76","15.83"
"10","015","00","006","0614","0194","277","117","160","39","316","739","0","42.76","15.83"
"10","015","00","006","0615","0000","293","130","163","18","311","507","0","61.34","25.64"
"10","015","00","006","0615","0193","293","130","163","18","311","507","0","61.34","25.64"
"10","015","00","007","0000","0000","5349","1921","3428","556","5905","11417","12847","51.72","16.83"
"10","015","00","007","0701","0000","483","163","320","22","505","859","0","58.79","18.98"
"10","015","00","007","0701","0211","483","163","320","22","505","859","0","58.79","18.98"
"10","015","00","007","0702","0000","688","266","422","46","734","1295","0","56.68","20.54"
"10","015","00","007","0702","0210","688","266","422","46","734","1295","0","56.68","20.54"
"10","015","00","007","0703","0000","480","149","331","90","570","958","0","59.5","15.55"
"10","015","00","007","0703","0212","480","149","331","90","570","958","0","59.5","15.55"
"10","015","00","007","0704","0000","514","164","350","78","592","1011","0","58.56","16.22"
"10","015","00","007","0704","0213","514","164","350","78","592","1011","0","58.56","16.22"
"10","015","00","007","0705","0000","545","191","354","57","602","1041","0","57.83","18.35"
"10","015","00","007","0705","0214","545","191","354","57","602","1041","0","57.83","18.35"
"10","015","00","007","0706","0000","256","86","170","14","270","471","0","57.32","18.26"
"10","015","00","007","0706","0221","256","86","170","14","270","471","0","57.32","18.26"
"10","015","00","007","0707","0000","372","149","223","29","401","756","0","53.04","19.71"
"10","015","00","007","0707","0222","327","131","196","29","356","640","0","55.63","20.47"
"10","015","00","007","0707","0223","45","18","27","0","45","116","0","38.79","15.52"
"10","015","00","007","0708","0000","156","51","105","6","162","496","0","32.66","10.28"
"10","015","00","007","0708","0224","156","51","105","6","162","496","0","32.66","10.28"
"10","015","00","007","0709","0000","135","53","82","11","146","324","0","45.06","16.36"
"10","015","00","007","0709","0225","135","53","82","11","146","324","0","45.06","16.36"
"10","015","00","007","0710","0000","166","74","92","19","185","454","0","40.75","16.3"
"10","015","00","007","0710","0226","166","74","92","19","185","454","0","40.75","16.3"
"10","015","00","007","0711","0000","415","145","270","79","494","1009","0","48.96","14.37"
"10","015","00","007","0711","0215","374","133","241","76","450","821","0","54.81","16.2"
"10","015","00","007","0711","0216","41","12","29","3","44","188","0","23.4","6.38"
"10","015","00","007","0712","0000","411","154","257","44","455","960","0","47.4","16.04"
"10","015","00","007","0712","0217","245","84","161","36","281","514","0","54.67","16.34"
"10","015","00","007","0712","0218","166","70","96","8","174","446","0","39.01","15.7"
"10","015","00","007","0713","0000","390","144","246","42","432","851","0","50.76","16.92"
"10","015","00","007","0713","0219","390","144","246","42","432","851","0","50.76","16.92"
"10","015","00","007","0714","0000","338","132","206","19","357","932","0","38.3","14.16"
"10","015","00","007","0714","0220","338","132","206","19","357","932","0","38.3","14.16"
"10","015","00","008","0000","0000","1724","678","1046","266","1990","4395","4811","45.28","15.43"
"10","015","00","008","0801","0000","702","259","443","77","779","1779","0","43.79","14.56"
"10","015","00","008","0801","0229","244","100","144","46","290","613","0","47.31","16.31"
"10","015","00","008","0801","0230","389","141","248","24","413","809","0","51.05","17.43"
"10","015","00","008","0801","0231","69","18","51","7","76","357","0","21.29","5.04"
"10","015","00","008","0802","0000","277","119","158","64","341","669","0","50.97","17.79"
"10","015","00","008","0802","0232","277","119","158","64","341","669","0","50.97","17.79"
"10","015","00","008","0803","0000","198","65","133","16","214","479","0","44.68","13.57"
"10","015","00","008","0803","0233","198","65","133","16","214","479","0","44.68","13.57"
"10","015","00","008","0804","0000","265","126","139","46","311","751","0","41.41","16.78"
"10","015","00","008","0804","0228","265","126","139","46","311","751","0","41.41","16.78"
"10","015","00","008","0805","0000","282","109","173","63","345","717","0","48.12","15.2"
"10","015","00","008","0805","0227","282","109","173","63","345","717","0","48.12","15.2"
"10","015","00","009","0000","0000","4711","1706","3005","407","5118","10279","11716","49.79","16.6"
"10","015","00","009","0901","0000","1014","371","643","73","1087","1904","0","57.09","19.49"
"10","015","00","009","0901","0241","448","153","295","30","478","813","0","58.79","18.82"
"10","015","00","009","0901","0242","566","218","348","43","609","1091","0","55.82","19.98"
"10","015","00","009","0902","0000","970","324","646","67","1037","1814","0","57.17","17.86"
"10","015","00","009","0902","0243","466","167","299","14","480","839","0","57.21","19.9"
"10","015","00","009","0902","0244","504","157","347","53","557","975","0","57.13","16.1"
"10","015","00","009","0903","0000","238","96","142","25","263","546","0","48.17","17.58"
"10","015","00","009","0903","0245","238","96","142","25","263","546","0","48.17","17.58"
"10","015","00","009","0904","0000","536","220","316","38","574","1002","0","57.29","21.96"
"10","015","00","009","0904","0246","536","220","316","38","574","1002","0","57.29","21.96"
"10","015","00","009","0905","0000","251","82","169","29","280","593","0","47.22","13.83"
"10","015","00","009","0905","0247","251","82","169","29","280","593","0","47.22","13.83"
"10","015","00","009","0906","0000","501","205","296","58","559","965","0","57.93","21.24"
"10","015","00","009","0906","0248","501","205","296","58","559","965","0","57.93","21.24"
"10","015","00","009","0907","0000","414","138","276","62","476","863","0","55.16","15.99"
"10","015","00","009","0907","0249","414","138","276","62","476","863","0","55.16","15.99"
"10","015","00","009","0908","0000","76","22","54","7","83","340","0","24.41","6.47"
"10","015","00","009","0908","0250","76","22","54","7","83","340","0","24.41","6.47"
"10","015","00","009","0909","0000","321","103","218","35","356","764","0","46.6","13.48"
"10","015","00","009","0909","0251","321","103","218","35","356","764","0","46.6","13.48"
"10","015","00","009","0910","0000","196","59","137","6","202","868","0","23.27","6.8"
"10","015","00","009","0910","0252","196","59","137","6","202","868","0","23.27","6.8"
"10","015","00","009","0911","0000","194","86","108","7","201","620","0","32.42","13.87"
"10","015","00","009","0911","0253","194","86","108","7","201","620","0","32.42","13.87"
"10","015","00","010","0000","0000","3823","1492","2331","373","4196","9065","10331","46.29","16.46"
"10","015","00","010","1001","0000","185","59","126","16","201","467","0","43.04","12.63"
"10","015","00","010","1001","0277","185","59","126","16","201","467","0","43.04","12.63"
"10","015","00","010","1002","0000","369","148","221","45","414","1032","0","40.12","14.34"
"10","015","00","010","1002","0278","369","148","221","45","414","1032","0","40.12","14.34"
"10","015","00","010","1003","0000","251","91","160","27","278","638","0","43.57","14.26"
"10","015","00","010","1003","0279","251","91","160","27","278","638","0","43.57","14.26"
"10","015","00","010","1004","0000","258","107","151","67","325","591","0","54.99","18.1"
"10","015","00","010","1004","0280","258","107","151","67","325","591","0","54.99","18.1"
"10","015","00","010","1005","0000","548","179","369","46","594","1087","0","54.65","16.47"
"10","015","00","010","1005","0281","548","179","369","46","594","1087","0","54.65","16.47"
"10","015","00","010","1006","0000","212","81","131","12","224","431","0","51.97","18.79"
"10","015","00","010","1006","0282","212","81","131","12","224","431","0","51.97","18.79"
"10","015","00","010","1007","0000","409","160","249","29","438","893","0","49.05","17.92"
"10","015","00","010","1007","0283","409","160","249","29","438","893","0","49.05","17.92"
"10","015","00","010","1008","0000","138","62","76","12","150","361","0","41.55","17.17"
"10","015","00","010","1008","0284","138","62","76","12","150","361","0","41.55","17.17"
"10","015","00","010","1009","0000","512","224","288","47","559","1362","0","41.04","16.45"
"10","015","00","010","1009","0285","512","224","288","47","559","1362","0","41.04","16.45"
"10","015","00","010","1010","0000","217","87","130","22","239","458","0","52.18","19.0"
"10","015","00","010","1010","0286","217","87","130","22","239","458","0","52.18","19.0"
"10","015","00","010","1011","0000","194","67","127","20","214","621","0","34.46","10.79"
"10","015","00","010","1011","0287","194","67","127","20","214","621","0","34.46","10.79"
"10","015","00","010","1012","0000","225","82","143","19","244","493","0","49.49","16.63"
"10","015","00","010","1012","0288","225","82","143","19","244","493","0","49.49","16.63"
"10","015","00","010","1013","0000","305","145","160","11","316","631","0","50.08","22.98"
"10","015","00","010","1013","0289","305","145","160","11","316","631","0","50.08","22.98"
"10","015","00","011","0000","0000","5951","2351","3600","389","6340","12562","15937","50.47","18.72"
"10","015","00","011","1101","0000","526","187","339","38","564","1373","0","41.08","13.62"
"10","015","00","011","1101","0103","526","187","339","38","564","1373","0","41.08","13.62"
"10","015","00","011","1102","0000","770","293","477","73","843","1806","0","46.68","16.22"
"10","015","00","011","1102","0104","687","269","418","67","754","1644","0","45.86","16.36"
"10","015","00","011","1102","0105","83","24","59","6","89","162","0","54.94","14.81"
"10","015","00","011","1103","0000","781","312","469","53","834","1766","0","47.23","17.67"
"10","015","00","011","1103","0106","178","78","100","17","195","384","0","50.78","20.31"
"10","015","00","011","1103","0107","603","234","369","36","639","1382","0","46.24","16.93"
"10","015","00","011","1104","0000","628","214","414","72","700","1139","0","61.46","18.79"
"10","015","00","011","1104","0111","628","214","414","72","700","1139","0","61.46","18.79"
"10","015","00","011","1105","0000","620","210","410","9","629","1213","0","51.85","17.31"
"10","015","00","011","1105","0112","620","210","410","9","629","1213","0","51.85","17.31"
"10","015","00","011","1106","0000","517","199","318","35","552","1084","0","50.92","18.36"
"10","015","00","011","1106","0113","367","156","211","25","392","754","0","51.99","20.69"
"10","015","00","011","1106","0114","150","43","107","10","160","330","0","48.48","13.03"
"10","015","00","011","1107","0000","821","368","453","40","861","1752","0","49.14","21.0"
"10","015","00","011","1107","0108","520","229","291","29","549","1125","0","48.8","20.36"
"10","015","00","011","1107","0109","301","139","162","11","312","627","0","49.76","22.17"
"10","015","00","011","1108","0000","567","309","258","35","602","987","0","60.99","31.31"
"10","015","00","011","1108","0110","567","309","258","35","602","987","0","60.99","31.31"
"10","015","00","011","1109","0000","721","259","462","34","755","1442","0","52.36","17.96"
"10","015","00","011","1109","0101","441","143","298","17","458","867","0","52.83","16.49"
"10","015","00","011","1109","0102","280","116","164","17","297","575","0","51.65","20.17"
"10","015","00","012","0000","0000","2684","1000","1684","251","2935","5269","6439","55.7","18.98"
"10","015","00","012","1201","0000","543","201","342","53","596","1072","0","55.6","18.75"
"10","015","00","012","1201","0234","543","201","342","53","596","1072","0","55.6","18.75"
"10","015","00","012","1202","0000","259","108","151","4","263","560","0","46.96","19.29"
"10","015","00","012","1202","0235","259","108","151","4","263","560","0","46.96","19.29"
"10","015","00","012","1203","0000","459","167","292","16","475","773","0","61.45","21.6"
"10","015","00","012","1203","0236","459","167","292","16","475","773","0","61.45","21.6"
"10","015","00","012","1204","0000","263","102","161","15","278","661","0","42.06","15.43"
"10","015","00","012","1204","0237","263","102","161","15","278","661","0","42.06","15.43"
"10","015","00","012","1205","0000","515","160","355","71","586","1117","0","52.46","14.32"
"10","015","00","012","1205","0238","224","65","159","13","237","442","0","53.62","14.71"
"10","015","00","012","1205","0239","291","95","196","58","349","675","0","51.7","14.07"
"10","015","00","012","1206","0000","645","262","383","92","737","1086","0","67.86","24.13"
"10","015","00","012","1206","0240","645","262","383","92","737","1086","0","67.86","24.13"
"10","015","00","013","0000","0000","2537","792","1745","267","2804","4947","6104","56.68","16.01"
"10","015","00","013","1301","0000","282","78","204","23","305","533","0","57.22","14.63"
"10","015","00","013","1301","0290","282","78","204","23","305","533","0","57.22","14.63"
"10","015","00","013","1302","0000","521","196","325","57","578","1015","0","56.95","19.31"
"10","015","00","013","1302","0291","290","117","173","40","330","522","0","63.22","22.41"
"10","015","00","013","1302","0292","231","79","152","17","248","493","0","50.3","16.02"
"10","015","00","013","1303","0000","396","107","289","45","441","701","0","62.91","15.26"
"10","015","00","013","1303","0293","396","107","289","45","441","701","0","62.91","15.26"
"10","015","00","013","1304","0000","399","102","297","44","443","746","0","59.38","13.67"
"10","015","00","013","1304","0294","399","102","297","44","443","746","0","59.38","13.67"
"10","015","00","013","1305","0000","463","164","299","64","527","1021","0","51.62","16.06"
"10","015","00","013","1305","0295","341","117","224","49","390","616","0","63.31","18.99"
"10","015","00","013","1305","0296","122","47","75","15","137","405","0","33.83","11.6"
"10","015","00","013","1306","0000","476","145","331","34","510","931","0","54.78","15.57"
"10","015","00","013","1306","0297","169","53","116","10","179","329","0","54.41","16.11"
"10","015","00","013","1306","0298","217","61","156","16","233","428","0","54.44","14.25"
"10","015","00","013","1306","0299","90","31","59","8","98","174","0","56.32","17.82"
"10","014","00","000","0000","0000","89751","33959","55792","6451","96202","185996","219268","51.72","18.26"
"10","014","00","001","0000","0000","45692","16986","28706","2472","48164","87803","105587","54.85","19.35"
"10","014","00","001","0101","0000","697","250","447","82","779","1505","0","51.76","16.61"
"10","014","00","001","0101","0052","697","250","447","82","779","1505","0","51.76","16.61"
"10","014","00","001","0102","0000","367","144","223","37","404","836","0","48.33","17.22"
"10","014","00","001","0102","0053","367","144","223","37","404","836","0","48.33","17.22"
"10","014","00","001","0103","0000","1121","377","744","79","1200","2162","0","55.5","17.44"
"10","014","00","001","0103","0056","1121","377","744","79","1200","2162","0","55.5","17.44"
"10","014","00","001","0104","0000","1389","499","890","78","1467","2688","0","54.58","18.56"
"10","014","00","001","0104","0059","700","243","457","28","728","1359","0","53.57","17.88"
"10","014","00","001","0104","0060","689","256","433","50","739","1329","0","55.61","19.26"
"10","014","00","001","0105","0000","1589","613","976","55","1644","2767","0","59.41","22.15"
"10","014","00","001","0105","0057","936","352","584","31","967","1627","0","59.43","21.63"
"10","014","00","001","0105","0058","653","261","392","24","677","1140","0","59.39","22.89"
"10","014","00","001","0106","0000","1380","486","894","84","1464","2644","0","55.37","18.38"
"10","014","00","001","0106","0054","713","256","457","27","740","1294","0","57.19","19.78"
"10","014","00","001","0106","0055","667","230","437","57","724","1350","0","53.63","17.04"
"10","014","00","001","0107","0000","3530","1153","2377","181","3711","6543","0","56.72","17.62"
"10","014","00","001","0107","0026","908","289","619","45","953","1638","0","58.18","17.64"
"10","014","00","001","0107","0027","830","266","564","43","873","1576","0","55.39","16.88"
"10","014","00","001","0107","0028","863","295","568","53","916","1595","0","57.43","18.5"
"10","014","00","001","0107","0029","929","303","626","40","969","1734","0","55.88","17.47"
"10","014","00","001","0108","0000","1776","696","1080","69","1845","3141","0","58.74","22.16"
"10","014","00","001","0108","0006","878","333","545","32","910","1651","0","55.12","20.17"
"10","014","00","001","0108","0007","898","363","535","37","935","1490","0","62.75","24.36"
"10","014","00","001","0109","0000","433","173","260","31","464","859","0","54.02","20.14"
"10","014","00","001","0109","0008","433","173","260","31","464","859","0","54.02","20.14"
"10","014","00","001","0110","0000","1519","501","1018","73","1592","2651","0","60.05","18.9"
"10","014","00","001","0110","0032","728","239","489","41","769","1313","0","58.57","18.2"
"10","014","00","001","0110","0033","791","262","529","32","823","1338","0","61.51","19.58"
"10","014","00","001","0111","0000","1724","611","1113","70","1794","3021","0","59.38","20.23"
"10","014","00","001","0111","0030","818","284","534","38","856","1476","0","57.99","19.24"
"10","014","00","001","0111","0031","906","327","579","32","938","1545","0","60.71","21.17"
"10","014","00","001","0112","0000","2268","789","1479","81","2349","4021","0","58.42","19.62"
"10","014","00","001","0112","0003","686","241","445","28","714","1259","0","56.71","19.14"
"10","014","00","001","0112","0004","760","284","476","32","792","1399","0","56.61","20.3"
"10","014","00","001","0112","0005","822","264","558","21","843","1363","0","61.85","19.37"
"10","014","00","001","0113","0000","868","344","524","42","910","1469","0","61.95","23.42"
"10","014","00","001","0113","0002","868","344","524","42","910","1469","0","61.95","23.42"
"10","014","00","001","0114","0000","341","139","202","38","379","651","0","58.22","21.35"
"10","014","00","001","0114","0010","341","139","202","38","379","651","0","58.22","21.35"
"10","014","00","001","0115","0000","787","328","459","49","836","1650","0","50.67","19.88"
"10","014","00","001","0115","0011","787","328","459","49","836","1650","0","50.67","19.88"
"10","014","00","001","0116","0000","357","148","209","25","382","632","0","60.44","23.42"
"10","014","00","001","0116","0013","357","148","209","25","382","632","0","60.44","23.42"
"10","014","00","001","0117","0000","661","280","381","60","721","1299","0","55.5","21.56"
"10","014","00","001","0117","0016","661","280","381","60","721","1299","0","55.5","21.56"
"10","014","00","001","0118","0000","519","220","299","29","548","890","0","61.57","24.72"
"10","014","00","001","0118","0009","519","220","299","29","548","890","0","61.57","24.72"
"10","014","00","001","0119","0000","432","178","254","21","453","724","0","62.57","24.59"
"10","014","00","001","0119","0012","432","178","254","21","453","724","0","62.57","24.59"
"10","014","00","001","0120","0000","473","208","265","19","492","811","0","60.67","25.65"
"10","014","00","001","0120","0017","473","208","265","19","492","811","0","60.67","25.65"
"10","014","00","001","0121","0000","442","175","267","21","463","771","0","60.05","22.7"
"10","014","00","001","0121","0014","442","175","267","21","463","771","0","60.05","22.7"
"10","014","00","001","0122","0000","410","206","204","13","423","798","0","53.01","25.81"
"10","014","00","001","0122","0015","410","206","204","13","423","798","0","53.01","25.81"
"10","014","00","001","0123","0000","413","169","244","24","437","874","0","50.0","19.34"
"10","014","00","001","0123","0001","413","169","244","24","437","874","0","50.0","19.34"
"10","014","00","001","0124","0000","476","199","277","18","494","764","0","64.66","26.05"
"10","014","00","001","0124","0018","476","199","277","18","494","764","0","64.66","26.05"
"10","014","00","001","0125","0000","294","121","173","11","305","601","0","50.75","20.13"
"10","014","00","001","0125","0023","294","121","173","11","305","601","0","50.75","20.13"
"10","014","00","001","0126","0000","420","187","233","10","430","784","0","54.85","23.85"
"10","014","00","001","0126","0019","420","187","233","10","430","784","0","54.85","23.85"
"10","014","00","001","0127","0000","209","87","122","10","219","417","0","52.52","20.86"
"10","014","00","001","0127","0024","209","87","122","10","219","417","0","52.52","20.86"
"10","014","00","001","0128","0000","214","96","118","9","223","427","0","52.22","22.48"
"10","014","00","001","0128","0020","214","96","118","9","223","427","0","52.22","22.48"
"10","014","00","001","0129","0000","790","315","475","55","845","1597","0","52.91","19.72"
"10","014","00","001","0129","0063","790","315","475","55","845","1597","0","52.91","19.72"
"10","014","00","001","0130","0000","1063","459","604","50","1113","2028","0","54.88","22.63"
"10","014","00","001","0130","0061","491","214","277","26","517","990","0","52.22","21.62"
"10","014","00","001","0130","0062","572","245","327","24","596","1038","0","57.42","23.6"
"10","014","00","001","0131","0000","1341","492","849","104","1445","2959","0","48.83","16.63"
"10","014","00","001","0131","0036","626","260","366","58","684","1407","0","48.61","18.48"
"10","014","00","001","0131","0037","715","232","483","46","761","1552","0","49.03","14.95"
"10","014","00","001","0132","0000","1412","484","928","59","1471","2577","0","57.08","18.78"
"10","014","00","001","0132","0034","704","237","467","28","732","1312","0","55.79","18.06"
"10","014","00","001","0132","0035","708","247","461","31","739","1265","0","58.42","19.53"
"10","014","00","001","0133","0000","749","263","486","65","814","1445","0","56.33","18.2"
"10","014","00","001","0133","0038","749","263","486","65","814","1445","0","56.33","18.2"
"10","014","00","001","0134","0000","1157","461","696","60","1217","2098","0","58.01","21.97"
"10","014","00","001","0134","0039","1157","461","696","60","1217","2098","0","58.01","21.97"
"10","014","00","001","0135","0000","747","254","493","48","795","1324","0","60.05","19.18"
"10","014","00","001","0135","0040","747","254","493","48","795","1324","0","60.05","19.18"
"10","014","00","001","0136","0000","1484","521","963","53","1537","2793","0","55.03","18.65"
"10","014","00","001","0136","0021","635","222","413","30","665","1292","0","51.47","17.18"
"10","014","00","001","0136","0022","849","299","550","23","872","1501","0","58.09","19.92"
"10","014","00","001","0137","0000","528","206","322","39","567","1001","0","56.64","20.58"
"10","014","00","001","0137","0025","528","206","322","39","567","1001","0","56.64","20.58"
"10","014","00","001","0138","0000","4051","1362","2689","182","4233","8002","0","52.9","17.02"
"10","014","00","001","0138","0041","822","278","544","43","865","1598","0","54.13","17.4"
"10","014","00","001","0138","0042","790","238","552","23","813","1513","0","53.73","15.73"
"10","014","00","001","0138","0043","826","269","557","31","857","1679","0","51.04","16.02"
"10","014","00","001","0138","0044","712","291","421","42","754","1414","0","53.32","20.58"
"10","014","00","001","0138","0045","901","286","615","43","944","1798","0","52.5","15.91"
"10","014","00","001","0139","0000","2446","857","1589","169","2615","5087","0","51.41","16.85"
"10","014","00","001","0139","0046","765","268","497","59","824","1749","0","47.11","15.32"
"10","014","00","001","0139","0047","863","298","565","66","929","1709","0","54.36","17.44"
"10","014","00","001","0139","0048","818","291","527","44","862","1629","0","52.92","17.86"
"10","014","00","001","0140","0000","1130","476","654","67","1197","2375","0","50.4","20.04"
"10","014","00","001","0140","0049","560","217","343","37","597","1116","0","53.49","19.44"
"10","014","00","001","0140","0050","570","259","311","30","600","1259","0","47.66","20.57"
"10","014","00","001","0141","0000","544","230","314","27","571","1232","0","46.35","18.67"
"10","014","00","001","0141","0051","544","230","314","27","571","1232","0","46.35","18.67"
"10","014","00","001","0142","0000","678","285","393","66","744","1385","0","53.72","20.58"
"10","014","00","001","0142","0064","678","285","393","66","744","1385","0","53.72","20.58"
"10","014","00","001","0143","0000","430","181","249","17","447","939","0","47.6","19.28"
"10","014","00","001","0143","0065","430","181","249","17","447","939","0","47.6","19.28"
"10","014","00","001","0144","0000","547","227","320","43","590","1258","0","46.9","18.04"
"10","014","00","001","0144","0066","547","227","320","43","590","1258","0","46.9","18.04"
"10","014","00","001","0145","0000","651","261","390","9","660","1350","0","48.89","19.33"
"10","014","00","001","0145","0067","651","261","390","9","660","1350","0","48.89","19.33"
"10","014","00","001","0146","0000","835","275","560","40","875","1953","0","44.8","14.08"
"10","014","00","001","0146","0068","476","150","326","11","487","1058","0","46.03","14.18"
"10","014","00","001","0146","0069","359","125","234","29","388","895","0","43.35","13.97"
"10","014","00","002","0000","0000","5595","1958","3637","601","6196","12426","14105","49.86","15.76"
"10","014","00","002","0201","0000","201","58","143","31","232","637","0","36.42","9.11"
"10","014","00","002","0201","0085","85","21","64","3","88","373","0","23.59","5.63"
"10","014","00","002","0201","0086","116","37","79","28","144","264","0","54.55","14.02"
"10","014","00","002","0202","0000","338","143","195","77","415","969","0","42.83","14.76"
"10","014","00","002","0202","0083","175","68","107","45","220","488","0","45.08","13.93"
"10","014","00","002","0202","0084","163","75","88","32","195","481","0","40.54","15.59"
"10","014","00","002","0203","0000","571","211","360","95","666","1403","0","47.47","15.04"
"10","014","00","002","0203","0081","224","77","147","39","263","516","0","50.97","14.92"
"10","014","00","002","0203","0082","347","134","213","56","403","887","0","45.43","15.11"
"10","014","00","002","0204","0000","1301","390","911","113","1414","2731","0","51.78","14.28"
"10","014","00","002","0204","0079","629","200","429","60","689","1365","0","50.48","14.65"
"10","014","00","002","0204","0080","672","190","482","53","725","1366","0","53.07","13.91"
"10","014","00","002","0205","0000","955","318","637","54","1009","1901","0","53.08","16.73"
"10","014","00","002","0205","0077","480","172","308","30","510","931","0","54.78","18.47"
"10","014","00","002","0205","0078","475","146","329","24","499","970","0","51.44","15.05"
"10","014","00","002","0206","0000","1072","431","641","54","1126","2197","0","51.25","19.62"
"10","014","00","002","0206","0074","144","55","89","16","160","339","0","47.2","16.22"
"10","014","00","002","0206","0075","470","173","297","12","482","995","0","48.44","17.39"
"10","014","00","002","0206","0076","458","203","255","26","484","863","0","56.08","23.52"
"10","014","00","002","0207","0000","294","118","176","51","345","747","0","46.18","15.8"
"10","014","00","002","0207","0073","294","118","176","51","345","747","0","46.18","15.8"
"10","014","00","002","0208","0000","863","289","574","126","989","1841","0","53.72","15.7"
"10","014","00","002","0208","0070","212","63","149","56","268","516","0","51.94","12.21"
"10","014","00","002","0208","0071","528","184","344","59","587","960","0","61.15","19.17"
"10","014","00","002","0208","0072","123","42","81","11","134","365","0","36.71","11.51"
"10","014","00","003","0000","0000","3567","1337","2230","191","3758","7509","8727","50.05","17.81"
"10","014","00","003","0301","0000","745","274","471","48","793","1691","0","46.9","16.2"
"10","014","00","003","0301","0093","438","146","292","37","475","912","0","52.08","16.01"
"10","014","00","003","0301","0094","307","128","179","11","318","779","0","40.82","16.43"
"10","014","00","003","0302","0000","599","205","394","28","627","1137","0","55.15","18.03"
"10","014","00","003","0302","0091","599","205","394","28","627","1137","0","55.15","18.03"
"10","014","00","003","0303","0000","366","149","217","23","389","887","0","43.86","16.8"
"10","014","00","003","0303","0090","366","149","217","23","389","887","0","43.86","16.8"
"10","014","00","003","0304","0000","476","173","303","25","501","828","0","60.51","20.89"
"10","014","00","003","0304","0089","476","173","303","25","501","828","0","60.51","20.89"
"10","014","00","003","0305","0000","853","325","528","34","887","1699","0","52.21","19.13"
"10","014","00","003","0305","0087","519","181","338","23","542","909","0","59.63","19.91"
"10","014","00","003","0305","0088","334","144","190","11","345","790","0","43.67","18.23"
"10","014","00","003","0306","0000","196","68","128","11","207","535","0","38.69","12.71"
"10","014","00","003","0306","0095","196","68","128","11","207","535","0","38.69","12.71"
"10","014","00","003","0307","0000","332","143","189","22","354","732","0","48.36","19.54"
"10","014","00","003","0307","0092","332","143","189","22","354","732","0","48.36","19.54"
"10","014","00","004","0000","0000","7316","3064","4252","610","7926","14976","17314","52.92","20.46"
"10","014","00","004","0401","0000","197","117","80","20","217","476","0","45.59","24.58"
"10","014","00","004","0401","0105","88","55","33","8","96","261","0","36.78","21.07"
"10","014","00","004","0401","0106","109","62","47","12","121","215","0","56.28","28.84"
"10","014","00","004","0402","0000","224","81","143","15","239","436","0","54.82","18.58"
"10","014","00","004","0402","0117","224","81","143","15","239","436","0","54.82","18.58"
"10","014","00","004","0403","0000","203","67","136","17","220","488","0","45.08","13.73"
"10","014","00","004","0403","0115","203","67","136","17","220","488","0","45.08","13.73"
"10","014","00","004","0404","0000","189","99","90","14","203","347","0","58.5","28.53"
"10","014","00","004","0404","0116","189","99","90","14","203","347","0","58.5","28.53"
"10","014","00","004","0405","0000","529","243","286","62","591","1163","0","50.82","20.89"
"10","014","00","004","0405","0103","323","155","168","37","360","727","0","49.52","21.32"
"10","014","00","004","0405","0104","206","88","118","25","231","436","0","52.98","20.18"
"10","014","00","004","0406","0000","575","252","323","51","626","1270","0","49.29","19.84"
"10","014","00","004","0406","0101","324","135","189","25","349","767","0","45.5","17.6"
"10","014","00","004","0406","0102","251","117","134","26","277","503","0","55.07","23.26"
"10","014","00","004","0407","0000","434","203","231","49","483","1066","0","45.31","19.04"
"10","014","00","004","0407","0098","87","50","37","15","102","219","0","46.58","22.83"
"10","014","00","004","0407","0099","206","98","108","20","226","460","0","49.13","21.3"
"10","014","00","004","0407","0100","141","55","86","14","155","387","0","40.05","14.21"
"10","014","00","004","0408","0000","1140","515","625","45","1185","2206","0","53.72","23.35"
"10","014","00","004","0408","0096","579","310","269","30","609","1041","0","58.5","29.78"
"10","014","00","004","0408","0097","561","205","356","15","576","1165","0","49.44","17.6"
"10","014","00","004","0409","0000","553","232","321","49","602","1110","0","54.23","20.9"
"10","014","00","004","0409","0110","553","232","321","49","602","1110","0","54.23","20.9"
"10","014","00","004","0410","0000","1544","568","976","106","1650","3015","0","54.73","18.84"
"10","014","00","004","0410","0107","750","301","449","53","803","1442","0","55.69","20.87"
"10","014","00","004","0410","0108","253","81","172","11","264","527","0","50.09","15.37"
"10","014","00","004","0410","0109","541","186","355","42","583","1046","0","55.74","17.78"
"10","014","00","004","0411","0000","597","230","367","35","632","1105","0","57.19","20.81"
"10","014","00","004","0411","0111","597","230","367","35","632","1105","0","57.19","20.81"
"10","014","00","004","0412","0000","607","182","425","122","729","1167","0","62.47","15.6"
"10","014","00","004","0412","0112","607","182","425","122","729","1167","0","62.47","15.6"
"10","014","00","004","0413","0000","524","275","249","25","549","1127","0","48.71","24.4"
"10","014","00","004","0413","0113","458","236","222","23","481","968","0","49.69","24.38"
"10","014","00","004","0413","0114","66","39","27","2","68","159","0","42.77","24.53"
"10","014","00","005","0000","0000","2956","1313","1643","206","3162","6936","7891","45.59","18.93"
"10","014","00","005","0501","0000","254","125","129","34","288","675","0","42.67","18.52"
"10","014","00","005","0501","0125","254","125","129","34","288","675","0","42.67","18.52"
"10","014","00","005","0502","0000","400","216","184","15","415","905","0","45.86","23.87"
"10","014","00","005","0502","0126","210","109","101","9","219","435","0","50.34","25.06"
"10","014","00","005","0502","0127","190","107","83","6","196","470","0","41.7","22.77"
"10","014","00","005","0503","0000","387","165","222","43","430","864","0","49.77","19.1"
"10","014","00","005","0503","0124","387","165","222","43","430","864","0","49.77","19.1"
"10","014","00","005","0504","0000","630","273","357","42","672","1446","0","46.47","18.88"
"10","014","00","005","0504","0121","484","225","259","33","517","1104","0","46.83","20.38"
"10","014","00","005","0504","0122","146","48","98","9","155","342","0","45.32","14.04"
"10","014","00","005","0505","0000","396","161","235","31","427","895","0","47.71","17.99"
"10","014","00","005","0505","0123","396","161","235","31","427","895","0","47.71","17.99"
"10","014","00","005","0506","0000","483","187","296","21","504","1096","0","45.99","17.06"
"10","014","00","005","0506","0118","186","62","124","8","194","522","0","37.16","11.88"
"10","014","00","005","0506","0119","297","125","172","13","310","574","0","54.01","21.78"
"10","014","00","005","0507","0000","406","186","220","20","426","1055","0","40.38","17.63"
"10","014","00","005","0507","0120","406","186","220","20","426","1055","0","40.38","17.63"
"10","014","00","006","0000","0000","3134","1293","1841","221","3355","7162","8207","46.84","18.05"
"10","014","00","006","0601","0000","479","198","281","39","518","1137","0","45.56","17.41"
"10","014","00","006","0601","0130","193","90","103","18","211","434","0","48.62","20.74"
"10","014","00","006","0601","0131","286","108","178","21","307","703","0","43.67","15.36"
"10","014","00","006","0602","0000","283","122","161","12","295","654","0","45.11","18.65"
"10","014","00","006","0602","0132","283","122","161","12","295","654","0","45.11","18.65"
"10","014","00","006","0603","0000","113","44","69","17","130","324","0","40.12","13.58"
"10","014","00","006","0603","0133","113","44","69","17","130","324","0","40.12","13.58"
"10","014","00","006","0604","0000","333","123","210","34","367","794","0","46.22","15.49"
"10","014","00","006","0604","0134","333","123","210","34","367","794","0","46.22","15.49"
"10","014","00","006","0605","0000","960","388","572","49","1009","1921","0","52.52","20.2"
"10","014","00","006","0605","0128","462","174","288","27","489","992","0","49.29","17.54"
"10","014","00","006","0605","0129","498","214","284","22","520","929","0","55.97","23.04"
"10","014","00","006","0606","0000","141","61","80","8","149","344","0","43.31","17.73"
"10","014","00","006","0606","0136","141","61","80","8","149","344","0","43.31","17.73"
"10","014","00","006","0607","0000","391","166","225","25","416","856","0","48.6","19.39"
"10","014","00","006","0607","0135","391","166","225","25","416","856","0","48.6","19.39"
"10","014","00","006","0608","0000","167","75","92","14","181","311","0","58.2","24.12"
"10","014","00","006","0608","0137","167","75","92","14","181","311","0","58.2","24.12"
"10","014","00","006","0609","0000","130","54","76","8","138","386","0","35.75","13.99"
"10","014","00","006","0609","0138","130","54","76","8","138","386","0","35.75","13.99"
"10","014","00","006","0610","0000","137","62","75","15","152","435","0","34.94","14.25"
"10","014","00","006","0610","0139","137","62","75","15","152","435","0","34.94","14.25"
"10","014","00","007","0000","0000","3047","1212","1835","299","3346","7635","8518","43.82","15.87"
"10","014","00","007","0701","0000","486","182","304","48","534","1620","0","32.96","11.23"
"10","014","00","007","0701","0147","196","66","130","17","213","867","0","24.57","7.61"
"10","014","00","007","0701","0148","137","57","80","11","148","345","0","42.9","16.52"
"10","014","00","007","0701","0149","153","59","94","20","173","408","0","42.4","14.46"
"10","014","00","007","0702","0000","343","127","216","18","361","1197","0","30.16","10.61"
"10","014","00","007","0702","0146","343","127","216","18","361","1197","0","30.16","10.61"
"10","014","00","007","0703","0000","396","132","264","27","423","977","0","43.3","13.51"
"10","014","00","007","0703","0145","396","132","264","27","423","977","0","43.3","13.51"
"10","014","00","007","0704","0000","106","44","62","8","114","262","0","43.51","16.79"
"10","014","00","007","0704","0150","106","44","62","8","114","262","0","43.51","16.79"
"10","014","00","007","0705","0000","219","73","146","38","257","555","0","46.31","13.15"
"10","014","00","007","0705","0144","219","73","146","38","257","555","0","46.31","13.15"
"10","014","00","007","0706","0000","373","148","225","62","435","918","0","47.39","16.12"
"10","014","00","007","0706","0143","373","148","225","62","435","918","0","47.39","16.12"
"10","014","00","007","0707","0000","1124","506","618","98","1222","2106","0","58.02","24.03"
"10","014","00","007","0707","0140","119","66","53","6","125","290","0","43.1","22.76"
"10","014","00","007","0707","0141","328","156","172","28","356","620","0","57.42","25.16"
"10","014","00","007","0707","0142","677","284","393","64","741","1196","0","61.96","23.75"
"10","014","00","008","0000","0000","2385","927","1458","358","2743","6484","7196","42.3","14.3"
"10","014","00","008","0801","0000","249","102","147","32","281","630","0","44.6","16.19"
"10","014","00","008","0801","0160","13","10","3","0","13","25","0","52.0","40.0"
"10","014","00","008","0801","0161","236","92","144","32","268","605","0","44.3","15.21"
"10","014","00","008","0802","0000","383","134","249","72","455","1191","0","38.2","11.25"
"10","014","00","008","0802","0157","224","87","137","55","279","660","0","42.27","13.18"
"10","014","00","008","0802","0158","107","27","80","5","112","336","0","33.33","8.04"
"10","014","00","008","0802","0159","52","20","32","12","64","195","0","32.82","10.26"
"10","014","00","008","0803","0000","143","71","72","6","149","532","0","28.01","13.35"
"10","014","00","008","0803","0156","143","71","72","6","149","532","0","28.01","13.35"
"10","014","00","008","0804","0000","733","290","443","75","808","1993","0","40.54","14.55"
"10","014","00","008","0804","0154","443","178","265","25","468","1268","0","36.91","14.04"
"10","014","00","008","0804","0155","290","112","178","50","340","725","0","46.9","15.45"
"10","014","00","008","0805","0000","417","164","253","92","509","913","0","55.75","17.96"
"10","014","00","008","0805","0153","417","164","253","92","509","913","0","55.75","17.96"
"10","014","00","008","0806","0000","460","166","294","81","541","1225","0","44.16","13.55"
"10","014","00","008","0806","0151","250","112","138","59","309","536","0","57.65","20.9"
"10","014","00","008","0806","0152","210","54","156","22","232","689","0","33.67","7.84"
"10","014","00","009","0000","0000","4384","1819","2565","385","4769","9666","11186","49.34","18.82"
"10","014","00","009","0901","0000","641","265","376","40","681","1297","0","52.51","20.43"
"10","014","00","009","0901","0162","361","169","192","24","385","722","0","53.32","23.41"
"10","014","00","009","0901","0163","280","96","184","16","296","575","0","51.48","16.7"
"10","014","00","009","0902","0000","300","130","170","18","318","623","0","51.04","20.87"
"10","014","00","009","0902","0164","300","130","170","18","318","623","0","51.04","20.87"
"10","014","00","009","0903","0000","277","148","129","33","310","622","0","49.84","23.79"
"10","014","00","009","0903","0165","277","148","129","33","310","622","0","49.84","23.79"
"10","014","00","009","0904","0000","224","97","127","10","234","560","0","41.79","17.32"
"10","014","00","009","0904","0166","224","97","127","10","234","560","0","41.79","17.32"
"10","014","00","009","0905","0000","742","289","453","54","796","1410","0","56.45","20.5"
"10","014","00","009","0905","0169","392","155","237","24","416","673","0","61.81","23.03"
"10","014","00","009","0905","0170","350","134","216","30","380","737","0","51.56","18.18"
"10","014","00","009","0906","0000","816","338","478","109","925","1766","0","52.38","19.14"
"10","014","00","009","0906","0167","462","153","309","74","536","957","0","56.01","15.99"
"10","014","00","009","0906","0168","354","185","169","35","389","809","0","48.08","22.87"
"10","014","00","009","0907","0000","376","170","206","44","420","798","0","52.63","21.3"
"10","014","00","009","0907","0171","218","88","130","23","241","424","0","56.84","20.75"
"10","014","00","009","0907","0172","158","82","76","21","179","374","0","47.86","21.93"
"10","014","00","009","0908","0000","615","230","385","34","649","1698","0","38.22","13.55"
"10","014","00","009","0908","0173","292","119","173","26","318","829","0","38.36","14.35"
"10","014","00","009","0908","0174","323","111","212","8","331","869","0","38.09","12.77"
"10","014","00","009","0909","0000","393","152","241","43","436","892","0","48.88","17.04"
"10","014","00","009","0909","0175","63","23","40","8","71","223","0","31.84","10.31"
"10","014","00","009","0909","0176","330","129","201","35","365","669","0","54.56","19.28"
"10","014","00","010","0000","0000","2357","915","1442","348","2705","5266","6100","51.37","17.38"
"10","014","00","010","1001","0000","314","115","199","80","394","763","0","51.64","15.07"
"10","014","00","010","1001","0181","153","48","105","60","213","386","0","55.18","12.44"
"10","014","00","010","1001","0182","161","67","94","20","181","377","0","48.01","17.77"
"10","014","00","010","1002","0000","459","228","231","74","533","1134","0","47.0","20.11"
"10","014","00","010","1002","0180","459","228","231","74","533","1134","0","47.0","20.11"
"10","014","00","010","1003","0000","634","179","455","74","708","1327","0","53.35","13.49"
"10","014","00","010","1003","0179","634","179","455","74","708","1327","0","53.35","13.49"
"10","014","00","010","1004","0000","657","293","364","74","731","1474","0","49.59","19.88"
"10","014","00","010","1004","0178","657","293","364","74","731","1474","0","49.59","19.88"
"10","014","00","010","1005","0000","293","100","193","46","339","568","0","59.68","17.61"
"10","014","00","010","1005","0177","293","100","193","46","339","568","0","59.68","17.61"
"10","014","00","011","0000","0000","1525","520","1005","62","1587","3579","4097","44.34","14.53"
"10","014","00","011","1101","0000","464","166","298","19","483","1023","0","47.21","16.23"
"10","014","00","011","1101","0185","363","127","236","18","381","813","0","46.86","15.62"
"10","014","00","011","1101","0186","101","39","62","1","102","210","0","48.57","18.57"
"10","014","00","011","1102","0000","455","151","304","22","477","1082","0","44.09","13.96"
"10","014","00","011","1102","0184","455","151","304","22","477","1082","0","44.09","13.96"
"10","014","00","011","1103","0000","606","203","403","21","627","1474","0","42.54","13.77"
"10","014","00","011","1103","0183","606","203","403","21","627","1474","0","42.54","13.77"
"10","014","00","012","0000","0000","1607","523","1084","144","1751","3278","4207","53.42","15.95"
"10","014","00","012","1201","0000","361","114","247","32","393","728","0","53.98","15.66"
"10","014","00","012","1201","0190","361","114","247","32","393","728","0","53.98","15.66"
"10","014","00","012","1202","0000","134","54","80","13","147","259","0","56.76","20.85"
"10","014","00","012","1202","0191","134","54","80","13","147","259","0","56.76","20.85"
"10","014","00","012","1203","0000","120","34","86","15","135","254","0","53.15","13.39"
"10","014","00","012","1203","0192","120","34","86","15","135","254","0","53.15","13.39"
"10","014","00","012","1204","0000","442","148","294","41","483","971","0","49.74","15.24"
"10","014","00","012","1204","0189","442","148","294","41","483","971","0","49.74","15.24"
"10","014","00","012","1205","0000","314","85","229","16","330","569","0","58.0","14.94"
"10","014","00","012","1205","0188","314","85","229","16","330","569","0","58.0","14.94"
"10","014","00","012","1206","0000","236","88","148","27","263","497","0","52.92","17.71"
"10","014","00","012","1206","0187","236","88","148","27","263","497","0","52.92","17.71"
"10","014","00","013","0000","0000","1439","462","977","134","1573","2930","3656","53.69","15.77"
"10","014","00","013","1301","0000","247","67","180","11","258","579","0","44.56","11.57"
"10","014","00","013","1301","0196","247","67","180","11","258","579","0","44.56","11.57"
"10","014","00","013","1302","0000","186","57","129","23","209","315","0","66.35","18.1"
"10","014","00","013","1302","0195","186","57","129","23","209","315","0","66.35","18.1"
"10","014","00","013","1303","0000","248","89","159","48","296","426","0","69.48","20.89"
"10","014","00","013","1303","0194","248","89","159","48","296","426","0","69.48","20.89"
"10","014","00","013","1304","0000","258","73","185","18","276","596","0","46.31","12.25"
"10","014","00","013","1304","0197","258","73","185","18","276","596","0","46.31","12.25"
"10","014","00","013","1305","0000","500","176","324","34","534","1014","0","52.66","17.36"
"10","014","00","013","1305","0193","500","176","324","34","534","1014","0","52.66","17.36"
"10","014","00","014","0000","0000","1598","473","1125","156","1754","3028","3748","57.93","15.62"
"10","014","00","014","1401","0000","362","117","245","31","393","520","0","75.58","22.5"
"10","014","00","014","1401","0200","362","117","245","31","393","520","0","75.58","22.5"
"10","014","00","014","1402","0000","356","81","275","33","389","601","0","64.73","13.48"
"10","014","00","014","1402","0199","356","81","275","33","389","601","0","64.73","13.48"
"10","014","00","014","1403","0000","566","176","390","41","607","1241","0","48.91","14.18"
"10","014","00","014","1403","0198","566","176","390","41","607","1241","0","48.91","14.18"
"10","014","00","014","1404","0000","170","51","119","21","191","336","0","56.85","15.18"
"10","014","00","014","1404","0201","170","51","119","21","191","336","0","56.85","15.18"
"10","014","00","014","1405","0000","144","48","96","30","174","330","0","52.73","14.55"
"10","014","00","014","1405","0202","144","48","96","30","174","330","0","52.73","14.55"
"10","014","00","015","0000","0000","1645","512","1133","163","1808","3137","3615","57.63","16.32"
"10","014","00","015","1501","0000","261","78","183","21","282","628","0","44.9","12.42"
"10","014","00","015","1501","0208","261","78","183","21","282","628","0","44.9","12.42"
"10","014","00","015","1502","0000","429","138","291","41","470","867","0","54.21","15.92"
"10","014","00","015","1502","0209","429","138","291","41","470","867","0","54.21","15.92"
"10","014","00","015","1503","0000","191","68","123","23","214","331","0","64.65","20.54"
"10","014","00","015","1503","0207","191","68","123","23","214","331","0","64.65","20.54"
"10","014","00","015","1504","0000","331","93","238","41","372","586","0","63.48","15.87"
"10","014","00","015","1504","0203","133","50","83","21","154","246","0","62.6","20.33"
"10","014","00","015","1504","0204","198","43","155","20","218","340","0","64.12","12.65"
"10","014","00","015","1505","0000","248","76","172","27","275","429","0","64.1","17.72"
"10","014","00","015","1505","0206","248","76","172","27","275","429","0","64.1","17.72"
"10","014","00","015","1506","0000","185","59","126","10","195","296","0","65.88","19.93"
"10","014","00","015","1506","0205","185","59","126","10","195","296","0","65.88","19.93"
"10","014","00","016","0000","0000","1504","645","859","101","1605","4181","5114","38.39","15.43"
"10","014","00","016","1601","0000","394","143","251","14","408","1240","0","32.9","11.53"
"10","014","00","016","1601","0212","394","143","251","14","408","1240","0","32.9","11.53"
"10","014","00","016","1602","0000","252","153","99","27","279","760","0","36.71","20.13"
"10","014","00","016","1602","0213","252","153","99","27","279","760","0","36.71","20.13"
"10","014","00","016","1603","0000","495","200","295","36","531","1238","0","42.89","16.16"
"10","014","00","016","1603","0211","495","200","295","36","531","1238","0","42.89","16.16"
"10","014","00","016","1604","0000","363","149","214","24","387","943","0","41.04","15.8"
"10","014","00","016","1604","0210","363","149","214","24","387","943","0","41.04","15.8"
"10","016","00","000","0000","0000","39432","16396","23036","2016","41448","90405","104400","45.85","18.14"
"10","016","00","001","0000","0000","25278","9944","15334","1141","26419","53655","62523","49.24","18.53"
"10","016","00","001","0102","0000","217","77","140","10","227","481","0","47.19","16.01"
"10","016","00","001","0102","0001","217","77","140","10","227","481","0","47.19","16.01"
"10","016","00","001","0103","0000","285","113","172","7","292","558","0","52.33","20.25"
"10","016","00","001","0103","0002","285","113","172","7","292","558","0","52.33","20.25"
"10","016","00","001","0104","0000","242","109","133","21","263","533","0","49.34","20.45"
"10","016","00","001","0104","0003","242","109","133","21","263","533","0","49.34","20.45"
"10","016","00","001","0105","0000","460","210","250","25","485","922","0","52.6","22.78"
"10","016","00","001","0105","0004","460","210","250","25","485","922","0","52.6","22.78"
"10","016","00","001","0106","0000","534","257","277","22","556","1021","0","54.46","25.17"
"10","016","00","001","0106","0005","534","257","277","22","556","1021","0","54.46","25.17"
"10","016","00","001","0107","0000","386","151","235","22","408","793","0","51.45","19.04"
"10","016","00","001","0107","0006","386","151","235","22","408","793","0","51.45","19.04"
"10","016","00","001","0108","0000","993","433","560","39","1032","1955","0","52.79","22.15"
"10","016","00","001","0108","0007","489","217","272","25","514","954","0","53.88","22.75"
"10","016","00","001","0108","0008","504","216","288","14","518","1001","0","51.75","21.58"
"10","016","00","001","0109","0000","1982","626","1356","110","2092","4130","0","50.65","15.16"
"10","016","00","001","0109","0010","623","170","453","41","664","1402","0","47.36","12.13"
"10","016","00","001","0109","0011","700","239","461","28","728","1389","0","52.41","17.21"
"10","016","00","001","0109","0012","659","217","442","41","700","1339","0","52.28","16.21"
"10","016","00","001","0110","0000","504","208","296","29","533","1192","0","44.71","17.45"
"10","016","00","001","0110","0009","504","208","296","29","533","1192","0","44.71","17.45"
"10","016","00","001","0111","0000","2502","952","1550","119","2621","5281","0","49.63","18.03"
"10","016","00","001","0111","0013","563","233","330","28","591","1254","0","47.13","18.58"
"10","016","00","001","0111","0014","564","210","354","37","601","1194","0","50.34","17.59"
"10","016","00","001","0111","0015","639","260","379","33","672","1393","0","48.24","18.66"
"10","016","00","001","0111","0016","736","249","487","21","757","1440","0","52.57","17.29"
"10","016","00","001","0112","0000","1177","485","692","55","1232","2499","0","49.3","19.41"
"10","016","00","001","0112","0017","577","233","344","22","599","1215","0","49.3","19.18"
"10","016","00","001","0112","0018","600","252","348","33","633","1284","0","49.3","19.63"
"10","016","00","001","0113","0000","730","239","491","23","753","1512","0","49.8","15.81"
"10","016","00","001","0113","0019","730","239","491","23","753","1512","0","49.8","15.81"
"10","016","00","001","0114","0000","2788","1025","1763","130","2918","6044","0","48.28","16.96"
"10","016","00","001","0114","0020","527","210","317","44","571","1181","0","48.35","17.78"
"10","016","00","001","0114","0021","647","229","418","33","680","1348","0","50.45","16.99"
"10","016","00","001","0114","0022","692","238","454","28","720","1391","0","51.76","17.11"
"10","016","00","001","0114","0023","922","348","574","25","947","2124","0","44.59","16.38"
"10","016","00","001","0115","0000","1475","552","923","60","1535","3082","0","49.81","17.91"
"10","016","00","001","0115","0024","717","263","454","36","753","1500","0","50.2","17.53"
"10","016","00","001","0115","0025","758","289","469","24","782","1582","0","49.43","18.27"
"10","016","00","001","0116","0000","1568","562","1006","49","1617","3192","0","50.66","17.61"
"10","016","00","001","0116","0026","783","274","509","20","803","1638","0","49.02","16.73"
"10","016","00","001","0116","0027","785","288","497","29","814","1554","0","52.38","18.53"
"10","016","00","001","0117","0000","802","315","487","32","834","1872","0","44.55","16.83"
"10","016","00","001","0117","0028","371","152","219","13","384","980","0","39.18","15.51"
"10","016","00","001","0117","0029","431","163","268","19","450","892","0","50.45","18.27"
"10","016","00","001","0118","0000","313","111","202","9","322","778","0","41.39","14.27"
"10","016","00","001","0118","0030","313","111","202","9","322","778","0","41.39","14.27"
"10","016","00","001","0119","0000","471","190","281","12","483","930","0","51.94","20.43"
"10","016","00","001","0119","0031","471","190","281","12","483","930","0","51.94","20.43"
"10","016","00","001","0120","0000","1431","496","935","39","1470","2609","0","56.34","19.01"
"10","016","00","001","0120","0032","841","292","549","25","866","1481","0","58.47","19.72"
"10","016","00","001","0120","0033","590","204","386","14","604","1128","0","53.55","18.09"
"10","016","00","001","0121","0000","213","89","124","8","221","415","0","53.25","21.45"
"10","016","00","001","0121","0034","213","89","124","8","221","415","0","53.25","21.45"
"10","016","00","001","0122","0000","1036","368","668","42","1078","2070","0","52.08","17.78"
"10","016","00","001","0122","0035","532","168","364","29","561","1120","0","50.09","15.0"
"10","016","00","001","0122","0036","504","200","304","13","517","950","0","54.42","21.05"
"10","016","00","001","0123","0000","277","134","143","11","288","627","0","45.93","21.37"
"10","016","00","001","0123","0037","277","134","143","11","288","627","0","45.93","21.37"
"10","016","00","001","0124","0000","507","239","268","17","524","989","0","52.98","24.17"
"10","016","00","001","0124","0039","507","239","268","17","524","989","0","52.98","24.17"
"10","016","00","001","0125","0000","525","190","335","18","543","1055","0","51.47","18.01"
"10","016","00","001","0125","0038","525","190","335","18","543","1055","0","51.47","18.01"
"10","016","00","001","0126","0000","308","143","165","23","331","591","0","56.01","24.2"
"10","016","00","001","0126","0040","308","143","165","23","331","591","0","56.01","24.2"
"10","016","00","001","0127","0000","835","389","446","27","862","1700","0","50.71","22.88"
"10","016","00","001","0127","0043","388","170","218","17","405","797","0","50.82","21.33"
"10","016","00","001","0127","0044","447","219","228","10","457","903","0","50.61","24.25"
"10","016","00","001","0128","0000","1078","529","549","66","1144","2466","0","46.39","21.45"
"10","016","00","001","0128","0041","627","280","347","33","660","1387","0","47.58","20.19"
"10","016","00","001","0128","0042","451","249","202","33","484","1079","0","44.86","23.08"
"10","016","00","001","0129","0000","170","90","80","10","180","376","0","47.87","23.94"
"10","016","00","001","0129","0045","170","90","80","10","180","376","0","47.87","23.94"
"10","016","00","001","0130","0000","183","73","110","14","197","371","0","53.1","19.68"
"10","016","00","001","0130","0046","183","73","110","14","197","371","0","53.1","19.68"
"10","016","00","001","0131","0000","459","177","282","20","479","1173","0","40.84","15.09"
"10","016","00","001","0131","0047","459","177","282","20","479","1173","0","40.84","15.09"
"10","016","00","001","0132","0000","488","259","229","21","509","1389","0","36.65","18.65"
"10","016","00","001","0132","0048","488","259","229","21","509","1389","0","36.65","18.65"
"10","016","00","001","0133","0000","177","90","87","37","214","761","0","28.12","11.83"
"10","016","00","001","0133","0049","177","90","87","37","214","761","0","28.12","11.83"
"10","016","00","001","0134","0000","162","63","99","14","176","288","0","61.11","21.88"
"10","016","00","001","0134","0050","162","63","99","14","176","288","0","61.11","21.88"
"10","016","00","002","0000","0000","5462","2445","3017","269","5731","12741","14533","44.98","19.19"
"10","016","00","002","0201","0000","564","220","344","35","599","1120","0","53.48","19.64"
"10","016","00","002","0201","0051","564","220","344","35","599","1120","0","53.48","19.64"
"10","016","00","002","0202","0000","139","56","83","5","144","332","0","43.37","16.87"
"10","016","00","002","0202","0052","139","56","83","5","144","332","0","43.37","16.87"
"10","016","00","002","0203","0000","100","46","54","4","104","242","0","42.98","19.01"
"10","016","00","002","0203","0053","100","46","54","4","104","242","0","42.98","19.01"
"10","016","00","002","0204","0000","110","59","51","3","113","293","0","38.57","20.14"
"10","016","00","002","0204","0054","110","59","51","3","113","293","0","38.57","20.14"
"10","016","00","002","0205","0000","257","122","135","20","277","666","0","41.59","18.32"
"10","016","00","002","0205","0055","257","122","135","20","277","666","0","41.59","18.32"
"10","016","00","002","0206","0000","151","60","91","11","162","326","0","49.69","18.4"
"10","016","00","002","0206","0056","151","60","91","11","162","326","0","49.69","18.4"
"10","016","00","002","0207","0000","308","155","153","13","321","732","0","43.85","21.17"
"10","016","00","002","0207","0057","308","155","153","13","321","732","0","43.85","21.17"
"10","016","00","002","0208","0000","294","111","183","10","304","651","0","46.7","17.05"
"10","016","00","002","0208","0058","294","111","183","10","304","651","0","46.7","17.05"
"10","016","00","002","0209","0000","328","130","198","15","343","744","0","46.1","17.47"
"10","016","00","002","0209","0059","328","130","198","15","343","744","0","46.1","17.47"
"10","016","00","002","0210","0000","71","34","37","3","74","134","0","55.22","25.37"
"10","016","00","002","0210","0060","71","34","37","3","74","134","0","55.22","25.37"
"10","016","00","002","0211","0000","77","35","42","2","79","216","0","36.57","16.2"
"10","016","00","002","0211","0062","77","35","42","2","79","216","0","36.57","16.2"
"10","016","00","002","0212","0000","131","58","73","3","134","279","0","48.03","20.79"
"10","016","00","002","0212","0064","131","58","73","3","134","279","0","48.03","20.79"
"10","016","00","002","0213","0000","189","62","127","11","200","664","0","30.12","9.34"
"10","016","00","002","0213","0063","189","62","127","11","200","664","0","30.12","9.34"
"10","016","00","002","0214","0000","149","53","96","1","150","296","0","50.68","17.91"
"10","016","00","002","0214","0065","149","53","96","1","150","296","0","50.68","17.91"
"10","016","00","002","0215","0000","315","180","135","13","328","794","0","41.31","22.67"
"10","016","00","002","0215","0061","315","180","135","13","328","794","0","41.31","22.67"
"10","016","00","002","0216","0000","118","39","79","4","122","257","0","47.47","15.18"
"10","016","00","002","0216","0066","118","39","79","4","122","257","0","47.47","15.18"
"10","016","00","002","0217","0000","26","8","18","1","27","89","0","30.34","8.99"
"10","016","00","002","0217","0067","26","8","18","1","27","89","0","30.34","8.99"
"10","016","00","002","0218","0000","378","178","200","18","396","815","0","48.59","21.84"
"10","016","00","002","0218","0068","378","178","200","18","396","815","0","48.59","21.84"
"10","016","00","002","0219","0000","394","169","225","14","408","975","0","41.85","17.33"
"10","016","00","002","0219","0069","394","169","225","14","408","975","0","41.85","17.33"
"10","016","00","002","0220","0000","301","165","136","20","321","648","0","49.54","25.46"
"10","016","00","002","0220","0070","301","165","136","20","321","648","0","49.54","25.46"
"10","016","00","002","0221","0000","789","371","418","52","841","1739","0","48.36","21.33"
"10","016","00","002","0221","0071","382","192","190","21","403","893","0","45.13","21.5"
"10","016","00","002","0221","0072","407","179","228","31","438","846","0","51.77","21.16"
"10","016","00","002","0222","0000","273","134","139","11","284","729","0","38.96","18.38"
"10","016","00","002","0222","0073","273","134","139","11","284","729","0","38.96","18.38"
"10","016","00","003","0000","0000","3523","1526","1997","211","3734","8625","9856","43.29","17.69"
"10","016","00","003","0301","0000","247","109","138","12","259","514","0","50.39","21.21"
"10","016","00","003","0301","0074","247","109","138","12","259","514","0","50.39","21.21"
"10","016","00","003","0302","0000","333","144","189","11","344","657","0","52.36","21.92"
"10","016","00","003","0302","0075","333","144","189","11","344","657","0","52.36","21.92"
"10","016","00","003","0303","0000","67","32","35","5","72","109","0","66.06","29.36"
"10","016","00","003","0303","0076","67","32","35","5","72","109","0","66.06","29.36"
"10","016","00","003","0304","0000","64","21","43","3","67","156","0","42.95","13.46"
"10","016","00","003","0304","0077","64","21","43","3","67","156","0","42.95","13.46"
"10","016","00","003","0305","0000","118","44","74","4","122","293","0","41.64","15.02"
"10","016","00","003","0305","0078","118","44","74","4","122","293","0","41.64","15.02"
"10","016","00","003","0306","0000","75","26","49","2","77","231","0","33.33","11.26"
"10","016","00","003","0306","0079","75","26","49","2","77","231","0","33.33","11.26"
"10","016","00","003","0307","0000","84","42","42","4","88","161","0","54.66","26.09"
"10","016","00","003","0307","0080","84","42","42","4","88","161","0","54.66","26.09"
"10","016","00","003","0308","0000","749","276","473","36","785","1705","0","46.04","16.19"
"10","016","00","003","0308","0081","749","276","473","36","785","1705","0","46.04","16.19"
"10","016","00","003","0309","0000","121","56","65","6","127","285","0","44.56","19.65"
"10","016","00","003","0309","0082","121","56","65","6","127","285","0","44.56","19.65"
"10","016","00","003","0310","0000","263","163","100","7","270","723","0","37.34","22.54"
"10","016","00","003","0310","0083","263","163","100","7","270","723","0","37.34","22.54"
"10","016","00","003","0311","0000","277","135","142","15","292","774","0","37.73","17.44"
"10","016","00","003","0311","0084","277","135","142","15","292","774","0","37.73","17.44"
"10","016","00","003","0312","0000","462","277","185","50","512","1429","0","35.83","19.38"
"10","016","00","003","0312","0085","462","277","185","50","512","1429","0","35.83","19.38"
"10","016","00","003","0313","0000","457","106","351","43","500","1084","0","46.13","9.78"
"10","016","00","003","0313","0086","457","106","351","43","500","1084","0","46.13","9.78"
"10","016","00","003","0314","0000","120","49","71","7","127","251","0","50.6","19.52"
"10","016","00","003","0314","0087","120","49","71","7","127","251","0","50.6","19.52"
"10","016","00","003","0315","0000","86","46","40","6","92","253","0","36.36","18.18"
"10","016","00","003","0315","0088","86","46","40","6","92","253","0","36.36","18.18"
"10","016","00","004","0000","0000","2438","1206","1232","213","2651","7382","8396","35.91","16.34"
"10","016","00","004","0401","0000","50","25","25","0","50","283","0","17.67","8.83"
"10","016","00","004","0401","0089","50","25","25","0","50","283","0","17.67","8.83"
"10","016","00","004","0402","0000","116","64","52","8","124","424","0","29.25","15.09"
"10","016","00","004","0402","0090","116","64","52","8","124","424","0","29.25","15.09"
"10","016","00","004","0403","0000","104","39","65","8","112","282","0","39.72","13.83"
"10","016","00","004","0403","0092","104","39","65","8","112","282","0","39.72","13.83"
"10","016","00","004","0404","0000","265","151","114","26","291","826","0","35.23","18.28"
"10","016","00","004","0404","0091","265","151","114","26","291","826","0","35.23","18.28"
"10","016","00","004","0405","0000","246","129","117","33","279","661","0","42.21","19.52"
"10","016","00","004","0405","0093","246","129","117","33","279","661","0","42.21","19.52"
"10","016","00","004","0406","0000","38","31","7","1","39","141","0","27.66","21.99"
"10","016","00","004","0406","0094","38","31","7","1","39","141","0","27.66","21.99"
"10","016","00","004","0407","0000","189","89","100","9","198","635","0","31.18","14.02"
"10","016","00","004","0407","0095","189","89","100","9","198","635","0","31.18","14.02"
"10","016","00","004","0408","0000","74","33","41","2","76","216","0","35.19","15.28"
"10","016","00","004","0408","0096","74","33","41","2","76","216","0","35.19","15.28"
"10","016","00","004","0409","0000","141","89","52","15","156","572","0","27.27","15.56"
"10","016","00","004","0409","0097","141","89","52","15","156","572","0","27.27","15.56"
"10","016","00","004","0410","0000","492","260","232","50","542","1267","0","42.78","20.52"
"10","016","00","004","0410","0098","492","260","232","50","542","1267","0","42.78","20.52"
"10","016","00","004","0411","0000","723","296","427","61","784","2075","0","37.78","14.27"
"10","016","00","004","0411","0099","306","121","185","17","323","942","0","34.29","12.85"
"10","016","00","004","0411","0100","417","175","242","44","461","1133","0","40.69","15.45"
"10","016","00","005","0000","0000","1772","838","934","111","1883","4628","5237","40.69","18.11"
"10","016","00","005","0501","0000","311","132","179","23","334","734","0","45.5","17.98"
"10","016","00","005","0501","0101","311","132","179","23","334","734","0","45.5","17.98"
"10","016","00","005","0502","0000","183","65","118","7","190","454","0","41.85","14.32"
"10","016","00","005","0502","0102","183","65","118","7","190","454","0","41.85","14.32"
"10","016","00","005","0503","0000","98","42","56","7","105","300","0","35.0","14.0"
"10","016","00","005","0503","0103","98","42","56","7","105","300","0","35.0","14.0"
"10","016","00","005","0504","0000","219","117","102","21","240","471","0","50.96","24.84"
"10","016","00","005","0504","0104","219","117","102","21","240","471","0","50.96","24.84"
"10","016","00","005","0505","0000","501","247","254","36","537","1414","0","37.98","17.47"
"10","016","00","005","0505","0105","223","100","123","13","236","672","0","35.12","14.88"
"10","016","00","005","0505","0106","278","147","131","23","301","742","0","40.57","19.81"
"10","016","00","005","0506","0000","202","85","117","4","206","476","0","43.28","17.86"
"10","016","00","005","0506","0108","202","85","117","4","206","476","0","43.28","17.86"
"10","016","00","005","0507","0000","60","34","26","5","65","208","0","31.25","16.35"
"10","016","00","005","0507","0109","60","34","26","5","65","208","0","31.25","16.35"
"10","016","00","005","0508","0000","108","73","35","4","112","264","0","42.42","27.65"
"10","016","00","005","0508","0107","108","73","35","4","112","264","0","42.42","27.65"
"10","016","00","005","0509","0000","90","43","47","4","94","307","0","30.62","14.01"
"10","016","00","005","0509","0110","90","43","47","4","94","307","0","30.62","14.01"
"10","016","00","006","0000","0000","959","437","522","71","1030","3374","3855","30.53","12.95"
"10","016","00","006","0601","0000","65","45","20","3","68","248","0","27.42","18.15"
"10","016","00","006","0601","0111","65","45","20","3","68","248","0","27.42","18.15"
"10","016","00","006","0602","0000","192","93","99","12","204","581","0","35.11","16.01"
"10","016","00","006","0602","0112","192","93","99","12","204","581","0","35.11","16.01"
"10","016","00","006","0603","0000","201","89","112","27","228","641","0","35.57","13.88"
"10","016","00","006","0603","0113","201","89","112","27","228","641","0","35.57","13.88"
"10","016","00","006","0604","0000","118","56","62","4","122","382","0","31.94","14.66"
"10","016","00","006","0604","0114","118","56","62","4","122","382","0","31.94","14.66"
"10","016","00","006","0605","0000","87","30","57","5","92","351","0","26.21","8.55"
"10","016","00","006","0605","0115","87","30","57","5","92","351","0","26.21","8.55"
"10","016","00","006","0606","0000","296","124","172","20","316","1171","0","26.99","10.59"
"10","016","00","006","0606","0116","296","124","172","20","316","1171","0","26.99","10.59"
"10","017","00","000","0000","0000","159117","68736","90381","7385","166502","320030","370269","52.03","21.48"
"10","017","00","001","0000","0000","20658","8903","11755","1089","21747","45545","51716","47.75","19.55"
"10","017","00","001","0101","0000","423","203","220","22","445","709","0","62.76","28.63"
"10","017","00","001","0101","0035","423","203","220","22","445","709","0","62.76","28.63"
"10","017","00","001","0102","0000","606","261","345","31","637","1219","0","52.26","21.41"
"10","017","00","001","0102","0033","606","261","345","31","637","1219","0","52.26","21.41"
"10","017","00","001","0103","0000","441","211","230","24","465","904","0","51.44","23.34"
"10","017","00","001","0103","0034","441","211","230","24","465","904","0","51.44","23.34"
"10","017","00","001","0104","0000","503","225","278","45","548","1037","0","52.84","21.7"
"10","017","00","001","0104","0032","503","225","278","45","548","1037","0","52.84","21.7"
"10","017","00","001","0105","0000","649","280","369","32","681","1210","0","56.28","23.14"
"10","017","00","001","0105","0031","649","280","369","32","681","1210","0","56.28","23.14"
"10","017","00","001","0106","0000","583","289","294","53","636","1175","0","54.13","24.6"
"10","017","00","001","0106","0030","583","289","294","53","636","1175","0","54.13","24.6"
"10","017","00","001","0107","0000","601","239","362","22","623","1267","0","49.17","18.86"
"10","017","00","001","0107","0029","601","239","362","22","623","1267","0","49.17","18.86"
"10","017","00","001","0108","0000","404","186","218","28","432","802","0","53.87","23.19"
"10","017","00","001","0108","0028","404","186","218","28","432","802","0","53.87","23.19"
"10","017","00","001","0109","0000","615","249","366","40","655","1594","0","41.09","15.62"
"10","017","00","001","0109","0027","615","249","366","40","655","1594","0","41.09","15.62"
"10","017","00","001","0110","0000","1080","380","700","56","1136","2316","0","49.05","16.41"
"10","017","00","001","0110","0025","429","154","275","31","460","859","0","53.55","17.93"
"10","017","00","001","0110","0026","651","226","425","25","676","1457","0","46.4","15.51"
"10","017","00","001","0111","0000","677","292","385","46","723","1341","0","53.91","21.77"
"10","017","00","001","0111","0024","677","292","385","46","723","1341","0","53.91","21.77"
"10","017","00","001","0112","0000","929","361","568","76","1005","2000","0","50.25","18.05"
"10","017","00","001","0112","0022","544","222","322","31","575","1138","0","50.53","19.51"
"10","017","00","001","0112","0023","385","139","246","45","430","862","0","49.88","16.13"
"10","017","00","001","0113","0000","1019","395","624","26","1045","1960","0","53.32","20.15"
"10","017","00","001","0113","0020","567","213","354","13","580","1090","0","53.21","19.54"
"10","017","00","001","0113","0021","452","182","270","13","465","870","0","53.45","20.92"
"10","017","00","001","0114","0000","611","279","332","31","642","1270","0","50.55","21.97"
"10","017","00","001","0114","0019","611","279","332","31","642","1270","0","50.55","21.97"
"10","017","00","001","0115","0000","516","216","300","26","542","1166","0","46.48","18.52"
"10","017","00","001","0115","0016","516","216","300","26","542","1166","0","46.48","18.52"
"10","017","00","001","0116","0000","824","388","436","56","880","1753","0","50.2","22.13"
"10","017","00","001","0116","0014","824","388","436","56","880","1753","0","50.2","22.13"
"10","017","00","001","0117","0000","402","169","233","41","443","984","0","45.02","17.17"
"10","017","00","001","0117","0015","402","169","233","41","443","984","0","45.02","17.17"
"10","017","00","001","0118","0000","559","261","298","34","593","1261","0","47.03","20.7"
"10","017","00","001","0118","0013","559","261","298","34","593","1261","0","47.03","20.7"
"10","017","00","001","0119","0000","675","419","256","27","702","1474","0","47.63","28.43"
"10","017","00","001","0119","0005","675","419","256","27","702","1474","0","47.63","28.43"
"10","017","00","001","0120","0000","528","250","278","36","564","1271","0","44.37","19.67"
"10","017","00","001","0120","0006","528","250","278","36","564","1271","0","44.37","19.67"
"10","017","00","001","0121","0000","256","151","105","11","267","466","0","57.3","32.4"
"10","017","00","001","0121","0001","256","151","105","11","267","466","0","57.3","32.4"
"10","017","00","001","0122","0000","2116","967","1149","97","2213","5256","0","42.1","18.4"
"10","017","00","001","0122","0002","553","305","248","20","573","1262","0","45.4","24.17"
"10","017","00","001","0122","0003","510","217","293","55","565","1171","0","48.25","18.53"
"10","017","00","001","0122","0004","1053","445","608","22","1075","2823","0","38.08","15.76"
"10","017","00","001","0123","0000","627","273","354","25","652","1694","0","38.49","16.12"
"10","017","00","001","0123","0018","627","273","354","25","652","1694","0","38.49","16.12"
"10","017","00","001","0124","0000","455","194","261","24","479","973","0","49.23","19.94"
"10","017","00","001","0124","0017","455","194","261","24","479","973","0","49.23","19.94"
"10","017","00","001","0125","0000","2434","935","1499","74","2508","5430","0","46.19","17.22"
"10","017","00","001","0125","0010","643","284","359","21","664","1352","0","49.11","21.01"
"10","017","00","001","0125","0011","658","246","412","13","671","1413","0","47.49","17.41"
"10","017","00","001","0125","0012","1133","405","728","40","1173","2665","0","44.02","15.2"
"10","017","00","001","0126","0000","2125","830","1295","106","2231","5013","0","44.5","16.56"
"10","017","00","001","0126","0007","1108","457","651","65","1173","2707","0","43.33","16.88"
"10","017","00","001","0126","0008","728","271","457","24","752","1545","0","48.67","17.54"
"10","017","00","001","0126","0009","289","102","187","17","306","761","0","40.21","13.4"
"10","017","00","002","0000","0000","23422","10557","12865","1218","24640","46256","53819","53.27","22.82"
"10","017","00","002","0201","0000","1954","853","1101","107","2061","3754","0","54.9","22.72"
"10","017","00","002","0201","0219","669","320","349","49","718","1258","0","57.07","25.44"
"10","017","00","002","0201","0220","651","272","379","39","690","1237","0","55.78","21.99"
"10","017","00","002","0201","0221","634","261","373","19","653","1259","0","51.87","20.73"
"10","017","00","002","0202","0000","1163","546","617","60","1223","2464","0","49.63","22.16"
"10","017","00","002","0202","0222","552","273","279","27","579","1120","0","51.7","24.38"
"10","017","00","002","0202","0223","611","273","338","33","644","1344","0","47.92","20.31"
"10","017","00","002","0203","0000","1938","795","1143","91","2029","3568","0","56.87","22.28"
"10","017","00","002","0203","0226","933","356","577","53","986","1735","0","56.83","20.52"
"10","017","00","002","0203","0227","1005","439","566","38","1043","1833","0","56.9","23.95"
"10","017","00","002","0204","0000","1029","471","558","67","1096","1900","0","57.68","24.79"
"10","017","00","002","0204","0228","501","249","252","20","521","938","0","55.54","26.55"
"10","017","00","002","0204","0229","528","222","306","47","575","962","0","59.77","23.08"
"10","017","00","002","0205","0000","1175","477","698","71","1246","2190","0","56.89","21.78"
"10","017","00","002","0205","0230","650","269","381","23","673","1191","0","56.51","22.59"
"10","017","00","002","0205","0231","525","208","317","48","573","999","0","57.36","20.82"
"10","017","00","002","0206","0000","746","332","414","38","784","1525","0","51.41","21.77"
"10","017","00","002","0206","0232","135","59","76","5","140","282","0","49.65","20.92"
"10","017","00","002","0206","0233","611","273","338","33","644","1243","0","51.81","21.96"
"10","017","00","002","0207","0000","546","254","292","35","581","1092","0","53.21","23.26"
"10","017","00","002","0207","0234","546","254","292","35","581","1092","0","53.21","23.26"
"10","017","00","002","0208","0000","1123","519","604","41","1164","2260","0","51.5","22.96"
"10","017","00","002","0208","0238","470","213","257","17","487","975","0","49.95","21.85"
"10","017","00","002","0208","0239","653","306","347","24","677","1285","0","52.68","23.81"
"10","017","00","002","0209","0000","2162","954","1208","97","2259","4286","0","52.71","22.26"
"10","017","00","002","0209","0235","638","293","345","36","674","1246","0","54.09","23.52"
"10","017","00","002","0209","0236","843","362","481","32","875","1722","0","50.81","21.02"
"10","017","00","002","0209","0237","681","299","382","29","710","1318","0","53.87","22.69"
"10","017","00","002","0210","0000","1687","724","963","101","1788","3463","0","51.63","20.91"
"10","017","00","002","0210","0244","922","411","511","56","978","1774","0","55.13","23.17"
"10","017","00","002","0210","0245","765","313","452","45","810","1689","0","47.96","18.53"
"10","017","00","002","0211","0000","947","481","466","62","1009","2066","0","48.84","23.28"
"10","017","00","002","0211","0240","490","259","231","37","527","1077","0","48.93","24.05"
"10","017","00","002","0211","0241","457","222","235","25","482","989","0","48.74","22.45"
"10","017","00","002","0212","0000","234","120","114","11","245","428","0","57.24","28.04"
"10","017","00","002","0212","0253","234","120","114","11","245","428","0","57.24","28.04"
"10","017","00","002","0213","0000","183","90","93","16","199","326","0","61.04","27.61"
"10","017","00","002","0213","0254","183","90","93","16","199","326","0","61.04","27.61"
"10","017","00","002","0214","0000","227","111","116","19","246","351","0","70.09","31.62"
"10","017","00","002","0214","0255","227","111","116","19","246","351","0","70.09","31.62"
"10","017","00","002","0215","0000","889","354","535","26","915","1871","0","48.9","18.92"
"10","017","00","002","0215","0256","889","354","535","26","915","1871","0","48.9","18.92"
"10","017","00","002","0216","0000","222","119","103","6","228","448","0","50.89","26.56"
"10","017","00","002","0216","0257","222","119","103","6","228","448","0","50.89","26.56"
"10","017","00","002","0217","0000","1066","475","591","44","1110","1936","0","57.33","24.54"
"10","017","00","002","0217","0224","594","264","330","30","624","1011","0","61.72","26.11"
"10","017","00","002","0217","0225","472","211","261","14","486","925","0","52.54","22.81"
"10","017","00","002","0218","0000","2920","1358","1562","144","3064","6059","0","50.57","22.41"
"10","017","00","002","0218","0246","649","309","340","49","698","1355","0","51.51","22.8"
"10","017","00","002","0218","0247","724","355","369","47","771","1512","0","50.99","23.48"
"10","017","00","002","0218","0248","704","329","375","25","729","1486","0","49.06","22.14"
"10","017","00","002","0218","0249","843","365","478","23","866","1706","0","50.76","21.4"
"10","017","00","002","0219","0000","2010","945","1065","108","2118","3803","0","55.69","24.85"
"10","017","00","002","0219","0250","726","323","403","33","759","1384","0","54.84","23.34"
"10","017","00","002","0219","0251","582","289","293","43","625","1045","0","59.81","27.66"
"10","017","00","002","0219","0252","702","333","369","32","734","1374","0","53.42","24.24"
"10","017","00","002","0220","0000","1201","579","622","74","1275","2466","0","51.7","23.48"
"10","017","00","002","0220","0242","568","264","304","39","607","1193","0","50.88","22.13"
"10","017","00","002","0220","0243","633","315","318","35","668","1273","0","52.47","24.74"
"10","017","00","003","0000","0000","16988","7218","9770","662","17650","33225","38606","53.12","21.72"
"10","017","00","003","0301","0000","683","290","393","28","711","1431","0","49.69","20.27"
"10","017","00","003","0301","0191","683","290","393","28","711","1431","0","49.69","20.27"
"10","017","00","003","0302","0000","354","177","177","15","369","637","0","57.93","27.79"
"10","017","00","003","0302","0193","354","177","177","15","369","637","0","57.93","27.79"
"10","017","00","003","0303","0000","411","199","212","26","437","735","0","59.46","27.07"
"10","017","00","003","0303","0194","411","199","212","26","437","735","0","59.46","27.07"
"10","017","00","003","0304","0000","1771","726","1045","78","1849","3641","0","50.78","19.94"
"10","017","00","003","0304","0195","497","199","298","30","527","1078","0","48.89","18.46"
"10","017","00","003","0304","0196","613","246","367","28","641","1238","0","51.78","19.87"
"10","017","00","003","0304","0197","661","281","380","20","681","1325","0","51.4","21.21"
"10","017","00","003","0305","0000","1382","558","824","71","1453","2626","0","55.33","21.25"
"10","017","00","003","0305","0206","692","292","400","42","734","1267","0","57.93","23.05"
"10","017","00","003","0305","0207","690","266","424","29","719","1359","0","52.91","19.57"
"10","017","00","003","0306","0000","1545","581","964","49","1594","2916","0","54.66","19.92"
"10","017","00","003","0306","0208","543","144","399","24","567","970","0","58.45","14.85"
"10","017","00","003","0306","0209","532","216","316","8","540","1002","0","53.89","21.56"
"10","017","00","003","0306","0210","470","221","249","17","487","944","0","51.59","23.41"
"10","017","00","003","0307","0000","1302","540","762","45","1347","2553","0","52.76","21.15"
"10","017","00","003","0307","0200","630","270","360","25","655","1110","0","59.01","24.32"
"10","017","00","003","0307","0201","672","270","402","20","692","1443","0","47.96","18.71"
"10","017","00","003","0308","0000","1307","582","725","64","1371","2654","0","51.66","21.93"
"10","017","00","003","0308","0198","769","341","428","34","803","1475","0","54.44","23.12"
"10","017","00","003","0308","0199","538","241","297","30","568","1179","0","48.18","20.44"
"10","017","00","003","0309","0000","205","92","113","21","226","415","0","54.46","22.17"
"10","017","00","003","0309","0202","205","92","113","21","226","415","0","54.46","22.17"
"10","017","00","003","0310","0000","2381","1129","1252","81","2462","4551","0","54.1","24.81"
"10","017","00","003","0310","0203","678","316","362","17","695","1378","0","50.44","22.93"
"10","017","00","003","0310","0204","809","456","353","26","835","1570","0","53.18","29.04"
"10","017","00","003","0310","0205","894","357","537","38","932","1603","0","58.14","22.27"
"10","017","00","003","0311","0000","210","92","118","6","216","456","0","47.37","20.18"
"10","017","00","003","0311","0192","210","92","118","6","216","456","0","47.37","20.18"
"10","017","00","003","0312","0000","2615","1101","1514","89","2704","4893","0","55.26","22.5"
"10","017","00","003","0312","0215","713","276","437","17","730","1328","0","54.97","20.78"
"10","017","00","003","0312","0216","606","276","330","21","627","1173","0","53.45","23.53"
"10","017","00","003","0312","0217","569","245","324","29","598","1019","0","58.68","24.04"
"10","017","00","003","0312","0218","727","304","423","22","749","1373","0","54.55","22.14"
"10","017","00","003","0313","0000","2822","1151","1671","89","2911","5717","0","50.92","20.13"
"10","017","00","003","0313","0211","826","351","475","27","853","1500","0","56.87","23.4"
"10","017","00","003","0313","0212","567","239","328","29","596","1442","0","41.33","16.57"
"10","017","00","003","0313","0213","632","255","377","12","644","1165","0","55.28","21.89"
"10","017","00","003","0313","0214","797","306","491","21","818","1610","0","50.81","19.01"
"10","017","00","004","0000","0000","18847","8790","10057","1071","19918","36738","43950","54.22","23.93"
"10","017","00","004","0401","0000","784","373","411","57","841","1782","0","47.19","20.93"
"10","017","00","004","0401","0072","784","373","411","57","841","1782","0","47.19","20.93"
"10","017","00","004","0402","0000","560","251","309","35","595","1055","0","56.4","23.79"
"10","017","00","004","0402","0073","560","251","309","35","595","1055","0","56.4","23.79"
"10","017","00","004","0403","0000","718","296","422","32","750","1558","0","48.14","19.0"
"10","017","00","004","0403","0074","718","296","422","32","750","1558","0","48.14","19.0"
"10","017","00","004","0404","0000","878","361","517","29","907","1736","0","52.25","20.79"
"10","017","00","004","0404","0075","878","361","517","29","907","1736","0","52.25","20.79"
"10","017","00","004","0405","0000","1295","536","759","64","1359","2352","0","57.78","22.79"
"10","017","00","004","0405","0076","696","298","398","37","733","1243","0","58.97","23.97"
"10","017","00","004","0405","0077","599","238","361","27","626","1109","0","56.45","21.46"
"10","017","00","004","0406","0000","952","357","595","27","979","1684","0","58.14","21.2"
"10","017","00","004","0406","0078","952","357","595","27","979","1684","0","58.14","21.2"
"10","017","00","004","0407","0000","484","238","246","24","508","919","0","55.28","25.9"
"10","017","00","004","0407","0079","484","238","246","24","508","919","0","55.28","25.9"
"10","017","00","004","0408","0000","496","232","264","13","509","991","0","51.36","23.41"
"10","017","00","004","0408","0080","496","232","264","13","509","991","0","51.36","23.41"
"10","017","00","004","0409","0000","476","218","258","11","487","876","0","55.59","24.89"
"10","017","00","004","0409","0081","476","218","258","11","487","876","0","55.59","24.89"
"10","017","00","004","0410","0000","836","400","436","46","882","1480","0","59.59","27.03"
"10","017","00","004","0410","0082","589","276","313","30","619","1046","0","59.18","26.39"
"10","017","00","004","0410","0083","247","124","123","16","263","434","0","60.6","28.57"
"10","017","00","004","0411","0000","415","203","212","24","439","764","0","57.46","26.57"
"10","017","00","004","0411","0084","415","203","212","24","439","764","0","57.46","26.57"
"10","017","00","004","0412","0000","485","237","248","15","500","968","0","51.65","24.48"
"10","017","00","004","0412","0085","485","237","248","15","500","968","0","51.65","24.48"
"10","017","00","004","0413","0000","1213","603","610","75","1288","2641","0","48.77","22.83"
"10","017","00","004","0413","0086","656","341","315","40","696","1326","0","52.49","25.72"
"10","017","00","004","0413","0087","557","262","295","35","592","1315","0","45.02","19.92"
"10","017","00","004","0414","0000","419","215","204","34","453","775","0","58.45","27.74"
"10","017","00","004","0414","0088","419","215","204","34","453","775","0","58.45","27.74"
"10","017","00","004","0415","0000","698","469","229","61","759","1326","0","57.24","35.37"
"10","017","00","004","0415","0089","341","289","52","39","380","652","0","58.28","44.33"
"10","017","00","004","0415","0090","357","180","177","22","379","674","0","56.23","26.71"
"10","017","00","004","0416","0000","389","187","202","29","418","789","0","52.98","23.7"
"10","017","00","004","0416","0091","389","187","202","29","418","789","0","52.98","23.7"
"10","017","00","004","0417","0000","860","379","481","46","906","1715","0","52.83","22.1"
"10","017","00","004","0417","0092","860","379","481","46","906","1715","0","52.83","22.1"
"10","017","00","004","0418","0000","436","208","228","29","465","849","0","54.77","24.5"
"10","017","00","004","0418","0093","436","208","228","29","465","849","0","54.77","24.5"
"10","017","00","004","0419","0000","478","225","253","16","494","875","0","56.46","25.71"
"10","017","00","004","0419","0094","478","225","253","16","494","875","0","56.46","25.71"
"10","017","00","004","0420","0000","408","192","216","31","439","851","0","51.59","22.56"
"10","017","00","004","0420","0095","408","192","216","31","439","851","0","51.59","22.56"
"10","017","00","004","0421","0000","400","180","220","28","428","735","0","58.23","24.49"
"10","017","00","004","0421","0096","400","180","220","28","428","735","0","58.23","24.49"
"10","017","00","004","0422","0000","484","193","291","68","552","1009","0","54.71","19.13"
"10","017","00","004","0422","0097","484","193","291","68","552","1009","0","54.71","19.13"
"10","017","00","004","0423","0000","510","239","271","32","542","1082","0","50.09","22.09"
"10","017","00","004","0423","0098","510","239","271","32","542","1082","0","50.09","22.09"
"10","017","00","004","0424","0000","1483","652","831","96","1579","2797","0","56.45","23.31"
"10","017","00","004","0424","0099","612","291","321","57","669","1278","0","52.35","22.77"
"10","017","00","004","0424","0100","871","361","510","39","910","1519","0","59.91","23.77"
"10","017","00","004","0425","0000","364","194","170","20","384","708","0","54.24","27.4"
"10","017","00","004","0425","0103","364","194","170","20","384","708","0","54.24","27.4"
"10","017","00","004","0426","0000","337","170","167","21","358","567","0","63.14","29.98"
"10","017","00","004","0426","0104","337","170","167","21","358","567","0","63.14","29.98"
"10","017","00","004","0427","0000","400","233","167","27","427","751","0","56.86","31.03"
"10","017","00","004","0427","0105","400","233","167","27","427","751","0","56.86","31.03"
"10","017","00","004","0428","0000","340","161","179","17","357","589","0","60.61","27.33"
"10","017","00","004","0428","0106","340","161","179","17","357","589","0","60.61","27.33"
"10","017","00","004","0429","0000","1249","588","661","64","1313","2514","0","52.23","23.39"
"10","017","00","004","0429","0101","566","287","279","35","601","1336","0","44.99","21.48"
"10","017","00","004","0429","0102","683","301","382","29","712","1178","0","60.44","25.55"
"10","017","00","005","0000","0000","20448","9114","11334","1018","21466","41856","47428","51.29","21.77"
"10","017","00","005","0501","0000","407","183","224","14","421","796","0","52.89","22.99"
"10","017","00","005","0501","0107","407","183","224","14","421","796","0","52.89","22.99"
"10","017","00","005","0502","0000","613","259","354","29","642","1036","0","61.97","25.0"
"10","017","00","005","0502","0108","613","259","354","29","642","1036","0","61.97","25.0"
"10","017","00","005","0503","0000","411","230","181","26","437","756","0","57.8","30.42"
"10","017","00","005","0503","0109","411","230","181","26","437","756","0","57.8","30.42"
"10","017","00","005","0504","0000","434","230","204","16","450","957","0","47.02","24.03"
"10","017","00","005","0504","0110","434","230","204","16","450","957","0","47.02","24.03"
"10","017","00","005","0505","0000","428","198","230","16","444","802","0","55.36","24.69"
"10","017","00","005","0505","0111","428","198","230","16","444","802","0","55.36","24.69"
"10","017","00","005","0506","0000","649","289","360","25","674","1263","0","53.37","22.88"
"10","017","00","005","0506","0112","649","289","360","25","674","1263","0","53.37","22.88"
"10","017","00","005","0507","0000","432","162","270","18","450","778","0","57.84","20.82"
"10","017","00","005","0507","0113","432","162","270","18","450","778","0","57.84","20.82"
"10","017","00","005","0508","0000","586","319","267","77","663","1180","0","56.19","27.03"
"10","017","00","005","0508","0114","586","319","267","77","663","1180","0","56.19","27.03"
"10","017","00","005","0509","0000","459","186","273","25","484","990","0","48.89","18.79"
"10","017","00","005","0509","0115","459","186","273","25","484","990","0","48.89","18.79"
"10","017","00","005","0510","0000","543","246","297","19","562","1332","0","42.19","18.47"
"10","017","00","005","0510","0116","543","246","297","19","562","1332","0","42.19","18.47"
"10","017","00","005","0511","0000","840","393","447","39","879","1770","0","49.66","22.2"
"10","017","00","005","0511","0117","383","166","217","28","411","848","0","48.47","19.58"
"10","017","00","005","0511","0118","457","227","230","11","468","922","0","50.76","24.62"
"10","017","00","005","0512","0000","688","312","376","30","718","1584","0","45.33","19.7"
"10","017","00","005","0512","0122","688","312","376","30","718","1584","0","45.33","19.7"
"10","017","00","005","0513","0000","477","211","266","22","499","1319","0","37.83","16.0"
"10","017","00","005","0513","0123","477","211","266","22","499","1319","0","37.83","16.0"
"10","017","00","005","0514","0000","268","120","148","23","291","574","0","50.7","20.91"
"10","017","00","005","0514","0120","268","120","148","23","291","574","0","50.7","20.91"
"10","017","00","005","0515","0000","426","202","224","31","457","877","0","52.11","23.03"
"10","017","00","005","0515","0121","426","202","224","31","457","877","0","52.11","23.03"
"10","017","00","005","0516","0000","360","188","172","67","427","715","0","59.72","26.29"
"10","017","00","005","0516","0141","360","188","172","67","427","715","0","59.72","26.29"
"10","017","00","005","0517","0000","483","239","244","33","516","849","0","60.78","28.15"
"10","017","00","005","0517","0140","483","239","244","33","516","849","0","60.78","28.15"
"10","017","00","005","0518","0000","430","218","212","20","450","932","0","48.28","23.39"
"10","017","00","005","0518","0139","430","218","212","20","450","932","0","48.28","23.39"
"10","017","00","005","0519","0000","701","329","372","60","761","1642","0","46.35","20.04"
"10","017","00","005","0519","0138","701","329","372","60","761","1642","0","46.35","20.04"
"10","017","00","005","0520","0000","2846","1163","1683","94","2940","5387","0","54.58","21.59"
"10","017","00","005","0520","0126","1105","457","648","19","1124","2088","0","53.83","21.89"
"10","017","00","005","0520","0127","1020","402","618","24","1044","1946","0","53.65","20.66"
"10","017","00","005","0520","0128","721","304","417","51","772","1353","0","57.06","22.47"
"10","017","00","005","0521","0000","2876","1226","1650","124","3000","5560","0","53.96","22.05"
"10","017","00","005","0521","0129","662","264","398","45","707","1317","0","53.68","20.05"
"10","017","00","005","0521","0130","477","214","263","21","498","870","0","57.24","24.6"
"10","017","00","005","0521","0131","708","293","415","19","727","1322","0","54.99","22.16"
"10","017","00","005","0521","0132","589","260","329","19","608","1295","0","46.95","20.08"
"10","017","00","005","0521","0133","440","195","245","20","460","756","0","60.85","25.79"
"10","017","00","005","0522","0000","1814","807","1007","84","1898","3815","0","49.75","21.15"
"10","017","00","005","0522","0124","943","427","516","49","992","1938","0","51.19","22.03"
"10","017","00","005","0522","0125","871","380","491","35","906","1877","0","48.27","20.25"
"10","017","00","005","0523","0000","259","102","157","14","273","459","0","59.48","22.22"
"10","017","00","005","0523","0119","259","102","157","14","273","459","0","59.48","22.22"
"10","017","00","005","0524","0000","3018","1302","1716","112","3130","6483","0","48.28","20.08"
"10","017","00","005","0524","0134","701","302","399","29","730","1602","0","45.57","18.85"
"10","017","00","005","0524","0135","727","321","406","25","752","1568","0","47.96","20.47"
"10","017","00","005","0524","0136","704","312","392","36","740","1404","0","52.71","22.22"
"10","017","00","005","0524","0137","886","367","519","22","908","1909","0","47.56","19.22"
"10","017","00","006","0000","0000","35362","14810","20552","1406","36768","70396","82263","52.23","21.04"
"10","017","00","006","0601","0000","574","243","331","24","598","1213","0","49.3","20.03"
"10","017","00","006","0601","0143","574","243","331","24","598","1213","0","49.3","20.03"
"10","017","00","006","0602","0000","466","219","247","14","480","1026","0","46.78","21.35"
"10","017","00","006","0602","0144","466","219","247","14","480","1026","0","46.78","21.35"
"10","017","00","006","0603","0000","624","284","340","49","673","1361","0","49.45","20.87"
"10","017","00","006","0603","0142","624","284","340","49","673","1361","0","49.45","20.87"
"10","017","00","006","0604","0000","568","251","317","60","628","1038","0","60.5","24.18"
"10","017","00","006","0604","0145","568","251","317","60","628","1038","0","60.5","24.18"
"10","017","00","006","0605","0000","478","370","108","50","528","897","0","58.86","41.25"
"10","017","00","006","0605","0146","478","370","108","50","528","897","0","58.86","41.25"
"10","017","00","006","0606","0000","931","446","485","62","993","2042","0","48.63","21.84"
"10","017","00","006","0606","0147","691","321","370","55","746","1401","0","53.25","22.91"
"10","017","00","006","0606","0148","240","125","115","7","247","641","0","38.53","19.5"
"10","017","00","006","0607","0000","969","487","482","51","1020","1944","0","52.47","25.05"
"10","017","00","006","0607","0149","728","372","356","30","758","1472","0","51.49","25.27"
"10","017","00","006","0607","0150","241","115","126","21","262","472","0","55.51","24.36"
"10","017","00","006","0608","0000","1595","769","826","61","1656","3250","0","50.95","23.66"
"10","017","00","006","0608","0153","923","452","471","27","950","1901","0","49.97","23.78"
"10","017","00","006","0608","0154","672","317","355","34","706","1349","0","52.34","23.5"
"10","017","00","006","0609","0000","481","243","238","19","500","841","0","59.45","28.89"
"10","017","00","006","0609","0151","481","243","238","19","500","841","0","59.45","28.89"
"10","017","00","006","0610","0000","279","139","140","24","303","571","0","53.06","24.34"
"10","017","00","006","0610","0152","279","139","140","24","303","571","0","53.06","24.34"
"10","017","00","006","0611","0000","1943","829","1114","91","2034","3922","0","51.86","21.14"
"10","017","00","006","0611","0179","1008","443","565","43","1051","1960","0","53.62","22.6"
"10","017","00","006","0611","0180","935","386","549","48","983","1962","0","50.1","19.67"
"10","017","00","006","0612","0000","821","355","466","31","852","1641","0","51.92","21.63"
"10","017","00","006","0612","0186","821","355","466","31","852","1641","0","51.92","21.63"
"10","017","00","006","0613","0000","2679","1135","1544","105","2784","5289","0","52.64","21.46"
"10","017","00","006","0613","0187","646","288","358","23","669","1279","0","52.31","22.52"
"10","017","00","006","0613","0188","683","257","426","25","708","1360","0","52.06","18.9"
"10","017","00","006","0613","0189","732","325","407","32","764","1399","0","54.61","23.23"
"10","017","00","006","0613","0190","618","265","353","25","643","1251","0","51.4","21.18"
"10","017","00","006","0614","0000","1938","823","1115","65","2003","3946","0","50.76","20.86"
"10","017","00","006","0614","0181","1076","453","623","39","1115","2117","0","52.67","21.4"
"10","017","00","006","0614","0182","862","370","492","26","888","1829","0","48.55","20.23"
"10","017","00","006","0615","0000","1316","558","758","61","1377","2576","0","53.45","21.66"
"10","017","00","006","0615","0155","599","257","342","28","627","1225","0","51.18","20.98"
"10","017","00","006","0615","0156","717","301","416","33","750","1351","0","55.51","22.28"
"10","017","00","006","0616","0000","2583","1049","1534","89","2672","4768","0","56.04","22.0"
"10","017","00","006","0616","0159","845","341","504","27","872","1613","0","54.06","21.14"
"10","017","00","006","0616","0160","917","362","555","34","951","1731","0","54.94","20.91"
"10","017","00","006","0616","0161","821","346","475","28","849","1424","0","59.62","24.3"
"10","017","00","006","0617","0000","1797","714","1083","75","1872","3485","0","53.72","20.49"
"10","017","00","006","0617","0162","898","352","546","40","938","1806","0","51.94","19.49"
"10","017","00","006","0617","0163","899","362","537","35","934","1679","0","55.63","21.56"
"10","017","00","006","0618","0000","1982","752","1230","60","2042","3942","0","51.8","19.08"
"10","017","00","006","0618","0164","990","396","594","30","1020","1902","0","53.63","20.82"
"10","017","00","006","0618","0165","992","356","636","30","1022","2040","0","50.1","17.45"
"10","017","00","006","0619","0000","1282","596","686","73","1355","2556","0","53.01","23.32"
"10","017","00","006","0619","0166","671","316","355","45","716","1313","0","54.53","24.07"
"10","017","00","006","0619","0167","611","280","331","28","639","1243","0","51.41","22.53"
"10","017","00","006","0620","0000","1371","562","809","36","1407","2968","0","47.41","18.94"
"10","017","00","006","0620","0171","662","277","385","20","682","1557","0","43.8","17.79"
"10","017","00","006","0620","0172","709","285","424","16","725","1411","0","51.38","20.2"
"10","017","00","006","0621","0000","2284","854","1430","63","2347","4538","0","51.72","18.82"
"10","017","00","006","0621","0183","723","318","405","18","741","1529","0","48.46","20.8"
"10","017","00","006","0621","0184","927","310","617","30","957","1869","0","51.2","16.59"
"10","017","00","006","0621","0185","634","226","408","15","649","1140","0","56.93","19.82"
"10","017","00","006","0622","0000","1837","724","1113","55","1892","3319","0","57.01","21.81"
"10","017","00","006","0622","0168","883","341","542","20","903","1759","0","51.34","19.39"
"10","017","00","006","0622","0169","423","163","260","15","438","694","0","63.11","23.49"
"10","017","00","006","0622","0170","531","220","311","20","551","866","0","63.63","25.4"
"10","017","00","006","0623","0000","2132","829","1303","70","2202","4650","0","47.35","17.83"
"10","017","00","006","0623","0176","795","304","491","22","817","1673","0","48.83","18.17"
"10","017","00","006","0623","0177","529","218","311","30","559","1054","0","53.04","20.68"
"10","017","00","006","0623","0178","808","307","501","18","826","1923","0","42.95","15.96"
"10","017","00","006","0624","0000","2370","872","1498","52","2422","4499","0","53.83","19.38"
"10","017","00","006","0624","0173","874","343","531","18","892","1568","0","56.89","21.88"
"10","017","00","006","0624","0174","710","293","417","25","735","1400","0","52.5","20.93"
"10","017","00","006","0624","0175","786","236","550","9","795","1531","0","51.93","15.41"
"10","017","00","006","0625","0000","2062","707","1355","66","2128","4114","0","51.73","17.19"
"10","017","00","006","0625","0157","883","351","532","28","911","1601","0","56.9","21.92"
"10","017","00","006","0625","0158","1179","356","823","38","1217","2513","0","48.43","14.17"
"10","017","00","007","0000","0000","23392","9344","14048","921","24313","46014","52487","52.84","20.31"
"10","017","00","007","0701","0000","595","251","344","34","629","1096","0","57.39","22.9"
"10","017","00","007","0701","0036","595","251","344","34","629","1096","0","57.39","22.9"
"10","017","00","007","0702","0000","713","279","434","32","745","1232","0","60.47","22.65"
"10","017","00","007","0702","0037","713","279","434","32","745","1232","0","60.47","22.65"
"10","017","00","007","0703","0000","650","288","362","11","661","1184","0","55.83","24.32"
"10","017","00","007","0703","0038","650","288","362","11","661","1184","0","55.83","24.32"
"10","017","00","007","0704","0000","1251","473","778","71","1322","2321","0","56.96","20.38"
"10","017","00","007","0704","0039","622","227","395","43","665","1133","0","58.69","20.04"
"10","017","00","007","0704","0040","629","246","383","28","657","1188","0","55.3","20.71"
"10","017","00","007","0705","0000","405","182","223","20","425","725","0","58.62","25.1"
"10","017","00","007","0705","0041","405","182","223","20","425","725","0","58.62","25.1"
"10","017","00","007","0706","0000","697","283","414","35","732","1524","0","48.03","18.57"
"10","017","00","007","0706","0042","697","283","414","35","732","1524","0","48.03","18.57"
"10","017","00","007","0707","0000","393","153","240","25","418","736","0","56.79","20.79"
"10","017","00","007","0707","0043","393","153","240","25","418","736","0","56.79","20.79"
"10","017","00","007","0708","0000","759","350","409","28","787","1562","0","50.38","22.41"
"10","017","00","007","0708","0044","317","144","173","14","331","611","0","54.17","23.57"
"10","017","00","007","0708","0045","442","206","236","14","456","951","0","47.95","21.66"
"10","017","00","007","0709","0000","826","314","512","30","856","1616","0","52.97","19.43"
"10","017","00","007","0709","0046","826","314","512","30","856","1616","0","52.97","19.43"
"10","017","00","007","0710","0000","805","322","483","22","827","1516","0","54.55","21.24"
"10","017","00","007","0710","0047","805","322","483","22","827","1516","0","54.55","21.24"
"10","017","00","007","0711","0000","1066","438","628","45","1111","2118","0","52.46","20.68"
"10","017","00","007","0711","0048","528","220","308","22","550","1049","0","52.43","20.97"
"10","017","00","007","0711","0049","538","218","320","23","561","1069","0","52.48","20.39"
"10","017","00","007","0712","0000","888","355","533","43","931","1763","0","52.81","20.14"
"10","017","00","007","0712","0054","494","172","322","30","524","999","0","52.45","17.22"
"10","017","00","007","0712","0055","394","183","211","13","407","764","0","53.27","23.95"
"10","017","00","007","0713","0000","1690","616","1074","52","1742","3570","0","48.8","17.25"
"10","017","00","007","0713","0056","721","279","442","31","752","1555","0","48.36","17.94"
"10","017","00","007","0713","0057","969","337","632","21","990","2015","0","49.13","16.72"
"10","017","00","007","0714","0000","1488","626","862","69","1557","2837","0","54.88","22.07"
"10","017","00","007","0714","0058","688","287","401","32","720","1268","0","56.78","22.63"
"10","017","00","007","0714","0059","800","339","461","37","837","1569","0","53.35","21.61"
"10","017","00","007","0715","0000","679","307","372","25","704","1295","0","54.36","23.71"
"10","017","00","007","0715","0071","679","307","372","25","704","1295","0","54.36","23.71"
"10","017","00","007","0716","0000","2311","900","1411","105","2416","4113","0","58.74","21.88"
"10","017","00","007","0716","0050","398","183","215","23","421","727","0","57.91","25.17"
"10","017","00","007","0716","0051","532","181","351","22","554","929","0","59.63","19.48"
"10","017","00","007","0716","0052","659","260","399","31","690","1118","0","61.72","23.26"
"10","017","00","007","0716","0053","722","276","446","29","751","1339","0","56.09","20.61"
"10","017","00","007","0717","0000","1576","629","947","57","1633","3780","0","43.2","16.64"
"10","017","00","007","0717","0069","844","338","506","32","876","2016","0","43.45","16.77"
"10","017","00","007","0717","0070","732","291","441","25","757","1764","0","42.91","16.5"
"10","017","00","007","0718","0000","1716","603","1113","58","1774","3461","0","51.26","17.42"
"10","017","00","007","0718","0060","918","341","577","41","959","1985","0","48.31","17.18"
"10","017","00","007","0718","0061","798","262","536","17","815","1476","0","55.22","17.75"
"10","017","00","007","0719","0000","1184","490","694","52","1236","2494","0","49.56","19.65"
"10","017","00","007","0719","0067","658","276","382","37","695","1485","0","46.8","18.59"
"10","017","00","007","0719","0068","526","214","312","15","541","1009","0","53.62","21.21"
"10","017","00","007","0720","0000","3700","1485","2215","107","3807","7071","0","53.84","21.0"
"10","017","00","007","0720","0062","817","322","495","26","843","1493","0","56.46","21.57"
"10","017","00","007","0720","0063","744","289","455","18","762","1249","0","61.01","23.14"
"10","017","00","007","0720","0064","767","333","434","24","791","1559","0","50.74","21.36"
"10","017","00","007","0720","0065","564","220","344","14","578","1168","0","49.49","18.84"
"10","017","00","007","0720","0066","808","321","487","25","833","1602","0","52.0","20.04"
"10","018","00","000","0000","0000","192355","80567","111788","8062","200417","351775","444775","56.97","22.9"
"10","018","00","001","0000","0000","90367","36854","53513","3608","93975","163757","215079","57.39","22.51"
"10","018","00","001","0101","0000","402","217","185","22","424","714","0","59.38","30.39"
"10","018","00","001","0101","0101","402","217","185","22","424","714","0","59.38","30.39"
"10","018","00","001","0102","0000","764","351","413","36","800","1396","0","57.31","25.14"
"10","018","00","001","0102","0103","764","351","413","36","800","1396","0","57.31","25.14"
"10","018","00","001","0103","0000","492","236","256","25","517","875","0","59.09","26.97"
"10","018","00","001","0103","0102","492","236","256","25","517","875","0","59.09","26.97"
"10","018","00","001","0104","0000","270","154","116","12","282","507","0","55.62","30.37"
"10","018","00","001","0104","0100","270","154","116","12","282","507","0","55.62","30.37"
"10","018","00","001","0105","0000","343","178","165","12","355","566","0","62.72","31.45"
"10","018","00","001","0105","0004","343","178","165","12","355","566","0","62.72","31.45"
"10","018","00","001","0106","0000","162","93","69","14","176","305","0","57.7","30.49"
"10","018","00","001","0106","0006","162","93","69","14","176","305","0","57.7","30.49"
"10","018","00","001","0107","0000","360","181","179","17","377","640","0","58.91","28.28"
"10","018","00","001","0107","0005","360","181","179","17","377","640","0","58.91","28.28"
"10","018","00","001","0108","0000","289","125","164","13","302","475","0","63.58","26.32"
"10","018","00","001","0108","0113","289","125","164","13","302","475","0","63.58","26.32"
"10","018","00","001","0109","0000","439","228","211","25","464","752","0","61.7","30.32"
"10","018","00","001","0109","0112","439","228","211","25","464","752","0","61.7","30.32"
"10","018","00","001","0110","0000","389","185","204","28","417","710","0","58.73","26.06"
"10","018","00","001","0110","0111","389","185","204","28","417","710","0","58.73","26.06"
"10","018","00","001","0111","0000","487","202","285","15","502","1512","0","33.2","13.36"
"10","018","00","001","0111","0001","487","202","285","15","502","1512","0","33.2","13.36"
"10","018","00","001","0112","0000","327","156","171","21","348","563","0","61.81","27.71"
"10","018","00","001","0112","0007","327","156","171","21","348","563","0","61.81","27.71"
"10","018","00","001","0113","0000","1704","661","1043","68","1772","3123","0","56.74","21.17"
"10","018","00","001","0113","0027","846","332","514","30","876","1573","0","55.69","21.11"
"10","018","00","001","0113","0028","858","329","529","38","896","1550","0","57.81","21.23"
"10","018","00","001","0114","0000","1592","753","839","95","1687","2928","0","57.62","25.72"
"10","018","00","001","0114","0114","456","229","227","25","481","880","0","54.66","26.02"
"10","018","00","001","0114","0115","546","262","284","39","585","989","0","59.15","26.49"
"10","018","00","001","0114","0116","590","262","328","31","621","1059","0","58.64","24.74"
"10","018","00","001","0115","0000","794","386","408","56","850","1422","0","59.77","27.14"
"10","018","00","001","0115","0117","349","176","173","22","371","607","0","61.12","29.0"
"10","018","00","001","0115","0118","445","210","235","34","479","815","0","58.77","25.77"
"10","018","00","001","0116","0000","2766","1256","1510","115","2881","5524","0","52.15","22.74"
"10","018","00","001","0116","0104","641","295","346","34","675","1232","0","54.79","23.94"
"10","018","00","001","0116","0105","695","364","331","29","724","1323","0","54.72","27.51"
"10","018","00","001","0116","0106","712","300","412","22","734","1516","0","48.42","19.79"
"10","018","00","001","0116","0107","718","297","421","30","748","1453","0","51.48","20.44"
"10","018","00","001","0117","0000","985","361","624","30","1015","1682","0","60.34","21.46"
"10","018","00","001","0117","0002","570","216","354","19","589","953","0","61.8","22.67"
"10","018","00","001","0117","0003","415","145","270","11","426","729","0","58.44","19.89"
"10","018","00","001","0118","0000","2461","962","1499","74","2535","4456","0","56.89","21.59"
"10","018","00","001","0118","0010","869","338","531","18","887","1615","0","54.92","20.93"
"10","018","00","001","0118","0011","717","284","433","31","748","1287","0","58.12","22.07"
"10","018","00","001","0118","0012","875","340","535","25","900","1554","0","57.92","21.88"
"10","018","00","001","0119","0000","2347","992","1355","82","2429","4162","0","58.36","23.83"
"10","018","00","001","0119","0013","798","305","493","23","821","1388","0","59.15","21.97"
"10","018","00","001","0119","0014","823","355","468","28","851","1419","0","59.97","25.02"
"10","018","00","001","0119","0015","726","332","394","31","757","1355","0","55.87","24.5"
"10","018","00","001","0120","0000","2668","1169","1499","109","2777","4714","0","58.91","24.8"
"10","018","00","001","0120","0019","600","291","309","25","625","1062","0","58.85","27.4"
"10","018","00","001","0120","0020","727","302","425","26","753","1315","0","57.26","22.97"
"10","018","00","001","0120","0021","585","246","339","18","603","1000","0","60.3","24.6"
"10","018","00","001","0120","0022","756","330","426","40","796","1337","0","59.54","24.68"
"10","018","00","001","0121","0000","3020","1306","1714","88","3108","5333","0","58.28","24.49"
"10","018","00","001","0121","0023","921","400","521","28","949","1747","0","54.32","22.9"
"10","018","00","001","0121","0024","933","408","525","27","960","1600","0","60.0","25.5"
"10","018","00","001","0121","0025","638","270","368","19","657","1158","0","56.74","23.32"
"10","018","00","001","0121","0026","528","228","300","14","542","828","0","65.46","27.54"
"10","018","00","001","0122","0000","1355","567","788","66","1421","2283","0","62.24","24.84"
"10","018","00","001","0122","0039","722","346","376","45","767","1271","0","60.35","27.22"
"10","018","00","001","0122","0040","633","221","412","21","654","1012","0","64.62","21.84"
"10","018","00","001","0123","0000","1386","628","758","71","1457","2604","0","55.95","24.12"
"10","018","00","001","0123","0041","558","257","301","34","592","1001","0","59.14","25.67"
"10","018","00","001","0123","0042","828","371","457","37","865","1603","0","53.96","23.14"
"10","018","00","001","0124","0000","2440","937","1503","102","2542","4297","0","59.16","21.81"
"10","018","00","001","0124","0050","686","288","398","24","710","1195","0","59.41","24.1"
"10","018","00","001","0124","0051","818","310","508","50","868","1569","0","55.32","19.76"
"10","018","00","001","0124","0052","936","339","597","28","964","1533","0","62.88","22.11"
"10","018","00","001","0125","0000","2290","611","1679","111","2401","3992","0","60.15","15.31"
"10","018","00","001","0125","0053","773","201","572","42","815","1336","0","61.0","15.04"
"10","018","00","001","0125","0054","763","184","579","35","798","1367","0","58.38","13.46"
"10","018","00","001","0125","0055","754","226","528","34","788","1289","0","61.13","17.53"
"10","018","00","001","0126","0000","3614","1372","2242","127","3741","6055","0","61.78","22.66"
"10","018","00","001","0126","0034","738","289","449","22","760","1262","0","60.22","22.9"
"10","018","00","001","0126","0035","670","258","412","22","692","1199","0","57.71","21.52"
"10","018","00","001","0126","0036","735","277","458","31","766","1226","0","62.48","22.59"
"10","018","00","001","0126","0037","848","320","528","37","885","1377","0","64.27","23.24"
"10","018","00","001","0126","0038","623","228","395","15","638","991","0","64.38","23.01"
"10","018","00","001","0127","0000","1783","672","1111","89","1872","3142","0","59.58","21.39"
"10","018","00","001","0127","0031","535","179","356","21","556","935","0","59.47","19.14"
"10","018","00","001","0127","0032","587","220","367","25","612","1074","0","56.98","20.48"
"10","018","00","001","0127","0033","661","273","388","43","704","1133","0","62.14","24.1"
"10","018","00","001","0128","0000","1825","776","1049","62","1887","3440","0","54.85","22.56"
"10","018","00","001","0128","0122","533","247","286","26","559","1062","0","52.64","23.26"
"10","018","00","001","0128","0123","604","260","344","21","625","1046","0","59.75","24.86"
"10","018","00","001","0128","0124","688","269","419","15","703","1332","0","52.78","20.2"
"10","018","00","001","0129","0000","1641","744","897","72","1713","2999","0","57.12","24.81"
"10","018","00","001","0129","0108","490","234","256","27","517","880","0","58.75","26.59"
"10","018","00","001","0129","0109","577","261","316","19","596","1058","0","56.33","24.67"
"10","018","00","001","0129","0110","574","249","325","26","600","1061","0","56.55","23.47"
"10","018","00","001","0130","0000","2826","1068","1758","99","2925","5036","0","58.08","21.21"
"10","018","00","001","0130","0132","684","262","422","24","708","1315","0","53.84","19.92"
"10","018","00","001","0130","0133","795","290","505","26","821","1413","0","58.1","20.52"
"10","018","00","001","0130","0134","584","212","372","24","608","1064","0","57.14","19.92"
"10","018","00","001","0130","0135","763","304","459","25","788","1244","0","63.34","24.44"
"10","018","00","001","0131","0000","3064","1196","1868","109","3173","5678","0","55.88","21.06"
"10","018","00","001","0131","0125","756","244","512","37","793","1350","0","58.74","18.07"
"10","018","00","001","0131","0126","738","275","463","22","760","1438","0","52.85","19.12"
"10","018","00","001","0131","0127","733","309","424","30","763","1414","0","53.96","21.85"
"10","018","00","001","0131","0128","837","368","469","20","857","1476","0","58.06","24.93"
"10","018","00","001","0132","0000","712","279","433","19","731","1233","0","59.29","22.63"
"10","018","00","001","0132","0099","712","279","433","19","731","1233","0","59.29","22.63"
"10","018","00","001","0133","0000","1679","591","1088","81","1760","3003","0","58.61","19.68"
"10","018","00","001","0133","0063","633","215","418","42","675","1132","0","59.63","18.99"
"10","018","00","001","0133","0064","148","59","89","5","153","251","0","60.96","23.51"
"10","018","00","001","0133","0065","898","317","581","34","932","1620","0","57.53","19.57"
"10","018","00","001","0135","0000","492","124","368","28","520","915","0","56.83","13.55"
"10","018","00","001","0135","0059","492","124","368","28","520","915","0","56.83","13.55"
"10","018","00","001","0136","0000","1574","556","1018","72","1646","2751","0","59.83","20.21"
"10","018","00","001","0136","0056","514","193","321","22","536","960","0","55.83","20.1"
"10","018","00","001","0136","0057","521","180","341","16","537","843","0","63.7","21.35"
"10","018","00","001","0136","0058","539","183","356","34","573","948","0","60.44","19.3"
"10","018","00","001","0137","0000","2003","757","1246","91","2094","3556","0","58.89","21.29"
"10","018","00","001","0137","0060","1001","276","725","45","1046","1801","0","58.08","15.32"
"10","018","00","001","0137","0061","597","190","407","30","627","1079","0","58.11","17.61"
"10","018","00","001","0137","0062","405","291","114","16","421","676","0","62.28","43.05"
"10","018","00","001","0138","0000","1393","625","768","67","1460","2768","0","52.75","22.58"
"10","018","00","001","0138","0043","673","308","365","35","708","1236","0","57.28","24.92"
"10","018","00","001","0138","0044","720","317","403","32","752","1532","0","49.09","20.69"
"10","018","00","001","0139","0000","1840","825","1015","103","1943","3331","0","58.33","24.77"
"10","018","00","001","0139","0045","699","309","390","43","742","1306","0","56.81","23.66"
"10","018","00","001","0139","0046","605","264","341","38","643","1073","0","59.93","24.6"
"10","018","00","001","0139","0047","536","252","284","22","558","952","0","58.61","26.47"
"10","018","00","001","0140","0000","1058","419","639","35","1093","2076","0","52.65","20.18"
"10","018","00","001","0140","0048","634","284","350","19","653","1298","0","50.31","21.88"
"10","018","00","001","0140","0049","424","135","289","16","440","778","0","56.56","17.35"
"10","018","00","001","0141","0000","2462","1131","1331","88","2550","4669","0","54.62","24.22"
"10","018","00","001","0141","0077","643","279","364","28","671","1215","0","55.23","22.96"
"10","018","00","001","0141","0078","550","250","300","24","574","1067","0","53.8","23.43"
"10","018","00","001","0141","0079","648","322","326","14","662","1194","0","55.44","26.97"
"10","018","00","001","0141","0080","621","280","341","22","643","1193","0","53.9","23.47"
"10","018","00","001","0142","0000","4267","1772","2495","147","4414","7900","0","55.87","22.43"
"10","018","00","001","0142","0066","773","325","448","25","798","1479","0","53.96","21.97"
"10","018","00","001","0142","0067","724","331","393","33","757","1402","0","53.99","23.61"
"10","018","00","001","0142","0068","692","256","436","37","729","1280","0","56.95","20.0"
"10","018","00","001","0142","0069","714","297","417","17","731","1228","0","59.53","24.19"
"10","018","00","001","0142","0070","619","282","337","11","630","1157","0","54.45","24.37"
"10","018","00","001","0142","0071","745","281","464","24","769","1354","0","56.79","20.75"
"10","018","00","001","0143","0000","2910","1095","1815","119","3029","5242","0","57.78","20.89"
"10","018","00","001","0143","0081","762","300","462","43","805","1388","0","58.0","21.61"
"10","018","00","001","0143","0082","721","279","442","25","746","1267","0","58.88","22.02"
"10","018","00","001","0143","0083","710","248","462","25","735","1299","0","56.58","19.09"
"10","018","00","001","0143","0084","717","268","449","26","743","1288","0","57.69","20.81"
"10","018","00","001","0144","0000","2457","967","1490","82","2539","4240","0","59.88","22.81"
"10","018","00","001","0144","0096","833","312","521","36","869","1400","0","62.07","22.29"
"10","018","00","001","0144","0097","889","363","526","13","902","1473","0","61.24","24.64"
"10","018","00","001","0144","0098","735","292","443","33","768","1367","0","56.18","21.36"
"10","018","00","001","0145","0000","2587","928","1659","97","2684","5042","0","53.23","18.41"
"10","018","00","001","0145","0092","686","245","441","29","715","1323","0","54.04","18.52"
"10","018","00","001","0145","0093","630","230","400","21","651","1207","0","53.94","19.06"
"10","018","00","001","0145","0094","610","212","398","27","637","1264","0","50.4","16.77"
"10","018","00","001","0145","0095","661","241","420","20","681","1248","0","54.57","19.31"
"10","018","00","001","0146","0000","2424","905","1519","133","2557","4634","0","55.18","19.53"
"10","018","00","001","0146","0088","566","212","354","41","607","1135","0","53.48","18.68"
"10","018","00","001","0146","0089","577","208","369","32","609","1165","0","52.27","17.85"
"10","018","00","001","0146","0090","598","243","355","29","627","1124","0","55.78","21.62"
"10","018","00","001","0146","0091","683","242","441","31","714","1210","0","59.01","20.0"
"10","018","00","001","0147","0000","3826","1479","2347","142","3968","6262","0","63.37","23.62"
"10","018","00","001","0147","0072","857","321","536","25","882","1334","0","66.12","24.06"
"10","018","00","001","0147","0073","707","276","431","42","749","1234","0","60.7","22.37"
"10","018","00","001","0147","0074","858","328","530","35","893","1398","0","63.88","23.46"
"10","018","00","001","0147","0075","555","237","318","17","572","928","0","61.64","25.54"
"10","018","00","001","0147","0076","849","317","532","23","872","1368","0","63.74","23.17"
"10","018","00","001","0148","0000","1351","604","747","54","1405","2357","0","59.61","25.63"
"10","018","00","001","0148","0029","731","313","418","27","758","1317","0","57.56","23.77"
"10","018","00","001","0148","0030","620","291","329","27","647","1040","0","62.21","27.98"
"10","018","00","001","0149","0000","1805","786","1019","78","1883","3392","0","55.51","23.17"
"10","018","00","001","0149","0119","456","176","280","23","479","777","0","61.65","22.65"
"10","018","00","001","0149","0120","681","300","381","32","713","1399","0","50.96","21.44"
"10","018","00","001","0149","0121","668","310","358","23","691","1216","0","56.83","25.49"
"10","018","00","001","0150","0000","2650","1096","1554","77","2727","4777","0","57.09","22.94"
"10","018","00","001","0150","0016","816","338","478","23","839","1490","0","56.31","22.68"
"10","018","00","001","0150","0017","892","346","546","23","915","1615","0","56.66","21.42"
"10","018","00","001","0150","0018","942","412","530","31","973","1672","0","58.19","24.64"
"10","018","00","001","0151","0000","989","393","596","36","1025","1782","0","57.52","22.05"
"10","018","00","001","0151","0008","402","152","250","17","419","741","0","56.55","20.51"
"10","018","00","001","0151","0009","587","241","346","19","606","1041","0","58.21","23.15"
"10","018","00","001","0152","0000","2107","892","1215","60","2167","3526","0","61.46","25.3"
"10","018","00","001","0152","0129","787","332","455","29","816","1326","0","61.54","25.04"
"10","018","00","001","0152","0130","587","224","363","16","603","927","0","65.05","24.16"
"10","018","00","001","0152","0131","733","336","397","15","748","1273","0","58.76","26.39"
"10","018","00","001","0153","0000","2336","935","1401","67","2403","4816","0","49.9","19.41"
"10","018","00","001","0153","0136","591","231","360","11","602","1160","0","51.9","19.91"
"10","018","00","001","0153","0137","675","266","409","17","692","1398","0","49.5","19.03"
"10","018","00","001","0153","0138","550","218","332","17","567","1384","0","40.97","15.75"
"10","018","00","001","0153","0139","520","220","300","22","542","874","0","62.01","25.17"
"10","018","00","001","0154","0000","2160","972","1188","67","2227","3600","0","61.86","27.0"
"10","018","00","001","0154","0085","727","339","388","25","752","1228","0","61.24","27.61"
"10","018","00","001","0154","0086","671","299","372","16","687","1135","0","60.53","26.34"
"10","018","00","001","0154","0087","762","334","428","26","788","1237","0","63.7","27.0"
"10","018","00","002","0000","0000","66792","28399","38393","2782","69574","123122","151391","56.51","23.07"
"10","018","00","002","0201","0000","312","159","153","12","324","535","0","60.56","29.72"
"10","018","00","002","0201","0141","312","159","153","12","324","535","0","60.56","29.72"
"10","018","00","002","0202","0000","416","184","232","28","444","711","0","62.45","25.88"
"10","018","00","002","0202","0144","416","184","232","28","444","711","0","62.45","25.88"
"10","018","00","002","0203","0000","425","211","214","23","448","746","0","60.05","28.28"
"10","018","00","002","0203","0142","425","211","214","23","448","746","0","60.05","28.28"
"10","018","00","002","0204","0000","259","142","117","5","264","477","0","55.35","29.77"
"10","018","00","002","0204","0140","259","142","117","5","264","477","0","55.35","29.77"
"10","018","00","002","0205","0000","587","332","255","25","612","1143","0","53.54","29.05"
"10","018","00","002","0205","0145","587","332","255","25","612","1143","0","53.54","29.05"
"10","018","00","002","0206","0000","290","148","142","11","301","546","0","55.13","27.11"
"10","018","00","002","0206","0143","290","148","142","11","301","546","0","55.13","27.11"
"10","018","00","002","0207","0000","704","336","368","36","740","1370","0","54.01","24.53"
"10","018","00","002","0207","0146","704","336","368","36","740","1370","0","54.01","24.53"
"10","018","00","002","0208","0000","517","233","284","25","542","957","0","56.64","24.35"
"10","018","00","002","0208","0172","517","233","284","25","542","957","0","56.64","24.35"
"10","018","00","002","0209","0000","333","171","162","25","358","561","0","63.81","30.48"
"10","018","00","002","0209","0169","333","171","162","25","358","561","0","63.81","30.48"
"10","018","00","002","0210","0000","471","200","271","16","487","761","0","63.99","26.28"
"10","018","00","002","0210","0167","471","200","271","16","487","761","0","63.99","26.28"
"10","018","00","002","0211","0000","465","250","215","16","481","788","0","61.04","31.73"
"10","018","00","002","0211","0168","465","250","215","16","481","788","0","61.04","31.73"
"10","018","00","002","0212","0000","698","350","348","28","726","1398","0","51.93","25.04"
"10","018","00","002","0212","0171","698","350","348","28","726","1398","0","51.93","25.04"
"10","018","00","002","0213","0000","774","358","416","54","828","1558","0","53.15","22.98"
"10","018","00","002","0213","0170","774","358","416","54","828","1558","0","53.15","22.98"
"10","018","00","002","0214","0000","2518","1152","1366","103","2621","4800","0","54.6","24.0"
"10","018","00","002","0214","0173","652","280","372","33","685","1195","0","57.32","23.43"
"10","018","00","002","0214","0174","593","289","304","21","614","1236","0","49.68","23.38"
"10","018","00","002","0214","0175","643","290","353","34","677","1255","0","53.94","23.11"
"10","018","00","002","0214","0176","630","293","337","15","645","1114","0","57.9","26.3"
"10","018","00","002","0215","0000","1572","671","901","54","1626","2949","0","55.14","22.75"
"10","018","00","002","0215","0188","770","332","438","22","792","1457","0","54.36","22.79"
"10","018","00","002","0215","0189","802","339","463","32","834","1492","0","55.9","22.72"
"10","018","00","002","0216","0000","2040","878","1162","93","2133","3906","0","54.61","22.48"
"10","018","00","002","0216","0185","613","267","346","17","630","1272","0","49.53","20.99"
"10","018","00","002","0216","0186","708","286","422","40","748","1306","0","57.27","21.9"
"10","018","00","002","0216","0187","719","325","394","36","755","1328","0","56.85","24.47"
"10","018","00","002","0217","0000","1226","535","691","61","1287","2131","0","60.39","25.11"
"10","018","00","002","0217","0190","679","288","391","34","713","1160","0","61.47","24.83"
"10","018","00","002","0217","0191","547","247","300","27","574","971","0","59.11","25.44"
"10","018","00","002","0218","0000","902","401","501","52","954","1651","0","57.78","24.29"
"10","018","00","002","0218","0228","513","222","291","15","528","946","0","55.81","23.47"
"10","018","00","002","0218","0229","389","179","210","37","426","705","0","60.43","25.39"
"10","018","00","002","0219","0000","2102","824","1278","90","2192","3852","0","56.91","21.39"
"10","018","00","002","0219","0221","646","255","391","27","673","1175","0","57.28","21.7"
"10","018","00","002","0219","0222","775","301","474","22","797","1371","0","58.13","21.95"
"10","018","00","002","0219","0223","681","268","413","41","722","1306","0","55.28","20.52"
"10","018","00","002","0220","0000","467","247","220","42","509","848","0","60.02","29.13"
"10","018","00","002","0220","0230","467","247","220","42","509","848","0","60.02","29.13"
"10","018","00","002","0221","0000","1507","595","912","51","1558","2712","0","57.45","21.94"
"10","018","00","002","0221","0199","781","291","490","29","810","1442","0","56.17","20.18"
"10","018","00","002","0221","0200","726","304","422","22","748","1270","0","58.9","23.94"
"10","018","00","002","0222","0000","3403","1433","1970","158","3561","5949","0","59.86","24.09"
"10","018","00","002","0222","0208","626","265","361","17","643","1106","0","58.14","23.96"
"10","018","00","002","0222","0209","608","238","370","20","628","1044","0","60.15","22.8"
"10","018","00","002","0222","0210","598","273","325","32","630","1061","0","59.38","25.73"
"10","018","00","002","0222","0211","850","353","497","53","903","1518","0","59.49","23.25"
"10","018","00","002","0222","0212","721","304","417","36","757","1220","0","62.05","24.92"
"10","018","00","002","0223","0000","2714","730","1984","89","2803","4623","0","60.63","15.79"
"10","018","00","002","0223","0217","593","175","418","8","601","1059","0","56.75","16.53"
"10","018","00","002","0223","0218","655","175","480","30","685","1130","0","60.62","15.49"
"10","018","00","002","0223","0219","725","204","521","28","753","1208","0","62.33","16.89"
"10","018","00","002","0223","0220","741","176","565","23","764","1226","0","62.32","14.36"
"10","018","00","002","0224","0000","2825","1154","1671","120","2945","5718","0","51.5","20.18"
"10","018","00","002","0224","0231","679","279","400","21","700","1295","0","54.05","21.54"
"10","018","00","002","0224","0232","736","265","471","26","762","1467","0","51.94","18.06"
"10","018","00","002","0224","0233","762","353","409","31","793","1659","0","47.8","21.28"
"10","018","00","002","0224","0234","648","257","391","42","690","1297","0","53.2","19.81"
"10","018","00","002","0225","0000","325","152","173","22","347","594","0","58.42","25.59"
"10","018","00","002","0225","0244","325","152","173","22","347","594","0","58.42","25.59"
"10","018","00","002","0226","0000","1543","693","850","93","1636","2831","0","57.79","24.48"
"10","018","00","002","0226","0235","746","330","416","46","792","1374","0","57.64","24.02"
"10","018","00","002","0226","0236","797","363","434","47","844","1457","0","57.93","24.91"
"10","018","00","002","0227","0000","801","364","437","46","847","1609","0","52.64","22.62"
"10","018","00","002","0227","0243","801","364","437","46","847","1609","0","52.64","22.62"
"10","018","00","002","0228","0000","1891","811","1080","76","1967","3393","0","57.97","23.9"
"10","018","00","002","0228","0237","605","253","352","30","635","1072","0","59.24","23.6"
"10","018","00","002","0228","0238","695","298","397","28","723","1350","0","53.56","22.07"
"10","018","00","002","0228","0239","591","260","331","18","609","971","0","62.72","26.78"
"10","018","00","002","0229","0000","2040","852","1188","86","2126","3723","0","57.1","22.88"
"10","018","00","002","0229","0240","813","355","458","39","852","1450","0","58.76","24.48"
"10","018","00","002","0229","0241","498","204","294","17","515","895","0","57.54","22.79"
"10","018","00","002","0229","0242","729","293","436","30","759","1378","0","55.08","21.26"
"10","018","00","002","0230","0000","991","451","540","30","1021","1766","0","57.81","25.54"
"10","018","00","002","0230","0158","635","297","338","24","659","1128","0","58.42","26.33"
"10","018","00","002","0230","0159","356","154","202","6","362","638","0","56.74","24.14"
"10","018","00","002","0231","0000","1859","787","1072","51","1910","3589","0","53.22","21.93"
"10","018","00","002","0231","0147","743","339","404","23","766","1390","0","55.11","24.39"
"10","018","00","002","0231","0148","441","139","302","15","456","962","0","47.4","14.45"
"10","018","00","002","0231","0149","675","309","366","13","688","1237","0","55.62","24.98"
"10","018","00","002","0232","0000","2594","1142","1452","121","2715","5156","0","52.66","22.15"
"10","018","00","002","0232","0151","358","150","208","28","386","758","0","50.92","19.79"
"10","018","00","002","0232","0152","666","272","394","25","691","1320","0","52.35","20.61"
"10","018","00","002","0232","0153","735","325","410","35","770","1519","0","50.69","21.4"
"10","018","00","002","0232","0154","125","60","65","8","133","347","0","38.33","17.29"
"10","018","00","002","0232","0155","710","335","375","25","735","1212","0","60.64","27.64"
"10","018","00","002","0233","0000","1536","747","789","70","1606","2912","0","55.15","25.65"
"10","018","00","002","0233","0156","779","362","417","34","813","1484","0","54.78","24.39"
"10","018","00","002","0233","0157","757","385","372","36","793","1428","0","55.53","26.96"
"10","018","00","002","0234","0000","2214","1027","1187","83","2297","4121","0","55.74","24.92"
"10","018","00","002","0234","0163","765","345","420","25","790","1394","0","56.67","24.75"
"10","018","00","002","0234","0164","771","353","418","30","801","1568","0","51.08","22.51"
"10","018","00","002","0234","0165","678","329","349","28","706","1159","0","60.91","28.39"
"10","018","00","002","0235","0000","104","40","64","1","105","252","0","41.67","15.87"
"10","018","00","002","0235","0166","104","40","64","1","105","252","0","41.67","15.87"
"10","018","00","002","0236","0000","2657","1133","1524","123","2780","4656","0","59.71","24.33"
"10","018","00","002","0236","0224","713","301","412","18","731","1340","0","54.55","22.46"
"10","018","00","002","0236","0225","647","294","353","45","692","1111","0","62.29","26.46"
"10","018","00","002","0236","0226","737","306","431","38","775","1197","0","64.75","25.56"
"10","018","00","002","0236","0227","560","232","328","22","582","1008","0","57.74","23.02"
"10","018","00","002","0237","0000","2863","1272","1591","112","2975","5296","0","56.17","24.02"
"10","018","00","002","0237","0177","764","343","421","27","791","1396","0","56.66","24.57"
"10","018","00","002","0237","0178","812","382","430","34","846","1456","0","58.1","26.24"
"10","018","00","002","0237","0179","732","295","437","21","753","1374","0","54.8","21.47"
"10","018","00","002","0237","0180","555","252","303","30","585","1070","0","54.67","23.55"
"10","018","00","002","0238","0000","2504","1105","1399","106","2610","4524","0","57.69","24.43"
"10","018","00","002","0238","0181","610","255","355","37","647","1142","0","56.65","22.33"
"10","018","00","002","0238","0182","595","264","331","0","595","1103","0","53.94","23.93"
"10","018","00","002","0238","0183","639","327","312","48","687","1190","0","57.73","27.48"
"10","018","00","002","0238","0184","660","259","401","21","681","1089","0","62.53","23.78"
"10","018","00","002","0239","0000","1981","834","1147","67","2048","4112","0","49.81","20.28"
"10","018","00","002","0239","0192","447","190","257","17","464","1401","0","33.12","13.56"
"10","018","00","002","0239","0193","753","336","417","21","774","1340","0","57.76","25.07"
"10","018","00","002","0239","0194","781","308","473","29","810","1371","0","59.08","22.47"
"10","018","00","002","0240","0000","2701","1150","1551","83","2784","4793","0","58.08","23.99"
"10","018","00","002","0240","0195","688","306","382","22","710","1267","0","56.04","24.15"
"10","018","00","002","0240","0196","656","285","371","22","678","1073","0","63.19","26.56"
"10","018","00","002","0240","0197","661","286","375","18","679","1159","0","58.58","24.68"
"10","018","00","002","0240","0198","696","273","423","21","717","1294","0","55.41","21.1"
"10","018","00","002","0241","0000","3201","1214","1987","83","3284","5721","0","57.4","21.22"
"10","018","00","002","0241","0213","853","328","525","10","863","1475","0","58.51","22.24"
"10","018","00","002","0241","0214","724","303","421","30","754","1373","0","54.92","22.07"
"10","018","00","002","0241","0215","819","301","518","18","837","1450","0","57.72","20.76"
"10","018","00","002","0241","0216","805","282","523","25","830","1423","0","58.33","19.82"
"10","018","00","002","0242","0000","3575","1397","2178","133","3708","6417","0","57.78","21.77"
"10","018","00","002","0242","0203","656","291","365","27","683","1163","0","58.73","25.02"
"10","018","00","002","0242","0204","716","275","441","25","741","1334","0","55.55","20.61"
"10","018","00","002","0242","0205","770","294","476","33","803","1415","0","56.75","20.78"
"10","018","00","002","0242","0206","777","306","471","21","798","1305","0","61.15","23.45"
"10","018","00","002","0242","0207","656","231","425","27","683","1200","0","56.92","19.25"
"10","018","00","002","0243","0000","1306","556","750","67","1373","2128","0","64.52","26.13"
"10","018","00","002","0243","0201","740","328","412","32","772","1179","0","65.48","27.82"
"10","018","00","002","0243","0202","566","228","338","35","601","949","0","63.33","24.03"
"10","018","00","002","0244","0000","778","341","437","17","795","1604","0","49.56","21.26"
"10","018","00","002","0244","0150","778","341","437","17","795","1604","0","49.56","21.26"
"10","018","00","002","0245","0000","1801","637","1164","95","1896","3235","0","58.61","19.69"
"10","018","00","002","0245","0160","668","157","511","45","713","1222","0","58.35","12.85"
"10","018","00","002","0245","0161","556","238","318","28","584","1076","0","54.28","22.12"
"10","018","00","002","0245","0162","577","242","335","22","599","937","0","63.93","25.83"
"10","018","00","003","0000","0000","35196","15314","19882","1672","36868","64896","78305","56.81","23.6"
"10","018","00","003","0301","0000","1437","649","788","92","1529","2513","0","60.84","25.83"
"10","018","00","003","0301","0271","639","299","340","37","676","1182","0","57.19","25.3"
"10","018","00","003","0301","0272","798","350","448","55","853","1331","0","64.09","26.3"
"10","018","00","003","0302","0000","2837","1317","1520","145","2982","5255","0","56.75","25.06"
"10","018","00","003","0302","0266","566","261","305","44","610","1088","0","56.07","23.99"
"10","018","00","003","0302","0267","463","232","231","11","474","903","0","52.49","25.69"
"10","018","00","003","0302","0268","560","261","299","36","596","1012","0","58.89","25.79"
"10","018","00","003","0302","0269","548","236","312","29","577","1014","0","56.9","23.27"
"10","018","00","003","0302","0270","700","327","373","25","725","1238","0","58.56","26.41"
"10","018","00","003","0303","0000","1266","518","748","62","1328","2288","0","58.04","22.64"
"10","018","00","003","0303","0264","526","199","327","25","551","970","0","56.8","20.52"
"10","018","00","003","0303","0265","740","319","421","37","777","1318","0","58.95","24.2"
"10","018","00","003","0304","0000","1395","668","727","94","1489","2371","0","62.8","28.17"
"10","018","00","003","0304","0262","751","357","394","48","799","1348","0","59.27","26.48"
"10","018","00","003","0304","0263","644","311","333","46","690","1023","0","67.45","30.4"
"10","018","00","003","0305","0000","1232","619","613","88","1320","2095","0","63.01","29.55"
"10","018","00","003","0305","0260","652","322","330","44","696","1138","0","61.16","28.3"
"10","018","00","003","0305","0261","580","297","283","44","624","957","0","65.2","31.03"
"10","018","00","003","0306","0000","1788","819","969","91","1879","3128","0","60.07","26.18"
"10","018","00","003","0306","0257","588","255","333","17","605","1067","0","56.7","23.9"
"10","018","00","003","0306","0258","503","217","286","31","534","863","0","61.88","25.14"
"10","018","00","003","0306","0259","697","347","350","43","740","1198","0","61.77","28.96"
"10","018","00","003","0307","0000","1602","679","923","66","1668","2881","0","57.9","23.57"
"10","018","00","003","0307","0252","817","367","450","46","863","1473","0","58.59","24.92"
"10","018","00","003","0307","0253","785","312","473","20","805","1408","0","57.17","22.16"
"10","018","00","003","0308","0000","2284","955","1329","81","2365","4517","0","52.36","21.14"
"10","018","00","003","0308","0254","619","277","342","22","641","1318","0","48.63","21.02"
"10","018","00","003","0308","0255","731","310","421","27","758","1337","0","56.69","23.19"
"10","018","00","003","0308","0256","934","368","566","32","966","1862","0","51.88","19.76"
"10","018","00","003","0309","0000","2649","1149","1500","93","2742","4959","0","55.29","23.17"
"10","018","00","003","0309","0245","747","319","428","35","782","1443","0","54.19","22.11"
"10","018","00","003","0309","0246","663","314","349","25","688","1241","0","55.44","25.3"
"10","018","00","003","0309","0247","641","273","368","21","662","1194","0","55.44","22.86"
"10","018","00","003","0309","0248","598","243","355","12","610","1081","0","56.43","22.48"
"10","018","00","003","0310","0000","2231","858","1373","97","2328","3917","0","59.43","21.9"
"10","018","00","003","0310","0273","608","216","392","24","632","976","0","64.75","22.13"
"10","018","00","003","0310","0274","447","195","252","15","462","834","0","55.4","23.38"
"10","018","00","003","0310","0275","508","187","321","25","533","919","0","58.0","20.35"
"10","018","00","003","0310","0276","668","260","408","33","701","1188","0","59.01","21.89"
"10","018","00","003","0311","0000","1939","799","1140","86","2025","3342","0","60.59","23.91"
"10","018","00","003","0311","0277","599","265","334","34","633","1086","0","58.29","24.4"
"10","018","00","003","0311","0278","687","304","383","33","720","1144","0","62.94","26.57"
"10","018","00","003","0311","0279","653","230","423","19","672","1112","0","60.43","20.68"
"10","018","00","003","0312","0000","2397","1002","1395","97","2494","4231","0","58.95","23.68"
"10","018","00","003","0312","0280","825","351","474","33","858","1476","0","58.13","23.78"
"10","018","00","003","0312","0281","697","288","409","34","731","1291","0","56.62","22.31"
"10","018","00","003","0312","0282","875","363","512","30","905","1464","0","61.82","24.8"
"10","018","00","003","0313","0000","1538","699","839","69","1607","2763","0","58.16","25.3"
"10","018","00","003","0313","0283","807","358","449","47","854","1427","0","59.85","25.09"
"10","018","00","003","0313","0284","731","341","390","22","753","1336","0","56.36","25.52"
"10","018","00","003","0314","0000","540","261","279","30","570","1131","0","50.4","23.08"
"10","018","00","003","0314","0285","540","261","279","30","570","1131","0","50.4","23.08"
"10","018","00","003","0315","0000","1195","513","682","81","1276","2076","0","61.46","24.71"
"10","018","00","003","0315","0286","609","252","357","45","654","1070","0","61.12","23.55"
"10","018","00","003","0315","0287","586","261","325","36","622","1006","0","61.83","25.94"
"10","018","00","003","0316","0000","1169","466","703","57","1226","2342","0","52.35","19.9"
"10","018","00","003","0316","0288","557","211","346","33","590","1223","0","48.24","17.25"
"10","018","00","003","0316","0289","612","255","357","24","636","1119","0","56.84","22.79"
"10","018","00","003","0317","0000","451","202","249","25","476","896","0","53.13","22.54"
"10","018","00","003","0317","0299","451","202","249","25","476","896","0","53.13","22.54"
"10","018","00","003","0318","0000","500","199","301","22","522","890","0","58.65","22.36"
"10","018","00","003","0318","0298","500","199","301","22","522","890","0","58.65","22.36"
"10","018","00","003","0319","0000","428","195","233","19","447","776","0","57.6","25.13"
"10","018","00","003","0319","0297","428","195","233","19","447","776","0","57.6","25.13"
"10","018","00","003","0320","0000","910","382","528","34","944","1784","0","52.91","21.41"
"10","018","00","003","0320","0295","398","177","221","16","414","719","0","57.58","24.62"
"10","018","00","003","0320","0296","512","205","307","18","530","1065","0","49.77","19.25"
"10","018","00","003","0321","0000","2050","888","1162","89","2139","4325","0","49.46","20.53"
"10","018","00","003","0321","0291","740","299","441","34","774","1627","0","47.57","18.38"
"10","018","00","003","0321","0292","632","326","306","17","649","1289","0","50.35","25.29"
"10","018","00","003","0321","0293","678","263","415","38","716","1409","0","50.82","18.67"
"10","018","00","003","0322","0000","675","308","367","30","705","1400","0","50.36","22.0"
"10","018","00","003","0322","0290","675","308","367","30","705","1400","0","50.36","22.0"
"10","018","00","003","0323","0000","415","224","191","24","439","814","0","53.93","27.52"
"10","018","00","003","0323","0294","415","224","191","24","439","814","0","53.93","27.52"
"10","018","00","003","0324","0000","2268","945","1323","100","2368","4202","0","56.35","22.49"
"10","018","00","003","0324","0249","462","220","242","22","484","807","0","59.98","27.26"
"10","018","00","003","0324","0250","932","389","543","36","968","1760","0","55.0","22.1"
"10","018","00","003","0324","0251","874","336","538","42","916","1635","0","56.02","20.55"
"10","020","00","000","0000","0000","118562","58391","60171","4694","123256","221553","268741","55.63","26.36"
"10","020","00","001","0000","0000","53674","25763","27911","2164","55838","100647","121279","55.48","25.6"
"10","020","00","001","0101","0000","2301","1106","1195","106","2407","4386","0","54.88","25.22"
"10","020","00","001","0101","0079","647","348","299","47","694","1282","0","54.13","27.15"
"10","020","00","001","0101","0080","886","408","478","37","923","1571","0","58.75","25.97"
"10","020","00","001","0101","0081","768","350","418","22","790","1533","0","51.53","22.83"
"10","020","00","001","0102","0000","1542","750","792","47","1589","3393","0","46.83","22.1"
"10","020","00","001","0102","0077","780","353","427","22","802","1823","0","43.99","19.36"
"10","020","00","001","0102","0078","762","397","365","25","787","1570","0","50.13","25.29"
"10","020","00","001","0103","0000","1427","679","748","39","1466","2832","0","51.77","23.98"
"10","020","00","001","0103","0075","632","301","331","15","647","1404","0","46.08","21.44"
"10","020","00","001","0103","0076","795","378","417","24","819","1428","0","57.35","26.47"
"10","020","00","001","0104","0000","1669","810","859","85","1754","3249","0","53.99","24.93"
"10","020","00","001","0104","0069","848","407","441","41","889","1682","0","52.85","24.2"
"10","020","00","001","0104","0070","821","403","418","44","865","1567","0","55.2","25.72"
"10","020","00","001","0105","0000","1240","558","682","33","1273","2188","0","58.18","25.5"
"10","020","00","001","0105","0071","661","313","348","14","675","1207","0","55.92","25.93"
"10","020","00","001","0105","0072","579","245","334","19","598","981","0","60.96","24.97"
"10","020","00","001","0134","0000","2284","963","1321","114","2398","4205","0","57.03","22.9"
"10","020","00","001","0134","0021","619","215","404","41","660","1199","0","55.05","17.93"
"10","020","00","001","0134","0022","662","264","398","26","688","1236","0","55.66","21.36"
"10","020","00","001","0134","0023","497","243","254","16","513","890","0","57.64","27.3"
"10","020","00","001","0134","0024","506","241","265","31","537","880","0","61.02","27.39"
"10","020","00","001","0135","0000","2359","1086","1273","84","2443","4172","0","58.56","26.03"
"10","020","00","001","0135","0018","888","424","464","28","916","1552","0","59.02","27.32"
"10","020","00","001","0135","0019","864","383","481","32","896","1558","0","57.51","24.58"
"10","020","00","001","0135","0020","607","279","328","24","631","1062","0","59.42","26.27"
"10","020","00","001","0136","0000","2089","959","1130","76","2165","3967","0","54.58","24.17"
"10","020","00","001","0136","0015","710","366","344","35","745","1453","0","51.27","25.19"
"10","020","00","001","0136","0016","581","255","326","19","600","1094","0","54.84","23.31"
"10","020","00","001","0136","0017","798","338","460","22","820","1420","0","57.75","23.8"
"10","020","00","001","0137","0000","1326","619","707","39","1365","2334","0","58.48","26.52"
"10","020","00","001","0137","0011","713","320","393","21","734","1221","0","60.11","26.21"
"10","020","00","001","0137","0012","613","299","314","18","631","1113","0","56.69","26.86"
"10","020","00","001","0138","0000","1015","480","535","38","1053","1794","0","58.7","26.76"
"10","020","00","001","0138","0005","421","202","219","16","437","702","0","62.25","28.77"
"10","020","00","001","0138","0006","594","278","316","22","616","1092","0","56.41","25.46"
"10","020","00","001","0139","0000","2308","991","1317","84","2392","4239","0","56.43","23.38"
"10","020","00","001","0139","0027","760","298","462","33","793","1435","0","55.26","20.77"
"10","020","00","001","0139","0028","788","350","438","30","818","1349","0","60.64","25.95"
"10","020","00","001","0139","0029","760","343","417","21","781","1455","0","53.68","23.57"
"10","020","00","001","0141","0000","898","417","481","42","940","1816","0","51.76","22.96"
"10","020","00","001","0141","0008","898","417","481","42","940","1816","0","51.76","22.96"
"10","020","00","001","0142","0000","472","247","225","24","496","1023","0","48.48","24.14"
"10","020","00","001","0142","0007","472","247","225","24","496","1023","0","48.48","24.14"
"10","020","00","001","0143","0000","1644","757","887","49","1693","2847","0","59.47","26.59"
"10","020","00","001","0143","0013","814","385","429","24","838","1452","0","57.71","26.52"
"10","020","00","001","0143","0014","830","372","458","25","855","1395","0","61.29","26.67"
"10","020","00","001","0144","0000","1263","541","722","33","1296","2301","0","56.32","23.51"
"10","020","00","001","0144","0001","576","248","328","18","594","1025","0","57.95","24.2"
"10","020","00","001","0144","0002","687","293","394","15","702","1276","0","55.02","22.96"
"10","020","00","001","0145","0000","1081","520","561","41","1122","1987","0","56.47","26.17"
"10","020","00","001","0145","0042","505","254","251","23","528","938","0","56.29","27.08"
"10","020","00","001","0145","0043","576","266","310","18","594","1049","0","56.63","25.36"
"10","020","00","001","0146","0000","686","382","304","35","721","1360","0","53.01","28.09"
"10","020","00","001","0146","0044","686","382","304","35","721","1360","0","53.01","28.09"
"10","020","00","001","0147","0000","761","422","339","55","816","1615","0","50.53","26.13"
"10","020","00","001","0147","0045","761","422","339","55","816","1615","0","50.53","26.13"
"10","020","00","001","0148","0000","658","359","299","21","679","1267","0","53.59","28.33"
"10","020","00","001","0148","0046","658","359","299","21","679","1267","0","53.59","28.33"
"10","020","00","001","0149","0000","1632","785","847","89","1721","3410","0","50.47","23.02"
"10","020","00","001","0149","0047","724","376","348","50","774","1579","0","49.02","23.81"
"10","020","00","001","0149","0048","908","409","499","39","947","1831","0","51.72","22.34"
"10","020","00","001","0150","0000","1167","598","569","30","1197","2146","0","55.78","27.87"
"10","020","00","001","0150","0049","556","266","290","19","575","977","0","58.85","27.23"
"10","020","00","001","0150","0050","611","332","279","11","622","1169","0","53.21","28.4"
"10","020","00","001","0151","0000","1398","685","713","73","1471","2504","0","58.75","27.36"
"10","020","00","001","0151","0051","682","353","329","57","739","1238","0","59.69","28.51"
"10","020","00","001","0151","0052","716","332","384","16","732","1266","0","57.82","26.22"
"10","020","00","001","0152","0000","1378","682","696","50","1428","2717","0","52.56","25.1"
"10","020","00","001","0152","0053","669","325","344","32","701","1429","0","49.06","22.74"
"10","020","00","001","0152","0054","709","357","352","18","727","1288","0","56.44","27.72"
"10","020","00","001","0153","0000","1288","621","667","77","1365","2347","0","58.16","26.46"
"10","020","00","001","0153","0060","588","303","285","32","620","1170","0","52.99","25.9"
"10","020","00","001","0153","0061","700","318","382","45","745","1177","0","63.3","27.02"
"10","020","00","001","0154","0000","2106","994","1112","77","2183","3893","0","56.08","25.53"
"10","020","00","001","0154","0057","636","307","329","30","666","1133","0","58.78","27.1"
"10","020","00","001","0154","0058","674","316","358","25","699","1235","0","56.6","25.59"
"10","020","00","001","0154","0059","796","371","425","22","818","1525","0","53.64","24.33"
"10","020","00","001","0155","0000","1949","914","1035","137","2086","3667","0","56.89","24.93"
"10","020","00","001","0155","0062","649","294","355","42","691","1207","0","57.25","24.36"
"10","020","00","001","0155","0063","690","308","382","36","726","1272","0","57.08","24.21"
"10","020","00","001","0155","0064","610","312","298","59","669","1188","0","56.31","26.26"
"10","020","00","001","0156","0000","1212","587","625","63","1275","2101","0","60.69","27.94"
"10","020","00","001","0156","0040","605","271","334","21","626","1023","0","61.19","26.49"
"10","020","00","001","0156","0041","607","316","291","42","649","1078","0","60.2","29.31"
"10","020","00","001","0157","0000","910","484","426","42","952","1824","0","52.19","26.54"
"10","020","00","001","0157","0038","554","282","272","27","581","961","0","60.46","29.34"
"10","020","00","001","0157","0039","356","202","154","15","371","863","0","42.99","23.41"
"10","020","00","001","0158","0000","1073","562","511","39","1112","2058","0","54.03","27.31"
"10","020","00","001","0158","0036","498","268","230","19","517","967","0","53.46","27.71"
"10","020","00","001","0158","0037","575","294","281","20","595","1091","0","54.54","26.95"
"10","020","00","001","0159","0000","1098","569","529","44","1142","2021","0","56.51","28.15"
"10","020","00","001","0159","0032","513","264","249","23","536","941","0","56.96","28.06"
"10","020","00","001","0159","0033","585","305","280","21","606","1080","0","56.11","28.24"
"10","020","00","001","0160","0000","1076","572","504","32","1108","1867","0","59.35","30.64"
"10","020","00","001","0160","0030","523","247","276","16","539","915","0","58.91","26.99"
"10","020","00","001","0160","0031","553","325","228","16","569","952","0","59.77","34.14"
"10","020","00","001","0161","0000","1071","484","587","26","1097","1858","0","59.04","26.05"
"10","020","00","001","0161","0025","667","290","377","14","681","1189","0","57.28","24.39"
"10","020","00","001","0161","0026","404","194","210","12","416","669","0","62.18","29.0"
"10","020","00","001","0162","0000","1224","679","545","34","1258","2210","0","56.92","30.72"
"10","020","00","001","0162","0034","607","331","276","15","622","1157","0","53.76","28.61"
"10","020","00","001","0162","0035","617","348","269","19","636","1053","0","60.4","33.05"
"10","020","00","001","0163","0000","1348","684","664","54","1402","2343","0","59.84","29.19"
"10","020","00","001","0163","0067","739","372","367","31","770","1332","0","57.81","27.93"
"10","020","00","001","0163","0068","609","312","297","23","632","1011","0","62.51","30.86"
"10","020","00","001","0164","0000","1165","613","552","50","1215","2192","0","55.43","27.97"
"10","020","00","001","0164","0065","593","302","291","20","613","1172","0","52.3","25.77"
"10","020","00","001","0164","0066","572","311","261","30","602","1020","0","59.02","30.49"
"10","020","00","001","0165","0000","1165","545","620","60","1225","2149","0","57.0","25.36"
"10","020","00","001","0165","0003","476","218","258","25","501","974","0","51.44","22.38"
"10","020","00","001","0165","0004","689","327","362","35","724","1175","0","61.62","27.83"
"10","020","00","001","0166","0000","1968","881","1087","61","2029","3634","0","55.83","24.24"
"10","020","00","001","0166","0009","1027","473","554","36","1063","1936","0","54.91","24.43"
"10","020","00","001","0166","0010","941","408","533","25","966","1698","0","56.89","24.03"
"10","020","00","001","0167","0000","1005","515","490","40","1045","1902","0","54.94","27.08"
"10","020","00","001","0167","0055","531","284","247","20","551","980","0","56.22","28.98"
"10","020","00","001","0167","0056","474","231","243","20","494","922","0","53.58","25.05"
"10","020","00","001","0168","0000","1418","663","755","41","1459","2829","0","51.57","23.44"
"10","020","00","001","0168","0073","735","325","410","26","761","1395","0","54.55","23.3"
"10","020","00","001","0168","0074","683","338","345","15","698","1434","0","48.68","23.57"
"10","020","00","002","0000","0000","64888","32628","32260","2530","67418","120906","147462","55.76","26.99"
"10","020","00","002","0201","0000","429","204","225","25","454","770","0","58.96","26.49"
"10","020","00","002","0201","0152","429","204","225","25","454","770","0","58.96","26.49"
"10","020","00","002","0202","0000","1128","604","524","37","1165","2071","0","56.25","29.16"
"10","020","00","002","0202","0157","538","315","223","19","557","997","0","55.87","31.59"
"10","020","00","002","0202","0158","590","289","301","18","608","1074","0","56.61","26.91"
"10","020","00","002","0203","0000","1272","658","614","61","1333","2257","0","59.06","29.15"
"10","020","00","002","0203","0148","641","330","311","32","673","1146","0","58.73","28.8"
"10","020","00","002","0203","0149","631","328","303","29","660","1111","0","59.41","29.52"
"10","020","00","002","0205","0000","971","501","470","47","1018","1970","0","51.68","25.43"
"10","020","00","002","0205","0153","541","261","280","20","561","1135","0","49.43","23.0"
"10","020","00","002","0205","0154","430","240","190","27","457","835","0","54.73","28.74"
"10","020","00","002","0209","0000","2162","1132","1030","53","2215","4311","0","51.38","26.26"
"10","020","00","002","0209","0159","650","326","324","10","660","1460","0","45.21","22.33"
"10","020","00","002","0209","0160","724","396","328","17","741","1352","0","54.81","29.29"
"10","020","00","002","0209","0161","788","410","378","26","814","1499","0","54.3","27.35"
"10","020","00","002","0210","0000","2257","1220","1037","135","2392","4132","0","57.89","29.53"
"10","020","00","002","0210","0168","807","434","373","59","866","1467","0","59.03","29.58"
"10","020","00","002","0210","0169","710","382","328","39","749","1431","0","52.34","26.69"
"10","020","00","002","0210","0170","740","404","336","37","777","1234","0","62.97","32.74"
"10","020","00","002","0211","0000","1609","845","764","54","1663","3214","0","51.74","26.29"
"10","020","00","002","0211","0165","816","490","326","30","846","1674","0","50.54","29.27"
"10","020","00","002","0211","0166","793","355","438","24","817","1540","0","53.05","23.05"
"10","020","00","002","0212","0000","1557","807","750","75","1632","2868","0","56.9","28.14"
"10","020","00","002","0212","0175","853","446","407","54","907","1546","0","58.67","28.85"
"10","020","00","002","0212","0176","704","361","343","21","725","1322","0","54.84","27.31"
"10","020","00","002","0213","0000","835","418","417","48","883","1549","0","57.0","26.99"
"10","020","00","002","0213","0177","835","418","417","48","883","1549","0","57.0","26.99"
"10","020","00","002","0214","0000","595","300","295","19","614","1155","0","53.16","25.97"
"10","020","00","002","0214","0174","595","300","295","19","614","1155","0","53.16","25.97"
"10","020","00","002","0215","0000","1207","639","568","44","1251","2120","0","59.01","30.14"
"10","020","00","002","0215","0093","619","330","289","29","648","1053","0","61.54","31.34"
"10","020","00","002","0215","0094","588","309","279","15","603","1067","0","56.51","28.96"
"10","020","00","002","0216","0000","2112","1071","1041","81","2193","4105","0","53.42","26.09"
"10","020","00","002","0216","0097","616","337","279","30","646","1196","0","54.01","28.18"
"10","020","00","002","0216","0098","646","348","298","19","665","1280","0","51.95","27.19"
"10","020","00","002","0216","0099","850","386","464","32","882","1629","0","54.14","23.7"
"10","020","00","002","0217","0000","1537","779","758","74","1611","3195","0","50.42","24.38"
"10","020","00","002","0217","0110","589","339","250","35","624","1396","0","44.7","24.28"
"10","020","00","002","0217","0111","948","440","508","39","987","1799","0","54.86","24.46"
"10","020","00","002","0218","0000","1727","850","877","47","1774","3440","0","51.57","24.71"
"10","020","00","002","0218","0095","760","369","391","21","781","1575","0","49.59","23.43"
"10","020","00","002","0218","0096","967","481","486","26","993","1865","0","53.24","25.79"
"10","020","00","002","0219","0000","2006","941","1065","52","2058","3351","0","61.41","28.08"
"10","020","00","002","0219","0105","623","284","339","17","640","1000","0","64.0","28.4"
"10","020","00","002","0219","0106","638","307","331","16","654","1095","0","59.73","28.04"
"10","020","00","002","0219","0107","745","350","395","19","764","1256","0","60.83","27.87"
"10","020","00","002","0220","0000","1082","529","553","48","1130","1827","0","61.85","28.95"
"10","020","00","002","0220","0108","542","271","271","28","570","962","0","59.25","28.17"
"10","020","00","002","0220","0109","540","258","282","20","560","865","0","64.74","29.83"
"10","020","00","002","0221","0000","3351","1578","1773","94","3445","6594","0","52.24","23.93"
"10","020","00","002","0221","0112","743","354","389","24","767","1505","0","50.96","23.52"
"10","020","00","002","0221","0113","887","424","463","42","929","1698","0","54.71","24.97"
"10","020","00","002","0221","0114","985","441","544","22","1007","1854","0","54.31","23.79"
"10","020","00","002","0221","0115","736","359","377","6","742","1537","0","48.28","23.36"
"10","020","00","002","0222","0000","1071","591","480","52","1123","2024","0","55.48","29.2"
"10","020","00","002","0222","0103","483","274","209","45","528","841","0","62.78","32.58"
"10","020","00","002","0222","0104","588","317","271","7","595","1183","0","50.3","26.8"
"10","020","00","002","0231","0000","1058","536","522","41","1099","1994","0","55.12","26.88"
"10","020","00","002","0231","0082","478","253","225","16","494","885","0","55.82","28.59"
"10","020","00","002","0231","0083","580","283","297","25","605","1109","0","54.55","25.52"
"10","020","00","002","0245","0000","944","388","556","40","984","1625","0","60.55","23.88"
"10","020","00","002","0245","0140","471","245","226","22","493","756","0","65.21","32.41"
"10","020","00","002","0245","0141","473","143","330","18","491","869","0","56.5","16.46"
"10","020","00","002","0246","0000","1005","544","461","24","1029","1904","0","54.04","28.57"
"10","020","00","002","0246","0138","387","227","160","13","400","736","0","54.35","30.84"
"10","020","00","002","0246","0139","618","317","301","11","629","1168","0","53.85","27.14"
"10","020","00","002","0247","0000","3170","1600","1570","92","3262","5706","0","57.17","28.04"
"10","020","00","002","0247","0134","840","391","449","37","877","1548","0","56.65","25.26"
"10","020","00","002","0247","0135","697","373","324","14","711","1295","0","54.9","28.8"
"10","020","00","002","0247","0136","786","404","382","15","801","1318","0","60.77","30.65"
"10","020","00","002","0247","0137","847","432","415","26","873","1545","0","56.5","27.96"
"10","020","00","002","0248","0000","2988","1463","1525","113","3101","5397","0","57.46","27.11"
"10","020","00","002","0248","0130","757","352","405","23","780","1185","0","65.82","29.7"
"10","020","00","002","0248","0131","769","392","377","29","798","1278","0","62.44","30.67"
"10","020","00","002","0248","0132","610","319","291","23","633","1394","0","45.41","22.88"
"10","020","00","002","0248","0133","852","400","452","38","890","1540","0","57.79","25.97"
"10","020","00","002","0249","0000","2350","1211","1139","107","2457","4343","0","56.57","27.88"
"10","020","00","002","0249","0120","716","358","358","33","749","1362","0","54.99","26.28"
"10","020","00","002","0249","0121","730","397","333","22","752","1279","0","58.8","31.04"
"10","020","00","002","0249","0122","904","456","448","52","956","1702","0","56.17","26.79"
"10","020","00","002","0250","0000","2120","1062","1058","114","2234","3715","0","60.13","28.59"
"10","020","00","002","0250","0117","553","304","249","51","604","944","0","63.98","32.2"
"10","020","00","002","0250","0118","903","444","459","37","940","1627","0","57.78","27.29"
"10","020","00","002","0250","0119","664","314","350","26","690","1144","0","60.31","27.45"
"10","020","00","002","0251","0000","1036","507","529","43","1079","1811","0","59.58","28.0"
"10","020","00","002","0251","0142","567","268","299","21","588","983","0","59.82","27.26"
"10","020","00","002","0251","0143","469","239","230","22","491","828","0","59.3","28.86"
"10","020","00","002","0252","0000","942","266","676","35","977","1775","0","55.04","14.99"
"10","020","00","002","0252","0144","942","266","676","35","977","1775","0","55.04","14.99"
"10","020","00","002","0253","0000","2742","1328","1414","95","2837","4992","0","56.83","26.6"
"10","020","00","002","0253","0126","741","350","391","26","767","1280","0","59.92","27.34"
"10","020","00","002","0253","0127","595","297","298","27","622","1220","0","50.98","24.34"
"10","020","00","002","0253","0128","686","322","364","17","703","1172","0","59.98","27.47"
"10","020","00","002","0253","0129","720","359","361","25","745","1320","0","56.44","27.2"
"10","020","00","002","0254","0000","733","195","538","33","766","1419","0","53.98","13.74"
"10","020","00","002","0254","0145","733","195","538","33","766","1419","0","53.98","13.74"
"10","020","00","002","0255","0000","769","391","378","52","821","1604","0","51.18","24.38"
"10","020","00","002","0255","0116","769","391","378","52","821","1604","0","51.18","24.38"
"10","020","00","002","0256","0000","1075","562","513","60","1135","1945","0","58.35","28.89"
"10","020","00","002","0256","0084","518","290","228","29","547","1020","0","53.63","28.43"
"10","020","00","002","0256","0085","557","272","285","31","588","925","0","63.57","29.41"
"10","020","00","002","0257","0000","796","470","326","19","815","1671","0","48.77","28.13"
"10","020","00","002","0257","0086","796","470","326","19","815","1671","0","48.77","28.13"
"10","020","00","002","0258","0000","1258","696","562","36","1294","2251","0","57.49","30.92"
"10","020","00","002","0258","0087","684","345","339","17","701","1215","0","57.7","28.4"
"10","020","00","002","0258","0088","574","351","223","19","593","1036","0","57.24","33.88"
"10","020","00","002","0259","0000","1186","670","516","46","1232","2256","0","54.61","29.7"
"10","020","00","002","0259","0089","587","346","241","19","606","1129","0","53.68","30.65"
"10","020","00","002","0259","0090","599","324","275","27","626","1127","0","55.55","28.75"
"10","020","00","002","0260","0000","713","351","362","20","733","1366","0","53.66","25.7"
"10","020","00","002","0260","0092","713","351","362","20","733","1366","0","53.66","25.7"
"10","020","00","002","0261","0000","776","427","349","29","805","1415","0","56.89","30.18"
"10","020","00","002","0261","0091","776","427","349","29","805","1415","0","56.89","30.18"
"10","020","00","002","0262","0000","893","487","406","28","921","1634","0","56.36","29.8"
"10","020","00","002","0262","0146","444","260","184","11","455","779","0","58.41","33.38"
"10","020","00","002","0262","0147","449","227","222","17","466","855","0","54.5","26.55"
"10","020","00","002","0263","0000","890","469","421","33","923","1584","0","58.27","29.61"
"10","020","00","002","0263","0150","476","243","233","21","497","767","0","64.8","31.68"
"10","020","00","002","0263","0151","414","226","188","12","426","817","0","52.14","27.66"
"10","020","00","002","0264","0000","1046","609","437","54","1100","2126","0","51.74","28.65"
"10","020","00","002","0264","0155","577","314","263","33","610","1182","0","51.61","26.57"
"10","020","00","002","0264","0156","469","295","174","21","490","944","0","51.91","31.25"
"10","020","00","002","0265","0000","2177","1088","1089","103","2280","4164","0","54.76","26.13"
"10","020","00","002","0265","0100","762","397","365","46","808","1393","0","58.0","28.5"
"10","020","00","002","0265","0101","641","312","329","27","668","1077","0","62.02","28.97"
"10","020","00","002","0265","0102","774","379","395","30","804","1694","0","47.46","22.37"
"10","020","00","002","0266","0000","1573","751","822","65","1638","2718","0","60.26","27.63"
"10","020","00","002","0266","0123","772","347","425","33","805","1358","0","59.28","25.55"
"10","020","00","002","0266","0124","801","404","397","32","833","1360","0","61.25","29.71"
"10","020","00","002","0267","0000","869","439","430","32","901","1589","0","56.7","27.63"
"10","020","00","002","0267","0125","869","439","430","32","901","1589","0","56.7","27.63"
"10","020","00","002","0268","0000","1989","969","1020","46","2035","3598","0","56.56","26.93"
"10","020","00","002","0268","0171","670","340","330","14","684","1266","0","54.03","26.86"
"10","020","00","002","0268","0172","678","338","340","22","700","1211","0","57.8","27.91"
"10","020","00","002","0268","0173","641","291","350","10","651","1121","0","58.07","25.96"
"10","020","00","002","0269","0000","2245","1144","1101","108","2353","4295","0","54.78","26.64"
"10","020","00","002","0269","0162","666","367","299","55","721","1262","0","57.13","29.08"
"10","020","00","002","0269","0163","702","330","372","15","717","1299","0","55.2","25.4"
"10","020","00","002","0269","0164","877","447","430","38","915","1734","0","52.77","25.78"
"10","020","00","002","0270","0000","637","338","299","16","653","1056","0","61.84","32.01"
"10","020","00","002","0270","0167","637","338","299","16","653","1056","0","61.84","32.01"
"09","020","00","000","0000","0000","41658","9644","32014","2263","43921","122695","138845","35.8","7.86"
"09","020","00","001","0000","0000","12599","2880","9719","642","13241","37815","43315","35.02","7.62"
"09","020","00","001","0101","0000","1741","407","1334","96","1837","4977","0","36.91","8.18"
"09","020","00","001","0101","0001","469","115","354","31","500","1396","0","35.82","8.24"
"09","020","00","001","0101","0002","669","156","513","26","695","1831","0","37.96","8.52"
"09","020","00","001","0101","0003","603","136","467","39","642","1750","0","36.69","7.77"
"09","020","00","001","0102","0000","3440","767","2673","170","3610","9882","0","36.53","7.76"
"09","020","00","001","0102","0007","510","144","366","47","557","1610","0","34.6","8.94"
"09","020","00","001","0102","0008","570","129","441","31","601","1687","0","35.63","7.65"
"09","020","00","001","0102","0009","562","115","447","18","580","1594","0","36.39","7.21"
"09","020","00","001","0102","0010","586","120","466","23","609","1726","0","35.28","6.95"
"09","020","00","001","0102","0011","609","138","471","23","632","1733","0","36.47","7.96"
"09","020","00","001","0102","0012","603","121","482","28","631","1532","0","41.19","7.9"
"09","020","00","001","0103","0000","1932","421","1511","103","2035","5465","0","37.24","7.7"
"09","020","00","001","0103","0004","683","155","528","34","717","1889","0","37.96","8.21"
"09","020","00","001","0103","0005","507","133","374","30","537","1675","0","32.06","7.94"
"09","020","00","001","0103","0006","742","133","609","39","781","1901","0","41.08","7.0"
"09","020","00","001","0104","0000","1305","299","1006","66","1371","4112","0","33.34","7.27"
"09","020","00","001","0104","0013","682","154","528","37","719","2079","0","34.58","7.41"
"09","020","00","001","0104","0014","623","145","478","29","652","2033","0","32.07","7.13"
"09","020","00","001","0105","0000","1018","241","777","48","1066","3788","0","28.14","6.36"
"09","020","00","001","0105","0018","695","169","526","25","720","2435","0","29.57","6.94"
"09","020","00","001","0105","0019","323","72","251","23","346","1353","0","25.57","5.32"
"09","020","00","001","0106","0000","689","155","534","44","733","2140","0","34.25","7.24"
"09","020","00","001","0106","0017","689","155","534","44","733","2140","0","34.25","7.24"
"09","020","00","001","0107","0000","940","210","730","37","977","2851","0","34.27","7.37"
"09","020","00","001","0107","0020","485","102","383","14","499","1574","0","31.7","6.48"
"09","020","00","001","0107","0021","455","108","347","23","478","1277","0","37.43","8.46"
"09","020","00","001","0108","0000","1534","380","1154","78","1612","4600","0","35.04","8.26"
"09","020","00","001","0108","0015","842","223","619","40","882","2517","0","35.04","8.86"
"09","020","00","001","0108","0016","692","157","535","38","730","2083","0","35.05","7.54"
"09","020","00","002","0000","0000","6225","1336","4889","348","6573","18560","20751","35.41","7.2"
"09","020","00","002","0201","0000","1730","394","1336","101","1831","5106","0","35.86","7.72"
"09","020","00","002","0201","0066","621","134","487","40","661","1909","0","34.63","7.02"
"09","020","00","002","0201","0067","596","132","464","28","624","1524","0","40.94","8.66"
"09","020","00","002","0201","0068","513","128","385","33","546","1673","0","32.64","7.65"
"09","020","00","002","0202","0000","663","111","552","38","701","1895","0","36.99","5.86"
"09","020","00","002","0202","0075","663","111","552","38","701","1895","0","36.99","5.86"
"09","020","00","002","0203","0000","434","121","313","30","464","1135","0","40.88","10.66"
"09","020","00","002","0203","0076","434","121","313","30","464","1135","0","40.88","10.66"
"09","020","00","002","0204","0000","846","184","662","51","897","2377","0","37.74","7.74"
"09","020","00","002","0204","0077","408","86","322","27","435","1252","0","34.74","6.87"
"09","020","00","002","0204","0078","438","98","340","24","462","1125","0","41.07","8.71"
"09","020","00","002","0205","0000","635","128","507","25","660","2003","0","32.95","6.39"
"09","020","00","002","0205","0069","635","128","507","25","660","2003","0","32.95","6.39"
"09","020","00","002","0206","0000","455","82","373","24","479","1540","0","31.1","5.32"
"09","020","00","002","0206","0072","455","82","373","24","479","1540","0","31.1","5.32"
"09","020","00","002","0207","0000","612","120","492","26","638","2166","0","29.46","5.54"
"09","020","00","002","0207","0073","364","81","283","14","378","1216","0","31.09","6.66"
"09","020","00","002","0207","0074","248","39","209","12","260","950","0","27.37","4.11"
"09","020","00","002","0208","0000","850","196","654","53","903","2338","0","38.62","8.38"
"09","020","00","002","0208","0070","465","108","357","29","494","1212","0","40.76","8.91"
"09","020","00","002","0208","0071","385","88","297","24","409","1126","0","36.32","7.82"
"09","020","00","003","0000","0000","8940","2089","6851","575","9515","25915","29658","36.72","8.06"
"09","020","00","003","0301","0000","1438","281","1157","193","1631","4137","0","39.42","6.79"
"09","020","00","003","0301","0049","398","39","359","142","540","1348","0","40.06","2.89"
"09","020","00","003","0301","0050","467","106","361","19","486","1386","0","35.06","7.65"
"09","020","00","003","0301","0051","573","136","437","32","605","1403","0","43.12","9.69"
"09","020","00","003","0302","0000","1165","309","856","68","1233","3264","0","37.78","9.47"
"09","020","00","003","0302","0052","643","170","473","29","672","1771","0","37.94","9.6"
"09","020","00","003","0302","0053","522","139","383","39","561","1493","0","37.58","9.31"
"09","020","00","003","0303","0000","837","211","626","55","892","2618","0","34.07","8.06"
"09","020","00","003","0303","0062","391","109","282","21","412","1236","0","33.33","8.82"
"09","020","00","003","0303","0063","446","102","344","34","480","1382","0","34.73","7.38"
"09","020","00","003","0304","0000","640","129","511","32","672","2006","0","33.5","6.43"
"09","020","00","003","0304","0056","640","129","511","32","672","2006","0","33.5","6.43"
"09","020","00","003","0305","0000","1006","193","813","48","1054","3145","0","33.51","6.14"
"09","020","00","003","0305","0064","545","90","455","15","560","1631","0","34.33","5.52"
"09","020","00","003","0305","0065","461","103","358","33","494","1514","0","32.63","6.8"
"09","020","00","003","0306","0000","2746","734","2012","125","2871","7628","0","37.64","9.62"
"09","020","00","003","0306","0057","613","190","423","30","643","1780","0","36.12","10.67"
"09","020","00","003","0306","0058","610","134","476","25","635","1739","0","36.52","7.71"
"09","020","00","003","0306","0059","452","125","327","27","479","1384","0","34.61","9.03"
"09","020","00","003","0306","0060","498","126","372","29","527","1400","0","37.64","9.0"
"09","020","00","003","0306","0061","573","159","414","14","587","1325","0","44.3","12.0"
"09","020","00","003","0307","0000","510","105","405","28","538","1510","0","35.63","6.95"
"09","020","00","003","0307","0054","510","105","405","28","538","1510","0","35.63","6.95"
"09","020","00","003","0308","0000","598","127","471","26","624","1607","0","38.83","7.9"
"09","020","00","003","0308","0055","598","127","471","26","624","1607","0","38.83","7.9"
"09","020","00","004","0000","0000","9691","2506","7185","483","10174","28162","31588","36.13","8.9"
"09","020","00","004","0401","0000","935","228","707","91","1026","3272","0","31.36","6.97"
"09","020","00","004","0401","0022","486","118","368","55","541","1735","0","31.18","6.8"
"09","020","00","004","0401","0023","449","110","339","36","485","1537","0","31.55","7.16"
"09","020","00","004","0402","0000","1477","358","1119","99","1576","4507","0","34.97","7.94"
"09","020","00","004","0402","0024","553","149","404","43","596","1766","0","33.75","8.44"
"09","020","00","004","0402","0025","357","105","252","18","375","1015","0","36.95","10.34"
"09","020","00","004","0402","0026","567","104","463","38","605","1726","0","35.05","6.03"
"09","020","00","004","0403","0000","483","109","374","22","505","1537","0","32.86","7.09"
"09","020","00","004","0403","0038","483","109","374","22","505","1537","0","32.86","7.09"
"09","020","00","004","0404","0000","2682","723","1959","97","2779","7318","0","37.97","9.88"
"09","020","00","004","0404","0027","503","107","396","34","537","1691","0","31.76","6.33"
"09","020","00","004","0404","0028","845","308","537","21","866","2044","0","42.37","15.07"
"09","020","00","004","0404","0029","740","180","560","24","764","1848","0","41.34","9.74"
"09","020","00","004","0404","0030","594","128","466","18","612","1735","0","35.27","7.38"
"09","020","00","004","0405","0000","1635","365","1270","86","1721","5157","0","33.37","7.08"
"09","020","00","004","0405","0031","599","163","436","28","627","1795","0","34.93","9.08"
"09","020","00","004","0405","0032","547","102","445","35","582","1834","0","31.73","5.56"
"09","020","00","004","0405","0033","489","100","389","23","512","1528","0","33.51","6.54"
"09","020","00","004","0406","0000","2479","723","1756","88","2567","6371","0","40.29","11.35"
"09","020","00","004","0406","0034","544","118","426","24","568","1473","0","38.56","8.01"
"09","020","00","004","0406","0035","573","134","439","26","599","1679","0","35.68","7.98"
"09","020","00","004","0406","0036","908","352","556","25","933","1921","0","48.57","18.32"
"09","020","00","004","0406","0037","454","119","335","13","467","1298","0","35.98","9.17"
"09","020","00","005","0000","0000","4045","790","3255","207","4252","11676","12847","36.42","6.77"
"09","020","00","005","0501","0000","996","202","794","36","1032","2841","0","36.33","7.11"
"09","020","00","005","0501","0045","505","119","386","20","525","1412","0","37.18","8.43"
"09","020","00","005","0501","0046","491","83","408","16","507","1429","0","35.48","5.81"
"09","020","00","005","0502","0000","452","101","351","28","480","1425","0","33.68","7.09"
"09","020","00","005","0502","0044","452","101","351","28","480","1425","0","33.68","7.09"
"09","020","00","005","0503","0000","753","154","599","43","796","2395","0","33.24","6.43"
"09","020","00","005","0503","0042","417","90","327","23","440","1296","0","33.95","6.94"
"09","020","00","005","0503","0043","336","64","272","20","356","1099","0","32.39","5.82"
"09","020","00","005","0504","0000","1267","220","1047","72","1339","3380","0","39.62","6.51"
"09","020","00","005","0504","0039","686","103","583","36","722","1647","0","43.84","6.25"
"09","020","00","005","0504","0040","581","117","464","36","617","1733","0","35.6","6.75"
"09","020","00","005","0505","0000","577","113","464","28","605","1635","0","37.0","6.91"
"09","020","00","005","0505","0041","577","113","464","28","605","1635","0","37.0","6.91"
"09","020","00","006","0000","0000","158","43","115","8","166","567","686","29.28","7.58"
"09","020","00","006","0601","0000","77","27","50","2","79","275","0","28.73","9.82"
"09","020","00","006","0601","0047","77","27","50","2","79","275","0","28.73","9.82"
"09","020","00","006","0602","0000","81","16","65","6","87","292","0","29.79","5.48"
"09","020","00","006","0602","0048","81","16","65","6","87","292","0","29.79","5.48"
"09","007","00","000","0000","0000","5566","1176","4390","190","5756","11205","13062","51.37","10.5"
"09","007","00","001","0000","0000","3182","658","2524","106","3288","6461","7657","50.89","10.18"
"09","007","00","001","0101","0000","984","192","792","30","1014","1967","0","51.55","9.76"
"09","007","00","001","0101","0001","984","192","792","30","1014","1967","0","51.55","9.76"
"09","007","00","001","01x2","0000","843","176","667","39","882","1837","0","48.01","9.58"
"09","007","00","001","01x2","0002","843","176","667","39","882","1837","0","48.01","9.58"
"09","007","00","001","01x4","0000","572","171","401","17","589","1114","0","52.87","15.35"
"09","007","00","001","01x4","0003","572","171","401","17","589","1114","0","52.87","15.35"
"09","007","00","001","01x5","0000","783","119","664","20","803","1543","0","52.04","7.71"
"09","007","00","001","01x5","0004","783","119","664","20","803","1543","0","52.04","7.71"
"09","007","00","002","0000","0000","1068","215","853","38","1106","2125","2430","52.05","10.12"
"09","007","00","002","02x1","0000","788","162","626","26","814","1515","0","53.73","10.69"
"09","007","00","002","02x1","0005","788","162","626","26","814","1515","0","53.73","10.69"
"09","007","00","002","02x4","0000","280","53","227","12","292","610","0","47.87","8.69"
"09","007","00","002","02x4","0006","280","53","227","12","292","610","0","47.87","8.69"
"09","007","00","003","0000","0000","763","181","582","25","788","1481","1627","53.21","12.22"
"09","007","00","003","03x1","0000","331","77","254","10","341","698","0","48.85","11.03"
"09","007","00","003","03x1","0007","331","77","254","10","341","698","0","48.85","11.03"
"09","007","00","003","03x4","0000","432","104","328","15","447","783","0","57.09","13.28"
"09","007","00","003","03x4","0008","432","104","328","15","447","783","0","57.09","13.28"
"09","007","00","004","0000","0000","553","122","431","21","574","1138","1348","50.44","10.72"
"09","007","00","004","04x1","0000","553","122","431","21","574","1138","0","50.44","10.72"
"09","007","00","004","04x1","0009","553","122","431","21","574","1138","0","50.44","10.72"
