"prv_code","city_code","area_code","dept_code","li_code","tbox_no","valid_ticket","agree_ticket","disagree_ticket","invalid_ticket","vote_ticket","votable_population","population","vote_to_votable","agree_to_votable"
"00","000","00","000","0000","0000","10312836","3507665","6805171","619001","10931837","19757067","23580833","55.33","17.75"
"63","000","00","000","0000","0000","1231036","479771","751265","58945","1289981","2228430","2669874","57.89","21.53"
"63","000","00","001","0000","0000","96127","37298","58829","4313","100440","169278","205826","59.33","22.03"
"63","000","00","001","0102","0000","2593","1099","1494","134","2727","4660","0","58.52","23.58"
"63","000","00","001","0102","0527","912","491","421","42","954","1583","0","60.27","31.02"
"63","000","00","001","0102","0528","935","369","566","46","981","1691","0","58.01","21.82"
"63","000","00","001","0102","0529","746","239","507","46","792","1386","0","57.14","17.24"
"63","000","00","001","0103","0000","3969","1562","2407","201","4170","6767","0","61.62","23.08"
"63","000","00","001","0103","0530","774","299","475","50","824","1362","0","60.5","21.95"
"63","000","00","001","0103","0531","803","318","485","42","845","1399","0","60.4","22.73"
"63","000","00","001","0103","0532","775","312","463","40","815","1324","0","61.56","23.56"
"63","000","00","001","0103","0533","793","317","476","38","831","1296","0","64.12","24.46"
"63","000","00","001","0103","0534","824","316","508","31","855","1386","0","61.69","22.8"
"63","000","00","001","0104","0000","3375","1255","2120","171","3546","5950","0","59.6","21.09"
"63","000","00","001","0104","0535","914","245","669","62","976","1529","0","63.83","16.02"
"63","000","00","001","0104","0536","790","295","495","36","826","1416","0","58.33","20.83"
"63","000","00","001","0104","0537","861","358","503","43","904","1619","0","55.84","22.11"
"63","000","00","001","0104","0538","810","357","453","30","840","1386","0","60.61","25.76"
"63","000","00","001","0105","0000","2430","983","1447","96","2526","4033","0","62.63","24.37"
"63","000","00","001","0105","0539","863","374","489","28","891","1380","0","64.57","27.1"
"63","000","00","001","0105","0540","782","310","472","40","822","1357","0","60.57","22.84"
"63","000","00","001","0105","0541","785","299","486","28","813","1296","0","62.73","23.07"
"63","000","00","001","0106","0000","2551","998","1553","120","2671","4450","0","60.02","22.43"
"63","000","00","001","0106","0542","926","368","558","57","983","1632","0","60.23","22.55"
"63","000","00","001","0106","0543","792","315","477","39","831","1414","0","58.77","22.28"
"63","000","00","001","0106","0544","833","315","518","24","857","1404","0","61.04","22.44"
"63","000","00","001","0107","0000","2483","924","1559","139","2622","4279","0","61.28","21.59"
"63","000","00","001","0107","0545","793","266","527","58","851","1365","0","62.34","19.49"
"63","000","00","001","0107","0546","815","313","502","49","864","1431","0","60.38","21.87"
"63","000","00","001","0107","0547","875","345","530","32","907","1483","0","61.16","23.26"
"63","000","00","001","0108","0000","2305","884","1421","110","2415","4010","0","60.22","22.04"
"63","000","00","001","0108","0548","772","309","463","43","815","1293","0","63.03","23.9"
"63","000","00","001","0108","0549","775","306","469","32","807","1410","0","57.23","21.7"
"63","000","00","001","0108","0550","758","269","489","35","793","1307","0","60.67","20.58"
"63","000","00","001","0109","0000","2247","852","1395","88","2335","3710","0","62.94","22.96"
"63","000","00","001","0109","0551","759","304","455","32","791","1242","0","63.69","24.48"
"63","000","00","001","0109","0552","718","272","446","20","738","1192","0","61.91","22.82"
"63","000","00","001","0109","0553","770","276","494","36","806","1276","0","63.17","21.63"
"63","000","00","001","0110","0000","2164","740","1424","74","2238","3676","0","60.88","20.13"
"63","000","00","001","0110","0554","696","151","545","16","712","1201","0","59.28","12.57"
"63","000","00","001","0110","0555","768","289","479","31","799","1318","0","60.62","21.93"
"63","000","00","001","0110","0556","700","300","400","27","727","1157","0","62.83","25.93"
"63","000","00","001","0111","0000","3538","1351","2187","165","3703","6311","0","58.68","21.41"
"63","000","00","001","0111","0557","652","248","404","20","672","1157","0","58.08","21.43"
"63","000","00","001","0111","0558","810","303","507","30","840","1357","0","61.9","22.33"
"63","000","00","001","0111","0559","630","249","381","28","658","1215","0","54.16","20.49"
"63","000","00","001","0111","0560","749","279","470","35","784","1345","0","58.29","20.74"
"63","000","00","001","0111","0561","697","272","425","52","749","1237","0","60.55","21.99"
"63","000","00","001","0112","0000","5037","1770","3267","190","5227","8478","0","61.65","20.88"
"63","000","00","001","0112","0562","842","257","585","33","875","1393","0","62.81","18.45"
"63","000","00","001","0112","0563","825","355","470","39","864","1331","0","64.91","26.67"
"63","000","00","001","0112","0564","937","377","560","42","979","1550","0","63.16","24.32"
"63","000","00","001","0112","0565","724","202","522","15","739","1308","0","56.5","15.44"
"63","000","00","001","0112","0566","842","266","576","34","876","1490","0","58.79","17.85"
"63","000","00","001","0112","0567","867","313","554","27","894","1406","0","63.58","22.26"
"63","000","00","001","0113","0000","1373","553","820","59","1432","2286","0","62.64","24.19"
"63","000","00","001","0113","0568","741","307","434","24","765","1191","0","64.23","25.78"
"63","000","00","001","0113","0569","632","246","386","35","667","1095","0","60.91","22.47"
"63","000","00","001","0114","0000","2087","776","1311","114","2201","3688","0","59.68","21.04"
"63","000","00","001","0114","0570","680","240","440","48","728","1198","0","60.77","20.03"
"63","000","00","001","0114","0571","715","268","447","37","752","1265","0","59.45","21.19"
"63","000","00","001","0114","0572","692","268","424","29","721","1225","0","58.86","21.88"
"63","000","00","001","0115","0000","2992","1103","1889","135","3127","5271","0","59.32","20.93"
"63","000","00","001","0115","0573","998","387","611","55","1053","1698","0","62.01","22.79"
"63","000","00","001","0115","0574","987","316","671","30","1017","1819","0","55.91","17.37"
"63","000","00","001","0115","0575","1007","400","607","50","1057","1754","0","60.26","22.81"
"63","000","00","001","0116","0000","4514","1831","2683","200","4714","7675","0","61.42","23.86"
"63","000","00","001","0116","0576","810","348","462","39","849","1361","0","62.38","25.57"
"63","000","00","001","0116","0577","722","278","444","23","745","1189","0","62.66","23.38"
"63","000","00","001","0116","0578","714","286","428","33","747","1214","0","61.53","23.56"
"63","000","00","001","0116","0579","741","317","424","31","772","1284","0","60.12","24.69"
"63","000","00","001","0116","0580","767","300","467","44","811","1297","0","62.53","23.13"
"63","000","00","001","0116","0581","760","302","458","30","790","1330","0","59.4","22.71"
"63","000","00","001","0117","0000","3270","1216","2054","147","3417","5685","0","60.11","21.39"
"63","000","00","001","0117","0582","817","309","508","44","861","1396","0","61.68","22.13"
"63","000","00","001","0117","0583","819","276","543","27","846","1480","0","57.16","18.65"
"63","000","00","001","0117","0584","828","317","511","34","862","1419","0","60.75","22.34"
"63","000","00","001","0117","0585","806","314","492","42","848","1390","0","61.01","22.59"
"63","000","00","001","0118","0000","3204","1406","1798","176","3380","7127","0","47.43","19.73"
"63","000","00","001","0118","0588","874","354","520","24","898","2677","0","33.55","13.22"
"63","000","00","001","0118","0589","731","316","415","49","780","1281","0","60.89","24.67"
"63","000","00","001","0118","0590","677","281","396","40","717","1469","0","48.81","19.13"
"63","000","00","001","0118","0591","922","455","467","63","985","1700","0","57.94","26.76"
"63","000","00","001","0119","0000","4100","1642","2458","206","4306","7443","0","57.85","22.06"
"63","000","00","001","0119","0592","791","333","458","37","828","1503","0","55.09","22.16"
"63","000","00","001","0119","0593","730","317","413","33","763","1309","0","58.29","24.22"
"63","000","00","001","0119","0594","783","290","493","53","836","1376","0","60.76","21.08"
"63","000","00","001","0119","0595","940","356","584","27","967","1654","0","58.46","21.52"
"63","000","00","001","0119","0596","856","346","510","56","912","1601","0","56.96","21.61"
"63","000","00","001","0120","0000","2838","1115","1723","121","2959","4845","0","61.07","23.01"
"63","000","00","001","0120","0597","860","331","529","25","885","1496","0","59.16","22.13"
"63","000","00","001","0120","0598","957","375","582","57","1014","1598","0","63.45","23.47"
"63","000","00","001","0120","0599","1021","409","612","39","1060","1751","0","60.54","23.36"
"63","000","00","001","0121","0000","5142","1703","3439","175","5317","8544","0","62.23","19.93"
"63","000","00","001","0121","0600","930","324","606","40","970","1557","0","62.3","20.81"
"63","000","00","001","0121","0601","1079","361","718","27","1106","1686","0","65.6","21.41"
"63","000","00","001","0121","0602","1010","267","743","39","1049","1707","0","61.45","15.64"
"63","000","00","001","0121","0603","1160","385","775","36","1196","1854","0","64.51","20.77"
"63","000","00","001","0121","0604","963","366","597","33","996","1740","0","57.24","21.03"
"63","000","00","001","0122","0000","4229","1678","2551","190","4419","7404","0","59.68","22.66"
"63","000","00","001","0122","0605","842","324","518","49","891","1494","0","59.64","21.69"
"63","000","00","001","0122","0606","836","328","508","41","877","1453","0","60.36","22.57"
"63","000","00","001","0122","0607","837","331","506","38","875","1458","0","60.01","22.7"
"63","000","00","001","0122","0608","865","378","487","35","900","1536","0","58.59","24.61"
"63","000","00","001","0122","0609","849","317","532","27","876","1463","0","59.88","21.67"
"63","000","00","001","0124","0000","3762","1498","2264","164","3926","7047","0","55.71","21.26"
"63","000","00","001","0124","0610","932","378","554","27","959","1790","0","53.58","21.12"
"63","000","00","001","0124","0611","967","392","575","48","1015","1679","0","60.45","23.35"
"63","000","00","001","0124","0612","891","337","554","43","934","1785","0","52.32","18.88"
"63","000","00","001","0124","0613","972","391","581","46","1018","1793","0","56.78","21.81"
"63","000","00","001","0125","0000","3218","1253","1965","168","3386","5573","0","60.76","22.48"
"63","000","00","001","0125","0614","781","284","497","42","823","1381","0","59.59","20.56"
"63","000","00","001","0125","0615","749","297","452","26","775","1279","0","60.59","23.22"
"63","000","00","001","0125","0616","946","367","579","63","1009","1681","0","60.02","21.83"
"63","000","00","001","0125","0617","742","305","437","37","779","1232","0","63.23","24.76"
"63","000","00","001","0126","0000","4365","1746","2619","157","4522","7803","0","57.95","22.38"
"63","000","00","001","0126","0618","858","347","511","33","891","1533","0","58.12","22.64"
"63","000","00","001","0126","0619","912","365","547","38","950","1540","0","61.69","23.7"
"63","000","00","001","0126","0620","947","377","570","33","980","1716","0","57.11","21.97"
"63","000","00","001","0126","0621","892","375","517","30","922","1664","0","55.41","22.54"
"63","000","00","001","0126","0622","756","282","474","23","779","1350","0","57.7","20.89"
"63","000","00","001","0127","0000","1809","715","1094","90","1899","3395","0","55.94","21.06"
"63","000","00","001","0127","0623","1007","381","626","37","1044","1837","0","56.83","20.74"
"63","000","00","001","0127","0624","802","334","468","53","855","1558","0","54.88","21.44"
"63","000","00","001","0128","0000","1647","613","1034","81","1728","2894","0","59.71","21.18"
"63","000","00","001","0128","0625","836","319","517","43","879","1420","0","61.9","22.46"
"63","000","00","001","0128","0626","811","294","517","38","849","1474","0","57.6","19.95"
"63","000","00","001","0129","0000","1829","671","1158","94","1923","3317","0","57.97","20.23"
"63","000","00","001","0129","0627","855","326","529","58","913","1591","0","57.39","20.49"
"63","000","00","001","0129","0628","974","345","629","36","1010","1726","0","58.52","19.99"
"63","000","00","001","0130","0000","3235","1480","1755","131","3366","5792","0","58.11","25.55"
"63","000","00","001","0130","0629","814","349","465","23","837","1452","0","57.64","24.04"
"63","000","00","001","0130","0630","819","338","481","29","848","1482","0","57.22","22.81"
"63","000","00","001","0130","0631","841","329","512","31","872","1460","0","59.73","22.53"
"63","000","00","001","0130","0632","761","464","297","48","809","1398","0","57.87","33.19"
"63","000","00","001","0131","0000","1547","588","959","60","1607","2649","0","60.66","22.2"
"63","000","00","001","0131","0633","832","327","505","37","869","1423","0","61.07","22.98"
"63","000","00","001","0131","0634","715","261","454","23","738","1226","0","60.2","21.29"
"63","000","00","001","0132","0000","2147","837","1310","83","2230","3761","0","59.29","22.25"
"63","000","00","001","0132","0635","675","251","424","31","706","1158","0","60.97","21.68"
"63","000","00","001","0132","0636","792","332","460","32","824","1426","0","57.78","23.28"
"63","000","00","001","0132","0637","680","254","426","20","700","1177","0","59.47","21.58"
"63","000","00","001","0133","0000","3090","1229","1861","145","3235","5355","0","60.41","22.95"
"63","000","00","001","0133","0638","754","320","434","38","792","1363","0","58.11","23.48"
"63","000","00","001","0133","0639","727","260","467","43","770","1240","0","62.1","20.97"
"63","000","00","001","0133","0640","815","314","501","36","851","1375","0","61.89","22.84"
"63","000","00","001","0133","0641","794","335","459","28","822","1377","0","59.69","24.33"
"63","000","00","001","0134","0000","1293","509","784","49","1342","2242","0","59.86","22.7"
"63","000","00","001","0134","0642","663","251","412","26","689","1225","0","56.24","20.49"
"63","000","00","001","0134","0643","630","258","372","23","653","1017","0","64.21","25.37"
"63","000","00","001","0135","0000","1744","718","1026","80","1824","3158","0","57.76","22.74"
"63","000","00","001","0135","0586","886","370","516","34","920","1525","0","60.33","24.26"
"63","000","00","001","0135","0587","858","348","510","46","904","1633","0","55.36","21.31"
"63","000","00","002","0000","0000","105635","40135","65500","4827","110462","190444","223594","58.0","21.07"
"63","000","00","002","0201","0000","2419","821","1598","85","2504","5151","0","48.61","15.94"
"63","000","00","002","0201","0644","773","281","492","32","805","2476","0","32.51","11.35"
"63","000","00","002","0201","0645","866","265","601","16","882","1381","0","63.87","19.19"
"63","000","00","002","0201","0646","780","275","505","37","817","1294","0","63.14","21.25"
"63","000","00","002","0202","0000","2295","839","1456","100","2395","3949","0","60.65","21.25"
"63","000","00","002","0202","0647","759","288","471","43","802","1351","0","59.36","21.32"
"63","000","00","002","0202","0648","753","267","486","23","776","1296","0","59.88","20.6"
"63","000","00","002","0202","0649","783","284","499","34","817","1302","0","62.75","21.81"
"63","000","00","002","0203","0000","1293","485","808","76","1369","2446","0","55.97","19.83"
"63","000","00","002","0203","0650","533","188","345","53","586","1025","0","57.17","18.34"
"63","000","00","002","0203","0651","760","297","463","23","783","1421","0","55.1","20.9"
"63","000","00","002","0204","0000","1623","641","982","63","1686","3076","0","54.81","20.84"
"63","000","00","002","0204","0652","820","315","505","36","856","1501","0","57.03","20.99"
"63","000","00","002","0204","0653","803","326","477","27","830","1575","0","52.7","20.7"
"63","000","00","002","0205","0000","1663","656","1007","56","1719","2898","0","59.32","22.64"
"63","000","00","002","0205","0654","852","329","523","28","880","1516","0","58.05","21.7"
"63","000","00","002","0205","0655","811","327","484","28","839","1382","0","60.71","23.66"
"63","000","00","002","0206","0000","2843","1088","1755","156","2999","5054","0","59.34","21.53"
"63","000","00","002","0206","0656","624","235","389","37","661","1128","0","58.6","20.83"
"63","000","00","002","0206","0657","754","275","479","46","800","1397","0","57.27","19.69"
"63","000","00","002","0206","0658","687","270","417","40","727","1161","0","62.62","23.26"
"63","000","00","002","0206","0659","778","308","470","33","811","1368","0","59.28","22.51"
"63","000","00","002","0207","0000","2694","1082","1612","111","2805","4589","0","61.12","23.58"
"63","000","00","002","0207","0660","617","233","384","15","632","1049","0","60.25","22.21"
"63","000","00","002","0207","0661","742","275","467","39","781","1308","0","59.71","21.02"
"63","000","00","002","0207","0662","693","281","412","38","731","1154","0","63.34","24.35"
"63","000","00","002","0207","0663","642","293","349","19","661","1078","0","61.32","27.18"
"63","000","00","002","0208","0000","3867","1459","2408","145","4012","6667","0","60.18","21.88"
"63","000","00","002","0208","0664","778","299","479","36","814","1375","0","59.2","21.75"
"63","000","00","002","0208","0665","828","272","556","35","863","1448","0","59.6","18.78"
"63","000","00","002","0208","0666","745","287","458","16","761","1250","0","60.88","22.96"
"63","000","00","002","0208","0667","804","330","474","21","825","1381","0","59.74","23.9"
"63","000","00","002","0208","0668","712","271","441","37","749","1213","0","61.75","22.34"
"63","000","00","002","0209","0000","5010","1837","3173","185","5195","8706","0","59.67","21.1"
"63","000","00","002","0209","0669","851","304","547","34","885","1373","0","64.46","22.14"
"63","000","00","002","0209","0670","725","264","461","29","754","1226","0","61.5","21.53"
"63","000","00","002","0209","0671","662","259","403","16","678","1117","0","60.7","23.19"
"63","000","00","002","0209","0672","669","257","412","35","704","1123","0","62.69","22.89"
"63","000","00","002","0209","0673","700","243","457","27","727","1200","0","60.58","20.25"
"63","000","00","002","0209","0674","689","259","430","23","712","1335","0","53.33","19.4"
"63","000","00","002","0209","0675","714","251","463","21","735","1332","0","55.18","18.84"
"63","000","00","002","0210","0000","1450","349","1101","122","1572","3190","0","49.28","10.94"
"63","000","00","002","0210","0676","626","33","593","57","683","1648","0","41.44","2.0"
"63","000","00","002","0210","0677","824","316","508","65","889","1542","0","57.65","20.49"
"63","000","00","002","0211","0000","2444","962","1482","131","2575","4362","0","59.03","22.05"
"63","000","00","002","0211","0678","673","272","401","62","735","1228","0","59.85","22.15"
"63","000","00","002","0211","0679","962","371","591","36","998","1731","0","57.65","21.43"
"63","000","00","002","0211","0680","809","319","490","33","842","1403","0","60.01","22.74"
"63","000","00","002","0212","0000","1777","673","1104","96","1873","3229","0","58.01","20.84"
"63","000","00","002","0212","0681","1014","371","643","60","1074","1929","0","55.68","19.23"
"63","000","00","002","0212","0682","763","302","461","36","799","1300","0","61.46","23.23"
"63","000","00","002","0213","0000","2341","887","1454","110","2451","4405","0","55.64","20.14"
"63","000","00","002","0213","0683","771","306","465","23","794","1486","0","53.43","20.59"
"63","000","00","002","0213","0684","745","308","437","42","787","1532","0","51.37","20.1"
"63","000","00","002","0213","0685","825","273","552","45","870","1387","0","62.73","19.68"
"63","000","00","002","0214","0000","1844","701","1143","118","1962","3536","0","55.49","19.82"
"63","000","00","002","0214","0686","616","223","393","44","660","1195","0","55.23","18.66"
"63","000","00","002","0214","0687","567","228","339","39","606","1068","0","56.74","21.35"
"63","000","00","002","0214","0688","661","250","411","35","696","1273","0","54.67","19.64"
"63","000","00","002","0215","0000","2158","856","1302","128","2286","3898","0","58.65","21.96"
"63","000","00","002","0215","0689","797","319","478","44","841","1329","0","63.28","24.0"
"63","000","00","002","0215","0690","699","285","414","40","739","1311","0","56.37","21.74"
"63","000","00","002","0215","0691","662","252","410","44","706","1258","0","56.12","20.03"
"63","000","00","002","0216","0000","2895","1200","1695","186","3081","5022","0","61.35","23.89"
"63","000","00","002","0216","0692","718","311","407","56","774","1277","0","60.61","24.35"
"63","000","00","002","0216","0693","763","292","471","53","816","1285","0","63.5","22.72"
"63","000","00","002","0216","0694","705","284","421","38","743","1161","0","64.0","24.46"
"63","000","00","002","0216","0695","709","313","396","39","748","1299","0","57.58","24.1"
"63","000","00","002","0217","0000","2738","1059","1679","108","2846","4811","0","59.16","22.01"
"63","000","00","002","0217","0696","682","253","429","36","718","1243","0","57.76","20.35"
"63","000","00","002","0217","0697","665","257","408","24","689","1197","0","57.56","21.47"
"63","000","00","002","0217","0698","762","310","452","23","785","1224","0","64.13","25.33"
"63","000","00","002","0217","0699","629","239","390","25","654","1147","0","57.02","20.84"
"63","000","00","002","0218","0000","2510","975","1535","97","2607","4373","0","59.62","22.3"
"63","000","00","002","0218","0700","615","256","359","13","628","1045","0","60.1","24.5"
"63","000","00","002","0218","0701","660","235","425","29","689","1096","0","62.86","21.44"
"63","000","00","002","0218","0702","625","256","369","17","642","1115","0","57.58","22.96"
"63","000","00","002","0218","0703","610","228","382","38","648","1117","0","58.01","20.41"
"63","000","00","002","0219","0000","2060","814","1246","84","2144","3770","0","56.87","21.59"
"63","000","00","002","0219","0704","518","233","285","21","539","1019","0","52.89","22.87"
"63","000","00","002","0219","0705","756","283","473","42","798","1346","0","59.29","21.03"
"63","000","00","002","0219","0706","786","298","488","21","807","1405","0","57.44","21.21"
"63","000","00","002","0220","0000","3805","1660","2145","160","3965","6448","0","61.49","25.74"
"63","000","00","002","0220","0707","767","288","479","34","801","1356","0","59.07","21.24"
"63","000","00","002","0220","0708","782","299","483","26","808","1250","0","64.64","23.92"
"63","000","00","002","0220","0709","745","484","261","31","776","1254","0","61.88","38.6"
"63","000","00","002","0220","0710","743","304","439","24","767","1317","0","58.24","23.08"
"63","000","00","002","0220","0711","768","285","483","45","813","1271","0","63.97","22.42"
"63","000","00","002","0221","0000","1067","411","656","68","1135","2004","0","56.64","20.51"
"63","000","00","002","0221","0712","527","203","324","33","560","979","0","57.2","20.74"
"63","000","00","002","0221","0713","540","208","332","35","575","1025","0","56.1","20.29"
"63","000","00","002","0222","0000","3253","1267","1986","95","3348","5741","0","58.32","22.07"
"63","000","00","002","0222","0714","748","296","452","23","771","1512","0","50.99","19.58"
"63","000","00","002","0222","0715","859","348","511","32","891","1483","0","60.08","23.47"
"63","000","00","002","0222","0716","810","321","489","26","836","1359","0","61.52","23.62"
"63","000","00","002","0222","0717","836","302","534","14","850","1387","0","61.28","21.77"
"63","000","00","002","0223","0000","2493","971","1522","92","2585","4448","0","58.12","21.83"
"63","000","00","002","0223","0718","792","306","486","24","816","1455","0","56.08","21.03"
"63","000","00","002","0223","0719","828","330","498","26","854","1461","0","58.45","22.59"
"63","000","00","002","0223","0720","873","335","538","42","915","1532","0","59.73","21.87"
"63","000","00","002","0224","0000","2318","925","1393","133","2451","3964","0","61.83","23.34"
"63","000","00","002","0224","0721","636","274","362","36","672","1043","0","64.43","26.27"
"63","000","00","002","0224","0722","523","206","317","32","555","875","0","63.43","23.54"
"63","000","00","002","0224","0723","520","198","322","17","537","927","0","57.93","21.36"
"63","000","00","002","0224","0724","639","247","392","48","687","1119","0","61.39","22.07"
"63","000","00","002","0225","0000","3971","1609","2362","201","4172","7061","0","59.09","22.79"
"63","000","00","002","0225","0725","802","307","495","52","854","1463","0","58.37","20.98"
"63","000","00","002","0225","0726","789","325","464","43","832","1293","0","64.35","25.14"
"63","000","00","002","0225","0727","841","327","514","43","884","1553","0","56.92","21.06"
"63","000","00","002","0225","0728","744","321","423","25","769","1360","0","56.54","23.6"
"63","000","00","002","0225","0729","795","329","466","38","833","1392","0","59.84","23.64"
"63","000","00","002","0226","0000","3027","1145","1882","127","3154","5430","0","58.08","21.09"
"63","000","00","002","0226","0730","796","293","503","14","810","1377","0","58.82","21.28"
"63","000","00","002","0226","0731","790","329","461","18","808","1377","0","58.68","23.89"
"63","000","00","002","0226","0732","653","246","407","30","683","1269","0","53.82","19.39"
"63","000","00","002","0226","0733","788","277","511","65","853","1407","0","60.63","19.69"
"63","000","00","002","0227","0000","2045","767","1278","104","2149","3609","0","59.55","21.25"
"63","000","00","002","0227","0734","652","248","404","40","692","1172","0","59.04","21.16"
"63","000","00","002","0227","0735","675","246","429","25","700","1182","0","59.22","20.81"
"63","000","00","002","0227","0736","718","273","445","39","757","1255","0","60.32","21.75"
"63","000","00","002","0228","0000","2376","838","1538","80","2456","4437","0","55.35","18.89"
"63","000","00","002","0228","0737","880","333","547","32","912","1689","0","54.0","19.72"
"63","000","00","002","0228","0738","865","318","547","23","888","1605","0","55.33","19.81"
"63","000","00","002","0228","0739","631","187","444","25","656","1143","0","57.39","16.36"
"63","000","00","002","0229","0000","3210","1149","2061","159","3369","5898","0","57.12","19.48"
"63","000","00","002","0229","0740","746","289","457","35","781","1440","0","54.24","20.07"
"63","000","00","002","0229","0741","818","294","524","41","859","1495","0","57.46","19.67"
"63","000","00","002","0229","0742","865","280","585","50","915","1514","0","60.44","18.49"
"63","000","00","002","0229","0743","781","286","495","33","814","1449","0","56.18","19.74"
"63","000","00","002","0230","0000","4513","1675","2838","157","4670","7867","0","59.36","21.29"
"63","000","00","002","0230","0744","813","311","502","45","858","1401","0","61.24","22.2"
"63","000","00","002","0230","0745","642","249","393","16","658","1181","0","55.72","21.08"
"63","000","00","002","0230","0746","856","317","539","15","871","1376","0","63.3","23.04"
"63","000","00","002","0230","0747","831","269","562","44","875","1422","0","61.53","18.92"
"63","000","00","002","0230","0748","714","254","460","24","738","1267","0","58.25","20.05"
"63","000","00","002","0230","0749","657","275","382","13","670","1220","0","54.92","22.54"
"63","000","00","002","0231","0000","2466","947","1519","82","2548","4622","0","55.13","20.49"
"63","000","00","002","0231","0750","798","283","515","27","825","1562","0","52.82","18.12"
"63","000","00","002","0231","0751","810","340","470","22","832","1455","0","57.18","23.37"
"63","000","00","002","0231","0752","858","324","534","33","891","1605","0","55.51","20.19"
"63","000","00","002","0232","0000","3378","1292","2086","112","3490","6070","0","57.5","21.29"
"63","000","00","002","0232","0753","990","354","636","25","1015","1626","0","62.42","21.77"
"63","000","00","002","0232","0754","906","377","529","35","941","1561","0","60.28","24.15"
"63","000","00","002","0232","0755","742","275","467","24","766","1547","0","49.52","17.78"
"63","000","00","002","0232","0756","740","286","454","28","768","1336","0","57.49","21.41"
"63","000","00","002","0233","0000","3656","1362","2294","210","3866","6899","0","56.04","19.74"
"63","000","00","002","0233","0757","643","251","392","42","685","1314","0","52.13","19.1"
"63","000","00","002","0233","0758","690","259","431","27","717","1297","0","55.28","19.97"
"63","000","00","002","0233","0759","724","251","473","43","767","1366","0","56.15","18.37"
"63","000","00","002","0233","0760","796","314","482","57","853","1472","0","57.95","21.33"
"63","000","00","002","0233","0761","803","287","516","41","844","1450","0","58.21","19.79"
"63","000","00","002","0234","0000","2331","896","1435","148","2479","4100","0","60.46","21.85"
"63","000","00","002","0234","0762","725","280","445","49","774","1328","0","58.28","21.08"
"63","000","00","002","0234","0763","811","308","503","46","857","1399","0","61.26","22.02"
"63","000","00","002","0234","0764","795","308","487","53","848","1373","0","61.76","22.43"
"63","000","00","002","0235","0000","1956","713","1243","71","2027","3592","0","56.43","19.85"
"63","000","00","002","0235","0765","602","196","406","13","615","1099","0","55.96","17.83"
"63","000","00","002","0235","0766","675","266","409","37","712","1226","0","58.08","21.7"
"63","000","00","002","0235","0767","679","251","428","21","700","1267","0","55.25","19.81"
"63","000","00","002","0236","0000","3479","1212","2267","151","3630","6247","0","58.11","19.4"
"63","000","00","002","0236","0768","825","249","576","48","873","1531","0","57.02","16.26"
"63","000","00","002","0236","0769","835","275","560","40","875","1438","0","60.85","19.12"
"63","000","00","002","0236","0770","899","342","557","20","919","1657","0","55.46","20.64"
"63","000","00","002","0236","0771","920","346","574","43","963","1621","0","59.41","21.34"
"63","000","00","002","0237","0000","1632","652","980","55","1687","2842","0","59.36","22.94"
"63","000","00","002","0237","0772","855","343","512","24","879","1508","0","58.29","22.75"
"63","000","00","002","0237","0773","777","309","468","31","808","1334","0","60.57","23.16"
"63","000","00","002","0238","0000","2011","786","1225","84","2095","3662","0","57.21","21.46"
"63","000","00","002","0238","0774","562","205","357","32","594","1246","0","47.67","16.45"
"63","000","00","002","0238","0775","734","295","439","29","763","1196","0","63.8","24.67"
"63","000","00","002","0238","0776","715","286","429","23","738","1220","0","60.49","23.44"
"63","000","00","002","0239","0000","3336","1269","2067","186","3522","6210","0","56.71","20.43"
"63","000","00","002","0239","0777","839","311","528","25","864","1538","0","56.18","20.22"
"63","000","00","002","0239","0778","885","338","547","54","939","1565","0","60.0","21.6"
"63","000","00","002","0239","0779","818","313","505","62","880","1621","0","54.29","19.31"
"63","000","00","002","0239","0780","794","307","487","45","839","1486","0","56.46","20.66"
"63","000","00","002","0240","0000","2400","894","1506","123","2523","4310","0","58.54","20.74"
"63","000","00","002","0240","0781","785","306","479","33","818","1507","0","54.28","20.31"
"63","000","00","002","0240","0782","861","330","531","40","901","1516","0","59.43","21.77"
"63","000","00","002","0240","0783","754","258","496","50","804","1287","0","62.47","20.05"
"63","000","00","002","0241","0000","988","311","677","72","1060","1851","0","57.27","16.8"
"63","000","00","002","0241","0784","521","189","332","41","562","1050","0","53.52","18.0"
"63","000","00","002","0241","0785","467","122","345","31","498","801","0","62.17","15.23"
"63","000","00","003","0000","0000","140449","54598","85851","5548","145997","252645","308835","57.79","21.61"
"63","000","00","003","0301","0000","2673","994","1679","98","2771","4848","0","57.16","20.5"
"63","000","00","003","0301","1214","629","241","388","23","652","1184","0","55.07","20.35"
"63","000","00","003","0301","1215","629","222","407","31","660","1197","0","55.14","18.55"
"63","000","00","003","0301","1216","693","264","429","20","713","1221","0","58.39","21.62"
"63","000","00","003","0301","1217","722","267","455","24","746","1246","0","59.87","21.43"
"63","000","00","003","0302","0000","2482","1051","1431","115","2597","4386","0","59.21","23.96"
"63","000","00","003","0302","1218","849","362","487","29","878","1478","0","59.4","24.49"
"63","000","00","003","0302","1219","709","319","390","49","758","1314","0","57.69","24.28"
"63","000","00","003","0302","1220","924","370","554","37","961","1594","0","60.29","23.21"
"63","000","00","003","0303","0000","3349","1318","2031","109","3458","5767","0","59.96","22.85"
"63","000","00","003","0303","1221","829","340","489","28","857","1429","0","59.97","23.79"
"63","000","00","003","0303","1222","858","313","545","27","885","1452","0","60.95","21.56"
"63","000","00","003","0303","1223","882","377","505","22","904","1551","0","58.28","24.31"
"63","000","00","003","0303","1224","780","288","492","32","812","1335","0","60.82","21.57"
"63","000","00","003","0304","0000","3722","1480","2242","140","3862","6795","0","56.84","21.78"
"63","000","00","003","0304","1225","638","253","385","23","661","1196","0","55.27","21.15"
"63","000","00","003","0304","1226","710","283","427","24","734","1339","0","54.82","21.14"
"63","000","00","003","0304","1227","809","356","453","20","829","1448","0","57.25","24.59"
"63","000","00","003","0304","1228","768","286","482","28","796","1373","0","57.98","20.83"
"63","000","00","003","0304","1229","797","302","495","45","842","1439","0","58.51","20.99"
"63","000","00","003","0305","0000","2270","806","1464","90","2360","4461","0","52.9","18.07"
"63","000","00","003","0305","1230","624","249","375","12","636","1174","0","54.17","21.21"
"63","000","00","003","0305","1231","593","211","382","24","617","1144","0","53.93","18.44"
"63","000","00","003","0305","1232","572","165","407","29","601","1119","0","53.71","14.75"
"63","000","00","003","0305","1233","481","181","300","25","506","1024","0","49.41","17.68"
"63","000","00","003","0306","0000","2959","1072","1887","109","3068","5067","0","60.55","21.16"
"63","000","00","003","0306","1234","616","205","411","12","628","1032","0","60.85","19.86"
"63","000","00","003","0306","1235","763","224","539","28","791","1319","0","59.97","16.98"
"63","000","00","003","0306","1236","818","311","507","28","846","1369","0","61.8","22.72"
"63","000","00","003","0306","1237","762","332","430","41","803","1347","0","59.61","24.65"
"63","000","00","003","0307","0000","3078","1213","1865","94","3172","5988","0","52.97","20.26"
"63","000","00","003","0307","1238","844","361","483","24","868","1655","0","52.45","21.81"
"63","000","00","003","0307","1239","794","287","507","21","815","1595","0","51.1","17.99"
"63","000","00","003","0307","1240","758","296","462","28","786","1429","0","55.0","20.71"
"63","000","00","003","0307","1241","682","269","413","21","703","1309","0","53.71","20.55"
"63","000","00","003","0308","0000","1502","605","897","52","1554","2818","0","55.15","21.47"
"63","000","00","003","0308","1242","805","298","507","21","826","1508","0","54.77","19.76"
"63","000","00","003","0308","1243","697","307","390","31","728","1310","0","55.57","23.44"
"63","000","00","003","0309","0000","1880","748","1132","87","1967","3667","0","53.64","20.4"
"63","000","00","003","0309","1244","632","245","387","25","657","1233","0","53.28","19.87"
"63","000","00","003","0309","1245","662","272","390","33","695","1287","0","54.0","21.13"
"63","000","00","003","0309","1246","586","231","355","29","615","1147","0","53.62","20.14"
"63","000","00","003","0310","0000","3377","1293","2084","152","3529","6508","0","54.23","19.87"
"63","000","00","003","0310","1247","657","241","416","22","679","1260","0","53.89","19.13"
"63","000","00","003","0310","1248","727","257","470","31","758","1377","0","55.05","18.66"
"63","000","00","003","0310","1249","672","281","391","44","716","1284","0","55.76","21.88"
"63","000","00","003","0310","1250","671","256","415","27","698","1314","0","53.12","19.48"
"63","000","00","003","0310","1251","650","258","392","28","678","1273","0","53.26","20.27"
"63","000","00","003","0311","0000","2841","1174","1667","78","2919","4829","0","60.45","24.31"
"63","000","00","003","0311","1252","660","288","372","19","679","1146","0","59.25","25.13"
"63","000","00","003","0311","1253","748","294","454","18","766","1285","0","59.61","22.88"
"63","000","00","003","0311","1254","776","333","443","20","796","1297","0","61.37","25.67"
"63","000","00","003","0311","1255","657","259","398","21","678","1101","0","61.58","23.52"
"63","000","00","003","0312","0000","2277","935","1342","115","2392","4047","0","59.11","23.1"
"63","000","00","003","0312","1256","716","305","411","43","759","1310","0","57.94","23.28"
"63","000","00","003","0312","1257","798","320","478","44","842","1365","0","61.68","23.44"
"63","000","00","003","0312","1258","763","310","453","28","791","1372","0","57.65","22.59"
"63","000","00","003","0313","0000","2094","865","1229","92","2186","3596","0","60.79","24.05"
"63","000","00","003","0313","1259","704","294","410","27","731","1189","0","61.48","24.73"
"63","000","00","003","0313","1260","735","296","439","25","760","1256","0","60.51","23.57"
"63","000","00","003","0313","1261","655","275","380","40","695","1151","0","60.38","23.89"
"63","000","00","003","0314","0000","3657","1484","2173","116","3773","6129","0","61.56","24.21"
"63","000","00","003","0314","1262","907","365","542","27","934","1501","0","62.23","24.32"
"63","000","00","003","0314","1263","901","382","519","23","924","1520","0","60.79","25.13"
"63","000","00","003","0314","1264","922","354","568","36","958","1529","0","62.66","23.15"
"63","000","00","003","0314","1265","927","383","544","30","957","1579","0","60.61","24.26"
"63","000","00","003","0315","0000","3079","1239","1840","92","3171","6705","0","47.29","18.48"
"63","000","00","003","0315","1266","664","264","400","18","682","2619","0","26.04","10.08"
"63","000","00","003","0315","1267","733","283","450","23","756","1290","0","58.6","21.94"
"63","000","00","003","0315","1268","795","317","478","22","817","1307","0","62.51","24.25"
"63","000","00","003","0315","1269","887","375","512","29","916","1489","0","61.52","25.18"
"63","000","00","003","0316","0000","2822","1169","1653","84","2906","4884","0","59.5","23.94"
"63","000","00","003","0316","1270","657","268","389","28","685","1097","0","62.44","24.43"
"63","000","00","003","0316","1271","756","322","434","24","780","1328","0","58.73","24.25"
"63","000","00","003","0316","1272","671","277","394","17","688","1189","0","57.86","23.3"
"63","000","00","003","0316","1273","738","302","436","15","753","1270","0","59.29","23.78"
"63","000","00","003","0317","0000","2961","1232","1729","106","3067","5155","0","59.5","23.9"
"63","000","00","003","0317","1274","772","339","433","16","788","1349","0","58.41","25.13"
"63","000","00","003","0317","1275","709","295","414","24","733","1292","0","56.73","22.83"
"63","000","00","003","0317","1276","777","309","468","35","812","1314","0","61.8","23.52"
"63","000","00","003","0317","1277","703","289","414","31","734","1200","0","61.17","24.08"
"63","000","00","003","0318","0000","1734","684","1050","68","1802","3119","0","57.77","21.93"
"63","000","00","003","0318","1278","864","346","518","40","904","1558","0","58.02","22.21"
"63","000","00","003","0318","1279","870","338","532","28","898","1561","0","57.53","21.65"
"63","000","00","003","0319","0000","1692","658","1034","64","1756","2945","0","59.63","22.34"
"63","000","00","003","0319","1280","823","314","509","39","862","1446","0","59.61","21.72"
"63","000","00","003","0319","1281","869","344","525","25","894","1499","0","59.64","22.95"
"63","000","00","003","0320","0000","1666","614","1052","54","1720","2978","0","57.76","20.62"
"63","000","00","003","0320","1282","839","300","539","25","864","1467","0","58.9","20.45"
"63","000","00","003","0320","1283","827","314","513","29","856","1511","0","56.65","20.78"
"63","000","00","003","0321","0000","2725","1050","1675","102","2827","4640","0","60.93","22.63"
"63","000","00","003","0321","1284","921","353","568","44","965","1600","0","60.31","22.06"
"63","000","00","003","0321","1285","916","345","571","25","941","1573","0","59.82","21.93"
"63","000","00","003","0321","1286","888","352","536","33","921","1467","0","62.78","23.99"
"63","000","00","003","0322","0000","3322","1284","2038","118","3440","5891","0","58.39","21.8"
"63","000","00","003","0322","1287","772","282","490","34","806","1358","0","59.35","20.77"
"63","000","00","003","0322","1288","871","338","533","35","906","1568","0","57.78","21.56"
"63","000","00","003","0322","1289","816","333","483","33","849","1411","0","60.17","23.6"
"63","000","00","003","0322","1290","863","331","532","16","879","1554","0","56.56","21.3"
"63","000","00","003","0323","0000","3432","1269","2163","97","3529","5712","0","61.78","22.22"
"63","000","00","003","0323","1291","793","308","485","34","827","1345","0","61.49","22.9"
"63","000","00","003","0323","1292","828","332","496","14","842","1435","0","58.68","23.14"
"63","000","00","003","0323","1293","906","327","579","22","928","1481","0","62.66","22.08"
"63","000","00","003","0323","1294","905","302","603","27","932","1451","0","64.23","20.81"
"63","000","00","003","0326","0000","1767","679","1088","72","1839","3091","0","59.5","21.97"
"63","000","00","003","0326","1295","888","342","546","48","936","1566","0","59.77","21.84"
"63","000","00","003","0326","1296","879","337","542","24","903","1525","0","59.21","22.1"
"63","000","00","003","0327","0000","2296","876","1420","102","2398","4215","0","56.89","20.78"
"63","000","00","003","0327","1297","742","282","460","33","775","1336","0","58.01","21.11"
"63","000","00","003","0327","1298","842","309","533","47","889","1483","0","59.95","20.84"
"63","000","00","003","0327","1299","712","285","427","22","734","1396","0","52.58","20.42"
"63","000","00","003","0328","0000","3188","1252","1936","139","3327","5535","0","60.11","22.62"
"63","000","00","003","0328","1300","826","350","476","41","867","1406","0","61.66","24.89"
"63","000","00","003","0328","1301","838","327","511","27","865","1434","0","60.32","22.8"
"63","000","00","003","0328","1302","720","270","450","35","755","1288","0","58.62","20.96"
"63","000","00","003","0328","1303","804","305","499","36","840","1407","0","59.7","21.68"
"63","000","00","003","0329","0000","2368","872","1496","116","2484","4554","0","54.55","19.15"
"63","000","00","003","0329","1304","806","309","497","27","833","1514","0","55.02","20.41"
"63","000","00","003","0329","1305","726","261","465","50","776","1550","0","50.06","16.84"
"63","000","00","003","0329","1306","836","302","534","39","875","1490","0","58.72","20.27"
"63","000","00","003","0330","0000","2637","1036","1601","87","2724","4663","0","58.42","22.22"
"63","000","00","003","0330","1307","706","302","404","23","729","1284","0","56.78","23.52"
"63","000","00","003","0330","1308","664","251","413","19","683","1129","0","60.5","22.23"
"63","000","00","003","0330","1309","690","268","422","20","710","1193","0","59.51","22.46"
"63","000","00","003","0330","1310","577","215","362","25","602","1057","0","56.95","20.34"
"63","000","00","003","0331","0000","2835","1141","1694","170","3005","5453","0","55.11","20.92"
"63","000","00","003","0331","1311","751","319","432","32","783","1361","0","57.53","23.44"
"63","000","00","003","0331","1312","750","265","485","47","797","1412","0","56.44","18.77"
"63","000","00","003","0331","1313","666","285","381","22","688","1423","0","48.35","20.03"
"63","000","00","003","0331","1314","668","272","396","69","737","1257","0","58.63","21.64"
"63","000","00","003","0332","0000","2811","1060","1751","129","2940","4829","0","60.88","21.95"
"63","000","00","003","0332","1315","675","227","448","28","703","1133","0","62.05","20.04"
"63","000","00","003","0332","1316","604","249","355","27","631","1077","0","58.59","23.12"
"63","000","00","003","0332","1317","749","299","450","35","784","1300","0","60.31","23.0"
"63","000","00","003","0332","1318","783","285","498","39","822","1319","0","62.32","21.61"
"63","000","00","003","0333","0000","1988","735","1253","122","2110","3633","0","58.08","20.23"
"63","000","00","003","0333","1319","693","255","438","61","754","1265","0","59.6","20.16"
"63","000","00","003","0333","1320","656","235","421","32","688","1265","0","54.39","18.58"
"63","000","00","003","0333","1321","639","245","394","29","668","1103","0","60.56","22.21"
"63","000","00","003","0334","0000","2294","877","1417","94","2388","3958","0","60.33","22.16"
"63","000","00","003","0334","1322","784","312","472","26","810","1341","0","60.4","23.27"
"63","000","00","003","0334","1323","791","281","510","36","827","1357","0","60.94","20.71"
"63","000","00","003","0334","1324","719","284","435","32","751","1260","0","59.6","22.54"
"63","000","00","003","0335","0000","2108","863","1245","84","2192","3844","0","57.02","22.45"
"63","000","00","003","0335","1325","742","315","427","31","773","1295","0","59.69","24.32"
"63","000","00","003","0335","1326","731","302","429","23","754","1399","0","53.9","21.59"
"63","000","00","003","0335","1327","635","246","389","30","665","1150","0","57.83","21.39"
"63","000","00","003","0336","0000","2784","1050","1734","111","2895","5149","0","56.22","20.39"
"63","000","00","003","0336","1328","694","278","416","17","711","1351","0","52.63","20.58"
"63","000","00","003","0336","1329","755","313","442","39","794","1341","0","59.21","23.34"
"63","000","00","003","0336","1330","612","207","405","16","628","1129","0","55.62","18.33"
"63","000","00","003","0336","1331","723","252","471","39","762","1328","0","57.38","18.98"
"63","000","00","003","0337","0000","3467","1209","2258","106","3573","6080","0","58.77","19.88"
"63","000","00","003","0337","1332","962","307","655","28","990","1557","0","63.58","19.72"
"63","000","00","003","0337","1333","894","322","572","32","926","1461","0","63.38","22.04"
"63","000","00","003","0337","1334","800","300","500","25","825","1589","0","51.92","18.88"
"63","000","00","003","0337","1335","811","280","531","21","832","1473","0","56.48","19.01"
"63","000","00","003","0338","0000","1836","697","1139","97","1933","3311","0","58.38","21.05"
"63","000","00","003","0338","1336","799","329","470","38","837","1479","0","56.59","22.24"
"63","000","00","003","0338","1337","494","163","331","30","524","833","0","62.91","19.57"
"63","000","00","003","0338","1338","543","205","338","29","572","999","0","57.26","20.52"
"63","000","00","003","0339","0000","1018","389","629","31","1049","1757","0","59.7","22.14"
"63","000","00","003","0339","1339","1018","389","629","31","1049","1757","0","59.7","22.14"
"63","000","00","003","0340","0000","4498","1797","2701","175","4673","7674","0","60.89","23.42"
"63","000","00","003","0340","1340","909","320","589","36","945","1573","0","60.08","20.34"
"63","000","00","003","0340","1341","947","375","572","35","982","1587","0","61.88","23.63"
"63","000","00","003","0340","1342","878","348","530","36","914","1496","0","61.1","23.26"
"63","000","00","003","0340","1343","841","384","457","28","869","1440","0","60.35","26.67"
"63","000","00","003","0340","1344","923","370","553","40","963","1578","0","61.03","23.45"
"63","000","00","003","0341","0000","2121","904","1217","48","2169","3594","0","60.35","25.15"
"63","000","00","003","0341","1345","714","301","413","15","729","1223","0","59.61","24.61"
"63","000","00","003","0341","1346","650","296","354","18","668","1119","0","59.7","26.45"
"63","000","00","003","0341","1347","757","307","450","15","772","1252","0","61.66","24.52"
"63","000","00","003","0343","0000","4024","1545","2479","141","4165","7232","0","57.59","21.36"
"63","000","00","003","0343","1348","913","377","536","34","947","1576","0","60.09","23.92"
"63","000","00","003","0343","1349","796","307","489","29","825","1425","0","57.89","21.54"
"63","000","00","003","0343","1350","781","317","464","17","798","1450","0","55.03","21.86"
"63","000","00","003","0343","1351","716","200","516","31","747","1444","0","51.73","13.85"
"63","000","00","003","0343","1352","818","344","474","30","848","1337","0","63.43","25.73"
"63","000","00","003","0344","0000","2875","1083","1792","124","2999","5100","0","58.8","21.24"
"63","000","00","003","0344","1353","778","299","479","20","798","1417","0","56.32","21.1"
"63","000","00","003","0344","1354","690","258","432","41","731","1250","0","58.48","20.64"
"63","000","00","003","0344","1355","657","252","405","27","684","1176","0","58.16","21.43"
"63","000","00","003","0344","1356","750","274","476","36","786","1257","0","62.53","21.8"
"63","000","00","003","0346","0000","2703","1044","1659","125","2828","4851","0","58.3","21.52"
"63","000","00","003","0346","1357","694","246","448","39","733","1257","0","58.31","19.57"
"63","000","00","003","0346","1358","657","267","390","28","685","1148","0","59.67","23.26"
"63","000","00","003","0346","1359","781","305","476","35","816","1418","0","57.55","21.51"
"63","000","00","003","0346","1360","571","226","345","23","594","1028","0","57.78","21.98"
"63","000","00","003","0347","0000","3872","1532","2340","161","4033","6796","0","59.34","22.54"
"63","000","00","003","0347","1361","840","356","484","29","869","1445","0","60.14","24.64"
"63","000","00","003","0347","1362","779","321","458","36","815","1361","0","59.88","23.59"
"63","000","00","003","0347","1363","795","268","527","33","828","1343","0","61.65","19.96"
"63","000","00","003","0347","1364","717","287","430","39","756","1267","0","59.67","22.65"
"63","000","00","003","0347","1365","741","300","441","24","765","1380","0","55.43","21.74"
"63","000","00","003","0348","0000","2332","866","1466","114","2446","4312","0","56.73","20.08"
"63","000","00","003","0348","1366","830","307","523","37","867","1524","0","56.89","20.14"
"63","000","00","003","0348","1367","850","319","531","29","879","1470","0","59.8","21.7"
"63","000","00","003","0348","1368","652","240","412","48","700","1318","0","53.11","18.21"
"63","000","00","003","0349","0000","2264","867","1397","92","2356","4254","0","55.38","20.38"
"63","000","00","003","0349","1369","746","297","449","33","779","1430","0","54.48","20.77"
"63","000","00","003","0349","1370","768","292","476","34","802","1386","0","57.86","21.07"
"63","000","00","003","0349","1371","750","278","472","25","775","1438","0","53.89","19.33"
"63","000","00","003","0350","0000","2813","1082","1731","119","2932","5267","0","55.67","20.54"
"63","000","00","003","0350","1372","648","236","412","22","670","1270","0","52.76","18.58"
"63","000","00","003","0350","1373","741","290","451","40","781","1395","0","55.99","20.79"
"63","000","00","003","0350","1374","722","253","469","23","745","1292","0","57.66","19.58"
"63","000","00","003","0350","1375","702","303","399","34","736","1310","0","56.18","23.13"
"63","000","00","003","0351","0000","2917","1122","1795","102","3019","5321","0","56.74","21.09"
"63","000","00","003","0351","1376","726","270","456","32","758","1319","0","57.47","20.47"
"63","000","00","003","0351","1377","764","309","455","25","789","1355","0","58.23","22.8"
"63","000","00","003","0351","1378","693","261","432","18","711","1312","0","54.19","19.89"
"63","000","00","003","0351","1379","734","282","452","27","761","1335","0","57.0","21.12"
"63","000","00","003","0352","0000","2194","838","1356","74","2268","4124","0","55.0","20.32"
"63","000","00","003","0352","1380","767","296","471","29","796","1489","0","53.46","19.88"
"63","000","00","003","0352","1381","746","291","455","24","770","1307","0","58.91","22.26"
"63","000","00","003","0352","1382","681","251","430","21","702","1328","0","52.86","18.9"
"63","000","00","003","0353","0000","2875","1158","1717","109","2984","5169","0","57.73","22.4"
"63","000","00","003","0353","1383","687","269","418","7","694","1277","0","54.35","21.06"
"63","000","00","003","0353","1384","729","296","433","32","761","1314","0","57.91","22.53"
"63","000","00","003","0353","1385","737","291","446","31","768","1270","0","60.47","22.91"
"63","000","00","003","0353","1386","722","302","420","39","761","1308","0","58.18","23.09"
"63","000","00","003","0354","0000","2039","815","1224","81","2120","3647","0","58.13","22.35"
"63","000","00","003","0354","1387","667","272","395","20","687","1138","0","60.37","23.9"
"63","000","00","003","0354","1388","714","268","446","31","745","1333","0","55.89","20.11"
"63","000","00","003","0354","1389","658","275","383","30","688","1176","0","58.5","23.38"
"63","000","00","003","0355","0000","2965","1075","1890","133","3098","5436","0","56.99","19.78"
"63","000","00","003","0355","1390","718","275","443","40","758","1311","0","57.82","20.98"
"63","000","00","003","0355","1391","702","227","475","20","722","1295","0","55.75","17.53"
"63","000","00","003","0355","1392","794","289","505","41","835","1421","0","58.76","20.34"
"63","000","00","003","0355","1393","751","284","467","32","783","1409","0","55.57","20.16"
"63","000","00","003","0356","0000","3682","1426","2256","158","3840","6534","0","58.77","21.82"
"63","000","00","003","0356","1394","807","301","506","34","841","1434","0","58.65","20.99"
"63","000","00","003","0356","1395","723","285","438","59","782","1449","0","53.97","19.67"
"63","000","00","003","0356","1396","736","298","438","24","760","1284","0","59.19","23.21"
"63","000","00","003","0356","1397","698","269","429","19","717","1248","0","57.45","21.55"
"63","000","00","003","0356","1398","718","273","445","22","740","1119","0","66.13","24.4"
"63","000","00","003","0357","0000","1284","471","813","100","1384","2327","0","59.48","20.24"
"63","000","00","003","0357","1399","511","196","315","27","538","883","0","60.93","22.2"
"63","000","00","003","0357","1400","323","92","231","39","362","630","0","57.46","14.6"
"63","000","00","003","0357","1401","450","183","267","34","484","814","0","59.46","22.48"
"63","000","00","004","0000","0000","106596","42578","64018","5211","111807","195148","229680","57.29","21.82"
"63","000","00","004","0401","0000","1671","648","1023","59","1730","2854","0","60.62","22.7"
"63","000","00","004","0401","0786","852","351","501","33","885","1522","0","58.15","23.06"
"63","000","00","004","0401","0787","819","297","522","26","845","1332","0","63.44","22.3"
"63","000","00","004","0402","0000","2326","972","1354","111","2437","4755","0","51.25","20.44"
"63","000","00","004","0402","0788","798","341","457","40","838","1656","0","50.6","20.59"
"63","000","00","004","0402","0789","674","280","394","35","709","1367","0","51.87","20.48"
"63","000","00","004","0402","0790","854","351","503","36","890","1732","0","51.39","20.27"
"63","000","00","004","0403","0000","1742","714","1028","89","1831","3284","0","55.76","21.74"
"63","000","00","004","0403","0791","892","359","533","44","936","1634","0","57.28","21.97"
"63","000","00","004","0403","0792","850","355","495","45","895","1650","0","54.24","21.52"
"63","000","00","004","0404","0000","2338","969","1369","103","2441","4046","0","60.33","23.95"
"63","000","00","004","0404","0793","791","312","479","33","824","1392","0","59.2","22.41"
"63","000","00","004","0404","0794","701","300","401","29","730","1177","0","62.02","25.49"
"63","000","00","004","0404","0795","846","357","489","41","887","1477","0","60.05","24.17"
"63","000","00","004","0405","0000","1230","477","753","70","1300","2359","0","55.11","20.22"
"63","000","00","004","0405","0796","542","234","308","39","581","1063","0","54.66","22.01"
"63","000","00","004","0405","0797","688","243","445","31","719","1296","0","55.48","18.75"
"63","000","00","004","0406","0000","3070","1251","1819","161","3231","6065","0","53.27","20.63"
"63","000","00","004","0406","0798","680","271","409","35","715","1330","0","53.76","20.38"
"63","000","00","004","0406","0799","755","290","465","49","804","1483","0","54.21","19.55"
"63","000","00","004","0406","0800","795","342","453","27","822","1542","0","53.31","22.18"
"63","000","00","004","0406","0801","840","348","492","50","890","1710","0","52.05","20.35"
"63","000","00","004","0407","0000","1958","723","1235","110","2068","3822","0","54.11","18.92"
"63","000","00","004","0407","0802","666","261","405","22","688","1315","0","52.32","19.85"
"63","000","00","004","0407","0803","651","246","405","50","701","1245","0","56.31","19.76"
"63","000","00","004","0407","0804","641","216","425","38","679","1262","0","53.8","17.12"
"63","000","00","004","0408","0000","3333","1378","1955","181","3514","6149","0","57.15","22.41"
"63","000","00","004","0408","0805","832","352","480","53","885","1518","0","58.3","23.19"
"63","000","00","004","0408","0806","824","325","499","56","880","1522","0","57.82","21.35"
"63","000","00","004","0408","0807","789","311","478","42","831","1580","0","52.59","19.68"
"63","000","00","004","0408","0808","888","390","498","30","918","1529","0","60.04","25.51"
"63","000","00","004","0409","0000","1906","787","1119","87","1993","3581","0","55.65","21.98"
"63","000","00","004","0409","0809","654","279","375","34","688","1221","0","56.35","22.85"
"63","000","00","004","0409","0810","703","291","412","26","729","1221","0","59.71","23.83"
"63","000","00","004","0409","0811","549","217","332","27","576","1139","0","50.57","19.05"
"63","000","00","004","0410","0000","2244","901","1343","113","2357","4306","0","54.74","20.92"
"63","000","00","004","0410","0812","745","284","461","59","804","1407","0","57.14","20.18"
"63","000","00","004","0410","0813","728","322","406","30","758","1321","0","57.38","24.38"
"63","000","00","004","0410","0814","771","295","476","24","795","1578","0","50.38","18.69"
"63","000","00","004","0411","0000","2462","964","1498","127","2589","4917","0","52.65","19.61"
"63","000","00","004","0411","0815","849","312","537","40","889","1739","0","51.12","17.94"
"63","000","00","004","0411","0816","821","325","496","38","859","1637","0","52.47","19.85"
"63","000","00","004","0411","0817","792","327","465","49","841","1541","0","54.57","21.22"
"63","000","00","004","0412","0000","1998","824","1174","110","2108","3765","0","55.99","21.89"
"63","000","00","004","0412","0818","684","269","415","36","720","1210","0","59.5","22.23"
"63","000","00","004","0412","0819","704","299","405","33","737","1331","0","55.37","22.46"
"63","000","00","004","0412","0820","610","256","354","41","651","1224","0","53.19","20.92"
"63","000","00","004","0413","0000","1797","525","1272","76","1873","3209","0","58.37","16.36"
"63","000","00","004","0413","0824","990","287","703","53","1043","1805","0","57.78","15.9"
"63","000","00","004","0413","0825","807","238","569","23","830","1404","0","59.12","16.95"
"63","000","00","004","0414","0000","4526","1775","2751","228","4754","7819","0","60.8","22.7"
"63","000","00","004","0414","0826","1023","432","591","39","1062","1708","0","62.18","25.29"
"63","000","00","004","0414","0827","878","360","518","37","915","1451","0","63.06","24.81"
"63","000","00","004","0414","0828","984","380","604","59","1043","1684","0","61.94","22.57"
"63","000","00","004","0414","0829","873","306","567","20","893","1585","0","56.34","19.31"
"63","000","00","004","0414","0830","768","297","471","73","841","1391","0","60.46","21.35"
"63","000","00","004","0415","0000","3278","1290","1988","107","3385","5575","0","60.72","23.14"
"63","000","00","004","0415","0831","867","328","539","49","916","1375","0","66.62","23.85"
"63","000","00","004","0415","0832","885","359","526","16","901","1472","0","61.21","24.39"
"63","000","00","004","0415","0833","717","282","435","22","739","1327","0","55.69","21.25"
"63","000","00","004","0415","0834","809","321","488","20","829","1401","0","59.17","22.91"
"63","000","00","004","0416","0000","4522","1948","2574","148","4670","7980","0","58.52","24.41"
"63","000","00","004","0416","0835","812","301","511","34","846","1423","0","59.45","21.15"
"63","000","00","004","0416","0836","904","367","537","25","929","1569","0","59.21","23.39"
"63","000","00","004","0416","0837","918","361","557","19","937","1651","0","56.75","21.87"
"63","000","00","004","0416","0838","881","487","394","26","907","1624","0","55.85","29.99"
"63","000","00","004","0416","0839","1007","432","575","44","1051","1713","0","61.35","25.22"
"63","000","00","004","0417","0000","507","117","390","36","543","944","0","57.52","12.39"
"63","000","00","004","0417","0862","507","117","390","36","543","944","0","57.52","12.39"
"63","000","00","004","0418","0000","2531","1014","1517","147","2678","4693","0","57.06","21.61"
"63","000","00","004","0418","0846","785","322","463","44","829","1472","0","56.32","21.88"
"63","000","00","004","0418","0847","768","335","433","53","821","1517","0","54.12","22.08"
"63","000","00","004","0418","0848","978","357","621","50","1028","1704","0","60.33","20.95"
"63","000","00","004","0419","0000","2549","961","1588","140","2689","4476","0","60.08","21.47"
"63","000","00","004","0419","0821","868","312","556","43","911","1585","0","57.48","19.68"
"63","000","00","004","0419","0822","889","336","553","61","950","1523","0","62.38","22.06"
"63","000","00","004","0419","0823","792","313","479","36","828","1368","0","60.53","22.88"
"63","000","00","004","0420","0000","2477","1001","1476","171","2648","4535","0","58.39","22.07"
"63","000","00","004","0420","0849","903","380","523","41","944","1603","0","58.89","23.71"
"63","000","00","004","0420","0850","731","272","459","64","795","1432","0","55.52","18.99"
"63","000","00","004","0420","0851","843","349","494","66","909","1500","0","60.6","23.27"
"63","000","00","004","0421","0000","3224","1266","1958","145","3369","5635","0","59.79","22.47"
"63","000","00","004","0421","0852","780","302","478","33","813","1332","0","61.04","22.67"
"63","000","00","004","0421","0853","846","330","516","44","890","1450","0","61.38","22.76"
"63","000","00","004","0421","0854","841","358","483","35","876","1434","0","61.09","24.97"
"63","000","00","004","0421","0855","757","276","481","33","790","1419","0","55.67","19.45"
"63","000","00","004","0422","0000","2253","935","1318","110","2363","4400","0","53.7","21.25"
"63","000","00","004","0422","0856","701","278","423","31","732","1292","0","56.66","21.52"
"63","000","00","004","0422","0857","810","344","466","39","849","1526","0","55.64","22.54"
"63","000","00","004","0422","0858","742","313","429","40","782","1582","0","49.43","19.79"
"63","000","00","004","0423","0000","2339","949","1390","148","2487","4584","0","54.25","20.7"
"63","000","00","004","0423","0859","788","333","455","44","832","1588","0","52.39","20.97"
"63","000","00","004","0423","0860","796","290","506","59","855","1463","0","58.44","19.82"
"63","000","00","004","0423","0861","755","326","429","45","800","1533","0","52.19","21.27"
"63","000","00","004","0424","0000","2624","1075","1549","122","2746","6843","0","40.13","15.71"
"63","000","00","004","0424","0863","1037","394","643","50","1087","1745","0","62.29","22.58"
"63","000","00","004","0424","0864","808","355","453","37","845","1679","0","50.33","21.14"
"63","000","00","004","0424","0865","779","326","453","35","814","3419","0","23.81","9.53"
"63","000","00","004","0425","0000","3981","1629","2352","244","4225","7203","0","58.66","22.62"
"63","000","00","004","0425","0866","786","337","449","50","836","1387","0","60.27","24.3"
"63","000","00","004","0425","0867","976","380","596","49","1025","1672","0","61.3","22.73"
"63","000","00","004","0425","0868","727","290","437","48","775","1319","0","58.76","21.99"
"63","000","00","004","0425","0869","726","292","434","46","772","1364","0","56.6","21.41"
"63","000","00","004","0425","0870","766","330","436","51","817","1461","0","55.92","22.59"
"63","000","00","004","0426","0000","1990","830","1160","118","2108","3654","0","57.69","22.71"
"63","000","00","004","0426","0871","656","274","382","38","694","1173","0","59.16","23.36"
"63","000","00","004","0426","0872","618","252","366","41","659","1171","0","56.28","21.52"
"63","000","00","004","0426","0873","716","304","412","39","755","1310","0","57.63","23.21"
"63","000","00","004","0427","0000","3899","1577","2322","160","4059","6655","0","60.99","23.7"
"63","000","00","004","0427","0874","802","311","491","31","833","1373","0","60.67","22.65"
"63","000","00","004","0427","0875","771","289","482","26","797","1290","0","61.78","22.4"
"63","000","00","004","0427","0876","792","323","469","38","830","1346","0","61.66","24.0"
"63","000","00","004","0427","0877","850","380","470","43","893","1468","0","60.83","25.89"
"63","000","00","004","0427","0878","684","274","410","22","706","1178","0","59.93","23.26"
"63","000","00","004","0428","0000","3398","1372","2026","157","3555","6102","0","58.26","22.48"
"63","000","00","004","0428","0879","952","386","566","37","989","1654","0","59.79","23.34"
"63","000","00","004","0428","0880","818","336","482","43","861","1464","0","58.81","22.95"
"63","000","00","004","0428","0881","783","310","473","37","820","1450","0","56.55","21.38"
"63","000","00","004","0428","0882","845","340","505","40","885","1534","0","57.69","22.16"
"63","000","00","004","0429","0000","3672","1487","2185","200","3872","6660","0","58.14","22.33"
"63","000","00","004","0429","0883","941","381","560","33","974","1703","0","57.19","22.37"
"63","000","00","004","0429","0884","895","354","541","60","955","1610","0","59.32","21.99"
"63","000","00","004","0429","0885","863","345","518","51","914","1653","0","55.29","20.87"
"63","000","00","004","0429","0886","973","407","566","56","1029","1694","0","60.74","24.03"
"63","000","00","004","0430","0000","2615","1098","1517","124","2739","4824","0","56.78","22.76"
"63","000","00","004","0430","0887","863","361","502","37","900","1623","0","55.45","22.24"
"63","000","00","004","0430","0888","897","387","510","46","943","1618","0","58.28","23.92"
"63","000","00","004","0430","0889","855","350","505","41","896","1583","0","56.6","22.11"
"63","000","00","004","0431","0000","2708","1163","1545","154","2862","4529","0","63.19","25.68"
"63","000","00","004","0431","0890","921","408","513","49","970","1605","0","60.44","25.42"
"63","000","00","004","0431","0891","834","365","469","50","884","1398","0","63.23","26.11"
"63","000","00","004","0431","0892","953","390","563","55","1008","1526","0","66.06","25.56"
"63","000","00","004","0432","0000","2600","1065","1535","143","2743","4739","0","57.88","22.47"
"63","000","00","004","0432","0893","868","357","511","47","915","1555","0","58.84","22.96"
"63","000","00","004","0432","0894","858","335","523","34","892","1597","0","55.85","20.98"
"63","000","00","004","0432","0895","874","373","501","62","936","1587","0","58.98","23.5"
"63","000","00","004","0433","0000","1825","753","1072","89","1914","3133","0","61.09","24.03"
"63","000","00","004","0433","0896","922","385","537","42","964","1587","0","60.74","24.26"
"63","000","00","004","0433","0897","903","368","535","47","950","1546","0","61.45","23.8"
"63","000","00","004","0434","0000","2808","1062","1746","132","2940","5094","0","57.71","20.85"
"63","000","00","004","0434","0898","721","255","466","40","761","1322","0","57.56","19.29"
"63","000","00","004","0434","0899","713","288","425","28","741","1267","0","58.48","22.73"
"63","000","00","004","0434","0900","666","267","399","22","688","1210","0","56.86","22.07"
"63","000","00","004","0434","0901","708","252","456","42","750","1295","0","57.92","19.46"
"63","000","00","004","0435","0000","2683","918","1765","122","2805","4474","0","62.7","20.52"
"63","000","00","004","0435","0902","839","322","517","47","886","1467","0","60.4","21.95"
"63","000","00","004","0435","0903","895","272","623","33","928","1491","0","62.24","18.24"
"63","000","00","004","0435","0904","949","324","625","42","991","1516","0","65.37","21.37"
"63","000","00","004","0436","0000","2196","936","1260","97","2293","4035","0","56.83","23.2"
"63","000","00","004","0436","0905","725","306","419","27","752","1384","0","54.34","22.11"
"63","000","00","004","0436","0906","684","308","376","44","728","1138","0","63.97","27.07"
"63","000","00","004","0436","0907","787","322","465","26","813","1513","0","53.73","21.28"
"63","000","00","004","0437","0000","1714","680","1034","104","1818","2988","0","60.84","22.76"
"63","000","00","004","0437","0908","879","358","521","48","927","1559","0","59.46","22.96"
"63","000","00","004","0437","0909","835","322","513","56","891","1429","0","62.35","22.53"
"63","000","00","004","0438","0000","1474","582","892","68","1542","2459","0","62.71","23.67"
"63","000","00","004","0438","0910","745","308","437","26","771","1245","0","61.93","24.74"
"63","000","00","004","0438","0911","729","274","455","42","771","1214","0","63.51","22.57"
"63","000","00","004","0439","0000","2968","1187","1781","108","3076","5339","0","57.61","22.23"
"63","000","00","004","0439","0912","807","332","475","25","832","1394","0","59.68","23.82"
"63","000","00","004","0439","0913","703","272","431","14","717","1336","0","53.67","20.36"
"63","000","00","004","0439","0914","675","287","388","32","707","1227","0","57.62","23.39"
"63","000","00","004","0439","0915","783","296","487","37","820","1382","0","59.33","21.42"
"63","000","00","004","0440","0000","2197","865","1332","106","2303","4100","0","56.17","21.1"
"63","000","00","004","0440","0916","785","287","498","43","828","1436","0","57.66","19.99"
"63","000","00","004","0440","0917","701","303","398","38","739","1405","0","52.6","21.57"
"63","000","00","004","0440","0918","711","275","436","25","736","1259","0","58.46","21.84"
"63","000","00","004","0441","0000","3604","1436","2168","136","3740","6297","0","59.39","22.8"
"63","000","00","004","0441","0840","949","366","583","41","990","1647","0","60.11","22.22"
"63","000","00","004","0441","0841","928","363","565","30","958","1762","0","54.37","20.6"
"63","000","00","004","0441","0842","832","370","462","33","865","1399","0","61.83","26.45"
"63","000","00","004","0441","0843","895","337","558","32","927","1489","0","62.26","22.63"
"63","000","00","004","0442","0000","1359","474","885","50","1409","2267","0","62.15","20.91"
"63","000","00","004","0442","0844","763","286","477","23","786","1269","0","61.94","22.54"
"63","000","00","004","0442","0845","596","188","408","27","623","998","0","62.42","18.84"
"63","000","00","005","0000","0000","72020","27634","44386","3023","75043","128292","159026","58.49","21.54"
"63","000","00","005","0501","0000","1456","582","874","67","1523","2625","0","58.02","22.17"
"63","000","00","005","0501","1001","755","302","453","28","783","1308","0","59.86","23.09"
"63","000","00","005","0501","1002","701","280","421","39","740","1317","0","56.19","21.26"
"63","000","00","005","0502","0000","1237","444","793","62","1299","2197","0","59.13","20.21"
"63","000","00","005","0502","1003","632","223","409","32","664","1069","0","62.11","20.86"
"63","000","00","005","0502","1004","605","221","384","30","635","1128","0","56.29","19.59"
"63","000","00","005","0503","0000","1125","480","645","45","1170","2101","0","55.69","22.85"
"63","000","00","005","0503","1005","613","247","366","35","648","1053","0","61.54","23.46"
"63","000","00","005","0503","1006","512","233","279","10","522","1048","0","49.81","22.23"
"63","000","00","005","0504","0000","2341","853","1488","94","2435","3990","0","61.03","21.38"
"63","000","00","005","0504","1007","694","241","453","40","734","1297","0","56.59","18.58"
"63","000","00","005","0504","1008","702","258","444","21","723","1193","0","60.6","21.63"
"63","000","00","005","0504","1009","945","354","591","33","978","1500","0","65.2","23.6"
"63","000","00","005","0505","0000","2229","912","1317","88","2317","4079","0","56.8","22.36"
"63","000","00","005","0505","1010","730","288","442","30","760","1346","0","56.46","21.4"
"63","000","00","005","0505","1011","704","275","429","25","729","1283","0","56.82","21.43"
"63","000","00","005","0505","1012","795","349","446","33","828","1450","0","57.1","24.07"
"63","000","00","005","0506","0000","3150","1264","1886","128","3278","5329","0","61.51","23.72"
"63","000","00","005","0506","1013","819","341","478","36","855","1433","0","59.67","23.8"
"63","000","00","005","0506","1014","825","350","475","36","861","1309","0","65.78","26.74"
"63","000","00","005","0506","1015","820","308","512","12","832","1386","0","60.03","22.22"
"63","000","00","005","0506","1016","686","265","421","44","730","1201","0","60.78","22.06"
"63","000","00","005","0507","0000","3044","1201","1843","131","3175","5107","0","62.17","23.52"
"63","000","00","005","0507","1017","791","313","478","34","825","1336","0","61.75","23.43"
"63","000","00","005","0507","1018","799","325","474","36","835","1358","0","61.49","23.93"
"63","000","00","005","0507","1019","686","267","419","33","719","1177","0","61.09","22.68"
"63","000","00","005","0507","1020","768","296","472","28","796","1236","0","64.4","23.95"
"63","000","00","005","0508","0000","1659","628","1031","74","1733","2952","0","58.71","21.27"
"63","000","00","005","0508","1021","819","302","517","42","861","1478","0","58.25","20.43"
"63","000","00","005","0508","1022","840","326","514","32","872","1474","0","59.16","22.12"
"63","000","00","005","0509","0000","2795","1058","1737","140","2935","4914","0","59.73","21.53"
"63","000","00","005","0509","1023","661","262","399","32","693","1172","0","59.13","22.35"
"63","000","00","005","0509","1024","730","282","448","41","771","1310","0","58.85","21.53"
"63","000","00","005","0509","1025","735","268","467","31","766","1263","0","60.65","21.22"
"63","000","00","005","0509","1026","669","246","423","36","705","1169","0","60.31","21.04"
"63","000","00","005","0510","0000","2208","805","1403","85","2293","3916","0","58.55","20.56"
"63","000","00","005","0510","1027","799","299","500","22","821","1391","0","59.02","21.5"
"63","000","00","005","0510","1028","660","236","424","22","682","1201","0","56.79","19.65"
"63","000","00","005","0510","1029","749","270","479","41","790","1324","0","59.67","20.39"
"63","000","00","005","0511","0000","2933","1182","1751","173","3106","5279","0","58.84","22.39"
"63","000","00","005","0511","1030","645","238","407","47","692","1216","0","56.91","19.57"
"63","000","00","005","0511","1031","651","269","382","35","686","1183","0","57.99","22.74"
"63","000","00","005","0511","1032","842","339","503","55","897","1469","0","61.06","23.08"
"63","000","00","005","0511","1033","795","336","459","36","831","1411","0","58.89","23.81"
"63","000","00","005","0512","0000","2425","938","1487","181","2606","4497","0","57.95","20.86"
"63","000","00","005","0512","1034","778","312","466","67","845","1398","0","60.44","22.32"
"63","000","00","005","0512","1035","783","289","494","64","847","1479","0","57.27","19.54"
"63","000","00","005","0512","1036","864","337","527","50","914","1620","0","56.42","20.8"
"63","000","00","005","0513","0000","1866","724","1142","62","1928","3160","0","61.01","22.91"
"63","000","00","005","0513","1037","595","228","367","16","611","1041","0","58.69","21.9"
"63","000","00","005","0513","1038","598","246","352","17","615","1056","0","58.24","23.3"
"63","000","00","005","0513","1039","673","250","423","29","702","1063","0","66.04","23.52"
"63","000","00","005","0514","0000","2817","1007","1810","180","2997","5865","0","51.1","17.17"
"63","000","00","005","0514","1040","716","266","450","43","759","1591","0","47.71","16.72"
"63","000","00","005","0514","1041","656","225","431","48","704","1502","0","46.87","14.98"
"63","000","00","005","0514","1042","675","241","434","41","716","1331","0","53.79","18.11"
"63","000","00","005","0514","1043","770","275","495","48","818","1441","0","56.77","19.08"
"63","000","00","005","0515","0000","2109","780","1329","71","2180","3562","0","61.2","21.9"
"63","000","00","005","0515","1044","771","315","456","23","794","1273","0","62.37","24.74"
"63","000","00","005","0515","1045","672","250","422","25","697","1133","0","61.52","22.07"
"63","000","00","005","0515","1046","666","215","451","23","689","1156","0","59.6","18.6"
"63","000","00","005","0516","0000","1498","570","928","87","1585","2643","0","59.97","21.57"
"63","000","00","005","0516","1047","760","300","460","42","802","1377","0","58.24","21.79"
"63","000","00","005","0516","1048","738","270","468","45","783","1266","0","61.85","21.33"
"63","000","00","005","0517","0000","1335","522","813","63","1398","2235","0","62.55","23.36"
"63","000","00","005","0517","1049","681","244","437","33","714","1111","0","64.27","21.96"
"63","000","00","005","0517","1050","654","278","376","30","684","1124","0","60.85","24.73"
"63","000","00","005","0518","0000","1641","621","1020","47","1688","2724","0","61.97","22.8"
"63","000","00","005","0518","1051","826","319","507","24","850","1373","0","61.91","23.23"
"63","000","00","005","0518","1052","815","302","513","23","838","1351","0","62.03","22.35"
"63","000","00","005","0519","0000","4973","1876","3097","153","5126","8679","0","59.06","21.62"
"63","000","00","005","0519","1053","867","334","533","23","890","1495","0","59.53","22.34"
"63","000","00","005","0519","1054","884","352","532","32","916","1436","0","63.79","24.51"
"63","000","00","005","0519","1055","858","331","527","15","873","1516","0","57.59","21.83"
"63","000","00","005","0519","1056","776","286","490","31","807","1374","0","58.73","20.82"
"63","000","00","005","0519","1057","812","279","533","27","839","1522","0","55.12","18.33"
"63","000","00","005","0519","1058","776","294","482","25","801","1336","0","59.96","22.01"
"63","000","00","005","0520","0000","2635","1023","1612","115","2750","4648","0","59.17","22.01"
"63","000","00","005","0520","1059","885","343","542","33","918","1551","0","59.19","22.11"
"63","000","00","005","0520","1060","911","355","556","46","957","1594","0","60.04","22.27"
"63","000","00","005","0520","1061","839","325","514","36","875","1503","0","58.22","21.62"
"63","000","00","005","0521","0000","4246","1495","2751","122","4368","7237","0","60.36","20.66"
"63","000","00","005","0521","1062","847","295","552","20","867","1455","0","59.59","20.27"
"63","000","00","005","0521","1063","856","304","552","12","868","1439","0","60.32","21.13"
"63","000","00","005","0521","1064","835","309","526","36","871","1469","0","59.29","21.03"
"63","000","00","005","0521","1065","840","259","581","33","873","1430","0","61.05","18.11"
"63","000","00","005","0521","1066","868","328","540","21","889","1444","0","61.57","22.71"
"63","000","00","005","0522","0000","723","267","456","10","733","1254","0","58.45","21.29"
"63","000","00","005","0522","1067","723","267","456","10","733","1254","0","58.45","21.29"
"63","000","00","005","0523","0000","1844","716","1128","97","1941","3213","0","60.41","22.28"
"63","000","00","005","0523","1068","534","200","334","40","574","932","0","61.59","21.46"
"63","000","00","005","0523","1069","612","256","356","33","645","1055","0","61.14","24.27"
"63","000","00","005","0523","1070","698","260","438","24","722","1226","0","58.89","21.21"
"63","000","00","005","0524","0000","1471","564","907","61","1532","2726","0","56.2","20.69"
"63","000","00","005","0524","1071","704","257","447","35","739","1390","0","53.17","18.49"
"63","000","00","005","0524","1072","767","307","460","26","793","1336","0","59.36","22.98"
"63","000","00","005","0525","0000","1538","605","933","70","1608","2780","0","57.84","21.76"
"63","000","00","005","0525","1073","727","285","442","30","757","1419","0","53.35","20.08"
"63","000","00","005","0525","1074","811","320","491","40","851","1361","0","62.53","23.51"
"63","000","00","005","0526","0000","2240","837","1403","54","2294","5016","0","45.73","16.69"
"63","000","00","005","0526","1075","866","318","548","33","899","2520","0","35.67","12.62"
"63","000","00","005","0526","1076","705","253","452","15","720","1224","0","58.82","20.67"
"63","000","00","005","0526","1077","669","266","403","6","675","1272","0","53.07","20.91"
"63","000","00","005","0527","0000","2240","885","1355","96","2336","3951","0","59.12","22.4"
"63","000","00","005","0527","1078","783","336","447","35","818","1400","0","58.43","24.0"
"63","000","00","005","0527","1079","719","277","442","30","749","1319","0","56.79","21.0"
"63","000","00","005","0527","1080","738","272","466","31","769","1232","0","62.42","22.08"
"63","000","00","005","0528","0000","1977","753","1224","72","2049","3274","0","62.58","23.0"
"63","000","00","005","0528","1081","782","307","475","27","809","1265","0","63.95","24.27"
"63","000","00","005","0528","1082","653","250","403","21","674","1055","0","63.89","23.7"
"63","000","00","005","0528","1083","542","196","346","24","566","954","0","59.33","20.55"
"63","000","00","005","0529","0000","2613","1024","1589","110","2723","4703","0","57.9","21.77"
"63","000","00","005","0529","1084","590","208","382","30","620","1018","0","60.9","20.43"
"63","000","00","005","0529","1085","793","308","485","18","811","1431","0","56.67","21.52"
"63","000","00","005","0529","1086","646","276","370","30","676","1271","0","53.19","21.72"
"63","000","00","005","0529","1087","584","232","352","32","616","983","0","62.67","23.6"
"63","000","00","005","0530","0000","3587","1380","2207","125","3712","6409","0","57.92","21.53"
"63","000","00","005","0530","1088","886","340","546","26","912","1594","0","57.21","21.33"
"63","000","00","005","0530","1089","921","355","566","39","960","1565","0","61.34","22.68"
"63","000","00","005","0530","1090","923","346","577","32","955","1650","0","57.88","20.97"
"63","000","00","005","0530","1091","857","339","518","28","885","1600","0","55.31","21.19"
"63","000","00","005","0531","0000","4065","1638","2427","160","4225","7227","0","58.46","22.67"
"63","000","00","005","0531","1092","762","305","457","29","791","1391","0","56.87","21.93"
"63","000","00","005","0531","1093","964","370","594","32","996","1769","0","56.3","20.92"
"63","000","00","005","0531","1094","828","355","473","35","863","1487","0","58.04","23.87"
"63","000","00","005","0531","1095","755","303","452","41","796","1291","0","61.66","23.47"
"63","000","00","005","0531","1096","756","305","451","23","779","1289","0","60.43","23.66"
"63","000","00","006","0000","0000","58979","24094","34885","3537","62516","107557","127833","58.12","22.4"
"63","000","00","006","0601","0000","1495","641","854","94","1589","2613","0","60.81","24.53"
"63","000","00","006","0601","0919","705","308","397","48","753","1261","0","59.71","24.43"
"63","000","00","006","0601","0920","790","333","457","46","836","1352","0","61.83","24.63"
"63","000","00","006","0602","0000","1600","627","973","80","1680","2972","0","56.53","21.1"
"63","000","00","006","0602","0921","807","328","479","37","844","1462","0","57.73","22.44"
"63","000","00","006","0602","0922","793","299","494","43","836","1510","0","55.36","19.8"
"63","000","00","006","0603","0000","2167","889","1278","153","2320","4132","0","56.15","21.52"
"63","000","00","006","0603","0923","765","329","436","34","799","1496","0","53.41","21.99"
"63","000","00","006","0603","0924","705","271","434","46","751","1329","0","56.51","20.39"
"63","000","00","006","0603","0925","697","289","408","73","770","1307","0","58.91","22.11"
"63","000","00","006","0604","0000","1824","783","1041","104","1928","3197","0","60.31","24.49"
"63","000","00","006","0604","0926","591","247","344","42","633","1065","0","59.44","23.19"
"63","000","00","006","0604","0927","612","265","347","20","632","1085","0","58.25","24.42"
"63","000","00","006","0604","0928","621","271","350","42","663","1047","0","63.32","25.88"
"63","000","00","006","0605","0000","2679","1172","1507","138","2817","4703","0","59.9","24.92"
"63","000","00","006","0605","0929","619","294","325","28","647","1215","0","53.25","24.2"
"63","000","00","006","0605","0930","673","292","381","27","700","1117","0","62.67","26.14"
"63","000","00","006","0605","0931","706","313","393","36","742","1186","0","62.56","26.39"
"63","000","00","006","0605","0932","681","273","408","47","728","1185","0","61.43","23.04"
"63","000","00","006","0606","0000","2235","911","1324","97","2332","3923","0","59.44","23.22"
"63","000","00","006","0606","0933","751","292","459","38","789","1359","0","58.06","21.49"
"63","000","00","006","0606","0934","717","271","446","23","740","1273","0","58.13","21.29"
"63","000","00","006","0606","0935","767","348","419","36","803","1291","0","62.2","26.96"
"63","000","00","006","0607","0000","2909","1181","1728","128","3037","5142","0","59.06","22.97"
"63","000","00","006","0607","0936","686","282","404","31","717","1288","0","55.67","21.89"
"63","000","00","006","0607","0937","748","276","472","31","779","1245","0","62.57","22.17"
"63","000","00","006","0607","0938","754","326","428","40","794","1261","0","62.97","25.85"
"63","000","00","006","0607","0939","721","297","424","26","747","1348","0","55.42","22.03"
"63","000","00","006","0608","0000","2430","998","1432","158","2588","4303","0","60.14","23.19"
"63","000","00","006","0608","0940","915","392","523","69","984","1676","0","58.71","23.39"
"63","000","00","006","0608","0941","770","290","480","36","806","1311","0","61.48","22.12"
"63","000","00","006","0608","0942","745","316","429","53","798","1316","0","60.64","24.01"
"63","000","00","006","0609","0000","2383","997","1386","159","2542","4253","0","59.77","23.44"
"63","000","00","006","0609","0943","770","318","452","61","831","1409","0","58.98","22.57"
"63","000","00","006","0609","0944","826","354","472","45","871","1436","0","60.65","24.65"
"63","000","00","006","0609","0945","787","325","462","53","840","1408","0","59.66","23.08"
"63","000","00","006","0610","0000","2057","831","1226","77","2134","3710","0","57.52","22.4"
"63","000","00","006","0610","0946","697","274","423","36","733","1276","0","57.45","21.47"
"63","000","00","006","0610","0947","600","238","362","19","619","1110","0","55.77","21.44"
"63","000","00","006","0610","0948","760","319","441","22","782","1324","0","59.06","24.09"
"63","000","00","006","0611","0000","4606","1732","2874","254","4860","7949","0","61.14","21.79"
"63","000","00","006","0611","0949","559","218","341","40","599","1016","0","58.96","21.46"
"63","000","00","006","0611","0950","609","240","369","35","644","1028","0","62.65","23.35"
"63","000","00","006","0611","0951","664","220","444","40","704","1158","0","60.79","19.0"
"63","000","00","006","0611","0952","668","242","426","37","705","1138","0","61.95","21.27"
"63","000","00","006","0611","0953","698","262","436","34","732","1214","0","60.3","21.58"
"63","000","00","006","0611","0954","620","220","400","22","642","1090","0","58.9","20.18"
"63","000","00","006","0611","0955","788","330","458","46","834","1305","0","63.91","25.29"
"63","000","00","006","0612","0000","1970","790","1180","106","2076","3518","0","59.01","22.46"
"63","000","00","006","0612","0956","631","259","372","27","658","1167","0","56.38","22.19"
"63","000","00","006","0612","0957","625","249","376","45","670","1148","0","58.36","21.69"
"63","000","00","006","0612","0958","714","282","432","34","748","1203","0","62.18","23.44"
"63","000","00","006","0613","0000","3035","1246","1789","168","3203","5427","0","59.02","22.96"
"63","000","00","006","0613","0959","770","310","460","38","808","1441","0","56.07","21.51"
"63","000","00","006","0613","0960","773","298","475","48","821","1315","0","62.43","22.66"
"63","000","00","006","0613","0961","762","335","427","40","802","1393","0","57.57","24.05"
"63","000","00","006","0613","0962","730","303","427","42","772","1278","0","60.41","23.71"
"63","000","00","006","0614","0000","1259","541","718","96","1355","2388","0","56.74","22.65"
"63","000","00","006","0614","0963","653","285","368","35","688","1246","0","55.22","22.87"
"63","000","00","006","0614","0964","606","256","350","61","667","1142","0","58.41","22.42"
"63","000","00","006","0615","0000","1584","634","950","96","1680","2699","0","62.25","23.49"
"63","000","00","006","0615","0965","790","308","482","53","843","1336","0","63.1","23.05"
"63","000","00","006","0615","0966","794","326","468","43","837","1363","0","61.41","23.92"
"63","000","00","006","0616","0000","2420","957","1463","107","2527","4354","0","58.04","21.98"
"63","000","00","006","0616","0967","837","320","517","23","860","1476","0","58.27","21.68"
"63","000","00","006","0616","0968","789","343","446","51","840","1418","0","59.24","24.19"
"63","000","00","006","0616","0969","794","294","500","33","827","1460","0","56.64","20.14"
"63","000","00","006","0617","0000","1175","480","695","116","1291","2468","0","52.31","19.45"
"63","000","00","006","0617","0970","599","250","349","41","640","1222","0","52.37","20.46"
"63","000","00","006","0617","0971","576","230","346","75","651","1246","0","52.25","18.46"
"63","000","00","006","0618","0000","2175","882","1293","101","2276","3885","0","58.58","22.7"
"63","000","00","006","0618","0972","732","285","447","52","784","1256","0","62.42","22.69"
"63","000","00","006","0618","0973","726","299","427","29","755","1289","0","58.57","23.2"
"63","000","00","006","0618","0974","717","298","419","20","737","1340","0","55.0","22.24"
"63","000","00","006","0619","0000","1543","610","933","113","1656","4014","0","41.26","15.2"
"63","000","00","006","0619","0975","777","348","429","47","824","1555","0","52.99","22.38"
"63","000","00","006","0619","0976","766","262","504","66","832","2459","0","33.83","10.65"
"63","000","00","006","0620","0000","2362","982","1380","182","2544","4466","0","56.96","21.99"
"63","000","00","006","0620","0977","490","192","298","55","545","1108","0","49.19","17.33"
"63","000","00","006","0620","0978","456","188","268","38","494","867","0","56.98","21.68"
"63","000","00","006","0620","0979","772","311","461","54","826","1329","0","62.15","23.4"
"63","000","00","006","0620","0980","644","291","353","35","679","1162","0","58.43","25.04"
"63","000","00","006","0621","0000","2942","1262","1680","193","3135","5823","0","53.84","21.67"
"63","000","00","006","0621","0981","732","290","442","62","794","1434","0","55.37","20.22"
"63","000","00","006","0621","0982","741","321","420","54","795","1351","0","58.85","23.76"
"63","000","00","006","0621","0983","734","326","408","43","777","1531","0","50.75","21.29"
"63","000","00","006","0621","0984","735","325","410","34","769","1507","0","51.03","21.57"
"63","000","00","006","0622","0000","3953","1623","2330","235","4188","7142","0","58.64","22.72"
"63","000","00","006","0622","0985","779","356","423","53","832","1488","0","55.91","23.92"
"63","000","00","006","0622","0986","790","321","469","62","852","1384","0","61.56","23.19"
"63","000","00","006","0622","0987","809","290","519","51","860","1460","0","58.9","19.86"
"63","000","00","006","0622","0988","792","313","479","52","844","1371","0","61.56","22.83"
"63","000","00","006","0622","0989","783","343","440","17","800","1439","0","55.59","23.84"
"63","000","00","006","0624","0000","2914","1206","1708","220","3134","5195","0","60.33","23.21"
"63","000","00","006","0624","0990","783","357","426","49","832","1376","0","60.47","25.94"
"63","000","00","006","0624","0991","716","288","428","68","784","1366","0","57.39","21.08"
"63","000","00","006","0624","0992","729","296","433","58","787","1218","0","64.61","24.3"
"63","000","00","006","0624","0993","686","265","421","45","731","1235","0","59.19","21.46"
"63","000","00","006","0625","0000","3189","1234","1955","185","3374","5651","0","59.71","21.84"
"63","000","00","006","0625","0994","725","248","477","19","744","1364","0","54.55","18.18"
"63","000","00","006","0625","0995","845","350","495","53","898","1408","0","63.78","24.86"
"63","000","00","006","0625","0996","795","309","486","52","847","1450","0","58.41","21.31"
"63","000","00","006","0625","0997","824","327","497","61","885","1429","0","61.93","22.88"
"63","000","00","006","0626","0000","2073","885","1188","177","2250","3630","0","61.98","24.38"
"63","000","00","006","0626","0998","662","284","378","57","719","1170","0","61.45","24.27"
"63","000","00","006","0626","0999","680","288","392","58","738","1245","0","59.28","23.13"
"63","000","00","006","0626","1000","731","313","418","62","793","1215","0","65.27","25.76"
"63","000","00","007","0000","0000","86183","33238","52945","5302","91485","164020","189875","55.78","20.26"
"63","000","00","007","0701","0000","2503","1010","1493","155","2658","4833","0","55.0","20.9"
"63","000","00","007","0701","1097","743","315","428","45","788","1305","0","60.38","24.14"
"63","000","00","007","0701","1098","549","205","344","59","608","1183","0","51.39","17.33"
"63","000","00","007","0701","1099","629","244","385","25","654","1176","0","55.61","20.75"
"63","000","00","007","0701","1100","582","246","336","26","608","1169","0","52.01","21.04"
"63","000","00","007","0702","0000","1408","510","898","88","1496","3020","0","49.54","16.89"
"63","000","00","007","0702","1101","707","235","472","34","741","1457","0","50.86","16.13"
"63","000","00","007","0702","1102","701","275","426","54","755","1563","0","48.3","17.59"
"63","000","00","007","0703","0000","1647","689","958","60","1707","3386","0","50.41","20.35"
"63","000","00","007","0703","1103","846","341","505","22","868","1771","0","49.01","19.25"
"63","000","00","007","0703","1104","801","348","453","38","839","1615","0","51.95","21.55"
"63","000","00","007","0704","0000","2963","1179","1784","193","3156","5794","0","54.47","20.35"
"63","000","00","007","0704","1105","763","318","445","69","832","1478","0","56.29","21.52"
"63","000","00","007","0704","1106","775","300","475","24","799","1462","0","54.65","20.52"
"63","000","00","007","0704","1107","680","243","437","55","735","1507","0","48.77","16.12"
"63","000","00","007","0704","1108","745","318","427","45","790","1347","0","58.65","23.61"
"63","000","00","007","0705","0000","2949","1244","1705","184","3133","5489","0","57.08","22.66"
"63","000","00","007","0705","1109","682","272","410","51","733","1367","0","53.62","19.9"
"63","000","00","007","0705","1110","746","293","453","42","788","1277","0","61.71","22.94"
"63","000","00","007","0705","1111","781","360","421","50","831","1395","0","59.57","25.81"
"63","000","00","007","0705","1112","740","319","421","41","781","1450","0","53.86","22.0"
"63","000","00","007","0706","0000","2618","1003","1615","182","2800","5192","0","53.93","19.32"
"63","000","00","007","0706","1113","664","255","409","34","698","1340","0","52.09","19.03"
"63","000","00","007","0706","1114","630","249","381","37","667","1242","0","53.7","20.05"
"63","000","00","007","0706","1115","652","264","388","62","714","1286","0","55.52","20.53"
"63","000","00","007","0706","1116","672","235","437","49","721","1324","0","54.46","17.75"
"63","000","00","007","0707","0000","2160","854","1306","158","2318","4411","0","52.55","19.36"
"63","000","00","007","0707","1117","803","330","473","59","862","1619","0","53.24","20.38"
"63","000","00","007","0707","1118","622","240","382","56","678","1352","0","50.15","17.75"
"63","000","00","007","0707","1119","735","284","451","43","778","1440","0","54.03","19.72"
"63","000","00","007","0708","0000","1946","768","1178","151","2097","3514","0","59.68","21.86"
"63","000","00","007","0708","1120","670","284","386","49","719","1194","0","60.22","23.79"
"63","000","00","007","0708","1121","644","235","409","48","692","1083","0","63.9","21.7"
"63","000","00","007","0708","1122","632","249","383","54","686","1237","0","55.46","20.13"
"63","000","00","007","0709","0000","2354","1001","1353","136","2490","4301","0","57.89","23.27"
"63","000","00","007","0709","1123","843","362","481","39","882","1625","0","54.28","22.28"
"63","000","00","007","0709","1124","759","300","459","43","802","1324","0","60.57","22.66"
"63","000","00","007","0709","1125","752","339","413","54","806","1352","0","59.62","25.07"
"63","000","00","007","0710","0000","2317","973","1344","135","2452","5559","0","44.11","17.5"
"63","000","00","007","0710","1126","703","282","421","47","750","2630","0","28.52","10.72"
"63","000","00","007","0710","1127","859","366","493","50","909","1504","0","60.44","24.34"
"63","000","00","007","0710","1128","755","325","430","38","793","1425","0","55.65","22.81"
"63","000","00","007","0711","0000","3298","1359","1939","222","3520","6398","0","55.02","21.24"
"63","000","00","007","0711","1144","529","213","316","34","563","1052","0","53.52","20.25"
"63","000","00","007","0711","1145","607","262","345","40","647","1135","0","57.0","23.08"
"63","000","00","007","0711","1146","637","245","392","54","691","1225","0","56.41","20.0"
"63","000","00","007","0711","1147","797","315","482","40","837","1583","0","52.87","19.9"
"63","000","00","007","0711","1148","728","324","404","54","782","1403","0","55.74","23.09"
"63","000","00","007","0712","0000","2195","865","1330","144","2339","3995","0","58.55","21.65"
"63","000","00","007","0712","1149","766","307","459","48","814","1406","0","57.89","21.83"
"63","000","00","007","0712","1150","766","271","495","48","814","1401","0","58.1","19.34"
"63","000","00","007","0712","1151","663","287","376","48","711","1188","0","59.85","24.16"
"63","000","00","007","0713","0000","1721","522","1199","72","1793","3076","0","58.29","16.97"
"63","000","00","007","0713","1198","773","250","523","40","813","1485","0","54.75","16.84"
"63","000","00","007","0713","1199","948","272","676","32","980","1591","0","61.6","17.1"
"63","000","00","007","0714","0000","4472","1470","3002","157","4629","7544","0","61.36","19.49"
"63","000","00","007","0714","1200","861","286","575","36","897","1394","0","64.35","20.52"
"63","000","00","007","0714","1201","844","291","553","29","873","1522","0","57.36","19.12"
"63","000","00","007","0714","1202","979","306","673","24","1003","1661","0","60.39","18.42"
"63","000","00","007","0714","1203","918","300","618","33","951","1561","0","60.92","19.22"
"63","000","00","007","0714","1204","870","287","583","35","905","1406","0","64.37","20.41"
"63","000","00","007","0715","0000","2678","1092","1586","161","2839","4891","0","58.05","22.33"
"63","000","00","007","0715","1137","653","282","371","20","673","1228","0","54.8","22.96"
"63","000","00","007","0715","1138","673","251","422","48","721","1268","0","56.86","19.79"
"63","000","00","007","0715","1139","675","272","403","54","729","1207","0","60.4","22.54"
"63","000","00","007","0715","1140","677","287","390","39","716","1188","0","60.27","24.16"
"63","000","00","007","0716","0000","3120","1223","1897","181","3301","6228","0","53.0","19.64"
"63","000","00","007","0716","1152","805","326","479","63","868","1597","0","54.35","20.41"
"63","000","00","007","0716","1153","736","272","464","61","797","1290","0","61.78","21.09"
"63","000","00","007","0716","1154","845","339","506","28","873","1746","0","50.0","19.42"
"63","000","00","007","0716","1155","734","286","448","29","763","1595","0","47.84","17.93"
"63","000","00","007","0717","0000","1794","641","1153","114","1908","3860","0","49.43","16.61"
"63","000","00","007","0717","1141","757","292","465","40","797","1474","0","54.07","19.81"
"63","000","00","007","0717","1142","609","197","412","26","635","1304","0","48.7","15.11"
"63","000","00","007","0717","1143","428","152","276","48","476","1082","0","43.99","14.05"
"63","000","00","007","0718","0000","4196","1683","2513","221","4417","7643","0","57.79","22.02"
"63","000","00","007","0718","1132","741","290","451","52","793","1447","0","54.8","20.04"
"63","000","00","007","0718","1133","824","306","518","42","866","1491","0","58.08","20.52"
"63","000","00","007","0718","1134","855","324","531","40","895","1500","0","59.67","21.6"
"63","000","00","007","0718","1135","969","438","531","45","1014","1582","0","64.1","27.69"
"63","000","00","007","0718","1136","807","325","482","42","849","1623","0","52.31","20.02"
"63","000","00","007","0719","0000","2306","962","1344","179","2485","4677","0","53.13","20.57"
"63","000","00","007","0719","1129","758","312","446","62","820","1591","0","51.54","19.61"
"63","000","00","007","0719","1130","762","317","445","51","813","1474","0","55.16","21.51"
"63","000","00","007","0719","1131","786","333","453","66","852","1612","0","52.85","20.66"
"63","000","00","007","0720","0000","1888","784","1104","113","2001","3212","0","62.3","24.41"
"63","000","00","007","0720","1163","601","248","353","29","630","1036","0","60.81","23.94"
"63","000","00","007","0720","1164","616","251","365","45","661","1035","0","63.86","24.25"
"63","000","00","007","0720","1165","671","285","386","39","710","1141","0","62.23","24.98"
"63","000","00","007","0721","0000","2723","979","1744","168","2891","5522","0","52.35","17.73"
"63","000","00","007","0721","1205","667","248","419","39","706","1498","0","47.13","16.56"
"63","000","00","007","0721","1206","656","230","426","52","708","1478","0","47.9","15.56"
"63","000","00","007","0721","1207","609","226","383","47","656","1170","0","56.07","19.32"
"63","000","00","007","0721","1208","791","275","516","30","821","1376","0","59.67","19.99"
"63","000","00","007","0722","0000","2177","871","1306","145","2322","3885","0","59.77","22.42"
"63","000","00","007","0722","1166","713","269","444","37","750","1271","0","59.01","21.16"
"63","000","00","007","0722","1167","740","299","441","69","809","1328","0","60.92","22.52"
"63","000","00","007","0722","1168","724","303","421","39","763","1286","0","59.33","23.56"
"63","000","00","007","0723","0000","1572","545","1027","109","1681","2903","0","57.91","18.77"
"63","000","00","007","0723","1172","908","322","586","49","957","1623","0","58.96","19.84"
"63","000","00","007","0723","1173","664","223","441","60","724","1280","0","56.56","17.42"
"63","000","00","007","0724","0000","2947","1120","1827","288","3235","6128","0","52.79","18.28"
"63","000","00","007","0724","1156","853","334","519","85","938","1701","0","55.14","19.64"
"63","000","00","007","0724","1157","600","235","365","65","665","1339","0","49.66","17.55"
"63","000","00","007","0724","1158","655","234","421","66","721","1484","0","48.58","15.77"
"63","000","00","007","0724","1159","839","317","522","72","911","1604","0","56.8","19.76"
"63","000","00","007","0725","0000","2516","982","1534","175","2691","4923","0","54.66","19.95"
"63","000","00","007","0725","1169","895","346","549","67","962","1679","0","57.3","20.61"
"63","000","00","007","0725","1170","847","353","494","64","911","1619","0","56.27","21.8"
"63","000","00","007","0725","1171","774","283","491","44","818","1625","0","50.34","17.42"
"63","000","00","007","0726","0000","2084","873","1211","150","2234","3767","0","59.3","23.17"
"63","000","00","007","0726","1160","664","282","382","38","702","1197","0","58.65","23.56"
"63","000","00","007","0726","1161","674","283","391","73","747","1347","0","55.46","21.01"
"63","000","00","007","0726","1162","746","308","438","39","785","1223","0","64.19","25.18"
"63","000","00","007","0727","0000","1651","585","1066","118","1769","2911","0","60.77","20.1"
"63","000","00","007","0727","1180","789","296","493","46","835","1342","0","62.22","22.06"
"63","000","00","007","0727","1181","862","289","573","72","934","1569","0","59.53","18.42"
"63","000","00","007","0728","0000","2224","878","1346","120","2344","4194","0","55.89","20.93"
"63","000","00","007","0728","1177","762","316","446","37","799","1373","0","58.19","23.02"
"63","000","00","007","0728","1178","724","279","445","54","778","1394","0","55.81","20.01"
"63","000","00","007","0728","1179","738","283","455","29","767","1427","0","53.75","19.83"
"63","000","00","007","0729","0000","1518","555","963","84","1602","3234","0","49.54","17.16"
"63","000","00","007","0729","1182","714","243","471","45","759","1514","0","50.13","16.05"
"63","000","00","007","0729","1183","804","312","492","39","843","1720","0","49.01","18.14"
"63","000","00","007","0730","0000","2508","1003","1505","157","2665","4533","0","58.79","22.13"
"63","000","00","007","0730","1174","839","339","500","63","902","1608","0","56.09","21.08"
"63","000","00","007","0730","1175","797","324","473","54","851","1453","0","58.57","22.3"
"63","000","00","007","0730","1176","872","340","532","40","912","1472","0","61.96","23.1"
"63","000","00","007","0731","0000","2142","797","1345","130","2272","4154","0","54.69","19.19"
"63","000","00","007","0731","1188","653","232","421","33","686","1307","0","52.49","17.75"
"63","000","00","007","0731","1189","779","284","495","60","839","1420","0","59.08","20.0"
"63","000","00","007","0731","1190","710","281","429","37","747","1427","0","52.35","19.69"
"63","000","00","007","0732","0000","3058","1303","1755","211","3269","5505","0","59.38","23.67"
"63","000","00","007","0732","1184","857","348","509","59","916","1461","0","62.7","23.82"
"63","000","00","007","0732","1185","669","261","408","34","703","1264","0","55.62","20.65"
"63","000","00","007","0732","1186","773","279","494","57","830","1334","0","62.22","20.91"
"63","000","00","007","0732","1187","759","415","344","61","820","1446","0","56.71","28.7"
"63","000","00","007","0733","0000","2700","885","1815","150","2850","4900","0","58.16","18.06"
"63","000","00","007","0733","1191","516","177","339","30","546","956","0","57.11","18.51"
"63","000","00","007","0733","1192","735","245","490","56","791","1352","0","58.51","18.12"
"63","000","00","007","0733","1193","744","244","500","37","781","1370","0","57.01","17.81"
"63","000","00","007","0733","1194","705","219","486","27","732","1222","0","59.9","17.92"
"63","000","00","007","0734","0000","2351","739","1612","110","2461","4365","0","56.38","16.93"
"63","000","00","007","0734","1195","758","212","546","36","794","1375","0","57.75","15.42"
"63","000","00","007","0734","1196","823","252","571","37","860","1463","0","58.78","17.22"
"63","000","00","007","0734","1197","770","275","495","37","807","1527","0","52.85","18.01"
"63","000","00","007","0735","0000","1864","711","1153","118","1982","3296","0","60.13","21.57"
"63","000","00","007","0735","1209","608","236","372","16","624","1093","0","57.09","21.59"
"63","000","00","007","0735","1210","627","244","383","57","684","1084","0","63.1","22.51"
"63","000","00","007","0735","1211","629","231","398","45","674","1119","0","60.23","20.64"
"63","000","00","007","0736","0000","1615","580","1035","63","1678","2777","0","60.42","20.89"
"63","000","00","007","0736","1212","828","287","541","27","855","1381","0","61.91","20.78"
"63","000","00","007","0736","1213","787","293","494","36","823","1396","0","58.95","20.99"
"63","000","00","008","0000","0000","130273","49133","81140","5773","136046","227211","273883","59.88","21.62"
"63","000","00","008","0801","0000","3462","1291","2171","155","3617","6228","0","58.08","20.73"
"63","000","00","008","0801","1402","836","328","508","35","871","1539","0","56.6","21.31"
"63","000","00","008","0801","1403","819","289","530","22","841","1548","0","54.33","18.67"
"63","000","00","008","0801","1404","849","314","535","57","906","1493","0","60.68","21.03"
"63","000","00","008","0801","1405","958","360","598","41","999","1648","0","60.62","21.84"
"63","000","00","008","0802","0000","3509","1272","2237","153","3662","6155","0","59.5","20.67"
"63","000","00","008","0802","1406","859","321","538","40","899","1544","0","58.23","20.79"
"63","000","00","008","0802","1407","873","298","575","36","909","1557","0","58.38","19.14"
"63","000","00","008","0802","1408","831","314","517","34","865","1514","0","57.13","20.74"
"63","000","00","008","0802","1409","946","339","607","43","989","1540","0","64.22","22.01"
"63","000","00","008","0803","0000","2570","955","1615","120","2690","4365","0","61.63","21.88"
"63","000","00","008","0803","1410","877","325","552","30","907","1466","0","61.87","22.17"
"63","000","00","008","0803","1411","858","327","531","39","897","1444","0","62.12","22.65"
"63","000","00","008","0803","1412","835","303","532","51","886","1455","0","60.89","20.82"
"63","000","00","008","0804","0000","3177","1141","2036","127","3304","5676","0","58.21","20.1"
"63","000","00","008","0804","1413","778","264","514","30","808","1440","0","56.11","18.33"
"63","000","00","008","0804","1414","827","276","551","35","862","1398","0","61.66","19.74"
"63","000","00","008","0804","1415","781","309","472","19","800","1412","0","56.66","21.88"
"63","000","00","008","0804","1416","791","292","499","43","834","1426","0","58.49","20.48"
"63","000","00","008","0805","0000","2493","954","1539","91","2584","4345","0","59.47","21.96"
"63","000","00","008","0805","1417","821","325","496","36","857","1437","0","59.64","22.62"
"63","000","00","008","0805","1418","778","284","494","31","809","1340","0","60.37","21.19"
"63","000","00","008","0805","1419","894","345","549","24","918","1568","0","58.55","22.0"
"63","000","00","008","0806","0000","2824","1029","1795","132","2956","5016","0","58.93","20.51"
"63","000","00","008","0806","1420","766","256","510","29","795","1372","0","57.94","18.66"
"63","000","00","008","0806","1421","587","227","360","30","617","1046","0","58.99","21.7"
"63","000","00","008","0806","1422","715","281","434","48","763","1274","0","59.89","22.06"
"63","000","00","008","0806","1423","756","265","491","25","781","1324","0","58.99","20.02"
"63","000","00","008","0807","0000","2778","1026","1752","110","2888","4829","0","59.81","21.25"
"63","000","00","008","0807","1424","939","336","603","43","982","1722","0","57.03","19.51"
"63","000","00","008","0807","1425","1005","367","638","43","1048","1737","0","60.33","21.13"
"63","000","00","008","0807","1426","834","323","511","24","858","1370","0","62.63","23.58"
"63","000","00","008","0808","0000","2310","895","1415","113","2423","3961","0","61.17","22.6"
"63","000","00","008","0808","1427","839","341","498","43","882","1495","0","59.0","22.81"
"63","000","00","008","0808","1428","772","297","475","35","807","1328","0","60.77","22.36"
"63","000","00","008","0808","1429","699","257","442","35","734","1138","0","64.5","22.58"
"63","000","00","008","0809","0000","3755","1373","2382","159","3914","6217","0","62.96","22.08"
"63","000","00","008","0809","1430","867","306","561","30","897","1471","0","60.98","20.8"
"63","000","00","008","0809","1431","697","260","437","22","719","1144","0","62.85","22.73"
"63","000","00","008","0809","1432","715","271","444","39","754","1176","0","64.12","23.04"
"63","000","00","008","0809","1433","731","265","466","36","767","1212","0","63.28","21.86"
"63","000","00","008","0809","1434","745","271","474","32","777","1214","0","64.0","22.32"
"63","000","00","008","0810","0000","2745","1062","1683","125","2870","4778","0","60.07","22.23"
"63","000","00","008","0810","1435","643","259","384","30","673","1170","0","57.52","22.14"
"63","000","00","008","0810","1436","770","296","474","33","803","1308","0","61.39","22.63"
"63","000","00","008","0810","1437","697","272","425","34","731","1190","0","61.43","22.86"
"63","000","00","008","0810","1438","635","235","400","28","663","1110","0","59.73","21.17"
"63","000","00","008","0811","0000","1679","569","1110","82","1761","2899","0","60.75","19.63"
"63","000","00","008","0811","1439","856","313","543","44","900","1512","0","59.52","20.7"
"63","000","00","008","0811","1440","823","256","567","38","861","1387","0","62.08","18.46"
"63","000","00","008","0812","0000","2393","919","1474","123","2516","4209","0","59.78","21.83"
"63","000","00","008","0812","1441","766","297","469","44","810","1355","0","59.78","21.92"
"63","000","00","008","0812","1442","780","318","462","47","827","1370","0","60.36","23.21"
"63","000","00","008","0812","1443","847","304","543","32","879","1484","0","59.23","20.49"
"63","000","00","008","0813","0000","2478","930","1548","113","2591","4240","0","61.11","21.93"
"63","000","00","008","0813","1444","990","372","618","46","1036","1786","0","58.01","20.83"
"63","000","00","008","0813","1445","726","248","478","45","771","1260","0","61.19","19.68"
"63","000","00","008","0813","1446","762","310","452","22","784","1194","0","65.66","25.96"
"63","000","00","008","0814","0000","1684","632","1052","90","1774","2936","0","60.42","21.53"
"63","000","00","008","0814","1450","796","302","494","60","856","1450","0","59.03","20.83"
"63","000","00","008","0814","1451","888","330","558","30","918","1486","0","61.78","22.21"
"63","000","00","008","0815","0000","3861","1447","2414","151","4012","6643","0","60.39","21.78"
"63","000","00","008","0815","1452","738","282","456","29","767","1259","0","60.92","22.4"
"63","000","00","008","0815","1453","791","274","517","26","817","1317","0","62.03","20.8"
"63","000","00","008","0815","1454","798","304","494","31","829","1321","0","62.76","23.01"
"63","000","00","008","0815","1455","829","318","511","35","864","1475","0","58.58","21.56"
"63","000","00","008","0815","1456","705","269","436","30","735","1271","0","57.83","21.16"
"63","000","00","008","0816","0000","2922","1094","1828","128","3050","5159","0","59.12","21.21"
"63","000","00","008","0816","1457","932","354","578","40","972","1609","0","60.41","22.0"
"63","000","00","008","0816","1458","820","288","532","21","841","1501","0","56.03","19.19"
"63","000","00","008","0816","1459","525","198","327","29","554","997","0","55.57","19.86"
"63","000","00","008","0816","1460","645","254","391","38","683","1052","0","64.92","24.14"
"63","000","00","008","0817","0000","2886","1038","1848","125","3011","4847","0","62.12","21.42"
"63","000","00","008","0817","1461","741","266","475","26","767","1247","0","61.51","21.33"
"63","000","00","008","0817","1462","696","264","432","36","732","1167","0","62.72","22.62"
"63","000","00","008","0817","1463","771","264","507","25","796","1280","0","62.19","20.63"
"63","000","00","008","0817","1464","678","244","434","38","716","1153","0","62.1","21.16"
"63","000","00","008","0818","0000","3482","1234","2248","151","3633","5817","0","62.45","21.21"
"63","000","00","008","0818","1465","915","360","555","41","956","1557","0","61.4","23.12"
"63","000","00","008","0818","1466","815","248","567","48","863","1444","0","59.76","17.17"
"63","000","00","008","0818","1467","913","344","569","34","947","1459","0","64.91","23.58"
"63","000","00","008","0818","1468","839","282","557","28","867","1357","0","63.89","20.78"
"63","000","00","008","0819","0000","2914","1124","1790","134","3048","4847","0","62.88","23.19"
"63","000","00","008","0819","1469","760","281","479","26","786","1194","0","65.83","23.53"
"63","000","00","008","0819","1470","619","270","349","45","664","1184","0","56.08","22.8"
"63","000","00","008","0819","1471","697","269","428","22","719","1119","0","64.25","24.04"
"63","000","00","008","0819","1472","838","304","534","41","879","1350","0","65.11","22.52"
"63","000","00","008","0820","0000","4302","1536","2766","142","4444","7265","0","61.17","21.14"
"63","000","00","008","0820","1473","814","266","548","33","847","1502","0","56.39","17.71"
"63","000","00","008","0820","1474","879","308","571","35","914","1511","0","60.49","20.38"
"63","000","00","008","0820","1475","908","359","549","29","937","1481","0","63.27","24.24"
"63","000","00","008","0820","1476","921","321","600","21","942","1477","0","63.78","21.73"
"63","000","00","008","0820","1477","780","282","498","24","804","1294","0","62.13","21.79"
"63","000","00","008","0821","0000","2168","811","1357","99","2267","3516","0","64.48","23.07"
"63","000","00","008","0821","1478","684","239","445","25","709","1040","0","68.17","22.98"
"63","000","00","008","0821","1479","804","293","511","32","836","1323","0","63.19","22.15"
"63","000","00","008","0821","1480","680","279","401","42","722","1153","0","62.62","24.2"
"63","000","00","008","0822","0000","3405","1335","2070","121","3526","5896","0","59.8","22.64"
"63","000","00","008","0822","1481","876","300","576","25","901","1525","0","59.08","19.67"
"63","000","00","008","0822","1482","757","258","499","35","792","1412","0","56.09","18.27"
"63","000","00","008","0822","1483","899","377","522","33","932","1473","0","63.27","25.59"
"63","000","00","008","0822","1484","873","400","473","28","901","1486","0","60.63","26.92"
"63","000","00","008","0823","0000","3594","1313","2281","165","3759","6013","0","62.51","21.84"
"63","000","00","008","0823","1485","974","353","621","41","1015","1616","0","62.81","21.84"
"63","000","00","008","0823","1486","901","306","595","45","946","1489","0","63.53","20.55"
"63","000","00","008","0823","1487","803","287","516","38","841","1414","0","59.48","20.3"
"63","000","00","008","0823","1488","916","367","549","41","957","1494","0","64.06","24.56"
"63","000","00","008","0824","0000","4659","1737","2922","189","4848","7764","0","62.44","22.37"
"63","000","00","008","0824","1489","922","339","583","40","962","1547","0","62.18","21.91"
"63","000","00","008","0824","1490","922","338","584","50","972","1587","0","61.25","21.3"
"63","000","00","008","0824","1491","943","337","606","26","969","1515","0","63.96","22.24"
"63","000","00","008","0824","1492","957","360","597","32","989","1573","0","62.87","22.89"
"63","000","00","008","0824","1493","915","363","552","41","956","1542","0","62.0","23.54"
"63","000","00","008","0825","0000","1732","679","1053","135","1867","3536","0","52.8","19.2"
"63","000","00","008","0825","1494","763","284","479","45","808","1465","0","55.15","19.39"
"63","000","00","008","0825","1495","306","132","174","38","344","699","0","49.21","18.88"
"63","000","00","008","0825","1496","663","263","400","52","715","1372","0","52.11","19.17"
"63","000","00","008","0826","0000","3369","1279","2090","156","3525","6057","0","58.2","21.12"
"63","000","00","008","0826","1497","707","283","424","40","747","1448","0","51.59","19.54"
"63","000","00","008","0826","1498","866","293","573","43","909","1548","0","58.72","18.93"
"63","000","00","008","0826","1499","873","342","531","28","901","1501","0","60.03","22.78"
"63","000","00","008","0826","1500","923","361","562","45","968","1560","0","62.05","23.14"
"63","000","00","008","0827","0000","4521","1661","2860","169","4690","7736","0","60.63","21.47"
"63","000","00","008","0827","1501","904","336","568","33","937","1567","0","59.8","21.44"
"63","000","00","008","0827","1502","892","367","525","26","918","1554","0","59.07","23.62"
"63","000","00","008","0827","1503","873","306","567","44","917","1544","0","59.39","19.82"
"63","000","00","008","0827","1504","909","335","574","43","952","1528","0","62.3","21.92"
"63","000","00","008","0827","1505","943","317","626","23","966","1543","0","62.61","20.54"
"63","000","00","008","0828","0000","4268","1652","2616","234","4502","9127","0","49.33","18.1"
"63","000","00","008","0828","1506","916","365","551","47","963","2754","0","34.97","13.25"
"63","000","00","008","0828","1507","842","322","520","54","896","1709","0","52.43","18.84"
"63","000","00","008","0828","1508","812","290","522","58","870","1515","0","57.43","19.14"
"63","000","00","008","0828","1509","826","305","521","37","863","1571","0","54.93","19.41"
"63","000","00","008","0828","1510","872","370","502","38","910","1578","0","57.67","23.45"
"63","000","00","008","0829","0000","3710","1385","2325","207","3917","6503","0","60.23","21.3"
"63","000","00","008","0829","1511","780","282","498","43","823","1454","0","56.6","19.39"
"63","000","00","008","0829","1512","816","298","518","41","857","1436","0","59.68","20.75"
"63","000","00","008","0829","1513","834","304","530","46","880","1402","0","62.77","21.68"
"63","000","00","008","0829","1514","666","256","410","37","703","1117","0","62.94","22.92"
"63","000","00","008","0829","1515","614","245","369","40","654","1094","0","59.78","22.39"
"63","000","00","008","0830","0000","4233","1562","2671","214","4447","7402","0","60.08","21.1"
"63","000","00","008","0830","1519","748","284","464","25","773","1385","0","55.81","20.51"
"63","000","00","008","0830","1520","813","330","483","41","854","1416","0","60.31","23.31"
"63","000","00","008","0830","1521","869","310","559","37","906","1412","0","64.16","21.95"
"63","000","00","008","0830","1522","811","299","512","59","870","1535","0","56.68","19.48"
"63","000","00","008","0830","1523","992","339","653","52","1044","1654","0","63.12","20.5"
"63","000","00","008","0831","0000","2902","1081","1821","107","3009","4781","0","62.94","22.61"
"63","000","00","008","0831","1524","713","262","451","23","736","1156","0","63.67","22.66"
"63","000","00","008","0831","1525","759","297","462","24","783","1231","0","63.61","24.13"
"63","000","00","008","0831","1526","695","233","462","35","730","1218","0","59.93","19.13"
"63","000","00","008","0831","1527","735","289","446","25","760","1176","0","64.63","24.57"
"63","000","00","008","0832","0000","2766","1032","1734","128","2894","4889","0","59.19","21.11"
"63","000","00","008","0832","1532","880","300","580","37","917","1613","0","56.85","18.6"
"63","000","00","008","0832","1533","983","373","610","49","1032","1697","0","60.81","21.98"
"63","000","00","008","0832","1534","903","359","544","42","945","1579","0","59.85","22.74"
"63","000","00","008","0833","0000","3999","1539","2460","174","4173","6932","0","60.2","22.2"
"63","000","00","008","0833","1538","945","398","547","34","979","1646","0","59.48","24.18"
"63","000","00","008","0833","1539","745","278","467","39","784","1286","0","60.96","21.62"
"63","000","00","008","0833","1540","722","296","426","24","746","1219","0","61.2","24.28"
"63","000","00","008","0833","1541","769","284","485","33","802","1292","0","62.07","21.98"
"63","000","00","008","0833","1542","818","283","535","44","862","1489","0","57.89","19.01"
"63","000","00","008","0834","0000","2863","1281","1582","94","2957","5133","0","57.61","24.96"
"63","000","00","008","0834","1547","890","363","527","25","915","1816","0","50.39","19.99"
"63","000","00","008","0834","1548","542","220","322","22","564","985","0","57.26","22.34"
"63","000","00","008","0834","1549","795","303","492","19","814","1314","0","61.95","23.06"
"63","000","00","008","0834","1550","636","395","241","28","664","1018","0","65.23","38.8"
"63","000","00","008","0835","0000","4103","1576","2527","171","4274","7131","0","59.94","22.1"
"63","000","00","008","0835","1551","914","362","552","28","942","1578","0","59.7","22.94"
"63","000","00","008","0835","1552","828","328","500","26","854","1457","0","58.61","22.51"
"63","000","00","008","0835","1553","786","275","511","38","824","1326","0","62.14","20.74"
"63","000","00","008","0835","1554","830","306","524","33","863","1393","0","61.95","21.97"
"63","000","00","008","0835","1555","745","305","440","46","791","1377","0","57.44","22.15"
"63","000","00","008","0836","0000","1892","740","1152","121","2013","3454","0","58.28","21.42"
"63","000","00","008","0836","1560","777","313","464","39","816","1288","0","63.35","24.3"
"63","000","00","008","0836","1561","680","269","411","38","718","1301","0","55.19","20.68"
"63","000","00","008","0836","1562","435","158","277","44","479","865","0","55.38","18.27"
"63","000","00","008","0837","0000","412","144","268","29","441","789","0","55.89","18.25"
"63","000","00","008","0837","1563","412","144","268","29","441","789","0","55.89","18.25"
"63","000","00","008","0838","0000","2218","775","1443","100","2318","3615","0","64.12","21.44"
"63","000","00","008","0838","1516","648","225","423","41","689","1070","0","64.39","21.03"
"63","000","00","008","0838","1517","823","284","539","28","851","1319","0","64.52","21.53"
"63","000","00","008","0838","1518","747","266","481","31","778","1226","0","63.46","21.7"
"63","000","00","008","0839","0000","3547","1390","2157","148","3695","6498","0","56.86","21.39"
"63","000","00","008","0839","1543","955","429","526","34","989","1611","0","61.39","26.63"
"63","000","00","008","0839","1544","770","294","476","37","807","1549","0","52.1","18.98"
"63","000","00","008","0839","1545","918","333","585","37","955","1678","0","56.91","19.85"
"63","000","00","008","0839","1546","904","334","570","40","944","1660","0","56.87","20.12"
"63","000","00","008","0840","0000","3683","1572","2111","131","3814","6091","0","62.62","25.81"
"63","000","00","008","0840","1556","837","378","459","35","872","1448","0","60.22","26.1"
"63","000","00","008","0840","1557","885","353","532","35","920","1447","0","63.58","24.4"
"63","000","00","008","0840","1558","1094","460","634","42","1136","1739","0","65.32","26.45"
"63","000","00","008","0840","1559","867","381","486","19","886","1457","0","60.81","26.15"
"63","000","00","008","0841","0000","3057","1269","1788","149","3206","5308","0","60.4","23.91"
"63","000","00","008","0841","1528","852","421","431","5","857","1392","0","61.57","30.24"
"63","000","00","008","0841","1529","711","287","424","73","784","1323","0","59.26","21.69"
"63","000","00","008","0841","1530","721","263","458","31","752","1297","0","57.98","20.28"
"63","000","00","008","0841","1531","773","298","475","40","813","1296","0","62.73","22.99"
"63","000","00","008","0842","0000","2533","879","1654","115","2648","4385","0","60.39","20.05"
"63","000","00","008","0842","1447","819","265","554","39","858","1444","0","59.42","18.35"
"63","000","00","008","0842","1448","863","317","546","34","897","1495","0","60.0","21.2"
"63","000","00","008","0842","1449","851","297","554","42","893","1446","0","61.76","20.54"
"63","000","00","008","0843","0000","2415","920","1495","93","2508","4223","0","59.39","21.79"
"63","000","00","008","0843","1535","800","322","478","41","841","1320","0","63.71","24.39"
"63","000","00","008","0843","1536","832","323","509","26","858","1438","0","59.67","22.46"
"63","000","00","008","0843","1537","783","275","508","26","809","1465","0","55.22","18.77"
"63","000","00","009","0000","0000","56829","22312","34517","2479","59308","101907","121769","58.2","21.89"
"63","000","00","009","0901","0000","2903","1138","1765","116","3019","5655","0","53.39","20.12"
"63","000","00","009","0901","0455","674","254","420","24","698","1280","0","54.53","19.84"
"63","000","00","009","0901","0456","752","292","460","22","774","1351","0","57.29","21.61"
"63","000","00","009","0901","0457","750","300","450","42","792","1345","0","58.88","22.3"
"63","000","00","009","0901","0458","727","292","435","28","755","1679","0","44.97","17.39"
"63","000","00","009","0902","0000","1676","677","999","85","1761","3315","0","53.12","20.42"
"63","000","00","009","0902","0459","867","357","510","36","903","1680","0","53.75","21.25"
"63","000","00","009","0902","0460","809","320","489","49","858","1635","0","52.48","19.57"
"63","000","00","009","0903","0000","2087","841","1246","109","2196","3486","0","62.99","24.13"
"63","000","00","009","0903","0465","676","256","420","24","700","1086","0","64.46","23.57"
"63","000","00","009","0903","0466","730","292","438","46","776","1202","0","64.56","24.29"
"63","000","00","009","0903","0467","681","293","388","39","720","1198","0","60.1","24.46"
"63","000","00","009","0904","0000","3406","1299","2107","121","3527","6330","0","55.72","20.52"
"63","000","00","009","0904","0461","772","277","495","43","815","1459","0","55.86","18.99"
"63","000","00","009","0904","0462","957","384","573","21","978","1706","0","57.33","22.51"
"63","000","00","009","0904","0463","851","305","546","47","898","1674","0","53.64","18.22"
"63","000","00","009","0904","0464","826","333","493","10","836","1491","0","56.07","22.33"
"63","000","00","009","0905","0000","3455","1360","2095","166","3621","6336","0","57.15","21.46"
"63","000","00","009","0905","0483","757","323","434","47","804","1518","0","52.96","21.28"
"63","000","00","009","0905","0484","930","370","560","38","968","1552","0","62.37","23.84"
"63","000","00","009","0905","0485","887","332","555","23","910","1658","0","54.89","20.02"
"63","000","00","009","0905","0486","881","335","546","58","939","1608","0","58.4","20.83"
"63","000","00","009","0906","0000","1769","669","1100","60","1829","3337","0","54.81","20.05"
"63","000","00","009","0906","0504","805","322","483","28","833","1649","0","50.52","19.53"
"63","000","00","009","0906","0505","964","347","617","32","996","1688","0","59.0","20.56"
"63","000","00","009","0907","0000","2342","867","1475","113","2455","4093","0","59.98","21.18"
"63","000","00","009","0907","0490","782","297","485","39","821","1397","0","58.77","21.26"
"63","000","00","009","0907","0491","779","276","503","43","822","1352","0","60.8","20.41"
"63","000","00","009","0907","0492","781","294","487","31","812","1344","0","60.42","21.88"
"63","000","00","009","0908","0000","2226","911","1315","98","2324","4165","0","55.8","21.87"
"63","000","00","009","0908","0493","738","314","424","22","760","1385","0","54.87","22.67"
"63","000","00","009","0908","0494","752","291","461","48","800","1399","0","57.18","20.8"
"63","000","00","009","0908","0495","736","306","430","28","764","1381","0","55.32","22.16"
"63","000","00","009","0909","0000","2326","937","1389","84","2410","4228","0","57.0","22.16"
"63","000","00","009","0909","0496","825","312","513","36","861","1548","0","55.62","20.16"
"63","000","00","009","0909","0497","652","268","384","19","671","1190","0","56.39","22.52"
"63","000","00","009","0909","0498","849","357","492","29","878","1490","0","58.93","23.96"
"63","000","00","009","0910","0000","3465","1335","2130","152","3617","5983","0","60.45","22.31"
"63","000","00","009","0910","0499","647","257","390","25","672","1096","0","61.31","23.45"
"63","000","00","009","0910","0500","748","289","459","29","777","1238","0","62.76","23.34"
"63","000","00","009","0910","0501","764","296","468","25","789","1271","0","62.08","23.29"
"63","000","00","009","0910","0502","627","227","400","41","668","1146","0","58.29","19.81"
"63","000","00","009","0910","0503","679","266","413","32","711","1232","0","57.71","21.59"
"63","000","00","009","0911","0000","3969","1541","2428","188","4157","6741","0","61.67","22.86"
"63","000","00","009","0911","0518","748","269","479","27","775","1225","0","63.27","21.96"
"63","000","00","009","0911","0519","755","313","442","54","809","1264","0","64.0","24.76"
"63","000","00","009","0911","0520","960","384","576","61","1021","1649","0","61.92","23.29"
"63","000","00","009","0911","0521","739","299","440","25","764","1267","0","60.3","23.6"
"63","000","00","009","0911","0522","767","276","491","21","788","1336","0","58.98","20.66"
"63","000","00","009","0912","0000","2225","859","1366","96","2321","3805","0","61.0","22.58"
"63","000","00","009","0912","0509","706","273","433","57","763","1195","0","63.85","22.85"
"63","000","00","009","0912","0510","742","306","436","11","753","1254","0","60.05","24.4"
"63","000","00","009","0912","0511","777","280","497","28","805","1356","0","59.37","20.65"
"63","000","00","009","0913","0000","2322","922","1400","136","2458","4011","0","61.28","22.99"
"63","000","00","009","0913","0512","755","295","460","78","833","1363","0","61.12","21.64"
"63","000","00","009","0913","0513","799","311","488","36","835","1317","0","63.4","23.61"
"63","000","00","009","0913","0514","768","316","452","22","790","1331","0","59.35","23.74"
"63","000","00","009","0914","0000","2622","986","1636","118","2740","4733","0","57.89","20.83"
"63","000","00","009","0914","0515","887","339","548","48","935","1610","0","58.07","21.06"
"63","000","00","009","0914","0516","838","318","520","25","863","1542","0","55.97","20.62"
"63","000","00","009","0914","0517","897","329","568","45","942","1581","0","59.58","20.81"
"63","000","00","009","0915","0000","2562","855","1707","102","2664","4508","0","59.09","18.97"
"63","000","00","009","0915","0506","874","325","549","32","906","1503","0","60.28","21.62"
"63","000","00","009","0915","0507","865","243","622","28","893","1542","0","57.91","15.76"
"63","000","00","009","0915","0508","823","287","536","42","865","1463","0","59.13","19.62"
"63","000","00","009","0916","0000","3999","1575","2424","215","4214","7922","0","53.19","19.88"
"63","000","00","009","0916","0478","794","298","496","49","843","1529","0","55.13","19.49"
"63","000","00","009","0916","0479","825","344","481","39","864","1618","0","53.4","21.26"
"63","000","00","009","0916","0480","708","281","427","52","760","1545","0","49.19","18.19"
"63","000","00","009","0916","0481","869","312","557","35","904","1569","0","57.62","19.89"
"63","000","00","009","0916","0482","803","340","463","40","843","1661","0","50.75","20.47"
"63","000","00","009","0917","0000","4674","2105","2569","187","4861","8171","0","59.49","25.76"
"63","000","00","009","0917","0468","758","330","428","23","781","1430","0","54.62","23.08"
"63","000","00","009","0917","0469","747","334","413","39","786","1275","0","61.65","26.2"
"63","000","00","009","0917","0470","826","390","436","44","870","1344","0","64.73","29.02"
"63","000","00","009","0917","0471","808","373","435","31","839","1391","0","60.32","26.82"
"63","000","00","009","0917","0472","804","363","441","19","823","1342","0","61.33","27.05"
"63","000","00","009","0917","0473","731","315","416","31","762","1389","0","54.86","22.68"
"63","000","00","009","0918","0000","3201","1176","2025","129","3330","5592","0","59.55","21.03"
"63","000","00","009","0918","0474","837","354","483","34","871","1426","0","61.08","24.82"
"63","000","00","009","0918","0475","784","237","547","29","813","1359","0","59.82","17.44"
"63","000","00","009","0918","0476","745","261","484","47","792","1366","0","57.98","19.11"
"63","000","00","009","0918","0477","835","324","511","19","854","1441","0","59.26","22.48"
"63","000","00","009","0919","0000","2944","1205","1739","120","3064","4916","0","62.33","24.51"
"63","000","00","009","0919","0523","707","264","443","24","731","1162","0","62.91","22.72"
"63","000","00","009","0919","0524","608","240","368","22","630","1045","0","60.29","22.97"
"63","000","00","009","0919","0525","856","417","439","42","898","1351","0","66.47","30.87"
"63","000","00","009","0919","0526","773","284","489","32","805","1358","0","59.28","20.91"
"63","000","00","009","0920","0000","2656","1054","1602","84","2740","4580","0","59.83","23.01"
"63","000","00","009","0920","0487","781","302","479","31","812","1475","0","55.05","20.47"
"63","000","00","009","0920","0488","997","416","581","32","1029","1722","0","59.76","24.16"
"63","000","00","009","0920","0489","878","336","542","21","899","1383","0","65.0","24.3"
"63","000","00","010","0000","0000","132754","52518","80236","5283","138037","236824","287227","58.29","22.18"
"63","000","00","010","1001","0000","3560","1394","2166","172","3732","6500","0","57.42","21.45"
"63","000","00","010","1001","0305","852","323","529","18","870","1661","0","52.38","19.45"
"63","000","00","010","1001","0306","841","342","499","52","893","1602","0","55.74","21.35"
"63","000","00","010","1001","0307","938","342","596","71","1009","1655","0","60.97","20.66"
"63","000","00","010","1001","0308","929","387","542","31","960","1582","0","60.68","24.46"
"63","000","00","010","1002","0000","4652","1880","2772","209","4861","8357","0","58.17","22.5"
"63","000","00","010","1002","0309","915","383","532","24","939","1688","0","55.63","22.69"
"63","000","00","010","1002","0310","957","423","534","52","1009","1737","0","58.09","24.35"
"63","000","00","010","1002","0311","1023","429","594","44","1067","1809","0","58.98","23.71"
"63","000","00","010","1002","0312","765","288","477","22","787","1376","0","57.19","20.93"
"63","000","00","010","1002","0313","992","357","635","67","1059","1747","0","60.62","20.44"
"63","000","00","010","1003","0000","3574","1430","2144","127","3701","5914","0","62.58","24.18"
"63","000","00","010","1003","0314","822","310","512","23","845","1389","0","60.84","22.32"
"63","000","00","010","1003","0315","881","380","501","31","912","1454","0","62.72","26.13"
"63","000","00","010","1003","0316","901","365","536","34","935","1468","0","63.69","24.86"
"63","000","00","010","1003","0317","970","375","595","39","1009","1603","0","62.94","23.39"
"63","000","00","010","1005","0000","3029","1199","1830","117","3146","5276","0","59.63","22.73"
"63","000","00","010","1005","0318","976","373","603","28","1004","1795","0","55.93","20.78"
"63","000","00","010","1005","0319","1050","432","618","39","1089","1737","0","62.69","24.87"
"63","000","00","010","1005","0320","1003","394","609","50","1053","1744","0","60.38","22.59"
"63","000","00","010","1006","0000","2726","1102","1624","98","2824","4732","0","59.68","23.29"
"63","000","00","010","1006","0321","925","355","570","41","966","1661","0","58.16","21.37"
"63","000","00","010","1006","0322","889","382","507","31","920","1577","0","58.34","24.22"
"63","000","00","010","1006","0323","912","365","547","26","938","1494","0","62.78","24.43"
"63","000","00","010","1007","0000","4697","1784","2913","218","4915","8285","0","59.32","21.53"
"63","000","00","010","1007","0324","935","332","603","33","968","1626","0","59.53","20.42"
"63","000","00","010","1007","0325","924","328","596","55","979","1641","0","59.66","19.99"
"63","000","00","010","1007","0326","889","357","532","30","919","1554","0","59.14","22.97"
"63","000","00","010","1007","0327","994","412","582","59","1053","1728","0","60.94","23.84"
"63","000","00","010","1007","0328","955","355","600","41","996","1736","0","57.37","20.45"
"63","000","00","010","1008","0000","4459","1759","2700","149","4608","7740","0","59.53","22.73"
"63","000","00","010","1008","0329","899","344","555","39","938","1461","0","64.2","23.55"
"63","000","00","010","1008","0330","883","319","564","22","905","1509","0","59.97","21.14"
"63","000","00","010","1008","0331","757","319","438","24","781","1358","0","57.51","23.49"
"63","000","00","010","1008","0332","986","393","593","31","1017","1761","0","57.75","22.32"
"63","000","00","010","1008","0333","934","384","550","33","967","1651","0","58.57","23.26"
"63","000","00","010","1009","0000","2928","1069","1859","124","3052","5472","0","55.77","19.54"
"63","000","00","010","1009","0334","1032","396","636","53","1085","1809","0","59.98","21.89"
"63","000","00","010","1009","0335","995","384","611","42","1037","1773","0","58.49","21.66"
"63","000","00","010","1009","0336","901","289","612","29","930","1890","0","49.21","15.29"
"63","000","00","010","1010","0000","4281","1624","2657","158","4439","7310","0","60.73","22.22"
"63","000","00","010","1010","0337","1076","436","640","43","1119","1760","0","63.58","24.77"
"63","000","00","010","1010","0338","939","345","594","37","976","1645","0","59.33","20.97"
"63","000","00","010","1010","0339","793","321","472","22","815","1324","0","61.56","24.24"
"63","000","00","010","1010","0340","641","213","428","27","668","1072","0","62.31","19.87"
"63","000","00","010","1010","0341","832","309","523","29","861","1509","0","57.06","20.48"
"63","000","00","010","1011","0000","4064","1432","2632","163","4227","7069","0","59.8","20.26"
"63","000","00","010","1011","0342","940","374","566","68","1008","1715","0","58.78","21.81"
"63","000","00","010","1011","0343","1018","280","738","32","1050","1774","0","59.19","15.78"
"63","000","00","010","1011","0344","1121","422","699","32","1153","1796","0","64.2","23.5"
"63","000","00","010","1011","0345","985","356","629","31","1016","1784","0","56.95","19.96"
"63","000","00","010","1012","0000","2839","1227","1612","105","2944","4835","0","60.89","25.38"
"63","000","00","010","1012","0346","833","344","489","50","883","1417","0","62.31","24.28"
"63","000","00","010","1012","0347","959","435","524","21","980","1699","0","57.68","25.6"
"63","000","00","010","1012","0348","1047","448","599","34","1081","1719","0","62.89","26.06"
"63","000","00","010","1013","0000","2588","1023","1565","104","2692","4784","0","56.27","21.38"
"63","000","00","010","1013","0349","976","400","576","38","1014","1715","0","59.13","23.32"
"63","000","00","010","1013","0350","843","347","496","23","866","1634","0","53.0","21.24"
"63","000","00","010","1013","0351","769","276","493","43","812","1435","0","56.59","19.23"
"63","000","00","010","1014","0000","3274","1306","1968","149","3423","5804","0","58.98","22.5"
"63","000","00","010","1014","0352","807","324","483","30","837","1440","0","58.13","22.5"
"63","000","00","010","1014","0353","875","355","520","24","899","1446","0","62.17","24.55"
"63","000","00","010","1014","0354","861","346","515","43","904","1657","0","54.56","20.88"
"63","000","00","010","1014","0355","731","281","450","52","783","1261","0","62.09","22.28"
"63","000","00","010","1015","0000","3618","1438","2180","157","3775","6183","0","61.05","23.26"
"63","000","00","010","1015","0356","211","83","128","27","238","456","0","52.19","18.2"
"63","000","00","010","1015","0357","922","367","555","23","945","1433","0","65.95","25.61"
"63","000","00","010","1015","0358","866","333","533","25","891","1485","0","60.0","22.42"
"63","000","00","010","1015","0359","878","362","516","31","909","1590","0","57.17","22.77"
"63","000","00","010","1015","0360","741","293","448","51","792","1219","0","64.97","24.04"
"63","000","00","010","1016","0000","2847","1023","1824","126","2973","5096","0","58.34","20.07"
"63","000","00","010","1016","0361","926","326","600","49","975","1732","0","56.29","18.82"
"63","000","00","010","1016","0362","994","367","627","32","1026","1727","0","59.41","21.25"
"63","000","00","010","1016","0363","927","330","597","45","972","1637","0","59.38","20.16"
"63","000","00","010","1017","0000","4246","1701","2545","142","4388","7433","0","59.03","22.88"
"63","000","00","010","1017","0364","801","307","494","31","832","1453","0","57.26","21.13"
"63","000","00","010","1017","0365","889","331","558","28","917","1617","0","56.71","20.47"
"63","000","00","010","1017","0366","881","356","525","30","911","1604","0","56.8","22.19"
"63","000","00","010","1017","0367","875","362","513","22","897","1406","0","63.8","25.75"
"63","000","00","010","1017","0368","800","345","455","31","831","1353","0","61.42","25.5"
"63","000","00","010","1018","0000","3510","1611","1899","113","3623","6052","0","59.86","26.62"
"63","000","00","010","1018","0369","1017","641","376","32","1049","1724","0","60.85","37.18"
"63","000","00","010","1018","0370","806","322","484","29","835","1378","0","60.6","23.37"
"63","000","00","010","1018","0371","839","327","512","22","861","1403","0","61.37","23.31"
"63","000","00","010","1018","0372","848","321","527","30","878","1547","0","56.76","20.75"
"63","000","00","010","1019","0000","4177","1655","2522","167","4344","7177","0","60.53","23.06"
"63","000","00","010","1019","0373","1000","410","590","38","1038","1718","0","60.42","23.86"
"63","000","00","010","1019","0374","999","406","593","44","1043","1813","0","57.53","22.39"
"63","000","00","010","1019","0375","1080","404","676","46","1126","1791","0","62.87","22.56"
"63","000","00","010","1019","0376","1098","435","663","39","1137","1855","0","61.29","23.45"
"63","000","00","010","1020","0000","3953","1503","2450","153","4106","6880","0","59.68","21.85"
"63","000","00","010","1020","0377","991","356","635","23","1014","1731","0","58.58","20.57"
"63","000","00","010","1020","0378","981","412","569","42","1023","1593","0","64.22","25.86"
"63","000","00","010","1020","0379","1006","347","659","42","1048","1869","0","56.07","18.57"
"63","000","00","010","1020","0380","975","388","587","46","1021","1687","0","60.52","23.0"
"63","000","00","010","1021","0000","2469","896","1573","95","2564","4144","0","61.87","21.62"
"63","000","00","010","1021","0381","901","359","542","15","916","1530","0","59.87","23.46"
"63","000","00","010","1021","0382","760","283","477","43","803","1300","0","61.77","21.77"
"63","000","00","010","1021","0383","808","254","554","37","845","1314","0","64.31","19.33"
"63","000","00","010","1022","0000","4462","1970","2492","173","4635","8925","0","51.93","22.07"
"63","000","00","010","1022","0384","739","309","430","19","758","1433","0","52.9","21.56"
"63","000","00","010","1022","0385","772","317","455","25","797","1450","0","54.97","21.86"
"63","000","00","010","1022","0386","873","344","529","49","922","1608","0","57.34","21.39"
"63","000","00","010","1022","0387","813","336","477","32","845","1414","0","59.76","23.76"
"63","000","00","010","1022","0388","462","359","103","23","485","1492","0","32.51","24.06"
"63","000","00","010","1022","0389","803","305","498","25","828","1528","0","54.19","19.96"
"63","000","00","010","1023","0000","3650","1467","2183","130","3780","6634","0","56.98","22.11"
"63","000","00","010","1023","0390","951","365","586","30","981","1692","0","57.98","21.57"
"63","000","00","010","1023","0391","879","356","523","39","918","1556","0","59.0","22.88"
"63","000","00","010","1023","0392","885","343","542","31","916","1637","0","55.96","20.95"
"63","000","00","010","1023","0393","935","403","532","30","965","1749","0","55.17","23.04"
"63","000","00","010","1024","0000","4014","1562","2452","204","4218","7348","0","57.4","21.26"
"63","000","00","010","1024","0394","657","238","419","28","685","1220","0","56.15","19.51"
"63","000","00","010","1024","0395","873","330","543","51","924","1600","0","57.75","20.63"
"63","000","00","010","1024","0396","814","325","489","40","854","1473","0","57.98","22.06"
"63","000","00","010","1024","0397","806","328","478","51","857","1498","0","57.21","21.9"
"63","000","00","010","1024","0398","864","341","523","34","898","1557","0","57.68","21.9"
"63","000","00","010","1025","0000","2233","853","1380","116","2349","4190","0","56.06","20.36"
"63","000","00","010","1025","0399","871","337","534","28","899","1674","0","53.7","20.13"
"63","000","00","010","1025","0400","1009","387","622","33","1042","1728","0","60.3","22.4"
"63","000","00","010","1025","0401","353","129","224","55","408","788","0","51.78","16.37"
"63","000","00","010","1026","0000","3818","1486","2332","164","3982","7138","0","55.79","20.82"
"63","000","00","010","1026","0402","826","339","487","46","872","1542","0","56.55","21.98"
"63","000","00","010","1026","0403","796","343","453","55","851","1676","0","50.78","20.47"
"63","000","00","010","1026","0404","695","276","419","37","732","1360","0","53.82","20.29"
"63","000","00","010","1026","0405","788","280","508","16","804","1259","0","63.86","22.24"
"63","000","00","010","1026","0406","713","248","465","10","723","1301","0","55.57","19.06"
"63","000","00","010","1027","0000","3215","1238","1977","139","3354","5998","0","55.92","20.64"
"63","000","00","010","1027","0407","614","244","370","29","643","1251","0","51.4","19.5"
"63","000","00","010","1027","0408","804","321","483","56","860","1502","0","57.26","21.37"
"63","000","00","010","1027","0409","868","307","561","35","903","1596","0","56.58","19.24"
"63","000","00","010","1027","0410","929","366","563","19","948","1649","0","57.49","22.2"
"63","000","00","010","1028","0000","1881","726","1155","61","1942","3520","0","55.17","20.63"
"63","000","00","010","1028","0411","944","375","569","37","981","1774","0","55.3","21.14"
"63","000","00","010","1028","0412","937","351","586","24","961","1746","0","55.04","20.1"
"63","000","00","010","1029","0000","3478","1402","2076","150","3628","7676","0","47.26","18.26"
"63","000","00","010","1029","0413","807","301","506","23","830","1473","0","56.35","20.43"
"63","000","00","010","1029","0414","932","374","558","37","969","2824","0","34.31","13.24"
"63","000","00","010","1029","0415","932","409","523","31","963","1849","0","52.08","22.12"
"63","000","00","010","1029","0416","807","318","489","59","866","1530","0","56.6","20.78"
"63","000","00","010","1030","0000","2726","1076","1650","106","2832","4808","0","58.9","22.38"
"63","000","00","010","1030","0417","909","372","537","40","949","1656","0","57.31","22.46"
"63","000","00","010","1030","0418","834","353","481","30","864","1457","0","59.3","24.23"
"63","000","00","010","1030","0419","983","351","632","36","1019","1695","0","60.12","20.71"
"63","000","00","010","1031","0000","3775","1513","2262","125","3900","6644","0","58.7","22.77"
"63","000","00","010","1031","0420","959","382","577","27","986","1663","0","59.29","22.97"
"63","000","00","010","1031","0421","911","339","572","37","948","1654","0","57.32","20.5"
"63","000","00","010","1031","0422","950","394","556","36","986","1642","0","60.05","24.0"
"63","000","00","010","1031","0423","955","398","557","25","980","1685","0","58.16","23.62"
"63","000","00","010","1032","0000","3203","1220","1983","132","3335","5552","0","60.07","21.97"
"63","000","00","010","1032","0424","1003","371","632","46","1049","1862","0","56.34","19.92"
"63","000","00","010","1032","0425","1100","454","646","40","1140","1900","0","60.0","23.89"
"63","000","00","010","1032","0426","1100","395","705","46","1146","1790","0","64.02","22.07"
"63","000","00","010","1033","0000","2573","958","1615","136","2709","4787","0","56.59","20.01"
"63","000","00","010","1033","0427","777","304","473","41","818","1417","0","57.73","21.45"
"63","000","00","010","1033","0428","934","347","587","36","970","1694","0","57.26","20.48"
"63","000","00","010","1033","0429","862","307","555","59","921","1676","0","54.95","18.32"
"63","000","00","010","1034","0000","4628","1883","2745","174","4802","8109","0","59.22","23.22"
"63","000","00","010","1034","0430","920","388","532","15","935","1643","0","56.91","23.62"
"63","000","00","010","1034","0431","904","364","540","36","940","1588","0","59.19","22.92"
"63","000","00","010","1034","0432","904","365","539","53","957","1603","0","59.7","22.77"
"63","000","00","010","1034","0433","921","371","550","31","952","1629","0","58.44","22.77"
"63","000","00","010","1034","0434","979","395","584","39","1018","1646","0","61.85","24.0"
"63","000","00","010","1035","0000","4186","1602","2584","154","4340","7457","0","58.2","21.48"
"63","000","00","010","1035","0435","1014","369","645","30","1044","1883","0","55.44","19.6"
"63","000","00","010","1035","0436","812","318","494","27","839","1434","0","58.51","22.18"
"63","000","00","010","1035","0437","798","312","486","18","816","1418","0","57.55","22.0"
"63","000","00","010","1035","0438","784","296","488","40","824","1373","0","60.01","21.56"
"63","000","00","010","1035","0439","778","307","471","39","817","1349","0","60.56","22.76"
"63","000","00","010","1036","0000","2712","1068","1644","95","2807","4624","0","60.71","23.1"
"63","000","00","010","1036","0440","896","341","555","36","932","1511","0","61.68","22.57"
"63","000","00","010","1036","0441","948","382","566","28","976","1563","0","62.44","24.44"
"63","000","00","010","1036","0442","868","345","523","31","899","1550","0","58.0","22.26"
"63","000","00","010","1037","0000","615","266","349","39","654","1157","0","56.53","22.99"
"63","000","00","010","1037","0443","615","266","349","39","654","1157","0","56.53","22.99"
"63","000","00","010","1038","0000","2920","1213","1707","124","3044","5175","0","58.82","23.44"
"63","000","00","010","1038","0444","1005","429","576","32","1037","1768","0","58.65","24.26"
"63","000","00","010","1038","0445","933","362","571","46","979","1664","0","58.83","21.75"
"63","000","00","010","1038","0446","982","422","560","46","1028","1743","0","58.98","24.21"
"63","000","00","010","1039","0000","4315","1735","2580","126","4441","7392","0","60.08","23.47"
"63","000","00","010","1039","0447","863","333","530","20","883","1480","0","59.66","22.5"
"63","000","00","010","1039","0448","939","398","541","43","982","1589","0","61.8","25.05"
"63","000","00","010","1039","0449","758","299","459","27","785","1371","0","57.26","21.81"
"63","000","00","010","1039","0450","962","376","586","18","980","1575","0","62.22","23.87"
"63","000","00","010","1039","0451","793","329","464","18","811","1377","0","58.9","23.89"
"63","000","00","010","1040","0000","2859","1224","1635","89","2948","4647","0","63.44","26.34"
"63","000","00","010","1040","0452","926","402","524","44","970","1469","0","66.03","27.37"
"63","000","00","010","1040","0453","952","388","564","15","967","1529","0","63.24","25.38"
"63","000","00","010","1040","0454","981","434","547","30","1011","1649","0","61.31","26.32"
"63","000","00","011","0000","0000","131099","51855","79244","7642","138741","241854","286695","57.37","21.44"
"63","000","00","011","1101","0000","1840","728","1112","150","1990","3415","0","58.27","21.32"
"63","000","00","011","1101","0142","899","350","549","63","962","1695","0","56.76","20.65"
"63","000","00","011","1101","0143","941","378","563","87","1028","1720","0","59.77","21.98"
"63","000","00","011","1102","0000","1498","585","913","113","1611","2834","0","56.85","20.64"
"63","000","00","011","1102","0144","677","259","418","66","743","1288","0","57.69","20.11"
"63","000","00","011","1102","0145","821","326","495","47","868","1546","0","56.14","21.09"
"63","000","00","011","1103","0000","1508","594","914","95","1603","2659","0","60.29","22.34"
"63","000","00","011","1103","0146","389","162","227","22","411","652","0","63.04","24.85"
"63","000","00","011","1103","0147","448","166","282","30","478","870","0","54.94","19.08"
"63","000","00","011","1103","0148","671","266","405","43","714","1137","0","62.8","23.39"
"63","000","00","011","1104","0000","2329","895","1434","137","2466","5331","0","46.26","16.79"
"63","000","00","011","1104","0149","620","235","385","41","661","1050","0","62.95","22.38"
"63","000","00","011","1104","0150","600","222","378","42","642","1031","0","62.27","21.53"
"63","000","00","011","1104","0151","629","241","388","13","642","1075","0","59.72","22.42"
"63","000","00","011","1104","0152","480","197","283","41","521","2175","0","23.95","9.06"
"63","000","00","011","1105","0000","3741","1457","2284","220","3961","6757","0","58.62","21.56"
"63","000","00","011","1105","0153","870","322","548","76","946","1775","0","53.3","18.14"
"63","000","00","011","1105","0154","941","348","593","36","977","1669","0","58.54","20.85"
"63","000","00","011","1105","0155","956","405","551","56","1012","1665","0","60.78","24.32"
"63","000","00","011","1105","0156","974","382","592","52","1026","1648","0","62.26","23.18"
"63","000","00","011","1106","0000","3105","1238","1867","197","3302","5565","0","59.34","22.25"
"63","000","00","011","1106","0157","704","246","458","21","725","1246","0","58.19","19.74"
"63","000","00","011","1106","0158","764","320","444","55","819","1419","0","57.72","22.55"
"63","000","00","011","1106","0159","714","294","420","68","782","1327","0","58.93","22.16"
"63","000","00","011","1106","0160","923","378","545","53","976","1573","0","62.05","24.03"
"63","000","00","011","1107","0000","3786","1389","2397","170","3956","6779","0","58.36","20.49"
"63","000","00","011","1107","0161","816","300","516","58","874","1470","0","59.46","20.41"
"63","000","00","011","1107","0162","988","357","631","32","1020","1775","0","57.46","20.11"
"63","000","00","011","1107","0163","952","340","612","35","987","1692","0","58.33","20.09"
"63","000","00","011","1107","0164","1030","392","638","45","1075","1842","0","58.36","21.28"
"63","000","00","011","1108","0000","3983","1561","2422","259","4242","7204","0","58.88","21.67"
"63","000","00","011","1108","0165","680","254","426","38","718","1166","0","61.58","21.78"
"63","000","00","011","1108","0166","820","319","501","66","886","1687","0","52.52","18.91"
"63","000","00","011","1108","0167","884","371","513","51","935","1624","0","57.57","22.84"
"63","000","00","011","1108","0168","862","330","532","68","930","1477","0","62.97","22.34"
"63","000","00","011","1108","0169","737","287","450","36","773","1250","0","61.84","22.96"
"63","000","00","011","1109","0000","3402","1340","2062","220","3622","5934","0","61.04","22.58"
"63","000","00","011","1109","0170","795","325","470","57","852","1434","0","59.41","22.66"
"63","000","00","011","1109","0171","821","336","485","54","875","1452","0","60.26","23.14"
"63","000","00","011","1109","0172","915","347","568","48","963","1533","0","62.82","22.64"
"63","000","00","011","1109","0173","871","332","539","61","932","1515","0","61.52","21.91"
"63","000","00","011","1110","0000","2261","912","1349","124","2385","3942","0","60.5","23.14"
"63","000","00","011","1110","0174","696","295","401","37","733","1203","0","60.93","24.52"
"63","000","00","011","1110","0175","868","355","513","59","927","1487","0","62.34","23.87"
"63","000","00","011","1110","0176","697","262","435","28","725","1252","0","57.91","20.93"
"63","000","00","011","1111","0000","3504","1359","2145","186","3690","6175","0","59.76","22.01"
"63","000","00","011","1111","0177","845","318","527","40","885","1536","0","57.62","20.7"
"63","000","00","011","1111","0178","897","324","573","49","946","1556","0","60.8","20.82"
"63","000","00","011","1111","0179","847","338","509","49","896","1511","0","59.3","22.37"
"63","000","00","011","1111","0180","915","379","536","48","963","1572","0","61.26","24.11"
"63","000","00","011","1112","0000","2765","1039","1726","201","2966","4921","0","60.27","21.11"
"63","000","00","011","1112","0181","909","325","584","63","972","1668","0","58.27","19.48"
"63","000","00","011","1112","0182","1000","358","642","90","1090","1685","0","64.69","21.25"
"63","000","00","011","1112","0183","856","356","500","48","904","1568","0","57.65","22.7"
"63","000","00","011","1113","0000","2923","1144","1779","212","3135","5632","0","55.66","20.31"
"63","000","00","011","1113","0184","687","272","415","45","732","1327","0","55.16","20.5"
"63","000","00","011","1113","0185","692","250","442","62","754","1338","0","56.35","18.68"
"63","000","00","011","1113","0186","742","292","450","54","796","1515","0","52.54","19.27"
"63","000","00","011","1113","0187","802","330","472","51","853","1452","0","58.75","22.73"
"63","000","00","011","1114","0000","2476","1073","1403","123","2599","4430","0","58.67","24.22"
"63","000","00","011","1114","0188","810","320","490","37","847","1448","0","58.49","22.1"
"63","000","00","011","1114","0189","861","419","442","50","911","1521","0","59.89","27.55"
"63","000","00","011","1114","0190","805","334","471","36","841","1461","0","57.56","22.86"
"63","000","00","011","1115","0000","2340","954","1386","158","2498","4747","0","52.62","20.1"
"63","000","00","011","1115","0191","775","330","445","65","840","1541","0","54.51","21.41"
"63","000","00","011","1115","0192","721","303","418","36","757","1611","0","46.99","18.81"
"63","000","00","011","1115","0193","844","321","523","57","901","1595","0","56.49","20.13"
"63","000","00","011","1116","0000","2645","1001","1644","186","2831","5188","0","54.57","19.29"
"63","000","00","011","1116","0194","838","321","517","45","883","1685","0","52.4","19.05"
"63","000","00","011","1116","0195","923","350","573","61","984","1816","0","54.19","19.27"
"63","000","00","011","1116","0196","884","330","554","80","964","1687","0","57.14","19.56"
"63","000","00","011","1117","0000","3557","1276","2281","219","3776","6631","0","56.94","19.24"
"63","000","00","011","1117","0197","866","314","552","71","937","1646","0","56.93","19.08"
"63","000","00","011","1117","0198","846","302","544","44","890","1643","0","54.17","18.38"
"63","000","00","011","1117","0199","919","321","598","51","970","1687","0","57.5","19.03"
"63","000","00","011","1117","0200","926","339","587","53","979","1655","0","59.15","20.48"
"63","000","00","011","1118","0000","1960","788","1172","80","2040","3634","0","56.14","21.68"
"63","000","00","011","1118","0201","918","369","549","36","954","1779","0","53.63","20.74"
"63","000","00","011","1118","0202","1042","419","623","44","1086","1855","0","58.54","22.59"
"63","000","00","011","1119","0000","2779","1220","1559","167","2946","5700","0","51.68","21.4"
"63","000","00","011","1119","0203","746","298","448","41","787","1350","0","58.3","22.07"
"63","000","00","011","1119","0204","726","252","474","34","760","1455","0","52.23","17.32"
"63","000","00","011","1119","0205","671","280","391","53","724","1497","0","48.36","18.7"
"63","000","00","011","1119","0206","636","390","246","39","675","1398","0","48.28","27.9"
"63","000","00","011","1120","0000","4184","1605","2579","332","4516","8041","0","56.16","19.96"
"63","000","00","011","1120","0207","964","358","606","63","1027","1747","0","58.79","20.49"
"63","000","00","011","1120","0208","756","304","452","70","826","1465","0","56.38","20.75"
"63","000","00","011","1120","0209","792","287","505","64","856","1530","0","55.95","18.76"
"63","000","00","011","1120","0210","907","350","557","65","972","1855","0","52.4","18.87"
"63","000","00","011","1120","0211","765","306","459","70","835","1444","0","57.83","21.19"
"63","000","00","011","1121","0000","3332","1307","2025","249","3581","6387","0","56.07","20.46"
"63","000","00","011","1121","0212","776","317","459","54","830","1563","0","53.1","20.28"
"63","000","00","011","1121","0213","796","296","500","59","855","1482","0","57.69","19.97"
"63","000","00","011","1121","0214","809","339","470","74","883","1552","0","56.89","21.84"
"63","000","00","011","1121","0215","951","355","596","62","1013","1790","0","56.59","19.83"
"63","000","00","011","1122","0000","3244","1242","2002","281","3525","6383","0","55.22","19.46"
"63","000","00","011","1122","0216","794","289","505","68","862","1628","0","52.95","17.75"
"63","000","00","011","1122","0217","716","282","434","53","769","1337","0","57.52","21.09"
"63","000","00","011","1122","0218","921","361","560","73","994","1750","0","56.8","20.63"
"63","000","00","011","1122","0219","813","310","503","87","900","1668","0","53.96","18.59"
"63","000","00","011","1123","0000","1945","727","1218","146","2091","4342","0","48.16","16.74"
"63","000","00","011","1123","0220","605","221","384","60","665","1403","0","47.4","15.75"
"63","000","00","011","1123","0221","660","263","397","40","700","1468","0","47.68","17.92"
"63","000","00","011","1123","0222","680","243","437","46","726","1471","0","49.35","16.52"
"63","000","00","011","1124","0000","2462","916","1546","193","2655","5240","0","50.67","17.48"
"63","000","00","011","1124","0223","804","281","523","66","870","1666","0","52.22","16.87"
"63","000","00","011","1124","0224","771","308","463","64","835","1587","0","52.61","19.41"
"63","000","00","011","1124","0225","887","327","560","63","950","1987","0","47.81","16.46"
"63","000","00","011","1125","0000","1626","639","987","67","1693","2999","0","56.45","21.31"
"63","000","00","011","1125","0226","636","252","384","20","656","1271","0","51.61","19.83"
"63","000","00","011","1125","0227","990","387","603","47","1037","1728","0","60.01","22.4"
"63","000","00","011","1126","0000","3603","1405","2198","184","3787","6297","0","60.14","22.31"
"63","000","00","011","1126","0228","922","360","562","57","979","1630","0","60.06","22.09"
"63","000","00","011","1126","0229","923","355","568","40","963","1619","0","59.48","21.93"
"63","000","00","011","1126","0230","793","300","493","42","835","1425","0","58.6","21.05"
"63","000","00","011","1126","0231","965","390","575","45","1010","1623","0","62.23","24.03"
"63","000","00","011","1127","0000","2243","903","1340","140","2383","3862","0","61.7","23.38"
"63","000","00","011","1127","0242","770","321","449","60","830","1273","0","65.2","25.22"
"63","000","00","011","1127","0243","730","282","448","39","769","1273","0","60.41","22.15"
"63","000","00","011","1127","0244","743","300","443","41","784","1316","0","59.57","22.8"
"63","000","00","011","1128","0000","2682","1115","1567","159","2841","4960","0","57.28","22.48"
"63","000","00","011","1128","0245","899","354","545","65","964","1659","0","58.11","21.34"
"63","000","00","011","1128","0246","950","423","527","41","991","1749","0","56.66","24.19"
"63","000","00","011","1128","0247","833","338","495","53","886","1552","0","57.09","21.78"
"63","000","00","011","1129","0000","2643","1036","1607","119","2762","4457","0","61.97","23.24"
"63","000","00","011","1129","0232","874","350","524","56","930","1564","0","59.46","22.38"
"63","000","00","011","1129","0233","856","366","490","36","892","1376","0","64.83","26.6"
"63","000","00","011","1129","0234","913","320","593","27","940","1517","0","61.96","21.09"
"63","000","00","011","1130","0000","2703","959","1744","134","2837","4952","0","57.29","19.37"
"63","000","00","011","1130","0248","867","294","573","45","912","1529","0","59.65","19.23"
"63","000","00","011","1130","0249","876","289","587","39","915","1644","0","55.66","17.58"
"63","000","00","011","1130","0250","960","376","584","50","1010","1779","0","56.77","21.14"
"63","000","00","011","1131","0000","3710","1476","2234","140","3850","6584","0","58.48","22.42"
"63","000","00","011","1131","0235","884","358","526","39","923","1729","0","53.38","20.71"
"63","000","00","011","1131","0236","894","344","550","35","929","1511","0","61.48","22.77"
"63","000","00","011","1131","0237","1054","413","641","36","1090","1811","0","60.19","22.81"
"63","000","00","011","1131","0238","878","361","517","30","908","1533","0","59.23","23.55"
"63","000","00","011","1132","0000","2624","979","1645","117","2741","4558","0","60.14","21.48"
"63","000","00","011","1132","0239","1030","415","615","43","1073","1657","0","64.76","25.05"
"63","000","00","011","1132","0240","830","329","501","25","855","1499","0","57.04","21.95"
"63","000","00","011","1132","0241","764","235","529","49","813","1402","0","57.99","16.76"
"63","000","00","011","1133","0000","2778","1099","1679","148","2926","5127","0","57.07","21.44"
"63","000","00","011","1133","0260","982","367","615","58","1040","1826","0","56.96","20.1"
"63","000","00","011","1133","0261","903","370","533","39","942","1647","0","57.19","22.47"
"63","000","00","011","1133","0262","893","362","531","51","944","1654","0","57.07","21.89"
"63","000","00","011","1134","0000","4219","1745","2474","193","4412","7652","0","57.66","22.8"
"63","000","00","011","1134","0251","875","353","522","38","913","1597","0","57.17","22.1"
"63","000","00","011","1134","0252","797","326","471","40","837","1454","0","57.57","22.42"
"63","000","00","011","1134","0253","914","390","524","52","966","1582","0","61.06","24.65"
"63","000","00","011","1134","0254","853","358","495","44","897","1518","0","59.09","23.58"
"63","000","00","011","1134","0255","780","318","462","19","799","1501","0","53.23","21.19"
"63","000","00","011","1135","0000","3334","1388","1946","165","3499","5690","0","61.49","24.39"
"63","000","00","011","1135","0256","822","335","487","38","860","1420","0","60.56","23.59"
"63","000","00","011","1135","0257","833","335","498","51","884","1494","0","59.17","22.42"
"63","000","00","011","1135","0258","949","398","551","37","986","1568","0","62.88","25.38"
"63","000","00","011","1135","0259","730","320","410","39","769","1208","0","63.66","26.49"
"63","000","00","011","1136","0000","3176","1357","1819","162","3338","5497","0","60.72","24.69"
"63","000","00","011","1136","0263","900","368","532","37","937","1550","0","60.45","23.74"
"63","000","00","011","1136","0264","792","365","427","27","819","1298","0","63.1","28.12"
"63","000","00","011","1136","0265","764","312","452","49","813","1297","0","62.68","24.06"
"63","000","00","011","1136","0266","720","312","408","49","769","1352","0","56.88","23.08"
"63","000","00","011","1137","0000","2493","1038","1455","136","2629","4565","0","57.59","22.74"
"63","000","00","011","1137","0267","837","317","520","40","877","1522","0","57.62","20.83"
"63","000","00","011","1137","0268","852","389","463","58","910","1602","0","56.8","24.28"
"63","000","00","011","1137","0269","804","332","472","38","842","1441","0","58.43","23.04"
"63","000","00","011","1138","0000","2390","1119","1271","90","2480","4410","0","56.24","25.37"
"63","000","00","011","1138","0270","710","320","390","15","725","1325","0","54.72","24.15"
"63","000","00","011","1138","0271","858","352","506","48","906","1567","0","57.82","22.46"
"63","000","00","011","1138","0272","822","447","375","27","849","1518","0","55.93","29.45"
"63","000","00","011","1139","0000","3713","1526","2187","144","3857","6605","0","58.4","23.1"
"63","000","00","011","1139","0273","911","357","554","36","947","1549","0","61.14","23.05"
"63","000","00","011","1139","0274","912","403","509","25","937","1652","0","56.72","24.39"
"63","000","00","011","1139","0275","1005","406","599","59","1064","1766","0","60.25","22.99"
"63","000","00","011","1139","0276","885","360","525","24","909","1638","0","55.49","21.98"
"63","000","00","011","1140","0000","3424","1303","2121","132","3556","6105","0","58.25","21.34"
"63","000","00","011","1140","0277","868","312","556","36","904","1491","0","60.63","20.93"
"63","000","00","011","1140","0278","867","336","531","24","891","1521","0","58.58","22.09"
"63","000","00","011","1140","0279","782","294","488","45","827","1351","0","61.21","21.76"
"63","000","00","011","1140","0280","907","361","546","27","934","1742","0","53.62","20.72"
"63","000","00","011","1141","0000","4207","1830","2377","169","4376","7594","0","57.62","24.1"
"63","000","00","011","1141","0281","847","370","477","39","886","1585","0","55.9","23.34"
"63","000","00","011","1141","0282","863","318","545","31","894","1521","0","58.78","20.91"
"63","000","00","011","1141","0283","844","360","484","22","866","1543","0","56.12","23.33"
"63","000","00","011","1141","0284","808","295","513","29","837","1404","0","59.62","21.01"
"63","000","00","011","1141","0285","845","487","358","48","893","1541","0","57.95","31.6"
"63","000","00","011","1142","0000","3149","1239","1910","135","3284","5828","0","56.35","21.26"
"63","000","00","011","1142","0286","850","323","527","30","880","1584","0","55.56","20.39"
"63","000","00","011","1142","0287","869","341","528","41","910","1519","0","59.91","22.45"
"63","000","00","011","1142","0288","762","304","458","24","786","1482","0","53.04","20.51"
"63","000","00","011","1142","0289","668","271","397","40","708","1243","0","56.96","21.8"
"63","000","00","011","1143","0000","616","229","387","47","663","1156","0","57.35","19.81"
"63","000","00","011","1143","0290","616","229","387","47","663","1156","0","57.35","19.81"
"63","000","00","011","1144","0000","607","241","366","76","683","1262","0","54.12","19.1"
"63","000","00","011","1144","0291","607","241","366","76","683","1262","0","54.12","19.1"
"63","000","00","011","1145","0000","996","384","612","64","1060","1747","0","60.68","21.98"
"63","000","00","011","1145","0292","498","179","319","35","533","889","0","59.96","20.13"
"63","000","00","011","1145","0293","498","205","293","29","527","858","0","61.42","23.89"
"63","000","00","011","1146","0000","1422","545","877","137","1559","2781","0","56.06","19.6"
"63","000","00","011","1146","0294","478","199","279","51","529","945","0","55.98","21.06"
"63","000","00","011","1146","0295","488","185","303","47","535","960","0","55.73","19.27"
"63","000","00","011","1146","0296","456","161","295","39","495","876","0","56.51","18.38"
"63","000","00","011","1147","0000","849","308","541","89","938","1475","0","63.59","20.88"
"63","000","00","011","1147","0297","331","137","194","33","364","556","0","65.47","24.64"
"63","000","00","011","1147","0298","518","171","347","56","574","919","0","62.46","18.61"
"63","000","00","011","1148","0000","814","309","505","88","902","1360","0","66.32","22.72"
"63","000","00","011","1148","0299","814","309","505","88","902","1360","0","66.32","22.72"
"63","000","00","011","1149","0000","772","274","498","61","833","1355","0","61.48","20.22"
"63","000","00","011","1149","0300","772","274","498","61","833","1355","0","61.48","20.22"
"63","000","00","011","1150","0000","1417","549","868","63","1480","2434","0","60.81","22.56"
"63","000","00","011","1150","0301","714","273","441","26","740","1252","0","59.11","21.81"
"63","000","00","011","1150","0302","703","276","427","37","740","1182","0","62.61","23.35"
"63","000","00","011","1151","0000","1320","510","810","65","1385","2671","0","51.85","19.09"
"63","000","00","011","1151","0303","674","262","412","31","705","1431","0","49.27","18.31"
"63","000","00","011","1151","0304","646","248","398","34","680","1240","0","54.84","20.0"
"63","000","00","012","0000","0000","114092","44378","69714","6007","120099","213250","255631","56.32","20.81"
"63","000","00","012","1201","0000","2199","1055","1144","134","2333","3797","0","61.44","27.79"
"63","000","00","012","1201","0001","748","462","286","55","803","1313","0","61.16","35.19"
"63","000","00","012","1201","0002","825","319","506","45","870","1403","0","62.01","22.74"
"63","000","00","012","1201","0003","626","274","352","34","660","1081","0","61.05","25.35"
"63","000","00","012","1202","0000","2151","891","1260","128","2279","3798","0","60.01","23.46"
"63","000","00","012","1202","0004","681","292","389","48","729","1209","0","60.3","24.15"
"63","000","00","012","1202","0005","744","303","441","38","782","1326","0","58.97","22.85"
"63","000","00","012","1202","0006","726","296","430","42","768","1263","0","60.81","23.44"
"63","000","00","012","1203","0000","2623","1031","1592","164","2787","4640","0","60.06","22.22"
"63","000","00","012","1203","0007","901","370","531","62","963","1580","0","60.95","23.42"
"63","000","00","012","1203","0008","887","330","557","44","931","1577","0","59.04","20.93"
"63","000","00","012","1203","0009","835","331","504","58","893","1483","0","60.22","22.32"
"63","000","00","012","1204","0000","3289","1231","2058","167","3456","6090","0","56.75","20.21"
"63","000","00","012","1204","0010","785","310","475","38","823","1461","0","56.33","21.22"
"63","000","00","012","1204","0011","776","321","455","51","827","1466","0","56.41","21.9"
"63","000","00","012","1204","0012","920","320","600","48","968","1620","0","59.75","19.75"
"63","000","00","012","1204","0013","808","280","528","30","838","1543","0","54.31","18.15"
"63","000","00","012","1205","0000","3402","1250","2152","194","3596","6230","0","57.72","20.06"
"63","000","00","012","1205","0014","772","282","490","55","827","1513","0","54.66","18.64"
"63","000","00","012","1205","0015","848","300","548","40","888","1534","0","57.89","19.56"
"63","000","00","012","1205","0016","925","337","588","59","984","1650","0","59.64","20.42"
"63","000","00","012","1205","0017","857","331","526","40","897","1533","0","58.51","21.59"
"63","000","00","012","1206","0000","3621","1573","2048","165","3786","6528","0","58.0","24.1"
"63","000","00","012","1206","0018","916","367","549","30","946","1702","0","55.58","21.56"
"63","000","00","012","1206","0019","946","438","508","33","979","1721","0","56.89","25.45"
"63","000","00","012","1206","0020","919","415","504","45","964","1575","0","61.21","26.35"
"63","000","00","012","1206","0021","840","353","487","57","897","1530","0","58.63","23.07"
"63","000","00","012","1207","0000","3577","1365","2212","176","3753","6810","0","55.11","20.04"
"63","000","00","012","1207","0022","961","361","600","47","1008","1728","0","58.33","20.89"
"63","000","00","012","1207","0023","937","350","587","44","981","1702","0","57.64","20.56"
"63","000","00","012","1207","0024","907","363","544","55","962","1696","0","56.72","21.4"
"63","000","00","012","1207","0025","772","291","481","30","802","1684","0","47.62","17.28"
"63","000","00","012","1208","0000","3793","1416","2377","168","3961","6642","0","59.64","21.32"
"63","000","00","012","1208","0026","988","384","604","44","1032","1717","0","60.1","22.36"
"63","000","00","012","1208","0027","920","350","570","25","945","1605","0","58.88","21.81"
"63","000","00","012","1208","0028","932","320","612","59","991","1723","0","57.52","18.57"
"63","000","00","012","1208","0029","953","362","591","40","993","1597","0","62.18","22.67"
"63","000","00","012","1209","0000","4320","1794","2526","170","4490","7993","0","56.17","22.44"
"63","000","00","012","1209","0030","945","350","595","33","978","1700","0","57.53","20.59"
"63","000","00","012","1209","0031","771","434","337","32","803","1544","0","52.01","28.11"
"63","000","00","012","1209","0032","854","329","525","37","891","1635","0","54.5","20.12"
"63","000","00","012","1209","0033","850","327","523","27","877","1495","0","58.66","21.87"
"63","000","00","012","1209","0034","900","354","546","41","941","1619","0","58.12","21.87"
"63","000","00","012","1210","0000","3117","1078","2039","124","3241","6869","0","47.18","15.69"
"63","000","00","012","1210","0035","546","35","511","38","584","1683","0","34.7","2.08"
"63","000","00","012","1210","0036","825","330","495","45","870","1662","0","52.35","19.86"
"63","000","00","012","1210","0037","888","340","548","21","909","1850","0","49.14","18.38"
"63","000","00","012","1210","0038","858","373","485","20","878","1674","0","52.45","22.28"
"63","000","00","012","1211","0000","2397","866","1531","133","2530","4183","0","60.48","20.7"
"63","000","00","012","1211","0039","860","298","562","60","920","1511","0","60.89","19.72"
"63","000","00","012","1211","0040","775","279","496","26","801","1393","0","57.5","20.03"
"63","000","00","012","1211","0041","762","289","473","47","809","1279","0","63.25","22.6"
"63","000","00","012","1212","0000","2311","900","1411","121","2432","3837","0","63.38","23.46"
"63","000","00","012","1212","0042","606","254","352","28","634","1122","0","56.51","22.64"
"63","000","00","012","1212","0043","831","312","519","48","879","1238","0","71.0","25.2"
"63","000","00","012","1212","0044","874","334","540","45","919","1477","0","62.22","22.61"
"63","000","00","012","1213","0000","3387","1197","2190","167","3554","5857","0","60.68","20.44"
"63","000","00","012","1213","0045","872","327","545","45","917","1495","0","61.34","21.87"
"63","000","00","012","1213","0046","898","318","580","32","930","1469","0","63.31","21.65"
"63","000","00","012","1213","0047","813","273","540","45","858","1462","0","58.69","18.67"
"63","000","00","012","1213","0048","804","279","525","45","849","1431","0","59.33","19.5"
"63","000","00","012","1214","0000","2500","1026","1474","113","2613","4391","0","59.51","23.37"
"63","000","00","012","1214","0049","831","348","483","37","868","1486","0","58.41","23.42"
"63","000","00","012","1214","0050","841","328","513","44","885","1449","0","61.08","22.64"
"63","000","00","012","1214","0051","828","350","478","32","860","1456","0","59.07","24.04"
"63","000","00","012","1215","0000","2242","851","1391","114","2356","4005","0","58.83","21.25"
"63","000","00","012","1215","0052","732","277","455","31","763","1311","0","58.2","21.13"
"63","000","00","012","1215","0053","766","293","473","46","812","1356","0","59.88","21.61"
"63","000","00","012","1215","0054","744","281","463","37","781","1338","0","58.37","21.0"
"63","000","00","012","1216","0000","2492","958","1534","96","2588","4644","0","55.73","20.63"
"63","000","00","012","1216","0055","859","324","535","31","890","1525","0","58.36","21.25"
"63","000","00","012","1216","0056","847","344","503","44","891","1620","0","55.0","21.23"
"63","000","00","012","1216","0057","786","290","496","21","807","1499","0","53.84","19.35"
"63","000","00","012","1217","0000","4210","1621","2589","239","4449","7724","0","57.6","20.99"
"63","000","00","012","1217","0058","867","300","567","28","895","1497","0","59.79","20.04"
"63","000","00","012","1217","0059","883","362","521","43","926","1624","0","57.02","22.29"
"63","000","00","012","1217","0060","778","294","484","62","840","1536","0","54.69","19.14"
"63","000","00","012","1217","0061","838","330","508","58","896","1469","0","60.99","22.46"
"63","000","00","012","1217","0062","844","335","509","48","892","1598","0","55.82","20.96"
"63","000","00","012","1218","0000","2599","1031","1568","161","2760","4923","0","56.06","20.94"
"63","000","00","012","1218","0063","901","370","531","27","928","1690","0","54.91","21.89"
"63","000","00","012","1218","0064","818","291","527","92","910","1599","0","56.91","18.2"
"63","000","00","012","1218","0065","880","370","510","42","922","1634","0","56.43","22.64"
"63","000","00","012","1219","0000","851","346","505","34","885","1660","0","53.31","20.84"
"63","000","00","012","1219","0066","851","346","505","34","885","1660","0","53.31","20.84"
"63","000","00","012","1220","0000","4892","1922","2970","249","5141","9045","0","56.84","21.25"
"63","000","00","012","1220","0067","942","378","564","58","1000","1900","0","52.63","19.89"
"63","000","00","012","1220","0068","970","402","568","50","1020","1797","0","56.76","22.37"
"63","000","00","012","1220","0069","1025","413","612","42","1067","1832","0","58.24","22.54"
"63","000","00","012","1220","0070","997","363","634","49","1046","1784","0","58.63","20.35"
"63","000","00","012","1220","0071","958","366","592","50","1008","1732","0","58.2","21.13"
"63","000","00","012","1221","0000","3974","1530","2444","280","4254","8470","0","50.22","18.06"
"63","000","00","012","1221","0072","515","220","295","46","561","2035","0","27.57","10.81"
"63","000","00","012","1221","0073","802","333","469","57","859","1504","0","57.11","22.14"
"63","000","00","012","1221","0074","966","333","633","55","1021","1683","0","60.67","19.79"
"63","000","00","012","1221","0075","842","315","527","62","904","1635","0","55.29","19.27"
"63","000","00","012","1221","0076","849","329","520","60","909","1613","0","56.35","20.4"
"63","000","00","012","1222","0000","3951","1583","2368","241","4192","7542","0","55.58","20.99"
"63","000","00","012","1222","0077","787","322","465","29","816","1483","0","55.02","21.71"
"63","000","00","012","1222","0078","815","331","484","43","858","1500","0","57.2","22.07"
"63","000","00","012","1222","0079","820","327","493","53","873","1483","0","58.87","22.05"
"63","000","00","012","1222","0080","816","321","495","57","873","1544","0","56.54","20.79"
"63","000","00","012","1222","0081","713","282","431","59","772","1532","0","50.39","18.41"
"63","000","00","012","1223","0000","2776","1131","1645","133","2909","5554","0","52.38","20.36"
"63","000","00","012","1223","0082","973","367","606","49","1022","1819","0","56.18","20.18"
"63","000","00","012","1223","0083","891","389","502","62","953","1863","0","51.15","20.88"
"63","000","00","012","1223","0084","912","375","537","22","934","1872","0","49.89","20.03"
"63","000","00","012","1224","0000","2687","1077","1610","119","2806","5164","0","54.34","20.86"
"63","000","00","012","1224","0085","861","320","541","41","902","1627","0","55.44","19.67"
"63","000","00","012","1224","0086","861","333","528","39","900","1696","0","53.07","19.63"
"63","000","00","012","1224","0087","965","424","541","39","1004","1841","0","54.54","23.03"
"63","000","00","012","1225","0000","3231","1282","1949","149","3380","5954","0","56.77","21.53"
"63","000","00","012","1225","0088","715","305","410","38","753","1324","0","56.87","23.04"
"63","000","00","012","1225","0089","787","292","495","34","821","1504","0","54.59","19.41"
"63","000","00","012","1225","0090","814","305","509","38","852","1511","0","56.39","20.19"
"63","000","00","012","1225","0091","915","380","535","39","954","1615","0","59.07","23.53"
"63","000","00","012","1226","0000","1361","546","815","57","1418","2762","0","51.34","19.77"
"63","000","00","012","1226","0092","641","241","400","30","671","1270","0","52.83","18.98"
"63","000","00","012","1226","0093","720","305","415","27","747","1492","0","50.07","20.44"
"63","000","00","012","1227","0000","3043","1271","1772","99","3142","5832","0","53.88","21.79"
"63","000","00","012","1227","0094","747","331","416","30","777","1429","0","54.37","23.16"
"63","000","00","012","1227","0095","800","339","461","16","816","1567","0","52.07","21.63"
"63","000","00","012","1227","0096","754","303","451","33","787","1388","0","56.7","21.83"
"63","000","00","012","1227","0097","742","298","444","20","762","1448","0","52.62","20.58"
"63","000","00","012","1228","0000","2053","792","1261","122","2175","3829","0","56.8","20.68"
"63","000","00","012","1228","0098","684","267","417","41","725","1356","0","53.47","19.69"
"63","000","00","012","1228","0099","698","269","429","38","736","1308","0","56.27","20.57"
"63","000","00","012","1228","0100","671","256","415","43","714","1165","0","61.29","21.97"
"63","000","00","012","1229","0000","3295","1199","2096","168","3463","5889","0","58.8","20.36"
"63","000","00","012","1229","0101","804","297","507","54","858","1429","0","60.04","20.78"
"63","000","00","012","1229","0102","784","269","515","22","806","1472","0","54.76","18.27"
"63","000","00","012","1229","0103","898","348","550","49","947","1508","0","62.8","23.08"
"63","000","00","012","1229","0104","809","285","524","43","852","1480","0","57.57","19.26"
"63","000","00","012","1230","0000","2338","906","1432","123","2461","4365","0","56.38","20.76"
"63","000","00","012","1230","0105","605","255","350","31","636","1142","0","55.69","22.33"
"63","000","00","012","1230","0106","794","300","494","28","822","1554","0","52.9","19.31"
"63","000","00","012","1230","0107","939","351","588","64","1003","1669","0","60.1","21.03"
"63","000","00","012","1231","0000","2761","990","1771","158","2919","5333","0","54.73","18.56"
"63","000","00","012","1231","0108","968","334","634","49","1017","1823","0","55.79","18.32"
"63","000","00","012","1231","0109","902","343","559","52","954","1739","0","54.86","19.72"
"63","000","00","012","1231","0110","891","313","578","57","948","1771","0","53.53","17.67"
"63","000","00","012","1232","0000","1517","538","979","84","1601","2937","0","54.51","18.32"
"63","000","00","012","1232","0111","724","246","478","53","777","1468","0","52.93","16.76"
"63","000","00","012","1232","0112","793","292","501","31","824","1469","0","56.09","19.88"
"63","000","00","012","1233","0000","2165","756","1409","118","2283","3617","0","63.12","20.9"
"63","000","00","012","1233","0113","682","236","446","28","710","1094","0","64.9","21.57"
"63","000","00","012","1233","0114","663","197","466","44","707","1101","0","64.21","17.89"
"63","000","00","012","1233","0115","820","323","497","46","866","1422","0","60.9","22.71"
"63","000","00","012","1234","0000","2188","782","1406","147","2335","3912","0","59.69","19.99"
"63","000","00","012","1234","0116","732","229","503","48","780","1390","0","56.12","16.47"
"63","000","00","012","1234","0117","740","263","477","44","784","1307","0","59.98","20.12"
"63","000","00","012","1234","0118","716","290","426","55","771","1215","0","63.46","23.87"
"63","000","00","012","1235","0000","2530","944","1586","133","2663","4886","0","54.5","19.32"
"63","000","00","012","1235","0119","857","326","531","45","902","1642","0","54.93","19.85"
"63","000","00","012","1235","0120","831","292","539","32","863","1623","0","53.17","17.99"
"63","000","00","012","1235","0121","842","326","516","56","898","1621","0","55.4","20.11"
"63","000","00","012","1236","0000","2909","1193","1716","134","3043","5397","0","56.38","22.1"
"63","000","00","012","1236","0122","733","310","423","23","756","1367","0","55.3","22.68"
"63","000","00","012","1236","0123","690","293","397","37","727","1309","0","55.54","22.38"
"63","000","00","012","1236","0124","759","309","450","33","792","1356","0","58.41","22.79"
"63","000","00","012","1236","0125","727","281","446","41","768","1365","0","56.26","20.59"
"63","000","00","012","1237","0000","3389","1393","1996","171","3560","6487","0","54.88","21.47"
"63","000","00","012","1237","0126","841","353","488","34","875","1613","0","54.25","21.88"
"63","000","00","012","1237","0127","752","311","441","30","782","1590","0","49.18","19.56"
"63","000","00","012","1237","0128","907","343","564","57","964","1662","0","58.0","20.64"
"63","000","00","012","1237","0129","889","386","503","50","939","1622","0","57.89","23.8"
"63","000","00","012","1238","0000","5168","2014","3154","284","5452","10006","0","54.49","20.13"
"63","000","00","012","1238","0130","966","417","549","29","995","1820","0","54.67","22.91"
"63","000","00","012","1238","0131","889","339","550","56","945","1615","0","58.51","20.99"
"63","000","00","012","1238","0132","694","252","442","60","754","1612","0","46.77","15.63"
"63","000","00","012","1238","0133","853","338","515","62","915","1652","0","55.39","20.46"
"63","000","00","012","1238","0134","918","352","566","26","944","1666","0","56.66","21.13"
"63","000","00","012","1238","0135","848","316","532","51","899","1641","0","54.78","19.26"
"63","000","00","012","1239","0000","1015","417","598","94","1109","2170","0","51.11","19.22"
"63","000","00","012","1239","0136","295","132","163","27","322","528","0","60.98","25.0"
"63","000","00","012","1239","0137","720","285","435","67","787","1642","0","47.93","17.36"
"63","000","00","012","1240","0000","788","272","516","65","853","1519","0","56.16","17.91"
"63","000","00","012","1240","0138","435","162","273","36","471","829","0","56.82","19.54"
"63","000","00","012","1240","0139","353","110","243","29","382","690","0","55.36","15.94"
"63","000","00","012","1241","0000","533","190","343","51","584","1067","0","54.73","17.81"
"63","000","00","012","1241","0140","533","190","343","51","584","1067","0","54.73","17.81"
"63","000","00","012","1242","0000","447","170","277","60","507","892","0","56.84","19.06"
"63","000","00","012","1242","0141","447","170","277","60","507","892","0","56.84","19.06"
"65","000","00","000","0000","0000","1759004","631350","1127654","107872","1866876","3375513","3992291","55.31","18.7"
"65","000","00","001","0000","0000","246051","89876","156175","16356","262407","463411","554357","56.63","19.39"
"65","000","00","001","0101","0000","706","286","420","71","777","1388","0","55.98","20.61"
"65","000","00","001","0101","0894","706","286","420","71","777","1388","0","55.98","20.61"
"65","000","00","001","0102","0000","728","298","430","34","762","1294","0","58.89","23.03"
"65","000","00","001","0102","0895","728","298","430","34","762","1294","0","58.89","23.03"
"65","000","00","001","0103","0000","392","170","222","13","405","667","0","60.72","25.49"
"65","000","00","001","0103","0896","392","170","222","13","405","667","0","60.72","25.49"
"65","000","00","001","0104","0000","448","154","294","36","484","898","0","53.9","17.15"
"65","000","00","001","0104","0897","448","154","294","36","484","898","0","53.9","17.15"
"65","000","00","001","0105","0000","914","305","609","55","969","1568","0","61.8","19.45"
"65","000","00","001","0105","0898","476","170","306","30","506","829","0","61.04","20.51"
"65","000","00","001","0105","0899","438","135","303","25","463","739","0","62.65","18.27"
"65","000","00","001","0106","0000","2329","892","1437","177","2506","4718","0","53.12","18.91"
"65","000","00","001","0106","0900","585","242","343","45","630","1035","0","60.87","23.38"
"65","000","00","001","0106","0901","761","302","459","39","800","1713","0","46.7","17.63"
"65","000","00","001","0106","0902","327","114","213","12","339","658","0","51.52","17.33"
"65","000","00","001","0106","0903","656","234","422","81","737","1312","0","56.17","17.84"
"65","000","00","001","0107","0000","1393","484","909","110","1503","2885","0","52.1","16.78"
"65","000","00","001","0107","0904","720","249","471","54","774","1492","0","51.88","16.69"
"65","000","00","001","0107","0905","673","235","438","56","729","1393","0","52.33","16.87"
"65","000","00","001","0108","0000","2813","1034","1779","195","3008","8490","0","35.43","12.18"
"65","000","00","001","0108","0906","830","304","526","44","874","4742","0","18.43","6.41"
"65","000","00","001","0108","0907","738","273","465","45","783","1439","0","54.41","18.97"
"65","000","00","001","0108","0908","652","239","413","68","720","1187","0","60.66","20.13"
"65","000","00","001","0108","0909","593","218","375","38","631","1122","0","56.24","19.43"
"65","000","00","001","0109","0000","2084","769","1315","149","2233","3787","0","58.96","20.31"
"65","000","00","001","0109","0910","734","261","473","58","792","1363","0","58.11","19.15"
"65","000","00","001","0109","0911","596","220","376","51","647","1093","0","59.19","20.13"
"65","000","00","001","0109","0912","754","288","466","40","794","1331","0","59.65","21.64"
"65","000","00","001","0110","0000","1973","750","1223","136","2109","3777","0","55.84","19.86"
"65","000","00","001","0110","0915","616","235","381","75","691","1268","0","54.5","18.53"
"65","000","00","001","0110","0916","659","238","421","27","686","1313","0","52.25","18.13"
"65","000","00","001","0110","0917","698","277","421","34","732","1196","0","61.2","23.16"
"65","000","00","001","0111","0000","2789","1043","1746","148","2937","4565","0","64.34","22.85"
"65","000","00","001","0111","0918","739","288","451","38","777","1137","0","68.34","25.33"
"65","000","00","001","0111","0919","773","305","468","38","811","1269","0","63.91","24.03"
"65","000","00","001","0111","0920","653","242","411","34","687","1117","0","61.5","21.67"
"65","000","00","001","0111","0921","624","208","416","38","662","1042","0","63.53","19.96"
"65","000","00","001","0112","0000","1352","468","884","135","1487","2473","0","60.13","18.92"
"65","000","00","001","0112","0922","682","243","439","79","761","1257","0","60.54","19.33"
"65","000","00","001","0112","0923","670","225","445","56","726","1216","0","59.7","18.5"
"65","000","00","001","0113","0000","1399","539","860","106","1505","2416","0","62.29","22.31"
"65","000","00","001","0113","0924","607","239","368","51","658","1126","0","58.44","21.23"
"65","000","00","001","0113","0925","792","300","492","55","847","1290","0","65.66","23.26"
"65","000","00","001","0114","0000","1994","635","1359","78","2072","3372","0","61.45","18.83"
"65","000","00","001","0114","0928","808","263","545","28","836","1329","0","62.9","19.79"
"65","000","00","001","0114","0929","582","162","420","22","604","996","0","60.64","16.27"
"65","000","00","001","0114","0930","604","210","394","28","632","1047","0","60.36","20.06"
"65","000","00","001","0115","0000","1465","512","953","99","1564","2524","0","61.97","20.29"
"65","000","00","001","0115","0931","754","260","494","58","812","1272","0","63.84","20.44"
"65","000","00","001","0115","0932","711","252","459","41","752","1252","0","60.06","20.13"
"65","000","00","001","0116","0000","1847","667","1180","177","2024","3509","0","57.68","19.01"
"65","000","00","001","0116","0936","533","192","341","54","587","1093","0","53.71","17.57"
"65","000","00","001","0116","0937","596","210","386","72","668","1148","0","58.19","18.29"
"65","000","00","001","0116","0938","718","265","453","51","769","1268","0","60.65","20.9"
"65","000","00","001","0117","0000","2330","860","1470","211","2541","4250","0","59.79","20.24"
"65","000","00","001","0117","0939","644","247","397","74","718","1230","0","58.37","20.08"
"65","000","00","001","0117","0940","539","178","361","39","578","1012","0","57.11","17.59"
"65","000","00","001","0117","0941","445","164","281","44","489","811","0","60.3","20.22"
"65","000","00","001","0117","0942","702","271","431","54","756","1197","0","63.16","22.64"
"65","000","00","001","0118","0000","1293","451","842","68","1361","2364","0","57.57","19.08"
"65","000","00","001","0118","0943","617","202","415","30","647","1142","0","56.65","17.69"
"65","000","00","001","0118","0944","676","249","427","38","714","1222","0","58.43","20.38"
"65","000","00","001","0119","0000","1770","682","1088","161","1931","3208","0","60.19","21.26"
"65","000","00","001","0119","0947","578","230","348","36","614","1011","0","60.73","22.75"
"65","000","00","001","0119","0948","613","243","370","68","681","1157","0","58.86","21.0"
"65","000","00","001","0119","0949","579","209","370","57","636","1040","0","61.15","20.1"
"65","000","00","001","0120","0000","2023","718","1305","100","2123","3621","0","58.63","19.83"
"65","000","00","001","0120","0950","682","248","434","32","714","1173","0","60.87","21.14"
"65","000","00","001","0120","0951","626","218","408","29","655","1193","0","54.9","18.27"
"65","000","00","001","0120","0952","715","252","463","39","754","1255","0","60.08","20.08"
"65","000","00","001","0121","0000","1873","702","1171","86","1959","3298","0","59.4","21.29"
"65","000","00","001","0121","0953","747","297","450","32","779","1306","0","59.65","22.74"
"65","000","00","001","0121","0954","608","224","384","18","626","1050","0","59.62","21.33"
"65","000","00","001","0121","0955","518","181","337","36","554","942","0","58.81","19.21"
"65","000","00","001","0122","0000","2122","740","1382","109","2231","3677","0","60.67","20.13"
"65","000","00","001","0122","0956","681","227","454","37","718","1133","0","63.37","20.04"
"65","000","00","001","0122","0957","704","249","455","31","735","1251","0","58.75","19.9"
"65","000","00","001","0122","0958","737","264","473","41","778","1293","0","60.17","20.42"
"65","000","00","001","0123","0000","1814","675","1139","160","1974","3492","0","56.53","19.33"
"65","000","00","001","0123","0959","601","220","381","55","656","1208","0","54.3","18.21"
"65","000","00","001","0123","0960","661","244","417","53","714","1223","0","58.38","19.95"
"65","000","00","001","0123","0961","552","211","341","52","604","1061","0","56.93","19.89"
"65","000","00","001","0124","0000","2187","689","1498","94","2281","3596","0","63.43","19.16"
"65","000","00","001","0124","0964","683","220","463","34","717","1120","0","64.02","19.64"
"65","000","00","001","0124","0965","656","230","426","39","695","1091","0","63.7","21.08"
"65","000","00","001","0124","0966","848","239","609","21","869","1385","0","62.74","17.26"
"65","000","00","001","0125","0000","1345","485","860","98","1443","2269","0","63.6","21.38"
"65","000","00","001","0125","0969","714","260","454","43","757","1191","0","63.56","21.83"
"65","000","00","001","0125","0970","631","225","406","55","686","1078","0","63.64","20.87"
"65","000","00","001","0126","0000","1459","519","940","122","1581","2673","0","59.15","19.42"
"65","000","00","001","0126","0971","735","245","490","66","801","1351","0","59.29","18.13"
"65","000","00","001","0126","0972","724","274","450","56","780","1322","0","59.0","20.73"
"65","000","00","001","0127","0000","1015","395","620","105","1120","1897","0","59.04","20.82"
"65","000","00","001","0127","0973","381","168","213","49","430","868","0","49.54","19.35"
"65","000","00","001","0127","0974","634","227","407","56","690","1029","0","67.06","22.06"
"65","000","00","001","0128","0000","3400","1259","2141","190","3590","6157","0","58.31","20.45"
"65","000","00","001","0128","0975","914","330","584","34","948","1602","0","59.18","20.6"
"65","000","00","001","0128","0976","768","269","499","57","825","1362","0","60.57","19.75"
"65","000","00","001","0128","0977","899","341","558","66","965","1698","0","56.83","20.08"
"65","000","00","001","0128","0978","819","319","500","33","852","1495","0","56.99","21.34"
"65","000","00","001","0129","0000","2174","835","1339","192","2366","4360","0","54.27","19.15"
"65","000","00","001","0129","0979","774","330","444","78","852","1522","0","55.98","21.68"
"65","000","00","001","0129","0980","697","254","443","60","757","1279","0","59.19","19.86"
"65","000","00","001","0129","0981","703","251","452","54","757","1559","0","48.56","16.1"
"65","000","00","001","0130","0000","2364","925","1439","171","2535","4788","0","52.94","19.32"
"65","000","00","001","0130","0982","742","281","461","85","827","1537","0","53.81","18.28"
"65","000","00","001","0130","0983","748","292","456","57","805","1531","0","52.58","19.07"
"65","000","00","001","0130","0984","874","352","522","29","903","1720","0","52.5","20.47"
"65","000","00","001","0131","0000","2777","1023","1754","178","2955","5277","0","56.0","19.39"
"65","000","00","001","0131","0985","598","214","384","39","637","1165","0","54.68","18.37"
"65","000","00","001","0131","0986","1015","382","633","45","1060","1857","0","57.08","20.57"
"65","000","00","001","0131","0987","558","201","357","68","626","1078","0","58.07","18.65"
"65","000","00","001","0131","0988","606","226","380","26","632","1177","0","53.7","19.2"
"65","000","00","001","0132","0000","1839","733","1106","85","1924","3253","0","59.15","22.53"
"65","000","00","001","0132","0989","1033","433","600","6","1039","1798","0","57.79","24.08"
"65","000","00","001","0132","0990","806","300","506","79","885","1455","0","60.82","20.62"
"65","000","00","001","0133","0000","2262","860","1402","125","2387","4295","0","55.58","20.02"
"65","000","00","001","0133","0993","891","382","509","25","916","1600","0","57.25","23.88"
"65","000","00","001","0133","0994","686","238","448","47","733","1409","0","52.02","16.89"
"65","000","00","001","0133","0995","685","240","445","53","738","1286","0","57.39","18.66"
"65","000","00","001","0134","0000","1176","442","734","141","1317","2547","0","51.71","17.35"
"65","000","00","001","0134","0996","579","192","387","96","675","1359","0","49.67","14.13"
"65","000","00","001","0134","0997","597","250","347","45","642","1188","0","54.04","21.04"
"65","000","00","001","0135","0000","3546","1421","2125","218","3764","6884","0","54.68","20.64"
"65","000","00","001","0135","0998","812","317","495","55","867","1627","0","53.29","19.48"
"65","000","00","001","0135","0999","703","344","359","40","743","1633","0","45.5","21.07"
"65","000","00","001","0135","1000","1040","407","633","64","1104","1814","0","60.86","22.44"
"65","000","00","001","0135","1001","991","353","638","59","1050","1810","0","58.01","19.5"
"65","000","00","001","0136","0000","1720","685","1035","180","1900","3315","0","57.32","20.66"
"65","000","00","001","0136","1005","565","224","341","70","635","1130","0","56.19","19.82"
"65","000","00","001","0136","1006","597","233","364","62","659","1056","0","62.41","22.06"
"65","000","00","001","0136","1007","558","228","330","48","606","1129","0","53.68","20.19"
"65","000","00","001","0137","0000","3502","1254","2248","239","3741","6233","0","60.02","20.12"
"65","000","00","001","0137","1008","872","305","567","100","972","1713","0","56.74","17.81"
"65","000","00","001","0137","1009","879","292","587","67","946","1622","0","58.32","18.0"
"65","000","00","001","0137","1010","853","323","530","46","899","1427","0","63.0","22.63"
"65","000","00","001","0137","1011","898","334","564","26","924","1471","0","62.81","22.71"
"65","000","00","001","0138","0000","1456","539","917","140","1596","2637","0","60.52","20.44"
"65","000","00","001","0138","1015","426","147","279","50","476","828","0","57.49","17.75"
"65","000","00","001","0138","1016","464","163","301","55","519","820","0","63.29","19.88"
"65","000","00","001","0138","1017","566","229","337","35","601","989","0","60.77","23.15"
"65","000","00","001","0139","0000","2295","847","1448","181","2476","4257","0","58.16","19.9"
"65","000","00","001","0139","1018","540","203","337","58","598","1023","0","58.46","19.84"
"65","000","00","001","0139","1019","555","193","362","34","589","1044","0","56.42","18.49"
"65","000","00","001","0139","1020","517","183","334","56","573","968","0","59.19","18.9"
"65","000","00","001","0139","1021","683","268","415","33","716","1222","0","58.59","21.93"
"65","000","00","001","0140","0000","1557","581","976","82","1639","2970","0","55.19","19.56"
"65","000","00","001","0140","1022","729","260","469","37","766","1385","0","55.31","18.77"
"65","000","00","001","0140","1023","828","321","507","45","873","1585","0","55.08","20.25"
"65","000","00","001","0141","0000","2010","713","1297","133","2143","3646","0","58.78","19.56"
"65","000","00","001","0141","1024","959","347","612","60","1019","1840","0","55.38","18.86"
"65","000","00","001","0141","1025","1051","366","685","73","1124","1806","0","62.24","20.27"
"65","000","00","001","0142","0000","2393","873","1520","174","2567","4482","0","57.27","19.48"
"65","000","00","001","0142","1026","798","292","506","60","858","1506","0","56.97","19.39"
"65","000","00","001","0142","1027","766","276","490","61","827","1476","0","56.03","18.7"
"65","000","00","001","0142","1028","829","305","524","53","882","1500","0","58.8","20.33"
"65","000","00","001","0143","0000","1728","658","1070","106","1834","3108","0","59.01","21.17"
"65","000","00","001","0143","1031","853","312","541","41","894","1601","0","55.84","19.49"
"65","000","00","001","0143","1032","875","346","529","65","940","1507","0","62.38","22.96"
"65","000","00","001","0144","0000","5040","1794","3246","209","5249","8859","0","59.25","20.25"
"65","000","00","001","0144","1035","1032","389","643","71","1103","1822","0","60.54","21.35"
"65","000","00","001","0144","1036","947","334","613","57","1004","1605","0","62.55","20.81"
"65","000","00","001","0144","1037","876","232","644","26","902","1549","0","58.23","14.98"
"65","000","00","001","0144","1038","1134","442","692","27","1161","1948","0","59.6","22.69"
"65","000","00","001","0144","1039","1051","397","654","28","1079","1935","0","55.76","20.52"
"65","000","00","001","0145","0000","1099","419","680","91","1190","2192","0","54.29","19.11"
"65","000","00","001","0145","1040","540","204","336","49","589","1097","0","53.69","18.6"
"65","000","00","001","0145","1041","559","215","344","42","601","1095","0","54.89","19.63"
"65","000","00","001","0146","0000","1984","745","1239","127","2111","3603","0","58.59","20.68"
"65","000","00","001","0146","1044","610","221","389","54","664","1187","0","55.94","18.62"
"65","000","00","001","0146","1045","645","243","402","37","682","1154","0","59.1","21.06"
"65","000","00","001","0146","1046","729","281","448","36","765","1262","0","60.62","22.27"
"65","000","00","001","0147","0000","1536","469","1067","134","1670","2681","0","62.29","17.49"
"65","000","00","001","0147","1047","641","200","441","74","715","1271","0","56.25","15.74"
"65","000","00","001","0147","1048","895","269","626","60","955","1410","0","67.73","19.08"
"65","000","00","001","0148","0000","2775","981","1794","243","3018","5365","0","56.25","18.29"
"65","000","00","001","0148","1049","843","324","519","72","915","1745","0","52.44","18.57"
"65","000","00","001","0148","1050","953","323","630","94","1047","1867","0","56.08","17.3"
"65","000","00","001","0148","1051","979","334","645","77","1056","1753","0","60.24","19.05"
"65","000","00","001","0149","0000","674","239","435","52","726","1204","0","60.3","19.85"
"65","000","00","001","0149","1052","674","239","435","52","726","1204","0","60.3","19.85"
"65","000","00","001","0150","0000","2962","1138","1824","204","3166","5455","0","58.04","20.86"
"65","000","00","001","0150","1053","830","305","525","58","888","1614","0","55.02","18.9"
"65","000","00","001","0150","1054","690","261","429","49","739","1237","0","59.74","21.1"
"65","000","00","001","0150","1055","736","292","444","69","805","1361","0","59.15","21.45"
"65","000","00","001","0150","1056","706","280","426","28","734","1243","0","59.05","22.53"
"65","000","00","001","0151","0000","2128","784","1344","148","2276","3979","0","57.2","19.7"
"65","000","00","001","0151","1057","747","287","460","34","781","1515","0","51.55","18.94"
"65","000","00","001","0151","1058","852","324","528","58","910","1515","0","60.07","21.39"
"65","000","00","001","0151","1059","529","173","356","56","585","949","0","61.64","18.23"
"65","000","00","001","0152","0000","1875","678","1197","149","2024","3768","0","53.72","17.99"
"65","000","00","001","0152","1060","830","298","532","72","902","1629","0","55.37","18.29"
"65","000","00","001","0152","1061","682","252","430","45","727","1238","0","58.72","20.36"
"65","000","00","001","0152","1062","363","128","235","32","395","901","0","43.84","14.21"
"65","000","00","001","0153","0000","1566","564","1002","138","1704","2956","0","57.65","19.08"
"65","000","00","001","0153","1063","801","303","498","71","872","1475","0","59.12","20.54"
"65","000","00","001","0153","1064","765","261","504","67","832","1481","0","56.18","17.62"
"65","000","00","001","0154","0000","2923","1077","1846","228","3151","5602","0","56.25","19.23"
"65","000","00","001","0154","1065","869","295","574","84","953","1800","0","52.94","16.39"
"65","000","00","001","0154","1066","831","304","527","66","897","1630","0","55.03","18.65"
"65","000","00","001","0154","1067","730","280","450","46","776","1298","0","59.78","21.57"
"65","000","00","001","0154","1068","493","198","295","32","525","874","0","60.07","22.65"
"65","000","00","001","0155","0000","1433","589","844","124","1557","2581","0","60.33","22.82"
"65","000","00","001","0155","1071","791","335","456","75","866","1451","0","59.68","23.09"
"65","000","00","001","0155","1072","642","254","388","49","691","1130","0","61.15","22.48"
"65","000","00","001","0156","0000","1637","587","1050","118","1755","2971","0","59.07","19.76"
"65","000","00","001","0156","1073","798","265","533","49","847","1440","0","58.82","18.4"
"65","000","00","001","0156","1074","839","322","517","69","908","1531","0","59.31","21.03"
"65","000","00","001","0157","0000","3667","1177","2490","178","3845","6492","0","59.23","18.13"
"65","000","00","001","0157","1077","653","219","434","22","675","1174","0","57.5","18.65"
"65","000","00","001","0157","1078","670","210","460","43","713","1228","0","58.06","17.1"
"65","000","00","001","0157","1079","674","152","522","27","701","1187","0","59.06","12.81"
"65","000","00","001","0157","1080","488","159","329","51","539","870","0","61.95","18.28"
"65","000","00","001","0157","1081","1182","437","745","35","1217","2033","0","59.86","21.5"
"65","000","00","001","0158","0000","1301","487","814","88","1389","2493","0","55.72","19.53"
"65","000","00","001","0158","1082","717","287","430","51","768","1418","0","54.16","20.24"
"65","000","00","001","0158","1083","584","200","384","37","621","1075","0","57.77","18.6"
"65","000","00","001","0159","0000","2316","888","1428","154","2470","4561","0","54.15","19.47"
"65","000","00","001","0159","1086","989","396","593","65","1054","1893","0","55.68","20.92"
"65","000","00","001","0159","1087","641","239","402","46","687","1302","0","52.76","18.36"
"65","000","00","001","0159","1088","686","253","433","43","729","1366","0","53.37","18.52"
"65","000","00","001","0160","0000","1404","524","880","114","1518","2518","0","60.29","20.81"
"65","000","00","001","0160","1089","761","286","475","70","831","1318","0","63.05","21.7"
"65","000","00","001","0160","1090","643","238","405","44","687","1200","0","57.25","19.83"
"65","000","00","001","0161","0000","2025","785","1240","143","2168","3774","0","57.45","20.8"
"65","000","00","001","0161","1091","1100","464","636","43","1143","2028","0","56.36","22.88"
"65","000","00","001","0161","1092","925","321","604","100","1025","1746","0","58.71","18.38"
"65","000","00","001","0162","0000","1646","635","1011","124","1770","2981","0","59.38","21.3"
"65","000","00","001","0162","1095","743","279","464","55","798","1418","0","56.28","19.68"
"65","000","00","001","0162","1096","903","356","547","69","972","1563","0","62.19","22.78"
"65","000","00","001","0163","0000","1792","664","1128","140","1932","3487","0","55.41","19.04"
"65","000","00","001","0163","1097","894","313","581","93","987","1780","0","55.45","17.58"
"65","000","00","001","0163","1098","898","351","547","47","945","1707","0","55.36","20.56"
"65","000","00","001","0164","0000","1493","537","956","115","1608","3051","0","52.7","17.6"
"65","000","00","001","0164","1099","348","119","229","11","359","906","0","39.62","13.13"
"65","000","00","001","0164","1100","536","192","344","56","592","1030","0","57.48","18.64"
"65","000","00","001","0164","1101","609","226","383","48","657","1115","0","58.92","20.27"
"65","000","00","001","0165","0000","3822","1455","2367","184","4006","7165","0","55.91","20.31"
"65","000","00","001","0165","1102","967","344","623","34","1001","1836","0","54.52","18.74"
"65","000","00","001","0165","1103","957","392","565","79","1036","1881","0","55.08","20.84"
"65","000","00","001","0165","1104","896","337","559","33","929","1688","0","55.04","19.96"
"65","000","00","001","0165","1105","1002","382","620","38","1040","1760","0","59.09","21.7"
"65","000","00","001","0166","0000","1827","650","1177","160","1987","3186","0","62.37","20.4"
"65","000","00","001","0166","1106","595","209","386","58","653","1044","0","62.55","20.02"
"65","000","00","001","0166","1107","605","214","391","38","643","1043","0","61.65","20.52"
"65","000","00","001","0166","1108","627","227","400","64","691","1099","0","62.88","20.66"
"65","000","00","001","0167","0000","1289","440","849","97","1386","2391","0","57.97","18.4"
"65","000","00","001","0167","1109","667","239","428","52","719","1260","0","57.06","18.97"
"65","000","00","001","0167","1110","622","201","421","45","667","1131","0","58.97","17.77"
"65","000","00","001","0168","0000","2211","770","1441","139","2350","3947","0","59.54","19.51"
"65","000","00","001","0168","1111","682","229","453","40","722","1225","0","58.94","18.69"
"65","000","00","001","0168","1112","869","323","546","37","906","1455","0","62.27","22.2"
"65","000","00","001","0168","1113","660","218","442","62","722","1267","0","56.99","17.21"
"65","000","00","001","0169","0000","2134","773","1361","155","2289","3832","0","59.73","20.17"
"65","000","00","001","0169","1116","623","239","384","23","646","1111","0","58.15","21.51"
"65","000","00","001","0169","1117","711","239","472","70","781","1177","0","66.36","20.31"
"65","000","00","001","0169","1118","800","295","505","62","862","1544","0","55.83","19.11"
"65","000","00","001","0170","0000","2107","841","1266","92","2199","4087","0","53.8","20.58"
"65","000","00","001","0170","1121","795","307","488","32","827","1504","0","54.99","20.41"
"65","000","00","001","0170","1122","711","270","441","35","746","1373","0","54.33","19.66"
"65","000","00","001","0170","1123","601","264","337","25","626","1210","0","51.74","21.82"
"65","000","00","001","0171","0000","1730","575","1155","136","1866","3360","0","55.54","17.11"
"65","000","00","001","0171","1124","887","300","587","69","956","1809","0","52.85","16.58"
"65","000","00","001","0171","1125","843","275","568","67","910","1551","0","58.67","17.73"
"65","000","00","001","0172","0000","2209","826","1383","94","2303","3795","0","60.69","21.77"
"65","000","00","001","0172","1126","816","302","514","19","835","1408","0","59.3","21.45"
"65","000","00","001","0172","1127","735","283","452","33","768","1285","0","59.77","22.02"
"65","000","00","001","0172","1128","658","241","417","42","700","1102","0","63.52","21.87"
"65","000","00","001","0173","0000","1593","573","1020","119","1712","3091","0","55.39","18.54"
"65","000","00","001","0173","1129","706","246","460","40","746","1399","0","53.32","17.58"
"65","000","00","001","0173","1130","887","327","560","79","966","1692","0","57.09","19.33"
"65","000","00","001","0174","0000","2459","879","1580","147","2606","4478","0","58.2","19.63"
"65","000","00","001","0174","1133","690","253","437","34","724","1246","0","58.11","20.3"
"65","000","00","001","0174","1134","812","315","497","48","860","1471","0","58.46","21.41"
"65","000","00","001","0174","1135","957","311","646","65","1022","1761","0","58.04","17.66"
"65","000","00","001","0175","0000","1561","569","992","102","1663","3027","0","54.94","18.8"
"65","000","00","001","0175","1136","806","302","504","56","862","1499","0","57.51","20.15"
"65","000","00","001","0175","1137","755","267","488","46","801","1528","0","52.42","17.47"
"65","000","00","001","0176","0000","1717","673","1044","94","1811","3086","0","58.68","21.81"
"65","000","00","001","0176","1138","865","333","532","49","914","1536","0","59.51","21.68"
"65","000","00","001","0176","1139","852","340","512","45","897","1550","0","57.87","21.94"
"65","000","00","001","0177","0000","1840","655","1185","100","1940","3350","0","57.91","19.55"
"65","000","00","001","0177","1140","1099","396","703","65","1164","2050","0","56.78","19.32"
"65","000","00","001","0177","1141","741","259","482","35","776","1300","0","59.69","19.92"
"65","000","00","001","0178","0000","3096","1097","1999","175","3271","5917","0","55.28","18.54"
"65","000","00","001","0178","1142","840","258","582","48","888","1537","0","57.77","16.79"
"65","000","00","001","0178","1143","677","258","419","29","706","1341","0","52.65","19.24"
"65","000","00","001","0178","1144","857","327","530","61","918","1606","0","57.16","20.36"
"65","000","00","001","0178","1145","722","254","468","37","759","1433","0","52.97","17.73"
"65","000","00","001","0179","0000","2179","755","1424","137","2316","4105","0","56.42","18.39"
"65","000","00","001","0179","1146","847","293","554","40","887","1685","0","52.64","17.39"
"65","000","00","001","0179","1147","722","252","470","52","774","1248","0","62.02","20.19"
"65","000","00","001","0179","1148","610","210","400","45","655","1172","0","55.89","17.92"
"65","000","00","001","0180","0000","3928","1429","2499","238","4166","7527","0","55.35","18.98"
"65","000","00","001","0180","1149","788","308","480","35","823","1640","0","50.18","18.78"
"65","000","00","001","0180","1150","741","270","471","42","783","1428","0","54.83","18.91"
"65","000","00","001","0180","1151","807","306","501","64","871","1527","0","57.04","20.04"
"65","000","00","001","0180","1152","773","267","506","22","795","1350","0","58.89","19.78"
"65","000","00","001","0180","1153","819","278","541","75","894","1582","0","56.51","17.57"
"65","000","00","001","0181","0000","1670","539","1131","87","1757","2823","0","62.24","19.09"
"65","000","00","001","0181","1154","568","171","397","32","600","919","0","65.29","18.61"
"65","000","00","001","0181","1155","515","184","331","27","542","930","0","58.28","19.78"
"65","000","00","001","0181","1156","587","184","403","28","615","974","0","63.14","18.89"
"65","000","00","001","0182","0000","1717","617","1100","106","1823","3170","0","57.51","19.46"
"65","000","00","001","0182","1157","972","342","630","40","1012","1732","0","58.43","19.75"
"65","000","00","001","0182","1158","745","275","470","66","811","1438","0","56.4","19.12"
"65","000","00","001","0183","0000","1731","617","1114","124","1855","3541","0","52.39","17.42"
"65","000","00","001","0183","1159","905","338","567","71","976","1777","0","54.92","19.02"
"65","000","00","001","0183","1160","826","279","547","53","879","1764","0","49.83","15.82"
"65","000","00","001","0184","0000","1956","751","1205","133","2089","3712","0","56.28","20.23"
"65","000","00","001","0184","1164","926","348","578","82","1008","1870","0","53.9","18.61"
"65","000","00","001","0184","1165","1030","403","627","51","1081","1842","0","58.69","21.88"
"65","000","00","001","0185","0000","1216","431","785","99","1315","2322","0","56.63","18.56"
"65","000","00","001","0185","1166","593","224","369","48","641","1094","0","58.59","20.48"
"65","000","00","001","0185","1167","623","207","416","51","674","1228","0","54.89","16.86"
"65","000","00","001","0186","0000","3217","1158","2059","188","3405","6224","0","54.71","18.61"
"65","000","00","001","0186","1170","801","309","492","46","847","1622","0","52.22","19.05"
"65","000","00","001","0186","1171","668","204","464","58","726","1205","0","60.25","16.93"
"65","000","00","001","0186","1172","861","309","552","50","911","1787","0","50.98","17.29"
"65","000","00","001","0186","1173","887","336","551","34","921","1610","0","57.2","20.87"
"65","000","00","001","0187","0000","3574","1362","2212","154","3728","6600","0","56.48","20.64"
"65","000","00","001","0187","1174","1270","491","779","42","1312","2216","0","59.21","22.16"
"65","000","00","001","0187","1175","1234","478","756","45","1279","2294","0","55.75","20.84"
"65","000","00","001","0187","1176","1070","393","677","67","1137","2090","0","54.4","18.8"
"65","000","00","001","0188","0000","1993","698","1295","105","2098","3742","0","56.07","18.65"
"65","000","00","001","0188","1177","654","225","429","28","682","1356","0","50.29","16.59"
"65","000","00","001","0188","1178","602","216","386","31","633","1067","0","59.33","20.24"
"65","000","00","001","0188","1179","737","257","480","46","783","1319","0","59.36","19.48"
"65","000","00","001","0189","0000","1741","634","1107","124","1865","3368","0","55.37","18.82"
"65","000","00","001","0189","1180","686","246","440","42","728","1316","0","55.32","18.69"
"65","000","00","001","0189","1181","592","210","382","58","650","1195","0","54.39","17.57"
"65","000","00","001","0189","1182","463","178","285","24","487","857","0","56.83","20.77"
"65","000","00","001","0190","0000","2441","943","1498","240","2681","4724","0","56.75","19.96"
"65","000","00","001","0190","1183","701","266","435","70","771","1417","0","54.41","18.77"
"65","000","00","001","0190","1184","828","340","488","77","905","1560","0","58.01","21.79"
"65","000","00","001","0190","1185","912","337","575","93","1005","1747","0","57.53","19.29"
"65","000","00","001","0191","0000","2153","825","1328","91","2244","3735","0","60.08","22.09"
"65","000","00","001","0191","1186","708","251","457","40","748","1176","0","63.61","21.34"
"65","000","00","001","0191","1187","622","241","381","27","649","1101","0","58.95","21.89"
"65","000","00","001","0191","1188","823","333","490","24","847","1458","0","58.09","22.84"
"65","000","00","001","0192","0000","3075","1062","2013","227","3302","5591","0","59.06","18.99"
"65","000","00","001","0192","1192","595","240","355","31","626","1120","0","55.89","21.43"
"65","000","00","001","0192","1193","570","192","378","83","653","1022","0","63.89","18.79"
"65","000","00","001","0192","1194","569","197","372","72","641","1049","0","61.11","18.78"
"65","000","00","001","0192","1195","577","189","388","15","592","1007","0","58.79","18.77"
"65","000","00","001","0192","1196","764","244","520","26","790","1393","0","56.71","17.52"
"65","000","00","001","0193","0000","430","163","267","68","498","974","0","51.13","16.74"
"65","000","00","001","0193","1197","161","59","102","38","199","474","0","41.98","12.45"
"65","000","00","001","0193","1198","269","104","165","30","299","500","0","59.8","20.8"
"65","000","00","001","0194","0000","1918","662","1256","129","2047","3502","0","58.45","18.9"
"65","000","00","001","0194","1199","637","236","401","44","681","1177","0","57.86","20.05"
"65","000","00","001","0194","1200","636","197","439","29","665","1186","0","56.07","16.61"
"65","000","00","001","0194","1201","645","229","416","56","701","1139","0","61.55","20.11"
"65","000","00","001","0195","0000","2079","687","1392","100","2179","5201","0","41.9","13.21"
"65","000","00","001","0195","1202","913","274","639","60","973","1750","0","55.6","15.66"
"65","000","00","001","0195","1203","1166","413","753","40","1206","3451","0","34.95","11.97"
"65","000","00","001","0196","0000","2368","879","1489","153","2521","4730","0","53.3","18.58"
"65","000","00","001","0196","1204","781","291","490","70","851","1620","0","52.53","17.96"
"65","000","00","001","0196","1205","433","167","266","21","454","903","0","50.28","18.49"
"65","000","00","001","0196","1206","685","236","449","39","724","1232","0","58.77","19.16"
"65","000","00","001","0196","1207","469","185","284","23","492","975","0","50.46","18.97"
"65","000","00","001","0197","0000","1326","458","868","77","1403","2515","0","55.79","18.21"
"65","000","00","001","0197","1208","637","223","414","35","672","1224","0","54.9","18.22"
"65","000","00","001","0197","1209","689","235","454","42","731","1291","0","56.62","18.2"
"65","000","00","001","0198","0000","4164","1560","2604","226","4390","8555","0","51.32","18.23"
"65","000","00","001","0198","1210","871","334","537","47","918","1828","0","50.22","18.27"
"65","000","00","001","0198","1211","822","320","502","58","880","1725","0","51.01","18.55"
"65","000","00","001","0198","1212","507","178","329","26","533","1085","0","49.12","16.41"
"65","000","00","001","0198","1213","1161","417","744","58","1219","2357","0","51.72","17.69"
"65","000","00","001","0198","1214","803","311","492","37","840","1560","0","53.85","19.94"
"65","000","00","001","0199","0000","2580","912","1668","130","2710","5152","0","52.6","17.7"
"65","000","00","001","0199","1218","897","300","597","52","949","1763","0","53.83","17.02"
"65","000","00","001","0199","1219","855","322","533","27","882","1744","0","50.57","18.46"
"65","000","00","001","0199","1220","828","290","538","51","879","1645","0","53.43","17.63"
"65","000","00","001","01A0","0000","1707","624","1083","118","1825","3118","0","58.53","20.01"
"65","000","00","001","01A0","1228","820","287","533","68","888","1566","0","56.7","18.33"
"65","000","00","001","01A0","1229","887","337","550","50","937","1552","0","60.37","21.71"
"65","000","00","001","01A1","0000","1298","505","793","120","1418","2270","0","62.47","22.25"
"65","000","00","001","01A1","0913","597","222","375","47","644","1026","0","62.77","21.64"
"65","000","00","001","01A1","0914","701","283","418","73","774","1244","0","62.22","22.75"
"65","000","00","001","01A2","0000","2167","780","1387","195","2362","3821","0","61.82","20.41"
"65","000","00","001","01A2","0933","662","217","445","69","731","1238","0","59.05","17.53"
"65","000","00","001","01A2","0934","815","319","496","65","880","1389","0","63.35","22.97"
"65","000","00","001","01A2","0935","690","244","446","61","751","1194","0","62.9","20.44"
"65","000","00","001","01A3","0000","1527","547","980","104","1631","2740","0","59.53","19.96"
"65","000","00","001","01A3","0962","836","316","520","40","876","1515","0","57.82","20.86"
"65","000","00","001","01A3","0963","691","231","460","64","755","1225","0","61.63","18.86"
"65","000","00","001","01A4","0000","1555","596","959","147","1702","2949","0","57.71","20.21"
"65","000","00","001","01A4","0991","699","251","448","65","764","1245","0","61.37","20.16"
"65","000","00","001","01A4","0992","856","345","511","82","938","1704","0","55.05","20.25"
"65","000","00","001","01A5","0000","1715","610","1105","66","1781","3134","0","56.83","19.46"
"65","000","00","001","01A5","1012","575","208","367","16","591","1076","0","54.93","19.33"
"65","000","00","001","01A5","1013","482","189","293","22","504","979","0","51.48","19.31"
"65","000","00","001","01A5","1014","658","213","445","28","686","1079","0","63.58","19.74"
"65","000","00","001","01A6","0000","1397","513","884","85","1482","2493","0","59.45","20.58"
"65","000","00","001","01A6","1033","755","280","475","61","816","1315","0","62.05","21.29"
"65","000","00","001","01A6","1034","642","233","409","24","666","1178","0","56.54","19.78"
"65","000","00","001","01A7","0000","1197","438","759","30","1227","2026","0","60.56","21.62"
"65","000","00","001","01A7","1069","555","190","365","16","571","992","0","57.56","19.15"
"65","000","00","001","01A7","1070","642","248","394","14","656","1034","0","63.44","23.98"
"65","000","00","001","01A8","0000","1528","531","997","69","1597","2697","0","59.21","19.69"
"65","000","00","001","01A8","1084","804","273","531","36","840","1515","0","55.45","18.02"
"65","000","00","001","01A8","1085","724","258","466","33","757","1182","0","64.04","21.83"
"65","000","00","001","01A9","0000","1120","409","711","74","1194","1966","0","60.73","20.8"
"65","000","00","001","01A9","1114","547","206","341","47","594","972","0","61.11","21.19"
"65","000","00","001","01A9","1115","573","203","370","27","600","994","0","60.36","20.42"
"65","000","00","001","01B0","0000","1860","672","1188","105","1965","3337","0","58.89","20.14"
"65","000","00","001","01B0","1131","935","343","592","32","967","1625","0","59.51","21.11"
"65","000","00","001","01B0","1132","925","329","596","73","998","1712","0","58.29","19.22"
"65","000","00","001","01B1","0000","1154","445","709","81","1235","1860","0","66.4","23.92"
"65","000","00","001","01B1","1168","618","222","396","44","662","998","0","66.33","22.24"
"65","000","00","001","01B1","1169","536","223","313","37","573","862","0","66.47","25.87"
"65","000","00","001","01B2","0000","1896","720","1176","108","2004","3778","0","53.04","19.06"
"65","000","00","001","01B2","1230","971","391","580","29","1000","1885","0","53.05","20.74"
"65","000","00","001","01B2","1231","925","329","596","79","1004","1893","0","53.04","17.38"
"65","000","00","001","01B3","0000","2573","925","1648","111","2684","5613","0","47.82","16.48"
"65","000","00","001","01B3","1215","956","350","606","32","988","2201","0","44.89","15.9"
"65","000","00","001","01B3","1216","818","306","512","48","866","1626","0","53.26","18.82"
"65","000","00","001","01B3","1217","799","269","530","31","830","1786","0","46.47","15.06"
"65","000","00","001","01B4","0000","1195","436","759","39","1234","2314","0","53.33","18.84"
"65","000","00","001","01B4","0926","621","231","390","13","634","1215","0","52.18","19.01"
"65","000","00","001","01B4","0927","574","205","369","26","600","1099","0","54.6","18.65"
"65","000","00","001","01B5","0000","1053","382","671","107","1160","1793","0","64.7","21.31"
"65","000","00","001","01B5","0945","474","149","325","38","512","796","0","64.32","18.72"
"65","000","00","001","01B5","0946","579","233","346","69","648","997","0","64.99","23.37"
"65","000","00","001","01B6","0000","1393","508","885","132","1525","2487","0","61.32","20.43"
"65","000","00","001","01B6","0967","731","259","472","60","791","1283","0","61.65","20.19"
"65","000","00","001","01B6","0968","662","249","413","72","734","1204","0","60.96","20.68"
"65","000","00","001","01B7","0000","1658","580","1078","146","1804","3024","0","59.66","19.18"
"65","000","00","001","01B7","1002","601","216","385","59","660","1133","0","58.25","19.06"
"65","000","00","001","01B7","1003","456","157","299","32","488","841","0","58.03","18.67"
"65","000","00","001","01B7","1004","601","207","394","55","656","1050","0","62.48","19.71"
"65","000","00","001","01B8","0000","1172","416","756","125","1297","2059","0","62.99","20.2"
"65","000","00","001","01B8","1029","624","219","405","70","694","1096","0","63.32","19.98"
"65","000","00","001","01B8","1030","548","197","351","55","603","963","0","62.62","20.46"
"65","000","00","001","01B9","0000","1722","585","1137","168","1890","3428","0","55.13","17.07"
"65","000","00","001","01B9","1042","839","291","548","83","922","1678","0","54.95","17.34"
"65","000","00","001","01B9","1043","883","294","589","85","968","1750","0","55.31","16.8"
"65","000","00","001","01C0","0000","1621","625","996","98","1719","2942","0","58.43","21.24"
"65","000","00","001","01C0","1075","801","313","488","59","860","1349","0","63.75","23.2"
"65","000","00","001","01C0","1076","820","312","508","39","859","1593","0","53.92","19.59"
"65","000","00","001","01C1","0000","1758","681","1077","69","1827","3428","0","53.3","19.87"
"65","000","00","001","01C1","1093","973","382","591","22","995","1954","0","50.92","19.55"
"65","000","00","001","01C1","1094","785","299","486","47","832","1474","0","56.45","20.28"
"65","000","00","001","01C2","0000","1096","355","741","118","1214","2061","0","58.9","17.22"
"65","000","00","001","01C2","1119","566","175","391","61","627","1021","0","61.41","17.14"
"65","000","00","001","01C2","1120","530","180","350","57","587","1040","0","56.44","17.31"
"65","000","00","001","01C3","0000","1974","688","1286","150","2124","3645","0","58.27","18.88"
"65","000","00","001","01C3","1161","697","243","454","30","727","1289","0","56.4","18.85"
"65","000","00","001","01C3","1162","638","218","420","54","692","1182","0","58.54","18.44"
"65","000","00","001","01C3","1163","639","227","412","66","705","1174","0","60.05","19.34"
"65","000","00","001","01C4","0000","6140","2173","3967","298","6438","12065","0","53.36","18.01"
"65","000","00","001","01C4","1221","890","319","571","33","923","1861","0","49.6","17.14"
"65","000","00","001","01C4","1222","774","255","519","34","808","1596","0","50.63","15.98"
"65","000","00","001","01C4","1223","955","338","617","59","1014","1871","0","54.2","18.07"
"65","000","00","001","01C4","1224","1015","370","645","48","1063","1938","0","54.85","19.09"
"65","000","00","001","01C4","1225","974","367","607","42","1016","1827","0","55.61","20.09"
"65","000","00","001","01C4","1226","689","242","447","34","723","1359","0","53.2","17.81"
"65","000","00","001","01C4","1227","843","282","561","48","891","1613","0","55.24","17.48"
"65","000","00","001","01C5","0000","1587","694","893","136","1723","3241","0","53.16","21.41"
"65","000","00","001","01C5","1189","773","380","393","49","822","1630","0","50.43","23.31"
"65","000","00","001","01C5","1190","814","314","500","87","901","1611","0","55.93","19.49"
"65","000","00","001","01C6","0000","605","189","416","38","643","1139","0","56.45","16.59"
"65","000","00","001","01C6","1191","605","189","416","38","643","1139","0","56.45","16.59"
"65","000","00","002","0000","0000","171736","64488","107248","12610","184346","329846","386077","55.89","19.55"
"65","000","00","002","0201","0000","2533","954","1579","159","2692","4753","0","56.64","20.07"
"65","000","00","002","0201","0659","764","296","468","45","809","1509","0","53.61","19.62"
"65","000","00","002","0201","0660","862","305","557","58","920","1591","0","57.83","19.17"
"65","000","00","002","0201","0661","907","353","554","56","963","1653","0","58.26","21.36"
"65","000","00","002","0202","0000","801","289","512","39","840","1459","0","57.57","19.81"
"65","000","00","002","0202","0665","801","289","512","39","840","1459","0","57.57","19.81"
"65","000","00","002","0203","0000","1169","417","752","102","1271","2090","0","60.81","19.95"
"65","000","00","002","0203","0666","579","208","371","51","630","1024","0","61.52","20.31"
"65","000","00","002","0203","0667","590","209","381","51","641","1066","0","60.13","19.61"
"65","000","00","002","0204","0000","512","197","315","51","563","856","0","65.77","23.01"
"65","000","00","002","0204","0668","512","197","315","51","563","856","0","65.77","23.01"
"65","000","00","002","0205","0000","1796","707","1089","99","1895","3533","0","53.64","20.01"
"65","000","00","002","0205","0671","968","360","608","52","1020","1887","0","54.05","19.08"
"65","000","00","002","0205","0672","828","347","481","47","875","1646","0","53.16","21.08"
"65","000","00","002","0206","0000","200","86","114","18","218","358","0","60.89","24.02"
"65","000","00","002","0206","0673","200","86","114","18","218","358","0","60.89","24.02"
"65","000","00","002","0207","0000","3003","1125","1878","140","3143","5443","0","57.74","20.67"
"65","000","00","002","0207","0674","575","215","360","51","626","1039","0","60.25","20.69"
"65","000","00","002","0207","0675","647","268","379","29","676","1114","0","60.68","24.06"
"65","000","00","002","0207","0676","901","347","554","30","931","1588","0","58.63","21.85"
"65","000","00","002","0207","0677","880","295","585","30","910","1702","0","53.47","17.33"
"65","000","00","002","0208","0000","2661","1025","1636","164","2825","4778","0","59.13","21.45"
"65","000","00","002","0208","0678","731","294","437","58","789","1288","0","61.26","22.83"
"65","000","00","002","0208","0679","924","356","568","62","986","1629","0","60.53","21.85"
"65","000","00","002","0208","0680","1006","375","631","44","1050","1861","0","56.42","20.15"
"65","000","00","002","0209","0000","1647","600","1047","137","1784","3108","0","57.4","19.31"
"65","000","00","002","0209","0683","833","295","538","67","900","1595","0","56.43","18.5"
"65","000","00","002","0209","0684","814","305","509","70","884","1513","0","58.43","20.16"
"65","000","00","002","0210","0000","3087","1239","1848","171","3258","8503","0","38.32","14.57"
"65","000","00","002","0210","0685","778","413","365","48","826","4433","0","18.63","9.32"
"65","000","00","002","0210","0686","701","230","471","45","746","1283","0","58.14","17.93"
"65","000","00","002","0210","0687","818","297","521","54","872","1430","0","60.98","20.77"
"65","000","00","002","0210","0688","790","299","491","24","814","1357","0","59.99","22.03"
"65","000","00","002","0211","0000","1019","391","628","80","1099","1846","0","59.53","21.18"
"65","000","00","002","0211","0689","537","201","336","35","572","963","0","59.4","20.87"
"65","000","00","002","0211","0690","482","190","292","45","527","883","0","59.68","21.52"
"65","000","00","002","0212","0000","1637","753","884","137","1774","3110","0","57.04","24.21"
"65","000","00","002","0212","0691","747","397","350","75","822","1494","0","55.02","26.57"
"65","000","00","002","0212","0692","890","356","534","62","952","1616","0","58.91","22.03"
"65","000","00","002","0213","0000","2219","856","1363","153","2372","3998","0","59.33","21.41"
"65","000","00","002","0213","0693","707","293","414","50","757","1329","0","56.96","22.05"
"65","000","00","002","0213","0694","763","287","476","44","807","1289","0","62.61","22.27"
"65","000","00","002","0213","0695","749","276","473","59","808","1380","0","58.55","20.0"
"65","000","00","002","0214","0000","3198","1216","1982","193","3391","5679","0","59.71","21.41"
"65","000","00","002","0214","0696","905","365","540","41","946","1668","0","56.71","21.88"
"65","000","00","002","0214","0697","712","272","440","64","776","1226","0","63.3","22.19"
"65","000","00","002","0214","0698","822","306","516","37","859","1421","0","60.45","21.53"
"65","000","00","002","0214","0699","759","273","486","51","810","1364","0","59.38","20.01"
"65","000","00","002","0215","0000","2094","769","1325","163","2257","3736","0","60.41","20.58"
"65","000","00","002","0215","0700","678","244","434","52","730","1232","0","59.25","19.81"
"65","000","00","002","0215","0701","716","260","456","57","773","1248","0","61.94","20.83"
"65","000","00","002","0215","0702","700","265","435","54","754","1256","0","60.03","21.1"
"65","000","00","002","0216","0000","1830","710","1120","93","1923","3175","0","60.57","22.36"
"65","000","00","002","0216","0703","887","342","545","46","933","1506","0","61.95","22.71"
"65","000","00","002","0216","0704","943","368","575","47","990","1669","0","59.32","22.05"
"65","000","00","002","0217","0000","3029","1162","1867","274","3303","5489","0","60.17","21.17"
"65","000","00","002","0217","0705","697","254","443","68","765","1308","0","58.49","19.42"
"65","000","00","002","0217","0706","782","303","479","46","828","1263","0","65.56","23.99"
"65","000","00","002","0217","0707","768","299","469","70","838","1471","0","56.97","20.33"
"65","000","00","002","0217","0708","782","306","476","90","872","1447","0","60.26","21.15"
"65","000","00","002","0218","0000","2716","985","1731","169","2885","5520","0","52.26","17.84"
"65","000","00","002","0218","0709","779","295","484","55","834","1693","0","49.26","17.42"
"65","000","00","002","0218","0710","1046","411","635","48","1094","2015","0","54.29","20.4"
"65","000","00","002","0218","0711","891","279","612","66","957","1812","0","52.81","15.4"
"65","000","00","002","0219","0000","1538","679","859","86","1624","2948","0","55.09","23.03"
"65","000","00","002","0219","0712","758","306","452","32","790","1509","0","52.35","20.28"
"65","000","00","002","0219","0713","780","373","407","54","834","1439","0","57.96","25.92"
"65","000","00","002","0220","0000","3475","1334","2141","176","3651","6530","0","55.91","20.43"
"65","000","00","002","0220","0714","773","284","489","47","820","1437","0","57.06","19.76"
"65","000","00","002","0220","0715","863","357","506","62","925","1697","0","54.51","21.04"
"65","000","00","002","0220","0716","911","346","565","32","943","1793","0","52.59","19.3"
"65","000","00","002","0220","0717","928","347","581","35","963","1603","0","60.07","21.65"
"65","000","00","002","0221","0000","1238","489","749","64","1302","2292","0","56.81","21.34"
"65","000","00","002","0221","0718","611","249","362","24","635","1166","0","54.46","21.36"
"65","000","00","002","0221","0719","627","240","387","40","667","1126","0","59.24","21.31"
"65","000","00","002","0222","0000","597","192","405","51","648","1291","0","50.19","14.87"
"65","000","00","002","0222","0720","597","192","405","51","648","1291","0","50.19","14.87"
"65","000","00","002","0223","0000","848","338","510","56","904","1597","0","56.61","21.16"
"65","000","00","002","0223","0721","848","338","510","56","904","1597","0","56.61","21.16"
"65","000","00","002","0224","0000","1148","400","748","105","1253","1992","0","62.9","20.08"
"65","000","00","002","0224","0722","603","216","387","62","665","1081","0","61.52","19.98"
"65","000","00","002","0224","0723","545","184","361","43","588","911","0","64.54","20.2"
"65","000","00","002","0225","0000","822","309","513","35","857","1719","0","49.85","17.98"
"65","000","00","002","0225","0724","822","309","513","35","857","1719","0","49.85","17.98"
"65","000","00","002","0226","0000","663","254","409","65","728","1289","0","56.48","19.71"
"65","000","00","002","0226","0725","663","254","409","65","728","1289","0","56.48","19.71"
"65","000","00","002","0227","0000","739","250","489","65","804","1318","0","61.0","18.97"
"65","000","00","002","0227","0726","739","250","489","65","804","1318","0","61.0","18.97"
"65","000","00","002","0228","0000","902","366","536","56","958","1822","0","52.58","20.09"
"65","000","00","002","0228","0727","902","366","536","56","958","1822","0","52.58","20.09"
"65","000","00","002","0229","0000","615","213","402","79","694","1185","0","58.57","17.97"
"65","000","00","002","0229","0728","615","213","402","79","694","1185","0","58.57","17.97"
"65","000","00","002","0230","0000","656","421","235","66","722","1369","0","52.74","30.75"
"65","000","00","002","0230","0729","656","421","235","66","722","1369","0","52.74","30.75"
"65","000","00","002","0231","0000","787","300","487","58","845","1507","0","56.07","19.91"
"65","000","00","002","0231","0730","787","300","487","58","845","1507","0","56.07","19.91"
"65","000","00","002","0232","0000","965","370","595","81","1046","1876","0","55.76","19.72"
"65","000","00","002","0232","0731","497","201","296","58","555","926","0","59.94","21.71"
"65","000","00","002","0232","0732","468","169","299","23","491","950","0","51.68","17.79"
"65","000","00","002","0233","0000","821","318","503","68","889","1678","0","52.98","18.95"
"65","000","00","002","0233","0733","821","318","503","68","889","1678","0","52.98","18.95"
"65","000","00","002","0234","0000","567","212","355","71","638","1117","0","57.12","18.98"
"65","000","00","002","0234","0734","567","212","355","71","638","1117","0","57.12","18.98"
"65","000","00","002","0235","0000","662","246","416","51","713","1318","0","54.1","18.66"
"65","000","00","002","0235","0735","662","246","416","51","713","1318","0","54.1","18.66"
"65","000","00","002","0236","0000","765","298","467","31","796","1388","0","57.35","21.47"
"65","000","00","002","0236","0736","765","298","467","31","796","1388","0","57.35","21.47"
"65","000","00","002","0237","0000","549","234","315","50","599","1026","0","58.38","22.81"
"65","000","00","002","0237","0737","549","234","315","50","599","1026","0","58.38","22.81"
"65","000","00","002","0238","0000","1179","455","724","75","1254","2063","0","60.79","22.06"
"65","000","00","002","0238","0738","633","248","385","48","681","1096","0","62.14","22.63"
"65","000","00","002","0238","0739","546","207","339","27","573","967","0","59.26","21.41"
"65","000","00","002","0239","0000","1696","666","1030","113","1809","3534","0","51.19","18.85"
"65","000","00","002","0239","0740","836","336","500","43","879","1871","0","46.98","17.96"
"65","000","00","002","0239","0741","860","330","530","70","930","1663","0","55.92","19.84"
"65","000","00","002","0240","0000","644","214","430","26","670","1208","0","55.46","17.72"
"65","000","00","002","0240","0742","644","214","430","26","670","1208","0","55.46","17.72"
"65","000","00","002","0241","0000","1252","504","748","74","1326","2476","0","53.55","20.36"
"65","000","00","002","0241","0743","691","292","399","52","743","1398","0","53.15","20.89"
"65","000","00","002","0241","0744","561","212","349","22","583","1078","0","54.08","19.67"
"65","000","00","002","0242","0000","1253","472","781","134","1387","2495","0","55.59","18.92"
"65","000","00","002","0242","0745","557","187","370","63","620","1102","0","56.26","16.97"
"65","000","00","002","0242","0746","696","285","411","71","767","1393","0","55.06","20.46"
"65","000","00","002","0243","0000","1420","503","917","107","1527","2485","0","61.45","20.24"
"65","000","00","002","0243","0747","679","237","442","61","740","1251","0","59.15","18.94"
"65","000","00","002","0243","0748","741","266","475","46","787","1234","0","63.78","21.56"
"65","000","00","002","0244","0000","1738","693","1045","130","1868","3251","0","57.46","21.32"
"65","000","00","002","0244","0749","897","373","524","63","960","1661","0","57.8","22.46"
"65","000","00","002","0244","0750","841","320","521","67","908","1590","0","57.11","20.13"
"65","000","00","002","0245","0000","2108","823","1285","169","2277","3773","0","60.35","21.81"
"65","000","00","002","0245","0751","643","246","397","59","702","1182","0","59.39","20.81"
"65","000","00","002","0245","0752","753","289","464","65","818","1369","0","59.75","21.11"
"65","000","00","002","0245","0753","712","288","424","45","757","1222","0","61.95","23.57"
"65","000","00","002","0246","0000","663","255","408","81","744","1304","0","57.06","19.56"
"65","000","00","002","0246","0754","663","255","408","81","744","1304","0","57.06","19.56"
"65","000","00","002","0247","0000","522","167","355","42","564","1054","0","53.51","15.84"
"65","000","00","002","0247","0755","522","167","355","42","564","1054","0","53.51","15.84"
"65","000","00","002","0248","0000","846","319","527","70","916","1635","0","56.02","19.51"
"65","000","00","002","0248","0756","846","319","527","70","916","1635","0","56.02","19.51"
"65","000","00","002","0249","0000","876","319","557","64","940","1779","0","52.84","17.93"
"65","000","00","002","0249","0757","876","319","557","64","940","1779","0","52.84","17.93"
"65","000","00","002","0250","0000","854","320","534","79","933","1633","0","57.13","19.6"
"65","000","00","002","0250","0758","854","320","534","79","933","1633","0","57.13","19.6"
"65","000","00","002","0251","0000","1204","449","755","79","1283","2128","0","60.29","21.1"
"65","000","00","002","0251","0759","604","240","364","38","642","1107","0","57.99","21.68"
"65","000","00","002","0251","0760","600","209","391","41","641","1021","0","62.78","20.47"
"65","000","00","002","0252","0000","773","294","479","82","855","1649","0","51.85","17.83"
"65","000","00","002","0252","0761","773","294","479","82","855","1649","0","51.85","17.83"
"65","000","00","002","0253","0000","460","171","289","35","495","874","0","56.64","19.57"
"65","000","00","002","0253","0762","460","171","289","35","495","874","0","56.64","19.57"
"65","000","00","002","0254","0000","724","275","449","100","824","1402","0","58.77","19.61"
"65","000","00","002","0254","0763","724","275","449","100","824","1402","0","58.77","19.61"
"65","000","00","002","0255","0000","803","277","526","69","872","1713","0","50.9","16.17"
"65","000","00","002","0255","0764","803","277","526","69","872","1713","0","50.9","16.17"
"65","000","00","002","0256","0000","1024","391","633","83","1107","2011","0","55.05","19.44"
"65","000","00","002","0256","0765","451","177","274","39","490","973","0","50.36","18.19"
"65","000","00","002","0256","0766","573","214","359","44","617","1038","0","59.44","20.62"
"65","000","00","002","0257","0000","797","287","510","124","921","1833","0","50.25","15.66"
"65","000","00","002","0257","0767","797","287","510","124","921","1833","0","50.25","15.66"
"65","000","00","002","0258","0000","434","168","266","30","464","817","0","56.79","20.56"
"65","000","00","002","0258","0768","434","168","266","30","464","817","0","56.79","20.56"
"65","000","00","002","0259","0000","774","287","487","51","825","1387","0","59.48","20.69"
"65","000","00","002","0259","0769","774","287","487","51","825","1387","0","59.48","20.69"
"65","000","00","002","0260","0000","448","169","279","27","475","784","0","60.59","21.56"
"65","000","00","002","0260","0770","448","169","279","27","475","784","0","60.59","21.56"
"65","000","00","002","0261","0000","1179","469","710","89","1268","2259","0","56.13","20.76"
"65","000","00","002","0261","0771","548","217","331","33","581","1096","0","53.01","19.8"
"65","000","00","002","0261","0772","631","252","379","56","687","1163","0","59.07","21.67"
"65","000","00","002","0262","0000","915","337","578","64","979","1868","0","52.41","18.04"
"65","000","00","002","0262","0773","915","337","578","64","979","1868","0","52.41","18.04"
"65","000","00","002","0263","0000","1004","359","645","109","1113","2051","0","54.27","17.5"
"65","000","00","002","0263","0774","544","194","350","71","615","1117","0","55.06","17.37"
"65","000","00","002","0263","0775","460","165","295","38","498","934","0","53.32","17.67"
"65","000","00","002","0264","0000","686","263","423","59","745","1412","0","52.76","18.63"
"65","000","00","002","0264","0776","686","263","423","59","745","1412","0","52.76","18.63"
"65","000","00","002","0265","0000","631","215","416","46","677","1062","0","63.75","20.24"
"65","000","00","002","0265","0777","631","215","416","46","677","1062","0","63.75","20.24"
"65","000","00","002","0266","0000","1029","375","654","125","1154","1827","0","63.16","20.53"
"65","000","00","002","0266","0778","457","164","293","55","512","891","0","57.46","18.41"
"65","000","00","002","0266","0779","572","211","361","70","642","936","0","68.59","22.54"
"65","000","00","002","0267","0000","1051","405","646","82","1133","2150","0","52.7","18.84"
"65","000","00","002","0267","0780","532","198","334","68","600","1085","0","55.3","18.25"
"65","000","00","002","0267","0781","519","207","312","14","533","1065","0","50.05","19.44"
"65","000","00","002","0268","0000","1573","603","970","105","1678","2948","0","56.92","20.45"
"65","000","00","002","0268","0782","739","314","425","64","803","1398","0","57.44","22.46"
"65","000","00","002","0268","0783","834","289","545","41","875","1550","0","56.45","18.65"
"65","000","00","002","0269","0000","848","311","537","63","911","1674","0","54.42","18.58"
"65","000","00","002","0269","0784","848","311","537","63","911","1674","0","54.42","18.58"
"65","000","00","002","0270","0000","656","232","424","55","711","1215","0","58.52","19.09"
"65","000","00","002","0270","0785","656","232","424","55","711","1215","0","58.52","19.09"
"65","000","00","002","0271","0000","824","311","513","59","883","1606","0","54.98","19.36"
"65","000","00","002","0271","0786","824","311","513","59","883","1606","0","54.98","19.36"
"65","000","00","002","0272","0000","1287","476","811","109","1396","2420","0","57.69","19.67"
"65","000","00","002","0272","0787","620","242","378","45","665","1182","0","56.26","20.47"
"65","000","00","002","0272","0788","667","234","433","64","731","1238","0","59.05","18.9"
"65","000","00","002","0273","0000","1524","585","939","99","1623","2750","0","59.02","21.27"
"65","000","00","002","0273","0789","747","293","454","56","803","1342","0","59.84","21.83"
"65","000","00","002","0273","0790","777","292","485","43","820","1408","0","58.24","20.74"
"65","000","00","002","0274","0000","897","328","569","83","980","1770","0","55.37","18.53"
"65","000","00","002","0274","0791","897","328","569","83","980","1770","0","55.37","18.53"
"65","000","00","002","0275","0000","1015","393","622","75","1090","1915","0","56.92","20.52"
"65","000","00","002","0275","0792","507","208","299","47","554","940","0","58.94","22.13"
"65","000","00","002","0275","0793","508","185","323","28","536","975","0","54.97","18.97"
"65","000","00","002","0276","0000","2176","811","1365","158","2334","4183","0","55.8","19.39"
"65","000","00","002","0276","0794","758","302","456","46","804","1507","0","53.35","20.04"
"65","000","00","002","0276","0795","752","274","478","61","813","1419","0","57.29","19.31"
"65","000","00","002","0276","0796","666","235","431","51","717","1257","0","57.04","18.7"
"65","000","00","002","0277","0000","1755","611","1144","127","1882","3364","0","55.95","18.16"
"65","000","00","002","0277","0797","860","314","546","61","921","1619","0","56.89","19.39"
"65","000","00","002","0277","0798","895","297","598","66","961","1745","0","55.07","17.02"
"65","000","00","002","0278","0000","2548","955","1593","197","2745","4898","0","56.04","19.5"
"65","000","00","002","0278","0799","780","310","470","79","859","1519","0","56.55","20.41"
"65","000","00","002","0278","0800","834","292","542","55","889","1682","0","52.85","17.36"
"65","000","00","002","0278","0801","934","353","581","63","997","1697","0","58.75","20.8"
"65","000","00","002","0279","0000","1031","330","701","99","1130","1997","0","56.58","16.52"
"65","000","00","002","0279","0802","562","179","383","56","618","1073","0","57.6","16.68"
"65","000","00","002","0279","0803","469","151","318","43","512","924","0","55.41","16.34"
"65","000","00","002","0280","0000","737","229","508","51","788","1613","0","48.85","14.2"
"65","000","00","002","0280","0804","737","229","508","51","788","1613","0","48.85","14.2"
"65","000","00","002","0281","0000","1108","373","735","101","1209","2152","0","56.18","17.33"
"65","000","00","002","0281","0805","509","173","336","45","554","1034","0","53.58","16.73"
"65","000","00","002","0281","0806","599","200","399","56","655","1118","0","58.59","17.89"
"65","000","00","002","0282","0000","1847","636","1211","167","2014","3595","0","56.02","17.69"
"65","000","00","002","0282","0807","628","210","418","63","691","1269","0","54.45","16.55"
"65","000","00","002","0282","0808","506","174","332","54","560","990","0","56.57","17.58"
"65","000","00","002","0282","0809","713","252","461","50","763","1336","0","57.11","18.86"
"65","000","00","002","0283","0000","1764","883","881","102","1866","3182","0","58.64","27.75"
"65","000","00","002","0283","0810","869","572","297","37","906","1601","0","56.59","35.73"
"65","000","00","002","0283","0811","895","311","584","65","960","1581","0","60.72","19.67"
"65","000","00","002","0284","0000","1436","508","928","103","1539","2571","0","59.86","19.76"
"65","000","00","002","0284","0812","725","260","465","56","781","1345","0","58.07","19.33"
"65","000","00","002","0284","0813","711","248","463","47","758","1226","0","61.83","20.23"
"65","000","00","002","0285","0000","1386","486","900","130","1516","2790","0","54.34","17.42"
"65","000","00","002","0285","0814","775","273","502","86","861","1650","0","52.18","16.55"
"65","000","00","002","0285","0815","611","213","398","44","655","1140","0","57.46","18.68"
"65","000","00","002","0286","0000","1717","617","1100","97","1814","3338","0","54.34","18.48"
"65","000","00","002","0286","0816","820","294","526","38","858","1639","0","52.35","17.94"
"65","000","00","002","0286","0817","897","323","574","59","956","1699","0","56.27","19.01"
"65","000","00","002","0287","0000","2219","763","1456","172","2391","4355","0","54.9","17.52"
"65","000","00","002","0287","0820","774","284","490","70","844","1540","0","54.81","18.44"
"65","000","00","002","0287","0821","668","215","453","51","719","1276","0","56.35","16.85"
"65","000","00","002","0287","0822","777","264","513","51","828","1539","0","53.8","17.15"
"65","000","00","002","0288","0000","1514","482","1032","129","1643","2898","0","56.69","16.63"
"65","000","00","002","0288","0828","738","200","538","70","808","1407","0","57.43","14.21"
"65","000","00","002","0288","0829","776","282","494","59","835","1491","0","56.0","18.91"
"65","000","00","002","0289","0000","2485","946","1539","188","2673","4718","0","56.66","20.05"
"65","000","00","002","0289","0837","756","290","466","62","818","1398","0","58.51","20.74"
"65","000","00","002","0289","0838","865","346","519","63","928","1706","0","54.4","20.28"
"65","000","00","002","0289","0839","864","310","554","63","927","1614","0","57.43","19.21"
"65","000","00","002","0290","0000","2502","969","1533","208","2710","4723","0","57.38","20.52"
"65","000","00","002","0290","0840","836","323","513","100","936","1591","0","58.83","20.3"
"65","000","00","002","0290","0841","859","339","520","45","904","1627","0","55.56","20.84"
"65","000","00","002","0290","0842","807","307","500","63","870","1505","0","57.81","20.4"
"65","000","00","002","0291","0000","1852","668","1184","40","1892","3577","0","52.89","18.67"
"65","000","00","002","0291","0832","986","351","635","0","986","1938","0","50.88","18.11"
"65","000","00","002","0291","0833","866","317","549","40","906","1639","0","55.28","19.34"
"65","000","00","002","0292","0000","1270","499","771","76","1346","2290","0","58.78","21.79"
"65","000","00","002","0292","0823","672","264","408","33","705","1170","0","60.26","22.56"
"65","000","00","002","0292","0824","598","235","363","43","641","1120","0","57.23","20.98"
"65","000","00","002","0293","0000","3663","1383","2280","185","3848","7372","0","52.2","18.76"
"65","000","00","002","0293","0846","1008","382","626","54","1062","1800","0","59.0","21.22"
"65","000","00","002","0293","0847","781","321","460","44","825","1703","0","48.44","18.85"
"65","000","00","002","0293","0848","939","372","567","45","984","1975","0","49.82","18.84"
"65","000","00","002","0293","0849","935","308","627","42","977","1894","0","51.58","16.26"
"65","000","00","002","0294","0000","2191","823","1368","112","2303","3957","0","58.2","20.8"
"65","000","00","002","0294","0850","780","294","486","43","823","1405","0","58.58","20.93"
"65","000","00","002","0294","0851","719","249","470","32","751","1293","0","58.08","19.26"
"65","000","00","002","0294","0852","692","280","412","37","729","1259","0","57.9","22.24"
"65","000","00","002","0295","0000","2060","799","1261","156","2216","3711","0","59.71","21.53"
"65","000","00","002","0295","0853","647","241","406","62","709","1144","0","61.98","21.07"
"65","000","00","002","0295","0854","713","284","429","52","765","1254","0","61.0","22.65"
"65","000","00","002","0295","0855","700","274","426","42","742","1313","0","56.51","20.87"
"65","000","00","002","0296","0000","1717","645","1072","134","1851","3369","0","54.94","19.15"
"65","000","00","002","0296","0856","799","301","498","78","877","1594","0","55.02","18.88"
"65","000","00","002","0296","0857","918","344","574","56","974","1775","0","54.87","19.38"
"65","000","00","002","0297","0000","1526","541","985","152","1678","2831","0","59.27","19.11"
"65","000","00","002","0297","0858","770","260","510","79","849","1516","0","56.0","17.15"
"65","000","00","002","0297","0859","756","281","475","73","829","1315","0","63.04","21.37"
"65","000","00","002","0298","0000","1019","360","659","114","1133","2003","0","56.57","17.97"
"65","000","00","002","0298","0860","460","179","281","59","519","843","0","61.57","21.23"
"65","000","00","002","0298","0861","559","181","378","55","614","1160","0","52.93","15.6"
"65","000","00","002","0299","0000","1181","405","776","111","1292","2106","0","61.35","19.23"
"65","000","00","002","0299","0862","563","173","390","55","618","1052","0","58.75","16.44"
"65","000","00","002","0299","0863","618","232","386","56","674","1054","0","63.95","22.01"
"65","000","00","002","02A0","0000","1023","372","651","78","1101","1933","0","56.96","19.24"
"65","000","00","002","02A0","0864","543","193","350","44","587","997","0","58.88","19.36"
"65","000","00","002","02A0","0865","480","179","301","34","514","936","0","54.91","19.12"
"65","000","00","002","02A1","0000","1594","570","1024","135","1729","3154","0","54.82","18.07"
"65","000","00","002","02A1","0866","830","294","536","78","908","1658","0","54.76","17.73"
"65","000","00","002","02A1","0867","764","276","488","57","821","1496","0","54.88","18.45"
"65","000","00","002","02A2","0000","1269","454","815","96","1365","2216","0","61.6","20.49"
"65","000","00","002","02A2","0868","611","231","380","50","661","1064","0","62.12","21.71"
"65","000","00","002","02A2","0869","658","223","435","46","704","1152","0","61.11","19.36"
"65","000","00","002","02A3","0000","2110","776","1334","128","2238","4173","0","53.63","18.6"
"65","000","00","002","02A3","0870","780","291","489","41","821","1532","0","53.59","18.99"
"65","000","00","002","02A3","0871","632","222","410","33","665","1338","0","49.7","16.59"
"65","000","00","002","02A3","0872","698","263","435","54","752","1303","0","57.71","20.18"
"65","000","00","002","02A4","0000","2211","828","1383","130","2341","4610","0","50.78","17.96"
"65","000","00","002","02A4","0880","651","232","419","29","680","1381","0","49.24","16.8"
"65","000","00","002","02A4","0881","780","298","482","71","851","1681","0","50.62","17.73"
"65","000","00","002","02A4","0882","780","298","482","30","810","1548","0","52.33","19.25"
"65","000","00","002","02A5","0000","2783","989","1794","176","2959","5569","0","53.13","17.76"
"65","000","00","002","02A5","0875","860","283","577","88","948","1821","0","52.06","15.54"
"65","000","00","002","02A5","0876","925","329","596","43","968","1906","0","50.79","17.26"
"65","000","00","002","02A5","0877","998","377","621","45","1043","1842","0","56.62","20.47"
"65","000","00","002","02A6","0000","1503","523","980","156","1659","2860","0","58.01","18.29"
"65","000","00","002","02A6","0873","734","251","483","87","821","1369","0","59.97","18.33"
"65","000","00","002","02A6","0874","769","272","497","69","838","1491","0","56.2","18.24"
"65","000","00","002","02A7","0000","1005","370","635","89","1094","1841","0","59.42","20.1"
"65","000","00","002","02A7","0878","433","139","294","44","477","878","0","54.33","15.83"
"65","000","00","002","02A7","0879","572","231","341","45","617","963","0","64.07","23.99"
"65","000","00","002","02A8","0000","3568","1372","2196","196","3764","6784","0","55.48","20.22"
"65","000","00","002","02A8","0883","833","344","489","61","894","1542","0","57.98","22.31"
"65","000","00","002","02A8","0884","809","326","483","62","871","1557","0","55.94","20.94"
"65","000","00","002","02A8","0885","851","311","540","47","898","1661","0","54.06","18.72"
"65","000","00","002","02A8","0886","1075","391","684","26","1101","2024","0","54.4","19.32"
"65","000","00","002","02A9","0000","872","319","553","76","948","1585","0","59.81","20.13"
"65","000","00","002","02A9","0669","398","154","244","37","435","764","0","56.94","20.16"
"65","000","00","002","02A9","0670","474","165","309","39","513","821","0","62.48","20.1"
"65","000","00","002","02B0","0000","2268","832","1436","201","2469","4172","0","59.18","19.94"
"65","000","00","002","02B0","0662","745","283","462","65","810","1392","0","58.19","20.33"
"65","000","00","002","02B0","0663","813","271","542","70","883","1451","0","60.85","18.68"
"65","000","00","002","02B0","0664","710","278","432","66","776","1329","0","58.39","20.92"
"65","000","00","002","02B1","0000","1832","677","1155","88","1920","3540","0","54.24","19.12"
"65","000","00","002","02B1","0681","861","306","555","50","911","1727","0","52.75","17.72"
"65","000","00","002","02B1","0682","971","371","600","38","1009","1813","0","55.65","20.46"
"65","000","00","002","02B2","0000","1408","528","880","121","1529","2603","0","58.74","20.28"
"65","000","00","002","02B2","0830","771","290","481","52","823","1381","0","59.59","21.0"
"65","000","00","002","02B2","0831","637","238","399","69","706","1222","0","57.77","19.48"
"65","000","00","002","02B3","0000","2497","1024","1473","208","2705","5130","0","52.73","19.96"
"65","000","00","002","02B3","0825","800","351","449","63","863","1789","0","48.24","19.62"
"65","000","00","002","02B3","0826","748","312","436","75","823","1520","0","54.14","20.53"
"65","000","00","002","02B3","0827","949","361","588","70","1019","1821","0","55.96","19.82"
"65","000","00","002","02B4","0000","2280","855","1425","155","2435","4507","0","54.03","18.97"
"65","000","00","002","02B4","0843","702","263","439","57","759","1331","0","57.02","19.76"
"65","000","00","002","02B4","0844","774","280","494","53","827","1678","0","49.28","16.69"
"65","000","00","002","02B4","0845","804","312","492","45","849","1498","0","56.68","20.83"
"65","000","00","002","02B5","0000","2577","901","1676","179","2756","5076","0","54.29","17.75"
"65","000","00","002","02B5","0834","835","317","518","72","907","1614","0","56.2","19.64"
"65","000","00","002","02B5","0835","891","311","580","46","937","1709","0","54.83","18.2"
"65","000","00","002","02B5","0836","851","273","578","61","912","1753","0","52.03","15.57"
"65","000","00","002","02B6","0000","1729","609","1120","135","1864","3039","0","61.34","20.04"
"65","000","00","002","02B6","0818","921","318","603","73","994","1501","0","66.22","21.19"
"65","000","00","002","02B6","0819","808","291","517","62","870","1538","0","56.57","18.92"
"65","000","00","002","02B7","0000","1598","543","1055","146","1744","3294","0","52.94","16.48"
"65","000","00","002","02B7","0887","748","271","477","54","802","1588","0","50.5","17.07"
"65","000","00","002","02B7","0888","850","272","578","92","942","1706","0","55.22","15.94"
"65","000","00","002","02B8","0000","1983","707","1276","138","2121","3705","0","57.25","19.08"
"65","000","00","002","02B8","0889","740","262","478","47","787","1341","0","58.69","19.54"
"65","000","00","002","02B8","0890","531","185","346","35","566","1025","0","55.22","18.05"
"65","000","00","002","02B8","0891","712","260","452","56","768","1339","0","57.36","19.42"
"65","000","00","002","02B9","0000","1803","673","1130","148","1951","3551","0","54.94","18.95"
"65","000","00","002","02B9","0892","882","322","560","77","959","1725","0","55.59","18.67"
"65","000","00","002","02B9","0893","921","351","570","71","992","1826","0","54.33","19.22"
"65","000","00","003","0000","0000","188344","65604","122740","9839","198183","355978","412545","55.67","18.43"
"65","000","00","003","0301","0000","2632","970","1662","135","2767","5249","0","52.71","18.48"
"65","000","00","003","0301","1232","781","292","489","63","844","1630","0","51.78","17.91"
"65","000","00","003","0301","1233","947","361","586","42","989","1775","0","55.72","20.34"
"65","000","00","003","0301","1234","904","317","587","30","934","1844","0","50.65","17.19"
"65","000","00","003","0302","0000","4369","1553","2816","241","4610","8034","0","57.38","19.33"
"65","000","00","003","0302","1282","898","353","545","63","961","1788","0","53.75","19.74"
"65","000","00","003","0302","1283","954","310","644","46","1000","1793","0","55.77","17.29"
"65","000","00","003","0302","1284","735","271","464","52","787","1352","0","58.21","20.04"
"65","000","00","003","0302","1285","992","354","638","50","1042","1813","0","57.47","19.53"
"65","000","00","003","0302","1286","790","265","525","30","820","1288","0","63.66","20.57"
"65","000","00","003","0303","0000","2006","685","1321","99","2105","3829","0","54.98","17.89"
"65","000","00","003","0303","1287","637","243","394","41","678","1186","0","57.17","20.49"
"65","000","00","003","0303","1288","632","194","438","8","640","1237","0","51.74","15.68"
"65","000","00","003","0303","1289","737","248","489","50","787","1406","0","55.97","17.64"
"65","000","00","003","0304","0000","2107","745","1362","139","2246","3774","0","59.51","19.74"
"65","000","00","003","0304","1290","759","279","480","54","813","1442","0","56.38","19.35"
"65","000","00","003","0304","1291","614","229","385","36","650","1040","0","62.5","22.02"
"65","000","00","003","0304","1292","734","237","497","49","783","1292","0","60.6","18.34"
"65","000","00","003","0305","0000","1893","647","1246","123","2016","3600","0","56.0","17.97"
"65","000","00","003","0305","1293","935","317","618","51","986","1811","0","54.45","17.5"
"65","000","00","003","0305","1294","958","330","628","72","1030","1789","0","57.57","18.45"
"65","000","00","003","0306","0000","1857","582","1275","96","1953","3177","0","61.47","18.32"
"65","000","00","003","0306","1295","530","157","373","30","560","859","0","65.19","18.28"
"65","000","00","003","0306","1296","600","168","432","27","627","972","0","64.51","17.28"
"65","000","00","003","0306","1297","727","257","470","39","766","1346","0","56.91","19.09"
"65","000","00","003","0307","0000","1302","449","853","34","1336","2157","0","61.94","20.82"
"65","000","00","003","0307","1235","625","229","396","16","641","1019","0","62.9","22.47"
"65","000","00","003","0307","1236","677","220","457","18","695","1138","0","61.07","19.33"
"65","000","00","003","0308","0000","2979","958","2021","148","3127","5702","0","54.84","16.8"
"65","000","00","003","0308","1237","933","326","607","31","964","1878","0","51.33","17.36"
"65","000","00","003","0308","1238","1083","290","793","43","1126","1980","0","56.87","14.65"
"65","000","00","003","0308","1239","963","342","621","74","1037","1844","0","56.24","18.55"
"65","000","00","003","0309","0000","2883","1044","1839","99","2982","5344","0","55.8","19.54"
"65","000","00","003","0309","1240","1166","460","706","31","1197","2085","0","57.41","22.06"
"65","000","00","003","0309","1241","790","253","537","43","833","1498","0","55.61","16.89"
"65","000","00","003","0309","1242","927","331","596","25","952","1761","0","54.06","18.8"
"65","000","00","003","0310","0000","1780","599","1181","103","1883","3294","0","57.16","18.18"
"65","000","00","003","0310","1248","896","330","566","60","956","1712","0","55.84","19.28"
"65","000","00","003","0310","1249","884","269","615","43","927","1582","0","58.6","17.0"
"65","000","00","003","0311","0000","1799","641","1158","83","1882","3235","0","58.18","19.81"
"65","000","00","003","0311","1250","915","323","592","42","957","1742","0","54.94","18.54"
"65","000","00","003","0311","1251","884","318","566","41","925","1493","0","61.96","21.3"
"65","000","00","003","0312","0000","2154","694","1460","123","2277","3990","0","57.07","17.39"
"65","000","00","003","0312","1252","694","257","437","34","728","1352","0","53.85","19.01"
"65","000","00","003","0312","1253","697","207","490","42","739","1244","0","59.41","16.64"
"65","000","00","003","0312","1254","763","230","533","47","810","1394","0","58.11","16.5"
"65","000","00","003","0313","0000","1707","633","1074","101","1808","3747","0","48.25","16.89"
"65","000","00","003","0313","1255","825","317","508","30","855","1917","0","44.6","16.54"
"65","000","00","003","0313","1256","882","316","566","71","953","1830","0","52.08","17.27"
"65","000","00","003","0314","0000","2026","752","1274","106","2132","3892","0","54.78","19.32"
"65","000","00","003","0314","1257","632","234","398","33","665","1124","0","59.16","20.82"
"65","000","00","003","0314","1258","689","260","429","31","720","1412","0","50.99","18.41"
"65","000","00","003","0314","1259","705","258","447","42","747","1356","0","55.09","19.03"
"65","000","00","003","0315","0000","2103","717","1386","144","2247","3940","0","57.03","18.2"
"65","000","00","003","0315","1260","724","225","499","28","752","1425","0","52.77","15.79"
"65","000","00","003","0315","1261","701","254","447","59","760","1259","0","60.37","20.17"
"65","000","00","003","0315","1262","678","238","440","57","735","1256","0","58.52","18.95"
"65","000","00","003","0316","0000","2293","801","1492","141","2434","4502","0","54.06","17.79"
"65","000","00","003","0316","1263","761","266","495","39","800","1423","0","56.22","18.69"
"65","000","00","003","0316","1264","639","214","425","52","691","1221","0","56.59","17.53"
"65","000","00","003","0316","1265","893","321","572","50","943","1858","0","50.75","17.28"
"65","000","00","003","0317","0000","2638","963","1675","113","2751","4958","0","55.49","19.42"
"65","000","00","003","0317","1266","899","325","574","46","945","1804","0","52.38","18.02"
"65","000","00","003","0317","1267","939","356","583","30","969","1669","0","58.06","21.33"
"65","000","00","003","0317","1268","800","282","518","37","837","1485","0","56.36","18.99"
"65","000","00","003","0318","0000","1918","684","1234","138","2056","3351","0","61.35","20.41"
"65","000","00","003","0318","1269","568","191","377","41","609","1005","0","60.6","19.0"
"65","000","00","003","0318","1270","696","267","429","59","755","1175","0","64.26","22.72"
"65","000","00","003","0318","1271","654","226","428","38","692","1171","0","59.09","19.3"
"65","000","00","003","0319","0000","2183","793","1390","104","2287","4413","0","51.82","17.97"
"65","000","00","003","0319","1272","848","301","547","30","878","1746","0","50.29","17.24"
"65","000","00","003","0319","1273","741","276","465","33","774","1555","0","49.77","17.75"
"65","000","00","003","0319","1274","594","216","378","41","635","1112","0","57.1","19.42"
"65","000","00","003","0320","0000","1705","632","1073","64","1769","3286","0","53.83","19.23"
"65","000","00","003","0320","1434","760","285","475","37","797","1462","0","54.51","19.49"
"65","000","00","003","0320","1435","945","347","598","27","972","1824","0","53.29","19.02"
"65","000","00","003","0321","0000","1534","572","962","83","1617","2823","0","57.28","20.26"
"65","000","00","003","0321","1436","723","282","441","46","769","1389","0","55.36","20.3"
"65","000","00","003","0321","1437","811","290","521","37","848","1434","0","59.14","20.22"
"65","000","00","003","0322","0000","2854","963","1891","87","2941","5350","0","54.97","18.0"
"65","000","00","003","0322","1440","978","309","669","25","1003","1858","0","53.98","16.63"
"65","000","00","003","0322","1441","943","331","612","20","963","1801","0","53.47","18.38"
"65","000","00","003","0322","1442","933","323","610","42","975","1691","0","57.66","19.1"
"65","000","00","003","0323","0000","2362","837","1525","82","2444","3948","0","61.9","21.2"
"65","000","00","003","0323","1443","787","290","497","31","818","1363","0","60.01","21.28"
"65","000","00","003","0323","1444","737","258","479","26","763","1220","0","62.54","21.15"
"65","000","00","003","0323","1445","838","289","549","25","863","1365","0","63.22","21.17"
"65","000","00","003","0324","0000","1703","598","1105","109","1812","3205","0","56.54","18.66"
"65","000","00","003","0324","1446","658","225","433","25","683","1178","0","57.98","19.1"
"65","000","00","003","0324","1447","476","166","310","30","506","830","0","60.96","20.0"
"65","000","00","003","0324","1448","569","207","362","54","623","1197","0","52.05","17.29"
"65","000","00","003","0325","0000","3761","1387","2374","124","3885","7168","0","54.2","19.35"
"65","000","00","003","0325","1275","1012","379","633","43","1055","1780","0","59.27","21.29"
"65","000","00","003","0325","1276","1025","398","627","31","1056","1918","0","55.06","20.75"
"65","000","00","003","0325","1277","737","257","480","27","764","1689","0","45.23","15.22"
"65","000","00","003","0325","1278","987","353","634","23","1010","1781","0","56.71","19.82"
"65","000","00","003","0326","0000","2563","914","1649","104","2667","4567","0","58.4","20.01"
"65","000","00","003","0326","1279","780","284","496","40","820","1419","0","57.79","20.01"
"65","000","00","003","0326","1280","694","247","447","31","725","1344","0","53.94","18.38"
"65","000","00","003","0326","1281","1089","383","706","33","1122","1804","0","62.2","21.23"
"65","000","00","003","0327","0000","2335","767","1568","138","2473","4082","0","60.58","18.79"
"65","000","00","003","0327","1449","762","237","525","45","807","1369","0","58.95","17.31"
"65","000","00","003","0327","1450","756","262","494","46","802","1336","0","60.03","19.61"
"65","000","00","003","0327","1451","817","268","549","47","864","1377","0","62.75","19.46"
"65","000","00","003","0328","0000","1784","613","1171","97","1881","3188","0","59.0","19.23"
"65","000","00","003","0328","1452","831","277","554","52","883","1499","0","58.91","18.48"
"65","000","00","003","0328","1453","953","336","617","45","998","1689","0","59.09","19.89"
"65","000","00","003","0329","0000","2328","855","1473","122","2450","4314","0","56.79","19.82"
"65","000","00","003","0329","1456","858","311","547","48","906","1545","0","58.64","20.13"
"65","000","00","003","0329","1457","697","261","436","48","745","1326","0","56.18","19.68"
"65","000","00","003","0329","1458","773","283","490","26","799","1443","0","55.37","19.61"
"65","000","00","003","0330","0000","3158","1057","2101","120","3278","5694","0","57.57","18.56"
"65","000","00","003","0330","1459","923","298","625","31","954","1712","0","55.72","17.41"
"65","000","00","003","0330","1460","998","333","665","48","1046","1916","0","54.59","17.38"
"65","000","00","003","0330","1461","507","169","338","34","541","863","0","62.69","19.58"
"65","000","00","003","0330","1462","730","257","473","7","737","1203","0","61.26","21.36"
"65","000","00","003","0331","0000","2286","743","1543","88","2374","4490","0","52.87","16.55"
"65","000","00","003","0331","1463","782","275","507","16","798","1483","0","53.81","18.54"
"65","000","00","003","0331","1464","814","263","551","27","841","1575","0","53.4","16.7"
"65","000","00","003","0331","1465","690","205","485","45","735","1432","0","51.33","14.32"
"65","000","00","003","0332","0000","2264","799","1465","123","2387","4073","0","58.61","19.62"
"65","000","00","003","0332","1466","757","259","498","52","809","1441","0","56.14","17.97"
"65","000","00","003","0332","1467","722","261","461","44","766","1269","0","60.36","20.57"
"65","000","00","003","0332","1468","785","279","506","27","812","1363","0","59.57","20.47"
"65","000","00","003","0333","0000","1597","538","1059","77","1674","2973","0","56.31","18.1"
"65","000","00","003","0333","1474","787","252","535","38","825","1526","0","54.06","16.51"
"65","000","00","003","0333","1475","810","286","524","39","849","1447","0","58.67","19.77"
"65","000","00","003","0334","0000","1529","476","1053","86","1615","2757","0","58.58","17.27"
"65","000","00","003","0334","1305","697","215","482","39","736","1319","0","55.8","16.3"
"65","000","00","003","0334","1306","832","261","571","47","879","1438","0","61.13","18.15"
"65","000","00","003","0335","0000","3221","1036","2185","161","3382","6396","0","52.88","16.2"
"65","000","00","003","0335","1307","895","299","596","36","931","1808","0","51.49","16.54"
"65","000","00","003","0335","1308","614","182","432","16","630","1191","0","52.9","15.28"
"65","000","00","003","0335","1309","836","280","556","63","899","1632","0","55.09","17.16"
"65","000","00","003","0335","1310","876","275","601","46","922","1765","0","52.24","15.58"
"65","000","00","003","0336","0000","2251","651","1600","101","2352","3909","0","60.17","16.65"
"65","000","00","003","0336","1311","677","193","484","22","699","1168","0","59.85","16.52"
"65","000","00","003","0336","1312","633","185","448","28","661","1176","0","56.21","15.73"
"65","000","00","003","0336","1313","941","273","668","51","992","1565","0","63.39","17.44"
"65","000","00","003","0337","0000","2323","817","1506","108","2431","4512","0","53.88","18.11"
"65","000","00","003","0337","1314","765","245","520","45","810","1578","0","51.33","15.53"
"65","000","00","003","0337","1315","1070","402","668","30","1100","2029","0","54.21","19.81"
"65","000","00","003","0337","1316","488","170","318","33","521","905","0","57.57","18.78"
"65","000","00","003","0338","0000","2237","719","1518","150","2387","4293","0","55.6","16.75"
"65","000","00","003","0338","1317","410","128","282","32","442","839","0","52.68","15.26"
"65","000","00","003","0338","1318","421","129","292","23","444","762","0","58.27","16.93"
"65","000","00","003","0338","1319","754","246","508","49","803","1420","0","56.55","17.32"
"65","000","00","003","0338","1320","652","216","436","46","698","1272","0","54.87","16.98"
"65","000","00","003","0339","0000","1928","623","1305","95","2023","3755","0","53.87","16.59"
"65","000","00","003","0339","1321","991","354","637","58","1049","1976","0","53.09","17.91"
"65","000","00","003","0339","1322","937","269","668","37","974","1779","0","54.75","15.12"
"65","000","00","003","0340","0000","1428","505","923","90","1518","2870","0","52.89","17.6"
"65","000","00","003","0340","1325","653","225","428","43","696","1369","0","50.84","16.44"
"65","000","00","003","0340","1326","775","280","495","47","822","1501","0","54.76","18.65"
"65","000","00","003","0341","0000","187","64","123","10","197","321","0","61.37","19.94"
"65","000","00","003","0341","1329","187","64","123","10","197","321","0","61.37","19.94"
"65","000","00","003","0342","0000","2314","767","1547","170","2484","4556","0","54.52","16.83"
"65","000","00","003","0342","1330","720","240","480","58","778","1474","0","52.78","16.28"
"65","000","00","003","0342","1331","769","252","517","75","844","1461","0","57.77","17.25"
"65","000","00","003","0342","1332","825","275","550","37","862","1621","0","53.18","16.96"
"65","000","00","003","0343","0000","1191","382","809","81","1272","2102","0","60.51","18.17"
"65","000","00","003","0343","1333","764","242","522","58","822","1327","0","61.94","18.24"
"65","000","00","003","0343","1334","427","140","287","23","450","775","0","58.06","18.06"
"65","000","00","003","0344","0000","2031","686","1345","89","2120","6749","0","31.41","10.16"
"65","000","00","003","0344","1337","761","259","502","29","790","4411","0","17.91","5.87"
"65","000","00","003","0344","1338","648","219","429","31","679","1212","0","56.02","18.07"
"65","000","00","003","0344","1339","622","208","414","29","651","1126","0","57.82","18.47"
"65","000","00","003","0345","0000","2213","714","1499","78","2291","4522","0","50.66","15.79"
"65","000","00","003","0345","1346","726","241","485","24","750","1627","0","46.1","14.81"
"65","000","00","003","0345","1347","773","249","524","25","798","1503","0","53.09","16.57"
"65","000","00","003","0345","1348","714","224","490","29","743","1392","0","53.38","16.09"
"65","000","00","003","0346","0000","2116","738","1378","93","2209","3898","0","56.67","18.93"
"65","000","00","003","0346","1349","609","215","394","29","638","1067","0","59.79","20.15"
"65","000","00","003","0346","1350","819","268","551","42","861","1623","0","53.05","16.51"
"65","000","00","003","0346","1351","688","255","433","22","710","1208","0","58.77","21.11"
"65","000","00","003","0347","0000","2370","1107","1263","85","2455","4870","0","50.41","22.73"
"65","000","00","003","0347","1352","858","578","280","40","898","1991","0","45.1","29.03"
"65","000","00","003","0347","1353","881","308","573","30","911","1932","0","47.15","15.94"
"65","000","00","003","0347","1354","631","221","410","15","646","947","0","68.22","23.34"
"65","000","00","003","0348","0000","1632","543","1089","114","1746","3234","0","53.99","16.79"
"65","000","00","003","0348","1355","903","296","607","57","960","1660","0","57.83","17.83"
"65","000","00","003","0348","1356","729","247","482","57","786","1574","0","49.94","15.69"
"65","000","00","003","0349","0000","2512","854","1658","169","2681","5146","0","52.1","16.6"
"65","000","00","003","0349","1357","1041","364","677","44","1085","2136","0","50.8","17.04"
"65","000","00","003","0349","1358","725","258","467","56","781","1462","0","53.42","17.65"
"65","000","00","003","0349","1359","746","232","514","69","815","1548","0","52.65","14.99"
"65","000","00","003","0350","0000","2506","857","1649","130","2636","4228","0","62.35","20.27"
"65","000","00","003","0350","1360","442","146","296","15","457","692","0","66.04","21.1"
"65","000","00","003","0350","1361","724","231","493","44","768","1221","0","62.9","18.92"
"65","000","00","003","0350","1362","750","285","465","38","788","1331","0","59.2","21.41"
"65","000","00","003","0350","1363","590","195","395","33","623","984","0","63.31","19.82"
"65","000","00","003","0351","0000","1583","532","1051","69","1652","3150","0","52.44","16.89"
"65","000","00","003","0351","1364","913","315","598","37","950","1871","0","50.77","16.84"
"65","000","00","003","0351","1365","670","217","453","32","702","1279","0","54.89","16.97"
"65","000","00","003","0352","0000","2663","931","1732","112","2775","4826","0","57.5","19.29"
"65","000","00","003","0352","1366","889","318","571","42","931","1629","0","57.15","19.52"
"65","000","00","003","0352","1367","815","313","502","29","844","1482","0","56.95","21.12"
"65","000","00","003","0352","1368","959","300","659","41","1000","1715","0","58.31","17.49"
"65","000","00","003","0353","0000","1043","327","716","60","1103","1952","0","56.51","16.75"
"65","000","00","003","0353","1369","1043","327","716","60","1103","1952","0","56.51","16.75"
"65","000","00","003","0354","0000","382","138","244","23","405","686","0","59.04","20.12"
"65","000","00","003","0354","1370","382","138","244","23","405","686","0","59.04","20.12"
"65","000","00","003","0355","0000","4090","1472","2618","153","4243","7264","0","58.41","20.26"
"65","000","00","003","0355","1371","742","267","475","33","775","1577","0","49.14","16.93"
"65","000","00","003","0355","1372","657","261","396","25","682","1158","0","58.89","22.54"
"65","000","00","003","0355","1373","739","263","476","16","755","1195","0","63.18","22.01"
"65","000","00","003","0355","1374","644","221","423","31","675","1054","0","64.04","20.97"
"65","000","00","003","0355","1375","378","133","245","18","396","612","0","64.71","21.73"
"65","000","00","003","0355","1376","930","327","603","30","960","1668","0","57.55","19.6"
"65","000","00","003","0356","0000","1391","504","887","102","1493","2240","0","66.65","22.5"
"65","000","00","003","0356","1377","634","219","415","53","687","1071","0","64.15","20.45"
"65","000","00","003","0356","1378","757","285","472","49","806","1169","0","68.95","24.38"
"65","000","00","003","0357","0000","2756","942","1814","132","2888","5558","0","51.96","16.95"
"65","000","00","003","0357","1379","720","265","455","31","751","1370","0","54.82","19.34"
"65","000","00","003","0357","1380","872","285","587","75","947","1574","0","60.17","18.11"
"65","000","00","003","0357","1381","1164","392","772","26","1190","2614","0","45.52","15.0"
"65","000","00","003","0358","0000","1375","499","876","107","1482","2518","0","58.86","19.82"
"65","000","00","003","0358","1382","820","266","554","50","870","1477","0","58.9","18.01"
"65","000","00","003","0358","1383","555","233","322","57","612","1041","0","58.79","22.38"
"65","000","00","003","0359","0000","2433","847","1586","187","2620","4723","0","55.47","17.93"
"65","000","00","003","0359","1384","749","260","489","62","811","1538","0","52.73","16.91"
"65","000","00","003","0359","1385","827","295","532","50","877","1599","0","54.85","18.45"
"65","000","00","003","0359","1386","857","292","565","75","932","1586","0","58.76","18.41"
"65","000","00","003","0360","0000","2069","725","1344","125","2194","3580","0","61.28","20.25"
"65","000","00","003","0360","1387","996","323","673","60","1056","1726","0","61.18","18.71"
"65","000","00","003","0360","1388","1073","402","671","65","1138","1854","0","61.38","21.68"
"65","000","00","003","0361","0000","2517","873","1644","152","2669","4390","0","60.8","19.89"
"65","000","00","003","0361","1389","847","295","552","48","895","1472","0","60.8","20.04"
"65","000","00","003","0361","1390","817","276","541","56","873","1430","0","61.05","19.3"
"65","000","00","003","0361","1391","853","302","551","48","901","1488","0","60.55","20.3"
"65","000","00","003","0362","0000","2156","774","1382","145","2301","4066","0","56.59","19.04"
"65","000","00","003","0362","1392","663","252","411","32","695","1251","0","55.56","20.14"
"65","000","00","003","0362","1393","824","275","549","38","862","1487","0","57.97","18.49"
"65","000","00","003","0362","1394","669","247","422","75","744","1328","0","56.02","18.6"
"65","000","00","003","0363","0000","1298","445","853","62","1360","2136","0","63.67","20.83"
"65","000","00","003","0363","1395","666","246","420","34","700","1128","0","62.06","21.81"
"65","000","00","003","0363","1396","632","199","433","28","660","1008","0","65.48","19.74"
"65","000","00","003","0364","0000","2110","750","1360","101","2211","4005","0","55.21","18.73"
"65","000","00","003","0364","1397","988","358","630","41","1029","1786","0","57.61","20.04"
"65","000","00","003","0364","1398","1122","392","730","60","1182","2219","0","53.27","17.67"
"65","000","00","003","0365","0000","1458","492","966","43","1501","2817","0","53.28","17.47"
"65","000","00","003","0365","1399","668","221","447","28","696","1322","0","52.65","16.72"
"65","000","00","003","0365","1400","790","271","519","15","805","1495","0","53.85","18.13"
"65","000","00","003","0366","0000","2366","778","1588","161","2527","4456","0","56.71","17.46"
"65","000","00","003","0366","1401","736","246","490","50","786","1414","0","55.59","17.4"
"65","000","00","003","0366","1402","907","270","637","61","968","1681","0","57.58","16.06"
"65","000","00","003","0366","1403","723","262","461","50","773","1361","0","56.8","19.25"
"65","000","00","003","0367","0000","2160","923","1237","108","2268","4089","0","55.47","22.57"
"65","000","00","003","0367","1404","759","240","519","44","803","1442","0","55.69","16.64"
"65","000","00","003","0367","1405","711","455","256","27","738","1383","0","53.36","32.9"
"65","000","00","003","0367","1406","690","228","462","37","727","1264","0","57.52","18.04"
"65","000","00","003","0368","0000","1911","670","1241","135","2046","3761","0","54.4","17.81"
"65","000","00","003","0368","1407","992","321","671","90","1082","1810","0","59.78","17.73"
"65","000","00","003","0368","1408","919","349","570","45","964","1951","0","49.41","17.89"
"65","000","00","003","0369","0000","1853","640","1213","103","1956","3527","0","55.46","18.15"
"65","000","00","003","0369","1409","763","276","487","41","804","1582","0","50.82","17.45"
"65","000","00","003","0369","1410","1090","364","726","62","1152","1945","0","59.23","18.71"
"65","000","00","003","0370","0000","2174","681","1493","95","2269","3950","0","57.44","17.24"
"65","000","00","003","0370","1411","767","237","530","43","810","1390","0","58.27","17.05"
"65","000","00","003","0370","1412","648","238","410","19","667","1161","0","57.45","20.5"
"65","000","00","003","0370","1413","759","206","553","33","792","1399","0","56.61","14.72"
"65","000","00","003","0371","0000","1904","617","1287","115","2019","3453","0","58.47","17.87"
"65","000","00","003","0371","1414","575","182","393","34","609","1070","0","56.92","17.01"
"65","000","00","003","0371","1415","609","211","398","32","641","1169","0","54.83","18.05"
"65","000","00","003","0371","1416","720","224","496","49","769","1214","0","63.34","18.45"
"65","000","00","003","0372","0000","1951","612","1339","102","2053","3371","0","60.9","18.15"
"65","000","00","003","0372","1471","637","201","436","37","674","1150","0","58.61","17.48"
"65","000","00","003","0372","1472","689","239","450","29","718","1154","0","62.22","20.71"
"65","000","00","003","0372","1473","625","172","453","36","661","1067","0","61.95","16.12"
"65","000","00","003","0373","0000","2974","1162","1812","98","3072","5742","0","53.5","20.24"
"65","000","00","003","0373","1245","965","376","589","34","999","1789","0","55.84","21.02"
"65","000","00","003","0373","1246","1084","419","665","30","1114","2000","0","55.7","20.95"
"65","000","00","003","0373","1247","925","367","558","34","959","1953","0","49.1","18.79"
"65","000","00","003","0374","0000","924","302","622","46","970","1712","0","56.66","17.64"
"65","000","00","003","0374","1433","924","302","622","46","970","1712","0","56.66","17.64"
"65","000","00","003","0375","0000","2065","680","1385","112","2177","3955","0","55.04","17.19"
"65","000","00","003","0375","1438","995","305","690","58","1053","1953","0","53.92","15.62"
"65","000","00","003","0375","1439","1070","375","695","54","1124","2002","0","56.14","18.73"
"65","000","00","003","0376","0000","1385","488","897","92","1477","2402","0","61.49","20.32"
"65","000","00","003","0376","1454","748","275","473","47","795","1323","0","60.09","20.79"
"65","000","00","003","0376","1455","637","213","424","45","682","1079","0","63.21","19.74"
"65","000","00","003","0377","0000","1210","400","810","51","1261","2260","0","55.8","17.7"
"65","000","00","003","0377","1469","613","169","444","23","636","1089","0","58.4","15.52"
"65","000","00","003","0377","1470","597","231","366","28","625","1171","0","53.37","19.73"
"65","000","00","003","0378","0000","1364","413","951","83","1447","2828","0","51.17","14.6"
"65","000","00","003","0378","1323","670","231","439","48","718","1454","0","49.38","15.89"
"65","000","00","003","0378","1324","694","182","512","35","729","1374","0","53.06","13.25"
"65","000","00","003","0379","0000","1158","378","780","101","1259","1970","0","63.91","19.19"
"65","000","00","003","0379","1327","548","173","375","54","602","920","0","65.43","18.8"
"65","000","00","003","0379","1328","610","205","405","47","657","1050","0","62.57","19.52"
"65","000","00","003","0380","0000","1847","620","1227","109","1956","3817","0","51.24","16.24"
"65","000","00","003","0380","1335","919","317","602","47","966","1916","0","50.42","16.54"
"65","000","00","003","0380","1336","928","303","625","62","990","1901","0","52.08","15.94"
"65","000","00","003","0381","0000","3226","1114","2112","145","3371","5946","0","56.69","18.74"
"65","000","00","003","0381","1340","775","261","514","25","800","1507","0","53.09","17.32"
"65","000","00","003","0381","1341","811","287","524","20","831","1519","0","54.71","18.89"
"65","000","00","003","0381","1342","809","309","500","44","853","1467","0","58.15","21.06"
"65","000","00","003","0381","1343","831","257","574","56","887","1453","0","61.05","17.69"
"65","000","00","003","0382","0000","1488","522","966","77","1565","2666","0","58.7","19.58"
"65","000","00","003","0382","1344","791","278","513","39","830","1364","0","60.85","20.38"
"65","000","00","003","0382","1345","697","244","453","38","735","1302","0","56.45","18.74"
"65","000","00","003","0383","0000","1338","463","875","76","1414","2421","0","58.41","19.12"
"65","000","00","003","0383","1298","577","206","371","37","614","1034","0","59.38","19.92"
"65","000","00","003","0383","1299","761","257","504","39","800","1387","0","57.68","18.53"
"65","000","00","003","0384","0000","1866","661","1205","113","1979","3737","0","52.96","17.69"
"65","000","00","003","0384","1300","1104","379","725","70","1174","2067","0","56.8","18.34"
"65","000","00","003","0384","1301","762","282","480","43","805","1670","0","48.2","16.89"
"65","000","00","003","0385","0000","2153","768","1385","120","2273","3771","0","60.28","20.37"
"65","000","00","003","0385","1417","783","278","505","48","831","1398","0","59.44","19.89"
"65","000","00","003","0385","1418","582","205","377","32","614","1049","0","58.53","19.54"
"65","000","00","003","0385","1419","788","285","503","40","828","1324","0","62.54","21.53"
"65","000","00","003","0386","0000","1639","697","942","79","1718","3474","0","49.45","20.06"
"65","000","00","003","0386","1420","821","426","395","28","849","1765","0","48.1","24.14"
"65","000","00","003","0386","1421","818","271","547","51","869","1709","0","50.85","15.86"
"65","000","00","003","0387","0000","1356","421","935","122","1478","2504","0","59.03","16.81"
"65","000","00","003","0387","1422","623","187","436","73","696","1186","0","58.68","15.77"
"65","000","00","003","0387","1423","733","234","499","49","782","1318","0","59.33","17.75"
"65","000","00","003","0388","0000","1492","577","915","77","1569","3067","0","51.16","18.81"
"65","000","00","003","0388","1424","805","312","493","34","839","1430","0","58.67","21.82"
"65","000","00","003","0388","1425","687","265","422","43","730","1637","0","44.59","16.19"
"65","000","00","003","0389","0000","2117","789","1328","142","2259","3894","0","58.01","20.26"
"65","000","00","003","0389","1426","689","263","426","51","740","1283","0","57.68","20.5"
"65","000","00","003","0389","1427","710","259","451","44","754","1310","0","57.56","19.77"
"65","000","00","003","0389","1428","718","267","451","47","765","1301","0","58.8","20.52"
"65","000","00","003","0390","0000","1689","614","1075","94","1783","3065","0","58.17","20.03"
"65","000","00","003","0390","1429","901","335","566","67","968","1681","0","57.58","19.93"
"65","000","00","003","0390","1430","788","279","509","27","815","1384","0","58.89","20.16"
"65","000","00","003","0391","0000","1441","544","897","39","1480","2966","0","49.9","18.34"
"65","000","00","003","0391","1431","653","251","402","32","685","1187","0","57.71","21.15"
"65","000","00","003","0391","1432","788","293","495","7","795","1779","0","44.69","16.47"
"65","000","00","003","0392","0000","1697","555","1142","111","1808","3199","0","56.52","17.35"
"65","000","00","003","0392","1302","623","222","401","41","664","1166","0","56.95","19.04"
"65","000","00","003","0392","1303","536","173","363","37","573","963","0","59.5","17.96"
"65","000","00","003","0392","1304","538","160","378","33","571","1070","0","53.36","14.95"
"65","000","00","003","0393","0000","1420","540","880","62","1482","2597","0","57.07","20.79"
"65","000","00","003","0393","1243","658","273","385","36","694","1254","0","55.34","21.77"
"65","000","00","003","0393","1244","762","267","495","26","788","1343","0","58.67","19.88"
"65","000","00","004","0000","0000","106034","37605","68429","5143","111177","187798","221123","59.2","20.02"
"65","000","00","004","0401","0000","1552","574","978","74","1626","3012","0","53.98","19.06"
"65","000","00","004","0401","1486","804","318","486","36","840","1568","0","53.57","20.28"
"65","000","00","004","0401","1487","748","256","492","38","786","1444","0","54.43","17.73"
"65","000","00","004","0402","0000","1436","466","970","58","1494","2535","0","58.93","18.38"
"65","000","00","004","0402","1601","713","243","470","22","735","1189","0","61.82","20.44"
"65","000","00","004","0402","1602","723","223","500","36","759","1346","0","56.39","16.57"
"65","000","00","004","0403","0000","1685","607","1078","59","1744","4440","0","39.28","13.67"
"65","000","00","004","0403","1495","843","288","555","30","873","1598","0","54.63","18.02"
"65","000","00","004","0403","1496","842","319","523","29","871","2842","0","30.65","11.22"
"65","000","00","004","0404","0000","1650","613","1037","69","1719","2710","0","63.43","22.62"
"65","000","00","004","0404","1497","752","269","483","39","791","1261","0","62.73","21.33"
"65","000","00","004","0404","1498","898","344","554","30","928","1449","0","64.04","23.74"
"65","000","00","004","0405","0000","1450","533","917","73","1523","2418","0","62.99","22.04"
"65","000","00","004","0405","1599","695","262","433","39","734","1155","0","63.55","22.68"
"65","000","00","004","0405","1600","755","271","484","34","789","1263","0","62.47","21.46"
"65","000","00","004","0406","0000","1748","653","1095","55","1803","3034","0","59.43","21.52"
"65","000","00","004","0406","1505","901","342","559","19","920","1566","0","58.75","21.84"
"65","000","00","004","0406","1506","847","311","536","36","883","1468","0","60.15","21.19"
"65","000","00","004","0407","0000","1513","550","963","77","1590","2486","0","63.96","22.12"
"65","000","00","004","0407","1507","814","302","512","44","858","1305","0","65.75","23.14"
"65","000","00","004","0407","1508","699","248","451","33","732","1181","0","61.98","21.0"
"65","000","00","004","0408","0000","1384","499","885","105","1489","2537","0","58.69","19.67"
"65","000","00","004","0408","1543","658","232","426","65","723","1234","0","58.59","18.8"
"65","000","00","004","0408","1544","726","267","459","40","766","1303","0","58.79","20.49"
"65","000","00","004","0409","0000","409","119","290","30","439","893","0","49.16","13.33"
"65","000","00","004","0409","1597","409","119","290","30","439","893","0","49.16","13.33"
"65","000","00","004","0410","0000","404","124","280","32","436","743","0","58.68","16.69"
"65","000","00","004","0410","1598","404","124","280","32","436","743","0","58.68","16.69"
"65","000","00","004","0411","0000","2296","837","1459","128","2424","4189","0","57.87","19.98"
"65","000","00","004","0411","1514","818","291","527","39","857","1488","0","57.59","19.56"
"65","000","00","004","0411","1515","754","275","479","51","805","1288","0","62.5","21.35"
"65","000","00","004","0411","1516","724","271","453","38","762","1413","0","53.93","19.18"
"65","000","00","004","0412","0000","1815","686","1129","108","1923","3289","0","58.47","20.86"
"65","000","00","004","0412","1527","957","377","580","55","1012","1798","0","56.28","20.97"
"65","000","00","004","0412","1528","858","309","549","53","911","1491","0","61.1","20.72"
"65","000","00","004","0413","0000","3638","1395","2243","150","3788","6230","0","60.8","22.39"
"65","000","00","004","0413","1582","879","326","553","45","924","1598","0","57.82","20.4"
"65","000","00","004","0413","1583","930","360","570","43","973","1609","0","60.47","22.37"
"65","000","00","004","0413","1584","819","318","501","34","853","1375","0","62.04","23.13"
"65","000","00","004","0413","1585","1010","391","619","28","1038","1648","0","62.99","23.73"
"65","000","00","004","0414","0000","2440","917","1523","116","2556","4535","0","56.36","20.22"
"65","000","00","004","0414","1579","865","313","552","42","907","1586","0","57.19","19.74"
"65","000","00","004","0414","1580","688","250","438","23","711","1313","0","54.15","19.04"
"65","000","00","004","0414","1581","887","354","533","51","938","1636","0","57.33","21.64"
"65","000","00","004","0415","0000","2195","781","1414","98","2293","3628","0","63.2","21.53"
"65","000","00","004","0415","1558","718","270","448","35","753","1209","0","62.28","22.33"
"65","000","00","004","0415","1559","684","247","437","30","714","1132","0","63.07","21.82"
"65","000","00","004","0415","1560","793","264","529","33","826","1287","0","64.18","20.51"
"65","000","00","004","0416","0000","2424","794","1630","112","2536","4081","0","62.14","19.46"
"65","000","00","004","0416","1520","701","232","469","43","744","1100","0","67.64","21.09"
"65","000","00","004","0416","1521","919","320","599","48","967","1545","0","62.59","20.71"
"65","000","00","004","0416","1522","804","242","562","21","825","1436","0","57.45","16.85"
"65","000","00","004","0417","0000","2219","756","1463","109","2328","3877","0","60.05","19.5"
"65","000","00","004","0417","1517","735","231","504","42","777","1329","0","58.47","17.38"
"65","000","00","004","0417","1518","856","302","554","30","886","1436","0","61.7","21.03"
"65","000","00","004","0417","1519","628","223","405","37","665","1112","0","59.8","20.05"
"65","000","00","004","0418","0000","1485","496","989","100","1585","2704","0","58.62","18.34"
"65","000","00","004","0418","1489","696","227","469","40","736","1188","0","61.95","19.11"
"65","000","00","004","0418","1490","789","269","520","60","849","1516","0","56.0","17.74"
"65","000","00","004","0419","0000","601","240","361","39","640","1140","0","56.14","21.05"
"65","000","00","004","0419","1488","601","240","361","39","640","1140","0","56.14","21.05"
"65","000","00","004","0420","0000","2057","737","1320","119","2176","3493","0","62.3","21.1"
"65","000","00","004","0420","1523","1023","352","671","60","1083","1731","0","62.56","20.34"
"65","000","00","004","0420","1524","1034","385","649","59","1093","1762","0","62.03","21.85"
"65","000","00","004","0421","0000","1334","492","842","60","1394","2617","0","53.27","18.8"
"65","000","00","004","0421","1525","707","255","452","42","749","1320","0","56.74","19.32"
"65","000","00","004","0421","1526","627","237","390","18","645","1297","0","49.73","18.27"
"65","000","00","004","0422","0000","982","388","594","40","1022","1783","0","57.32","21.76"
"65","000","00","004","0422","1606","469","179","290","12","481","879","0","54.72","20.36"
"65","000","00","004","0422","1607","513","209","304","28","541","904","0","59.85","23.12"
"65","000","00","004","0423","0000","1795","679","1116","82","1877","3314","0","56.64","20.49"
"65","000","00","004","0423","1480","947","375","572","36","983","1733","0","56.72","21.64"
"65","000","00","004","0423","1481","848","304","544","46","894","1581","0","56.55","19.23"
"65","000","00","004","0424","0000","2024","678","1346","106","2130","3452","0","61.7","19.64"
"65","000","00","004","0424","1568","1083","376","707","44","1127","1876","0","60.07","20.04"
"65","000","00","004","0424","1569","941","302","639","62","1003","1576","0","63.64","19.16"
"65","000","00","004","0425","0000","1968","654","1314","62","2030","3469","0","58.52","18.85"
"65","000","00","004","0425","1570","964","338","626","38","1002","1661","0","60.33","20.35"
"65","000","00","004","0425","1571","1004","316","688","24","1028","1808","0","56.86","17.48"
"65","000","00","004","0426","0000","2134","735","1399","108","2242","3547","0","63.21","20.72"
"65","000","00","004","0426","1563","732","215","517","33","765","1222","0","62.6","17.59"
"65","000","00","004","0426","1564","677","232","445","37","714","1157","0","61.71","20.05"
"65","000","00","004","0426","1565","725","288","437","38","763","1168","0","65.33","24.66"
"65","000","00","004","0427","0000","1488","537","951","71","1559","2655","0","58.72","20.23"
"65","000","00","004","0427","1566","711","266","445","41","752","1283","0","58.61","20.73"
"65","000","00","004","0427","1567","777","271","506","30","807","1372","0","58.82","19.75"
"65","000","00","004","0428","0000","1664","606","1058","83","1747","2979","0","58.64","20.34"
"65","000","00","004","0428","1610","842","311","531","46","888","1551","0","57.25","20.05"
"65","000","00","004","0428","1611","822","295","527","37","859","1428","0","60.15","20.66"
"65","000","00","004","0429","0000","1312","449","863","89","1401","2239","0","62.57","20.05"
"65","000","00","004","0429","1608","715","242","473","51","766","1221","0","62.74","19.82"
"65","000","00","004","0429","1609","597","207","390","38","635","1018","0","62.38","20.33"
"65","000","00","004","0430","0000","2299","796","1503","61","2360","3932","0","60.02","20.24"
"65","000","00","004","0430","1551","733","259","474","14","747","1210","0","61.74","21.4"
"65","000","00","004","0430","1552","926","316","610","26","952","1630","0","58.4","19.39"
"65","000","00","004","0430","1553","640","221","419","21","661","1092","0","60.53","20.24"
"65","000","00","004","0431","0000","2480","826","1654","107","2587","4196","0","61.65","19.69"
"65","000","00","004","0431","1547","598","220","378","19","617","991","0","62.26","22.2"
"65","000","00","004","0431","1548","617","213","404","24","641","1016","0","63.09","20.96"
"65","000","00","004","0431","1549","661","226","435","33","694","1146","0","60.56","19.72"
"65","000","00","004","0431","1550","604","167","437","31","635","1043","0","60.88","16.01"
"65","000","00","004","0432","0000","1395","491","904","71","1466","2334","0","62.81","21.04"
"65","000","00","004","0432","1556","617","214","403","33","650","1049","0","61.96","20.4"
"65","000","00","004","0432","1557","778","277","501","38","816","1285","0","63.5","21.56"
"65","000","00","004","0433","0000","2321","846","1475","122","2443","4225","0","57.82","20.02"
"65","000","00","004","0433","1576","659","239","420","31","690","1177","0","58.62","20.31"
"65","000","00","004","0433","1577","872","316","556","52","924","1557","0","59.34","20.3"
"65","000","00","004","0433","1578","790","291","499","39","829","1491","0","55.6","19.52"
"65","000","00","004","0434","0000","1830","669","1161","89","1919","3434","0","55.88","19.48"
"65","000","00","004","0434","1536","917","332","585","52","969","1713","0","56.57","19.38"
"65","000","00","004","0434","1537","913","337","576","37","950","1721","0","55.2","19.58"
"65","000","00","004","0435","0000","2458","854","1604","129","2587","4177","0","61.93","20.45"
"65","000","00","004","0435","1540","803","267","536","35","838","1348","0","62.17","19.81"
"65","000","00","004","0435","1541","896","311","585","37","933","1461","0","63.86","21.29"
"65","000","00","004","0435","1542","759","276","483","57","816","1368","0","59.65","20.18"
"65","000","00","004","0436","0000","853","321","532","65","918","1554","0","59.07","20.66"
"65","000","00","004","0436","1476","853","321","532","65","918","1554","0","59.07","20.66"
"65","000","00","004","0437","0000","1221","406","815","72","1293","2107","0","61.37","19.27"
"65","000","00","004","0437","1478","515","173","342","27","542","854","0","63.47","20.26"
"65","000","00","004","0437","1479","706","233","473","45","751","1253","0","59.94","18.6"
"65","000","00","004","0438","0000","2608","880","1728","118","2726","4561","0","59.77","19.29"
"65","000","00","004","0438","1499","846","287","559","43","889","1511","0","58.84","18.99"
"65","000","00","004","0438","1500","888","305","583","37","925","1470","0","62.93","20.75"
"65","000","00","004","0438","1501","874","288","586","38","912","1580","0","57.72","18.23"
"65","000","00","004","0439","0000","2296","791","1505","86","2382","3789","0","62.87","20.88"
"65","000","00","004","0439","1502","881","304","577","27","908","1438","0","63.14","21.14"
"65","000","00","004","0439","1503","788","276","512","35","823","1305","0","63.07","21.15"
"65","000","00","004","0439","1504","627","211","416","24","651","1046","0","62.24","20.17"
"65","000","00","004","0440","0000","1644","534","1110","87","1731","2938","0","58.92","18.18"
"65","000","00","004","0440","1545","823","271","552","33","856","1516","0","56.46","17.88"
"65","000","00","004","0440","1546","821","263","558","54","875","1422","0","61.53","18.5"
"65","000","00","004","0441","0000","381","112","269","46","427","768","0","55.6","14.58"
"65","000","00","004","0441","1596","381","112","269","46","427","768","0","55.6","14.58"
"65","000","00","004","0442","0000","492","131","361","33","525","853","0","61.55","15.36"
"65","000","00","004","0442","1595","492","131","361","33","525","853","0","61.55","15.36"
"65","000","00","004","0443","0000","1041","373","668","49","1090","1898","0","57.43","19.65"
"65","000","00","004","0443","1572","1041","373","668","49","1090","1898","0","57.43","19.65"
"65","000","00","004","0444","0000","2453","882","1571","146","2599","4271","0","60.85","20.65"
"65","000","00","004","0444","1573","897","329","568","39","936","1508","0","62.07","21.82"
"65","000","00","004","0444","1574","765","273","492","61","826","1341","0","61.6","20.36"
"65","000","00","004","0444","1575","791","280","511","46","837","1422","0","58.86","19.69"
"65","000","00","004","0445","0000","1179","422","757","85","1264","2011","0","62.85","20.98"
"65","000","00","004","0445","1612","604","211","393","51","655","1044","0","62.74","20.21"
"65","000","00","004","0445","1613","575","211","364","34","609","967","0","62.98","21.82"
"65","000","00","004","0446","0000","1966","741","1225","111","2077","3545","0","58.59","20.9"
"65","000","00","004","0446","1593","1051","389","662","68","1119","1938","0","57.74","20.07"
"65","000","00","004","0446","1594","915","352","563","43","958","1607","0","59.61","21.9"
"65","000","00","004","0447","0000","2480","933","1547","150","2630","4361","0","60.31","21.39"
"65","000","00","004","0447","1511","883","326","557","84","967","1649","0","58.64","19.77"
"65","000","00","004","0447","1512","722","275","447","34","756","1206","0","62.69","22.8"
"65","000","00","004","0447","1513","875","332","543","32","907","1506","0","60.23","22.05"
"65","000","00","004","0448","0000","1576","595","981","82","1658","2823","0","58.73","21.08"
"65","000","00","004","0448","1509","908","331","577","46","954","1720","0","55.47","19.24"
"65","000","00","004","0448","1510","668","264","404","36","704","1103","0","63.83","23.93"
"65","000","00","004","0449","0000","1985","673","1312","110","2095","3465","0","60.46","19.42"
"65","000","00","004","0449","1533","612","200","412","14","626","1115","0","56.14","17.94"
"65","000","00","004","0449","1534","681","234","447","48","729","1133","0","64.34","20.65"
"65","000","00","004","0449","1535","692","239","453","48","740","1217","0","60.81","19.64"
"65","000","00","004","0450","0000","1310","440","870","64","1374","2331","0","58.94","18.88"
"65","000","00","004","0450","1529","690","235","455","16","706","1223","0","57.73","19.22"
"65","000","00","004","0450","1530","620","205","415","48","668","1108","0","60.29","18.5"
"65","000","00","004","0451","0000","1743","614","1129","77","1820","3104","0","58.63","19.78"
"65","000","00","004","0451","1484","938","335","603","49","987","1650","0","59.82","20.3"
"65","000","00","004","0451","1485","805","279","526","28","833","1454","0","57.29","19.19"
"65","000","00","004","0452","0000","609","180","429","16","625","1065","0","58.69","16.9"
"65","000","00","004","0452","1477","609","180","429","16","625","1065","0","58.69","16.9"
"65","000","00","004","0453","0000","1154","395","759","51","1205","2025","0","59.51","19.51"
"65","000","00","004","0453","1493","629","209","420","25","654","1084","0","60.33","19.28"
"65","000","00","004","0453","1494","525","186","339","26","551","941","0","58.55","19.77"
"65","000","00","004","0454","0000","1526","553","973","73","1599","2835","0","56.4","19.51"
"65","000","00","004","0454","1491","736","267","469","49","785","1397","0","56.19","19.11"
"65","000","00","004","0454","1492","790","286","504","24","814","1438","0","56.61","19.89"
"65","000","00","004","0455","0000","1728","565","1163","82","1810","3298","0","54.88","17.13"
"65","000","00","004","0455","1482","904","296","608","57","961","1735","0","55.39","17.06"
"65","000","00","004","0455","1483","824","269","555","25","849","1563","0","54.32","17.21"
"65","000","00","004","0456","0000","2059","716","1343","68","2127","3653","0","58.23","19.6"
"65","000","00","004","0456","1554","1066","370","696","46","1112","1872","0","59.4","19.76"
"65","000","00","004","0456","1555","993","346","647","22","1015","1781","0","56.99","19.43"
"65","000","00","004","0457","0000","1345","480","865","52","1397","2411","0","57.94","19.91"
"65","000","00","004","0457","1603","745","268","477","37","782","1368","0","57.16","19.59"
"65","000","00","004","0457","1604","600","212","388","15","615","1043","0","58.96","20.33"
"65","000","00","004","0458","0000","988","381","607","42","1030","1709","0","60.27","22.29"
"65","000","00","004","0458","1605","988","381","607","42","1030","1709","0","60.27","22.29"
"65","000","00","004","0459","0000","1470","497","973","69","1539","2584","0","59.56","19.23"
"65","000","00","004","0459","1538","712","236","476","43","755","1327","0","56.9","17.78"
"65","000","00","004","0459","1539","758","261","497","26","784","1257","0","62.37","20.76"
"65","000","00","004","0460","0000","1548","553","995","86","1634","2673","0","61.13","20.69"
"65","000","00","004","0460","1531","822","304","518","40","862","1408","0","61.22","21.59"
"65","000","00","004","0460","1532","726","249","477","46","772","1265","0","61.03","19.68"
"65","000","00","004","0461","0000","1292","492","800","78","1370","2166","0","63.25","22.71"
"65","000","00","004","0461","1561","634","234","400","37","671","1068","0","62.83","21.91"
"65","000","00","004","0461","1562","658","258","400","41","699","1098","0","63.66","23.5"
"65","000","00","004","0462","0000","5202","1868","3334","154","5356","8673","0","61.75","21.54"
"65","000","00","004","0462","1586","620","235","385","32","652","1077","0","60.54","21.82"
"65","000","00","004","0462","1587","678","252","426","25","703","1157","0","60.76","21.78"
"65","000","00","004","0462","1588","829","311","518","22","851","1339","0","63.55","23.23"
"65","000","00","004","0462","1589","788","280","508","15","803","1306","0","61.49","21.44"
"65","000","00","004","0462","1590","760","274","486","15","775","1236","0","62.7","22.17"
"65","000","00","004","0462","1591","683","221","462","21","704","1133","0","62.14","19.51"
"65","000","00","004","0462","1592","844","295","549","24","868","1425","0","60.91","20.7"
"65","000","00","005","0000","0000","185260","67789","117471","11395","196655","344981","417405","57.0","19.65"
"65","000","00","005","0501","0000","2722","976","1746","203","2925","4792","0","61.04","20.37"
"65","000","00","005","0501","0302","611","243","368","52","663","1123","0","59.04","21.64"
"65","000","00","005","0501","0303","715","245","470","55","770","1278","0","60.25","19.17"
"65","000","00","005","0501","0304","695","244","451","43","738","1163","0","63.46","20.98"
"65","000","00","005","0501","0305","701","244","457","53","754","1228","0","61.4","19.87"
"65","000","00","005","0502","0000","3795","1514","2281","173","3968","7166","0","55.37","21.13"
"65","000","00","005","0502","0328","679","260","419","23","702","1382","0","50.8","18.81"
"65","000","00","005","0502","0329","800","350","450","40","840","1475","0","56.95","23.73"
"65","000","00","005","0502","0330","819","305","514","27","846","1462","0","57.87","20.86"
"65","000","00","005","0502","0331","753","305","448","36","789","1426","0","55.33","21.39"
"65","000","00","005","0502","0332","744","294","450","47","791","1421","0","55.67","20.69"
"65","000","00","005","0503","0000","668","251","417","81","749","1341","0","55.85","18.72"
"65","000","00","005","0503","0449","668","251","417","81","749","1341","0","55.85","18.72"
"65","000","00","005","0504","0000","2218","804","1414","148","2366","3923","0","60.31","20.49"
"65","000","00","005","0504","0306","653","231","422","56","709","1211","0","58.55","19.08"
"65","000","00","005","0504","0307","677","241","436","42","719","1176","0","61.14","20.49"
"65","000","00","005","0504","0308","888","332","556","50","938","1536","0","61.07","21.61"
"65","000","00","005","0505","0000","2098","809","1289","94","2192","3872","0","56.61","20.89"
"65","000","00","005","0505","0333","829","307","522","37","866","1536","0","56.38","19.99"
"65","000","00","005","0505","0334","880","359","521","45","925","1587","0","58.29","22.62"
"65","000","00","005","0505","0335","389","143","246","12","401","749","0","53.54","19.09"
"65","000","00","005","0506","0000","1893","675","1218","130","2023","3313","0","61.06","20.37"
"65","000","00","005","0506","0446","608","229","379","52","660","1107","0","59.62","20.69"
"65","000","00","005","0506","0447","640","228","412","33","673","1063","0","63.31","21.45"
"65","000","00","005","0506","0448","645","218","427","45","690","1143","0","60.37","19.07"
"65","000","00","005","0507","0000","2323","818","1505","143","2466","4240","0","58.16","19.29"
"65","000","00","005","0507","0312","714","256","458","56","770","1353","0","56.91","18.92"
"65","000","00","005","0507","0313","809","279","530","60","869","1409","0","61.67","19.8"
"65","000","00","005","0507","0314","800","283","517","27","827","1478","0","55.95","19.15"
"65","000","00","005","0508","0000","2063","803","1260","176","2239","3930","0","56.97","20.43"
"65","000","00","005","0508","0383","679","258","421","62","741","1342","0","55.22","19.23"
"65","000","00","005","0508","0384","721","281","440","60","781","1341","0","58.24","20.95"
"65","000","00","005","0508","0385","663","264","399","54","717","1247","0","57.5","21.17"
"65","000","00","005","0509","0000","3355","1295","2060","172","3527","6296","0","56.02","20.57"
"65","000","00","005","0509","0501","787","294","493","46","833","1539","0","54.13","19.1"
"65","000","00","005","0509","0502","863","342","521","38","901","1586","0","56.81","21.56"
"65","000","00","005","0509","0503","881","323","558","55","936","1631","0","57.39","19.8"
"65","000","00","005","0509","0504","824","336","488","33","857","1540","0","55.65","21.82"
"65","000","00","005","0510","0000","1101","410","691","82","1183","1892","0","62.53","21.67"
"65","000","00","005","0510","0315","534","204","330","45","579","921","0","62.87","22.15"
"65","000","00","005","0510","0316","567","206","361","37","604","971","0","62.2","21.22"
"65","000","00","005","0511","0000","2798","989","1809","192","2990","5088","0","58.77","19.44"
"65","000","00","005","0511","0379","669","243","426","63","732","1167","0","62.72","20.82"
"65","000","00","005","0511","0380","672","224","448","48","720","1299","0","55.43","17.24"
"65","000","00","005","0511","0381","667","244","423","38","705","1207","0","58.41","20.22"
"65","000","00","005","0511","0382","790","278","512","43","833","1415","0","58.87","19.65"
"65","000","00","005","0512","0000","1384","524","860","113","1497","2771","0","54.02","18.91"
"65","000","00","005","0512","0518","664","250","414","58","722","1371","0","52.66","18.23"
"65","000","00","005","0512","0519","720","274","446","55","775","1400","0","55.36","19.57"
"65","000","00","005","0513","0000","1708","638","1070","84","1792","3070","0","58.37","20.78"
"65","000","00","005","0513","0319","386","150","236","26","412","697","0","59.11","21.52"
"65","000","00","005","0513","0320","693","251","442","26","719","1235","0","58.22","20.32"
"65","000","00","005","0513","0321","629","237","392","32","661","1138","0","58.08","20.83"
"65","000","00","005","0514","0000","2285","812","1473","162","2447","4068","0","60.15","19.96"
"65","000","00","005","0514","0390","747","303","444","39","786","1346","0","58.4","22.51"
"65","000","00","005","0514","0391","760","248","512","69","829","1372","0","60.42","18.08"
"65","000","00","005","0514","0392","778","261","517","54","832","1350","0","61.63","19.33"
"65","000","00","005","0515","0000","5188","1920","3268","241","5429","9838","0","55.18","19.52"
"65","000","00","005","0515","0547","644","229","415","33","677","1126","0","60.12","20.34"
"65","000","00","005","0515","0548","690","248","442","31","721","1240","0","58.15","20.0"
"65","000","00","005","0515","0549","798","284","514","37","835","1460","0","57.19","19.45"
"65","000","00","005","0515","0550","567","214","353","33","600","1072","0","55.97","19.96"
"65","000","00","005","0515","0551","553","207","346","40","593","1127","0","52.62","18.37"
"65","000","00","005","0515","0552","753","262","491","23","776","1332","0","58.26","19.67"
"65","000","00","005","0515","0553","694","285","409","15","709","1341","0","52.87","21.25"
"65","000","00","005","0515","0554","489","191","298","29","518","1140","0","45.44","16.75"
"65","000","00","005","0516","0000","1364","522","842","56","1420","4462","0","31.82","11.7"
"65","000","00","005","0516","0322","553","196","357","19","572","1063","0","53.81","18.44"
"65","000","00","005","0516","0323","811","326","485","37","848","3399","0","24.95","9.59"
"65","000","00","005","0517","0000","2086","723","1363","146","2232","3947","0","56.55","18.32"
"65","000","00","005","0517","0393","671","241","430","59","730","1307","0","55.85","18.44"
"65","000","00","005","0517","0394","708","253","455","68","776","1353","0","57.35","18.7"
"65","000","00","005","0517","0395","707","229","478","19","726","1287","0","56.41","17.79"
"65","000","00","005","0518","0000","2763","982","1781","190","2953","5155","0","57.28","19.05"
"65","000","00","005","0518","0452","716","244","472","34","750","1309","0","57.3","18.64"
"65","000","00","005","0518","0453","694","247","447","43","737","1216","0","60.61","20.31"
"65","000","00","005","0518","0454","643","199","444","48","691","1278","0","54.07","15.57"
"65","000","00","005","0518","0455","710","292","418","65","775","1352","0","57.32","21.6"
"65","000","00","005","0519","0000","871","313","558","64","935","1575","0","59.37","19.87"
"65","000","00","005","0519","0324","871","313","558","64","935","1575","0","59.37","19.87"
"65","000","00","005","0520","0000","1012","363","649","100","1112","1907","0","58.31","19.04"
"65","000","00","005","0520","0413","535","193","342","36","571","955","0","59.79","20.21"
"65","000","00","005","0520","0414","477","170","307","64","541","952","0","56.83","17.86"
"65","000","00","005","0521","0000","3016","1064","1952","242","3258","6100","0","53.41","17.44"
"65","000","00","005","0521","0485","758","263","495","67","825","1505","0","54.82","17.48"
"65","000","00","005","0521","0486","754","267","487","70","824","1527","0","53.96","17.49"
"65","000","00","005","0521","0487","742","263","479","38","780","1482","0","52.63","17.75"
"65","000","00","005","0521","0488","762","271","491","67","829","1586","0","52.27","17.09"
"65","000","00","005","0522","0000","964","392","572","52","1016","1615","0","62.91","24.27"
"65","000","00","005","0522","0325","964","392","572","52","1016","1615","0","62.91","24.27"
"65","000","00","005","0523","0000","3108","1143","1965","188","3296","5541","0","59.48","20.63"
"65","000","00","005","0523","0415","778","305","473","28","806","1412","0","57.08","21.6"
"65","000","00","005","0523","0416","768","268","500","56","824","1415","0","58.23","18.94"
"65","000","00","005","0523","0417","796","273","523","61","857","1421","0","60.31","19.21"
"65","000","00","005","0523","0418","766","297","469","43","809","1293","0","62.57","22.97"
"65","000","00","005","0524","0000","1155","421","734","88","1243","2161","0","57.52","19.48"
"65","000","00","005","0524","0491","571","215","356","42","613","1090","0","56.24","19.72"
"65","000","00","005","0524","0492","584","206","378","46","630","1071","0","58.82","19.23"
"65","000","00","005","0525","0000","2457","886","1571","166","2623","4748","0","55.24","18.66"
"65","000","00","005","0525","0371","833","308","525","56","889","1571","0","56.59","19.61"
"65","000","00","005","0525","0372","811","299","512","53","864","1594","0","54.2","18.76"
"65","000","00","005","0525","0373","813","279","534","57","870","1583","0","54.96","17.62"
"65","000","00","005","0526","0000","1222","390","832","61","1283","2027","0","63.3","19.24"
"65","000","00","005","0526","0386","623","175","448","21","644","984","0","65.45","17.78"
"65","000","00","005","0526","0387","599","215","384","40","639","1043","0","61.27","20.61"
"65","000","00","005","0527","0000","2505","997","1508","154","2659","4704","0","56.53","21.19"
"65","000","00","005","0527","0508","587","217","370","33","620","1181","0","52.5","18.37"
"65","000","00","005","0527","0509","607","235","372","55","662","1135","0","58.33","20.7"
"65","000","00","005","0527","0510","645","254","391","30","675","1173","0","57.54","21.65"
"65","000","00","005","0527","0511","666","291","375","36","702","1215","0","57.78","23.95"
"65","000","00","005","0528","0000","1227","446","781","127","1354","2406","0","56.28","18.54"
"65","000","00","005","0528","0362","575","210","365","58","633","1170","0","54.1","17.95"
"65","000","00","005","0528","0363","652","236","416","69","721","1236","0","58.33","19.09"
"65","000","00","005","0529","0000","1397","549","848","63","1460","2320","0","62.93","23.66"
"65","000","00","005","0529","0388","721","279","442","36","757","1135","0","66.7","24.58"
"65","000","00","005","0529","0389","676","270","406","27","703","1185","0","59.32","22.78"
"65","000","00","005","0530","0000","2479","861","1618","219","2698","4728","0","57.06","18.21"
"65","000","00","005","0530","0353","819","288","531","76","895","1558","0","57.45","18.49"
"65","000","00","005","0530","0354","782","275","507","71","853","1567","0","54.44","17.55"
"65","000","00","005","0530","0355","878","298","580","72","950","1603","0","59.26","18.59"
"65","000","00","005","0531","0000","2592","877","1715","189","2781","4477","0","62.12","19.59"
"65","000","00","005","0531","0443","833","290","543","73","906","1535","0","59.02","18.89"
"65","000","00","005","0531","0444","912","280","632","47","959","1492","0","64.28","18.77"
"65","000","00","005","0531","0445","847","307","540","69","916","1450","0","63.17","21.17"
"65","000","00","005","0532","0000","2820","986","1834","153","2973","5219","0","56.96","18.89"
"65","000","00","005","0532","0523","690","241","449","53","743","1318","0","56.37","18.29"
"65","000","00","005","0532","0524","682","212","470","54","736","1411","0","52.16","15.02"
"65","000","00","005","0532","0525","723","279","444","28","751","1262","0","59.51","22.11"
"65","000","00","005","0532","0526","725","254","471","18","743","1228","0","60.5","20.68"
"65","000","00","005","0533","0000","2163","853","1310","172","2335","4251","0","54.93","20.07"
"65","000","00","005","0533","0344","651","251","400","53","704","1351","0","52.11","18.58"
"65","000","00","005","0533","0345","734","310","424","61","795","1403","0","56.66","22.1"
"65","000","00","005","0533","0346","778","292","486","58","836","1497","0","55.85","19.51"
"65","000","00","005","0534","0000","1608","548","1060","99","1707","3285","0","51.96","16.68"
"65","000","00","005","0534","0438","753","268","485","49","802","1633","0","49.11","16.41"
"65","000","00","005","0534","0439","855","280","575","50","905","1652","0","54.78","16.95"
"65","000","00","005","0535","0000","1293","445","848","88","1381","2670","0","51.72","16.67"
"65","000","00","005","0535","0529","662","244","418","46","708","1326","0","53.39","18.4"
"65","000","00","005","0535","0530","631","201","430","42","673","1344","0","50.07","14.96"
"65","000","00","005","0536","0000","1582","574","1008","111","1693","3126","0","54.16","18.36"
"65","000","00","005","0536","0326","788","297","491","61","849","1612","0","52.67","18.42"
"65","000","00","005","0536","0327","794","277","517","50","844","1514","0","55.75","18.3"
"65","000","00","005","0537","0000","2026","731","1295","95","2121","3484","0","60.88","20.98"
"65","000","00","005","0537","0400","653","226","427","55","708","1148","0","61.67","19.69"
"65","000","00","005","0537","0401","677","245","432","4","681","1201","0","56.7","20.4"
"65","000","00","005","0537","0402","696","260","436","36","732","1135","0","64.49","22.91"
"65","000","00","005","0538","0000","3209","1131","2078","203","3412","6209","0","54.95","18.22"
"65","000","00","005","0538","0542","624","226","398","40","664","1245","0","53.33","18.15"
"65","000","00","005","0538","0543","616","207","409","40","656","1212","0","54.13","17.08"
"65","000","00","005","0538","0544","628","229","399","57","685","1253","0","54.67","18.28"
"65","000","00","005","0538","0545","638","214","424","39","677","1272","0","53.22","16.82"
"65","000","00","005","0538","0546","703","255","448","27","730","1227","0","59.49","20.78"
"65","000","00","005","0539","0000","2151","804","1347","133","2284","3713","0","61.51","21.65"
"65","000","00","005","0539","0374","717","230","487","55","772","1245","0","62.01","18.47"
"65","000","00","005","0539","0375","685","261","424","30","715","1203","0","59.43","21.7"
"65","000","00","005","0539","0376","749","313","436","48","797","1265","0","63.0","24.74"
"65","000","00","005","0540","0000","1109","383","726","73","1182","1990","0","59.4","19.25"
"65","000","00","005","0540","0458","444","164","280","26","470","881","0","53.35","18.62"
"65","000","00","005","0540","0459","665","219","446","47","712","1109","0","64.2","19.75"
"65","000","00","005","0541","0000","2066","708","1358","116","2182","3833","0","56.93","18.47"
"65","000","00","005","0541","0537","700","241","459","29","729","1301","0","56.03","18.52"
"65","000","00","005","0541","0538","677","232","445","50","727","1262","0","57.61","18.38"
"65","000","00","005","0541","0539","689","235","454","37","726","1270","0","57.17","18.5"
"65","000","00","005","0542","0000","1276","407","869","67","1343","2442","0","55.0","16.67"
"65","000","00","005","0542","0369","671","221","450","35","706","1225","0","57.63","18.04"
"65","000","00","005","0542","0370","605","186","419","32","637","1217","0","52.34","15.28"
"65","000","00","005","0543","0000","3896","1394","2502","228","4124","7475","0","55.17","18.65"
"65","000","00","005","0543","0460","672","221","451","49","721","1291","0","55.85","17.12"
"65","000","00","005","0543","0461","681","269","412","21","702","1293","0","54.29","20.8"
"65","000","00","005","0543","0462","732","290","442","57","789","1336","0","59.06","21.71"
"65","000","00","005","0543","0463","700","236","464","42","742","1384","0","53.61","17.05"
"65","000","00","005","0543","0464","602","215","387","35","637","1231","0","51.75","17.47"
"65","000","00","005","0543","0465","509","163","346","24","533","940","0","56.7","17.34"
"65","000","00","005","0544","0000","2183","743","1440","147","2330","4010","0","58.1","18.53"
"65","000","00","005","0544","0531","726","231","495","44","770","1355","0","56.83","17.05"
"65","000","00","005","0544","0532","697","227","470","65","762","1306","0","58.35","17.38"
"65","000","00","005","0544","0533","760","285","475","38","798","1349","0","59.15","21.13"
"65","000","00","005","0545","0000","2429","813","1616","179","2608","4756","0","54.84","17.09"
"65","000","00","005","0545","0366","923","326","597","33","956","1586","0","60.28","20.55"
"65","000","00","005","0545","0367","771","245","526","59","830","1597","0","51.97","15.34"
"65","000","00","005","0545","0368","735","242","493","87","822","1573","0","52.26","15.38"
"65","000","00","005","0546","0000","2076","736","1340","210","2286","4025","0","56.8","18.29"
"65","000","00","005","0546","0466","685","252","433","82","767","1369","0","56.03","18.41"
"65","000","00","005","0546","0467","708","220","488","67","775","1384","0","56.0","15.9"
"65","000","00","005","0546","0468","683","264","419","61","744","1272","0","58.49","20.75"
"65","000","00","005","0547","0000","2052","755","1297","171","2223","3876","0","57.35","19.48"
"65","000","00","005","0547","0347","704","244","460","70","774","1272","0","60.85","19.18"
"65","000","00","005","0547","0348","625","228","397","29","654","1269","0","51.54","17.97"
"65","000","00","005","0547","0349","723","283","440","72","795","1335","0","59.55","21.2"
"65","000","00","005","0548","0000","4918","1680","3238","255","5173","9217","0","56.12","18.23"
"65","000","00","005","0548","0471","825","309","516","22","847","1528","0","55.43","20.22"
"65","000","00","005","0548","0472","633","202","431","46","679","1244","0","54.58","16.24"
"65","000","00","005","0548","0473","681","198","483","48","729","1356","0","53.76","14.6"
"65","000","00","005","0548","0474","583","178","405","24","607","1164","0","52.15","15.29"
"65","000","00","005","0548","0475","786","272","514","54","840","1423","0","59.03","19.11"
"65","000","00","005","0548","0476","746","270","476","31","777","1250","0","62.16","21.6"
"65","000","00","005","0548","0477","664","251","413","30","694","1252","0","55.43","20.05"
"65","000","00","005","0549","0000","1165","416","749","91","1256","2200","0","57.09","18.91"
"65","000","00","005","0549","0364","556","192","364","54","610","1071","0","56.96","17.93"
"65","000","00","005","0549","0365","609","224","385","37","646","1129","0","57.22","19.84"
"65","000","00","005","0550","0000","4303","1689","2614","193","4496","7788","0","57.73","21.69"
"65","000","00","005","0550","0480","911","352","559","42","953","1646","0","57.9","21.39"
"65","000","00","005","0550","0481","812","345","467","54","866","1551","0","55.83","22.24"
"65","000","00","005","0550","0482","866","310","556","42","908","1526","0","59.5","20.31"
"65","000","00","005","0550","0483","843","337","506","24","867","1518","0","57.11","22.2"
"65","000","00","005","0550","0484","871","345","526","31","902","1547","0","58.31","22.3"
"65","000","00","005","0551","0000","1407","499","908","98","1505","2542","0","59.21","19.63"
"65","000","00","005","0551","0377","695","236","459","63","758","1255","0","60.4","18.8"
"65","000","00","005","0551","0378","712","263","449","35","747","1287","0","58.04","20.44"
"65","000","00","005","0552","0000","2138","774","1364","119","2257","4004","0","56.37","19.33"
"65","000","00","005","0552","0435","853","304","549","48","901","1584","0","56.88","19.19"
"65","000","00","005","0552","0436","838","296","542","33","871","1602","0","54.37","18.48"
"65","000","00","005","0552","0437","447","174","273","38","485","818","0","59.29","21.27"
"65","000","00","005","0553","0000","4930","1823","3107","260","5190","9369","0","55.4","19.46"
"65","000","00","005","0553","0429","785","302","483","50","835","1641","0","50.88","18.4"
"65","000","00","005","0553","0430","825","339","486","42","867","1633","0","53.09","20.76"
"65","000","00","005","0553","0431","853","304","549","22","875","1531","0","57.15","19.86"
"65","000","00","005","0553","0432","851","317","534","52","903","1517","0","59.53","20.9"
"65","000","00","005","0553","0433","761","244","517","59","820","1487","0","55.14","16.41"
"65","000","00","005","0553","0434","855","317","538","35","890","1560","0","57.05","20.32"
"65","000","00","005","0554","0000","4011","1442","2569","210","4221","7331","0","57.58","19.67"
"65","000","00","005","0554","0419","767","287","480","26","793","1475","0","53.76","19.46"
"65","000","00","005","0554","0420","764","277","487","57","821","1429","0","57.45","19.38"
"65","000","00","005","0554","0421","810","295","515","39","849","1481","0","57.33","19.92"
"65","000","00","005","0554","0422","828","267","561","63","891","1472","0","60.53","18.14"
"65","000","00","005","0554","0423","842","316","526","25","867","1474","0","58.82","21.44"
"65","000","00","005","0555","0000","1944","711","1233","168","2112","4163","0","50.73","17.08"
"65","000","00","005","0555","0505","651","227","424","44","695","1388","0","50.07","16.35"
"65","000","00","005","0555","0506","644","240","404","73","717","1388","0","51.66","17.29"
"65","000","00","005","0555","0507","649","244","405","51","700","1387","0","50.47","17.59"
"65","000","00","005","0556","0000","1279","438","841","103","1382","2241","0","61.67","19.54"
"65","000","00","005","0556","0499","630","205","425","54","684","1130","0","60.53","18.14"
"65","000","00","005","0556","0500","649","233","416","49","698","1111","0","62.83","20.97"
"65","000","00","005","0557","0000","1677","630","1047","91","1768","3276","0","53.97","19.23"
"65","000","00","005","0557","0396","712","257","455","31","743","1567","0","47.42","16.4"
"65","000","00","005","0557","0397","965","373","592","60","1025","1709","0","59.98","21.83"
"65","000","00","005","0558","0000","1607","608","999","88","1695","3244","0","52.25","18.74"
"65","000","00","005","0558","0398","813","284","529","37","850","1616","0","52.6","17.57"
"65","000","00","005","0558","0399","794","324","470","51","845","1628","0","51.9","19.9"
"65","000","00","005","0559","0000","2278","815","1463","139","2417","4258","0","56.76","19.14"
"65","000","00","005","0559","0440","792","309","483","48","840","1498","0","56.07","20.63"
"65","000","00","005","0559","0441","714","257","457","46","760","1379","0","55.11","18.64"
"65","000","00","005","0559","0442","772","249","523","45","817","1381","0","59.16","18.03"
"65","000","00","005","0560","0000","2619","1011","1608","174","2793","4394","0","63.56","23.01"
"65","000","00","005","0560","0309","880","342","538","51","931","1486","0","62.65","23.01"
"65","000","00","005","0560","0310","906","343","563","68","974","1513","0","64.38","22.67"
"65","000","00","005","0560","0311","833","326","507","55","888","1395","0","63.66","23.37"
"65","000","00","005","0561","0000","1739","601","1138","178","1917","3322","0","57.71","18.09"
"65","000","00","005","0561","0360","935","347","588","90","1025","1696","0","60.44","20.46"
"65","000","00","005","0561","0361","804","254","550","88","892","1626","0","54.86","15.62"
"65","000","00","005","0562","0000","3182","1208","1974","162","3344","5442","0","61.45","22.2"
"65","000","00","005","0562","0409","811","300","511","61","872","1389","0","62.78","21.6"
"65","000","00","005","0562","0410","697","258","439","40","737","1272","0","57.94","20.28"
"65","000","00","005","0562","0411","858","336","522","33","891","1409","0","63.24","23.85"
"65","000","00","005","0562","0412","816","314","502","28","844","1372","0","61.52","22.89"
"65","000","00","005","0563","0000","1765","686","1079","80","1845","3243","0","56.89","21.15"
"65","000","00","005","0563","0358","868","315","553","39","907","1698","0","53.42","18.55"
"65","000","00","005","0563","0359","897","371","526","41","938","1545","0","60.71","24.01"
"65","000","00","005","0564","0000","3256","1218","2038","92","3348","5852","0","57.21","20.81"
"65","000","00","005","0564","0340","837","302","535","12","849","1493","0","56.87","20.23"
"65","000","00","005","0564","0341","836","303","533","41","877","1507","0","58.2","20.11"
"65","000","00","005","0564","0342","809","315","494","12","821","1456","0","56.39","21.63"
"65","000","00","005","0564","0343","774","298","476","27","801","1396","0","57.38","21.35"
"65","000","00","005","0565","0000","1711","568","1143","99","1810","3050","0","59.34","18.62"
"65","000","00","005","0565","0317","897","301","596","66","963","1534","0","62.78","19.62"
"65","000","00","005","0565","0318","814","267","547","33","847","1516","0","55.87","17.61"
"65","000","00","005","0566","0000","1745","628","1117","156","1901","3301","0","57.59","19.02"
"65","000","00","005","0566","0497","881","313","568","82","963","1689","0","57.02","18.53"
"65","000","00","005","0566","0498","864","315","549","74","938","1612","0","58.19","19.54"
"65","000","00","005","0567","0000","1190","413","777","107","1297","2105","0","61.62","19.62"
"65","000","00","005","0567","0489","553","197","356","68","621","1065","0","58.31","18.5"
"65","000","00","005","0567","0490","637","216","421","39","676","1040","0","65.0","20.77"
"65","000","00","005","0568","0000","1187","434","753","105","1292","2340","0","55.21","18.55"
"65","000","00","005","0568","0456","619","235","384","61","680","1298","0","52.39","18.1"
"65","000","00","005","0568","0457","568","199","369","44","612","1042","0","58.73","19.1"
"65","000","00","005","0569","0000","1581","620","961","85","1666","2712","0","61.43","22.86"
"65","000","00","005","0569","0495","806","297","509","47","853","1362","0","62.63","21.81"
"65","000","00","005","0569","0496","775","323","452","38","813","1350","0","60.22","23.93"
"65","000","00","005","0570","0000","3188","1236","1952","144","3332","5880","0","56.67","21.02"
"65","000","00","005","0570","0512","820","318","502","48","868","1488","0","58.33","21.37"
"65","000","00","005","0570","0513","782","310","472","41","823","1444","0","56.99","21.47"
"65","000","00","005","0570","0514","808","308","500","29","837","1499","0","55.84","20.55"
"65","000","00","005","0570","0515","778","300","478","26","804","1449","0","55.49","20.7"
"65","000","00","005","0571","0000","2237","823","1414","190","2427","4371","0","55.53","18.83"
"65","000","00","005","0571","0520","749","260","489","73","822","1457","0","56.42","17.84"
"65","000","00","005","0571","0521","764","294","470","56","820","1502","0","54.59","19.57"
"65","000","00","005","0571","0522","724","269","455","61","785","1412","0","55.59","19.05"
"65","000","00","005","0572","0000","2894","1034","1860","164","3058","5129","0","59.62","20.16"
"65","000","00","005","0572","0336","718","239","479","43","761","1276","0","59.64","18.73"
"65","000","00","005","0572","0337","719","283","436","28","747","1303","0","57.33","21.72"
"65","000","00","005","0572","0338","719","256","463","49","768","1259","0","61.0","20.33"
"65","000","00","005","0572","0339","738","256","482","44","782","1291","0","60.57","19.83"
"65","000","00","005","0573","0000","1763","677","1086","63","1826","3209","0","56.9","21.1"
"65","000","00","005","0573","0356","835","324","511","25","860","1538","0","55.92","21.07"
"65","000","00","005","0573","0357","928","353","575","38","966","1671","0","57.81","21.13"
"65","000","00","005","0574","0000","2282","845","1437","121","2403","3841","0","62.56","22.0"
"65","000","00","005","0574","0350","762","300","462","32","794","1300","0","61.08","23.08"
"65","000","00","005","0574","0351","730","265","465","49","779","1286","0","60.58","20.61"
"65","000","00","005","0574","0352","790","280","510","40","830","1255","0","66.14","22.31"
"65","000","00","005","0575","0000","4195","1561","2634","118","4313","7288","0","59.18","21.42"
"65","000","00","005","0575","0424","859","333","526","14","873","1462","0","59.71","22.78"
"65","000","00","005","0575","0425","871","340","531","18","889","1484","0","59.91","22.91"
"65","000","00","005","0575","0426","810","282","528","30","840","1461","0","57.49","19.3"
"65","000","00","005","0575","0427","824","300","524","32","856","1444","0","59.28","20.78"
"65","000","00","005","0575","0428","831","306","525","24","855","1437","0","59.5","21.29"
"65","000","00","005","0576","0000","5364","1961","3403","223","5587","9313","0","59.99","21.06"
"65","000","00","005","0576","0403","869","314","555","55","924","1495","0","61.81","21.0"
"65","000","00","005","0576","0404","866","328","538","50","916","1486","0","61.64","22.07"
"65","000","00","005","0576","0405","887","312","575","33","920","1483","0","62.04","21.04"
"65","000","00","005","0576","0406","825","277","548","35","860","1553","0","55.38","17.84"
"65","000","00","005","0576","0407","983","384","599","23","1006","1625","0","61.91","23.63"
"65","000","00","005","0576","0408","934","346","588","27","961","1671","0","57.51","20.71"
"65","000","00","005","0577","0000","1209","427","782","77","1286","2159","0","59.56","19.78"
"65","000","00","005","0577","0450","588","205","383","37","625","1063","0","58.8","19.29"
"65","000","00","005","0577","0451","621","222","399","40","661","1096","0","60.31","20.26"
"65","000","00","005","0578","0000","1646","618","1028","67","1713","3402","0","50.35","18.17"
"65","000","00","005","0578","0493","823","307","516","37","860","1704","0","50.47","18.02"
"65","000","00","005","0578","0494","823","311","512","30","853","1698","0","50.24","18.32"
"65","000","00","005","0579","0000","966","378","588","60","1026","1981","0","51.79","19.08"
"65","000","00","005","0579","0478","444","193","251","16","460","1022","0","45.01","18.88"
"65","000","00","005","0579","0479","522","185","337","44","566","959","0","59.02","19.29"
"65","000","00","005","0580","0000","1180","427","753","58","1238","2131","0","58.09","20.04"
"65","000","00","005","0580","0469","606","216","390","29","635","1073","0","59.18","20.13"
"65","000","00","005","0580","0470","574","211","363","29","603","1058","0","56.99","19.94"
"65","000","00","005","0581","0000","1717","642","1075","120","1837","3288","0","55.87","19.53"
"65","000","00","005","0581","0516","872","332","540","55","927","1640","0","56.52","20.24"
"65","000","00","005","0581","0517","845","310","535","65","910","1648","0","55.22","18.81"
"65","000","00","005","0582","0000","1923","859","1064","130","2053","3509","0","58.51","24.48"
"65","000","00","005","0582","0527","970","426","544","53","1023","1748","0","58.52","24.37"
"65","000","00","005","0582","0528","953","433","520","77","1030","1761","0","58.49","24.59"
"65","000","00","005","0583","0000","2117","732","1385","135","2252","3784","0","59.51","19.34"
"65","000","00","005","0583","0534","689","253","436","38","727","1265","0","57.47","20.0"
"65","000","00","005","0583","0535","717","236","481","58","775","1282","0","60.45","18.41"
"65","000","00","005","0583","0536","711","243","468","39","750","1237","0","60.63","19.64"
"65","000","00","005","0584","0000","1191","479","712","128","1319","2465","0","53.51","19.43"
"65","000","00","005","0584","0540","669","266","403","63","732","1245","0","58.8","21.37"
"65","000","00","005","0584","0541","522","213","309","65","587","1220","0","48.11","17.46"
"65","000","00","006","0000","0000","142311","48345","93966","7075","149386","264053","302055","56.57","18.31"
"65","000","00","006","0601","0000","1663","606","1057","104","1767","3019","0","58.53","20.07"
"65","000","00","006","0601","2049","869","326","543","50","919","1552","0","59.21","21.01"
"65","000","00","006","0601","2050","794","280","514","54","848","1467","0","57.81","19.09"
"65","000","00","006","0602","0000","2042","715","1327","110","2152","3593","0","59.89","19.9"
"65","000","00","006","0602","2051","761","258","503","38","799","1371","0","58.28","18.82"
"65","000","00","006","0602","2052","571","199","372","30","601","991","0","60.65","20.08"
"65","000","00","006","0602","2053","710","258","452","42","752","1231","0","61.09","20.96"
"65","000","00","006","0603","0000","1888","676","1212","104","1992","3408","0","58.45","19.84"
"65","000","00","006","0603","2054","943","336","607","52","995","1701","0","58.5","19.75"
"65","000","00","006","0603","2055","945","340","605","52","997","1707","0","58.41","19.92"
"65","000","00","006","0604","0000","1927","654","1273","68","1995","3639","0","54.82","17.97"
"65","000","00","006","0604","2056","968","329","639","36","1004","1773","0","56.63","18.56"
"65","000","00","006","0604","2057","959","325","634","32","991","1866","0","53.11","17.42"
"65","000","00","006","0605","0000","2920","1058","1862","110","3030","4958","0","61.11","21.34"
"65","000","00","006","0605","2058","1000","363","637","33","1033","1735","0","59.54","20.92"
"65","000","00","006","0605","2059","1019","370","649","31","1050","1632","0","64.34","22.67"
"65","000","00","006","0605","2060","901","325","576","46","947","1591","0","59.52","20.43"
"65","000","00","006","0606","0000","2756","928","1828","131","2887","4790","0","60.27","19.37"
"65","000","00","006","0606","2063","684","241","443","52","736","1260","0","58.41","19.13"
"65","000","00","006","0606","2064","1126","367","759","40","1166","1948","0","59.86","18.84"
"65","000","00","006","0606","2065","946","320","626","39","985","1582","0","62.26","20.23"
"65","000","00","006","0607","0000","2755","945","1810","107","2862","5031","0","56.89","18.78"
"65","000","00","006","0607","2070","951","328","623","31","982","1735","0","56.6","18.9"
"65","000","00","006","0607","2071","915","293","622","39","954","1716","0","55.59","17.07"
"65","000","00","006","0607","2072","889","324","565","37","926","1580","0","58.61","20.51"
"65","000","00","006","0608","0000","3394","1217","2177","177","3571","5947","0","60.05","20.46"
"65","000","00","006","0608","2073","810","311","499","41","851","1358","0","62.67","22.9"
"65","000","00","006","0608","2074","937","346","591","65","1002","1610","0","62.24","21.49"
"65","000","00","006","0608","2075","747","257","490","37","784","1383","0","56.69","18.58"
"65","000","00","006","0608","2076","900","303","597","34","934","1596","0","58.52","18.98"
"65","000","00","006","0609","0000","1288","392","896","51","1339","2520","0","53.13","15.56"
"65","000","00","006","0609","2077","689","224","465","38","727","1360","0","53.46","16.47"
"65","000","00","006","0609","2078","599","168","431","13","612","1160","0","52.76","14.48"
"65","000","00","006","0610","0000","1567","452","1115","51","1618","2470","0","65.51","18.3"
"65","000","00","006","0610","2079","786","192","594","34","820","1236","0","66.34","15.53"
"65","000","00","006","0610","2080","781","260","521","17","798","1234","0","64.67","21.07"
"65","000","00","006","0611","0000","1510","499","1011","117","1627","2820","0","57.7","17.7"
"65","000","00","006","0611","2081","840","292","548","76","916","1579","0","58.01","18.49"
"65","000","00","006","0611","2082","670","207","463","41","711","1241","0","57.29","16.68"
"65","000","00","006","0612","0000","718","252","466","72","790","1578","0","50.06","15.97"
"65","000","00","006","0612","2085","718","252","466","72","790","1578","0","50.06","15.97"
"65","000","00","006","0613","0000","1461","522","939","106","1567","2917","0","53.72","17.9"
"65","000","00","006","0613","2086","756","292","464","39","795","1442","0","55.13","20.25"
"65","000","00","006","0613","2087","705","230","475","67","772","1475","0","52.34","15.59"
"65","000","00","006","0614","0000","4256","1402","2854","211","4467","7921","0","56.39","17.7"
"65","000","00","006","0614","2088","887","301","586","45","932","1580","0","58.99","19.05"
"65","000","00","006","0614","2089","854","224","630","28","882","1585","0","55.65","14.13"
"65","000","00","006","0614","2090","835","301","534","58","893","1586","0","56.31","18.98"
"65","000","00","006","0614","2091","1022","358","664","55","1077","1931","0","55.77","18.54"
"65","000","00","006","0614","2092","658","218","440","25","683","1239","0","55.13","17.59"
"65","000","00","006","0615","0000","2339","761","1578","212","2551","4617","0","55.25","16.48"
"65","000","00","006","0615","2097","913","318","595","102","1015","1885","0","53.85","16.87"
"65","000","00","006","0615","2098","676","213","463","59","735","1345","0","54.65","15.84"
"65","000","00","006","0615","2099","750","230","520","51","801","1387","0","57.75","16.58"
"65","000","00","006","0616","0000","5498","1853","3645","297","5795","10556","0","54.9","17.55"
"65","000","00","006","0616","2105","932","313","619","59","991","1835","0","54.01","17.06"
"65","000","00","006","0616","2106","1025","339","686","58","1083","2009","0","53.91","16.87"
"65","000","00","006","0616","2107","759","240","519","53","812","1450","0","56.0","16.55"
"65","000","00","006","0616","2108","924","316","608","37","961","1726","0","55.68","18.31"
"65","000","00","006","0616","2109","923","332","591","53","976","1797","0","54.31","18.48"
"65","000","00","006","0616","2110","935","313","622","37","972","1739","0","55.89","18.0"
"65","000","00","006","0617","0000","2765","994","1771","146","2911","5599","0","51.99","17.75"
"65","000","00","006","0617","2114","820","284","536","38","858","1662","0","51.62","17.09"
"65","000","00","006","0617","2115","1123","410","713","60","1183","2067","0","57.23","19.84"
"65","000","00","006","0617","2116","822","300","522","48","870","1870","0","46.52","16.04"
"65","000","00","006","0618","0000","2730","937","1793","151","2881","5222","0","55.17","17.94"
"65","000","00","006","0618","2123","508","177","331","36","544","1079","0","50.42","16.4"
"65","000","00","006","0618","2124","598","198","400","21","619","1140","0","54.3","17.37"
"65","000","00","006","0618","2125","951","321","630","52","1003","1825","0","54.96","17.59"
"65","000","00","006","0618","2126","673","241","432","42","715","1178","0","60.7","20.46"
"65","000","00","006","0619","0000","2429","796","1633","160","2589","5277","0","49.06","15.08"
"65","000","00","006","0619","2133","903","287","616","69","972","1992","0","48.8","14.41"
"65","000","00","006","0619","2134","764","255","509","53","817","1668","0","48.98","15.29"
"65","000","00","006","0619","2135","762","254","508","38","800","1617","0","49.47","15.71"
"65","000","00","006","0620","0000","2893","981","1912","157","3050","5428","0","56.19","18.07"
"65","000","00","006","0620","2136","1000","343","657","78","1078","2013","0","53.55","17.04"
"65","000","00","006","0620","2137","1008","350","658","36","1044","1791","0","58.29","19.54"
"65","000","00","006","0620","2138","885","288","597","43","928","1624","0","57.14","17.73"
"65","000","00","006","0621","0000","413","125","288","38","451","939","0","48.03","13.31"
"65","000","00","006","0621","2142","413","125","288","38","451","939","0","48.03","13.31"
"65","000","00","006","0622","0000","2621","871","1750","105","2726","4725","0","57.69","18.43"
"65","000","00","006","0622","2148","1041","354","687","40","1081","1860","0","58.12","19.03"
"65","000","00","006","0622","2149","871","277","594","37","908","1743","0","52.09","15.89"
"65","000","00","006","0622","2150","709","240","469","28","737","1122","0","65.69","21.39"
"65","000","00","006","0623","0000","2373","808","1565","99","2472","4575","0","54.03","17.66"
"65","000","00","006","0623","2151","777","215","562","38","815","1468","0","55.52","14.65"
"65","000","00","006","0623","2152","920","340","580","32","952","1763","0","54.0","19.29"
"65","000","00","006","0623","2153","676","253","423","29","705","1344","0","52.46","18.82"
"65","000","00","006","0624","0000","365","90","275","43","408","753","0","54.18","11.95"
"65","000","00","006","0624","2154","365","90","275","43","408","753","0","54.18","11.95"
"65","000","00","006","0625","0000","1451","603","848","57","1508","2839","0","53.12","21.24"
"65","000","00","006","0625","2155","322","137","185","11","333","602","0","55.32","22.76"
"65","000","00","006","0625","2156","1129","466","663","46","1175","2237","0","52.53","20.83"
"65","000","00","006","0626","0000","1083","376","707","65","1148","2239","0","51.27","16.79"
"65","000","00","006","0626","2157","577","203","374","32","609","1096","0","55.57","18.52"
"65","000","00","006","0626","2158","506","173","333","33","539","1143","0","47.16","15.14"
"65","000","00","006","0627","0000","744","261","483","75","819","1569","0","52.2","16.63"
"65","000","00","006","0627","2159","744","261","483","75","819","1569","0","52.2","16.63"
"65","000","00","006","0628","0000","555","211","344","60","615","1284","0","47.9","16.43"
"65","000","00","006","0628","2160","555","211","344","60","615","1284","0","47.9","16.43"
"65","000","00","006","0629","0000","549","218","331","42","591","1189","0","49.71","18.33"
"65","000","00","006","0629","2161","144","53","91","12","156","439","0","35.54","12.07"
"65","000","00","006","0629","2162","405","165","240","30","435","750","0","58.0","22.0"
"65","000","00","006","0630","0000","2459","841","1618","137","2596","4840","0","53.64","17.38"
"65","000","00","006","0630","2145","898","306","592","51","949","1838","0","51.63","16.65"
"65","000","00","006","0630","2146","777","272","505","39","816","1453","0","56.16","18.72"
"65","000","00","006","0630","2147","784","263","521","47","831","1549","0","53.65","16.98"
"65","000","00","006","0631","0000","852","306","546","47","899","1603","0","56.08","19.09"
"65","000","00","006","0631","1987","852","306","546","47","899","1603","0","56.08","19.09"
"65","000","00","006","0632","0000","937","272","665","47","984","1921","0","51.22","14.16"
"65","000","00","006","0632","1988","937","272","665","47","984","1921","0","51.22","14.16"
"65","000","00","006","0633","0000","1255","444","811","59","1314","2317","0","56.71","19.16"
"65","000","00","006","0633","1989","571","193","378","24","595","1082","0","54.99","17.84"
"65","000","00","006","0633","1990","684","251","433","35","719","1235","0","58.22","20.32"
"65","000","00","006","0634","0000","885","283","602","31","916","1568","0","58.42","18.05"
"65","000","00","006","0634","1991","885","283","602","31","916","1568","0","58.42","18.05"
"65","000","00","006","0635","0000","431","180","251","33","464","771","0","60.18","23.35"
"65","000","00","006","0635","1992","431","180","251","33","464","771","0","60.18","23.35"
"65","000","00","006","0636","0000","1239","479","760","82","1321","2264","0","58.35","21.16"
"65","000","00","006","0636","1993","683","283","400","34","717","1256","0","57.09","22.53"
"65","000","00","006","0636","1994","556","196","360","48","604","1008","0","59.92","19.44"
"65","000","00","006","0637","0000","2693","922","1771","117","2810","4701","0","59.77","19.61"
"65","000","00","006","0637","1995","854","284","570","43","897","1515","0","59.21","18.75"
"65","000","00","006","0637","1996","971","308","663","38","1009","1637","0","61.64","18.81"
"65","000","00","006","0637","1997","868","330","538","36","904","1549","0","58.36","21.3"
"65","000","00","006","0638","0000","2998","1024","1974","161","3159","5335","0","59.21","19.19"
"65","000","00","006","0638","1998","1214","402","812","50","1264","2011","0","62.85","19.99"
"65","000","00","006","0638","1999","844","285","559","62","906","1554","0","58.3","18.34"
"65","000","00","006","0638","2000","940","337","603","49","989","1770","0","55.88","19.04"
"65","000","00","006","0639","0000","1330","458","872","96","1426","2442","0","58.39","18.76"
"65","000","00","006","0639","2001","729","265","464","53","782","1316","0","59.42","20.14"
"65","000","00","006","0639","2002","601","193","408","43","644","1126","0","57.19","17.14"
"65","000","00","006","0640","0000","4420","1470","2950","187","4607","7834","0","58.81","18.76"
"65","000","00","006","0640","2003","762","261","501","40","802","1460","0","54.93","17.88"
"65","000","00","006","0640","2004","904","310","594","45","949","1584","0","59.91","19.57"
"65","000","00","006","0640","2005","791","278","513","41","832","1449","0","57.42","19.19"
"65","000","00","006","0640","2006","919","287","632","35","954","1520","0","62.76","18.88"
"65","000","00","006","0640","2007","1044","334","710","26","1070","1821","0","58.76","18.34"
"65","000","00","006","0641","0000","3800","1233","2567","119","3919","6728","0","58.25","18.33"
"65","000","00","006","0641","2008","1082","398","684","42","1124","1956","0","57.46","20.35"
"65","000","00","006","0641","2009","930","331","599","49","979","1665","0","58.8","19.88"
"65","000","00","006","0641","2010","951","183","768","16","967","1588","0","60.89","11.52"
"65","000","00","006","0641","2011","837","321","516","12","849","1519","0","55.89","21.13"
"65","000","00","006","0642","0000","2273","770","1503","119","2392","5969","0","40.07","12.9"
"65","000","00","006","0642","2014","649","207","442","46","695","1106","0","62.84","18.72"
"65","000","00","006","0642","2015","392","150","242","18","410","2700","0","15.19","5.56"
"65","000","00","006","0642","2016","591","195","396","19","610","995","0","61.31","19.6"
"65","000","00","006","0642","2017","641","218","423","36","677","1168","0","57.96","18.66"
"65","000","00","006","0643","0000","1399","489","910","71","1470","2208","0","66.58","22.15"
"65","000","00","006","0643","2018","722","238","484","41","763","1123","0","67.94","21.19"
"65","000","00","006","0643","2019","677","251","426","30","707","1085","0","65.16","23.13"
"65","000","00","006","0644","0000","3218","1072","2146","163","3381","5645","0","59.89","18.99"
"65","000","00","006","0644","2020","840","300","540","46","886","1412","0","62.75","21.25"
"65","000","00","006","0644","2021","941","315","626","45","986","1659","0","59.43","18.99"
"65","000","00","006","0644","2022","725","230","495","38","763","1198","0","63.69","19.2"
"65","000","00","006","0644","2023","712","227","485","34","746","1376","0","54.22","16.5"
"65","000","00","006","0645","0000","2111","669","1442","84","2195","3926","0","55.91","17.04"
"65","000","00","006","0645","2024","690","224","466","30","720","1300","0","55.38","17.23"
"65","000","00","006","0645","2025","695","208","487","28","723","1238","0","58.4","16.8"
"65","000","00","006","0645","2026","726","237","489","26","752","1388","0","54.18","17.07"
"65","000","00","006","0646","0000","1114","380","734","58","1172","1841","0","63.66","20.64"
"65","000","00","006","0646","2027","550","193","357","38","588","933","0","63.02","20.69"
"65","000","00","006","0646","2028","564","187","377","20","584","908","0","64.32","20.59"
"65","000","00","006","0647","0000","2029","688","1341","121","2150","3508","0","61.29","19.61"
"65","000","00","006","0647","2031","571","192","379","34","605","971","0","62.31","19.77"
"65","000","00","006","0647","2032","668","228","440","41","709","1145","0","61.92","19.91"
"65","000","00","006","0647","2033","790","268","522","46","836","1392","0","60.06","19.25"
"65","000","00","006","0648","0000","1657","533","1124","98","1755","2892","0","60.68","18.43"
"65","000","00","006","0648","2034","865","266","599","52","917","1452","0","63.15","18.32"
"65","000","00","006","0648","2035","792","267","525","46","838","1440","0","58.19","18.54"
"65","000","00","006","0649","0000","1970","690","1280","108","2078","3611","0","57.55","19.11"
"65","000","00","006","0649","2036","954","341","613","57","1011","1786","0","56.61","19.09"
"65","000","00","006","0649","2037","1016","349","667","51","1067","1825","0","58.47","19.12"
"65","000","00","006","0650","0000","1858","656","1202","71","1929","3227","0","59.78","20.33"
"65","000","00","006","0650","2038","870","284","586","28","898","1477","0","60.8","19.23"
"65","000","00","006","0650","2039","988","372","616","43","1031","1750","0","58.91","21.26"
"65","000","00","006","0651","0000","2072","606","1466","74","2146","3771","0","56.91","16.07"
"65","000","00","006","0651","2040","982","272","710","39","1021","1792","0","56.98","15.18"
"65","000","00","006","0651","2041","1090","334","756","35","1125","1979","0","56.85","16.88"
"65","000","00","006","0652","0000","2432","770","1662","90","2522","4133","0","61.02","18.63"
"65","000","00","006","0652","2042","479","158","321","27","506","826","0","61.26","19.13"
"65","000","00","006","0652","2043","1097","335","762","45","1142","1924","0","59.36","17.41"
"65","000","00","006","0652","2044","856","277","579","18","874","1383","0","63.2","20.03"
"65","000","00","006","0653","0000","398","137","261","31","429","830","0","51.69","16.51"
"65","000","00","006","0653","2045","398","137","261","31","429","830","0","51.69","16.51"
"65","000","00","006","0654","0000","3046","1050","1996","110","3156","5197","0","60.73","20.2"
"65","000","00","006","0654","2046","1025","354","671","39","1064","1759","0","60.49","20.13"
"65","000","00","006","0654","2047","1142","387","755","44","1186","1957","0","60.6","19.78"
"65","000","00","006","0654","2048","879","309","570","27","906","1481","0","61.17","20.86"
"65","000","00","006","0655","0000","1861","620","1241","56","1917","3135","0","61.15","19.78"
"65","000","00","006","0655","2119","1001","322","679","33","1034","1712","0","60.4","18.81"
"65","000","00","006","0655","2120","860","298","562","23","883","1423","0","62.05","20.94"
"65","000","00","006","0656","0000","3459","1126","2333","187","3646","6684","0","54.55","16.85"
"65","000","00","006","0656","2093","1001","320","681","48","1049","1892","0","55.44","16.91"
"65","000","00","006","0656","2094","752","231","521","56","808","1529","0","52.84","15.11"
"65","000","00","006","0656","2095","751","228","523","41","792","1358","0","58.32","16.79"
"65","000","00","006","0656","2096","955","347","608","42","997","1905","0","52.34","18.22"
"65","000","00","006","0657","0000","2437","792","1645","96","2533","4334","0","58.44","18.27"
"65","000","00","006","0657","2139","676","208","468","40","716","1178","0","60.78","17.66"
"65","000","00","006","0657","2140","730","242","488","24","754","1277","0","59.04","18.95"
"65","000","00","006","0657","2141","1031","342","689","32","1063","1879","0","56.57","18.2"
"65","000","00","006","0658","0000","3564","1263","2301","154","3718","6377","0","58.3","19.81"
"65","000","00","006","0658","2066","731","257","474","35","766","1315","0","58.25","19.54"
"65","000","00","006","0658","2067","818","301","517","48","866","1562","0","55.44","19.27"
"65","000","00","006","0658","2068","1162","410","752","21","1183","1982","0","59.69","20.69"
"65","000","00","006","0658","2069","853","295","558","50","903","1518","0","59.49","19.43"
"65","000","00","006","0659","0000","2014","699","1315","93","2107","3435","0","61.34","20.35"
"65","000","00","006","0659","2121","954","360","594","55","1009","1666","0","60.56","21.61"
"65","000","00","006","0659","2122","1060","339","721","38","1098","1769","0","62.07","19.16"
"65","000","00","006","0660","0000","4723","1594","3129","178","4901","9469","0","51.76","16.83"
"65","000","00","006","0660","2127","766","264","502","31","797","1463","0","54.48","18.05"
"65","000","00","006","0660","2128","630","214","416","37","667","1152","0","57.9","18.58"
"65","000","00","006","0660","2129","906","298","608","36","942","2008","0","46.91","14.84"
"65","000","00","006","0660","2130","926","315","611","43","969","2120","0","45.71","14.86"
"65","000","00","006","0660","2131","683","241","442","10","693","1153","0","60.1","20.9"
"65","000","00","006","0660","2132","812","262","550","21","833","1573","0","52.96","16.66"
"65","000","00","006","0661","0000","1597","520","1077","95","1692","2829","0","59.81","18.38"
"65","000","00","006","0661","2029","866","272","594","46","912","1582","0","57.65","17.19"
"65","000","00","006","0661","2030","731","248","483","49","780","1247","0","62.55","19.89"
"65","000","00","006","0662","0000","1508","477","1031","90","1598","3006","0","53.16","15.87"
"65","000","00","006","0662","2061","745","245","500","68","813","1495","0","54.38","16.39"
"65","000","00","006","0662","2062","763","232","531","22","785","1511","0","51.95","15.35"
"65","000","00","006","0663","0000","1306","431","875","61","1367","2489","0","54.92","17.32"
"65","000","00","006","0663","2083","694","239","455","28","722","1275","0","56.63","18.75"
"65","000","00","006","0663","2084","612","192","420","33","645","1214","0","53.13","15.82"
"65","000","00","006","0664","0000","2614","884","1730","68","2682","4809","0","55.77","18.38"
"65","000","00","006","0664","2111","831","252","579","28","859","1523","0","56.4","16.55"
"65","000","00","006","0664","2112","875","297","578","21","896","1642","0","54.57","18.09"
"65","000","00","006","0664","2113","908","335","573","19","927","1644","0","56.39","20.38"
"65","000","00","006","0665","0000","1398","548","850","48","1446","2280","0","63.42","24.04"
"65","000","00","006","0665","2012","724","284","440","26","750","1185","0","63.29","23.97"
"65","000","00","006","0665","2013","674","264","410","22","696","1095","0","63.56","24.11"
"65","000","00","006","0666","0000","1999","686","1313","110","2109","3797","0","55.54","18.07"
"65","000","00","006","0666","2100","1035","354","681","43","1078","1960","0","55.0","18.06"
"65","000","00","006","0666","2101","964","332","632","67","1031","1837","0","56.12","18.07"
"65","000","00","006","0667","0000","2791","987","1804","130","2921","4983","0","58.62","19.81"
"65","000","00","006","0667","2102","907","326","581","41","948","1662","0","57.04","19.61"
"65","000","00","006","0667","2103","940","337","603","55","995","1617","0","61.53","20.84"
"65","000","00","006","0667","2104","944","324","620","34","978","1704","0","57.39","19.01"
"65","000","00","006","0668","0000","1896","656","1240","58","1954","3528","0","55.39","18.59"
"65","000","00","006","0668","2117","1055","364","691","26","1081","1982","0","54.54","18.37"
"65","000","00","006","0668","2118","841","292","549","32","873","1546","0","56.47","18.89"
"65","000","00","006","0669","0000","1315","437","878","111","1426","2394","0","59.57","18.25"
"65","000","00","006","0669","2143","527","196","331","20","547","960","0","56.98","20.42"
"65","000","00","006","0669","2144","788","241","547","91","879","1434","0","61.3","16.81"
"65","000","00","007","0000","0000","79324","28180","51144","4931","84255","152102","183780","55.39","18.53"
"65","000","00","007","0701","0000","1669","544","1125","136","1805","3613","0","49.96","15.06"
"65","000","00","007","0701","1620","818","215","603","77","895","1897","0","47.18","11.33"
"65","000","00","007","0701","1621","851","329","522","59","910","1716","0","53.03","19.17"
"65","000","00","007","0702","0000","1925","631","1294","123","2048","3470","0","59.02","18.18"
"65","000","00","007","0702","1617","625","214","411","48","673","1211","0","55.57","17.67"
"65","000","00","007","0702","1618","620","218","402","42","662","1125","0","58.84","19.38"
"65","000","00","007","0702","1619","680","199","481","33","713","1134","0","62.87","17.55"
"65","000","00","007","0703","0000","2059","701","1358","127","2186","4252","0","51.41","16.49"
"65","000","00","007","0703","1614","688","238","450","54","742","1408","0","52.7","16.9"
"65","000","00","007","0703","1615","674","221","453","15","689","1310","0","52.6","16.87"
"65","000","00","007","0703","1616","697","242","455","58","755","1534","0","49.22","15.78"
"65","000","00","007","0704","0000","1677","600","1077","102","1779","3296","0","53.97","18.2"
"65","000","00","007","0704","1643","600","216","384","51","651","1116","0","58.33","19.35"
"65","000","00","007","0704","1644","529","189","340","36","565","1077","0","52.46","17.55"
"65","000","00","007","0704","1645","548","195","353","15","563","1103","0","51.04","17.68"
"65","000","00","007","0705","0000","2925","1088","1837","140","3065","5619","0","54.55","19.36"
"65","000","00","007","0705","1639","754","287","467","26","780","1483","0","52.6","19.35"
"65","000","00","007","0705","1640","806","301","505","25","831","1524","0","54.53","19.75"
"65","000","00","007","0705","1641","747","285","462","51","798","1431","0","55.77","19.92"
"65","000","00","007","0705","1642","618","215","403","38","656","1181","0","55.55","18.2"
"65","000","00","007","0706","0000","1907","688","1219","159","2066","4297","0","48.08","16.01"
"65","000","00","007","0706","1633","651","239","412","60","711","1927","0","36.9","12.4"
"65","000","00","007","0706","1634","472","165","307","49","521","914","0","57.0","18.05"
"65","000","00","007","0706","1635","784","284","500","50","834","1456","0","57.28","19.51"
"65","000","00","007","0707","0000","2197","845","1352","133","2330","4468","0","52.15","18.91"
"65","000","00","007","0707","1624","758","311","447","47","805","1542","0","52.2","20.17"
"65","000","00","007","0707","1625","756","277","479","60","816","1470","0","55.51","18.84"
"65","000","00","007","0707","1626","683","257","426","26","709","1456","0","48.7","17.65"
"65","000","00","007","0708","0000","1745","600","1145","117","1862","3218","0","57.86","18.65"
"65","000","00","007","0708","1652","472","151","321","30","502","870","0","57.7","17.36"
"65","000","00","007","0708","1653","761","262","499","53","814","1338","0","60.84","19.58"
"65","000","00","007","0708","1654","512","187","325","34","546","1010","0","54.06","18.51"
"65","000","00","007","0709","0000","2506","952","1554","154","2660","4558","0","58.36","20.89"
"65","000","00","007","0709","1657","815","317","498","70","885","1405","0","62.99","22.56"
"65","000","00","007","0709","1658","838","321","517","51","889","1587","0","56.02","20.23"
"65","000","00","007","0709","1659","853","314","539","33","886","1566","0","56.58","20.05"
"65","000","00","007","0710","0000","2094","790","1304","145","2239","3749","0","59.72","21.07"
"65","000","00","007","0710","1667","716","262","454","61","777","1268","0","61.28","20.66"
"65","000","00","007","0710","1668","706","262","444","39","745","1281","0","58.16","20.45"
"65","000","00","007","0710","1669","672","266","406","45","717","1200","0","59.75","22.17"
"65","000","00","007","0711","0000","1611","517","1094","85","1696","2979","0","56.93","17.35"
"65","000","00","007","0711","1663","928","309","619","43","971","1701","0","57.08","18.17"
"65","000","00","007","0711","1664","683","208","475","42","725","1278","0","56.73","16.28"
"65","000","00","007","0712","0000","737","254","483","51","788","1491","0","52.85","17.04"
"65","000","00","007","0712","1670","737","254","483","51","788","1491","0","52.85","17.04"
"65","000","00","007","0713","0000","542","179","363","38","580","1066","0","54.41","16.79"
"65","000","00","007","0713","1671","542","179","363","38","580","1066","0","54.41","16.79"
"65","000","00","007","0714","0000","1682","584","1098","66","1748","3132","0","55.81","18.65"
"65","000","00","007","0714","1686","846","270","576","39","885","1566","0","56.51","17.24"
"65","000","00","007","0714","1687","836","314","522","27","863","1566","0","55.11","20.05"
"65","000","00","007","0715","0000","1773","613","1160","165","1938","3427","0","56.55","17.89"
"65","000","00","007","0715","1676","645","209","436","46","691","1144","0","60.4","18.27"
"65","000","00","007","0715","1677","527","180","347","41","568","1059","0","53.64","17.0"
"65","000","00","007","0715","1678","601","224","377","78","679","1224","0","55.47","18.3"
"65","000","00","007","0716","0000","2247","808","1439","144","2391","4452","0","53.71","18.15"
"65","000","00","007","0716","1683","771","260","511","65","836","1514","0","55.22","17.17"
"65","000","00","007","0716","1684","750","270","480","33","783","1546","0","50.65","17.46"
"65","000","00","007","0716","1685","726","278","448","46","772","1392","0","55.46","19.97"
"65","000","00","007","0717","0000","2273","761","1512","149","2422","4572","0","52.97","16.64"
"65","000","00","007","0717","1673","824","263","561","51","875","1616","0","54.15","16.27"
"65","000","00","007","0717","1674","698","260","438","53","751","1589","0","47.26","16.36"
"65","000","00","007","0717","1675","751","238","513","45","796","1367","0","58.23","17.41"
"65","000","00","007","0718","0000","1425","514","911","139","1564","2883","0","54.25","17.83"
"65","000","00","007","0718","1699","802","310","492","54","856","1606","0","53.3","19.3"
"65","000","00","007","0718","1700","623","204","419","85","708","1277","0","55.44","15.97"
"65","000","00","007","0719","0000","2696","925","1771","187","2883","5231","0","55.11","17.68"
"65","000","00","007","0719","1695","646","218","428","53","699","1247","0","56.05","17.48"
"65","000","00","007","0719","1696","697","230","467","58","755","1390","0","54.32","16.55"
"65","000","00","007","0719","1697","702","241","461","43","745","1293","0","57.62","18.64"
"65","000","00","007","0719","1698","651","236","415","33","684","1301","0","52.57","18.14"
"65","000","00","007","0720","0000","2369","857","1512","146","2515","4264","0","58.98","20.1"
"65","000","00","007","0720","1692","931","353","578","74","1005","1661","0","60.51","21.25"
"65","000","00","007","0720","1693","857","322","535","39","896","1585","0","56.53","20.32"
"65","000","00","007","0720","1694","581","182","399","33","614","1018","0","60.31","17.88"
"65","000","00","007","0721","0000","730","246","484","30","760","1683","0","45.16","14.62"
"65","000","00","007","0721","1708","730","246","484","30","760","1683","0","45.16","14.62"
"65","000","00","007","0722","0000","701","286","415","42","743","1565","0","47.48","18.27"
"65","000","00","007","0722","1722","701","286","415","42","743","1565","0","47.48","18.27"
"65","000","00","007","0723","0000","874","300","574","68","942","1638","0","57.51","18.32"
"65","000","00","007","0723","1714","874","300","574","68","942","1638","0","57.51","18.32"
"65","000","00","007","0724","0000","6328","2165","4163","317","6645","11772","0","56.45","18.39"
"65","000","00","007","0724","1715","841","333","508","37","878","1592","0","55.15","20.92"
"65","000","00","007","0724","1716","862","259","603","35","897","1521","0","58.97","17.03"
"65","000","00","007","0724","1717","971","345","626","52","1023","1707","0","59.93","20.21"
"65","000","00","007","0724","1718","964","349","615","54","1018","1741","0","58.47","20.05"
"65","000","00","007","0724","1719","886","297","589","42","928","1655","0","56.07","17.95"
"65","000","00","007","0724","1720","861","307","554","54","915","1775","0","51.55","17.3"
"65","000","00","007","0724","1721","943","275","668","43","986","1781","0","55.36","15.44"
"65","000","00","007","0725","0000","1031","367","664","53","1084","1966","0","55.14","18.67"
"65","000","00","007","0725","1723","479","169","310","24","503","936","0","53.74","18.06"
"65","000","00","007","0725","1724","552","198","354","29","581","1030","0","56.41","19.22"
"65","000","00","007","0726","0000","4315","1523","2792","143","4458","7662","0","58.18","19.88"
"65","000","00","007","0726","1709","787","262","525","50","837","1452","0","57.64","18.04"
"65","000","00","007","0726","1710","900","326","574","31","931","1592","0","58.48","20.48"
"65","000","00","007","0726","1711","916","307","609","25","941","1619","0","58.12","18.96"
"65","000","00","007","0726","1712","976","338","638","26","1002","1642","0","61.02","20.58"
"65","000","00","007","0726","1713","736","290","446","11","747","1357","0","55.05","21.37"
"65","000","00","007","0727","0000","557","182","375","54","611","877","0","69.67","20.75"
"65","000","00","007","0727","1672","557","182","375","54","611","877","0","69.67","20.75"
"65","000","00","007","0728","0000","1976","751","1225","120","2096","3846","0","54.5","19.53"
"65","000","00","007","0728","1646","733","286","447","42","775","1385","0","55.96","20.65"
"65","000","00","007","0728","1647","636","236","400","35","671","1266","0","53.0","18.64"
"65","000","00","007","0728","1648","607","229","378","43","650","1195","0","54.39","19.16"
"65","000","00","007","0729","0000","1666","608","1058","124","1790","3245","0","55.16","18.74"
"65","000","00","007","0729","1660","504","178","326","27","531","997","0","53.26","17.85"
"65","000","00","007","0729","1661","624","230","394","55","679","1187","0","57.2","19.38"
"65","000","00","007","0729","1662","538","200","338","42","580","1061","0","54.67","18.85"
"65","000","00","007","0730","0000","1792","674","1118","124","1916","3196","0","59.95","21.09"
"65","000","00","007","0730","1655","889","302","587","62","951","1658","0","57.36","18.21"
"65","000","00","007","0730","1656","903","372","531","62","965","1538","0","62.74","24.19"
"65","000","00","007","0731","0000","1887","662","1225","88","1975","3571","0","55.31","18.54"
"65","000","00","007","0731","1627","616","222","394","27","643","1124","0","57.21","19.75"
"65","000","00","007","0731","1628","626","211","415","32","658","1235","0","53.28","17.09"
"65","000","00","007","0731","1629","645","229","416","29","674","1212","0","55.61","18.89"
"65","000","00","007","0732","0000","1967","651","1316","144","2111","3764","0","56.08","17.3"
"65","000","00","007","0732","1630","581","196","385","36","617","1223","0","50.45","16.03"
"65","000","00","007","0732","1631","759","215","544","72","831","1335","0","62.25","16.1"
"65","000","00","007","0732","1632","627","240","387","36","663","1206","0","54.98","19.9"
"65","000","00","007","0733","0000","2456","944","1512","177","2633","5192","0","50.71","18.18"
"65","000","00","007","0733","1679","546","217","329","39","585","1141","0","51.27","19.02"
"65","000","00","007","0733","1680","612","222","390","23","635","1396","0","45.49","15.9"
"65","000","00","007","0733","1681","601","250","351","37","638","1157","0","55.14","21.61"
"65","000","00","007","0733","1682","697","255","442","78","775","1498","0","51.74","17.02"
"65","000","00","007","0734","0000","2387","857","1530","160","2547","4454","0","57.18","19.24"
"65","000","00","007","0734","1636","735","246","489","43","778","1409","0","55.22","17.46"
"65","000","00","007","0734","1637","838","270","568","64","902","1500","0","60.13","18.0"
"65","000","00","007","0734","1638","814","341","473","53","867","1545","0","56.12","22.07"
"65","000","00","007","0735","0000","2636","885","1751","152","2788","4995","0","55.82","17.72"
"65","000","00","007","0735","1701","642","248","394","56","698","1219","0","57.26","20.34"
"65","000","00","007","0735","1702","715","221","494","35","750","1454","0","51.58","15.2"
"65","000","00","007","0735","1703","671","210","461","30","701","1314","0","53.35","15.98"
"65","000","00","007","0735","1704","608","206","402","31","639","1008","0","63.39","20.44"
"65","000","00","007","0736","0000","2326","816","1510","158","2484","4615","0","53.82","17.68"
"65","000","00","007","0736","1705","787","282","505","63","850","1574","0","54.0","17.92"
"65","000","00","007","0736","1706","751","261","490","30","781","1364","0","57.26","19.13"
"65","000","00","007","0736","1707","788","273","515","65","853","1677","0","50.86","16.28"
"65","000","00","007","0737","0000","1559","585","974","108","1667","2739","0","60.86","21.36"
"65","000","00","007","0737","1665","819","316","503","46","865","1433","0","60.36","22.05"
"65","000","00","007","0737","1666","740","269","471","62","802","1306","0","61.41","20.6"
"65","000","00","007","0738","0000","1582","581","1001","76","1658","2998","0","55.3","19.38"
"65","000","00","007","0738","1688","785","300","485","50","835","1517","0","55.04","19.78"
"65","000","00","007","0738","1689","797","281","516","26","823","1481","0","55.57","18.97"
"65","000","00","007","0739","0000","1226","402","824","76","1302","2424","0","53.71","16.58"
"65","000","00","007","0739","1690","644","213","431","43","687","1261","0","54.48","16.89"
"65","000","00","007","0739","1691","582","189","393","33","615","1163","0","52.88","16.25"
"65","000","00","007","0740","0000","1324","507","817","89","1413","2517","0","56.14","20.14"
"65","000","00","007","0740","1649","627","238","389","56","683","1254","0","54.47","18.98"
"65","000","00","007","0740","1650","697","269","428","33","730","1263","0","57.8","21.3"
"65","000","00","007","0741","0000","850","319","531","62","912","1473","0","61.91","21.66"
"65","000","00","007","0741","1651","850","319","531","62","912","1473","0","61.91","21.66"
"65","000","00","007","0742","0000","1095","418","677","60","1155","1873","0","61.67","22.32"
"65","000","00","007","0742","1622","425","158","267","33","458","736","0","62.23","21.47"
"65","000","00","007","0742","1623","670","260","410","27","697","1137","0","61.3","22.87"
"65","000","00","008","0000","0000","35696","12659","23037","2140","37836","71645","86223","52.81","17.67"
"65","000","00","008","0801","0000","539","205","334","42","581","965","0","60.21","21.24"
"65","000","00","008","0801","1726","539","205","334","42","581","965","0","60.21","21.24"
"65","000","00","008","0802","0000","1034","355","679","57","1091","2019","0","54.04","17.58"
"65","000","00","008","0802","1729","554","181","373","44","598","1057","0","56.58","17.12"
"65","000","00","008","0802","1730","480","174","306","13","493","962","0","51.25","18.09"
"65","000","00","008","0803","0000","2617","967","1650","139","2756","5052","0","54.55","19.14"
"65","000","00","008","0803","1732","981","355","626","56","1037","1742","0","59.53","20.38"
"65","000","00","008","0803","1733","827","310","517","47","874","1634","0","53.49","18.97"
"65","000","00","008","0803","1734","809","302","507","36","845","1676","0","50.42","18.02"
"65","000","00","008","0804","0000","1845","702","1143","111","1956","3728","0","52.47","18.83"
"65","000","00","008","0804","1727","1003","369","634","63","1066","1931","0","55.2","19.11"
"65","000","00","008","0804","1728","842","333","509","48","890","1797","0","49.53","18.53"
"65","000","00","008","0805","0000","556","202","354","29","585","934","0","62.63","21.63"
"65","000","00","008","0805","1731","556","202","354","29","585","934","0","62.63","21.63"
"65","000","00","008","0806","0000","284","99","185","14","298","515","0","57.86","19.22"
"65","000","00","008","0806","1725","284","99","185","14","298","515","0","57.86","19.22"
"65","000","00","008","0807","0000","800","275","525","45","845","1440","0","58.68","19.1"
"65","000","00","008","0807","1750","800","275","525","45","845","1440","0","58.68","19.1"
"65","000","00","008","0808","0000","3895","1315","2580","238","4133","7315","0","56.5","17.98"
"65","000","00","008","0808","1751","924","305","619","69","993","1809","0","54.89","16.86"
"65","000","00","008","0808","1752","924","324","600","64","988","1758","0","56.2","18.43"
"65","000","00","008","0808","1753","831","269","562","37","868","1589","0","54.63","16.93"
"65","000","00","008","0808","1754","601","215","386","38","639","1067","0","59.89","20.15"
"65","000","00","008","0808","1755","615","202","413","30","645","1092","0","59.07","18.5"
"65","000","00","008","0809","0000","1572","581","991","104","1676","3208","0","52.24","18.11"
"65","000","00","008","0809","1747","471","189","282","35","506","942","0","53.72","20.06"
"65","000","00","008","0809","1748","652","238","414","52","704","1317","0","53.45","18.07"
"65","000","00","008","0809","1749","449","154","295","17","466","949","0","49.1","16.23"
"65","000","00","008","0810","0000","3104","1087","2017","168","3272","6702","0","48.82","16.22"
"65","000","00","008","0810","1743","858","288","570","35","893","1737","0","51.41","16.58"
"65","000","00","008","0810","1744","755","248","507","48","803","1669","0","48.11","14.86"
"65","000","00","008","0810","1745","799","296","503","37","836","1842","0","45.39","16.07"
"65","000","00","008","0810","1746","692","255","437","48","740","1454","0","50.89","17.54"
"65","000","00","008","0811","0000","3328","1170","2158","194","3522","7102","0","49.59","16.47"
"65","000","00","008","0811","1739","855","285","570","54","909","1782","0","51.01","15.99"
"65","000","00","008","0811","1740","758","276","482","40","798","1496","0","53.34","18.45"
"65","000","00","008","0811","1741","983","330","653","43","1026","2071","0","49.54","15.93"
"65","000","00","008","0811","1742","732","279","453","57","789","1753","0","45.01","15.92"
"65","000","00","008","0812","0000","385","133","252","5","390","850","0","45.88","15.65"
"65","000","00","008","0812","1738","385","133","252","5","390","850","0","45.88","15.65"
"65","000","00","008","0813","0000","120","41","79","3","123","227","0","54.19","18.06"
"65","000","00","008","0813","1774","120","41","79","3","123","227","0","54.19","18.06"
"65","000","00","008","0814","0000","2256","776","1480","163","2419","4604","0","52.54","16.85"
"65","000","00","008","0814","1768","659","221","438","55","714","1479","0","48.28","14.94"
"65","000","00","008","0814","1769","840","298","542","55","895","1736","0","51.56","17.17"
"65","000","00","008","0814","1770","757","257","500","53","810","1389","0","58.32","18.5"
"65","000","00","008","0815","0000","1909","689","1220","138","2047","4064","0","50.37","16.95"
"65","000","00","008","0815","1762","474","161","313","27","501","1026","0","48.83","15.69"
"65","000","00","008","0815","1763","810","297","513","43","853","1721","0","49.56","17.26"
"65","000","00","008","0815","1764","625","231","394","68","693","1317","0","52.62","17.54"
"65","000","00","008","0816","0000","1804","662","1142","158","1962","3526","0","55.64","18.77"
"65","000","00","008","0816","1765","585","207","378","42","627","1046","0","59.94","19.79"
"65","000","00","008","0816","1766","633","236","397","56","689","1144","0","60.23","20.63"
"65","000","00","008","0816","1767","586","219","367","60","646","1336","0","48.35","16.39"
"65","000","00","008","0817","0000","2322","747","1575","127","2449","4249","0","57.64","17.58"
"65","000","00","008","0817","1756","925","311","614","41","966","1730","0","55.84","17.98"
"65","000","00","008","0817","1757","674","197","477","41","715","1281","0","55.82","15.38"
"65","000","00","008","0817","1758","723","239","484","45","768","1238","0","62.04","19.31"
"65","000","00","008","0818","0000","2383","802","1581","145","2528","5137","0","49.21","15.61"
"65","000","00","008","0818","1771","977","313","664","63","1040","1956","0","53.17","16.0"
"65","000","00","008","0818","1772","702","253","449","53","755","1371","0","55.07","18.45"
"65","000","00","008","0818","1773","704","236","468","29","733","1810","0","40.5","13.04"
"65","000","00","008","0819","0000","1949","684","1265","126","2075","4022","0","51.59","17.01"
"65","000","00","008","0819","1759","814","270","544","55","869","1568","0","55.42","17.22"
"65","000","00","008","0819","1760","639","233","406","46","685","1271","0","53.89","18.33"
"65","000","00","008","0819","1761","496","181","315","25","521","1183","0","44.04","15.3"
"65","000","00","008","0820","0000","2994","1167","1827","134","3128","5986","0","52.26","19.5"
"65","000","00","008","0820","1735","1049","398","651","85","1134","2052","0","55.26","19.4"
"65","000","00","008","0820","1736","912","357","555","29","941","1977","0","47.6","18.06"
"65","000","00","008","0820","1737","1033","412","621","20","1053","1957","0","53.81","21.05"
"65","000","00","009","0000","0000","47039","16312","30727","2757","49796","94291","115712","52.81","17.3"
"65","000","00","009","0901","0000","167","58","109","20","187","274","0","68.25","21.17"
"65","000","00","009","0901","1917","167","58","109","20","187","274","0","68.25","21.17"
"65","000","00","009","0902","0000","292","105","187","30","322","583","0","55.23","18.01"
"65","000","00","009","0902","1918","292","105","187","30","322","583","0","55.23","18.01"
"65","000","00","009","0903","0000","1653","588","1065","62","1715","3479","0","49.3","16.9"
"65","000","00","009","0903","1919","788","271","517","20","808","1765","0","45.78","15.35"
"65","000","00","009","0903","1920","865","317","548","42","907","1714","0","52.92","18.49"
"65","000","00","009","0904","0000","1376","475","901","74","1450","2684","0","54.02","17.7"
"65","000","00","009","0904","1921","667","227","440","29","696","1355","0","51.37","16.75"
"65","000","00","009","0904","1922","709","248","461","45","754","1329","0","56.73","18.66"
"65","000","00","009","0905","0000","506","176","330","59","565","1059","0","53.35","16.62"
"65","000","00","009","0905","1923","506","176","330","59","565","1059","0","53.35","16.62"
"65","000","00","009","0906","0000","3410","1320","2090","219","3629","6529","0","55.58","20.22"
"65","000","00","009","0906","1924","739","289","450","47","786","1364","0","57.62","21.19"
"65","000","00","009","0906","1925","600","240","360","46","646","1098","0","58.83","21.86"
"65","000","00","009","0906","1926","668","251","417","45","713","1296","0","55.02","19.37"
"65","000","00","009","0906","1927","627","223","404","43","670","1240","0","54.03","17.98"
"65","000","00","009","0906","1928","776","317","459","38","814","1531","0","53.17","20.71"
"65","000","00","009","0907","0000","2506","855","1651","120","2626","5025","0","52.26","17.01"
"65","000","00","009","0907","1952","793","281","512","37","830","1634","0","50.8","17.2"
"65","000","00","009","0907","1953","878","292","586","51","929","1716","0","54.14","17.02"
"65","000","00","009","0907","1954","835","282","553","32","867","1675","0","51.76","16.84"
"65","000","00","009","0908","0000","4165","1476","2689","244","4409","8724","0","50.54","16.92"
"65","000","00","009","0908","1929","687","233","454","26","713","1444","0","49.38","16.14"
"65","000","00","009","0908","1930","657","232","425","71","728","1347","0","54.05","17.22"
"65","000","00","009","0908","1931","744","254","490","44","788","1455","0","54.16","17.46"
"65","000","00","009","0908","1932","706","249","457","35","741","1556","0","47.62","16.0"
"65","000","00","009","0908","1933","592","225","367","26","618","1390","0","44.46","16.19"
"65","000","00","009","0908","1934","779","283","496","42","821","1532","0","53.59","18.47"
"65","000","00","009","0909","0000","4065","1422","2643","192","4257","8053","0","52.86","17.66"
"65","000","00","009","0909","1935","619","206","413","55","674","1377","0","48.95","14.96"
"65","000","00","009","0909","1936","858","302","556","41","899","1731","0","51.94","17.45"
"65","000","00","009","0909","1937","831","284","547","31","862","1705","0","50.56","16.66"
"65","000","00","009","0909","1938","845","328","517","34","879","1590","0","55.28","20.63"
"65","000","00","009","0909","1939","912","302","610","31","943","1650","0","57.15","18.3"
"65","000","00","009","0910","0000","1702","537","1165","167","1869","3638","0","51.37","14.76"
"65","000","00","009","0910","1966","573","185","388","62","635","1389","0","45.72","13.32"
"65","000","00","009","0910","1967","600","216","384","66","666","1315","0","50.65","16.43"
"65","000","00","009","0910","1968","529","136","393","39","568","934","0","60.81","14.56"
"65","000","00","009","0911","0000","1014","346","668","56","1070","2199","0","48.66","15.73"
"65","000","00","009","0911","1969","584","202","382","28","612","1270","0","48.19","15.91"
"65","000","00","009","0911","1970","430","144","286","28","458","929","0","49.3","15.5"
"65","000","00","009","0912","0000","521","163","358","16","537","1035","0","51.88","15.75"
"65","000","00","009","0912","1971","521","163","358","16","537","1035","0","51.88","15.75"
"65","000","00","009","0913","0000","230","79","151","13","243","502","0","48.41","15.74"
"65","000","00","009","0913","1972","230","79","151","13","243","502","0","48.41","15.74"
"65","000","00","009","0914","0000","364","98","266","49","413","836","0","49.4","11.72"
"65","000","00","009","0914","1973","364","98","266","49","413","836","0","49.4","11.72"
"65","000","00","009","0915","0000","275","85","190","54","329","669","0","49.18","12.71"
"65","000","00","009","0915","1974","275","85","190","54","329","669","0","49.18","12.71"
"65","000","00","009","0916","0000","377","119","258","63","440","733","0","60.03","16.23"
"65","000","00","009","0916","1975","377","119","258","63","440","733","0","60.03","16.23"
"65","000","00","009","0917","0000","1081","373","708","59","1140","2138","0","53.32","17.45"
"65","000","00","009","0917","1979","409","143","266","36","445","771","0","57.72","18.55"
"65","000","00","009","0917","1980","672","230","442","23","695","1367","0","50.84","16.83"
"65","000","00","009","0918","0000","685","188","497","31","716","1394","0","51.36","13.49"
"65","000","00","009","0918","1978","685","188","497","31","716","1394","0","51.36","13.49"
"65","000","00","009","0919","0000","1277","423","854","103","1380","2761","0","49.98","15.32"
"65","000","00","009","0919","1981","592","183","409","55","647","1241","0","52.14","14.75"
"65","000","00","009","0919","1982","685","240","445","48","733","1520","0","48.22","15.79"
"65","000","00","009","0920","0000","520","142","378","37","557","873","0","63.8","16.27"
"65","000","00","009","0920","1983","520","142","378","37","557","873","0","63.8","16.27"
"65","000","00","009","0921","0000","515","166","349","66","581","1322","0","43.95","12.56"
"65","000","00","009","0921","1986","515","166","349","66","581","1322","0","43.95","12.56"
"65","000","00","009","0922","0000","770","260","510","122","892","1865","0","47.83","13.94"
"65","000","00","009","0922","1984","284","105","179","90","374","768","0","48.7","13.67"
"65","000","00","009","0922","1985","486","155","331","32","518","1097","0","47.22","14.13"
"65","000","00","009","0923","0000","2860","1026","1834","150","3010","5947","0","50.61","17.25"
"65","000","00","009","0923","1959","679","218","461","51","730","1363","0","53.56","15.99"
"65","000","00","009","0923","1960","837","314","523","36","873","1624","0","53.76","19.33"
"65","000","00","009","0923","1961","709","260","449","47","756","1352","0","55.92","19.23"
"65","000","00","009","0923","1962","635","234","401","16","651","1608","0","40.49","14.55"
"65","000","00","009","0924","0000","3178","1181","1997","172","3350","6635","0","50.49","17.8"
"65","000","00","009","0924","1955","695","246","449","48","743","1649","0","45.06","14.92"
"65","000","00","009","0924","1956","739","257","482","50","789","1489","0","52.99","17.26"
"65","000","00","009","0924","1957","824","312","512","46","870","1771","0","49.12","17.62"
"65","000","00","009","0924","1958","920","366","554","28","948","1726","0","54.92","21.21"
"65","000","00","009","0925","0000","2200","790","1410","195","2395","4629","0","51.74","17.07"
"65","000","00","009","0925","1963","735","255","480","50","785","1458","0","53.84","17.49"
"65","000","00","009","0925","1964","757","278","479","42","799","1641","0","48.69","16.94"
"65","000","00","009","0925","1965","708","257","451","103","811","1530","0","53.01","16.8"
"65","000","00","009","0926","0000","1678","531","1147","104","1782","3198","0","55.72","16.6"
"65","000","00","009","0926","1976","879","268","611","55","934","1560","0","59.87","17.18"
"65","000","00","009","0926","1977","799","263","536","49","848","1638","0","51.77","16.06"
"65","000","00","009","0927","0000","6766","2288","4478","172","6938","12019","0","57.73","19.04"
"65","000","00","009","0927","1944","854","282","572","21","875","1579","0","55.41","17.86"
"65","000","00","009","0927","1945","747","245","502","23","770","1435","0","53.66","17.07"
"65","000","00","009","0927","1946","942","292","650","27","969","1659","0","58.41","17.6"
"65","000","00","009","0927","1947","897","345","552","23","920","1512","0","60.85","22.82"
"65","000","00","009","0927","1948","820","267","553","28","848","1463","0","57.96","18.25"
"65","000","00","009","0927","1949","851","310","541","12","863","1465","0","58.91","21.16"
"65","000","00","009","0927","1950","846","272","574","11","857","1463","0","58.58","18.59"
"65","000","00","009","0927","1951","809","275","534","27","836","1443","0","57.93","19.06"
"65","000","00","009","0928","0000","2886","1042","1844","108","2994","5488","0","54.56","18.99"
"65","000","00","009","0928","1940","773","269","504","25","798","1441","0","55.38","18.67"
"65","000","00","009","0928","1941","788","267","521","24","812","1404","0","57.83","19.02"
"65","000","00","009","0928","1942","741","278","463","32","773","1295","0","59.69","21.47"
"65","000","00","009","0928","1943","584","228","356","27","611","1348","0","45.33","16.91"
"65","000","00","010","0000","0000","73970","26552","47418","3662","77632","147272","172677","52.71","18.03"
"65","000","00","010","1001","0000","269","97","172","23","292","544","0","53.68","17.83"
"65","000","00","010","1001","0029","269","97","172","23","292","544","0","53.68","17.83"
"65","000","00","010","1002","0000","529","176","353","52","581","1044","0","55.65","16.86"
"65","000","00","010","1002","0030","529","176","353","52","581","1044","0","55.65","16.86"
"65","000","00","010","1003","0000","700","200","500","42","742","1462","0","50.75","13.68"
"65","000","00","010","1003","0031","700","200","500","42","742","1462","0","50.75","13.68"
"65","000","00","010","1004","0000","720","237","483","79","799","1525","0","52.39","15.54"
"65","000","00","010","1004","0032","720","237","483","79","799","1525","0","52.39","15.54"
"65","000","00","010","1005","0000","433","149","284","40","473","986","0","47.97","15.11"
"65","000","00","010","1005","0033","433","149","284","40","473","986","0","47.97","15.11"
"65","000","00","010","1006","0000","1191","361","830","112","1303","2516","0","51.79","14.35"
"65","000","00","010","1006","0035","584","171","413","73","657","1173","0","56.01","14.58"
"65","000","00","010","1006","0036","607","190","417","39","646","1343","0","48.1","14.15"
"65","000","00","010","1007","0000","424","128","296","37","461","806","0","57.2","15.88"
"65","000","00","010","1007","0034","424","128","296","37","461","806","0","57.2","15.88"
"65","000","00","010","1008","0000","5551","1943","3608","186","5737","12236","0","46.89","15.88"
"65","000","00","010","1008","0065","948","317","631","29","977","1837","0","53.18","17.26"
"65","000","00","010","1008","0066","636","233","403","15","651","1924","0","33.84","12.11"
"65","000","00","010","1008","0067","1145","390","755","25","1170","2340","0","50.0","16.67"
"65","000","00","010","1008","0068","737","251","486","58","795","1704","0","46.65","14.73"
"65","000","00","010","1008","0069","684","257","427","36","720","1363","0","52.82","18.86"
"65","000","00","010","1008","0070","1401","495","906","23","1424","3068","0","46.41","16.13"
"65","000","00","010","1009","0000","722","226","496","37","759","1528","0","49.67","14.79"
"65","000","00","010","1009","0071","722","226","496","37","759","1528","0","49.67","14.79"
"65","000","00","010","1010","0000","3173","1094","2079","145","3318","6351","0","52.24","17.23"
"65","000","00","010","1010","0079","732","220","512","49","781","1373","0","56.88","16.02"
"65","000","00","010","1010","0080","913","321","592","30","943","1732","0","54.45","18.53"
"65","000","00","010","1010","0081","720","267","453","43","763","1519","0","50.23","17.58"
"65","000","00","010","1010","0082","808","286","522","23","831","1727","0","48.12","16.56"
"65","000","00","010","1011","0000","2583","908","1675","158","2741","5041","0","54.37","18.01"
"65","000","00","010","1011","0072","786","313","473","50","836","1600","0","52.25","19.56"
"65","000","00","010","1011","0073","1015","319","696","56","1071","1874","0","57.15","17.02"
"65","000","00","010","1011","0074","782","276","506","52","834","1567","0","53.22","17.61"
"65","000","00","010","1012","0000","4458","1599","2859","174","4632","8417","0","55.03","19.0"
"65","000","00","010","1012","0093","918","303","615","42","960","1804","0","53.22","16.8"
"65","000","00","010","1012","0094","696","251","445","40","736","1322","0","55.67","18.99"
"65","000","00","010","1012","0095","1040","414","626","31","1071","2019","0","53.05","20.51"
"65","000","00","010","1012","0096","943","323","620","37","980","1696","0","57.78","19.04"
"65","000","00","010","1012","0097","861","308","553","24","885","1576","0","56.15","19.54"
"65","000","00","010","1013","0000","913","313","600","48","961","2027","0","47.41","15.44"
"65","000","00","010","1013","0037","501","177","324","13","514","1153","0","44.58","15.35"
"65","000","00","010","1013","0038","412","136","276","35","447","874","0","51.14","15.56"
"65","000","00","010","1014","0000","519","155","364","76","595","1063","0","55.97","14.58"
"65","000","00","010","1014","0039","519","155","364","76","595","1063","0","55.97","14.58"
"65","000","00","010","1015","0000","622","187","435","41","663","1309","0","50.65","14.29"
"65","000","00","010","1015","0040","622","187","435","41","663","1309","0","50.65","14.29"
"65","000","00","010","1016","0000","642","219","423","51","693","1290","0","53.72","16.98"
"65","000","00","010","1016","0041","642","219","423","51","693","1290","0","53.72","16.98"
"65","000","00","010","1017","0000","3278","1219","2059","156","3434","6129","0","56.03","19.89"
"65","000","00","010","1017","0042","930","319","611","27","957","1675","0","57.13","19.04"
"65","000","00","010","1017","0043","826","308","518","48","874","1589","0","55.0","19.38"
"65","000","00","010","1017","0044","895","339","556","47","942","1624","0","58.0","20.87"
"65","000","00","010","1017","0045","627","253","374","34","661","1241","0","53.26","20.39"
"65","000","00","010","1018","0000","2962","1093","1869","153","3115","5578","0","55.84","19.59"
"65","000","00","010","1018","0046","642","219","423","53","695","1317","0","52.77","16.63"
"65","000","00","010","1018","0047","669","237","432","26","695","1225","0","56.73","19.35"
"65","000","00","010","1018","0048","755","287","468","35","790","1426","0","55.4","20.13"
"65","000","00","010","1018","0049","896","350","546","39","935","1610","0","58.07","21.74"
"65","000","00","010","1019","0000","3241","1261","1980","213","3454","6426","0","53.75","19.62"
"65","000","00","010","1019","0052","878","348","530","38","916","1822","0","50.27","19.1"
"65","000","00","010","1019","0053","663","280","383","74","737","1232","0","59.82","22.73"
"65","000","00","010","1019","0054","825","273","552","71","896","1588","0","56.42","17.19"
"65","000","00","010","1019","0055","875","360","515","30","905","1784","0","50.73","20.18"
"65","000","00","010","1020","0000","2655","1031","1624","118","2773","5205","0","53.28","19.81"
"65","000","00","010","1020","0056","874","334","540","54","928","1762","0","52.67","18.96"
"65","000","00","010","1020","0057","794","311","483","28","822","1546","0","53.17","20.12"
"65","000","00","010","1020","0058","987","386","601","36","1023","1897","0","53.93","20.35"
"65","000","00","010","1021","0000","4688","1668","3020","143","4831","9332","0","51.77","17.87"
"65","000","00","010","1021","0059","771","277","494","22","793","1489","0","53.26","18.6"
"65","000","00","010","1021","0060","826","312","514","38","864","1679","0","51.46","18.58"
"65","000","00","010","1021","0061","824","311","513","25","849","1693","0","50.15","18.37"
"65","000","00","010","1021","0062","810","256","554","19","829","1674","0","49.52","15.29"
"65","000","00","010","1021","0063","705","247","458","20","725","1330","0","54.51","18.57"
"65","000","00","010","1021","0064","752","265","487","19","771","1467","0","52.56","18.06"
"65","000","00","010","1022","0000","2912","1094","1818","135","3047","5459","0","55.82","20.04"
"65","000","00","010","1022","0098","959","363","596","33","992","1781","0","55.7","20.38"
"65","000","00","010","1022","0099","919","356","563","55","974","1665","0","58.5","21.38"
"65","000","00","010","1022","0100","1034","375","659","47","1081","2013","0","53.7","18.63"
"65","000","00","010","1023","0000","1890","657","1233","104","1994","3659","0","54.5","17.96"
"65","000","00","010","1023","0106","577","199","378","27","604","1289","0","46.86","15.44"
"65","000","00","010","1023","0107","738","263","475","49","787","1319","0","59.67","19.94"
"65","000","00","010","1023","0108","575","195","380","28","603","1051","0","57.37","18.55"
"65","000","00","010","1024","0000","701","231","470","35","736","1348","0","54.6","17.14"
"65","000","00","010","1024","0109","701","231","470","35","736","1348","0","54.6","17.14"
"65","000","00","010","1025","0000","556","210","346","35","591","1106","0","53.44","18.99"
"65","000","00","010","1025","0110","556","210","346","35","591","1106","0","53.44","18.99"
"65","000","00","010","1026","0000","392","135","257","28","420","717","0","58.58","18.83"
"65","000","00","010","1026","0111","392","135","257","28","420","717","0","58.58","18.83"
"65","000","00","010","1027","0000","704","268","436","33","737","1385","0","53.21","19.35"
"65","000","00","010","1027","0112","704","268","436","33","737","1385","0","53.21","19.35"
"65","000","00","010","1028","0000","463","173","290","39","502","841","0","59.69","20.57"
"65","000","00","010","1028","0113","463","173","290","39","502","841","0","59.69","20.57"
"65","000","00","010","1029","0000","363","135","228","23","386","665","0","58.05","20.3"
"65","000","00","010","1029","0114","363","135","228","23","386","665","0","58.05","20.3"
"65","000","00","010","1030","0000","237","86","151","14","251","419","0","59.9","20.53"
"65","000","00","010","1030","0115","237","86","151","14","251","419","0","59.9","20.53"
"65","000","00","010","1031","0000","876","306","570","25","901","1599","0","56.35","19.14"
"65","000","00","010","1031","0116","876","306","570","25","901","1599","0","56.35","19.14"
"65","000","00","010","1032","0000","2480","870","1610","163","2643","4930","0","53.61","17.65"
"65","000","00","010","1032","0117","817","293","524","61","878","1670","0","52.57","17.54"
"65","000","00","010","1032","0118","907","321","586","52","959","1683","0","56.98","19.07"
"65","000","00","010","1032","0119","756","256","500","50","806","1577","0","51.11","16.23"
"65","000","00","010","1033","0000","1775","628","1147","75","1850","3832","0","48.28","16.39"
"65","000","00","010","1033","0120","775","275","500","38","813","1618","0","50.25","17.0"
"65","000","00","010","1033","0121","1000","353","647","37","1037","2214","0","46.84","15.94"
"65","000","00","010","1034","0000","1950","675","1275","126","2076","3750","0","55.36","18.0"
"65","000","00","010","1034","0083","694","235","459","33","727","1297","0","56.05","18.12"
"65","000","00","010","1034","0084","526","193","333","45","571","1066","0","53.56","18.11"
"65","000","00","010","1034","0085","730","247","483","48","778","1387","0","56.09","17.81"
"65","000","00","010","1035","0000","3802","1347","2455","144","3946","7408","0","53.27","18.18"
"65","000","00","010","1035","0086","1001","337","664","40","1041","1909","0","54.53","17.65"
"65","000","00","010","1035","0087","923","328","595","34","957","1770","0","54.07","18.53"
"65","000","00","010","1035","0088","993","338","655","44","1037","2049","0","50.61","16.5"
"65","000","00","010","1035","0089","885","344","541","26","911","1680","0","54.23","20.48"
"65","000","00","010","1036","0000","2285","850","1435","107","2392","4250","0","56.28","20.0"
"65","000","00","010","1036","0090","802","302","500","46","848","1433","0","59.18","21.07"
"65","000","00","010","1036","0091","706","264","442","25","731","1365","0","53.55","19.34"
"65","000","00","010","1036","0092","777","284","493","36","813","1452","0","55.99","19.56"
"65","000","00","010","1037","0000","1936","817","1119","68","2004","4020","0","49.85","20.32"
"65","000","00","010","1037","0077","1059","416","643","39","1098","1992","0","55.12","20.88"
"65","000","00","010","1037","0078","877","401","476","29","906","2028","0","44.67","19.77"
"65","000","00","010","1038","0000","1301","567","734","37","1338","2456","0","54.48","23.09"
"65","000","00","010","1038","0075","681","323","358","21","702","1245","0","56.39","25.94"
"65","000","00","010","1038","0076","620","244","376","16","636","1211","0","52.52","20.15"
"65","000","00","010","1039","0000","1927","716","1211","85","2012","3906","0","51.51","18.33"
"65","000","00","010","1039","0050","1072","403","669","35","1107","1982","0","55.85","20.33"
"65","000","00","010","1039","0051","855","313","542","50","905","1924","0","47.04","16.27"
"65","000","00","010","1040","0000","1871","678","1193","102","1973","3612","0","54.62","18.77"
"65","000","00","010","1040","0101","553","212","341","41","594","1108","0","53.61","19.13"
"65","000","00","010","1040","0102","686","250","436","40","726","1305","0","55.63","19.16"
"65","000","00","010","1040","0103","632","216","416","21","653","1199","0","54.46","18.02"
"65","000","00","010","1041","0000","2027","750","1277","81","2108","4142","0","50.89","18.11"
"65","000","00","010","1041","0104","1030","364","666","38","1068","2017","0","52.95","18.05"
"65","000","00","010","1041","0105","997","386","611","43","1040","2125","0","48.94","18.16"
"65","000","00","010","1042","0000","3249","1095","2154","119","3368","6953","0","48.44","15.75"
"65","000","00","010","1042","0122","914","321","593","40","954","1832","0","52.07","17.52"
"65","000","00","010","1042","0123","1054","374","680","61","1115","2123","0","52.52","17.62"
"65","000","00","010","1042","0124","1281","400","881","18","1299","2998","0","43.33","13.34"
"65","000","00","011","0000","0000","87141","32285","54856","4848","91989","173831","200217","52.92","18.57"
"65","000","00","011","1101","0000","664","248","416","42","706","1262","0","55.94","19.65"
"65","000","00","011","1101","2337","664","248","416","42","706","1262","0","55.94","19.65"
"65","000","00","011","1102","0000","491","191","300","50","541","917","0","59.0","20.83"
"65","000","00","011","1102","2338","491","191","300","50","541","917","0","59.0","20.83"
"65","000","00","011","1103","0000","2174","820","1354","93","2267","4156","0","54.55","19.73"
"65","000","00","011","1103","2339","1040","383","657","35","1075","1929","0","55.73","19.85"
"65","000","00","011","1103","2340","1134","437","697","58","1192","2227","0","53.52","19.62"
"65","000","00","011","1104","0000","163","74","89","12","175","322","0","54.35","22.98"
"65","000","00","011","1104","2343","163","74","89","12","175","322","0","54.35","22.98"
"65","000","00","011","1105","0000","1253","494","759","87","1340","2564","0","52.26","19.27"
"65","000","00","011","1105","2373","620","275","345","52","672","1244","0","54.02","22.11"
"65","000","00","011","1105","2374","633","219","414","35","668","1320","0","50.61","16.59"
"65","000","00","011","1106","0000","1752","665","1087","111","1863","4797","0","38.84","13.86"
"65","000","00","011","1106","2350","329","144","185","27","356","1809","0","19.68","7.96"
"65","000","00","011","1106","2351","741","281","460","28","769","1601","0","48.03","17.55"
"65","000","00","011","1106","2352","682","240","442","56","738","1387","0","53.21","17.3"
"65","000","00","011","1107","0000","2448","911","1537","93","2541","4840","0","52.5","18.82"
"65","000","00","011","1107","2344","787","296","491","6","793","1460","0","54.32","20.27"
"65","000","00","011","1107","2345","844","343","501","39","883","1719","0","51.37","19.95"
"65","000","00","011","1107","2346","817","272","545","48","865","1661","0","52.08","16.38"
"65","000","00","011","1108","0000","3336","1317","2019","137","3473","6144","0","56.53","21.44"
"65","000","00","011","1108","2355","1077","417","660","41","1118","2072","0","53.96","20.13"
"65","000","00","011","1108","2356","1186","453","733","56","1242","2120","0","58.58","21.37"
"65","000","00","011","1108","2357","1073","447","626","40","1113","1952","0","57.02","22.9"
"65","000","00","011","1109","0000","1884","679","1205","145","2029","3964","0","51.19","17.13"
"65","000","00","011","1109","2365","657","227","430","61","718","1363","0","52.68","16.65"
"65","000","00","011","1109","2366","661","237","424","36","697","1368","0","50.95","17.32"
"65","000","00","011","1109","2367","566","215","351","48","614","1233","0","49.8","17.44"
"65","000","00","011","1110","0000","678","254","424","57","735","1481","0","49.63","17.15"
"65","000","00","011","1110","2378","678","254","424","57","735","1481","0","49.63","17.15"
"65","000","00","011","1111","0000","713","301","412","59","772","1497","0","51.57","20.11"
"65","000","00","011","1111","2379","713","301","412","59","772","1497","0","51.57","20.11"
"65","000","00","011","1112","0000","1888","692","1196","87","1975","3940","0","50.13","17.56"
"65","000","00","011","1112","2381","904","324","580","55","959","1913","0","50.13","16.94"
"65","000","00","011","1112","2382","984","368","616","32","1016","2027","0","50.12","18.15"
"65","000","00","011","1113","0000","998","386","612","60","1058","2127","0","49.74","18.15"
"65","000","00","011","1113","2385","998","386","612","60","1058","2127","0","49.74","18.15"
"65","000","00","011","1114","0000","2482","902","1580","171","2653","5447","0","48.71","16.56"
"65","000","00","011","1114","2386","729","282","447","47","776","1642","0","47.26","17.17"
"65","000","00","011","1114","2387","928","334","594","65","993","1912","0","51.94","17.47"
"65","000","00","011","1114","2388","825","286","539","59","884","1893","0","46.7","15.11"
"65","000","00","011","1115","0000","2138","795","1343","161","2299","4554","0","50.48","17.46"
"65","000","00","011","1115","2389","663","244","419","53","716","1466","0","48.84","16.64"
"65","000","00","011","1115","2390","727","252","475","67","794","1538","0","51.63","16.38"
"65","000","00","011","1115","2391","748","299","449","41","789","1550","0","50.9","19.29"
"65","000","00","011","1116","0000","696","235","461","55","751","1456","0","51.58","16.14"
"65","000","00","011","1116","2392","696","235","461","55","751","1456","0","51.58","16.14"
"65","000","00","011","1117","0000","537","180","357","38","575","947","0","60.72","19.01"
"65","000","00","011","1117","2393","537","180","357","38","575","947","0","60.72","19.01"
"65","000","00","011","1118","0000","850","288","562","34","884","1988","0","44.47","14.49"
"65","000","00","011","1118","2400","850","288","562","34","884","1988","0","44.47","14.49"
"65","000","00","011","1119","0000","1801","672","1129","181","1982","4055","0","48.88","16.57"
"65","000","00","011","1119","2395","899","321","578","128","1027","2043","0","50.27","15.71"
"65","000","00","011","1119","2396","902","351","551","53","955","2012","0","47.47","17.45"
"65","000","00","011","1120","0000","2809","1021","1788","182","2991","5100","0","58.65","20.02"
"65","000","00","011","1120","2431","722","265","457","44","766","1335","0","57.38","19.85"
"65","000","00","011","1120","2432","767","259","508","40","807","1324","0","60.95","19.56"
"65","000","00","011","1120","2433","726","266","460","55","781","1286","0","60.73","20.68"
"65","000","00","011","1120","2434","594","231","363","43","637","1155","0","55.15","20.0"
"65","000","00","011","1121","0000","1699","607","1092","90","1789","3847","0","46.5","15.78"
"65","000","00","011","1121","2363","826","291","535","49","875","1941","0","45.08","14.99"
"65","000","00","011","1121","2364","873","316","557","41","914","1906","0","47.95","16.58"
"65","000","00","011","1122","0000","2083","763","1320","159","2242","4215","0","53.19","18.1"
"65","000","00","011","1122","2438","1109","416","693","104","1213","2184","0","55.54","19.05"
"65","000","00","011","1122","2439","974","347","627","55","1029","2031","0","50.66","17.09"
"65","000","00","011","1123","0000","304","93","211","12","316","556","0","56.83","16.73"
"65","000","00","011","1123","2380","304","93","211","12","316","556","0","56.83","16.73"
"65","000","00","011","1124","0000","1770","661","1109","104","1874","3336","0","56.18","19.81"
"65","000","00","011","1124","2440","916","335","581","57","973","1759","0","55.32","19.04"
"65","000","00","011","1124","2441","854","326","528","47","901","1577","0","57.13","20.67"
"65","000","00","011","1125","0000","1492","525","967","62","1554","2765","0","56.2","18.99"
"65","000","00","011","1125","2442","717","252","465","22","739","1364","0","54.18","18.48"
"65","000","00","011","1125","2443","775","273","502","40","815","1401","0","58.17","19.49"
"65","000","00","011","1126","0000","3247","1143","2104","197","3444","6938","0","49.64","16.47"
"65","000","00","011","1126","2411","852","298","554","42","894","1765","0","50.65","16.88"
"65","000","00","011","1126","2412","773","251","522","29","802","1815","0","44.19","13.83"
"65","000","00","011","1126","2413","808","289","519","67","875","1778","0","49.21","16.25"
"65","000","00","011","1126","2414","814","305","509","59","873","1580","0","55.25","19.3"
"65","000","00","011","1127","0000","2660","980","1680","105","2765","5304","0","52.13","18.48"
"65","000","00","011","1127","2422","964","377","587","34","998","2035","0","49.04","18.53"
"65","000","00","011","1127","2423","937","316","621","46","983","1895","0","51.87","16.68"
"65","000","00","011","1127","2424","759","287","472","25","784","1374","0","57.06","20.89"
"65","000","00","011","1128","0000","796","296","500","62","858","1595","0","53.79","18.56"
"65","000","00","011","1128","2336","796","296","500","62","858","1595","0","53.79","18.56"
"65","000","00","011","1129","0000","3202","1140","2062","164","3366","6514","0","51.67","17.5"
"65","000","00","011","1129","2405","756","268","488","37","793","1511","0","52.48","17.74"
"65","000","00","011","1129","2406","796","298","498","36","832","1691","0","49.2","17.62"
"65","000","00","011","1129","2407","828","276","552","42","870","1636","0","53.18","16.87"
"65","000","00","011","1129","2408","822","298","524","49","871","1676","0","51.97","17.78"
"65","000","00","011","1130","0000","3602","1327","2275","206","3808","7292","0","52.22","18.2"
"65","000","00","011","1130","2401","1045","405","640","47","1092","2198","0","49.68","18.43"
"65","000","00","011","1130","2402","827","284","543","42","869","1712","0","50.76","16.59"
"65","000","00","011","1130","2403","961","367","594","46","1007","1806","0","55.76","20.32"
"65","000","00","011","1130","2404","769","271","498","71","840","1576","0","53.3","17.2"
"65","000","00","011","1131","0000","2460","909","1551","147","2607","4725","0","55.17","19.24"
"65","000","00","011","1131","2358","819","290","529","62","881","1654","0","53.26","17.53"
"65","000","00","011","1131","2359","709","261","448","54","763","1444","0","52.84","18.07"
"65","000","00","011","1131","2360","932","358","574","31","963","1627","0","59.19","22.0"
"65","000","00","011","1132","0000","1888","747","1141","110","1998","3817","0","52.34","19.57"
"65","000","00","011","1132","2361","851","329","522","61","912","1751","0","52.08","18.79"
"65","000","00","011","1132","2362","1037","418","619","49","1086","2066","0","52.57","20.23"
"65","000","00","011","1133","0000","2206","804","1402","117","2323","4604","0","50.46","17.46"
"65","000","00","011","1133","2397","660","246","414","26","686","1471","0","46.63","16.72"
"65","000","00","011","1133","2398","776","274","502","38","814","1603","0","50.78","17.09"
"65","000","00","011","1133","2399","770","284","486","53","823","1530","0","53.79","18.56"
"65","000","00","011","1134","0000","1429","538","891","96","1525","2941","0","51.85","18.29"
"65","000","00","011","1134","2415","763","302","461","46","809","1516","0","53.36","19.92"
"65","000","00","011","1134","2416","666","236","430","50","716","1425","0","50.25","16.56"
"65","000","00","011","1135","0000","1454","487","967","93","1547","2824","0","54.78","17.25"
"65","000","00","011","1135","2417","728","234","494","36","764","1388","0","55.04","16.86"
"65","000","00","011","1135","2418","726","253","473","57","783","1436","0","54.53","17.62"
"65","000","00","011","1136","0000","2269","877","1392","88","2357","4624","0","50.97","18.97"
"65","000","00","011","1136","2419","797","321","476","41","838","1591","0","52.67","20.18"
"65","000","00","011","1136","2420","785","298","487","30","815","1639","0","49.73","18.18"
"65","000","00","011","1136","2421","687","258","429","17","704","1394","0","50.5","18.51"
"65","000","00","011","1137","0000","1885","602","1283","80","1965","3176","0","61.87","18.95"
"65","000","00","011","1137","2435","1009","331","678","31","1040","1682","0","61.83","19.68"
"65","000","00","011","1137","2436","876","271","605","49","925","1494","0","61.91","18.14"
"65","000","00","011","1138","0000","632","212","420","72","704","1166","0","60.38","18.18"
"65","000","00","011","1138","2437","632","212","420","72","704","1166","0","60.38","18.18"
"65","000","00","011","1139","0000","2008","741","1267","81","2089","3753","0","55.66","19.74"
"65","000","00","011","1139","2444","650","266","384","46","696","1173","0","59.34","22.68"
"65","000","00","011","1139","2445","541","204","337","12","553","993","0","55.69","20.54"
"65","000","00","011","1139","2446","817","271","546","23","840","1587","0","52.93","17.08"
"65","000","00","011","1140","0000","1215","395","820","56","1271","2429","0","52.33","16.26"
"65","000","00","011","1140","2409","629","216","413","30","659","1264","0","52.14","17.09"
"65","000","00","011","1140","2410","586","179","407","26","612","1165","0","52.53","15.36"
"65","000","00","011","1141","0000","1382","511","871","75","1457","2510","0","58.05","20.36"
"65","000","00","011","1141","2341","596","234","362","46","642","1143","0","56.17","20.47"
"65","000","00","011","1141","2342","786","277","509","29","815","1367","0","59.62","20.26"
"65","000","00","011","1142","0000","2235","853","1382","75","2310","4378","0","52.76","19.48"
"65","000","00","011","1142","2368","788","305","483","18","806","1554","0","51.87","19.63"
"65","000","00","011","1142","2369","833","295","538","40","873","1700","0","51.35","17.35"
"65","000","00","011","1142","2370","614","253","361","17","631","1124","0","56.14","22.51"
"65","000","00","011","1143","0000","3100","1078","2022","133","3233","5763","0","56.1","18.71"
"65","000","00","011","1143","2427","822","291","531","31","853","1548","0","55.1","18.8"
"65","000","00","011","1143","2428","742","232","510","30","772","1350","0","57.19","17.19"
"65","000","00","011","1143","2429","781","300","481","35","816","1499","0","54.44","20.01"
"65","000","00","011","1143","2430","755","255","500","37","792","1366","0","57.98","18.67"
"65","000","00","011","1144","0000","500","196","304","20","520","923","0","56.34","21.24"
"65","000","00","011","1144","2394","500","196","304","20","520","923","0","56.34","21.24"
"65","000","00","011","1145","0000","2633","1217","1416","122","2755","4938","0","55.79","24.65"
"65","000","00","011","1145","2347","859","327","532","45","904","1590","0","56.86","20.57"
"65","000","00","011","1145","2348","841","294","547","38","879","1599","0","54.97","18.39"
"65","000","00","011","1145","2349","933","596","337","39","972","1749","0","55.57","34.08"
"65","000","00","011","1146","0000","2059","759","1300","100","2159","3853","0","56.03","19.7"
"65","000","00","011","1146","2353","944","370","574","54","998","1779","0","56.1","20.8"
"65","000","00","011","1146","2354","1115","389","726","46","1161","2074","0","55.98","18.76"
"65","000","00","011","1147","0000","2450","852","1598","120","2570","4541","0","56.6","18.76"
"65","000","00","011","1147","2375","796","297","499","38","834","1473","0","56.62","20.16"
"65","000","00","011","1147","2376","944","303","641","51","995","1802","0","55.22","16.81"
"65","000","00","011","1147","2377","710","252","458","31","741","1266","0","58.53","19.91"
"65","000","00","011","1148","0000","2074","803","1271","112","2186","3950","0","55.34","20.33"
"65","000","00","011","1148","2371","1034","403","631","54","1088","1900","0","57.26","21.21"
"65","000","00","011","1148","2372","1040","400","640","58","1098","2050","0","53.56","19.51"
"65","000","00","011","1149","0000","1401","549","852","51","1452","2373","0","61.19","23.14"
"65","000","00","011","1149","2425","605","252","353","23","628","1061","0","59.19","23.75"
"65","000","00","011","1149","2426","796","297","499","28","824","1312","0","62.8","22.64"
"65","000","00","011","1150","0000","1251","495","756","84","1335","2623","0","50.9","18.87"
"65","000","00","011","1150","2383","910","362","548","37","947","1927","0","49.14","18.79"
"65","000","00","011","1150","2384","341","133","208","47","388","696","0","55.75","19.11"
"65","000","00","012","0000","0000","15700","5235","10465","1265","16965","35036","40022","48.42","14.94"
"65","000","00","012","1201","0000","389","125","264","31","420","725","0","57.93","17.24"
"65","000","00","012","1201","2220","389","125","264","31","420","725","0","57.93","17.24"
"65","000","00","012","1202","0000","981","340","641","56","1037","1899","0","54.61","17.9"
"65","000","00","012","1202","2221","572","204","368","37","609","1074","0","56.7","18.99"
"65","000","00","012","1202","2222","409","136","273","19","428","825","0","51.88","16.48"
"65","000","00","012","1203","0000","627","230","397","33","660","1242","0","53.14","18.52"
"65","000","00","012","1203","2223","627","230","397","33","660","1242","0","53.14","18.52"
"65","000","00","012","1204","0000","773","266","507","62","835","1632","0","51.16","16.3"
"65","000","00","012","1204","2225","439","152","287","30","469","872","0","53.78","17.43"
"65","000","00","012","1204","2226","334","114","220","32","366","760","0","48.16","15.0"
"65","000","00","012","1205","0000","580","224","356","45","625","1330","0","46.99","16.84"
"65","000","00","012","1205","2227","580","224","356","45","625","1330","0","46.99","16.84"
"65","000","00","012","1206","0000","305","89","216","26","331","598","0","55.35","14.88"
"65","000","00","012","1206","2224","305","89","216","26","331","598","0","55.35","14.88"
"65","000","00","012","1207","0000","1666","549","1117","139","1805","3609","0","50.01","15.21"
"65","000","00","012","1207","2228","739","249","490","48","787","1683","0","46.76","14.8"
"65","000","00","012","1207","2229","469","159","310","48","517","980","0","52.76","16.22"
"65","000","00","012","1207","2230","458","141","317","43","501","946","0","52.96","14.9"
"65","000","00","012","1208","0000","504","181","323","55","559","1089","0","51.33","16.62"
"65","000","00","012","1208","2235","504","181","323","55","559","1089","0","51.33","16.62"
"65","000","00","012","1209","0000","695","224","471","55","750","1623","0","46.21","13.8"
"65","000","00","012","1209","2233","411","132","279","25","436","978","0","44.58","13.5"
"65","000","00","012","1209","2234","284","92","192","30","314","645","0","48.68","14.26"
"65","000","00","012","1210","0000","560","190","370","47","607","1291","0","47.02","14.72"
"65","000","00","012","1210","2245","330","113","217","38","368","673","0","54.68","16.79"
"65","000","00","012","1210","2246","230","77","153","9","239","618","0","38.67","12.46"
"65","000","00","012","1211","0000","823","334","489","97","920","1701","0","54.09","19.64"
"65","000","00","012","1211","2240","417","174","243","33","450","817","0","55.08","21.3"
"65","000","00","012","1211","2241","406","160","246","64","470","884","0","53.17","18.1"
"65","000","00","012","1212","0000","1337","488","849","86","1423","2985","0","47.67","16.35"
"65","000","00","012","1212","2242","577","222","355","41","618","1333","0","46.36","16.65"
"65","000","00","012","1212","2243","246","96","150","8","254","607","0","41.85","15.82"
"65","000","00","012","1212","2244","514","170","344","37","551","1045","0","52.73","16.27"
"65","000","00","012","1213","0000","880","301","579","83","963","1923","0","50.08","15.65"
"65","000","00","012","1213","2247","457","165","292","39","496","1063","0","46.66","15.52"
"65","000","00","012","1213","2248","423","136","287","44","467","860","0","54.3","15.81"
"65","000","00","012","1214","0000","217","70","147","28","245","461","0","53.15","15.18"
"65","000","00","012","1214","2237","217","70","147","28","245","461","0","53.15","15.18"
"65","000","00","012","1215","0000","115","38","77","22","137","274","0","50.0","13.87"
"65","000","00","012","1215","2238","115","38","77","22","137","274","0","50.0","13.87"
"65","000","00","012","1216","0000","107","42","65","17","124","286","0","43.36","14.69"
"65","000","00","012","1216","2236","107","42","65","17","124","286","0","43.36","14.69"
"65","000","00","012","1217","0000","88","34","54","7","95","155","0","61.29","21.94"
"65","000","00","012","1217","2239","88","34","54","7","95","155","0","61.29","21.94"
"65","000","00","012","1218","0000","133","47","86","3","136","432","0","31.48","10.88"
"65","000","00","012","1218","2249","133","47","86","3","136","432","0","31.48","10.88"
"65","000","00","012","1219","0000","163","46","117","9","172","445","0","38.65","10.34"
"65","000","00","012","1219","2250","163","46","117","9","172","445","0","38.65","10.34"
"65","000","00","012","1220","0000","129","34","95","9","138","318","0","43.4","10.69"
"65","000","00","012","1220","2251","129","34","95","9","138","318","0","43.4","10.69"
"65","000","00","012","1221","0000","70","13","57","7","77","159","0","48.43","8.18"
"65","000","00","012","1221","2252","70","13","57","7","77","159","0","48.43","8.18"
"65","000","00","012","1222","0000","136","41","95","11","147","337","0","43.62","12.17"
"65","000","00","012","1222","2253","136","41","95","11","147","337","0","43.62","12.17"
"65","000","00","012","1223","0000","178","55","123","12","190","369","0","51.49","14.91"
"65","000","00","012","1223","2256","178","55","123","12","190","369","0","51.49","14.91"
"65","000","00","012","1224","0000","92","31","61","7","99","180","0","55.0","17.22"
"65","000","00","012","1224","2254","92","31","61","7","99","180","0","55.0","17.22"
"65","000","00","012","1225","0000","66","21","45","15","81","187","0","43.32","11.23"
"65","000","00","012","1225","2255","66","21","45","15","81","187","0","43.32","11.23"
"65","000","00","012","1226","0000","166","54","112","20","186","335","0","55.52","16.12"
"65","000","00","012","1226","2257","166","54","112","20","186","335","0","55.52","16.12"
"65","000","00","012","1227","0000","110","36","74","8","118","297","0","39.73","12.12"
"65","000","00","012","1227","2259","110","36","74","8","118","297","0","39.73","12.12"
"65","000","00","012","1228","0000","186","58","128","18","204","470","0","43.4","12.34"
"65","000","00","012","1228","2258","186","58","128","18","204","470","0","43.4","12.34"
"65","000","00","012","1229","0000","448","112","336","21","469","1241","0","37.79","9.02"
"65","000","00","012","1229","2262","448","112","336","21","469","1241","0","37.79","9.02"
"65","000","00","012","1230","0000","916","285","631","118","1034","1946","0","53.13","14.65"
"65","000","00","012","1230","2263","468","149","319","65","533","998","0","53.41","14.93"
"65","000","00","012","1230","2264","448","136","312","53","501","948","0","52.85","14.35"
"65","000","00","012","1231","0000","482","144","338","30","512","1308","0","39.14","11.01"
"65","000","00","012","1231","2265","482","144","338","30","512","1308","0","39.14","11.01"
"65","000","00","012","1232","0000","173","48","125","3","176","267","0","65.92","17.98"
"65","000","00","012","1232","2260","173","48","125","3","176","267","0","65.92","17.98"
"65","000","00","012","1233","0000","226","51","175","15","241","876","0","27.51","5.82"
"65","000","00","012","1233","2261","226","51","175","15","241","876","0","27.51","5.82"
"65","000","00","012","1234","0000","1379","434","945","70","1449","3046","0","47.57","14.25"
"65","000","00","012","1234","2231","596","189","407","30","626","1375","0","45.53","13.75"
"65","000","00","012","1234","2232","783","245","538","40","823","1671","0","49.25","14.66"
"65","000","00","013","0000","0000","103714","37665","66049","6692","110406","200783","236964","54.99","18.76"
"65","000","00","013","1301","0000","1726","615","1111","137","1863","4869","0","38.26","12.63"
"65","000","00","013","1301","1799","514","203","311","37","551","2518","0","21.88","8.06"
"65","000","00","013","1301","1800","624","223","401","39","663","1218","0","54.43","18.31"
"65","000","00","013","1301","1801","588","189","399","61","649","1133","0","57.28","16.68"
"65","000","00","013","1302","0000","966","362","604","88","1054","1825","0","57.75","19.84"
"65","000","00","013","1302","1802","469","162","307","39","508","894","0","56.82","18.12"
"65","000","00","013","1302","1803","497","200","297","49","546","931","0","58.65","21.48"
"65","000","00","013","1303","0000","2841","1053","1788","182","3023","5283","0","57.22","19.93"
"65","000","00","013","1303","1808","734","287","447","50","784","1378","0","56.89","20.83"
"65","000","00","013","1303","1809","774","286","488","55","829","1421","0","58.34","20.13"
"65","000","00","013","1303","1810","692","237","455","39","731","1340","0","54.55","17.69"
"65","000","00","013","1303","1811","641","243","398","38","679","1144","0","59.35","21.24"
"65","000","00","013","1304","0000","2506","866","1640","158","2664","4954","0","53.77","17.48"
"65","000","00","013","1304","1795","681","231","450","31","712","1292","0","55.11","17.88"
"65","000","00","013","1304","1796","649","232","417","35","684","1324","0","51.66","17.52"
"65","000","00","013","1304","1797","568","188","380","47","615","1155","0","53.25","16.28"
"65","000","00","013","1304","1798","608","215","393","45","653","1183","0","55.2","18.17"
"65","000","00","013","1305","0000","1118","364","754","37","1155","1820","0","63.46","20.0"
"65","000","00","013","1305","1804","1118","364","754","37","1155","1820","0","63.46","20.0"
"65","000","00","013","1306","0000","2155","730","1425","201","2356","4161","0","56.62","17.54"
"65","000","00","013","1306","1820","702","235","467","77","779","1356","0","57.45","17.33"
"65","000","00","013","1306","1821","776","271","505","56","832","1496","0","55.61","18.11"
"65","000","00","013","1306","1822","677","224","453","68","745","1309","0","56.91","17.11"
"65","000","00","013","1307","0000","2780","970","1810","219","2999","5067","0","59.19","19.14"
"65","000","00","013","1307","1816","653","224","429","52","705","1230","0","57.32","18.21"
"65","000","00","013","1307","1817","712","258","454","61","773","1342","0","57.6","19.23"
"65","000","00","013","1307","1818","699","257","442","46","745","1268","0","58.75","20.27"
"65","000","00","013","1307","1819","716","231","485","60","776","1227","0","63.24","18.83"
"65","000","00","013","1308","0000","2044","792","1252","148","2192","3900","0","56.21","20.31"
"65","000","00","013","1308","1827","611","236","375","62","673","1182","0","56.94","19.97"
"65","000","00","013","1308","1828","812","311","501","43","855","1558","0","54.88","19.96"
"65","000","00","013","1308","1829","621","245","376","43","664","1160","0","57.24","21.12"
"65","000","00","013","1309","0000","1591","547","1044","73","1664","2965","0","56.12","18.45"
"65","000","00","013","1309","1858","738","249","489","40","778","1445","0","53.84","17.23"
"65","000","00","013","1309","1859","853","298","555","33","886","1520","0","58.29","19.61"
"65","000","00","013","1310","0000","4072","1541","2531","240","4312","7503","0","57.47","20.54"
"65","000","00","013","1310","1840","806","300","506","59","865","1576","0","54.89","19.04"
"65","000","00","013","1310","1841","778","294","484","52","830","1458","0","56.93","20.16"
"65","000","00","013","1310","1842","786","284","502","83","869","1517","0","57.28","18.72"
"65","000","00","013","1310","1843","851","315","536","29","880","1489","0","59.1","21.16"
"65","000","00","013","1310","1844","851","348","503","17","868","1463","0","59.33","23.79"
"65","000","00","013","1311","0000","1452","553","899","119","1571","2821","0","55.69","19.6"
"65","000","00","013","1311","1830","723","275","448","46","769","1357","0","56.67","20.27"
"65","000","00","013","1311","1831","729","278","451","73","802","1464","0","54.78","18.99"
"65","000","00","013","1312","0000","3692","1338","2354","212","3904","7204","0","54.19","18.57"
"65","000","00","013","1312","1875","738","265","473","51","789","1402","0","56.28","18.9"
"65","000","00","013","1312","1876","705","261","444","46","751","1379","0","54.46","18.93"
"65","000","00","013","1312","1877","729","270","459","45","774","1471","0","52.62","18.35"
"65","000","00","013","1312","1878","720","235","485","35","755","1410","0","53.55","16.67"
"65","000","00","013","1312","1879","800","307","493","35","835","1542","0","54.15","19.91"
"65","000","00","013","1313","0000","2610","979","1631","177","2787","5586","0","49.89","17.53"
"65","000","00","013","1313","1864","620","246","374","36","656","1337","0","49.07","18.4"
"65","000","00","013","1313","1865","552","199","353","40","592","1325","0","44.68","15.02"
"65","000","00","013","1313","1866","665","240","425","43","708","1390","0","50.94","17.27"
"65","000","00","013","1313","1867","773","294","479","58","831","1534","0","54.17","19.17"
"65","000","00","013","1314","0000","2080","747","1333","133","2213","3850","0","57.48","19.4"
"65","000","00","013","1314","1880","630","226","404","52","682","1238","0","55.09","18.26"
"65","000","00","013","1314","1881","638","226","412","52","690","1301","0","53.04","17.37"
"65","000","00","013","1314","1882","812","295","517","29","841","1311","0","64.15","22.5"
"65","000","00","013","1315","0000","713","262","451","75","788","1484","0","53.1","17.65"
"65","000","00","013","1315","1868","713","262","451","75","788","1484","0","53.1","17.65"
"65","000","00","013","1316","0000","3183","1100","2083","198","3381","6156","0","54.92","17.87"
"65","000","00","013","1316","1869","727","256","471","69","796","1532","0","51.96","16.71"
"65","000","00","013","1316","1870","801","270","531","51","852","1507","0","56.54","17.92"
"65","000","00","013","1316","1871","829","301","528","40","869","1550","0","56.06","19.42"
"65","000","00","013","1316","1872","826","273","553","38","864","1567","0","55.14","17.42"
"65","000","00","013","1317","0000","3249","1202","2047","259","3508","6530","0","53.72","18.41"
"65","000","00","013","1317","1892","643","233","410","74","717","1312","0","54.65","17.76"
"65","000","00","013","1317","1893","626","233","393","55","681","1301","0","52.34","17.91"
"65","000","00","013","1317","1894","612","229","383","53","665","1254","0","53.03","18.26"
"65","000","00","013","1317","1895","622","240","382","33","655","1215","0","53.91","19.75"
"65","000","00","013","1317","1896","746","267","479","44","790","1448","0","54.56","18.44"
"65","000","00","013","1318","0000","3171","1073","2098","236","3407","6194","0","55.0","17.32"
"65","000","00","013","1318","1906","773","184","589","56","829","1550","0","53.48","11.87"
"65","000","00","013","1318","1907","854","328","526","67","921","1606","0","57.35","20.42"
"65","000","00","013","1318","1908","776","281","495","54","830","1509","0","55.0","18.62"
"65","000","00","013","1318","1909","768","280","488","59","827","1529","0","54.09","18.31"
"65","000","00","013","1319","0000","2285","795","1490","116","2401","4283","0","56.06","18.56"
"65","000","00","013","1319","1886","746","244","502","45","791","1335","0","59.25","18.28"
"65","000","00","013","1319","1887","764","257","507","41","805","1459","0","55.17","17.61"
"65","000","00","013","1319","1888","775","294","481","30","805","1489","0","54.06","19.74"
"65","000","00","013","1320","0000","2240","796","1444","151","2391","4330","0","55.22","18.38"
"65","000","00","013","1320","1792","625","227","398","69","694","1206","0","57.55","18.82"
"65","000","00","013","1320","1793","704","269","435","26","730","1255","0","58.17","21.43"
"65","000","00","013","1320","1794","911","300","611","56","967","1869","0","51.74","16.05"
"65","000","00","013","1321","0000","3656","1271","2385","213","3869","7156","0","54.07","17.76"
"65","000","00","013","1321","1787","692","215","477","44","736","1424","0","51.69","15.1"
"65","000","00","013","1321","1788","730","256","474","55","785","1455","0","53.95","17.59"
"65","000","00","013","1321","1789","707","236","471","31","738","1419","0","52.01","16.63"
"65","000","00","013","1321","1790","765","277","488","45","810","1357","0","59.69","20.41"
"65","000","00","013","1321","1791","762","287","475","38","800","1501","0","53.3","19.12"
"65","000","00","013","1322","0000","2061","767","1294","133","2194","4013","0","54.67","19.11"
"65","000","00","013","1322","1784","666","251","415","44","710","1378","0","51.52","18.21"
"65","000","00","013","1322","1785","630","237","393","34","664","1256","0","52.87","18.87"
"65","000","00","013","1322","1786","765","279","486","55","820","1379","0","59.46","20.23"
"65","000","00","013","1323","0000","2220","755","1465","141","2361","4405","0","53.6","17.14"
"65","000","00","013","1323","1781","780","292","488","44","824","1499","0","54.97","19.48"
"65","000","00","013","1323","1782","741","230","511","36","777","1495","0","51.97","15.38"
"65","000","00","013","1323","1783","699","233","466","61","760","1411","0","53.86","16.51"
"65","000","00","013","1324","0000","2284","856","1428","164","2448","4638","0","52.78","18.46"
"65","000","00","013","1324","1778","743","345","398","72","815","1474","0","55.29","23.41"
"65","000","00","013","1324","1779","726","241","485","44","770","1489","0","51.71","16.19"
"65","000","00","013","1324","1780","815","270","545","48","863","1675","0","51.52","16.12"
"65","000","00","013","1325","0000","1405","496","909","61","1466","2448","0","59.89","20.26"
"65","000","00","013","1325","1776","720","269","451","30","750","1242","0","60.39","21.66"
"65","000","00","013","1325","1777","685","227","458","31","716","1206","0","59.37","18.82"
"65","000","00","013","1326","0000","743","257","486","64","807","1505","0","53.62","17.08"
"65","000","00","013","1326","1775","743","257","486","64","807","1505","0","53.62","17.08"
"65","000","00","013","1327","0000","2386","933","1453","159","2545","4640","0","54.85","20.11"
"65","000","00","013","1327","1847","840","314","526","58","898","1598","0","56.2","19.65"
"65","000","00","013","1327","1848","738","310","428","65","803","1500","0","53.53","20.67"
"65","000","00","013","1327","1849","808","309","499","36","844","1542","0","54.73","20.04"
"65","000","00","013","1328","0000","2542","971","1571","111","2653","5032","0","52.72","19.3"
"65","000","00","013","1328","1835","864","318","546","41","905","1639","0","55.22","19.4"
"65","000","00","013","1328","1836","945","365","580","42","987","1728","0","57.12","21.12"
"65","000","00","013","1328","1837","733","288","445","28","761","1665","0","45.71","17.3"
"65","000","00","013","1329","0000","1667","617","1050","77","1744","3140","0","55.54","19.65"
"65","000","00","013","1329","1850","906","346","560","47","953","1619","0","58.86","21.37"
"65","000","00","013","1329","1851","761","271","490","30","791","1521","0","52.01","17.82"
"65","000","00","013","1330","0000","2127","744","1383","154","2281","3975","0","57.38","18.72"
"65","000","00","013","1330","1900","746","262","484","66","812","1366","0","59.44","19.18"
"65","000","00","013","1330","1901","711","261","450","43","754","1292","0","58.36","20.2"
"65","000","00","013","1330","1902","670","221","449","45","715","1317","0","54.29","16.78"
"65","000","00","013","1331","0000","2245","863","1382","167","2412","4421","0","54.56","19.52"
"65","000","00","013","1331","1910","709","240","469","60","769","1458","0","52.74","16.46"
"65","000","00","013","1331","1911","778","317","461","65","843","1468","0","57.43","21.59"
"65","000","00","013","1331","1912","758","306","452","42","800","1495","0","53.51","20.47"
"65","000","00","013","1332","0000","1385","507","878","74","1459","2605","0","56.01","19.46"
"65","000","00","013","1332","1862","655","217","438","32","687","1262","0","54.44","17.19"
"65","000","00","013","1332","1863","730","290","440","42","772","1343","0","57.48","21.59"
"65","000","00","013","1333","0000","2653","912","1741","219","2872","4947","0","58.06","18.44"
"65","000","00","013","1333","1812","662","249","413","63","725","1268","0","57.18","19.64"
"65","000","00","013","1333","1813","620","191","429","73","693","1196","0","57.94","15.97"
"65","000","00","013","1333","1814","743","270","473","36","779","1308","0","59.56","20.64"
"65","000","00","013","1333","1815","628","202","426","47","675","1175","0","57.45","17.19"
"65","000","00","013","1334","0000","1853","693","1160","166","2019","3896","0","51.82","17.79"
"65","000","00","013","1334","1897","652","210","442","58","710","1321","0","53.75","15.9"
"65","000","00","013","1334","1898","542","207","335","61","603","1150","0","52.43","18.0"
"65","000","00","013","1334","1899","659","276","383","47","706","1425","0","49.54","19.37"
"65","000","00","013","1335","0000","2175","807","1368","140","2315","4116","0","56.24","19.61"
"65","000","00","013","1335","1832","655","232","423","45","700","1335","0","52.43","17.38"
"65","000","00","013","1335","1833","688","254","434","59","747","1346","0","55.5","18.87"
"65","000","00","013","1335","1834","832","321","511","36","868","1435","0","60.49","22.37"
"65","000","00","013","1336","0000","2605","954","1651","181","2786","4896","0","56.9","19.49"
"65","000","00","013","1336","1823","650","251","399","51","701","1175","0","59.66","21.36"
"65","000","00","013","1336","1824","640","235","405","58","698","1237","0","56.43","19.0"
"65","000","00","013","1336","1825","674","226","448","48","722","1256","0","57.48","17.99"
"65","000","00","013","1336","1826","641","242","399","24","665","1228","0","54.15","19.71"
"65","000","00","013","1337","0000","2051","740","1311","102","2153","3975","0","54.16","18.62"
"65","000","00","013","1337","1805","683","229","454","26","709","1320","0","53.71","17.35"
"65","000","00","013","1337","1806","629","237","392","35","664","1241","0","53.51","19.1"
"65","000","00","013","1337","1807","739","274","465","41","780","1414","0","55.16","19.38"
"65","000","00","013","1338","0000","2280","819","1461","148","2428","4680","0","51.88","17.5"
"65","000","00","013","1338","1883","716","235","481","39","755","1511","0","49.97","15.55"
"65","000","00","013","1338","1884","769","269","500","50","819","1531","0","53.49","17.57"
"65","000","00","013","1338","1885","795","315","480","59","854","1638","0","52.14","19.23"
"65","000","00","013","1339","0000","1624","594","1030","100","1724","2900","0","59.45","20.48"
"65","000","00","013","1339","1838","755","267","488","62","817","1333","0","61.29","20.03"
"65","000","00","013","1339","1839","869","327","542","38","907","1567","0","57.88","20.87"
"65","000","00","013","1340","0000","2971","1057","1914","216","3187","5663","0","56.28","18.67"
"65","000","00","013","1340","1913","673","235","438","72","745","1303","0","57.18","18.04"
"65","000","00","013","1340","1914","724","255","469","47","771","1365","0","56.48","18.68"
"65","000","00","013","1340","1915","756","274","482","64","820","1476","0","55.56","18.56"
"65","000","00","013","1340","1916","818","293","525","33","851","1519","0","56.02","19.29"
"65","000","00","013","1341","0000","1403","540","863","33","1436","2846","0","50.46","18.97"
"65","000","00","013","1341","1860","689","255","434","14","703","1484","0","47.37","17.18"
"65","000","00","013","1341","1861","714","285","429","19","733","1362","0","53.82","20.93"
"65","000","00","013","1342","0000","2388","911","1477","102","2490","4173","0","59.67","21.83"
"65","000","00","013","1342","1855","792","290","502","15","807","1423","0","56.71","20.38"
"65","000","00","013","1342","1856","773","300","473","38","811","1321","0","61.39","22.71"
"65","000","00","013","1342","1857","823","321","502","49","872","1429","0","61.02","22.46"
"65","000","00","013","1343","0000","2734","1133","1601","109","2843","5120","0","55.53","22.13"
"65","000","00","013","1343","1852","899","378","521","27","926","1691","0","54.76","22.35"
"65","000","00","013","1343","1853","828","332","496","56","884","1657","0","53.35","20.04"
"65","000","00","013","1343","1854","1007","423","584","26","1033","1772","0","58.3","23.87"
"65","000","00","013","1344","0000","1622","600","1022","67","1689","3048","0","55.41","19.69"
"65","000","00","013","1344","1845","862","315","547","28","890","1584","0","56.19","19.89"
"65","000","00","013","1344","1846","760","285","475","39","799","1464","0","54.58","19.47"
"65","000","00","013","1345","0000","1387","554","833","89","1476","2660","0","55.49","20.83"
"65","000","00","013","1345","1873","742","342","400","41","783","1367","0","57.28","25.02"
"65","000","00","013","1345","1874","645","212","433","48","693","1293","0","53.6","16.4"
"65","000","00","013","1346","0000","2809","951","1858","191","3000","5364","0","55.93","17.73"
"65","000","00","013","1346","1889","931","312","619","89","1020","1774","0","57.5","17.59"
"65","000","00","013","1346","1890","940","354","586","42","982","1792","0","54.8","19.75"
"65","000","00","013","1346","1891","938","285","653","60","998","1798","0","55.51","15.85"
"65","000","00","013","1347","0000","1964","678","1286","152","2116","3736","0","56.64","18.15"
"65","000","00","013","1347","1903","710","232","478","45","755","1324","0","57.02","17.52"
"65","000","00","013","1347","1904","598","225","373","50","648","1189","0","54.5","18.92"
"65","000","00","013","1347","1905","656","221","435","57","713","1223","0","58.3","18.07"
"65","000","00","014","0000","0000","83762","31191","52571","5891","89653","167457","201173","53.54","18.63"
"65","000","00","014","1401","0000","5811","2135","3676","262","6073","10484","0","57.93","20.36"
"65","000","00","014","1401","0581","1013","403","610","47","1060","1791","0","59.18","22.5"
"65","000","00","014","1401","0582","985","352","633","58","1043","1714","0","60.85","20.54"
"65","000","00","014","1401","0583","982","373","609","37","1019","1780","0","57.25","20.96"
"65","000","00","014","1401","0584","935","354","581","38","973","1713","0","56.8","20.67"
"65","000","00","014","1401","0585","946","313","633","38","984","1720","0","57.21","18.2"
"65","000","00","014","1401","0586","950","340","610","44","994","1766","0","56.29","19.25"
"65","000","00","014","1402","0000","2630","996","1634","166","2796","4958","0","56.39","20.09"
"65","000","00","014","1402","0573","908","398","510","55","963","1652","0","58.29","24.09"
"65","000","00","014","1402","0574","846","300","546","67","913","1650","0","55.33","18.18"
"65","000","00","014","1402","0575","876","298","578","44","920","1656","0","55.56","18.0"
"65","000","00","014","1403","0000","1536","546","990","115","1651","3576","0","46.17","15.27"
"65","000","00","014","1403","0561","642","232","410","52","694","1779","0","39.01","13.04"
"65","000","00","014","1403","0562","894","314","580","63","957","1797","0","53.26","17.47"
"65","000","00","014","1404","0000","2443","893","1550","203","2646","4665","0","56.72","19.14"
"65","000","00","014","1404","0555","832","325","507","78","910","1600","0","56.88","20.31"
"65","000","00","014","1404","0556","807","281","526","55","862","1549","0","55.65","18.14"
"65","000","00","014","1404","0557","804","287","517","70","874","1516","0","57.65","18.93"
"65","000","00","014","1405","0000","1669","632","1037","152","1821","3361","0","54.18","18.8"
"65","000","00","014","1405","0655","796","292","504","79","875","1673","0","52.3","17.45"
"65","000","00","014","1405","0656","873","340","533","73","946","1688","0","56.04","20.14"
"65","000","00","014","1406","0000","4387","1643","2744","281","4668","9051","0","51.57","18.15"
"65","000","00","014","1406","0640","971","344","627","59","1030","1851","0","55.65","18.58"
"65","000","00","014","1406","0641","835","306","529","46","881","1791","0","49.19","17.09"
"65","000","00","014","1406","0642","860","333","527","65","925","1853","0","49.92","17.97"
"65","000","00","014","1406","0643","815","308","507","49","864","1758","0","49.15","17.52"
"65","000","00","014","1406","0644","906","352","554","62","968","1798","0","53.84","19.58"
"65","000","00","014","1407","0000","2657","968","1689","175","2832","5589","0","50.67","17.32"
"65","000","00","014","1407","0604","914","348","566","50","964","1806","0","53.38","19.27"
"65","000","00","014","1407","0605","917","320","597","75","992","1910","0","51.94","16.75"
"65","000","00","014","1407","0606","826","300","526","50","876","1873","0","46.77","16.02"
"65","000","00","014","1408","0000","2531","932","1599","139","2670","4826","0","55.33","19.31"
"65","000","00","014","1408","0616","838","305","533","54","892","1634","0","54.59","18.67"
"65","000","00","014","1408","0617","816","291","525","54","870","1573","0","55.31","18.5"
"65","000","00","014","1408","0618","877","336","541","31","908","1619","0","56.08","20.75"
"65","000","00","014","1409","0000","2798","1021","1777","191","2989","5491","0","54.43","18.59"
"65","000","00","014","1409","0619","926","341","585","79","1005","1878","0","53.51","18.16"
"65","000","00","014","1409","0620","895","310","585","72","967","1797","0","53.81","17.25"
"65","000","00","014","1409","0621","977","370","607","40","1017","1816","0","56.0","20.37"
"65","000","00","014","1410","0000","1512","537","975","128","1640","2836","0","57.83","18.94"
"65","000","00","014","1410","0622","726","253","473","67","793","1344","0","59.0","18.82"
"65","000","00","014","1410","0623","786","284","502","61","847","1492","0","56.77","19.03"
"65","000","00","014","1411","0000","1505","575","930","87","1592","2963","0","53.73","19.41"
"65","000","00","014","1411","0636","857","335","522","40","897","1602","0","55.99","20.91"
"65","000","00","014","1411","0637","648","240","408","47","695","1361","0","51.07","17.63"
"65","000","00","014","1412","0000","1102","439","663","236","1338","2287","0","58.5","19.2"
"65","000","00","014","1412","0634","468","229","239","172","640","1111","0","57.61","20.61"
"65","000","00","014","1412","0635","634","210","424","64","698","1176","0","59.35","17.86"
"65","000","00","014","1413","0000","946","323","623","101","1047","1959","0","53.45","16.49"
"65","000","00","014","1413","0624","946","323","623","101","1047","1959","0","53.45","16.49"
"65","000","00","014","1414","0000","1417","538","879","123","1540","2980","0","51.68","18.05"
"65","000","00","014","1414","0630","675","272","403","55","730","1332","0","54.8","20.42"
"65","000","00","014","1414","0631","742","266","476","68","810","1648","0","49.15","16.14"
"65","000","00","014","1415","0000","2702","932","1770","150","2852","5122","0","55.68","18.2"
"65","000","00","014","1415","0587","835","300","535","48","883","1623","0","54.41","18.48"
"65","000","00","014","1415","0588","914","273","641","36","950","1740","0","54.6","15.69"
"65","000","00","014","1415","0589","953","359","594","66","1019","1759","0","57.93","20.41"
"65","000","00","014","1416","0000","2987","1137","1850","181","3168","5489","0","57.72","20.71"
"65","000","00","014","1416","0590","960","379","581","69","1029","1775","0","57.97","21.35"
"65","000","00","014","1416","0591","1046","386","660","43","1089","1909","0","57.05","20.22"
"65","000","00","014","1416","0592","981","372","609","69","1050","1805","0","58.17","20.61"
"65","000","00","014","1417","0000","3007","1149","1858","177","3184","5952","0","53.49","19.3"
"65","000","00","014","1417","0597","707","244","463","56","763","1434","0","53.21","17.02"
"65","000","00","014","1417","0598","754","301","453","55","809","1450","0","55.79","20.76"
"65","000","00","014","1417","0599","763","302","461","22","785","1543","0","50.87","19.57"
"65","000","00","014","1417","0600","783","302","481","44","827","1525","0","54.23","19.8"
"65","000","00","014","1418","0000","1650","583","1067","108","1758","3545","0","49.59","16.45"
"65","000","00","014","1418","0607","822","291","531","48","870","1785","0","48.74","16.3"
"65","000","00","014","1418","0608","828","292","536","60","888","1760","0","50.45","16.59"
"65","000","00","014","1419","0000","2522","960","1562","167","2689","5146","0","52.25","18.66"
"65","000","00","014","1419","0609","969","345","624","56","1025","1841","0","55.68","18.74"
"65","000","00","014","1419","0610","883","337","546","49","932","1855","0","50.24","18.17"
"65","000","00","014","1419","0611","670","278","392","62","732","1450","0","50.48","19.17"
"65","000","00","014","1420","0000","1418","537","881","197","1615","3126","0","51.66","17.18"
"65","000","00","014","1420","0612","757","287","470","77","834","1585","0","52.62","18.11"
"65","000","00","014","1420","0613","661","250","411","120","781","1541","0","50.68","16.22"
"65","000","00","014","1421","0000","3888","1471","2417","279","4167","8323","0","50.07","17.67"
"65","000","00","014","1421","0645","852","320","532","54","906","1645","0","55.08","19.45"
"65","000","00","014","1421","0646","728","283","445","61","789","1612","0","48.95","17.56"
"65","000","00","014","1421","0647","804","332","472","61","865","1784","0","48.49","18.61"
"65","000","00","014","1421","0648","729","269","460","64","793","1701","0","46.62","15.81"
"65","000","00","014","1421","0649","775","267","508","39","814","1581","0","51.49","16.89"
"65","000","00","014","1422","0000","2504","1000","1504","162","2666","4648","0","57.36","21.51"
"65","000","00","014","1422","0650","799","340","459","47","846","1534","0","55.15","22.16"
"65","000","00","014","1422","0651","871","346","525","60","931","1620","0","57.47","21.36"
"65","000","00","014","1422","0652","834","314","520","55","889","1494","0","59.5","21.02"
"65","000","00","014","1423","0000","1488","554","934","95","1583","2881","0","54.95","19.23"
"65","000","00","014","1423","0579","677","265","412","50","727","1367","0","53.18","19.39"
"65","000","00","014","1423","0580","811","289","522","45","856","1514","0","56.54","19.09"
"65","000","00","014","1424","0000","2382","829","1553","145","2527","4810","0","52.54","17.23"
"65","000","00","014","1424","0566","766","270","496","49","815","1524","0","53.48","17.72"
"65","000","00","014","1424","0567","778","262","516","57","835","1612","0","51.8","16.25"
"65","000","00","014","1424","0568","838","297","541","39","877","1674","0","52.39","17.74"
"65","000","00","014","1425","0000","1523","577","946","101","1624","2938","0","55.28","19.64"
"65","000","00","014","1425","0571","775","301","474","53","828","1473","0","56.21","20.43"
"65","000","00","014","1425","0572","748","276","472","48","796","1465","0","54.33","18.84"
"65","000","00","014","1426","0000","1349","479","870","80","1429","2726","0","52.42","17.57"
"65","000","00","014","1426","0632","658","247","411","43","701","1355","0","51.73","18.23"
"65","000","00","014","1426","0633","691","232","459","37","728","1371","0","53.1","16.92"
"65","000","00","014","1427","0000","2527","922","1605","198","2725","4838","0","56.32","19.06"
"65","000","00","014","1427","0625","812","294","518","72","884","1611","0","54.87","18.25"
"65","000","00","014","1427","0626","853","319","534","62","915","1574","0","58.13","20.27"
"65","000","00","014","1427","0627","862","309","553","64","926","1653","0","56.02","18.69"
"65","000","00","014","1428","0000","1906","736","1170","124","2030","4897","0","41.45","15.03"
"65","000","00","014","1428","0628","1006","394","612","53","1059","3085","0","34.33","12.77"
"65","000","00","014","1428","0629","900","342","558","71","971","1812","0","53.59","18.87"
"65","000","00","014","1429","0000","2202","779","1423","168","2370","4270","0","55.5","18.24"
"65","000","00","014","1429","0558","725","249","476","50","775","1404","0","55.2","17.74"
"65","000","00","014","1429","0559","684","235","449","74","758","1381","0","54.89","17.02"
"65","000","00","014","1429","0560","793","295","498","44","837","1485","0","56.36","19.87"
"65","000","00","014","1430","0000","1356","492","864","99","1455","2725","0","53.39","18.06"
"65","000","00","014","1430","0657","639","219","420","41","680","1249","0","54.44","17.53"
"65","000","00","014","1430","0658","717","273","444","58","775","1476","0","52.51","18.5"
"65","000","00","014","1431","0000","2264","854","1410","170","2434","4569","0","53.27","18.69"
"65","000","00","014","1431","0576","763","271","492","57","820","1571","0","52.2","17.25"
"65","000","00","014","1431","0577","755","302","453","65","820","1523","0","53.84","19.83"
"65","000","00","014","1431","0578","746","281","465","48","794","1475","0","53.83","19.05"
"65","000","00","014","1432","0000","1222","413","809","130","1352","2455","0","55.07","16.82"
"65","000","00","014","1432","0638","769","250","519","56","825","1530","0","53.92","16.34"
"65","000","00","014","1432","0639","453","163","290","74","527","925","0","56.97","17.62"
"65","000","00","014","1433","0000","1148","485","663","78","1226","2168","0","56.55","22.37"
"65","000","00","014","1433","0653","621","273","348","37","658","1183","0","55.62","23.08"
"65","000","00","014","1433","0654","527","212","315","41","568","985","0","57.66","21.52"
"65","000","00","014","1434","0000","1484","569","915","104","1588","2867","0","55.39","19.85"
"65","000","00","014","1434","0614","817","306","511","55","872","1626","0","53.63","18.82"
"65","000","00","014","1434","0615","667","263","404","49","716","1241","0","57.7","21.19"
"65","000","00","014","1435","0000","2283","837","1446","168","2451","4566","0","53.68","18.33"
"65","000","00","014","1435","0563","718","262","456","71","789","1364","0","57.84","19.21"
"65","000","00","014","1435","0564","850","311","539","58","908","1635","0","55.54","19.02"
"65","000","00","014","1435","0565","715","264","451","39","754","1567","0","48.12","16.85"
"65","000","00","014","1436","0000","1643","625","1018","88","1731","3652","0","47.4","17.11"
"65","000","00","014","1436","0569","852","318","534","52","904","1838","0","49.18","17.3"
"65","000","00","014","1436","0570","791","307","484","36","827","1814","0","45.59","16.92"
"65","000","00","014","1437","0000","3344","1306","2038","219","3563","6697","0","53.2","19.5"
"65","000","00","014","1437","0593","832","330","502","40","872","1642","0","53.11","20.1"
"65","000","00","014","1437","0594","867","327","540","52","919","1713","0","53.65","19.09"
"65","000","00","014","1437","0595","829","330","499","65","894","1746","0","51.2","18.9"
"65","000","00","014","1437","0596","816","319","497","62","878","1596","0","55.01","19.99"
"65","000","00","014","1438","0000","2019","787","1232","144","2163","4021","0","53.79","19.57"
"65","000","00","014","1438","0601","664","252","412","49","713","1419","0","50.25","17.76"
"65","000","00","014","1438","0602","700","292","408","40","740","1298","0","57.01","22.5"
"65","000","00","014","1438","0603","655","243","412","55","710","1304","0","54.45","18.63"
"65","000","00","015","0000","0000","36326","12868","23458","2422","38748","72443","86156","53.49","17.76"
"65","000","00","015","1501","0000","2118","785","1333","190","2308","4225","0","54.63","18.58"
"65","000","00","015","1501","0207","701","277","424","96","797","1456","0","54.74","19.02"
"65","000","00","015","1501","0208","735","252","483","51","786","1482","0","53.04","17.0"
"65","000","00","015","1501","0209","682","256","426","43","725","1287","0","56.33","19.89"
"65","000","00","015","1502","0000","542","218","324","34","576","1106","0","52.08","19.71"
"65","000","00","015","1502","0210","542","218","324","34","576","1106","0","52.08","19.71"
"65","000","00","015","1503","0000","1769","663","1106","130","1899","3437","0","55.25","19.29"
"65","000","00","015","1503","0212","908","345","563","51","959","1833","0","52.32","18.82"
"65","000","00","015","1503","0213","611","230","381","45","656","1141","0","57.49","20.16"
"65","000","00","015","1503","0214","250","88","162","34","284","463","0","61.34","19.01"
"65","000","00","015","1504","0000","606","199","407","75","681","1283","0","53.08","15.51"
"65","000","00","015","1504","0211","606","199","407","75","681","1283","0","53.08","15.51"
"65","000","00","015","1505","0000","2503","888","1615","174","2677","5271","0","50.79","16.85"
"65","000","00","015","1505","0219","864","307","557","99","963","1832","0","52.57","16.76"
"65","000","00","015","1505","0220","787","292","495","35","822","1542","0","53.31","18.94"
"65","000","00","015","1505","0221","852","289","563","40","892","1897","0","47.02","15.23"
"65","000","00","015","1506","0000","2521","897","1624","231","2752","5478","0","50.24","16.37"
"65","000","00","015","1506","0222","871","306","565","90","961","1964","0","48.93","15.58"
"65","000","00","015","1506","0223","817","302","515","68","885","1779","0","49.75","16.98"
"65","000","00","015","1506","0224","833","289","544","73","906","1735","0","52.22","16.66"
"65","000","00","015","1507","0000","583","257","326","36","619","1281","0","48.32","20.06"
"65","000","00","015","1507","0229","583","257","326","36","619","1281","0","48.32","20.06"
"65","000","00","015","1508","0000","1917","698","1219","157","2074","3910","0","53.04","17.85"
"65","000","00","015","1508","0236","503","199","304","29","532","1333","0","39.91","14.93"
"65","000","00","015","1508","0237","713","280","433","52","765","1263","0","60.57","22.17"
"65","000","00","015","1508","0238","701","219","482","76","777","1314","0","59.13","16.67"
"65","000","00","015","1509","0000","1519","501","1018","86","1605","3126","0","51.34","16.03"
"65","000","00","015","1509","0230","789","263","526","59","848","1566","0","54.15","16.79"
"65","000","00","015","1509","0231","730","238","492","27","757","1560","0","48.53","15.26"
"65","000","00","015","1510","0000","2387","840","1547","129","2516","4643","0","54.19","18.09"
"65","000","00","015","1510","0239","748","271","477","36","784","1513","0","51.82","17.91"
"65","000","00","015","1510","0240","827","261","566","31","858","1517","0","56.56","17.21"
"65","000","00","015","1510","0241","812","308","504","62","874","1613","0","54.18","19.09"
"65","000","00","015","1511","0000","1107","307","800","65","1172","2281","0","51.38","13.46"
"65","000","00","015","1511","0253","541","154","387","30","571","1127","0","50.67","13.66"
"65","000","00","015","1511","0254","566","153","413","35","601","1154","0","52.08","13.26"
"65","000","00","015","1512","0000","1553","457","1096","111","1664","2709","0","61.42","16.87"
"65","000","00","015","1512","0251","795","243","552","58","853","1397","0","61.06","17.39"
"65","000","00","015","1512","0252","758","214","544","53","811","1312","0","61.81","16.31"
"65","000","00","015","1513","0000","2125","723","1402","110","2235","3916","0","57.07","18.46"
"65","000","00","015","1513","0248","732","254","478","28","760","1441","0","52.74","17.63"
"65","000","00","015","1513","0249","729","249","480","26","755","1305","0","57.85","19.08"
"65","000","00","015","1513","0250","664","220","444","56","720","1170","0","61.54","18.8"
"65","000","00","015","1514","0000","1443","536","907","137","1580","2819","0","56.05","19.01"
"65","000","00","015","1514","0217","768","306","462","77","845","1534","0","55.08","19.95"
"65","000","00","015","1514","0218","675","230","445","60","735","1285","0","57.2","17.9"
"65","000","00","015","1515","0000","1763","471","1292","75","1838","3401","0","54.04","13.85"
"65","000","00","015","1515","0232","843","182","661","39","882","1622","0","54.38","11.22"
"65","000","00","015","1515","0233","920","289","631","36","956","1779","0","53.74","16.25"
"65","000","00","015","1516","0000","1743","639","1104","96","1839","3446","0","53.37","18.54"
"65","000","00","015","1516","0215","928","324","604","50","978","1786","0","54.76","18.14"
"65","000","00","015","1516","0216","815","315","500","46","861","1660","0","51.87","18.98"
"65","000","00","015","1517","0000","1535","556","979","100","1635","3054","0","53.54","18.21"
"65","000","00","015","1517","0234","719","235","484","57","776","1487","0","52.19","15.8"
"65","000","00","015","1517","0235","816","321","495","43","859","1567","0","54.82","20.49"
"65","000","00","015","1518","0000","3620","1242","2378","192","3812","7389","0","51.59","16.81"
"65","000","00","015","1518","0225","1082","421","661","29","1111","2299","0","48.33","18.31"
"65","000","00","015","1518","0226","806","266","540","49","855","1755","0","48.72","15.16"
"65","000","00","015","1518","0227","874","282","592","52","926","1674","0","55.32","16.85"
"65","000","00","015","1518","0228","858","273","585","62","920","1661","0","55.39","16.44"
"65","000","00","015","1519","0000","3443","1220","2223","197","3640","6815","0","53.41","17.9"
"65","000","00","015","1519","0242","825","277","548","49","874","1616","0","54.08","17.14"
"65","000","00","015","1519","0243","813","296","517","53","866","1616","0","53.59","18.32"
"65","000","00","015","1519","0244","859","305","554","60","919","1689","0","54.41","18.06"
"65","000","00","015","1519","0245","946","342","604","35","981","1894","0","51.8","18.06"
"65","000","00","015","1520","0000","1529","771","758","97","1626","2853","0","56.99","27.02"
"65","000","00","015","1520","0246","714","248","466","49","763","1210","0","63.06","20.5"
"65","000","00","015","1520","0247","815","523","292","48","863","1643","0","52.53","31.83"
"65","000","00","016","0000","0000","33689","11793","21896","1893","35582","64252","78683","55.38","18.35"
"65","000","00","016","1601","0000","409","138","271","32","441","829","0","53.2","16.65"
"65","000","00","016","1601","0255","298","96","202","27","325","643","0","50.54","14.93"
"65","000","00","016","1601","0256","111","42","69","5","116","186","0","62.37","22.58"
"65","000","00","016","1602","0000","1558","507","1051","80","1638","3051","0","53.69","16.62"
"65","000","00","016","1602","0257","716","237","479","30","746","1457","0","51.2","16.27"
"65","000","00","016","1602","0258","842","270","572","50","892","1594","0","55.96","16.94"
"65","000","00","016","1603","0000","2903","983","1920","191","3094","5921","0","52.25","16.6"
"65","000","00","016","1603","0259","763","227","536","44","807","1598","0","50.5","14.21"
"65","000","00","016","1603","0260","731","262","469","38","769","1503","0","51.16","17.43"
"65","000","00","016","1603","0261","686","240","446","64","750","1436","0","52.23","16.71"
"65","000","00","016","1603","0262","723","254","469","45","768","1384","0","55.49","18.35"
"65","000","00","016","1604","0000","1307","408","899","77","1384","2526","0","54.79","16.15"
"65","000","00","016","1604","0263","660","196","464","42","702","1231","0","57.03","15.92"
"65","000","00","016","1604","0264","647","212","435","35","682","1295","0","52.66","16.37"
"65","000","00","016","1605","0000","2023","705","1318","108","2131","3901","0","54.63","18.07"
"65","000","00","016","1605","0267","643","213","430","33","676","1253","0","53.95","17.0"
"65","000","00","016","1605","0268","634","216","418","32","666","1294","0","51.47","16.69"
"65","000","00","016","1605","0269","746","276","470","43","789","1354","0","58.27","20.38"
"65","000","00","016","1606","0000","1916","682","1234","82","1998","3605","0","55.42","18.92"
"65","000","00","016","1606","0270","663","211","452","27","690","1259","0","54.81","16.76"
"65","000","00","016","1606","0271","700","268","432","22","722","1252","0","57.67","21.41"
"65","000","00","016","1606","0272","553","203","350","33","586","1094","0","53.56","18.56"
"65","000","00","016","1607","0000","2122","785","1337","155","2277","4048","0","56.25","19.39"
"65","000","00","016","1607","0280","694","263","431","40","734","1201","0","61.12","21.9"
"65","000","00","016","1607","0281","607","239","368","55","662","1182","0","56.01","20.22"
"65","000","00","016","1607","0282","821","283","538","60","881","1665","0","52.91","17.0"
"65","000","00","016","1608","0000","1784","658","1126","105","1889","3306","0","57.14","19.9"
"65","000","00","016","1608","0287","580","202","378","32","612","1152","0","53.13","17.53"
"65","000","00","016","1608","0288","598","244","354","30","628","1114","0","56.37","21.9"
"65","000","00","016","1608","0289","606","212","394","43","649","1040","0","62.4","20.38"
"65","000","00","016","1609","0000","1897","648","1249","90","1987","3517","0","56.5","18.42"
"65","000","00","016","1609","0294","654","231","423","31","685","1211","0","56.56","19.08"
"65","000","00","016","1609","0295","684","234","450","28","712","1237","0","57.56","18.92"
"65","000","00","016","1609","0296","559","183","376","31","590","1069","0","55.19","17.12"
"65","000","00","016","1610","0000","2307","800","1507","137","2444","4348","0","56.21","18.4"
"65","000","00","016","1610","0299","707","249","458","42","749","1420","0","52.75","17.54"
"65","000","00","016","1610","0300","727","268","459","54","781","1337","0","58.41","20.04"
"65","000","00","016","1610","0301","873","283","590","41","914","1591","0","57.45","17.79"
"65","000","00","016","1611","0000","1698","596","1102","106","1804","3224","0","55.96","18.49"
"65","000","00","016","1611","0273","852","294","558","40","892","1590","0","56.1","18.49"
"65","000","00","016","1611","0274","846","302","544","66","912","1634","0","55.81","18.48"
"65","000","00","016","1612","0000","3672","1318","2354","221","3893","7245","0","53.73","18.19"
"65","000","00","016","1612","0283","945","319","626","65","1010","1855","0","54.45","17.2"
"65","000","00","016","1612","0284","960","338","622","71","1031","1866","0","55.25","18.11"
"65","000","00","016","1612","0285","992","387","605","43","1035","1935","0","53.49","20.0"
"65","000","00","016","1612","0286","775","274","501","42","817","1589","0","51.42","17.24"
"65","000","00","016","1613","0000","1131","439","692","65","1196","1978","0","60.47","22.19"
"65","000","00","016","1613","0290","556","199","357","42","598","1003","0","59.62","19.84"
"65","000","00","016","1613","0291","575","240","335","23","598","975","0","61.33","24.62"
"65","000","00","016","1614","0000","1506","546","960","66","1572","2920","0","53.84","18.7"
"65","000","00","016","1614","0292","737","283","454","50","787","1440","0","54.65","19.65"
"65","000","00","016","1614","0293","769","263","506","16","785","1480","0","53.04","17.77"
"65","000","00","016","1615","0000","1843","647","1196","92","1935","3331","0","58.09","19.42"
"65","000","00","016","1615","0297","943","344","599","55","998","1680","0","59.4","20.48"
"65","000","00","016","1615","0298","900","303","597","37","937","1651","0","56.75","18.35"
"65","000","00","016","1616","0000","1714","602","1112","123","1837","3173","0","57.89","18.97"
"65","000","00","016","1616","0265","839","318","521","60","899","1563","0","57.52","20.35"
"65","000","00","016","1616","0266","875","284","591","63","938","1610","0","58.26","17.64"
"65","000","00","016","1617","0000","3899","1331","2568","163","4062","7329","0","55.42","18.16"
"65","000","00","016","1617","0275","701","256","445","28","729","1536","0","47.46","16.67"
"65","000","00","016","1617","0276","860","305","555","28","888","1534","0","57.89","19.88"
"65","000","00","016","1617","0277","911","270","641","41","952","1545","0","61.62","17.48"
"65","000","00","016","1617","0278","743","255","488","41","784","1399","0","56.04","18.23"
"65","000","00","016","1617","0279","684","245","439","25","709","1315","0","53.92","18.63"
"65","000","00","017","0000","0000","45916","16881","29035","2376","48292","86203","108950","56.02","19.58"
"65","000","00","017","1701","0000","1841","647","1194","145","1986","3657","0","54.31","17.69"
"65","000","00","017","1701","0145","629","203","426","53","682","1268","0","53.79","16.01"
"65","000","00","017","1701","0146","565","211","354","42","607","1171","0","51.84","18.02"
"65","000","00","017","1701","0147","647","233","414","50","697","1218","0","57.22","19.13"
"65","000","00","017","1702","0000","2335","880","1455","167","2502","4861","0","51.47","18.1"
"65","000","00","017","1702","0148","872","317","555","43","915","1788","0","51.17","17.73"
"65","000","00","017","1702","0149","763","283","480","65","828","1625","0","50.95","17.42"
"65","000","00","017","1702","0150","700","280","420","59","759","1448","0","52.42","19.34"
"65","000","00","017","1703","0000","4317","1573","2744","249","4566","8259","0","55.29","19.05"
"65","000","00","017","1703","0151","619","217","402","66","685","1328","0","51.58","16.34"
"65","000","00","017","1703","0152","653","238","415","54","707","1523","0","46.42","15.63"
"65","000","00","017","1703","0153","644","227","417","39","683","1245","0","54.86","18.23"
"65","000","00","017","1703","0154","800","278","522","26","826","1329","0","62.15","20.92"
"65","000","00","017","1703","0155","822","313","509","37","859","1465","0","58.63","21.37"
"65","000","00","017","1703","0156","779","300","479","27","806","1369","0","58.88","21.91"
"65","000","00","017","1704","0000","2099","783","1316","141","2240","3818","0","58.67","20.51"
"65","000","00","017","1704","0157","741","280","461","49","790","1346","0","58.69","20.8"
"65","000","00","017","1704","0158","589","212","377","60","649","1181","0","54.95","17.95"
"65","000","00","017","1704","0159","769","291","478","32","801","1291","0","62.04","22.54"
"65","000","00","017","1705","0000","1922","660","1262","132","2054","3654","0","56.21","18.06"
"65","000","00","017","1705","0160","623","210","413","51","674","1213","0","55.56","17.31"
"65","000","00","017","1705","0161","699","243","456","34","733","1256","0","58.36","19.35"
"65","000","00","017","1705","0162","600","207","393","47","647","1185","0","54.6","17.47"
"65","000","00","017","1706","0000","696","213","483","60","756","1361","0","55.55","15.65"
"65","000","00","017","1706","0163","696","213","483","60","756","1361","0","55.55","15.65"
"65","000","00","017","1707","0000","9327","3341","5986","306","9633","17256","0","55.82","19.36"
"65","000","00","017","1707","0164","877","292","585","22","899","1756","0","51.2","16.63"
"65","000","00","017","1707","0165","843","256","587","20","863","1676","0","51.49","15.27"
"65","000","00","017","1707","0166","857","304","553","15","872","1540","0","56.62","19.74"
"65","000","00","017","1707","0167","819","291","528","32","851","1569","0","54.24","18.55"
"65","000","00","017","1707","0168","811","286","525","27","838","1514","0","55.35","18.89"
"65","000","00","017","1707","0169","674","265","409","18","692","1193","0","58.01","22.21"
"65","000","00","017","1707","0170","888","332","556","23","911","1610","0","56.58","20.62"
"65","000","00","017","1707","0171","742","290","452","34","776","1338","0","58.0","21.67"
"65","000","00","017","1707","0172","649","217","432","27","676","1141","0","59.25","19.02"
"65","000","00","017","1707","0173","709","259","450","32","741","1307","0","56.69","19.82"
"65","000","00","017","1707","0174","740","272","468","24","764","1327","0","57.57","20.5"
"65","000","00","017","1707","0175","718","277","441","32","750","1285","0","58.37","21.56"
"65","000","00","017","1708","0000","8484","3214","5270","295","8779","15777","0","55.64","20.37"
"65","000","00","017","1708","0176","805","339","466","40","845","1481","0","57.06","22.89"
"65","000","00","017","1708","0177","842","339","503","23","865","1510","0","57.28","22.45"
"65","000","00","017","1708","0178","905","341","564","40","945","1785","0","52.94","19.1"
"65","000","00","017","1708","0179","946","351","595","28","974","1792","0","54.35","19.59"
"65","000","00","017","1708","0180","832","315","517","28","860","1517","0","56.69","20.76"
"65","000","00","017","1708","0181","873","334","539","26","899","1564","0","57.48","21.36"
"65","000","00","017","1708","0182","872","286","586","23","895","1560","0","57.37","18.33"
"65","000","00","017","1708","0183","809","324","485","30","839","1544","0","54.34","20.98"
"65","000","00","017","1708","0184","835","301","534","27","862","1593","0","54.11","18.9"
"65","000","00","017","1708","0185","765","284","481","30","795","1431","0","55.56","19.85"
"65","000","00","017","1709","0000","2917","1054","1863","160","3077","5291","0","58.16","19.92"
"65","000","00","017","1709","0195","790","270","520","31","821","1380","0","59.49","19.57"
"65","000","00","017","1709","0196","721","258","463","49","770","1367","0","56.33","18.87"
"65","000","00","017","1709","0197","749","272","477","35","784","1350","0","58.07","20.15"
"65","000","00","017","1709","0198","657","254","403","45","702","1194","0","58.79","21.27"
"65","000","00","017","1710","0000","455","160","295","49","504","1026","0","49.12","15.59"
"65","000","00","017","1710","0202","455","160","295","49","504","1026","0","49.12","15.59"
"65","000","00","017","1711","0000","609","226","383","64","673","1210","0","55.62","18.68"
"65","000","00","017","1711","0203","609","226","383","64","673","1210","0","55.62","18.68"
"65","000","00","017","1712","0000","450","166","284","67","517","912","0","56.69","18.2"
"65","000","00","017","1712","0204","450","166","284","67","517","912","0","56.69","18.2"
"65","000","00","017","1713","0000","440","176","264","39","479","824","0","58.13","21.36"
"65","000","00","017","1713","0205","440","176","264","39","479","824","0","58.13","21.36"
"65","000","00","017","1714","0000","768","287","481","66","834","1411","0","59.11","20.34"
"65","000","00","017","1714","0206","768","287","481","66","834","1411","0","59.11","20.34"
"65","000","00","017","1715","0000","3208","1267","1941","143","3351","5852","0","57.26","21.65"
"65","000","00","017","1715","0186","812","325","487","32","844","1571","0","53.72","20.69"
"65","000","00","017","1715","0187","795","310","485","32","827","1439","0","57.47","21.54"
"65","000","00","017","1715","0188","804","306","498","35","839","1451","0","57.82","21.09"
"65","000","00","017","1715","0189","797","326","471","44","841","1391","0","60.46","23.44"
"65","000","00","017","1716","0000","4081","1516","2565","174","4255","7417","0","57.37","20.44"
"65","000","00","017","1716","0190","769","277","492","45","814","1461","0","55.72","18.96"
"65","000","00","017","1716","0191","893","340","553","21","914","1691","0","54.05","20.11"
"65","000","00","017","1716","0192","804","304","500","43","847","1524","0","55.58","19.95"
"65","000","00","017","1716","0193","805","278","527","34","839","1343","0","62.47","20.7"
"65","000","00","017","1716","0194","810","317","493","31","841","1398","0","60.16","22.68"
"65","000","00","017","1717","0000","1967","718","1249","119","2086","3617","0","57.67","19.85"
"65","000","00","017","1717","0199","685","250","435","52","737","1344","0","54.84","18.6"
"65","000","00","017","1717","0200","613","215","398","39","652","1154","0","56.5","18.63"
"65","000","00","017","1717","0201","669","253","416","28","697","1119","0","62.29","22.61"
"65","000","00","018","0000","0000","10755","3861","6894","625","11380","20624","23617","55.18","18.72"
"65","000","00","018","1801","0000","1510","551","959","60","1570","3004","0","52.26","18.34"
"65","000","00","018","1801","2169","692","258","434","9","701","1496","0","46.86","17.25"
"65","000","00","018","1801","2170","818","293","525","51","869","1508","0","57.63","19.43"
"65","000","00","018","1802","0000","1207","417","790","67","1274","2281","0","55.85","18.28"
"65","000","00","018","1802","2163","576","203","373","28","604","1142","0","52.89","17.78"
"65","000","00","018","1802","2164","631","214","417","39","670","1139","0","58.82","18.79"
"65","000","00","018","1803","0000","1324","479","845","75","1399","2710","0","51.62","17.68"
"65","000","00","018","1803","2167","656","242","414","37","693","1330","0","52.11","18.2"
"65","000","00","018","1803","2168","668","237","431","38","706","1380","0","51.16","17.17"
"65","000","00","018","1804","0000","1024","369","655","55","1079","1946","0","55.45","18.96"
"65","000","00","018","1804","2174","367","133","234","32","399","782","0","51.02","17.01"
"65","000","00","018","1804","2175","657","236","421","23","680","1164","0","58.42","20.27"
"65","000","00","018","1805","0000","313","107","206","27","340","556","0","61.15","19.24"
"65","000","00","018","1805","2178","313","107","206","27","340","556","0","61.15","19.24"
"65","000","00","018","1806","0000","2997","1084","1913","171","3168","5579","0","56.78","19.43"
"65","000","00","018","1806","2171","870","343","527","62","932","1624","0","57.39","21.12"
"65","000","00","018","1806","2172","1124","377","747","49","1173","2165","0","54.18","17.41"
"65","000","00","018","1806","2173","1003","364","639","60","1063","1790","0","59.39","20.34"
"65","000","00","018","1807","0000","1208","437","771","83","1291","2465","0","52.37","17.73"
"65","000","00","018","1807","2165","535","188","347","41","576","1065","0","54.08","17.65"
"65","000","00","018","1807","2166","673","249","424","42","715","1400","0","51.07","17.79"
"65","000","00","018","1808","0000","1172","417","755","87","1259","2083","0","60.44","20.02"
"65","000","00","018","1808","2176","747","270","477","57","804","1344","0","59.82","20.09"
"65","000","00","018","1808","2177","425","147","278","30","455","739","0","61.57","19.89"
"65","000","00","019","0000","0000","3176","1094","2082","293","3469","6861","7727","50.56","15.95"
"65","000","00","019","1901","0000","222","90","132","21","243","391","0","62.15","23.02"
"65","000","00","019","1901","2179","222","90","132","21","243","391","0","62.15","23.02"
"65","000","00","019","1902","0000","366","108","258","39","405","789","0","51.33","13.69"
"65","000","00","019","1902","2180","366","108","258","39","405","789","0","51.33","13.69"
"65","000","00","019","1903","0000","271","111","160","32","303","683","0","44.36","16.25"
"65","000","00","019","1903","2185","271","111","160","32","303","683","0","44.36","16.25"
"65","000","00","019","1904","0000","255","76","179","24","279","662","0","42.15","11.48"
"65","000","00","019","1904","2181","255","76","179","24","279","662","0","42.15","11.48"
"65","000","00","019","1905","0000","151","48","103","10","161","310","0","51.94","15.48"
"65","000","00","019","1905","2182","151","48","103","10","161","310","0","51.94","15.48"
"65","000","00","019","1906","0000","168","53","115","18","186","373","0","49.87","14.21"
"65","000","00","019","1906","2183","136","43","93","12","148","280","0","52.86","15.36"
"65","000","00","019","1906","2184","32","10","22","6","38","93","0","40.86","10.75"
"65","000","00","019","1907","0000","296","95","201","20","316","591","0","53.47","16.07"
"65","000","00","019","1907","2188","296","95","201","20","316","591","0","53.47","16.07"
"65","000","00","019","1908","0000","272","83","189","14","286","726","0","39.39","11.43"
"65","000","00","019","1908","2187","272","83","189","14","286","726","0","39.39","11.43"
"65","000","00","019","1909","0000","156","61","95","34","190","282","0","67.38","21.63"
"65","000","00","019","1909","2189","156","61","95","34","190","282","0","67.38","21.63"
"65","000","00","019","1910","0000","199","68","131","8","207","323","0","64.09","21.05"
"65","000","00","019","1910","2186","199","68","131","8","207","323","0","64.09","21.05"
"65","000","00","019","1911","0000","318","105","213","21","339","788","0","43.02","13.32"
"65","000","00","019","1911","2190","318","105","213","21","339","788","0","43.02","13.32"
"65","000","00","019","1912","0000","502","196","306","52","554","943","0","58.75","20.78"
"65","000","00","019","1912","2191","502","196","306","52","554","943","0","58.75","20.78"
"65","000","00","020","0000","0000","2727","898","1829","291","3018","5891","6570","51.23","15.24"
"65","000","00","020","2001","0000","419","141","278","67","486","843","0","57.65","16.73"
"65","000","00","020","2001","2196","290","99","191","41","331","595","0","55.63","16.64"
"65","000","00","020","2001","2197","129","42","87","26","155","248","0","62.5","16.94"
"65","000","00","020","2002","0000","640","211","429","33","673","1248","0","53.93","16.91"
"65","000","00","020","2002","2192","640","211","429","33","673","1248","0","53.93","16.91"
"65","000","00","020","2003","0000","574","182","392","80","654","1141","0","57.32","15.95"
"65","000","00","020","2003","2194","574","182","392","80","654","1141","0","57.32","15.95"
"65","000","00","020","2004","0000","169","65","104","7","176","417","0","42.21","15.59"
"65","000","00","020","2004","2195","169","65","104","7","176","417","0","42.21","15.59"
"65","000","00","020","2005","0000","343","113","230","32","375","816","0","45.96","13.85"
"65","000","00","020","2005","2198","159","54","105","10","169","338","0","50.0","15.98"
"65","000","00","020","2005","2199","184","59","125","22","206","478","0","43.1","12.34"
"65","000","00","020","2006","0000","250","83","167","42","292","612","0","47.71","13.56"
"65","000","00","020","2006","2193","250","83","167","42","292","612","0","47.71","13.56"
"65","000","00","020","2007","0000","332","103","229","30","362","814","0","44.47","12.65"
"65","000","00","020","2007","2200","151","52","99","9","160","390","0","41.03","13.33"
"65","000","00","020","2007","2201","181","51","130","21","202","424","0","47.64","12.03"
"65","000","00","021","0000","0000","9023","3186","5837","741","9764","20119","23010","48.53","15.84"
"65","000","00","021","2101","0000","137","44","93","11","148","312","0","47.44","14.1"
"65","000","00","021","2101","0011","137","44","93","11","148","312","0","47.44","14.1"
"65","000","00","021","2102","0000","2294","835","1459","147","2441","4806","0","50.79","17.37"
"65","000","00","021","2102","0012","669","248","421","33","702","1421","0","49.4","17.45"
"65","000","00","021","2102","0013","752","276","476","53","805","1557","0","51.7","17.73"
"65","000","00","021","2102","0014","873","311","562","61","934","1828","0","51.09","17.01"
"65","000","00","021","2103","0000","497","168","329","43","540","1060","0","50.94","15.85"
"65","000","00","021","2103","0015","497","168","329","43","540","1060","0","50.94","15.85"
"65","000","00","021","2104","0000","314","105","209","42","356","819","0","43.47","12.82"
"65","000","00","021","2104","0016","314","105","209","42","356","819","0","43.47","12.82"
"65","000","00","021","2105","0000","2622","897","1725","189","2811","6140","0","45.78","14.61"
"65","000","00","021","2105","0017","681","244","437","39","720","1701","0","42.33","14.34"
"65","000","00","021","2105","0018","785","288","497","54","839","1740","0","48.22","16.55"
"65","000","00","021","2105","0019","633","211","422","43","676","1451","0","46.59","14.54"
"65","000","00","021","2105","0020","523","154","369","53","576","1248","0","46.15","12.34"
"65","000","00","021","2106","0000","316","115","201","18","334","629","0","53.1","18.28"
"65","000","00","021","2106","0021","316","115","201","18","334","629","0","53.1","18.28"
"65","000","00","021","2107","0000","213","62","151","22","235","504","0","46.63","12.3"
"65","000","00","021","2107","0022","213","62","151","22","235","504","0","46.63","12.3"
"65","000","00","021","2108","0000","297","106","191","23","320","698","0","45.85","15.19"
"65","000","00","021","2108","0023","297","106","191","23","320","698","0","45.85","15.19"
"65","000","00","021","2109","0000","922","314","608","55","977","2069","0","47.22","15.18"
"65","000","00","021","2109","0024","922","314","608","55","977","2069","0","47.22","15.18"
"65","000","00","021","2110","0000","376","150","226","41","417","784","0","53.19","19.13"
"65","000","00","021","2110","0025","376","150","226","41","417","784","0","53.19","19.13"
"65","000","00","021","2111","0000","238","86","152","28","266","522","0","50.96","16.48"
"65","000","00","021","2111","0026","238","86","152","28","266","522","0","50.96","16.48"
"65","000","00","021","2112","0000","248","91","157","61","309","587","0","52.64","15.5"
"65","000","00","021","2112","0027","248","91","157","61","309","587","0","52.64","15.5"
"65","000","00","021","2113","0000","549","213","336","61","610","1189","0","51.3","17.91"
"65","000","00","021","2113","0028","549","213","336","61","610","1189","0","51.3","17.91"
"65","000","00","022","0000","0000","4910","1579","3331","541","5451","10528","12158","51.78","15.0"
"65","000","00","022","2201","0000","530","186","344","51","581","1121","0","51.83","16.59"
"65","000","00","022","2201","0001","530","186","344","51","581","1121","0","51.83","16.59"
"65","000","00","022","2202","0000","603","195","408","69","672","1389","0","48.38","14.04"
"65","000","00","022","2202","0002","603","195","408","69","672","1389","0","48.38","14.04"
"65","000","00","022","2203","0000","984","303","681","126","1110","2177","0","50.99","13.92"
"65","000","00","022","2203","0003","430","121","309","60","490","933","0","52.52","12.97"
"65","000","00","022","2203","0004","554","182","372","66","620","1244","0","49.84","14.63"
"65","000","00","022","2204","0000","402","123","279","83","485","883","0","54.93","13.93"
"65","000","00","022","2204","0005","402","123","279","83","485","883","0","54.93","13.93"
"65","000","00","022","2205","0000","781","252","529","58","839","1564","0","53.64","16.11"
"65","000","00","022","2205","0006","781","252","529","58","839","1564","0","53.64","16.11"
"65","000","00","022","2206","0000","744","247","497","52","796","1500","0","53.07","16.47"
"65","000","00","022","2206","0007","744","247","497","52","796","1500","0","53.07","16.47"
"65","000","00","022","2207","0000","135","37","98","16","151","328","0","46.04","11.28"
"65","000","00","022","2207","0008","135","37","98","16","151","328","0","46.04","11.28"
"65","000","00","022","2208","0000","370","120","250","35","405","651","0","62.21","18.43"
"65","000","00","022","2208","0009","370","120","250","35","405","651","0","62.21","18.43"
"65","000","00","022","2209","0000","361","116","245","51","412","915","0","45.03","12.68"
"65","000","00","022","2209","0010","361","116","245","51","412","915","0","45.03","12.68"
"65","000","00","023","0000","0000","16411","5690","10721","1076","17487","32970","38861","53.04","17.26"
"65","000","00","023","2301","0000","3202","1155","2047","192","3394","6595","0","51.46","17.51"
"65","000","00","023","2301","0125","693","251","442","51","744","1498","0","49.67","16.76"
"65","000","00","023","2301","0126","865","330","535","34","899","1939","0","46.36","17.02"
"65","000","00","023","2301","0127","748","239","509","61","809","1516","0","53.36","15.77"
"65","000","00","023","2301","0128","896","335","561","46","942","1642","0","57.37","20.4"
"65","000","00","023","2302","0000","1517","582","935","118","1635","3203","0","51.05","18.17"
"65","000","00","023","2302","0129","868","348","520","74","942","1927","0","48.88","18.06"
"65","000","00","023","2302","0130","649","234","415","44","693","1276","0","54.31","18.34"
"65","000","00","023","2303","0000","1497","500","997","78","1575","2752","0","57.23","18.17"
"65","000","00","023","2303","0131","749","247","502","40","789","1349","0","58.49","18.31"
"65","000","00","023","2303","0132","748","253","495","38","786","1403","0","56.02","18.03"
"65","000","00","023","2304","0000","1783","601","1182","103","1886","3497","0","53.93","17.19"
"65","000","00","023","2304","0133","841","294","547","48","889","1644","0","54.08","17.88"
"65","000","00","023","2304","0134","942","307","635","55","997","1853","0","53.8","16.57"
"65","000","00","023","2305","0000","988","321","667","56","1044","1793","0","58.23","17.9"
"65","000","00","023","2305","0135","988","321","667","56","1044","1793","0","58.23","17.9"
"65","000","00","023","2306","0000","3240","1158","2082","193","3433","6457","0","53.17","17.93"
"65","000","00","023","2306","0136","834","281","553","49","883","1644","0","53.71","17.09"
"65","000","00","023","2306","0137","919","330","589","44","963","1846","0","52.17","17.88"
"65","000","00","023","2306","0138","670","240","430","49","719","1346","0","53.42","17.83"
"65","000","00","023","2306","0139","817","307","510","51","868","1621","0","53.55","18.94"
"65","000","00","023","2307","0000","1828","569","1259","122","1950","4077","0","47.83","13.96"
"65","000","00","023","2307","0140","885","255","630","58","943","2110","0","44.69","12.09"
"65","000","00","023","2307","0141","943","314","629","64","1007","1967","0","51.19","15.96"
"65","000","00","023","2308","0000","830","292","538","67","897","1626","0","55.17","17.96"
"65","000","00","023","2308","0142","830","292","538","67","897","1626","0","55.17","17.96"
"65","000","00","023","2309","0000","774","256","518","60","834","1514","0","55.09","16.91"
"65","000","00","023","2309","0143","774","256","518","60","834","1514","0","55.09","16.91"
"65","000","00","023","2310","0000","752","256","496","87","839","1456","0","57.62","17.58"
"65","000","00","023","2310","0144","752","256","496","87","839","1456","0","57.62","17.58"
"65","000","00","024","0000","0000","1844","547","1297","233","2077","4321","4687","48.07","12.66"
"65","000","00","024","2401","0000","165","45","120","31","196","384","0","51.04","11.72"
"65","000","00","024","2401","2208","165","45","120","31","196","384","0","51.04","11.72"
"65","000","00","024","2402","0000","98","29","69","3","101","232","0","43.53","12.5"
"65","000","00","024","2402","2209","98","29","69","3","101","232","0","43.53","12.5"
"65","000","00","024","2403","0000","128","37","91","12","140","249","0","56.22","14.86"
"65","000","00","024","2403","2210","128","37","91","12","140","249","0","56.22","14.86"
"65","000","00","024","2404","0000","208","82","126","44","252","458","0","55.02","17.9"
"65","000","00","024","2404","2211","208","82","126","44","252","458","0","55.02","17.9"
"65","000","00","024","2405","0000","109","29","80","18","127","232","0","54.74","12.5"
"65","000","00","024","2405","2212","109","29","80","18","127","232","0","54.74","12.5"
"65","000","00","024","2406","0000","247","82","165","17","264","635","0","41.57","12.91"
"65","000","00","024","2406","2213","247","82","165","17","264","635","0","41.57","12.91"
"65","000","00","024","2407","0000","212","55","157","35","247","427","0","57.85","12.88"
"65","000","00","024","2407","2214","212","55","157","35","247","427","0","57.85","12.88"
"65","000","00","024","2408","0000","71","21","50","2","73","147","0","49.66","14.29"
"65","000","00","024","2408","2216","71","21","50","2","73","147","0","49.66","14.29"
"65","000","00","024","2409","0000","125","24","101","13","138","365","0","37.81","6.58"
"65","000","00","024","2409","2217","125","24","101","13","138","365","0","37.81","6.58"
"65","000","00","024","2410","0000","98","19","79","11","109","177","0","61.58","10.73"
"65","000","00","024","2410","2219","98","19","79","11","109","177","0","61.58","10.73"
"65","000","00","024","2411","0000","327","110","217","40","367","862","0","42.58","12.76"
"65","000","00","024","2411","2215","327","110","217","40","367","862","0","42.58","12.76"
"65","000","00","024","2412","0000","56","14","42","7","63","153","0","41.18","9.15"
"65","000","00","024","2412","2218","56","14","42","7","63","153","0","41.18","9.15"
"65","000","00","025","0000","0000","3509","1037","2472","374","3883","7999","8872","48.54","12.96"
"65","000","00","025","2501","0000","195","54","141","20","215","455","0","47.25","11.87"
"65","000","00","025","2501","2266","195","54","141","20","215","455","0","47.25","11.87"
"65","000","00","025","2502","0000","174","52","122","25","199","391","0","50.9","13.3"
"65","000","00","025","2502","2278","58","18","40","7","65","120","0","54.17","15.0"
"65","000","00","025","2502","2279","116","34","82","18","134","271","0","49.45","12.55"
"65","000","00","025","2503","0000","382","111","271","40","422","782","0","53.96","14.19"
"65","000","00","025","2503","2267","133","38","95","15","148","286","0","51.75","13.29"
"65","000","00","025","2503","2268","249","73","176","25","274","496","0","55.24","14.72"
"65","000","00","025","2504","0000","358","111","247","48","406","733","0","55.39","15.14"
"65","000","00","025","2504","2280","185","52","133","28","213","362","0","58.84","14.36"
"65","000","00","025","2504","2281","173","59","114","20","193","371","0","52.02","15.9"
"65","000","00","025","2505","0000","154","45","109","12","166","383","0","43.34","11.75"
"65","000","00","025","2505","2269","154","45","109","12","166","383","0","43.34","11.75"
"65","000","00","025","2506","0000","589","174","415","67","656","1539","0","42.63","11.31"
"65","000","00","025","2506","2270","335","97","238","43","378","887","0","42.62","10.94"
"65","000","00","025","2506","2271","254","77","177","24","278","652","0","42.64","11.81"
"65","000","00","025","2507","0000","159","46","113","10","169","333","0","50.75","13.81"
"65","000","00","025","2507","2272","159","46","113","10","169","333","0","50.75","13.81"
"65","000","00","025","2508","0000","412","130","282","46","458","924","0","49.57","14.07"
"65","000","00","025","2508","2273","292","84","208","29","321","642","0","50.0","13.08"
"65","000","00","025","2508","2274","120","46","74","17","137","282","0","48.58","16.31"
"65","000","00","025","2509","0000","244","77","167","27","271","621","0","43.64","12.4"
"65","000","00","025","2509","2275","244","77","167","27","271","621","0","43.64","12.4"
"65","000","00","025","2510","0000","162","55","107","10","172","422","0","40.76","13.03"
"65","000","00","025","2510","2276","162","55","107","10","172","422","0","40.76","13.03"
"65","000","00","025","2511","0000","112","33","79","25","137","369","0","37.13","8.94"
"65","000","00","025","2511","2277","112","33","79","25","137","369","0","37.13","8.94"
"65","000","00","025","2512","0000","568","149","419","44","612","1047","0","58.45","14.23"
"65","000","00","025","2512","2282","568","149","419","44","612","1047","0","58.45","14.23"
"65","000","00","026","0000","0000","4467","1418","3049","482","4949","11279","12364","43.88","12.57"
"65","000","00","026","2601","0000","379","126","253","55","434","876","0","49.54","14.38"
"65","000","00","026","2601","2283","379","126","253","55","434","876","0","49.54","14.38"
"65","000","00","026","2602","0000","212","73","139","14","226","516","0","43.8","14.15"
"65","000","00","026","2602","2285","212","73","139","14","226","516","0","43.8","14.15"
"65","000","00","026","2603","0000","245","82","163","57","302","686","0","44.02","11.95"
"65","000","00","026","2603","2286","130","46","84","23","153","373","0","41.02","12.33"
"65","000","00","026","2603","2287","115","36","79","34","149","313","0","47.6","11.5"
"65","000","00","026","2604","0000","197","74","123","20","217","433","0","50.12","17.09"
"65","000","00","026","2604","2284","197","74","123","20","217","433","0","50.12","17.09"
"65","000","00","026","2605","0000","234","85","149","32","266","676","0","39.35","12.57"
"65","000","00","026","2605","2292","234","85","149","32","266","676","0","39.35","12.57"
"65","000","00","026","2606","0000","682","206","476","72","754","1673","0","45.07","12.31"
"65","000","00","026","2606","2290","312","88","224","26","338","812","0","41.63","10.84"
"65","000","00","026","2606","2291","370","118","252","46","416","861","0","48.32","13.7"
"65","000","00","026","2607","0000","723","244","479","42","765","1731","0","44.19","14.1"
"65","000","00","026","2607","2295","295","93","202","7","302","769","0","39.27","12.09"
"65","000","00","026","2607","2296","428","151","277","35","463","962","0","48.13","15.7"
"65","000","00","026","2608","0000","712","230","482","86","798","2046","0","39.0","11.24"
"65","000","00","026","2608","2293","374","132","242","31","405","1091","0","37.12","12.1"
"65","000","00","026","2608","2294","338","98","240","55","393","955","0","41.15","10.26"
"65","000","00","026","2609","0000","409","124","285","43","452","900","0","50.22","13.78"
"65","000","00","026","2609","2288","227","63","164","14","241","485","0","49.69","12.99"
"65","000","00","026","2609","2289","182","61","121","29","211","415","0","50.84","14.7"
"65","000","00","026","2610","0000","347","77","270","21","368","739","0","49.8","10.42"
"65","000","00","026","2610","2297","203","44","159","11","214","390","0","54.87","11.28"
"65","000","00","026","2610","2298","144","33","111","10","154","349","0","44.13","9.46"
"65","000","00","026","2611","0000","327","97","230","40","367","1003","0","36.59","9.67"
"65","000","00","026","2611","2299","173","49","124","30","203","508","0","39.96","9.65"
"65","000","00","026","2611","2300","154","48","106","10","164","495","0","33.13","9.7"
"65","000","00","027","0000","0000","8737","3271","5466","890","9627","18978","21821","50.73","17.24"
"65","000","00","027","2701","0000","233","69","164","29","262","481","0","54.47","14.35"
"65","000","00","027","2701","2301","233","69","164","29","262","481","0","54.47","14.35"
"65","000","00","027","2702","0000","342","106","236","39","381","715","0","53.29","14.83"
"65","000","00","027","2702","2302","342","106","236","39","381","715","0","53.29","14.83"
"65","000","00","027","2703","0000","194","58","136","21","215","481","0","44.7","12.06"
"65","000","00","027","2703","2303","194","58","136","21","215","481","0","44.7","12.06"
"65","000","00","027","2704","0000","766","200","566","69","835","1792","0","46.6","11.16"
"65","000","00","027","2704","2304","766","200","566","69","835","1792","0","46.6","11.16"
"65","000","00","027","2705","0000","1826","1025","801","167","1993","3791","0","52.57","27.04"
"65","000","00","027","2705","2305","830","277","553","82","912","1781","0","51.21","15.55"
"65","000","00","027","2705","2306","996","748","248","85","1081","2010","0","53.78","37.21"
"65","000","00","027","2706","0000","832","287","545","73","905","1716","0","52.74","16.72"
"65","000","00","027","2706","2310","403","139","264","33","436","828","0","52.66","16.79"
"65","000","00","027","2706","2311","429","148","281","40","469","888","0","52.82","16.67"
"65","000","00","027","2707","0000","554","188","366","58","612","1211","0","50.54","15.52"
"65","000","00","027","2707","2312","554","188","366","58","612","1211","0","50.54","15.52"
"65","000","00","027","2708","0000","216","62","154","23","239","416","0","57.45","14.9"
"65","000","00","027","2708","2313","216","62","154","23","239","416","0","57.45","14.9"
"65","000","00","027","2709","0000","350","122","228","48","398","682","0","58.36","17.89"
"65","000","00","027","2709","2314","350","122","228","48","398","682","0","58.36","17.89"
"65","000","00","027","2710","0000","299","90","209","50","349","644","0","54.19","13.98"
"65","000","00","027","2710","2315","299","90","209","50","349","644","0","54.19","13.98"
"65","000","00","027","2711","0000","367","89","278","42","409","830","0","49.28","10.72"
"65","000","00","027","2711","2316","367","89","278","42","409","830","0","49.28","10.72"
"65","000","00","027","2712","0000","235","63","172","26","261","469","0","55.65","13.43"
"65","000","00","027","2712","2318","235","63","172","26","261","469","0","55.65","13.43"
"65","000","00","027","2713","0000","89","27","62","11","100","188","0","53.19","14.36"
"65","000","00","027","2713","2317","89","27","62","11","100","188","0","53.19","14.36"
"65","000","00","027","2714","0000","186","54","132","31","217","582","0","37.29","9.28"
"65","000","00","027","2714","2319","186","54","132","31","217","582","0","37.29","9.28"
"65","000","00","027","2715","0000","2248","831","1417","203","2451","4980","0","49.22","16.69"
"65","000","00","027","2715","2307","695","221","474","64","759","1572","0","48.28","14.06"
"65","000","00","027","2715","2308","832","382","450","81","913","1777","0","51.38","21.5"
"65","000","00","027","2715","2309","721","228","493","58","779","1631","0","47.76","13.98"
"65","000","00","028","0000","0000","8681","2609","6072","926","9607","19297","22102","49.78","13.52"
"65","000","00","028","2801","0000","2103","658","1445","152","2255","4309","0","52.33","15.27"
"65","000","00","028","2801","2320","642","192","450","53","695","1286","0","54.04","14.93"
"65","000","00","028","2801","2321","798","263","535","61","859","1576","0","54.51","16.69"
"65","000","00","028","2801","2322","663","203","460","38","701","1447","0","48.45","14.03"
"65","000","00","028","2802","0000","1067","308","759","101","1168","2532","0","46.13","12.16"
"65","000","00","028","2802","2325","429","137","292","47","476","1215","0","39.18","11.28"
"65","000","00","028","2802","2326","638","171","467","54","692","1317","0","52.54","12.98"
"65","000","00","028","2803","0000","1234","384","850","231","1465","3226","0","45.41","11.9"
"65","000","00","028","2803","2327","575","186","389","152","727","1676","0","43.38","11.1"
"65","000","00","028","2803","2328","659","198","461","79","738","1550","0","47.61","12.77"
"65","000","00","028","2804","0000","1402","426","976","144","1546","2705","0","57.15","15.75"
"65","000","00","028","2804","2329","526","170","356","59","585","945","0","61.9","17.99"
"65","000","00","028","2804","2330","876","256","620","85","961","1760","0","54.6","14.55"
"65","000","00","028","2805","0000","262","59","203","24","286","570","0","50.18","10.35"
"65","000","00","028","2805","2331","262","59","203","24","286","570","0","50.18","10.35"
"65","000","00","028","2806","0000","437","145","292","28","465","952","0","48.84","15.23"
"65","000","00","028","2806","2332","437","145","292","28","465","952","0","48.84","15.23"
"65","000","00","028","2807","0000","335","78","257","59","394","674","0","58.46","11.57"
"65","000","00","028","2807","2333","335","78","257","59","394","674","0","58.46","11.57"
"65","000","00","028","2808","0000","192","64","128","20","212","405","0","52.35","15.8"
"65","000","00","028","2808","2334","192","64","128","20","212","405","0","52.35","15.8"
"65","000","00","028","2809","0000","500","143","357","51","551","1089","0","50.6","13.13"
"65","000","00","028","2809","2335","500","143","357","51","551","1089","0","50.6","13.13"
"65","000","00","028","2810","0000","1149","344","805","116","1265","2835","0","44.62","12.13"
"65","000","00","028","2810","2323","607","182","425","64","671","1466","0","45.77","12.41"
"65","000","00","028","2810","2324","542","162","380","52","594","1369","0","43.39","11.83"
"65","000","00","029","0000","0000","2751","832","1919","105","2856","5264","6383","54.26","15.81"
"65","000","00","029","2901","0000","1165","347","818","29","1194","2367","0","50.44","14.66"
"65","000","00","029","2901","2203","593","187","406","10","603","1198","0","50.33","15.61"
"65","000","00","029","2901","2204","572","160","412","19","591","1169","0","50.56","13.69"
"65","000","00","029","2902","0000","910","301","609","36","946","1568","0","60.33","19.2"
"65","000","00","029","2902","2202","910","301","609","36","946","1568","0","60.33","19.2"
"65","000","00","029","2903","0000","303","83","220","19","322","615","0","52.36","13.5"
"65","000","00","029","2903","2207","303","83","220","19","322","615","0","52.36","13.5"
"65","000","00","029","2904","0000","250","66","184","20","270","486","0","55.56","13.58"
"65","000","00","029","2904","2206","250","66","184","20","270","486","0","55.56","13.58"
"65","000","00","029","2905","0000","123","35","88","1","124","228","0","54.39","15.35"
"65","000","00","029","2905","2205","123","35","88","1","124","228","0","54.39","15.35"
"68","000","00","000","0000","0000","886585","295646","590939","43820","930405","1801823","2215615","51.64","16.41"
"68","000","00","001","0000","0000","174940","63229","111711","7703","182643","359790","446246","50.76","17.57"
"68","000","00","001","0101","0000","345","147","198","17","362","690","0","52.46","21.3"
"68","000","00","001","0101","0032","345","147","198","17","362","690","0","52.46","21.3"
"68","000","00","001","0102","0000","750","281","469","46","796","1353","0","58.83","20.77"
"68","000","00","001","0102","0034","750","281","469","46","796","1353","0","58.83","20.77"
"68","000","00","001","0103","0000","688","273","415","44","732","1582","0","46.27","17.26"
"68","000","00","001","0103","0043","688","273","415","44","732","1582","0","46.27","17.26"
"68","000","00","001","0104","0000","3111","1108","2003","140","3251","6636","0","48.99","16.7"
"68","000","00","001","0104","0001","767","275","492","41","808","1593","0","50.72","17.26"
"68","000","00","001","0104","0002","817","295","522","31","848","1934","0","43.85","15.25"
"68","000","00","001","0104","0003","857","308","549","54","911","1661","0","54.85","18.54"
"68","000","00","001","0104","0004","670","230","440","14","684","1448","0","47.24","15.88"
"68","000","00","001","0105","0000","1623","583","1040","53","1676","3483","0","48.12","16.74"
"68","000","00","001","0105","0190","831","303","528","24","855","1790","0","47.77","16.93"
"68","000","00","001","0105","0191","792","280","512","29","821","1693","0","48.49","16.54"
"68","000","00","001","0106","0000","4158","1466","2692","126","4284","9063","0","47.27","16.18"
"68","000","00","001","0106","0204","873","311","562","26","899","1796","0","50.06","17.32"
"68","000","00","001","0106","0205","896","339","557","15","911","1878","0","48.51","18.05"
"68","000","00","001","0106","0206","816","272","544","38","854","1729","0","49.39","15.73"
"68","000","00","001","0106","0207","817","281","536","24","841","1843","0","45.63","15.25"
"68","000","00","001","0106","0208","756","263","493","23","779","1817","0","42.87","14.47"
"68","000","00","001","0107","0000","545","213","332","39","584","1028","0","56.81","20.72"
"68","000","00","001","0107","0044","545","213","332","39","584","1028","0","56.81","20.72"
"68","000","00","001","0108","0000","696","281","415","42","738","1452","0","50.83","19.35"
"68","000","00","001","0108","0036","696","281","415","42","738","1452","0","50.83","19.35"
"68","000","00","001","0109","0000","816","299","517","58","874","1681","0","51.99","17.79"
"68","000","00","001","0109","0037","816","299","517","58","874","1681","0","51.99","17.79"
"68","000","00","001","0110","0000","2472","834","1638","122","2594","5078","0","51.08","16.42"
"68","000","00","001","0110","0187","796","302","494","37","833","1764","0","47.22","17.12"
"68","000","00","001","0110","0188","966","282","684","65","1031","1899","0","54.29","14.85"
"68","000","00","001","0110","0189","710","250","460","20","730","1415","0","51.59","17.67"
"68","000","00","001","0111","0000","2233","814","1419","138","2371","4509","0","52.58","18.05"
"68","000","00","001","0111","0113","626","252","374","50","676","1308","0","51.68","19.27"
"68","000","00","001","0111","0114","774","260","514","41","815","1583","0","51.48","16.42"
"68","000","00","001","0111","0115","833","302","531","47","880","1618","0","54.39","18.67"
"68","000","00","001","0112","0000","2118","755","1363","104","2222","4668","0","47.6","16.17"
"68","000","00","001","0112","0131","763","285","478","45","808","1689","0","47.84","16.87"
"68","000","00","001","0112","0132","670","239","431","22","692","1542","0","44.88","15.5"
"68","000","00","001","0112","0133","685","231","454","37","722","1437","0","50.24","16.08"
"68","000","00","001","0113","0000","1468","559","909","61","1529","2928","0","52.22","19.09"
"68","000","00","001","0113","0193","663","250","413","19","682","1434","0","47.56","17.43"
"68","000","00","001","0113","0194","805","309","496","42","847","1494","0","56.69","20.68"
"68","000","00","001","0114","0000","901","311","590","43","944","1916","0","49.27","16.23"
"68","000","00","001","0114","0192","901","311","590","43","944","1916","0","49.27","16.23"
"68","000","00","001","0115","0000","529","185","344","24","553","979","0","56.49","18.9"
"68","000","00","001","0115","0209","529","185","344","24","553","979","0","56.49","18.9"
"68","000","00","001","0116","0000","1659","584","1075","83","1742","3565","0","48.86","16.38"
"68","000","00","001","0116","0134","829","281","548","35","864","1679","0","51.46","16.74"
"68","000","00","001","0116","0135","830","303","527","48","878","1886","0","46.55","16.07"
"68","000","00","001","0117","0000","1236","403","833","77","1313","2210","0","59.41","18.24"
"68","000","00","001","0117","0105","659","193","466","33","692","1149","0","60.23","16.8"
"68","000","00","001","0117","0106","577","210","367","44","621","1061","0","58.53","19.79"
"68","000","00","001","0118","0000","1499","510","989","78","1577","3058","0","51.57","16.68"
"68","000","00","001","0118","0127","941","311","630","49","990","1995","0","49.62","15.59"
"68","000","00","001","0118","0128","558","199","359","29","587","1063","0","55.22","18.72"
"68","000","00","001","0119","0000","720","235","485","42","762","1587","0","48.02","14.81"
"68","000","00","001","0119","0041","720","235","485","42","762","1587","0","48.02","14.81"
"68","000","00","001","0120","0000","737","274","463","58","795","1375","0","57.82","19.93"
"68","000","00","001","0120","0028","737","274","463","58","795","1375","0","57.82","19.93"
"68","000","00","001","0121","0000","493","197","296","26","519","852","0","60.92","23.12"
"68","000","00","001","0121","0033","493","197","296","26","519","852","0","60.92","23.12"
"68","000","00","001","0122","0000","4567","1607","2960","189","4756","9234","0","51.51","17.4"
"68","000","00","001","0122","0155","878","325","553","31","909","1807","0","50.3","17.99"
"68","000","00","001","0122","0156","910","332","578","38","948","1857","0","51.05","17.88"
"68","000","00","001","0122","0157","842","255","587","52","894","1589","0","56.26","16.05"
"68","000","00","001","0122","0158","1016","382","634","39","1055","2088","0","50.53","18.3"
"68","000","00","001","0122","0159","921","313","608","29","950","1893","0","50.18","16.53"
"68","000","00","001","0123","0000","3391","1246","2145","97","3488","6570","0","53.09","18.96"
"68","000","00","001","0123","0050","777","259","518","24","801","1489","0","53.79","17.39"
"68","000","00","001","0123","0051","997","389","608","18","1015","1821","0","55.74","21.36"
"68","000","00","001","0123","0052","736","262","474","22","758","1563","0","48.5","16.76"
"68","000","00","001","0123","0053","881","336","545","33","914","1697","0","53.86","19.8"
"68","000","00","001","0124","0000","2884","984","1900","154","3038","6075","0","50.01","16.2"
"68","000","00","001","0124","0151","690","244","446","42","732","1569","0","46.65","15.55"
"68","000","00","001","0124","0152","717","220","497","28","745","1505","0","49.5","14.62"
"68","000","00","001","0124","0153","707","252","455","51","758","1496","0","50.67","16.84"
"68","000","00","001","0124","0154","770","268","502","33","803","1505","0","53.36","17.81"
"68","000","00","001","0125","0000","752","263","489","49","801","1451","0","55.2","18.13"
"68","000","00","001","0125","0042","752","263","489","49","801","1451","0","55.2","18.13"
"68","000","00","001","0126","0000","2864","1076","1788","131","2995","5866","0","51.06","18.34"
"68","000","00","001","0126","0045","930","309","621","36","966","1934","0","49.95","15.98"
"68","000","00","001","0126","0046","499","180","319","52","551","1016","0","54.23","17.72"
"68","000","00","001","0126","0047","557","217","340","27","584","1079","0","54.12","20.11"
"68","000","00","001","0126","0048","878","370","508","16","894","1837","0","48.67","20.14"
"68","000","00","001","0127","0000","729","246","483","47","776","1390","0","55.83","17.7"
"68","000","00","001","0127","0049","729","246","483","47","776","1390","0","55.83","17.7"
"68","000","00","001","0128","0000","2450","924","1526","159","2609","4944","0","52.77","18.69"
"68","000","00","001","0128","0081","787","347","440","49","836","1449","0","57.69","23.95"
"68","000","00","001","0128","0082","807","286","521","67","874","1803","0","48.47","15.86"
"68","000","00","001","0128","0083","856","291","565","43","899","1692","0","53.13","17.2"
"68","000","00","001","0129","0000","2321","781","1540","105","2426","4421","0","54.87","17.67"
"68","000","00","001","0129","0060","636","204","432","29","665","1115","0","59.64","18.3"
"68","000","00","001","0129","0061","821","303","518","41","862","1562","0","55.19","19.4"
"68","000","00","001","0129","0062","864","274","590","35","899","1744","0","51.55","15.71"
"68","000","00","001","0130","0000","2620","945","1675","119","2739","5152","0","53.16","18.34"
"68","000","00","001","0130","0057","907","345","562","33","940","1766","0","53.23","19.54"
"68","000","00","001","0130","0058","790","267","523","47","837","1555","0","53.83","17.17"
"68","000","00","001","0130","0059","923","333","590","39","962","1831","0","52.54","18.19"
"68","000","00","001","0131","0000","634","239","395","24","658","1698","0","38.75","14.08"
"68","000","00","001","0131","0035","634","239","395","24","658","1698","0","38.75","14.08"
"68","000","00","001","0132","0000","3106","1152","1954","139","3245","5981","0","54.26","19.26"
"68","000","00","001","0132","0013","734","280","454","43","777","1482","0","52.43","18.89"
"68","000","00","001","0132","0014","750","254","496","35","785","1423","0","55.17","17.85"
"68","000","00","001","0132","0015","802","320","482","33","835","1509","0","55.33","21.21"
"68","000","00","001","0132","0016","820","298","522","28","848","1567","0","54.12","19.02"
"68","000","00","001","0133","0000","2992","1023","1969","135","3127","5805","0","53.87","17.62"
"68","000","00","001","0133","0020","744","267","477","45","789","1399","0","56.4","19.09"
"68","000","00","001","0133","0021","823","288","535","40","863","1540","0","56.04","18.7"
"68","000","00","001","0133","0022","784","249","535","24","808","1638","0","49.33","15.2"
"68","000","00","001","0133","0023","641","219","422","26","667","1228","0","54.32","17.83"
"68","000","00","001","0134","0000","2447","1224","1223","145","2592","4781","0","54.21","25.6"
"68","000","00","001","0134","0038","802","603","199","53","855","1669","0","51.23","36.13"
"68","000","00","001","0134","0039","826","277","549","48","874","1530","0","57.12","18.1"
"68","000","00","001","0134","0040","819","344","475","44","863","1582","0","54.55","21.74"
"68","000","00","001","0135","0000","1594","548","1046","120","1714","3529","0","48.57","15.53"
"68","000","00","001","0135","0086","549","210","339","38","587","1173","0","50.04","17.9"
"68","000","00","001","0135","0087","557","196","361","18","575","1162","0","49.48","16.87"
"68","000","00","001","0135","0088","488","142","346","64","552","1194","0","46.23","11.89"
"68","000","00","001","0136","0000","2653","937","1716","110","2763","5705","0","48.43","16.42"
"68","000","00","001","0136","0092","844","268","576","57","901","1780","0","50.62","15.06"
"68","000","00","001","0136","0093","849","322","527","27","876","1904","0","46.01","16.91"
"68","000","00","001","0136","0094","960","347","613","26","986","2021","0","48.79","17.17"
"68","000","00","001","0137","0000","1889","722","1167","55","1944","3870","0","50.23","18.66"
"68","000","00","001","0137","0185","950","356","594","26","976","1925","0","50.7","18.49"
"68","000","00","001","0137","0186","939","366","573","29","968","1945","0","49.77","18.82"
"68","000","00","001","0138","0000","2201","813","1388","125","2326","4271","0","54.46","19.04"
"68","000","00","001","0138","0195","666","230","436","56","722","1311","0","55.07","17.54"
"68","000","00","001","0138","0196","735","258","477","38","773","1476","0","52.37","17.48"
"68","000","00","001","0138","0197","800","325","475","31","831","1484","0","56.0","21.9"
"68","000","00","001","0139","0000","999","379","620","65","1064","1970","0","54.01","19.24"
"68","000","00","001","0139","0202","541","207","334","34","575","1015","0","56.65","20.39"
"68","000","00","001","0139","0203","458","172","286","31","489","955","0","51.2","18.01"
"68","000","00","001","0140","0000","2631","893","1738","131","2762","5333","0","51.79","16.74"
"68","000","00","001","0140","0029","902","291","611","42","944","1743","0","54.16","16.7"
"68","000","00","001","0140","0030","864","301","563","51","915","1862","0","49.14","16.17"
"68","000","00","001","0140","0031","865","301","564","38","903","1728","0","52.26","17.42"
"68","000","00","001","0141","0000","3054","1068","1986","229","3283","6230","0","52.7","17.14"
"68","000","00","001","0141","0024","769","260","509","59","828","1649","0","50.21","15.77"
"68","000","00","001","0141","0025","800","267","533","38","838","1601","0","52.34","16.68"
"68","000","00","001","0141","0026","702","277","425","101","803","1477","0","54.37","18.75"
"68","000","00","001","0141","0027","783","264","519","31","814","1503","0","54.16","17.56"
"68","000","00","001","0142","0000","2433","1096","1337","138","2571","5170","0","49.73","21.2"
"68","000","00","001","0142","0010","747","272","475","42","789","1590","0","49.62","17.11"
"68","000","00","001","0142","0011","791","302","489","44","835","1637","0","51.01","18.45"
"68","000","00","001","0142","0012","895","522","373","52","947","1943","0","48.74","26.87"
"68","000","00","001","0143","0000","2392","889","1503","126","2518","5024","0","50.12","17.7"
"68","000","00","001","0143","0007","848","329","519","32","880","1800","0","48.89","18.28"
"68","000","00","001","0143","0008","829","308","521","45","874","1598","0","54.69","19.27"
"68","000","00","001","0143","0009","715","252","463","49","764","1626","0","46.99","15.5"
"68","000","00","001","0144","0000","2111","786","1325","97","2208","4160","0","53.08","18.89"
"68","000","00","001","0144","0017","674","239","435","36","710","1305","0","54.41","18.31"
"68","000","00","001","0144","0018","658","249","409","30","688","1416","0","48.59","17.58"
"68","000","00","001","0144","0019","779","298","481","31","810","1439","0","56.29","20.71"
"68","000","00","001","0145","0000","2313","867","1446","71","2384","4197","0","56.8","20.66"
"68","000","00","001","0145","0173","833","287","546","25","858","1432","0","59.92","20.04"
"68","000","00","001","0145","0174","786","316","470","35","821","1421","0","57.78","22.24"
"68","000","00","001","0145","0175","694","264","430","11","705","1344","0","52.46","19.64"
"68","000","00","001","0146","0000","2417","830","1587","134","2551","5384","0","47.38","15.42"
"68","000","00","001","0146","0182","774","260","514","40","814","1860","0","43.76","13.98"
"68","000","00","001","0146","0183","816","291","525","54","870","1726","0","50.41","16.86"
"68","000","00","001","0146","0184","827","279","548","40","867","1798","0","48.22","15.52"
"68","000","00","001","0147","0000","2893","1028","1865","135","3028","6097","0","49.66","16.86"
"68","000","00","001","0147","0198","740","288","452","38","778","1514","0","51.39","19.02"
"68","000","00","001","0147","0199","714","248","466","43","757","1446","0","52.35","17.15"
"68","000","00","001","0147","0200","741","259","482","24","765","1573","0","48.63","16.47"
"68","000","00","001","0147","0201","698","233","465","30","728","1564","0","46.55","14.9"
"68","000","00","001","0148","0000","3244","1157","2087","166","3410","6901","0","49.41","16.77"
"68","000","00","001","0148","0139","890","313","577","48","938","1846","0","50.81","16.96"
"68","000","00","001","0148","0140","741","266","475","38","779","1644","0","47.38","16.18"
"68","000","00","001","0148","0141","773","296","477","33","806","1674","0","48.15","17.68"
"68","000","00","001","0148","0142","840","282","558","47","887","1737","0","51.07","16.23"
"68","000","00","001","0149","0000","2789","1012","1777","79","2868","5873","0","48.83","17.23"
"68","000","00","001","0149","0107","851","307","544","23","874","1831","0","47.73","16.77"
"68","000","00","001","0149","0108","1032","368","664","39","1071","2168","0","49.4","16.97"
"68","000","00","001","0149","0109","906","337","569","17","923","1874","0","49.25","17.98"
"68","000","00","001","0150","0000","3996","1332","2664","141","4137","8384","0","49.34","15.89"
"68","000","00","001","0150","0116","995","360","635","49","1044","2127","0","49.08","16.93"
"68","000","00","001","0150","0117","967","334","633","17","984","2033","0","48.4","16.43"
"68","000","00","001","0150","0118","1039","353","686","18","1057","2098","0","50.38","16.83"
"68","000","00","001","0150","0119","995","285","710","57","1052","2126","0","49.48","13.41"
"68","000","00","001","0151","0000","4141","1529","2612","142","4283","8396","0","51.01","18.21"
"68","000","00","001","0151","0146","847","334","513","31","878","1774","0","49.49","18.83"
"68","000","00","001","0151","0147","832","295","537","35","867","1666","0","52.04","17.71"
"68","000","00","001","0151","0148","783","281","502","16","799","1528","0","52.29","18.39"
"68","000","00","001","0151","0149","831","294","537","41","872","1709","0","51.02","17.2"
"68","000","00","001","0151","0150","848","325","523","19","867","1719","0","50.44","18.91"
"68","000","00","001","0152","0000","1440","514","926","76","1516","2598","0","58.35","19.78"
"68","000","00","001","0152","0079","746","272","474","45","791","1404","0","56.34","19.37"
"68","000","00","001","0152","0080","694","242","452","31","725","1194","0","60.72","20.27"
"68","000","00","001","0153","0000","1871","707","1164","76","1947","3728","0","52.23","18.96"
"68","000","00","001","0153","0084","958","365","593","40","998","1913","0","52.17","19.08"
"68","000","00","001","0153","0085","913","342","571","36","949","1815","0","52.29","18.84"
"68","000","00","001","0154","0000","1844","665","1179","82","1926","3914","0","49.21","16.99"
"68","000","00","001","0154","0074","909","345","564","39","948","1949","0","48.64","17.7"
"68","000","00","001","0154","0075","935","320","615","43","978","1965","0","49.77","16.28"
"68","000","00","001","0155","0000","3035","995","2040","156","3191","6512","0","49.0","15.28"
"68","000","00","001","0155","0076","1029","330","699","52","1081","2414","0","44.78","13.67"
"68","000","00","001","0155","0077","943","319","624","51","994","1942","0","51.18","16.43"
"68","000","00","001","0155","0078","1063","346","717","53","1116","2156","0","51.76","16.05"
"68","000","00","001","0156","0000","2344","749","1595","99","2443","4845","0","50.42","15.46"
"68","000","00","001","0156","0095","753","219","534","46","799","1545","0","51.72","14.17"
"68","000","00","001","0156","0096","771","254","517","23","794","1617","0","49.1","15.71"
"68","000","00","001","0156","0097","820","276","544","30","850","1683","0","50.51","16.4"
"68","000","00","001","0157","0000","2734","994","1740","68","2802","5884","0","47.62","16.89"
"68","000","00","001","0157","0176","878","316","562","22","900","1942","0","46.34","16.27"
"68","000","00","001","0157","0177","979","346","633","29","1008","2001","0","50.37","17.29"
"68","000","00","001","0157","0178","877","332","545","17","894","1941","0","46.06","17.1"
"68","000","00","001","0158","0000","3669","1267","2402","148","3817","8196","0","46.57","15.46"
"68","000","00","001","0158","0213","1022","366","656","50","1072","2164","0","49.54","16.91"
"68","000","00","001","0158","0214","948","329","619","38","986","2020","0","48.81","16.29"
"68","000","00","001","0158","0215","835","292","543","26","861","1924","0","44.75","15.18"
"68","000","00","001","0158","0216","864","280","584","34","898","2088","0","43.01","13.41"
"68","000","00","001","0159","0000","3419","1189","2230","132","3551","9237","0","38.44","12.87"
"68","000","00","001","0159","0101","884","305","579","32","916","1873","0","48.91","16.28"
"68","000","00","001","0159","0102","726","255","471","33","759","3687","0","20.59","6.92"
"68","000","00","001","0159","0103","925","334","591","24","949","1850","0","51.3","18.05"
"68","000","00","001","0159","0104","884","295","589","43","927","1827","0","50.74","16.15"
"68","000","00","001","0160","0000","2508","899","1609","99","2607","5084","0","51.28","17.68"
"68","000","00","001","0160","0089","834","324","510","49","883","1695","0","52.09","19.12"
"68","000","00","001","0160","0090","877","316","561","29","906","1797","0","50.42","17.58"
"68","000","00","001","0160","0091","797","259","538","21","818","1592","0","51.38","16.27"
"68","000","00","001","0161","0000","3583","1296","2287","135","3718","7274","0","51.11","17.82"
"68","000","00","001","0161","0123","821","295","526","38","859","1691","0","50.8","17.45"
"68","000","00","001","0161","0124","936","345","591","20","956","1900","0","50.32","18.16"
"68","000","00","001","0161","0125","880","300","580","54","934","1761","0","53.04","17.04"
"68","000","00","001","0161","0126","946","356","590","23","969","1922","0","50.42","18.52"
"68","000","00","001","0162","0000","2668","964","1704","152","2820","5712","0","49.37","16.88"
"68","000","00","001","0162","0063","826","299","527","38","864","1838","0","47.01","16.27"
"68","000","00","001","0162","0064","957","362","595","57","1014","1889","0","53.68","19.16"
"68","000","00","001","0162","0065","885","303","582","57","942","1985","0","47.46","15.26"
"68","000","00","001","0163","0000","2429","908","1521","124","2553","4811","0","53.07","18.87"
"68","000","00","001","0163","0136","818","307","511","69","887","1657","0","53.53","18.53"
"68","000","00","001","0163","0137","700","266","434","23","723","1349","0","53.6","19.72"
"68","000","00","001","0163","0138","911","335","576","32","943","1805","0","52.24","18.56"
"68","000","00","001","0164","0000","2410","863","1547","76","2486","4605","0","53.98","18.74"
"68","000","00","001","0164","0054","904","327","577","33","937","1740","0","53.85","18.79"
"68","000","00","001","0164","0055","827","287","540","30","857","1626","0","52.71","17.65"
"68","000","00","001","0164","0056","679","249","430","13","692","1239","0","55.85","20.1"
"68","000","00","001","0165","0000","2568","903","1665","100","2668","4555","0","58.57","19.82"
"68","000","00","001","0165","0066","835","296","539","40","875","1524","0","57.41","19.42"
"68","000","00","001","0165","0067","846","282","564","28","874","1425","0","61.33","19.79"
"68","000","00","001","0165","0068","887","325","562","32","919","1606","0","57.22","20.24"
"68","000","00","001","0166","0000","2202","747","1455","54","2256","4066","0","55.48","18.37"
"68","000","00","001","0166","0069","1124","362","762","23","1147","2056","0","55.79","17.61"
"68","000","00","001","0166","0070","1078","385","693","31","1109","2010","0","55.17","19.15"
"68","000","00","001","0167","0000","2291","826","1465","106","2397","4702","0","50.98","17.57"
"68","000","00","001","0167","0143","797","265","532","42","839","1566","0","53.58","16.92"
"68","000","00","001","0167","0144","781","287","494","30","811","1517","0","53.46","18.92"
"68","000","00","001","0167","0145","713","274","439","34","747","1619","0","46.14","16.92"
"68","000","00","001","0168","0000","2957","1126","1831","61","3018","5893","0","51.21","19.11"
"68","000","00","001","0168","0168","1210","450","760","27","1237","2204","0","56.13","20.42"
"68","000","00","001","0168","0169","914","414","500","20","934","2033","0","45.94","20.36"
"68","000","00","001","0168","0170","833","262","571","14","847","1656","0","51.15","15.82"
"68","000","00","001","0169","0000","2246","852","1394","71","2317","4541","0","51.02","18.76"
"68","000","00","001","0169","0110","687","253","434","18","705","1524","0","46.26","16.6"
"68","000","00","001","0169","0111","783","288","495","22","805","1528","0","52.68","18.85"
"68","000","00","001","0169","0112","776","311","465","31","807","1489","0","54.2","20.89"
"68","000","00","001","0170","0000","2770","1008","1762","107","2877","5371","0","53.57","18.77"
"68","000","00","001","0170","0071","1056","364","692","51","1107","2245","0","49.31","16.21"
"68","000","00","001","0170","0072","822","330","492","34","856","1590","0","53.84","20.75"
"68","000","00","001","0170","0073","892","314","578","22","914","1536","0","59.51","20.44"
"68","000","00","001","0171","0000","2747","982","1765","115","2862","5717","0","50.06","17.18"
"68","000","00","001","0171","0098","947","332","615","54","1001","1834","0","54.58","18.1"
"68","000","00","001","0171","0099","938","349","589","36","974","2055","0","47.4","16.98"
"68","000","00","001","0171","0100","862","301","561","25","887","1828","0","48.52","16.47"
"68","000","00","001","0172","0000","2857","1005","1852","92","2949","5843","0","50.47","17.2"
"68","000","00","001","0172","0120","905","305","600","33","938","1917","0","48.93","15.91"
"68","000","00","001","0172","0121","951","348","603","32","983","1997","0","49.22","17.43"
"68","000","00","001","0172","0122","1001","352","649","27","1028","1929","0","53.29","18.25"
"68","000","00","001","0173","0000","1629","611","1018","51","1680","3158","0","53.2","19.35"
"68","000","00","001","0173","0129","712","263","449","25","737","1412","0","52.2","18.63"
"68","000","00","001","0173","0130","917","348","569","26","943","1746","0","54.01","19.93"
"68","000","00","001","0174","0000","3728","1342","2386","121","3849","7902","0","48.71","16.98"
"68","000","00","001","0174","0164","992","331","661","29","1021","2103","0","48.55","15.74"
"68","000","00","001","0174","0165","935","331","604","28","963","1943","0","49.56","17.04"
"68","000","00","001","0174","0166","954","363","591","30","984","1927","0","51.06","18.84"
"68","000","00","001","0174","0167","847","317","530","34","881","1929","0","45.67","16.43"
"68","000","00","001","0175","0000","2726","966","1760","105","2831","5729","0","49.42","16.86"
"68","000","00","001","0175","0160","568","181","387","24","592","1303","0","45.43","13.89"
"68","000","00","001","0175","0161","725","274","451","33","758","1416","0","53.53","19.35"
"68","000","00","001","0175","0162","641","211","430","23","664","1351","0","49.15","15.62"
"68","000","00","001","0175","0163","792","300","492","25","817","1659","0","49.25","18.08"
"68","000","00","001","0176","0000","1673","648","1025","74","1747","3450","0","50.64","18.78"
"68","000","00","001","0176","0171","829","317","512","44","873","1712","0","50.99","18.52"
"68","000","00","001","0176","0172","844","331","513","30","874","1738","0","50.29","19.04"
"68","000","00","001","0177","0000","1733","611","1122","94","1827","3856","0","47.38","15.85"
"68","000","00","001","0177","0005","920","340","580","39","959","1974","0","48.58","17.22"
"68","000","00","001","0177","0006","813","271","542","55","868","1882","0","46.12","14.4"
"68","000","00","001","0178","0000","2435","855","1580","94","2529","4835","0","52.31","17.68"
"68","000","00","001","0178","0179","876","292","584","37","913","1702","0","53.64","17.16"
"68","000","00","001","0178","0180","791","296","495","29","820","1589","0","51.6","18.63"
"68","000","00","001","0178","0181","768","267","501","28","796","1544","0","51.55","17.29"
"68","000","00","001","0179","0000","2120","829","1291","57","2177","4217","0","51.62","19.66"
"68","000","00","001","0179","0210","703","300","403","21","724","1363","0","53.12","22.01"
"68","000","00","001","0179","0211","778","281","497","13","791","1546","0","51.16","18.18"
"68","000","00","001","0179","0212","639","248","391","23","662","1308","0","50.61","18.96"
"68","000","00","002","0000","0000","168905","55628","113277","7506","176411","334402","411135","52.75","16.64"
"68","000","00","002","0201","0000","1364","378","986","92","1456","2916","0","49.93","12.96"
"68","000","00","002","0201","0617","625","159","466","27","652","1329","0","49.06","11.96"
"68","000","00","002","0201","0618","739","219","520","65","804","1587","0","50.66","13.8"
"68","000","00","002","0202","0000","2780","841","1939","114","2894","5418","0","53.41","15.52"
"68","000","00","002","0202","0614","995","306","689","42","1037","1818","0","57.04","16.83"
"68","000","00","002","0202","0615","956","295","661","38","994","1991","0","49.92","14.82"
"68","000","00","002","0202","0616","829","240","589","34","863","1609","0","53.64","14.92"
"68","000","00","002","0203","0000","1556","444","1112","85","1641","3033","0","54.1","14.64"
"68","000","00","002","0203","0654","820","254","566","34","854","1588","0","53.78","15.99"
"68","000","00","002","0203","0655","736","190","546","51","787","1445","0","54.46","13.15"
"68","000","00","002","0204","0000","477","164","313","29","506","943","0","53.66","17.39"
"68","000","00","002","0204","0763","477","164","313","29","506","943","0","53.66","17.39"
"68","000","00","002","0205","0000","1098","330","768","60","1158","2152","0","53.81","15.33"
"68","000","00","002","0205","0689","538","151","387","21","559","1087","0","51.43","13.89"
"68","000","00","002","0205","0690","560","179","381","39","599","1065","0","56.24","16.81"
"68","000","00","002","0206","0000","2110","694","1416","118","2228","4283","0","52.02","16.2"
"68","000","00","002","0206","0691","934","300","634","57","991","1844","0","53.74","16.27"
"68","000","00","002","0206","0692","549","167","382","31","580","1220","0","47.54","13.69"
"68","000","00","002","0206","0693","627","227","400","30","657","1219","0","53.9","18.62"
"68","000","00","002","0207","0000","2565","864","1701","109","2674","5415","0","49.38","15.96"
"68","000","00","002","0207","0771","977","316","661","50","1027","2156","0","47.63","14.66"
"68","000","00","002","0207","0772","681","223","458","27","708","1479","0","47.87","15.08"
"68","000","00","002","0207","0773","907","325","582","32","939","1780","0","52.75","18.26"
"68","000","00","002","0208","0000","2448","670","1778","144","2592","5136","0","50.47","13.05"
"68","000","00","002","0208","0679","778","233","545","41","819","1659","0","49.37","14.04"
"68","000","00","002","0208","0680","905","246","659","67","972","1874","0","51.87","13.13"
"68","000","00","002","0208","0681","765","191","574","36","801","1603","0","49.97","11.92"
"68","000","00","002","0209","0000","1779","606","1173","74","1853","3474","0","53.34","17.44"
"68","000","00","002","0209","0675","817","271","546","48","865","1659","0","52.14","16.34"
"68","000","00","002","0209","0676","962","335","627","26","988","1815","0","54.44","18.46"
"68","000","00","002","0210","0000","1894","597","1297","90","1984","3758","0","52.79","15.89"
"68","000","00","002","0210","0662","735","221","514","41","776","1489","0","52.12","14.84"
"68","000","00","002","0210","0663","438","156","282","23","461","827","0","55.74","18.86"
"68","000","00","002","0210","0664","721","220","501","26","747","1442","0","51.8","15.26"
"68","000","00","002","0211","0000","2260","664","1596","107","2367","4303","0","55.01","15.43"
"68","000","00","002","0211","0602","725","215","510","36","761","1281","0","59.41","16.78"
"68","000","00","002","0211","0603","810","249","561","23","833","1462","0","56.98","17.03"
"68","000","00","002","0211","0604","725","200","525","48","773","1560","0","49.55","12.82"
"68","000","00","002","0212","0000","2635","798","1837","130","2765","5378","0","51.41","14.84"
"68","000","00","002","0212","0619","967","289","678","30","997","1955","0","51.0","14.78"
"68","000","00","002","0212","0620","838","260","578","51","889","1711","0","51.96","15.2"
"68","000","00","002","0212","0621","830","249","581","49","879","1712","0","51.34","14.54"
"68","000","00","002","0213","0000","1762","614","1148","54","1816","3009","0","60.35","20.41"
"68","000","00","002","0213","0652","929","330","599","26","955","1625","0","58.77","20.31"
"68","000","00","002","0213","0653","833","284","549","28","861","1384","0","62.21","20.52"
"68","000","00","002","0214","0000","1086","415","671","51","1137","2061","0","55.17","20.14"
"68","000","00","002","0214","0754","439","154","285","28","467","852","0","54.81","18.08"
"68","000","00","002","0214","0755","647","261","386","23","670","1209","0","55.42","21.59"
"68","000","00","002","0215","0000","1986","707","1279","84","2070","3498","0","59.18","20.21"
"68","000","00","002","0215","0721","798","273","525","34","832","1384","0","60.12","19.73"
"68","000","00","002","0215","0722","622","222","400","12","634","1122","0","56.51","19.79"
"68","000","00","002","0215","0723","566","212","354","38","604","992","0","60.89","21.37"
"68","000","00","002","0216","0000","2122","717","1405","75","2197","4141","0","53.05","17.31"
"68","000","00","002","0216","0627","646","208","438","25","671","1201","0","55.87","17.32"
"68","000","00","002","0216","0628","702","257","445","25","727","1353","0","53.73","18.99"
"68","000","00","002","0216","0629","774","252","522","25","799","1587","0","50.35","15.88"
"68","000","00","002","0217","0000","1776","656","1120","67","1843","5573","0","33.07","11.77"
"68","000","00","002","0217","0642","691","250","441","23","714","3474","0","20.55","7.2"
"68","000","00","002","0217","0643","1085","406","679","44","1129","2099","0","53.79","19.34"
"68","000","00","002","0218","0000","1642","567","1075","56","1698","3540","0","47.97","16.02"
"68","000","00","002","0218","0648","937","311","626","38","975","1900","0","51.32","16.37"
"68","000","00","002","0218","0649","705","256","449","18","723","1640","0","44.09","15.61"
"68","000","00","002","0219","0000","2411","1039","1372","85","2496","4845","0","51.52","21.44"
"68","000","00","002","0219","0667","786","531","255","39","825","1764","0","46.77","30.1"
"68","000","00","002","0219","0668","807","250","557","16","823","1488","0","55.31","16.8"
"68","000","00","002","0219","0669","818","258","560","30","848","1593","0","53.23","16.2"
"68","000","00","002","0220","0000","1570","523","1047","48","1618","3362","0","48.13","15.56"
"68","000","00","002","0220","0665","852","286","566","19","871","1842","0","47.29","15.53"
"68","000","00","002","0220","0666","718","237","481","29","747","1520","0","49.14","15.59"
"68","000","00","002","0221","0000","1673","593","1080","76","1749","3334","0","52.46","17.79"
"68","000","00","002","0221","0732","939","339","600","40","979","1951","0","50.18","17.38"
"68","000","00","002","0221","0733","734","254","480","36","770","1383","0","55.68","18.37"
"68","000","00","002","0222","0000","2360","906","1454","109","2469","4872","0","50.68","18.6"
"68","000","00","002","0222","0787","525","195","330","37","562","1097","0","51.23","17.78"
"68","000","00","002","0222","0788","907","351","556","24","931","1917","0","48.57","18.31"
"68","000","00","002","0222","0789","928","360","568","48","976","1858","0","52.53","19.38"
"68","000","00","002","0223","0000","1266","409","857","51","1317","2506","0","52.55","16.32"
"68","000","00","002","0223","0673","591","192","399","26","617","1249","0","49.4","15.37"
"68","000","00","002","0223","0674","675","217","458","25","700","1257","0","55.69","17.26"
"68","000","00","002","0224","0000","1965","793","1172","118","2083","3776","0","55.16","21.0"
"68","000","00","002","0224","0768","528","184","344","32","560","1028","0","54.47","17.9"
"68","000","00","002","0224","0769","631","314","317","43","674","1157","0","58.25","27.14"
"68","000","00","002","0224","0770","806","295","511","43","849","1591","0","53.36","18.54"
"68","000","00","002","0225","0000","1808","615","1193","79","1887","3667","0","51.46","16.77"
"68","000","00","002","0225","0724","912","322","590","33","945","1820","0","51.92","17.69"
"68","000","00","002","0225","0725","896","293","603","46","942","1847","0","51.0","15.86"
"68","000","00","002","0226","0000","1877","665","1212","107","1984","3712","0","53.45","17.91"
"68","000","00","002","0226","0696","877","329","548","66","943","1733","0","54.41","18.98"
"68","000","00","002","0226","0697","1000","336","664","41","1041","1979","0","52.6","16.98"
"68","000","00","002","0227","0000","3439","1110","2329","151","3590","6638","0","54.08","16.72"
"68","000","00","002","0227","0716","892","272","620","38","930","1798","0","51.72","15.13"
"68","000","00","002","0227","0717","993","294","699","49","1042","1822","0","57.19","16.14"
"68","000","00","002","0227","0718","832","263","569","28","860","1613","0","53.32","16.31"
"68","000","00","002","0227","0719","722","281","441","36","758","1405","0","53.95","20.0"
"68","000","00","002","0228","0000","417","149","268","25","442","731","0","60.47","20.38"
"68","000","00","002","0228","0764","417","149","268","25","442","731","0","60.47","20.38"
"68","000","00","002","0229","0000","2417","678","1739","168","2585","4672","0","55.33","14.51"
"68","000","00","002","0229","0608","809","216","593","77","886","1627","0","54.46","13.28"
"68","000","00","002","0229","0609","823","252","571","36","859","1519","0","56.55","16.59"
"68","000","00","002","0229","0610","785","210","575","55","840","1526","0","55.05","13.76"
"68","000","00","002","0230","0000","1400","431","969","75","1475","2836","0","52.01","15.2"
"68","000","00","002","0230","0658","750","236","514","38","788","1546","0","50.97","15.27"
"68","000","00","002","0230","0659","650","195","455","37","687","1290","0","53.26","15.12"
"68","000","00","002","0231","0000","1835","593","1242","106","1941","3544","0","54.77","16.73"
"68","000","00","002","0231","0737","922","310","612","63","985","1703","0","57.84","18.2"
"68","000","00","002","0231","0738","913","283","630","43","956","1841","0","51.93","15.37"
"68","000","00","002","0232","0000","1765","609","1156","47","1812","3507","0","51.67","17.37"
"68","000","00","002","0232","0752","967","351","616","27","994","1987","0","50.03","17.66"
"68","000","00","002","0232","0753","798","258","540","20","818","1520","0","53.82","16.97"
"68","000","00","002","0233","0000","4189","1273","2916","148","4337","8947","0","48.47","14.23"
"68","000","00","002","0233","0701","904","258","646","35","939","1943","0","48.33","13.28"
"68","000","00","002","0233","0702","697","223","474","17","714","1363","0","52.38","16.36"
"68","000","00","002","0233","0703","936","321","615","41","977","2172","0","44.98","14.78"
"68","000","00","002","0233","0704","842","241","601","37","879","1798","0","48.89","13.4"
"68","000","00","002","0233","0705","810","230","580","18","828","1671","0","49.55","13.76"
"68","000","00","002","0234","0000","4149","1413","2736","198","4347","8663","0","50.18","16.31"
"68","000","00","002","0234","0709","681","245","436","34","715","1923","0","37.18","12.74"
"68","000","00","002","0234","0710","849","290","559","52","901","1572","0","57.32","18.45"
"68","000","00","002","0234","0711","987","304","683","27","1014","1850","0","54.81","16.43"
"68","000","00","002","0234","0712","778","268","510","44","822","1583","0","51.93","16.93"
"68","000","00","002","0234","0713","854","306","548","41","895","1735","0","51.59","17.64"
"68","000","00","002","0235","0000","1005","341","664","51","1056","1957","0","53.96","17.42"
"68","000","00","002","0235","0758","1005","341","664","51","1056","1957","0","53.96","17.42"
"68","000","00","002","0236","0000","3764","1239","2525","141","3905","7473","0","52.25","16.58"
"68","000","00","002","0236","0741","908","284","624","23","931","1636","0","56.91","17.36"
"68","000","00","002","0236","0742","840","244","596","34","874","1528","0","57.2","15.97"
"68","000","00","002","0236","0743","1046","354","692","57","1103","2289","0","48.19","15.47"
"68","000","00","002","0236","0744","970","357","613","27","997","2020","0","49.36","17.67"
"68","000","00","002","0237","0000","2359","777","1582","91","2450","4365","0","56.13","17.8"
"68","000","00","002","0237","0636","695","237","458","25","720","1368","0","52.63","17.32"
"68","000","00","002","0237","0637","813","246","567","38","851","1424","0","59.76","17.28"
"68","000","00","002","0237","0638","851","294","557","28","879","1573","0","55.88","18.69"
"68","000","00","002","0238","0000","922","319","603","62","984","1730","0","56.88","18.44"
"68","000","00","002","0238","0720","922","319","603","62","984","1730","0","56.88","18.44"
"68","000","00","002","0239","0000","2516","675","1841","186","2702","4878","0","55.39","13.84"
"68","000","00","002","0239","0611","807","207","600","66","873","1618","0","53.96","12.79"
"68","000","00","002","0239","0612","850","245","605","56","906","1554","0","58.3","15.77"
"68","000","00","002","0239","0613","859","223","636","64","923","1706","0","54.1","13.07"
"68","000","00","002","0240","0000","523","205","318","32","555","1011","0","54.9","20.28"
"68","000","00","002","0240","0766","523","205","318","32","555","1011","0","54.9","20.28"
"68","000","00","002","0241","0000","1480","516","964","71","1551","3045","0","50.94","16.95"
"68","000","00","002","0241","0756","748","257","491","55","803","1481","0","54.22","17.35"
"68","000","00","002","0241","0757","732","259","473","16","748","1564","0","47.83","16.56"
"68","000","00","002","0242","0000","2309","797","1512","107","2416","4841","0","49.91","16.46"
"68","000","00","002","0242","0591","707","236","471","36","743","1401","0","53.03","16.85"
"68","000","00","002","0242","0592","858","296","562","42","900","1798","0","50.06","16.46"
"68","000","00","002","0242","0593","744","265","479","29","773","1642","0","47.08","16.14"
"68","000","00","002","0243","0000","2773","967","1806","145","2918","6378","0","45.75","15.16"
"68","000","00","002","0243","0798","975","310","665","63","1038","2068","0","50.19","14.99"
"68","000","00","002","0243","0799","853","292","561","38","891","2152","0","41.4","13.57"
"68","000","00","002","0243","0800","945","365","580","44","989","2158","0","45.83","16.91"
"68","000","00","002","0244","0000","3050","1028","2022","127","3177","6013","0","52.84","17.1"
"68","000","00","002","0244","0779","745","246","499","21","766","1426","0","53.72","17.25"
"68","000","00","002","0244","0780","744","255","489","42","786","1618","0","48.58","15.76"
"68","000","00","002","0244","0781","748","229","519","36","784","1441","0","54.41","15.89"
"68","000","00","002","0244","0782","813","298","515","28","841","1528","0","55.04","19.5"
"68","000","00","002","0245","0000","841","291","550","37","878","1532","0","57.31","18.99"
"68","000","00","002","0245","0767","841","291","550","37","878","1532","0","57.31","18.99"
"68","000","00","002","0246","0000","1620","418","1202","101","1721","3344","0","51.47","12.5"
"68","000","00","002","0246","0785","754","235","519","54","808","1534","0","52.67","15.32"
"68","000","00","002","0246","0786","866","183","683","47","913","1810","0","50.44","10.11"
"68","000","00","002","0247","0000","2705","897","1808","187","2892","5162","0","56.02","17.38"
"68","000","00","002","0247","0793","1044","357","687","79","1123","2037","0","55.13","17.53"
"68","000","00","002","0247","0794","667","234","433","33","700","1158","0","60.45","20.21"
"68","000","00","002","0247","0795","994","306","688","75","1069","1967","0","54.35","15.56"
"68","000","00","002","0248","0000","1470","468","1002","59","1529","3148","0","48.57","14.87"
"68","000","00","002","0248","0777","715","220","495","32","747","1609","0","46.43","13.67"
"68","000","00","002","0248","0778","755","248","507","27","782","1539","0","50.81","16.11"
"68","000","00","002","0249","0000","1818","579","1239","93","1911","3686","0","51.84","15.71"
"68","000","00","002","0249","0796","865","285","580","62","927","1830","0","50.66","15.57"
"68","000","00","002","0249","0797","953","294","659","31","984","1856","0","53.02","15.84"
"68","000","00","002","0250","0000","453","166","287","38","491","851","0","57.7","19.51"
"68","000","00","002","0250","0765","453","166","287","38","491","851","0","57.7","19.51"
"68","000","00","002","0251","0000","2433","967","1466","117","2550","4643","0","54.92","20.83"
"68","000","00","002","0251","0790","845","411","434","36","881","1576","0","55.9","26.08"
"68","000","00","002","0251","0791","775","260","515","53","828","1478","0","56.02","17.59"
"68","000","00","002","0251","0792","813","296","517","28","841","1589","0","52.93","18.63"
"68","000","00","002","0252","0000","2323","744","1579","105","2428","4812","0","50.46","15.46"
"68","000","00","002","0252","0729","703","234","469","31","734","1234","0","59.48","18.96"
"68","000","00","002","0252","0730","906","278","628","46","952","2023","0","47.06","13.74"
"68","000","00","002","0252","0731","714","232","482","28","742","1555","0","47.72","14.92"
"68","000","00","002","0253","0000","1467","472","995","53","1520","2587","0","58.76","18.25"
"68","000","00","002","0253","0634","655","200","455","23","678","1177","0","57.6","16.99"
"68","000","00","002","0253","0635","812","272","540","30","842","1410","0","59.72","19.29"
"68","000","00","002","0254","0000","1545","486","1059","68","1613","2767","0","58.29","17.56"
"68","000","00","002","0254","0761","599","190","409","31","630","1066","0","59.1","17.82"
"68","000","00","002","0254","0762","946","296","650","37","983","1701","0","57.79","17.4"
"68","000","00","002","0255","0000","2681","961","1720","100","2781","5434","0","51.18","17.68"
"68","000","00","002","0255","0774","838","279","559","55","893","1651","0","54.09","16.9"
"68","000","00","002","0255","0775","983","379","604","27","1010","1870","0","54.01","20.27"
"68","000","00","002","0255","0776","860","303","557","18","878","1913","0","45.9","15.84"
"68","000","00","002","0256","0000","2806","911","1895","141","2947","5294","0","55.67","17.21"
"68","000","00","002","0256","0706","924","302","622","61","985","1969","0","50.03","15.34"
"68","000","00","002","0256","0707","936","295","641","48","984","1563","0","62.96","18.87"
"68","000","00","002","0256","0708","946","314","632","32","978","1762","0","55.51","17.82"
"68","000","00","002","0257","0000","2449","852","1597","70","2519","4543","0","55.45","18.75"
"68","000","00","002","0257","0698","859","325","534","23","882","1621","0","54.41","20.05"
"68","000","00","002","0257","0699","755","247","508","31","786","1391","0","56.51","17.76"
"68","000","00","002","0257","0700","835","280","555","16","851","1531","0","55.58","18.29"
"68","000","00","002","0258","0000","1536","495","1041","86","1622","2854","0","56.83","17.34"
"68","000","00","002","0258","0694","656","216","440","39","695","1260","0","55.16","17.14"
"68","000","00","002","0258","0695","880","279","601","47","927","1594","0","58.16","17.5"
"68","000","00","002","0259","0000","1324","426","898","48","1372","2557","0","53.66","16.66"
"68","000","00","002","0259","0714","658","209","449","29","687","1292","0","53.17","16.18"
"68","000","00","002","0259","0715","666","217","449","19","685","1265","0","54.15","17.15"
"68","000","00","002","0260","0000","1694","556","1138","60","1754","3331","0","52.66","16.69"
"68","000","00","002","0260","0630","967","311","656","37","1004","1883","0","53.32","16.52"
"68","000","00","002","0260","0631","727","245","482","23","750","1448","0","51.8","16.92"
"68","000","00","002","0261","0000","1845","634","1211","76","1921","3726","0","51.56","17.02"
"68","000","00","002","0261","0632","907","312","595","35","942","1810","0","52.04","17.24"
"68","000","00","002","0261","0633","938","322","616","41","979","1916","0","51.1","16.81"
"68","000","00","002","0262","0000","2531","865","1666","88","2619","4657","0","56.24","18.57"
"68","000","00","002","0262","0594","849","296","553","40","889","1670","0","53.23","17.72"
"68","000","00","002","0262","0595","777","273","504","23","800","1456","0","54.95","18.75"
"68","000","00","002","0262","0596","905","296","609","25","930","1531","0","60.74","19.33"
"68","000","00","002","0263","0000","1774","498","1276","60","1834","3576","0","51.29","13.93"
"68","000","00","002","0263","0597","905","259","646","33","938","1623","0","57.79","15.96"
"68","000","00","002","0263","0598","869","239","630","27","896","1953","0","45.88","12.24"
"68","000","00","002","0264","0000","1870","622","1248","110","1980","3628","0","54.58","17.14"
"68","000","00","002","0264","0783","855","283","572","51","906","1683","0","53.83","16.82"
"68","000","00","002","0264","0784","1015","339","676","59","1074","1945","0","55.22","17.43"
"68","000","00","002","0265","0000","2344","691","1653","74","2418","4082","0","59.24","16.93"
"68","000","00","002","0265","0605","910","289","621","26","936","1602","0","58.43","18.04"
"68","000","00","002","0265","0606","619","161","458","26","645","1006","0","64.12","16.0"
"68","000","00","002","0265","0607","815","241","574","22","837","1474","0","56.78","16.35"
"68","000","00","002","0266","0000","2302","765","1537","66","2368","4296","0","55.12","17.81"
"68","000","00","002","0266","0639","645","225","420","17","662","1152","0","57.47","19.53"
"68","000","00","002","0266","0640","651","212","439","11","662","1178","0","56.2","18.0"
"68","000","00","002","0266","0641","1006","328","678","38","1044","1966","0","53.1","16.68"
"68","000","00","002","0267","0000","1254","368","886","63","1317","2125","0","61.98","17.32"
"68","000","00","002","0267","0650","566","177","389","24","590","994","0","59.36","17.81"
"68","000","00","002","0267","0651","688","191","497","39","727","1131","0","64.28","16.89"
"68","000","00","002","0268","0000","2416","821","1595","69","2485","4658","0","53.35","17.63"
"68","000","00","002","0268","0670","777","333","444","23","800","1505","0","53.16","22.13"
"68","000","00","002","0268","0671","847","250","597","19","866","1661","0","52.14","15.05"
"68","000","00","002","0268","0672","792","238","554","27","819","1492","0","54.89","15.95"
"68","000","00","002","0269","0000","1447","597","850","71","1518","2575","0","58.95","23.18"
"68","000","00","002","0269","0644","632","301","331","31","663","1178","0","56.28","25.55"
"68","000","00","002","0269","0645","815","296","519","40","855","1397","0","61.2","21.19"
"68","000","00","002","0270","0000","1872","633","1239","79","1951","3756","0","51.94","16.85"
"68","000","00","002","0270","0646","888","310","578","38","926","1669","0","55.48","18.57"
"68","000","00","002","0270","0647","984","323","661","41","1025","2087","0","49.11","15.48"
"68","000","00","002","0271","0000","1665","497","1168","100","1765","3596","0","49.08","13.82"
"68","000","00","002","0271","0660","977","271","706","69","1046","2145","0","48.76","12.63"
"68","000","00","002","0271","0661","688","226","462","31","719","1451","0","49.55","15.58"
"68","000","00","002","0272","0000","2350","709","1641","97","2447","4686","0","52.22","15.13"
"68","000","00","002","0272","0622","794","238","556","42","836","1448","0","57.73","16.44"
"68","000","00","002","0272","0623","791","253","538","42","833","1605","0","51.9","15.76"
"68","000","00","002","0272","0624","765","218","547","13","778","1633","0","47.64","13.35"
"68","000","00","002","0273","0000","2848","982","1866","82","2930","5990","0","48.91","16.39"
"68","000","00","002","0273","0745","1046","346","700","26","1072","2027","0","52.89","17.07"
"68","000","00","002","0273","0746","813","297","516","21","834","1883","0","44.29","15.77"
"68","000","00","002","0273","0747","989","339","650","35","1024","2080","0","49.23","16.3"
"68","000","00","002","0274","0000","3109","954","2155","110","3219","5466","0","58.89","17.45"
"68","000","00","002","0274","0748","339","124","215","12","351","646","0","54.33","19.2"
"68","000","00","002","0274","0749","1074","325","749","42","1116","1780","0","62.7","18.26"
"68","000","00","002","0274","0750","767","205","562","24","791","1372","0","57.65","14.94"
"68","000","00","002","0274","0751","929","300","629","32","961","1668","0","57.61","17.99"
"68","000","00","002","0275","0000","1616","458","1158","54","1670","3555","0","46.98","12.88"
"68","000","00","002","0275","0656","772","203","569","34","806","1743","0","46.24","11.65"
"68","000","00","002","0275","0657","844","255","589","20","864","1812","0","47.68","14.07"
"68","000","00","002","0276","0000","1860","544","1316","70","1930","3484","0","55.4","15.61"
"68","000","00","002","0276","0625","967","305","662","49","1016","1795","0","56.6","16.99"
"68","000","00","002","0276","0626","893","239","654","21","914","1689","0","54.11","14.15"
"68","000","00","002","0277","0000","1718","514","1204","93","1811","3448","0","52.52","14.91"
"68","000","00","002","0277","0685","911","249","662","56","967","1739","0","55.61","14.32"
"68","000","00","002","0277","0686","807","265","542","37","844","1709","0","49.39","15.51"
"68","000","00","002","0278","0000","1732","504","1228","69","1801","3319","0","54.26","15.19"
"68","000","00","002","0278","0687","874","277","597","38","912","1655","0","55.11","16.74"
"68","000","00","002","0278","0688","858","227","631","31","889","1664","0","53.43","13.64"
"68","000","00","002","0279","0000","2371","718","1653","101","2472","4416","0","55.98","16.26"
"68","000","00","002","0279","0734","670","198","472","36","706","1164","0","60.65","17.01"
"68","000","00","002","0279","0735","787","254","533","26","813","1482","0","54.86","17.14"
"68","000","00","002","0279","0736","914","266","648","39","953","1770","0","53.84","15.03"
"68","000","00","002","0280","0000","1352","479","873","70","1422","2405","0","59.13","19.92"
"68","000","00","002","0280","0759","688","247","441","41","729","1223","0","59.61","20.2"
"68","000","00","002","0280","0760","664","232","432","29","693","1182","0","58.63","19.63"
"68","000","00","002","0281","0000","1641","566","1075","47","1688","3243","0","52.05","17.45"
"68","000","00","002","0281","0677","835","282","553","28","863","1702","0","50.71","16.57"
"68","000","00","002","0281","0678","806","284","522","19","825","1541","0","53.54","18.43"
"68","000","00","002","0282","0000","2269","694","1575","75","2344","4712","0","49.75","14.73"
"68","000","00","002","0282","0599","637","197","440","22","659","1155","0","57.06","17.06"
"68","000","00","002","0282","0600","808","238","570","30","838","1800","0","46.56","13.22"
"68","000","00","002","0282","0601","824","259","565","23","847","1757","0","48.21","14.74"
"68","000","00","002","0283","0000","2731","997","1734","86","2817","5423","0","51.95","18.38"
"68","000","00","002","0283","0682","845","290","555","39","884","1735","0","50.95","16.71"
"68","000","00","002","0283","0683","899","314","585","21","920","1815","0","50.69","17.3"
"68","000","00","002","0283","0684","987","393","594","26","1013","1873","0","54.08","20.98"
"68","000","00","002","0284","0000","2123","678","1445","125","2248","3731","0","60.25","18.17"
"68","000","00","002","0284","0726","718","202","516","43","761","1302","0","58.45","15.51"
"68","000","00","002","0284","0727","655","224","431","42","697","1203","0","57.94","18.62"
"68","000","00","002","0284","0728","750","252","498","40","790","1226","0","64.44","20.55"
"68","000","00","002","0285","0000","2118","762","1356","65","2183","3970","0","54.99","19.19"
"68","000","00","002","0285","0739","1034","389","645","32","1066","1941","0","54.92","20.04"
"68","000","00","002","0285","0740","1084","373","711","33","1117","2029","0","55.05","18.38"
"68","000","00","003","0000","0000","38510","12329","26181","2824","41334","78285","94862","52.8","15.75"
"68","000","00","003","0301","0000","777","269","508","52","829","1477","0","56.13","18.21"
"68","000","00","003","0301","0522","777","269","508","52","829","1477","0","56.13","18.21"
"68","000","00","003","0302","0000","527","178","349","33","560","1006","0","55.67","17.69"
"68","000","00","003","0302","0523","527","178","349","33","560","1006","0","55.67","17.69"
"68","000","00","003","0303","0000","2214","720","1494","113","2327","4752","0","48.97","15.15"
"68","000","00","003","0303","0527","724","244","480","38","762","1585","0","48.08","15.39"
"68","000","00","003","0303","0528","796","266","530","44","840","1612","0","52.11","16.5"
"68","000","00","003","0303","0529","694","210","484","31","725","1555","0","46.62","13.5"
"68","000","00","003","0304","0000","2793","899","1894","217","3010","5544","0","54.29","16.22"
"68","000","00","003","0304","0530","720","230","490","54","774","1282","0","60.37","17.94"
"68","000","00","003","0304","0531","675","207","468","55","730","1392","0","52.44","14.87"
"68","000","00","003","0304","0532","668","207","461","50","718","1422","0","50.49","14.56"
"68","000","00","003","0304","0533","730","255","475","58","788","1448","0","54.42","17.61"
"68","000","00","003","0305","0000","729","244","485","47","776","1269","0","61.15","19.23"
"68","000","00","003","0305","0534","729","244","485","47","776","1269","0","61.15","19.23"
"68","000","00","003","0306","0000","524","170","354","67","591","977","0","60.49","17.4"
"68","000","00","003","0306","0535","524","170","354","67","591","977","0","60.49","17.4"
"68","000","00","003","0307","0000","1445","502","943","132","1577","3036","0","51.94","16.53"
"68","000","00","003","0307","0539","491","187","304","40","531","1056","0","50.28","17.71"
"68","000","00","003","0307","0540","587","200","387","59","646","1263","0","51.15","15.84"
"68","000","00","003","0307","0541","367","115","252","33","400","717","0","55.79","16.04"
"68","000","00","003","0308","0000","1024","345","679","77","1101","2275","0","48.4","15.16"
"68","000","00","003","0308","0542","532","176","356","27","559","1299","0","43.03","13.55"
"68","000","00","003","0308","0543","492","169","323","50","542","976","0","55.53","17.32"
"68","000","00","003","0309","0000","449","129","320","59","508","938","0","54.16","13.75"
"68","000","00","003","0309","0544","449","129","320","59","508","938","0","54.16","13.75"
"68","000","00","003","0310","0000","395","107","288","28","423","832","0","50.84","12.86"
"68","000","00","003","0310","0545","395","107","288","28","423","832","0","50.84","12.86"
"68","000","00","003","0311","0000","718","228","490","48","766","1359","0","56.36","16.78"
"68","000","00","003","0311","0536","718","228","490","48","766","1359","0","56.36","16.78"
"68","000","00","003","0312","0000","916","334","582","122","1038","1795","0","57.83","18.61"
"68","000","00","003","0312","0537","620","222","398","66","686","1135","0","60.44","19.56"
"68","000","00","003","0312","0538","296","112","184","56","352","660","0","53.33","16.97"
"68","000","00","003","0313","0000","1250","376","874","99","1349","2713","0","49.72","13.86"
"68","000","00","003","0313","0548","656","208","448","44","700","1410","0","49.65","14.75"
"68","000","00","003","0313","0549","594","168","426","55","649","1303","0","49.81","12.89"
"68","000","00","003","0314","0000","689","255","434","55","744","1560","0","47.69","16.35"
"68","000","00","003","0314","0546","373","122","251","24","397","866","0","45.84","14.09"
"68","000","00","003","0314","0547","316","133","183","31","347","694","0","50.0","19.16"
"68","000","00","003","0315","0000","1249","344","905","110","1359","2852","0","47.65","12.06"
"68","000","00","003","0315","0557","678","203","475","65","743","1446","0","51.38","14.04"
"68","000","00","003","0315","0558","571","141","430","45","616","1406","0","43.81","10.03"
"68","000","00","003","0316","0000","1323","330","993","61","1384","2542","0","54.45","12.98"
"68","000","00","003","0316","0555","643","147","496","36","679","1173","0","57.89","12.53"
"68","000","00","003","0316","0556","680","183","497","25","705","1369","0","51.5","13.37"
"68","000","00","003","0317","0000","1899","659","1240","99","1998","3603","0","55.45","18.29"
"68","000","00","003","0317","0550","552","194","358","37","589","1125","0","52.36","17.24"
"68","000","00","003","0317","0551","616","212","404","28","644","1170","0","55.04","18.12"
"68","000","00","003","0317","0552","731","253","478","34","765","1308","0","58.49","19.34"
"68","000","00","003","0318","0000","2565","794","1771","159","2724","5012","0","54.35","15.84"
"68","000","00","003","0318","0562","833","264","569","23","856","1684","0","50.83","15.68"
"68","000","00","003","0318","0563","1011","312","699","73","1084","1959","0","55.33","15.93"
"68","000","00","003","0318","0564","721","218","503","63","784","1369","0","57.27","15.92"
"68","000","00","003","0319","0000","1396","433","963","76","1472","3088","0","47.67","14.02"
"68","000","00","003","0319","0565","754","248","506","49","803","1431","0","56.11","17.33"
"68","000","00","003","0319","0566","642","185","457","27","669","1657","0","40.37","11.16"
"68","000","00","003","0320","0000","707","235","472","25","732","1514","0","48.35","15.52"
"68","000","00","003","0320","0575","707","235","472","25","732","1514","0","48.35","15.52"
"68","000","00","003","0321","0000","2145","702","1443","229","2374","4947","0","47.99","14.19"
"68","000","00","003","0321","0570","720","240","480","64","784","1511","0","51.89","15.88"
"68","000","00","003","0321","0571","717","260","457","81","798","1719","0","46.42","15.13"
"68","000","00","003","0321","0572","708","202","506","84","792","1717","0","46.13","11.76"
"68","000","00","003","0322","0000","1898","585","1313","111","2009","3732","0","53.83","15.68"
"68","000","00","003","0322","0578","466","139","327","15","481","831","0","57.88","16.73"
"68","000","00","003","0322","0579","734","229","505","49","783","1407","0","55.65","16.28"
"68","000","00","003","0322","0580","698","217","481","47","745","1494","0","49.87","14.52"
"68","000","00","003","0323","0000","1201","356","845","125","1326","2395","0","55.37","14.86"
"68","000","00","003","0323","0573","590","192","398","62","652","1207","0","54.02","15.91"
"68","000","00","003","0323","0574","611","164","447","63","674","1188","0","56.73","13.8"
"68","000","00","003","0324","0000","1488","458","1030","111","1599","2789","0","57.33","16.42"
"68","000","00","003","0324","0576","782","247","535","74","856","1529","0","55.98","16.15"
"68","000","00","003","0324","0577","706","211","495","37","743","1260","0","58.97","16.75"
"68","000","00","003","0325","0000","2235","756","1479","175","2410","4508","0","53.46","16.77"
"68","000","00","003","0325","0524","749","228","521","66","815","1553","0","52.48","14.68"
"68","000","00","003","0325","0525","805","288","517","64","869","1597","0","54.41","18.03"
"68","000","00","003","0325","0526","681","240","441","45","726","1358","0","53.46","17.67"
"68","000","00","003","0326","0000","1865","617","1248","117","1982","3875","0","51.15","15.92"
"68","000","00","003","0326","0567","580","190","390","29","609","1387","0","43.91","13.7"
"68","000","00","003","0326","0568","532","183","349","37","569","1085","0","52.44","16.87"
"68","000","00","003","0326","0569","753","244","509","51","804","1403","0","57.31","17.39"
"68","000","00","003","0327","0000","2460","763","1697","143","2603","4648","0","56.0","16.42"
"68","000","00","003","0327","0559","835","244","591","27","862","1592","0","54.15","15.33"
"68","000","00","003","0327","0560","791","248","543","62","853","1497","0","56.98","16.57"
"68","000","00","003","0327","0561","834","271","563","54","888","1559","0","56.96","17.38"
"68","000","00","003","0328","0000","1629","541","1088","134","1763","3247","0","54.3","16.66"
"68","000","00","003","0328","0553","548","198","350","69","617","1094","0","56.4","18.1"
"68","000","00","003","0328","0554","1081","343","738","65","1146","2153","0","53.23","15.93"
"68","000","00","004","0000","0000","67443","21210","46233","3207","70650","137917","169991","51.23","15.38"
"68","000","00","004","0401","0000","1870","556","1314","78","1948","3705","0","52.58","15.01"
"68","000","00","004","0401","0960","959","275","684","44","1003","1943","0","51.62","14.15"
"68","000","00","004","0401","0961","911","281","630","34","945","1762","0","53.63","15.95"
"68","000","00","004","0402","0000","562","167","395","27","589","1083","0","54.39","15.42"
"68","000","00","004","0402","0962","562","167","395","27","589","1083","0","54.39","15.42"
"68","000","00","004","0403","0000","1411","669","742","102","1513","2633","0","57.46","25.41"
"68","000","00","004","0403","0964","674","468","206","55","729","1274","0","57.22","36.73"
"68","000","00","004","0403","0965","737","201","536","47","784","1359","0","57.69","14.79"
"68","000","00","004","0404","0000","2888","838","2050","101","2989","6964","0","42.92","12.03"
"68","000","00","004","0404","0966","837","288","549","29","866","2444","0","35.43","11.78"
"68","000","00","004","0404","0967","996","258","738","34","1030","2298","0","44.82","11.23"
"68","000","00","004","0404","0968","1055","292","763","38","1093","2222","0","49.19","13.14"
"68","000","00","004","0405","0000","1575","501","1074","145","1720","3237","0","53.14","15.48"
"68","000","00","004","0405","0969","780","251","529","73","853","1610","0","52.98","15.59"
"68","000","00","004","0405","0970","795","250","545","72","867","1627","0","53.29","15.37"
"68","000","00","004","0406","0000","1200","386","814","73","1273","2776","0","45.86","13.9"
"68","000","00","004","0406","0973","730","227","503","50","780","1776","0","43.92","12.78"
"68","000","00","004","0406","0974","470","159","311","23","493","1000","0","49.3","15.9"
"68","000","00","004","0407","0000","2306","628","1678","118","2424","4112","0","58.95","15.27"
"68","000","00","004","0407","1003","868","220","648","30","898","1448","0","62.02","15.19"
"68","000","00","004","0407","1004","721","196","525","42","763","1351","0","56.48","14.51"
"68","000","00","004","0407","1005","717","212","505","46","763","1313","0","58.11","16.15"
"68","000","00","004","0408","0000","1372","416","956","48","1420","2602","0","54.57","15.99"
"68","000","00","004","0408","0989","619","193","426","29","648","1194","0","54.27","16.16"
"68","000","00","004","0408","0990","753","223","530","19","772","1408","0","54.83","15.84"
"68","000","00","004","0409","0000","998","287","711","54","1052","2027","0","51.9","14.16"
"68","000","00","004","0409","0963","998","287","711","54","1052","2027","0","51.9","14.16"
"68","000","00","004","0410","0000","1728","524","1204","76","1804","3300","0","54.67","15.88"
"68","000","00","004","0410","0956","897","291","606","24","921","1713","0","53.77","16.99"
"68","000","00","004","0410","0957","831","233","598","52","883","1587","0","55.64","14.68"
"68","000","00","004","0411","0000","761","225","536","45","806","1434","0","56.21","15.69"
"68","000","00","004","0411","0929","761","225","536","45","806","1434","0","56.21","15.69"
"68","000","00","004","0412","0000","626","165","461","34","660","1137","0","58.05","14.51"
"68","000","00","004","0412","0932","626","165","461","34","660","1137","0","58.05","14.51"
"68","000","00","004","0413","0000","2512","782","1730","129","2641","5314","0","49.7","14.72"
"68","000","00","004","0413","0936","768","244","524","49","817","1449","0","56.38","16.84"
"68","000","00","004","0413","0937","818","267","551","48","866","1877","0","46.14","14.22"
"68","000","00","004","0413","0938","926","271","655","32","958","1988","0","48.19","13.63"
"68","000","00","004","0414","0000","2055","621","1434","61","2116","4219","0","50.15","14.72"
"68","000","00","004","0414","0933","1065","323","742","38","1103","2211","0","49.89","14.61"
"68","000","00","004","0414","0934","990","298","692","23","1013","2008","0","50.45","14.84"
"68","000","00","004","0415","0000","1852","602","1250","39","1891","3730","0","50.7","16.14"
"68","000","00","004","0415","0942","900","286","614","13","913","1848","0","49.4","15.48"
"68","000","00","004","0415","0943","952","316","636","26","978","1882","0","51.97","16.79"
"68","000","00","004","0416","0000","1687","480","1207","47","1734","3657","0","47.42","13.13"
"68","000","00","004","0416","0991","751","220","531","27","778","1737","0","44.79","12.67"
"68","000","00","004","0416","0992","936","260","676","20","956","1920","0","49.79","13.54"
"68","000","00","004","0417","0000","1707","519","1188","73","1780","3378","0","52.69","15.36"
"68","000","00","004","0417","0997","866","246","620","45","911","1692","0","53.84","14.54"
"68","000","00","004","0417","0998","841","273","568","28","869","1686","0","51.54","16.19"
"68","000","00","004","0418","0000","2163","595","1568","136","2299","3923","0","58.6","15.17"
"68","000","00","004","0418","0926","655","187","468","53","708","1269","0","55.79","14.74"
"68","000","00","004","0418","0927","727","190","537","43","770","1246","0","61.8","15.25"
"68","000","00","004","0418","0928","781","218","563","40","821","1408","0","58.31","15.48"
"68","000","00","004","0419","0000","1501","414","1087","99","1600","3172","0","50.44","13.05"
"68","000","00","004","0419","0930","733","208","525","53","786","1515","0","51.88","13.73"
"68","000","00","004","0419","0931","768","206","562","46","814","1657","0","49.12","12.43"
"68","000","00","004","0420","0000","880","270","610","53","933","1861","0","50.13","14.51"
"68","000","00","004","0420","0977","880","270","610","53","933","1861","0","50.13","14.51"
"68","000","00","004","0421","0000","1734","509","1225","121","1855","3841","0","48.29","13.25"
"68","000","00","004","0421","0975","974","281","693","68","1042","2290","0","45.5","12.27"
"68","000","00","004","0421","0976","760","228","532","53","813","1551","0","52.42","14.7"
"68","000","00","004","0422","0000","1301","381","920","123","1424","2685","0","53.04","14.19"
"68","000","00","004","0422","0980","738","204","534","62","800","1498","0","53.4","13.62"
"68","000","00","004","0422","0981","563","177","386","61","624","1187","0","52.57","14.91"
"68","000","00","004","0423","0000","1779","514","1265","83","1862","3752","0","49.63","13.7"
"68","000","00","004","0423","1006","833","236","597","49","882","1689","0","52.22","13.97"
"68","000","00","004","0423","1007","946","278","668","34","980","2063","0","47.5","13.48"
"68","000","00","004","0424","0000","1371","416","955","83","1454","2694","0","53.97","15.44"
"68","000","00","004","0424","0982","658","211","447","50","708","1270","0","55.75","16.61"
"68","000","00","004","0424","0983","713","205","508","33","746","1424","0","52.39","14.4"
"68","000","00","004","0425","0000","2388","1208","1180","140","2528","5412","0","46.71","22.32"
"68","000","00","004","0425","0986","766","240","526","55","821","1783","0","46.05","13.46"
"68","000","00","004","0425","0987","804","225","579","18","822","1709","0","48.1","13.17"
"68","000","00","004","0425","0988","818","743","75","67","885","1920","0","46.09","38.7"
"68","000","00","004","0426","0000","1640","499","1141","40","1680","3007","0","55.87","16.59"
"68","000","00","004","0426","0958","786","251","535","22","808","1416","0","57.06","17.73"
"68","000","00","004","0426","0959","854","248","606","18","872","1591","0","54.81","15.59"
"68","000","00","004","0427","0000","2999","959","2040","87","3086","6381","0","48.36","15.03"
"68","000","00","004","0427","0950","973","316","657","28","1001","2101","0","47.64","15.04"
"68","000","00","004","0427","0951","1008","339","669","42","1050","2054","0","51.12","16.5"
"68","000","00","004","0427","0952","1018","304","714","17","1035","2226","0","46.5","13.66"
"68","000","00","004","0428","0000","1860","646","1214","45","1905","3687","0","51.67","17.52"
"68","000","00","004","0428","0946","714","214","500","12","726","1562","0","46.48","13.7"
"68","000","00","004","0428","0947","1146","432","714","33","1179","2125","0","55.48","20.33"
"68","000","00","004","0429","0000","1605","516","1089","39","1644","3248","0","50.62","15.89"
"68","000","00","004","0429","0953","755","222","533","12","767","1405","0","54.59","15.8"
"68","000","00","004","0429","0954","850","294","556","27","877","1843","0","47.59","15.95"
"68","000","00","004","0430","0000","1700","580","1120","105","1805","3347","0","53.93","17.33"
"68","000","00","004","0430","0971","818","309","509","50","868","1589","0","54.63","19.45"
"68","000","00","004","0430","0972","882","271","611","55","937","1758","0","53.3","15.42"
"68","000","00","004","0431","0000","1748","570","1178","68","1816","3883","0","46.77","14.68"
"68","000","00","004","0431","0995","913","282","631","39","952","2020","0","47.13","13.96"
"68","000","00","004","0431","0996","835","288","547","29","864","1863","0","46.38","15.46"
"68","000","00","004","0432","0000","1740","556","1184","117","1857","3492","0","53.18","15.92"
"68","000","00","004","0432","1001","872","286","586","55","927","1603","0","57.83","17.84"
"68","000","00","004","0432","1002","868","270","598","62","930","1889","0","49.23","14.29"
"68","000","00","004","0433","0000","1654","528","1126","95","1749","3183","0","54.95","16.59"
"68","000","00","004","0433","0999","820","269","551","68","888","1626","0","54.61","16.54"
"68","000","00","004","0433","1000","834","259","575","27","861","1557","0","55.3","16.63"
"68","000","00","004","0434","0000","2933","917","2016","99","3032","5546","0","54.67","16.53"
"68","000","00","004","0434","0939","1066","315","751","29","1095","1931","0","56.71","16.31"
"68","000","00","004","0434","0940","1006","356","650","48","1054","1938","0","54.39","18.37"
"68","000","00","004","0434","0941","861","246","615","22","883","1677","0","52.65","14.67"
"68","000","00","004","0435","0000","975","318","657","29","1004","1911","0","52.54","16.64"
"68","000","00","004","0435","0935","975","318","657","29","1004","1911","0","52.54","16.64"
"68","000","00","004","0436","0000","1517","476","1041","58","1575","3479","0","45.27","13.68"
"68","000","00","004","0436","0944","612","195","417","18","630","1541","0","40.88","12.65"
"68","000","00","004","0436","0945","905","281","624","40","945","1938","0","48.76","14.5"
"68","000","00","004","0437","0000","1392","440","952","84","1476","2725","0","54.17","16.15"
"68","000","00","004","0437","0993","613","209","404","33","646","1234","0","52.35","16.94"
"68","000","00","004","0437","0994","779","231","548","51","830","1491","0","55.67","15.49"
"68","000","00","004","0438","0000","1299","377","922","104","1403","2926","0","47.95","12.88"
"68","000","00","004","0438","0978","480","155","325","59","539","1141","0","47.24","13.58"
"68","000","00","004","0438","0979","819","222","597","45","864","1785","0","48.4","12.44"
"68","000","00","004","0439","0000","991","296","695","40","1031","2324","0","44.36","12.74"
"68","000","00","004","0439","0955","991","296","695","40","1031","2324","0","44.36","12.74"
"68","000","00","004","0440","0000","1728","385","1343","59","1787","3323","0","53.78","11.59"
"68","000","00","004","0440","0948","857","137","720","31","888","1516","0","58.58","9.04"
"68","000","00","004","0440","0949","871","248","623","28","899","1807","0","49.75","13.72"
"68","000","00","004","0441","0000","1435","474","961","50","1485","2807","0","52.9","16.89"
"68","000","00","004","0441","0984","755","245","510","19","774","1273","0","60.8","19.25"
"68","000","00","004","0441","0985","680","229","451","31","711","1534","0","46.35","14.93"
"68","000","00","005","0000","0000","62750","21787","40963","3168","65918","129252","164057","51.0","16.86"
"68","000","00","005","0501","0000","1340","422","918","147","1487","2896","0","51.35","14.57"
"68","000","00","005","0501","0396","632","206","426","79","711","1358","0","52.36","15.17"
"68","000","00","005","0501","0397","708","216","492","68","776","1538","0","50.46","14.04"
"68","000","00","005","0502","0000","1691","498","1193","112","1803","3791","0","47.56","13.14"
"68","000","00","005","0502","0398","812","214","598","51","863","2118","0","40.75","10.1"
"68","000","00","005","0502","0399","879","284","595","61","940","1673","0","56.19","16.98"
"68","000","00","005","0503","0000","2183","750","1433","113","2296","4816","0","47.67","15.57"
"68","000","00","005","0503","0404","660","212","448","27","687","1446","0","47.51","14.66"
"68","000","00","005","0503","0405","709","253","456","53","762","1623","0","46.95","15.59"
"68","000","00","005","0503","0406","814","285","529","33","847","1747","0","48.48","16.31"
"68","000","00","005","0504","0000","2166","1048","1118","101","2267","4687","0","48.37","22.36"
"68","000","00","005","0504","0411","1048","713","335","53","1101","2189","0","50.3","32.57"
"68","000","00","005","0504","0412","1118","335","783","48","1166","2498","0","46.68","13.41"
"68","000","00","005","0506","0000","1704","595","1109","139","1843","4088","0","45.08","14.55"
"68","000","00","005","0506","0414","786","265","521","65","851","1991","0","42.74","13.31"
"68","000","00","005","0506","0415","918","330","588","74","992","2097","0","47.31","15.74"
"68","000","00","005","0507","0000","1740","589","1151","71","1811","3567","0","50.77","16.51"
"68","000","00","005","0507","0430","929","296","633","48","977","1864","0","52.41","15.88"
"68","000","00","005","0507","0431","811","293","518","23","834","1703","0","48.97","17.2"
"68","000","00","005","0508","0000","1944","684","1260","67","2011","3815","0","52.71","17.93"
"68","000","00","005","0508","0432","921","318","603","33","954","1893","0","50.4","16.8"
"68","000","00","005","0508","0433","1023","366","657","34","1057","1922","0","54.99","19.04"
"68","000","00","005","0509","0000","1267","417","850","57","1324","2380","0","55.63","17.52"
"68","000","00","005","0509","0440","685","227","458","33","718","1181","0","60.8","19.22"
"68","000","00","005","0509","0441","582","190","392","24","606","1199","0","50.54","15.85"
"68","000","00","005","0510","0000","1210","366","844","128","1338","2521","0","53.07","14.52"
"68","000","00","005","0510","0459","523","173","350","42","565","1318","0","42.87","13.13"
"68","000","00","005","0510","0460","687","193","494","86","773","1203","0","64.26","16.04"
"68","000","00","005","0511","0000","785","248","537","38","823","1771","0","46.47","14.0"
"68","000","00","005","0511","0461","785","248","537","38","823","1771","0","46.47","14.0"
"68","000","00","005","0512","0000","1584","524","1060","163","1747","3595","0","48.6","14.58"
"68","000","00","005","0512","0462","785","257","528","72","857","1832","0","46.78","14.03"
"68","000","00","005","0512","0463","799","267","532","91","890","1763","0","50.48","15.14"
"68","000","00","005","0513","0000","617","231","386","20","637","1497","0","42.55","15.43"
"68","000","00","005","0513","0464","617","231","386","20","637","1497","0","42.55","15.43"
"68","000","00","005","0514","0000","881","267","614","115","996","1671","0","59.61","15.98"
"68","000","00","005","0514","0465","881","267","614","115","996","1671","0","59.61","15.98"
"68","000","00","005","0515","0000","1273","414","859","144","1417","2488","0","56.95","16.64"
"68","000","00","005","0515","0466","482","163","319","56","538","929","0","57.91","17.55"
"68","000","00","005","0515","0467","791","251","540","88","879","1559","0","56.38","16.1"
"68","000","00","005","0516","0000","1620","473","1147","84","1704","2938","0","58.0","16.1"
"68","000","00","005","0516","0468","767","228","539","25","792","1497","0","52.91","15.23"
"68","000","00","005","0516","0469","853","245","608","59","912","1441","0","63.29","17.0"
"68","000","00","005","0517","0000","1518","521","997","48","1566","3161","0","49.54","16.48"
"68","000","00","005","0517","0428","732","231","501","20","752","1668","0","45.08","13.85"
"68","000","00","005","0517","0429","786","290","496","28","814","1493","0","54.52","19.42"
"68","000","00","005","0518","0000","2492","897","1595","121","2613","5039","0","51.86","17.8"
"68","000","00","005","0518","0416","799","290","509","49","848","1558","0","54.43","18.61"
"68","000","00","005","0518","0417","959","352","607","33","992","1891","0","52.46","18.61"
"68","000","00","005","0518","0418","734","255","479","39","773","1590","0","48.62","16.04"
"68","000","00","005","0519","0000","1251","381","870","52","1303","2588","0","50.35","14.72"
"68","000","00","005","0519","0438","623","184","439","29","652","1232","0","52.92","14.94"
"68","000","00","005","0519","0439","628","197","431","23","651","1356","0","48.01","14.53"
"68","000","00","005","0520","0000","1515","511","1004","89","1604","3150","0","50.92","16.22"
"68","000","00","005","0520","0436","826","268","558","27","853","1688","0","50.53","15.88"
"68","000","00","005","0520","0437","689","243","446","62","751","1462","0","51.37","16.62"
"68","000","00","005","0521","0000","683","226","457","38","721","1322","0","54.54","17.1"
"68","000","00","005","0521","0413","683","226","457","38","721","1322","0","54.54","17.1"
"68","000","00","005","0522","0000","1684","559","1125","93","1777","3425","0","51.88","16.32"
"68","000","00","005","0522","0407","968","310","658","55","1023","1988","0","51.46","15.59"
"68","000","00","005","0522","0408","716","249","467","38","754","1437","0","52.47","17.33"
"68","000","00","005","0523","0000","1481","363","1118","99","1580","2979","0","53.04","12.19"
"68","000","00","005","0523","0409","809","261","548","58","867","1532","0","56.59","17.04"
"68","000","00","005","0523","0410","672","102","570","41","713","1447","0","49.27","7.05"
"68","000","00","005","0524","0000","1613","560","1053","84","1697","3172","0","53.5","17.65"
"68","000","00","005","0524","0457","821","279","542","33","854","1483","0","57.59","18.81"
"68","000","00","005","0524","0458","792","281","511","51","843","1689","0","49.91","16.64"
"68","000","00","005","0525","0000","2124","754","1370","72","2196","4595","0","47.79","16.41"
"68","000","00","005","0525","0453","1277","430","847","38","1315","2727","0","48.22","15.77"
"68","000","00","005","0525","0454","847","324","523","34","881","1868","0","47.16","17.34"
"68","000","00","005","0526","0000","2063","755","1308","65","2128","4233","0","50.27","17.84"
"68","000","00","005","0526","0446","989","346","643","40","1029","2055","0","50.07","16.84"
"68","000","00","005","0526","0447","1074","409","665","25","1099","2178","0","50.46","18.78"
"68","000","00","005","0527","0000","1713","574","1139","58","1771","3551","0","49.87","16.16"
"68","000","00","005","0527","0425","815","268","547","27","842","1731","0","48.64","15.48"
"68","000","00","005","0527","0426","898","306","592","31","929","1820","0","51.04","16.81"
"68","000","00","005","0528","0000","2242","744","1498","91","2333","4926","0","47.36","15.1"
"68","000","00","005","0528","0419","1038","343","695","45","1083","2404","0","45.05","14.27"
"68","000","00","005","0528","0420","1204","401","803","46","1250","2522","0","49.56","15.9"
"68","000","00","005","0529","0000","1681","568","1113","50","1731","3348","0","51.7","16.97"
"68","000","00","005","0529","0421","824","269","555","20","844","1633","0","51.68","16.47"
"68","000","00","005","0529","0422","857","299","558","30","887","1715","0","51.72","17.43"
"68","000","00","005","0530","0000","844","293","551","38","882","1633","0","54.01","17.94"
"68","000","00","005","0530","0427","844","293","551","38","882","1633","0","54.01","17.94"
"68","000","00","005","0531","0000","2831","973","1858","106","2937","5379","0","54.6","18.09"
"68","000","00","005","0531","0449","873","292","581","43","916","1667","0","54.95","17.52"
"68","000","00","005","0531","0450","916","319","597","30","946","1745","0","54.21","18.28"
"68","000","00","005","0531","0451","1042","362","680","33","1075","1967","0","54.65","18.4"
"68","000","00","005","0532","0000","1871","665","1206","53","1924","3511","0","54.8","18.94"
"68","000","00","005","0532","0448","889","335","554","29","918","1709","0","53.72","19.6"
"68","000","00","005","0532","0452","982","330","652","24","1006","1802","0","55.83","18.31"
"68","000","00","005","0533","0000","1568","560","1008","59","1627","3133","0","51.93","17.87"
"68","000","00","005","0533","0442","882","313","569","31","913","1710","0","53.39","18.3"
"68","000","00","005","0533","0443","686","247","439","28","714","1423","0","50.18","17.36"
"68","000","00","005","0534","0000","1643","1003","640","54","1697","3161","0","53.69","31.73"
"68","000","00","005","0534","0444","797","318","479","19","816","1522","0","53.61","20.89"
"68","000","00","005","0534","0445","846","685","161","35","881","1639","0","53.75","41.79"
"68","000","00","005","0535","0000","1437","460","977","47","1484","2731","0","54.34","16.84"
"68","000","00","005","0535","0434","725","225","500","22","747","1393","0","53.63","16.15"
"68","000","00","005","0535","0435","712","235","477","25","737","1338","0","55.08","17.56"
"68","000","00","005","0536","0000","2146","735","1411","58","2204","4604","0","47.87","15.96"
"68","000","00","005","0536","0402","1110","352","758","38","1148","2250","0","51.02","15.64"
"68","000","00","005","0536","0403","1036","383","653","20","1056","2354","0","44.86","16.27"
"68","000","00","005","0537","0000","1638","545","1093","69","1707","3199","0","53.36","17.04"
"68","000","00","005","0537","0400","775","263","512","28","803","1500","0","53.53","17.53"
"68","000","00","005","0537","0401","863","282","581","41","904","1699","0","53.21","16.6"
"68","000","00","005","0538","0000","1545","580","965","84","1629","3153","0","51.67","18.4"
"68","000","00","005","0538","0455","733","272","461","50","783","1537","0","50.94","17.7"
"68","000","00","005","0538","0456","812","308","504","34","846","1616","0","52.35","19.06"
"68","000","00","005","0539","0000","1957","673","1284","58","2015","4244","0","47.48","15.86"
"68","000","00","005","0539","0423","1011","333","678","23","1034","2215","0","46.68","15.03"
"68","000","00","005","0539","0424","946","340","606","35","981","2029","0","48.35","16.76"
"68","000","00","005","0540","0000","1205","361","844","83","1288","2494","0","51.64","14.47"
"68","000","00","005","0540","0470","703","211","492","51","754","1465","0","51.47","14.4"
"68","000","00","005","0540","0471","502","150","352","32","534","1029","0","51.9","14.58"
"68","000","00","006","0000","0000","35088","11444","23644","1798","36886","73900","90407","49.91","15.49"
"68","000","00","006","0601","0000","2878","947","1931","152","3030","6145","0","49.31","15.41"
"68","000","00","006","0601","0472","667","229","438","39","706","1538","0","45.9","14.89"
"68","000","00","006","0601","0473","632","203","429","31","663","1616","0","41.03","12.56"
"68","000","00","006","0601","0474","762","267","495","48","810","1437","0","56.37","18.58"
"68","000","00","006","0601","0475","817","248","569","34","851","1554","0","54.76","15.96"
"68","000","00","006","0602","0000","3100","1144","1956","175","3275","6471","0","50.61","17.68"
"68","000","00","006","0602","0476","605","214","391","40","645","1237","0","52.14","17.3"
"68","000","00","006","0602","0477","646","211","435","52","698","1347","0","51.82","15.66"
"68","000","00","006","0602","0478","624","226","398","23","647","1261","0","51.31","17.92"
"68","000","00","006","0602","0479","600","212","388","39","639","1256","0","50.88","16.88"
"68","000","00","006","0602","0480","625","281","344","21","646","1370","0","47.15","20.51"
"68","000","00","006","0603","0000","2019","608","1411","92","2111","4617","0","45.72","13.17"
"68","000","00","006","0603","0481","710","207","503","35","745","1610","0","46.27","12.86"
"68","000","00","006","0603","0482","677","197","480","37","714","1419","0","50.32","13.88"
"68","000","00","006","0603","0483","632","204","428","20","652","1588","0","41.06","12.85"
"68","000","00","006","0604","0000","770","265","505","44","814","1612","0","50.5","16.44"
"68","000","00","006","0604","0484","770","265","505","44","814","1612","0","50.5","16.44"
"68","000","00","006","0605","0000","4946","1707","3239","256","5202","10011","0","51.96","17.05"
"68","000","00","006","0605","0485","673","221","452","45","718","1440","0","49.86","15.35"
"68","000","00","006","0605","0486","612","211","401","35","647","1326","0","48.79","15.91"
"68","000","00","006","0605","0487","761","241","520","57","818","1455","0","56.22","16.56"
"68","000","00","006","0605","0488","789","260","529","51","840","1562","0","53.78","16.65"
"68","000","00","006","0605","0489","696","231","465","31","727","1284","0","56.62","17.99"
"68","000","00","006","0605","0490","676","258","418","17","693","1454","0","47.66","17.74"
"68","000","00","006","0605","0491","739","285","454","20","759","1490","0","50.94","19.13"
"68","000","00","006","0606","0000","2257","713","1544","164","2421","4861","0","49.8","14.67"
"68","000","00","006","0606","0492","716","234","482","33","749","1617","0","46.32","14.47"
"68","000","00","006","0606","0493","755","250","505","73","828","1594","0","51.94","15.68"
"68","000","00","006","0606","0494","786","229","557","58","844","1650","0","51.15","13.88"
"68","000","00","006","0607","0000","2795","900","1895","121","2916","5896","0","49.46","15.26"
"68","000","00","006","0607","0495","675","208","467","20","695","1467","0","47.38","14.18"
"68","000","00","006","0607","0496","721","232","489","29","750","1494","0","50.2","15.53"
"68","000","00","006","0607","0497","726","246","480","48","774","1538","0","50.33","15.99"
"68","000","00","006","0607","0498","673","214","459","24","697","1397","0","49.89","15.32"
"68","000","00","006","0608","0000","755","243","512","28","783","1637","0","47.83","14.84"
"68","000","00","006","0608","0499","755","243","512","28","783","1637","0","47.83","14.84"
"68","000","00","006","0610","0000","1450","446","1004","89","1539","2866","0","53.7","15.56"
"68","000","00","006","0610","0500","654","206","448","44","698","1452","0","48.07","14.19"
"68","000","00","006","0610","0501","796","240","556","45","841","1414","0","59.48","16.97"
"68","000","00","006","0611","0000","3103","996","2107","118","3221","6871","0","46.88","14.5"
"68","000","00","006","0611","0502","818","245","573","34","852","1670","0","51.02","14.67"
"68","000","00","006","0611","0503","766","269","497","18","784","1701","0","46.09","15.81"
"68","000","00","006","0611","0504","748","230","518","31","779","1813","0","42.97","12.69"
"68","000","00","006","0611","0505","771","252","519","35","806","1687","0","47.78","14.94"
"68","000","00","006","0612","0000","1684","597","1087","49","1733","3206","0","54.05","18.62"
"68","000","00","006","0612","0506","838","284","554","10","848","1650","0","51.39","17.21"
"68","000","00","006","0612","0507","846","313","533","39","885","1556","0","56.88","20.12"
"68","000","00","006","0613","0000","795","273","522","30","825","1844","0","44.74","14.8"
"68","000","00","006","0613","0508","795","273","522","30","825","1844","0","44.74","14.8"
"68","000","00","006","0614","0000","1321","423","898","117","1438","2750","0","52.29","15.38"
"68","000","00","006","0614","0509","594","191","403","59","653","1336","0","48.88","14.3"
"68","000","00","006","0614","0510","727","232","495","58","785","1414","0","55.52","16.41"
"68","000","00","006","0615","0000","1409","339","1070","77","1486","2465","0","60.28","13.75"
"68","000","00","006","0615","0511","695","221","474","47","742","1238","0","59.94","17.85"
"68","000","00","006","0615","0512","714","118","596","30","744","1227","0","60.64","9.62"
"68","000","00","006","0616","0000","1176","381","795","56","1232","2548","0","48.35","14.95"
"68","000","00","006","0616","0513","580","207","373","24","604","1199","0","50.38","17.26"
"68","000","00","006","0616","0514","596","174","422","32","628","1349","0","46.55","12.9"
"68","000","00","006","0617","0000","1087","357","730","56","1143","2200","0","51.95","16.23"
"68","000","00","006","0617","0515","546","184","362","29","575","1120","0","51.34","16.43"
"68","000","00","006","0617","0516","541","173","368","27","568","1080","0","52.59","16.02"
"68","000","00","006","0618","0000","1309","417","892","60","1369","2686","0","50.97","15.52"
"68","000","00","006","0618","0517","627","194","433","32","659","1341","0","49.14","14.47"
"68","000","00","006","0618","0518","682","223","459","28","710","1345","0","52.79","16.58"
"68","000","00","006","0619","0000","2234","688","1546","114","2348","5214","0","45.03","13.2"
"68","000","00","006","0619","0519","664","203","461","45","709","1565","0","45.3","12.97"
"68","000","00","006","0619","0520","639","215","424","20","659","1519","0","43.38","14.15"
"68","000","00","006","0619","0521","931","270","661","49","980","2130","0","46.01","12.68"
"68","000","00","007","0000","0000","61862","22419","39443","3057","64919","131702","160182","49.29","17.02"
"68","000","00","007","0701","0000","1890","676","1214","79","1969","3735","0","52.72","18.1"
"68","000","00","007","0701","0270","725","266","459","21","746","1455","0","51.27","18.28"
"68","000","00","007","0701","0271","1165","410","755","58","1223","2280","0","53.64","17.98"
"68","000","00","007","0702","0000","3177","982","2195","194","3371","6706","0","50.27","14.64"
"68","000","00","007","0702","0231","1067","336","731","61","1128","2178","0","51.79","15.43"
"68","000","00","007","0702","0232","842","299","543","64","906","1672","0","54.19","17.88"
"68","000","00","007","0702","0233","556","102","454","28","584","1376","0","42.44","7.41"
"68","000","00","007","0702","0234","712","245","467","41","753","1480","0","50.88","16.55"
"68","000","00","007","0703","0000","2017","749","1268","124","2141","4353","0","49.18","17.21"
"68","000","00","007","0703","0261","419","145","274","25","444","841","0","52.79","17.24"
"68","000","00","007","0703","0262","991","404","587","55","1046","2284","0","45.8","17.69"
"68","000","00","007","0703","0263","607","200","407","44","651","1228","0","53.01","16.29"
"68","000","00","007","0704","0000","2842","1044","1798","154","2996","5735","0","52.24","18.2"
"68","000","00","007","0704","0235","660","250","410","36","696","1258","0","55.33","19.87"
"68","000","00","007","0704","0236","725","248","477","24","749","1464","0","51.16","16.94"
"68","000","00","007","0704","0237","868","318","550","73","941","1844","0","51.03","17.25"
"68","000","00","007","0704","0238","589","228","361","21","610","1169","0","52.18","19.5"
"68","000","00","007","0705","0000","1539","514","1025","87","1626","3253","0","49.98","15.8"
"68","000","00","007","0705","0245","882","306","576","41","923","1788","0","51.62","17.11"
"68","000","00","007","0705","0246","657","208","449","46","703","1465","0","47.99","14.2"
"68","000","00","007","0706","0000","2445","836","1609","122","2567","5386","0","47.66","15.52"
"68","000","00","007","0706","0239","730","240","490","40","770","1921","0","40.08","12.49"
"68","000","00","007","0706","0240","780","261","519","34","814","1694","0","48.05","15.41"
"68","000","00","007","0706","0241","935","335","600","48","983","1771","0","55.51","18.92"
"68","000","00","007","0707","0000","1859","467","1392","103","1962","3629","0","54.06","12.87"
"68","000","00","007","0707","0220","902","216","686","43","945","1744","0","54.19","12.39"
"68","000","00","007","0707","0221","957","251","706","60","1017","1885","0","53.95","13.32"
"68","000","00","007","0708","0000","2497","799","1698","112","2609","5033","0","51.84","15.88"
"68","000","00","007","0708","0217","460","131","329","25","485","874","0","55.49","14.99"
"68","000","00","007","0708","0218","1009","275","734","65","1074","2014","0","53.33","13.65"
"68","000","00","007","0708","0219","1028","393","635","22","1050","2145","0","48.95","18.32"
"68","000","00","007","0709","0000","583","208","375","38","621","1156","0","53.72","17.99"
"68","000","00","007","0709","0276","583","208","375","38","621","1156","0","53.72","17.99"
"68","000","00","007","0710","0000","1768","668","1100","79","1847","3553","0","51.98","18.8"
"68","000","00","007","0710","0272","881","347","534","38","919","1668","0","55.1","20.8"
"68","000","00","007","0710","0273","887","321","566","41","928","1885","0","49.23","17.03"
"68","000","00","007","0711","0000","894","721","173","84","978","1840","0","53.15","39.18"
"68","000","00","007","0711","0289","894","721","173","84","978","1840","0","53.15","39.18"
"68","000","00","007","0712","0000","865","290","575","54","919","1917","0","47.94","15.13"
"68","000","00","007","0712","0267","865","290","575","54","919","1917","0","47.94","15.13"
"68","000","00","007","0713","0000","2120","676","1444","141","2261","4707","0","48.03","14.36"
"68","000","00","007","0713","0222","705","248","457","46","751","1546","0","48.58","16.04"
"68","000","00","007","0713","0223","778","300","478","55","833","1684","0","49.47","17.81"
"68","000","00","007","0713","0224","637","128","509","40","677","1477","0","45.84","8.67"
"68","000","00","007","0714","0000","2164","745","1419","160","2324","4832","0","48.1","15.42"
"68","000","00","007","0714","0242","743","258","485","49","792","1665","0","47.57","15.5"
"68","000","00","007","0714","0243","685","251","434","52","737","1439","0","51.22","17.44"
"68","000","00","007","0714","0244","736","236","500","59","795","1728","0","46.01","13.66"
"68","000","00","007","0715","0000","2750","944","1806","172","2922","5448","0","53.63","17.33"
"68","000","00","007","0715","0227","753","246","507","47","800","1525","0","52.46","16.13"
"68","000","00","007","0715","0228","564","201","363","45","609","1041","0","58.5","19.31"
"68","000","00","007","0715","0229","661","239","422","35","696","1404","0","49.57","17.02"
"68","000","00","007","0715","0230","772","258","514","45","817","1478","0","55.28","17.46"
"68","000","00","007","0716","0000","1874","667","1207","152","2026","3952","0","51.27","16.88"
"68","000","00","007","0716","0256","476","165","311","56","532","1005","0","52.94","16.42"
"68","000","00","007","0716","0257","729","256","473","39","768","1449","0","53.0","17.67"
"68","000","00","007","0716","0258","669","246","423","57","726","1498","0","48.46","16.42"
"68","000","00","007","0717","0000","828","272","556","62","890","1752","0","50.8","15.53"
"68","000","00","007","0717","0250","828","272","556","62","890","1752","0","50.8","15.53"
"68","000","00","007","0718","0000","1090","336","754","86","1176","2439","0","48.22","13.78"
"68","000","00","007","0718","0265","606","173","433","38","644","1378","0","46.73","12.55"
"68","000","00","007","0718","0266","484","163","321","48","532","1061","0","50.14","15.36"
"68","000","00","007","0719","0000","1626","611","1015","90","1716","4057","0","42.3","15.06"
"68","000","00","007","0719","0277","830","298","532","48","878","2114","0","41.53","14.1"
"68","000","00","007","0719","0278","796","313","483","42","838","1943","0","43.13","16.11"
"68","000","00","007","0720","0000","2833","1101","1732","101","2934","6056","0","48.45","18.18"
"68","000","00","007","0720","0286","1070","423","647","37","1107","2187","0","50.62","19.34"
"68","000","00","007","0720","0287","907","340","567","42","949","1959","0","48.44","17.36"
"68","000","00","007","0720","0288","856","338","518","22","878","1910","0","45.97","17.7"
"68","000","00","007","0721","0000","1095","352","743","37","1132","2266","0","49.96","15.53"
"68","000","00","007","0721","0290","1095","352","743","37","1132","2266","0","49.96","15.53"
"68","000","00","007","0722","0000","2147","852","1295","93","2240","5170","0","43.33","16.48"
"68","000","00","007","0722","0247","753","311","442","46","799","1659","0","48.16","18.75"
"68","000","00","007","0722","0248","708","278","430","27","735","1693","0","43.41","16.42"
"68","000","00","007","0722","0249","686","263","423","20","706","1818","0","38.83","14.47"
"68","000","00","007","0723","0000","869","268","601","48","917","1979","0","46.34","13.54"
"68","000","00","007","0723","0264","869","268","601","48","917","1979","0","46.34","13.54"
"68","000","00","007","0724","0000","1601","598","1003","40","1641","3317","0","49.47","18.03"
"68","000","00","007","0724","0251","872","341","531","17","889","1818","0","48.9","18.76"
"68","000","00","007","0724","0252","729","257","472","23","752","1499","0","50.17","17.14"
"68","000","00","007","0725","0000","2795","1052","1743","113","2908","5847","0","49.73","17.99"
"68","000","00","007","0725","0253","920","350","570","50","970","1916","0","50.63","18.27"
"68","000","00","007","0725","0254","890","327","563","36","926","1804","0","51.33","18.13"
"68","000","00","007","0725","0255","985","375","610","27","1012","2127","0","47.58","17.63"
"68","000","00","007","0726","0000","1545","546","999","93","1638","3920","0","41.79","13.93"
"68","000","00","007","0726","0259","899","305","594","51","950","2149","0","44.21","14.19"
"68","000","00","007","0726","0260","646","241","405","42","688","1771","0","38.85","13.61"
"68","000","00","007","0727","0000","2444","971","1473","95","2539","5139","0","49.41","18.89"
"68","000","00","007","0727","0279","807","312","495","26","833","1800","0","46.28","17.33"
"68","000","00","007","0727","0280","936","384","552","41","977","2020","0","48.37","19.01"
"68","000","00","007","0727","0281","701","275","426","28","729","1319","0","55.27","20.85"
"68","000","00","007","0728","0000","4094","1583","2511","132","4226","8591","0","49.19","18.43"
"68","000","00","007","0728","0282","1148","436","712","36","1184","2229","0","53.12","19.56"
"68","000","00","007","0728","0283","936","354","582","30","966","1992","0","48.49","17.77"
"68","000","00","007","0728","0284","1015","382","633","41","1056","2237","0","47.21","17.08"
"68","000","00","007","0728","0285","995","411","584","25","1020","2133","0","47.82","19.27"
"68","000","00","007","0729","0000","1823","894","929","32","1855","3553","0","52.21","25.16"
"68","000","00","007","0729","0274","891","432","459","16","907","1849","0","49.05","23.36"
"68","000","00","007","0729","0275","932","462","470","16","948","1704","0","55.63","27.11"
"68","000","00","007","0730","0000","1089","361","728","58","1147","2956","0","38.8","12.21"
"68","000","00","007","0730","0225","814","266","548","42","856","1528","0","56.02","17.41"
"68","000","00","007","0730","0226","275","95","180","16","291","1428","0","20.38","6.65"
"68","000","00","007","0731","0000","3076","1090","1986","68","3144","6452","0","48.73","16.89"
"68","000","00","007","0731","0291","1055","344","711","21","1076","2387","0","45.08","14.41"
"68","000","00","007","0731","0292","798","278","520","19","817","1692","0","48.29","16.43"
"68","000","00","007","0731","0293","453","178","275","13","466","904","0","51.55","19.69"
"68","000","00","007","0731","0294","770","290","480","15","785","1469","0","53.44","19.74"
"68","000","00","007","0732","0000","1623","546","1077","54","1677","2973","0","56.41","18.37"
"68","000","00","007","0732","0268","875","307","568","26","901","1540","0","58.51","19.94"
"68","000","00","007","0732","0269","748","239","509","28","776","1433","0","54.15","16.68"
"68","000","00","008","0000","0000","78896","26246","52650","4541","83437","165065","201493","50.55","15.9"
"68","000","00","008","0801","0000","2778","990","1788","119","2897","7162","0","40.45","13.82"
"68","000","00","008","0801","0295","758","250","508","70","828","1761","0","47.02","14.2"
"68","000","00","008","0801","0296","719","267","452","11","730","1804","0","40.47","14.8"
"68","000","00","008","0801","0297","500","188","312","14","514","1813","0","28.35","10.37"
"68","000","00","008","0801","0298","801","285","516","24","825","1784","0","46.24","15.98"
"68","000","00","008","0802","0000","3584","1153","2431","141","3725","8278","0","45.0","13.93"
"68","000","00","008","0802","0299","943","302","641","24","967","2257","0","42.84","13.38"
"68","000","00","008","0802","0300","760","233","527","33","793","1857","0","42.7","12.55"
"68","000","00","008","0802","0301","942","299","643","34","976","2261","0","43.17","13.22"
"68","000","00","008","0802","0302","939","319","620","50","989","1903","0","51.97","16.76"
"68","000","00","008","0803","0000","1632","547","1085","90","1722","3620","0","47.57","15.11"
"68","000","00","008","0803","0303","914","283","631","69","983","1955","0","50.28","14.48"
"68","000","00","008","0803","0304","718","264","454","21","739","1665","0","44.38","15.86"
"68","000","00","008","0804","0000","1574","495","1079","112","1686","3216","0","52.43","15.39"
"68","000","00","008","0804","0310","844","267","577","59","903","1630","0","55.4","16.38"
"68","000","00","008","0804","0311","730","228","502","53","783","1586","0","49.37","14.38"
"68","000","00","008","0805","0000","1625","495","1130","141","1766","3559","0","49.62","13.91"
"68","000","00","008","0805","0312","809","245","564","63","872","1649","0","52.88","14.86"
"68","000","00","008","0805","0313","816","250","566","78","894","1910","0","46.81","13.09"
"68","000","00","008","0806","0000","1630","472","1158","125","1755","3252","0","53.97","14.51"
"68","000","00","008","0806","0314","829","224","605","72","901","1612","0","55.89","13.9"
"68","000","00","008","0806","0315","801","248","553","53","854","1640","0","52.07","15.12"
"68","000","00","008","0807","0000","1594","503","1091","124","1718","3273","0","52.49","15.37"
"68","000","00","008","0807","0318","828","267","561","44","872","1711","0","50.96","15.6"
"68","000","00","008","0807","0319","766","236","530","80","846","1562","0","54.16","15.11"
"68","000","00","008","0808","0000","2221","701","1520","124","2345","4415","0","53.11","15.88"
"68","000","00","008","0808","0320","837","253","584","47","884","1735","0","50.95","14.58"
"68","000","00","008","0808","0321","820","275","545","28","848","1658","0","51.15","16.59"
"68","000","00","008","0808","0322","564","173","391","49","613","1022","0","59.98","16.93"
"68","000","00","008","0809","0000","1546","510","1036","78","1624","3414","0","47.57","14.94"
"68","000","00","008","0809","0323","719","241","478","46","765","1673","0","45.73","14.41"
"68","000","00","008","0809","0324","827","269","558","32","859","1741","0","49.34","15.45"
"68","000","00","008","0810","0000","1008","307","701","60","1068","2110","0","50.62","14.55"
"68","000","00","008","0810","0325","1008","307","701","60","1068","2110","0","50.62","14.55"
"68","000","00","008","0811","0000","1362","451","911","70","1432","2519","0","56.85","17.9"
"68","000","00","008","0811","0331","725","255","470","31","756","1341","0","56.38","19.02"
"68","000","00","008","0811","0332","637","196","441","39","676","1178","0","57.39","16.64"
"68","000","00","008","0812","0000","1495","511","984","126","1621","3871","0","41.88","13.2"
"68","000","00","008","0812","0335","792","237","555","68","860","1943","0","44.26","12.2"
"68","000","00","008","0812","0336","703","274","429","58","761","1928","0","39.47","14.21"
"68","000","00","008","0813","0000","1479","522","957","87","1566","3147","0","49.76","16.59"
"68","000","00","008","0813","0339","867","313","554","40","907","1947","0","46.58","16.08"
"68","000","00","008","0813","0340","612","209","403","47","659","1200","0","54.92","17.42"
"68","000","00","008","0814","0000","1681","574","1107","121","1802","3883","0","46.41","14.78"
"68","000","00","008","0814","0341","826","270","556","61","887","1895","0","46.81","14.25"
"68","000","00","008","0814","0342","855","304","551","60","915","1988","0","46.03","15.29"
"68","000","00","008","0815","0000","1796","622","1174","102","1898","3410","0","55.66","18.24"
"68","000","00","008","0815","0348","676","219","457","57","733","1317","0","55.66","16.63"
"68","000","00","008","0815","0349","1120","403","717","45","1165","2093","0","55.66","19.25"
"68","000","00","008","0816","0000","1723","566","1157","84","1807","3545","0","50.97","15.97"
"68","000","00","008","0816","0351","854","273","581","52","906","1782","0","50.84","15.32"
"68","000","00","008","0816","0352","869","293","576","32","901","1763","0","51.11","16.62"
"68","000","00","008","0817","0000","3288","1056","2232","172","3460","6933","0","49.91","15.23"
"68","000","00","008","0817","0359","966","331","635","63","1029","1998","0","51.5","16.57"
"68","000","00","008","0817","0360","485","156","329","34","519","916","0","56.66","17.03"
"68","000","00","008","0817","0361","881","281","600","46","927","1943","0","47.71","14.46"
"68","000","00","008","0817","0362","956","288","668","29","985","2076","0","47.45","13.87"
"68","000","00","008","0818","0000","763","292","471","48","811","1505","0","53.89","19.4"
"68","000","00","008","0818","0371","763","292","471","48","811","1505","0","53.89","19.4"
"68","000","00","008","0819","0000","1619","551","1068","114","1733","3303","0","52.47","16.68"
"68","000","00","008","0819","0373","819","304","515","59","878","1618","0","54.26","18.79"
"68","000","00","008","0819","0374","800","247","553","55","855","1685","0","50.74","14.66"
"68","000","00","008","0820","0000","1698","583","1115","100","1798","3716","0","48.39","15.69"
"68","000","00","008","0820","0375","805","297","508","46","851","1835","0","46.38","16.19"
"68","000","00","008","0820","0376","893","286","607","54","947","1881","0","50.35","15.2"
"68","000","00","008","0821","0000","832","271","561","32","864","1766","0","48.92","15.35"
"68","000","00","008","0821","0377","832","271","561","32","864","1766","0","48.92","15.35"
"68","000","00","008","0822","0000","2916","942","1974","140","3056","5083","0","60.12","18.53"
"68","000","00","008","0822","0385","914","311","603","56","970","1685","0","57.57","18.46"
"68","000","00","008","0822","0386","896","320","576","50","946","1748","0","54.12","18.31"
"68","000","00","008","0822","0387","1106","311","795","34","1140","1650","0","69.09","18.85"
"68","000","00","008","0823","0000","1987","687","1300","103","2090","3923","0","53.28","17.51"
"68","000","00","008","0823","0390","967","319","648","56","1023","1841","0","55.57","17.33"
"68","000","00","008","0823","0391","1020","368","652","47","1067","2082","0","51.25","17.68"
"68","000","00","008","0824","0000","1541","467","1074","128","1669","3578","0","46.65","13.05"
"68","000","00","008","0824","0365","697","221","476","65","762","1474","0","51.7","14.99"
"68","000","00","008","0824","0366","160","30","130","15","175","718","0","24.37","4.18"
"68","000","00","008","0824","0367","684","216","468","48","732","1386","0","52.81","15.58"
"68","000","00","008","0825","0000","1309","436","873","74","1383","2483","0","55.7","17.56"
"68","000","00","008","0825","0355","625","224","401","40","665","1170","0","56.84","19.15"
"68","000","00","008","0825","0356","684","212","472","34","718","1313","0","54.68","16.15"
"68","000","00","008","0826","0000","1815","588","1227","77","1892","4169","0","45.38","14.1"
"68","000","00","008","0826","0344","909","306","603","10","919","2061","0","44.59","14.85"
"68","000","00","008","0826","0345","906","282","624","67","973","2108","0","46.16","13.38"
"68","000","00","008","0827","0000","1951","622","1329","104","2055","4015","0","51.18","15.49"
"68","000","00","008","0827","0378","849","260","589","78","927","1817","0","51.02","14.31"
"68","000","00","008","0827","0379","1102","362","740","26","1128","2198","0","51.32","16.47"
"68","000","00","008","0828","0000","2176","690","1486","121","2297","4185","0","54.89","16.49"
"68","000","00","008","0828","0307","836","275","561","48","884","1583","0","55.84","17.37"
"68","000","00","008","0828","0308","647","191","456","37","684","1246","0","54.9","15.33"
"68","000","00","008","0828","0309","693","224","469","36","729","1356","0","53.76","16.52"
"68","000","00","008","0829","0000","1416","451","965","108","1524","2854","0","53.4","15.8"
"68","000","00","008","0829","0363","680","217","463","52","732","1363","0","53.71","15.92"
"68","000","00","008","0829","0364","736","234","502","56","792","1491","0","53.12","15.69"
"68","000","00","008","0830","0000","2046","727","1319","92","2138","3951","0","54.11","18.4"
"68","000","00","008","0830","0382","671","228","443","34","705","1257","0","56.09","18.14"
"68","000","00","008","0830","0383","613","232","381","43","656","1267","0","51.78","18.31"
"68","000","00","008","0830","0384","762","267","495","15","777","1427","0","54.45","18.71"
"68","000","00","008","0831","0000","1560","509","1051","89","1649","3085","0","53.45","16.5"
"68","000","00","008","0831","0388","751","269","482","50","801","1478","0","54.19","18.2"
"68","000","00","008","0831","0389","809","240","569","39","848","1607","0","52.77","14.93"
"68","000","00","008","0832","0000","983","336","647","66","1049","2006","0","52.29","16.75"
"68","000","00","008","0832","0343","983","336","647","66","1049","2006","0","52.29","16.75"
"68","000","00","008","0833","0000","1616","530","1086","80","1696","3543","0","47.87","14.96"
"68","000","00","008","0833","0346","823","263","560","55","878","1862","0","47.15","14.12"
"68","000","00","008","0833","0347","793","267","526","25","818","1681","0","48.66","15.88"
"68","000","00","008","0834","0000","800","261","539","53","853","1499","0","56.9","17.41"
"68","000","00","008","0834","0350","800","261","539","53","853","1499","0","56.9","17.41"
"68","000","00","008","0835","0000","655","214","441","46","701","1436","0","48.82","14.9"
"68","000","00","008","0835","0372","655","214","441","46","701","1436","0","48.82","14.9"
"68","000","00","008","0836","0000","1065","369","696","45","1110","2209","0","50.25","16.7"
"68","000","00","008","0836","0393","1065","369","696","45","1110","2209","0","50.25","16.7"
"68","000","00","008","0837","0000","849","470","379","56","905","1959","0","46.2","23.99"
"68","000","00","008","0837","0392","849","470","379","56","905","1959","0","46.2","23.99"
"68","000","00","008","0838","0000","2062","692","1370","73","2135","4531","0","47.12","15.27"
"68","000","00","008","0838","0328","792","271","521","29","821","1848","0","44.43","14.66"
"68","000","00","008","0838","0329","697","223","474","29","726","1334","0","54.42","16.72"
"68","000","00","008","0838","0330","573","198","375","15","588","1349","0","43.59","14.68"
"68","000","00","008","0839","0000","1420","489","931","83","1503","3075","0","48.88","15.9"
"68","000","00","008","0839","0337","672","233","439","29","701","1403","0","49.96","16.61"
"68","000","00","008","0839","0338","748","256","492","54","802","1672","0","47.97","15.31"
"68","000","00","008","0840","0000","1384","463","921","92","1476","2694","0","54.79","17.19"
"68","000","00","008","0840","0305","729","265","464","54","783","1431","0","54.72","18.52"
"68","000","00","008","0840","0306","655","198","457","38","693","1263","0","54.87","15.68"
"68","000","00","008","0841","0000","1310","476","834","79","1389","2537","0","54.75","18.76"
"68","000","00","008","0841","0353","617","209","408","51","668","1226","0","54.49","17.05"
"68","000","00","008","0841","0354","693","267","426","28","721","1311","0","55.0","20.37"
"68","000","00","008","0842","0000","2030","701","1329","59","2089","3821","0","54.67","18.35"
"68","000","00","008","0842","0380","872","312","560","40","912","1732","0","52.66","18.01"
"68","000","00","008","0842","0381","1158","389","769","19","1177","2089","0","56.34","18.62"
"68","000","00","008","0843","0000","1866","636","1230","81","1947","3864","0","50.39","16.46"
"68","000","00","008","0843","0394","937","313","624","36","973","1864","0","52.2","16.79"
"68","000","00","008","0843","0395","929","323","606","45","974","2000","0","48.7","16.15"
"68","000","00","008","0844","0000","1392","488","904","84","1476","2716","0","54.34","17.97"
"68","000","00","008","0844","0316","621","217","404","39","660","1303","0","50.65","16.65"
"68","000","00","008","0844","0317","771","271","500","45","816","1413","0","57.75","19.18"
"68","000","00","008","0845","0000","1139","303","836","67","1206","2155","0","55.96","14.06"
"68","000","00","008","0845","0326","589","153","436","29","618","1145","0","53.97","13.36"
"68","000","00","008","0845","0327","550","150","400","38","588","1010","0","58.22","14.85"
"68","000","00","008","0846","0000","1974","587","1387","209","2183","4294","0","50.84","13.67"
"68","000","00","008","0846","0368","697","219","478","77","774","1487","0","52.05","14.73"
"68","000","00","008","0846","0369","714","212","502","76","790","1552","0","50.9","13.66"
"68","000","00","008","0846","0370","563","156","407","56","619","1255","0","49.32","12.43"
"68","000","00","008","0847","0000","1401","486","915","89","1490","2836","0","52.54","17.14"
"68","000","00","008","0847","0333","709","247","462","39","748","1374","0","54.44","17.98"
"68","000","00","008","0847","0334","692","239","453","50","742","1462","0","50.75","16.35"
"68","000","00","008","0848","0000","1305","454","851","73","1378","2667","0","51.67","17.02"
"68","000","00","008","0848","0357","628","211","417","26","654","1186","0","55.14","17.79"
"68","000","00","008","0848","0358","677","243","434","47","724","1481","0","48.89","16.41"
"68","000","00","009","0000","0000","51708","15518","36190","2635","54343","101574","122981","53.5","15.28"
"68","000","00","009","0901","0000","2216","677","1539","111","2327","4513","0","51.56","15.0"
"68","000","00","009","0901","1008","735","199","536","28","763","1482","0","51.48","13.43"
"68","000","00","009","0901","1009","733","247","486","38","771","1528","0","50.46","16.16"
"68","000","00","009","0901","1010","748","231","517","45","793","1503","0","52.76","15.37"
"68","000","00","009","0902","0000","2793","939","1854","192","2985","5661","0","52.73","16.59"
"68","000","00","009","0902","1013","873","297","576","76","949","2088","0","45.45","14.22"
"68","000","00","009","0902","1014","1042","290","752","75","1117","1987","0","56.22","14.59"
"68","000","00","009","0902","1015","878","352","526","41","919","1586","0","57.94","22.19"
"68","000","00","009","0903","0000","1816","519","1297","93","1909","4006","0","47.65","12.96"
"68","000","00","009","0903","1018","939","262","677","56","995","2081","0","47.81","12.59"
"68","000","00","009","0903","1019","877","257","620","37","914","1925","0","47.48","13.35"
"68","000","00","009","0904","0000","1496","456","1040","82","1578","3188","0","49.5","14.3"
"68","000","00","009","0904","1064","794","254","540","36","830","1649","0","50.33","15.4"
"68","000","00","009","0904","1065","702","202","500","46","748","1539","0","48.6","13.13"
"68","000","00","009","0906","0000","1771","559","1212","129","1900","3662","0","51.88","15.26"
"68","000","00","009","0906","1022","828","267","561","54","882","1790","0","49.27","14.92"
"68","000","00","009","0906","1023","943","292","651","75","1018","1872","0","54.38","15.6"
"68","000","00","009","0907","0000","2118","637","1481","103","2221","4152","0","53.49","15.34"
"68","000","00","009","0907","1026","725","220","505","33","758","1398","0","54.22","15.74"
"68","000","00","009","0907","1027","660","186","474","31","691","1345","0","51.38","13.83"
"68","000","00","009","0907","1028","733","231","502","39","772","1409","0","54.79","16.39"
"68","000","00","009","0908","0000","315","105","210","15","330","678","0","48.67","15.49"
"68","000","00","009","0908","1071","315","105","210","15","330","678","0","48.67","15.49"
"68","000","00","009","0909","0000","2171","669","1502","114","2285","4282","0","53.36","15.62"
"68","000","00","009","0909","1031","780","232","548","51","831","1597","0","52.04","14.53"
"68","000","00","009","0909","1032","720","228","492","27","747","1410","0","52.98","16.17"
"68","000","00","009","0909","1033","671","209","462","36","707","1275","0","55.45","16.39"
"68","000","00","009","0910","0000","2841","884","1957","97","2938","5372","0","54.69","16.46"
"68","000","00","009","0910","1037","984","301","683","32","1016","1786","0","56.89","16.85"
"68","000","00","009","0910","1038","863","292","571","37","900","1756","0","51.25","16.63"
"68","000","00","009","0910","1039","994","291","703","28","1022","1830","0","55.85","15.9"
"68","000","00","009","0911","0000","1052","337","715","60","1112","1909","0","58.25","17.65"
"68","000","00","009","0911","1034","1052","337","715","60","1112","1909","0","58.25","17.65"
"68","000","00","009","0912","0000","2301","744","1557","118","2419","4369","0","55.37","17.03"
"68","000","00","009","0912","1066","838","263","575","48","886","1541","0","57.5","17.07"
"68","000","00","009","0912","1067","714","242","472","40","754","1375","0","54.84","17.6"
"68","000","00","009","0912","1068","749","239","510","30","779","1453","0","53.61","16.45"
"68","000","00","009","0913","0000","1615","468","1147","86","1701","3597","0","47.29","13.01"
"68","000","00","009","0913","1042","840","246","594","52","892","1805","0","49.42","13.63"
"68","000","00","009","0913","1043","775","222","553","34","809","1792","0","45.15","12.39"
"68","000","00","009","0914","0000","2044","602","1442","109","2153","4268","0","50.45","14.1"
"68","000","00","009","0914","1049","640","174","466","54","694","1297","0","53.51","13.42"
"68","000","00","009","0914","1050","675","198","477","15","690","1407","0","49.04","14.07"
"68","000","00","009","0914","1051","729","230","499","40","769","1564","0","49.17","14.71"
"68","000","00","009","0915","0000","1824","509","1315","90","1914","3485","0","54.92","14.61"
"68","000","00","009","0915","1054","891","250","641","45","936","1721","0","54.39","14.53"
"68","000","00","009","0915","1055","933","259","674","45","978","1764","0","55.44","14.68"
"68","000","00","009","0916","0000","1309","440","869","59","1368","2373","0","57.65","18.54"
"68","000","00","009","0916","1069","566","188","378","43","609","1074","0","56.7","17.5"
"68","000","00","009","0916","1070","743","252","491","16","759","1299","0","58.43","19.4"
"68","000","00","009","0917","0000","770","210","560","53","823","1499","0","54.9","14.01"
"68","000","00","009","0917","1056","770","210","560","53","823","1499","0","54.9","14.01"
"68","000","00","009","0918","0000","965","276","689","48","1013","2151","0","47.09","12.83"
"68","000","00","009","0918","1057","965","276","689","48","1013","2151","0","47.09","12.83"
"68","000","00","009","0919","0000","1689","498","1191","45","1734","2980","0","58.19","16.71"
"68","000","00","009","0919","1058","839","236","603","23","862","1524","0","56.56","15.49"
"68","000","00","009","0919","1059","850","262","588","22","872","1456","0","59.89","17.99"
"68","000","00","009","0920","0000","1320","402","918","105","1425","2784","0","51.19","14.44"
"68","000","00","009","0920","1011","748","234","514","46","794","1568","0","50.64","14.92"
"68","000","00","009","0920","1012","572","168","404","59","631","1216","0","51.89","13.82"
"68","000","00","009","0921","0000","1203","365","838","74","1277","2355","0","54.23","15.5"
"68","000","00","009","0921","1016","595","195","400","32","627","1221","0","51.35","15.97"
"68","000","00","009","0921","1017","608","170","438","42","650","1134","0","57.32","14.99"
"68","000","00","009","0922","0000","2228","678","1550","70","2298","4135","0","55.57","16.4"
"68","000","00","009","0922","1020","1107","331","776","27","1134","2095","0","54.13","15.8"
"68","000","00","009","0922","1021","1121","347","774","43","1164","2040","0","57.06","17.01"
"68","000","00","009","0923","0000","1822","531","1291","118","1940","3518","0","55.14","15.09"
"68","000","00","009","0923","1024","907","280","627","65","972","1726","0","56.32","16.22"
"68","000","00","009","0923","1025","915","251","664","53","968","1792","0","54.02","14.01"
"68","000","00","009","0924","0000","1538","527","1011","61","1599","3012","0","53.09","17.5"
"68","000","00","009","0924","1029","649","233","416","16","665","1362","0","48.83","17.11"
"68","000","00","009","0924","1030","889","294","595","45","934","1650","0","56.61","17.82"
"68","000","00","009","0925","0000","2085","595","1490","98","2183","4026","0","54.22","14.78"
"68","000","00","009","0925","1035","1059","298","761","46","1105","2024","0","54.59","14.72"
"68","000","00","009","0925","1036","1026","297","729","52","1078","2002","0","53.85","14.84"
"68","000","00","009","0926","0000","1778","508","1270","66","1844","3216","0","57.34","15.8"
"68","000","00","009","0926","1040","962","288","674","35","997","1697","0","58.75","16.97"
"68","000","00","009","0926","1041","816","220","596","31","847","1519","0","55.76","14.48"
"68","000","00","009","0927","0000","820","208","612","61","881","1500","0","58.73","13.87"
"68","000","00","009","0927","1044","820","208","612","61","881","1500","0","58.73","13.87"
"68","000","00","009","0928","0000","1948","587","1361","113","2061","3980","0","51.78","14.75"
"68","000","00","009","0928","1046","626","195","431","35","661","1444","0","45.78","13.5"
"68","000","00","009","0928","1047","629","184","445","43","672","1321","0","50.87","13.93"
"68","000","00","009","0928","1048","693","208","485","35","728","1215","0","59.92","17.12"
"68","000","00","009","0929","0000","1111","299","812","97","1208","2340","0","51.62","12.78"
"68","000","00","009","0929","1052","642","173","469","58","700","1317","0","53.15","13.14"
"68","000","00","009","0929","1053","469","126","343","39","508","1023","0","49.66","12.32"
"68","000","00","009","0930","0000","2204","557","1647","49","2253","3746","0","60.14","14.87"
"68","000","00","009","0930","1060","1080","276","804","28","1108","1847","0","59.99","14.94"
"68","000","00","009","0930","1061","1124","281","843","21","1145","1899","0","60.29","14.8"
"68","000","00","009","0931","0000","1866","516","1350","83","1949","3390","0","57.49","15.22"
"68","000","00","009","0931","1062","900","249","651","37","937","1725","0","54.32","14.43"
"68","000","00","009","0931","1063","966","267","699","46","1012","1665","0","60.78","16.04"
"68","000","00","009","0932","0000","679","216","463","36","715","1427","0","50.11","15.14"
"68","000","00","009","0932","1045","679","216","463","36","715","1427","0","50.11","15.14"
"68","000","00","010","0000","0000","93703","29969","63734","4046","97749","183560","225897","53.25","16.33"
"68","000","00","010","1001","0000","2373","796","1577","92","2465","4781","0","51.56","16.65"
"68","000","00","010","1001","0864","815","254","561","23","838","1717","0","48.81","14.79"
"68","000","00","010","1001","0865","686","240","446","35","721","1319","0","54.66","18.2"
"68","000","00","010","1001","0866","872","302","570","34","906","1745","0","51.92","17.31"
"68","000","00","010","1002","0000","2320","796","1524","78","2398","4129","0","58.08","19.28"
"68","000","00","010","1002","0867","905","296","609","38","943","1721","0","54.79","17.2"
"68","000","00","010","1002","0868","650","220","430","22","672","1206","0","55.72","18.24"
"68","000","00","010","1002","0869","765","280","485","18","783","1202","0","65.14","23.29"
"68","000","00","010","1003","0000","2884","1045","1839","77","2961","5256","0","56.34","19.88"
"68","000","00","010","1003","0850","646","234","412","24","670","1044","0","64.18","22.41"
"68","000","00","010","1003","0851","614","217","397","16","630","1124","0","56.05","19.31"
"68","000","00","010","1003","0852","806","288","518","21","827","1517","0","54.52","18.98"
"68","000","00","010","1003","0853","818","306","512","16","834","1571","0","53.09","19.48"
"68","000","00","010","1004","0000","2905","933","1972","150","3055","5442","0","56.14","17.14"
"68","000","00","010","1004","0840","683","200","483","47","730","1307","0","55.85","15.3"
"68","000","00","010","1004","0841","720","229","491","31","751","1337","0","56.17","17.13"
"68","000","00","010","1004","0842","615","211","404","24","639","980","0","65.2","21.53"
"68","000","00","010","1004","0843","887","293","594","48","935","1818","0","51.43","16.12"
"68","000","00","010","1005","0000","2568","880","1688","79","2647","5083","0","52.08","17.31"
"68","000","00","010","1005","0857","852","291","561","26","878","1555","0","56.46","18.71"
"68","000","00","010","1005","0858","949","324","625","33","982","2051","0","47.88","15.8"
"68","000","00","010","1005","0859","767","265","502","20","787","1477","0","53.28","17.94"
"68","000","00","010","1006","0000","1870","687","1183","56","1926","3895","0","49.45","17.64"
"68","000","00","010","1006","0835","976","415","561","40","1016","1901","0","53.45","21.83"
"68","000","00","010","1006","0836","894","272","622","16","910","1994","0","45.64","13.64"
"68","000","00","010","1007","0000","1998","631","1367","83","2081","3585","0","58.05","17.6"
"68","000","00","010","1007","0875","552","189","363","33","585","1010","0","57.92","18.71"
"68","000","00","010","1007","0876","696","228","468","24","720","1261","0","57.1","18.08"
"68","000","00","010","1007","0877","750","214","536","26","776","1314","0","59.06","16.29"
"68","000","00","010","1008","0000","2955","1049","1906","87","3042","6426","0","47.34","16.32"
"68","000","00","010","1008","0883","626","205","421","26","652","2213","0","29.46","9.26"
"68","000","00","010","1008","0884","577","215","362","16","593","949","0","62.49","22.66"
"68","000","00","010","1008","0885","937","336","601","30","967","1621","0","59.65","20.73"
"68","000","00","010","1008","0886","815","293","522","15","830","1643","0","50.52","17.83"
"68","000","00","010","1009","0000","1411","435","976","48","1459","2475","0","58.95","17.58"
"68","000","00","010","1009","0870","672","209","463","33","705","1208","0","58.36","17.3"
"68","000","00","010","1009","0871","739","226","513","15","754","1267","0","59.51","17.84"
"68","000","00","010","1010","0000","2170","662","1508","97","2267","3993","0","56.77","16.58"
"68","000","00","010","1010","0891","591","192","399","23","614","1039","0","59.1","18.48"
"68","000","00","010","1010","0892","745","226","519","32","777","1318","0","58.95","17.15"
"68","000","00","010","1010","0893","834","244","590","42","876","1636","0","53.55","14.91"
"68","000","00","010","1011","0000","2016","607","1409","96","2112","4038","0","52.3","15.03"
"68","000","00","010","1011","0896","669","206","463","47","716","1480","0","48.38","13.92"
"68","000","00","010","1011","0897","696","205","491","19","715","1330","0","53.76","15.41"
"68","000","00","010","1011","0898","651","196","455","30","681","1228","0","55.46","15.96"
"68","000","00","010","1012","0000","2205","679","1526","128","2333","4431","0","52.65","15.32"
"68","000","00","010","1012","0801","713","228","485","46","759","1487","0","51.04","15.33"
"68","000","00","010","1012","0802","721","213","508","43","764","1453","0","52.58","14.66"
"68","000","00","010","1012","0803","771","238","533","39","810","1491","0","54.33","15.96"
"68","000","00","010","1013","0000","2840","1003","1837","115","2955","5762","0","51.28","17.41"
"68","000","00","010","1013","0806","921","419","502","30","951","1921","0","49.51","21.81"
"68","000","00","010","1013","0807","1030","310","720","38","1068","1974","0","54.1","15.7"
"68","000","00","010","1013","0808","889","274","615","47","936","1867","0","50.13","14.68"
"68","000","00","010","1014","0000","2336","659","1677","138","2474","4440","0","55.72","14.84"
"68","000","00","010","1014","0827","519","143","376","48","567","1048","0","54.1","13.65"
"68","000","00","010","1014","0828","663","198","465","39","702","1259","0","55.76","15.73"
"68","000","00","010","1014","0829","542","158","384","23","565","1061","0","53.25","14.89"
"68","000","00","010","1014","0830","612","160","452","28","640","1072","0","59.7","14.93"
"68","000","00","010","1015","0000","1182","339","843","38","1220","2326","0","52.45","14.57"
"68","000","00","010","1015","0820","559","154","405","13","572","1130","0","50.62","13.63"
"68","000","00","010","1015","0821","623","185","438","25","648","1196","0","54.18","15.47"
"68","000","00","010","1016","0000","2457","730","1727","106","2563","5300","0","48.36","13.77"
"68","000","00","010","1016","0824","788","238","550","35","823","1564","0","52.62","15.22"
"68","000","00","010","1016","0825","748","203","545","43","791","1824","0","43.37","11.13"
"68","000","00","010","1016","0826","921","289","632","28","949","1912","0","49.63","15.12"
"68","000","00","010","1017","0000","1419","426","993","78","1497","2780","0","53.85","15.32"
"68","000","00","010","1017","0917","703","216","487","49","752","1385","0","54.3","15.6"
"68","000","00","010","1017","0918","716","210","506","29","745","1395","0","53.41","15.05"
"68","000","00","010","1018","0000","1639","459","1180","70","1709","3342","0","51.14","13.73"
"68","000","00","010","1018","0919","845","225","620","28","873","1711","0","51.02","13.15"
"68","000","00","010","1018","0920","794","234","560","42","836","1631","0","51.26","14.35"
"68","000","00","010","1019","0000","1319","384","935","83","1402","2541","0","55.18","15.11"
"68","000","00","010","1019","0923","588","180","408","35","623","1127","0","55.28","15.97"
"68","000","00","010","1019","0924","731","204","527","48","779","1414","0","55.09","14.43"
"68","000","00","010","1020","0000","1021","259","762","38","1059","1931","0","54.84","13.41"
"68","000","00","010","1020","0922","1021","259","762","38","1059","1931","0","54.84","13.41"
"68","000","00","010","1021","0000","599","203","396","19","618","1110","0","55.68","18.29"
"68","000","00","010","1021","0921","599","203","396","19","618","1110","0","55.68","18.29"
"68","000","00","010","1022","0000","827","230","597","26","853","1609","0","53.01","14.29"
"68","000","00","010","1022","0925","827","230","597","26","853","1609","0","53.01","14.29"
"68","000","00","010","1023","0000","2132","678","1454","160","2292","4199","0","54.58","16.15"
"68","000","00","010","1023","0902","650","225","425","64","714","1243","0","57.44","18.1"
"68","000","00","010","1023","0903","782","243","539","59","841","1590","0","52.89","15.28"
"68","000","00","010","1023","0904","700","210","490","37","737","1366","0","53.95","15.37"
"68","000","00","010","1024","0000","2633","825","1808","187","2820","5390","0","52.32","15.31"
"68","000","00","010","1024","0913","479","142","337","38","517","1052","0","49.14","13.5"
"68","000","00","010","1024","0914","657","216","441","49","706","1154","0","61.18","18.72"
"68","000","00","010","1024","0915","802","251","551","21","823","1645","0","50.03","15.26"
"68","000","00","010","1024","0916","695","216","479","79","774","1539","0","50.29","14.04"
"68","000","00","010","1025","0000","1327","373","954","79","1406","2811","0","50.02","13.27"
"68","000","00","010","1025","0908","652","190","462","52","704","1351","0","52.11","14.06"
"68","000","00","010","1025","0909","675","183","492","27","702","1460","0","48.08","12.53"
"68","000","00","010","1026","0000","2133","647","1486","69","2202","4327","0","50.89","14.95"
"68","000","00","010","1026","0910","893","259","634","31","924","1841","0","50.19","14.07"
"68","000","00","010","1026","0911","703","234","469","16","719","1475","0","48.75","15.86"
"68","000","00","010","1026","0912","537","154","383","22","559","1011","0","55.29","15.23"
"68","000","00","010","1027","0000","1485","466","1019","69","1554","3006","0","51.7","15.5"
"68","000","00","010","1027","0804","660","214","446","44","704","1346","0","52.3","15.9"
"68","000","00","010","1027","0805","825","252","573","25","850","1660","0","51.2","15.18"
"68","000","00","010","1028","0000","3216","1058","2158","146","3362","6483","0","51.86","16.32"
"68","000","00","010","1028","0860","790","254","536","22","812","1501","0","54.1","16.92"
"68","000","00","010","1028","0861","736","248","488","47","783","1405","0","55.73","17.65"
"68","000","00","010","1028","0862","821","252","569","52","873","1656","0","52.72","15.22"
"68","000","00","010","1028","0863","869","304","565","25","894","1921","0","46.54","15.83"
"68","000","00","010","1029","0000","879","254","625","48","927","1788","0","51.85","14.21"
"68","000","00","010","1029","0831","879","254","625","48","927","1788","0","51.85","14.21"
"68","000","00","010","1030","0000","2180","654","1526","124","2304","4320","0","53.33","15.14"
"68","000","00","010","1030","0832","765","221","544","33","798","1510","0","52.85","14.64"
"68","000","00","010","1030","0833","700","213","487","41","741","1403","0","52.82","15.18"
"68","000","00","010","1030","0834","715","220","495","50","765","1407","0","54.37","15.64"
"68","000","00","010","1031","0000","2070","709","1361","85","2155","3761","0","57.3","18.85"
"68","000","00","010","1031","0844","776","275","501","31","807","1463","0","55.16","18.8"
"68","000","00","010","1031","0845","684","231","453","29","713","1213","0","58.78","19.04"
"68","000","00","010","1031","0846","610","203","407","25","635","1085","0","58.53","18.71"
"68","000","00","010","1032","0000","1686","510","1176","61","1747","3217","0","54.31","15.85"
"68","000","00","010","1032","0822","855","255","600","31","886","1685","0","52.58","15.13"
"68","000","00","010","1032","0823","831","255","576","30","861","1532","0","56.2","16.64"
"68","000","00","010","1033","0000","2910","864","2046","114","3024","6014","0","50.28","14.37"
"68","000","00","010","1033","0809","902","257","645","29","931","1786","0","52.13","14.39"
"68","000","00","010","1033","0810","658","195","463","30","688","1634","0","42.11","11.93"
"68","000","00","010","1033","0811","579","170","409","26","605","1080","0","56.02","15.74"
"68","000","00","010","1033","0812","771","242","529","29","800","1514","0","52.84","15.98"
"68","000","00","010","1034","0000","2117","619","1498","121","2238","4262","0","52.51","14.52"
"68","000","00","010","1034","0847","710","182","528","28","738","1458","0","50.62","12.48"
"68","000","00","010","1034","0848","730","209","521","52","782","1408","0","55.54","14.84"
"68","000","00","010","1034","0849","677","228","449","41","718","1396","0","51.43","16.33"
"68","000","00","010","1035","0000","1579","515","1064","60","1639","3094","0","52.97","16.65"
"68","000","00","010","1035","0889","755","249","506","35","790","1577","0","50.1","15.79"
"68","000","00","010","1035","0890","824","266","558","25","849","1517","0","55.97","17.53"
"68","000","00","010","1036","0000","2211","732","1479","85","2296","3806","0","60.33","19.23"
"68","000","00","010","1036","0899","784","280","504","30","814","1377","0","59.11","20.33"
"68","000","00","010","1036","0900","706","234","472","25","731","1198","0","61.02","19.53"
"68","000","00","010","1036","0901","721","218","503","30","751","1231","0","61.01","17.71"
"68","000","00","010","1037","0000","2560","869","1691","101","2661","5039","0","52.81","17.25"
"68","000","00","010","1037","0880","745","240","505","28","773","1399","0","55.25","17.16"
"68","000","00","010","1037","0881","948","353","595","43","991","1968","0","50.36","17.94"
"68","000","00","010","1037","0882","867","276","591","30","897","1672","0","53.65","16.51"
"68","000","00","010","1038","0000","1995","602","1393","86","2081","4201","0","49.54","14.33"
"68","000","00","010","1038","0905","684","198","486","37","721","1332","0","54.13","14.86"
"68","000","00","010","1038","0906","561","169","392","20","581","1201","0","48.38","14.07"
"68","000","00","010","1038","0907","750","235","515","29","779","1668","0","46.7","14.09"
"68","000","00","010","1039","0000","1518","484","1034","47","1565","2790","0","56.09","17.35"
"68","000","00","010","1039","0894","714","243","471","31","745","1316","0","56.61","18.47"
"68","000","00","010","1039","0895","804","241","563","16","820","1474","0","55.63","16.35"
"68","000","00","010","1040","0000","814","273","541","55","869","1561","0","55.67","17.49"
"68","000","00","010","1040","0878","387","122","265","34","421","722","0","58.31","16.9"
"68","000","00","010","1040","0879","427","151","276","21","448","839","0","53.4","18.0"
"68","000","00","010","1041","0000","2106","758","1348","75","2181","3703","0","58.9","20.47"
"68","000","00","010","1041","0872","590","197","393","20","610","1094","0","55.76","18.01"
"68","000","00","010","1041","0873","779","276","503","42","821","1394","0","58.9","19.8"
"68","000","00","010","1041","0874","737","285","452","13","750","1215","0","61.73","23.46"
"68","000","00","010","1042","0000","2754","945","1809","91","2845","4896","0","58.11","19.3"
"68","000","00","010","1042","0854","960","330","630","30","990","1752","0","56.51","18.84"
"68","000","00","010","1042","0855","836","280","556","33","869","1434","0","60.6","19.53"
"68","000","00","010","1042","0856","958","335","623","28","986","1710","0","57.66","19.59"
"68","000","00","010","1043","0000","2776","934","1842","85","2861","5358","0","53.4","17.43"
"68","000","00","010","1043","0837","870","288","582","36","906","1730","0","52.37","16.65"
"68","000","00","010","1043","0838","978","343","635","32","1010","1905","0","53.02","18.01"
"68","000","00","010","1043","0839","928","303","625","17","945","1723","0","54.85","17.59"
"68","000","00","010","1044","0000","1896","676","1220","64","1960","3596","0","54.51","18.8"
"68","000","00","010","1044","0887","980","360","620","32","1012","1844","0","54.88","19.52"
"68","000","00","010","1044","0888","916","316","600","32","948","1752","0","54.11","18.04"
"68","000","00","010","1045","0000","2199","676","1523","148","2347","4767","0","49.23","14.18"
"68","000","00","010","1045","0813","842","268","574","41","883","1918","0","46.04","13.97"
"68","000","00","010","1045","0814","581","175","406","78","659","1182","0","55.75","14.81"
"68","000","00","010","1045","0815","776","233","543","29","805","1667","0","48.29","13.98"
"68","000","00","010","1046","0000","3213","956","2257","104","3317","6496","0","51.06","14.72"
"68","000","00","010","1046","0816","730","228","502","32","762","1640","0","46.46","13.9"
"68","000","00","010","1046","0817","802","253","549","24","826","1603","0","51.53","15.78"
"68","000","00","010","1046","0818","856","236","620","18","874","1556","0","56.17","15.17"
"68","000","00","010","1046","0819","825","239","586","30","855","1697","0","50.38","14.08"
"68","000","00","011","0000","0000","21610","6408","15202","1394","23004","41461","49159","55.48","15.46"
"68","000","00","011","1101","0000","1568","501","1067","65","1633","2862","0","57.06","17.51"
"68","000","00","011","1101","1072","751","232","519","22","773","1306","0","59.19","17.76"
"68","000","00","011","1101","1073","817","269","548","43","860","1556","0","55.27","17.29"
"68","000","00","011","1102","0000","2121","596","1525","119","2240","3945","0","56.78","15.11"
"68","000","00","011","1102","1074","960","213","747","56","1016","1849","0","54.95","11.52"
"68","000","00","011","1102","1075","1161","383","778","63","1224","2096","0","58.4","18.27"
"68","000","00","011","1103","0000","744","211","533","54","798","1517","0","52.6","13.91"
"68","000","00","011","1103","1076","744","211","533","54","798","1517","0","52.6","13.91"
"68","000","00","011","1104","0000","1937","604","1333","110","2047","3951","0","51.81","15.29"
"68","000","00","011","1104","1077","1121","339","782","63","1184","2095","0","56.52","16.18"
"68","000","00","011","1104","1078","816","265","551","47","863","1856","0","46.5","14.28"
"68","000","00","011","1105","0000","2213","657","1556","117","2330","4024","0","57.9","16.33"
"68","000","00","011","1105","1086","1096","317","779","42","1138","1992","0","57.13","15.91"
"68","000","00","011","1105","1087","1117","340","777","75","1192","2032","0","58.66","16.73"
"68","000","00","011","1106","0000","1378","431","947","85","1463","2542","0","57.55","16.96"
"68","000","00","011","1106","1082","732","239","493","49","781","1271","0","61.45","18.8"
"68","000","00","011","1106","1083","646","192","454","36","682","1271","0","53.66","15.11"
"68","000","00","011","1107","0000","1223","399","824","92","1315","2319","0","56.71","17.21"
"68","000","00","011","1107","1084","668","211","457","40","708","1234","0","57.37","17.1"
"68","000","00","011","1107","1085","555","188","367","52","607","1085","0","55.94","17.33"
"68","000","00","011","1108","0000","653","192","461","30","683","1385","0","49.31","13.86"
"68","000","00","011","1108","1081","653","192","461","30","683","1385","0","49.31","13.86"
"68","000","00","011","1109","0000","639","188","451","64","703","1425","0","49.33","13.19"
"68","000","00","011","1109","1080","639","188","451","64","703","1425","0","49.33","13.19"
"68","000","00","011","1110","0000","1050","306","744","44","1094","1986","0","55.09","15.41"
"68","000","00","011","1110","1079","1050","306","744","44","1094","1986","0","55.09","15.41"
"68","000","00","011","1111","0000","397","112","285","29","426","741","0","57.49","15.11"
"68","000","00","011","1111","1098","397","112","285","29","426","741","0","57.49","15.11"
"68","000","00","011","1112","0000","789","203","586","83","872","1714","0","50.88","11.84"
"68","000","00","011","1112","1100","789","203","586","83","872","1714","0","50.88","11.84"
"68","000","00","011","1113","0000","528","174","354","54","582","943","0","61.72","18.45"
"68","000","00","011","1113","1099","528","174","354","54","582","943","0","61.72","18.45"
"68","000","00","011","1114","0000","720","201","519","27","747","1340","0","55.75","15.0"
"68","000","00","011","1114","1101","720","201","519","27","747","1340","0","55.75","15.0"
"68","000","00","011","1115","0000","454","121","333","47","501","995","0","50.35","12.16"
"68","000","00","011","1115","1097","454","121","333","47","501","995","0","50.35","12.16"
"68","000","00","011","1116","0000","1263","361","902","77","1340","2265","0","59.16","15.94"
"68","000","00","011","1116","1095","495","131","364","25","520","896","0","58.04","14.62"
"68","000","00","011","1116","1096","768","230","538","52","820","1369","0","59.9","16.8"
"68","000","00","011","1117","0000","605","168","437","63","668","1050","0","63.62","16.0"
"68","000","00","011","1117","1094","605","168","437","63","668","1050","0","63.62","16.0"
"68","000","00","011","1118","0000","377","122","255","31","408","663","0","61.54","18.4"
"68","000","00","011","1118","1092","377","122","255","31","408","663","0","61.54","18.4"
"68","000","00","011","1119","0000","469","147","322","17","486","908","0","53.52","16.19"
"68","000","00","011","1119","1091","469","147","322","17","486","908","0","53.52","16.19"
"68","000","00","011","1120","0000","541","152","389","47","588","1088","0","54.04","13.97"
"68","000","00","011","1120","1093","541","152","389","47","588","1088","0","54.04","13.97"
"68","000","00","011","1121","0000","603","163","440","44","647","1106","0","58.5","14.74"
"68","000","00","011","1121","1090","603","163","440","44","647","1106","0","58.5","14.74"
"68","000","00","011","1122","0000","652","197","455","57","709","1291","0","54.92","15.26"
"68","000","00","011","1122","1088","652","197","455","57","709","1291","0","54.92","15.26"
"68","000","00","011","1123","0000","686","202","484","38","724","1401","0","51.68","14.42"
"68","000","00","011","1123","1089","686","202","484","38","724","1401","0","51.68","14.42"
"68","000","00","012","0000","0000","26145","8475","17670","1647","27792","55149","67208","50.39","15.37"
"68","000","00","012","1201","0000","1188","382","806","66","1254","2733","0","45.88","13.98"
"68","000","00","012","1201","1102","628","196","432","40","668","1371","0","48.72","14.3"
"68","000","00","012","1201","1103","560","186","374","26","586","1362","0","43.02","13.66"
"68","000","00","012","1202","0000","473","167","306","61","534","997","0","53.56","16.75"
"68","000","00","012","1202","1104","473","167","306","61","534","997","0","53.56","16.75"
"68","000","00","012","1203","0000","637","199","438","34","671","1407","0","47.69","14.14"
"68","000","00","012","1203","1105","637","199","438","34","671","1407","0","47.69","14.14"
"68","000","00","012","1204","0000","864","283","581","31","895","1692","0","52.9","16.73"
"68","000","00","012","1204","1106","864","283","581","31","895","1692","0","52.9","16.73"
"68","000","00","012","1205","0000","478","149","329","28","506","892","0","56.73","16.7"
"68","000","00","012","1205","1109","478","149","329","28","506","892","0","56.73","16.7"
"68","000","00","012","1206","0000","1036","311","725","45","1081","2070","0","52.22","15.02"
"68","000","00","012","1206","1107","634","179","455","32","666","1279","0","52.07","14.0"
"68","000","00","012","1206","1108","402","132","270","13","415","791","0","52.47","16.69"
"68","000","00","012","1207","0000","503","140","363","29","532","886","0","60.05","15.8"
"68","000","00","012","1207","1110","503","140","363","29","532","886","0","60.05","15.8"
"68","000","00","012","1208","0000","358","111","247","39","397","712","0","55.76","15.59"
"68","000","00","012","1208","1111","358","111","247","39","397","712","0","55.76","15.59"
"68","000","00","012","1209","0000","737","230","507","76","813","1609","0","50.53","14.29"
"68","000","00","012","1209","1112","737","230","507","76","813","1609","0","50.53","14.29"
"68","000","00","012","1210","0000","1220","387","833","82","1302","2625","0","49.6","14.74"
"68","000","00","012","1210","1113","653","213","440","52","705","1274","0","55.34","16.72"
"68","000","00","012","1210","1114","567","174","393","30","597","1351","0","44.19","12.88"
"68","000","00","012","1211","0000","1343","449","894","91","1434","2504","0","57.27","17.93"
"68","000","00","012","1211","1115","684","239","445","43","727","1262","0","57.61","18.94"
"68","000","00","012","1211","1116","659","210","449","48","707","1242","0","56.92","16.91"
"68","000","00","012","1212","0000","1520","541","979","90","1610","3074","0","52.37","17.6"
"68","000","00","012","1212","1117","721","252","469","51","772","1461","0","52.84","17.25"
"68","000","00","012","1212","1118","799","289","510","39","838","1613","0","51.95","17.92"
"68","000","00","012","1213","0000","770","231","539","44","814","1479","0","55.04","15.62"
"68","000","00","012","1213","1119","770","231","539","44","814","1479","0","55.04","15.62"
"68","000","00","012","1214","0000","2198","748","1450","137","2335","4760","0","49.05","15.71"
"68","000","00","012","1214","1120","673","223","450","62","735","1552","0","47.36","14.37"
"68","000","00","012","1214","1121","734","251","483","30","764","1517","0","50.36","16.55"
"68","000","00","012","1214","1122","791","274","517","45","836","1691","0","49.44","16.2"
"68","000","00","012","1215","0000","1921","616","1305","90","2011","3762","0","53.46","16.37"
"68","000","00","012","1215","1123","641","219","422","13","654","1157","0","56.53","18.93"
"68","000","00","012","1215","1124","701","228","473","47","748","1455","0","51.41","15.67"
"68","000","00","012","1215","1125","579","169","410","30","609","1150","0","52.96","14.7"
"68","000","00","012","1216","0000","1179","367","812","67","1246","2363","0","52.73","15.53"
"68","000","00","012","1216","1126","577","187","390","49","626","1112","0","56.29","16.82"
"68","000","00","012","1216","1127","602","180","422","18","620","1251","0","49.56","14.39"
"68","000","00","012","1217","0000","1398","469","929","172","1570","2939","0","53.42","15.96"
"68","000","00","012","1217","1128","710","222","488","70","780","1446","0","53.94","15.35"
"68","000","00","012","1217","1129","688","247","441","102","790","1493","0","52.91","16.54"
"68","000","00","012","1218","0000","1267","410","857","106","1373","2476","0","55.45","16.56"
"68","000","00","012","1218","1130","638","213","425","67","705","1339","0","52.65","15.91"
"68","000","00","012","1218","1131","629","197","432","39","668","1137","0","58.75","17.33"
"68","000","00","012","1219","0000","491","142","349","38","529","1043","0","50.72","13.61"
"68","000","00","012","1219","1132","491","142","349","38","529","1043","0","50.72","13.61"
"68","000","00","012","1220","0000","903","315","588","54","957","1968","0","48.63","16.01"
"68","000","00","012","1220","1133","435","159","276","28","463","993","0","46.63","16.01"
"68","000","00","012","1220","1134","468","156","312","26","494","975","0","50.67","16.0"
"68","000","00","012","1221","0000","782","282","500","37","819","2029","0","40.36","13.9"
"68","000","00","012","1221","1135","782","282","500","37","819","2029","0","40.36","13.9"
"68","000","00","012","1222","0000","1403","467","936","96","1499","3802","0","39.43","12.28"
"68","000","00","012","1222","1139","755","241","514","55","810","1870","0","43.32","12.89"
"68","000","00","012","1222","1140","648","226","422","41","689","1932","0","35.66","11.7"
"68","000","00","012","1223","0000","798","253","545","25","823","1884","0","43.68","13.43"
"68","000","00","012","1223","1141","384","114","270","10","394","899","0","43.83","12.68"
"68","000","00","012","1223","1142","414","139","275","15","429","985","0","43.55","14.11"
"68","000","00","012","1224","0000","2678","826","1852","109","2787","5443","0","51.2","15.18"
"68","000","00","012","1224","1136","922","294","628","41","963","1765","0","54.56","16.66"
"68","000","00","012","1224","1137","886","287","599","34","920","1809","0","50.86","15.87"
"68","000","00","012","1224","1138","870","245","625","34","904","1869","0","48.37","13.11"
"68","000","00","013","0000","0000","5025","984","4041","294","5319","9766","11997","54.46","10.08"
"68","000","00","013","1301","0000","1034","210","824","82","1116","1991","0","56.05","10.55"
"68","000","00","013","1301","0581","1034","210","824","82","1116","1991","0","56.05","10.55"
"68","000","00","013","1302","0000","748","142","606","52","800","1392","0","57.47","10.2"
"68","000","00","013","1302","0582","748","142","606","52","800","1392","0","57.47","10.2"
"68","000","00","013","1303","0000","372","82","290","18","390","716","0","54.47","11.45"
"68","000","00","013","1303","0584","372","82","290","18","390","716","0","54.47","11.45"
"68","000","00","013","1304","0000","296","67","229","18","314","564","0","55.67","11.88"
"68","000","00","013","1304","0583","296","67","229","18","314","564","0","55.67","11.88"
"68","000","00","013","1305","0000","292","90","202","14","306","669","0","45.74","13.45"
"68","000","00","013","1305","0586","292","90","202","14","306","669","0","45.74","13.45"
"68","000","00","013","1306","0000","259","41","218","6","265","683","0","38.8","6.0"
"68","000","00","013","1306","0589","259","41","218","6","265","683","0","38.8","6.0"
"68","000","00","013","1307","0000","372","72","300","13","385","760","0","50.66","9.47"
"68","000","00","013","1307","0587","372","72","300","13","385","760","0","50.66","9.47"
"68","000","00","013","1308","0000","652","89","563","31","683","1224","0","55.8","7.27"
"68","000","00","013","1308","0590","652","89","563","31","683","1224","0","55.8","7.27"
"68","000","00","013","1309","0000","600","134","466","44","644","1016","0","63.39","13.19"
"68","000","00","013","1309","0585","600","134","466","44","644","1016","0","63.39","13.19"
"68","000","00","013","1310","0000","400","57","343","16","416","751","0","55.39","7.59"
"68","000","00","013","1310","0588","400","57","343","16","416","751","0","55.39","7.59"
"66","000","00","000","0000","0000","1261852","411320","850532","71273","1333125","2295642","2799254","58.07","17.92"
"66","000","00","001","0000","0000","7755","2487","5268","485","8240","14696","18557","56.07","16.92"
"66","000","00","001","0101","0000","773","222","551","47","820","1531","0","53.56","14.5"
"66","000","00","001","0101","1071","773","222","551","47","820","1531","0","53.56","14.5"
"66","000","00","001","0102","0000","1093","395","698","86","1179","2046","0","57.62","19.31"
"66","000","00","001","0102","1075","636","224","412","50","686","1191","0","57.6","18.81"
"66","000","00","001","0102","1076","457","171","286","36","493","855","0","57.66","20.0"
"66","000","00","001","0103","0000","946","344","602","79","1025","1652","0","62.05","20.82"
"66","000","00","001","0103","1070","946","344","602","79","1025","1652","0","62.05","20.82"
"66","000","00","001","0104","0000","783","215","568","27","810","1431","0","56.6","15.02"
"66","000","00","001","0104","1072","783","215","568","27","810","1431","0","56.6","15.02"
"66","000","00","001","0105","0000","1095","332","763","73","1168","2042","0","57.2","16.26"
"66","000","00","001","0105","1073","577","171","406","39","616","1060","0","58.11","16.13"
"66","000","00","001","0105","1074","518","161","357","34","552","982","0","56.21","16.4"
"66","000","00","001","0106","0000","923","271","652","44","967","1840","0","52.55","14.73"
"66","000","00","001","0106","1077","515","161","354","28","543","1135","0","47.84","14.19"
"66","000","00","001","0106","1078","408","110","298","16","424","705","0","60.14","15.6"
"66","000","00","001","0107","0000","1241","416","825","98","1339","2313","0","57.89","17.99"
"66","000","00","001","0107","1079","579","184","395","32","611","1009","0","60.56","18.24"
"66","000","00","001","0107","1080","662","232","430","66","728","1304","0","55.83","17.79"
"66","000","00","001","0108","0000","901","292","609","31","932","1841","0","50.62","15.86"
"66","000","00","001","0108","1081","901","292","609","31","932","1841","0","50.62","15.86"
"66","000","00","002","0000","0000","35703","11829","23874","2239","37942","64291","76070","59.02","18.4"
"66","000","00","002","0201","0000","1486","507","979","64","1550","2999","0","51.68","16.91"
"66","000","00","002","0201","1148","432","168","264","17","449","1138","0","39.46","14.76"
"66","000","00","002","0201","1149","560","184","376","19","579","984","0","58.84","18.7"
"66","000","00","002","0201","1150","494","155","339","28","522","877","0","59.52","17.67"
"66","000","00","002","0202","0000","1794","601","1193","140","1934","3129","0","61.81","19.21"
"66","000","00","002","0202","1151","630","223","407","39","669","1070","0","62.52","20.84"
"66","000","00","002","0202","1152","639","213","426","48","687","1106","0","62.12","19.26"
"66","000","00","002","0202","1153","525","165","360","53","578","953","0","60.65","17.31"
"66","000","00","002","0203","0000","2037","654","1383","116","2153","3636","0","59.21","17.99"
"66","000","00","002","0203","1154","699","220","479","34","733","1195","0","61.34","18.41"
"66","000","00","002","0203","1155","680","211","469","33","713","1251","0","56.99","16.87"
"66","000","00","002","0203","1156","658","223","435","49","707","1190","0","59.41","18.74"
"66","000","00","002","0204","0000","1569","540","1029","117","1686","2837","0","59.43","19.03"
"66","000","00","002","0204","1157","737","255","482","56","793","1394","0","56.89","18.29"
"66","000","00","002","0204","1158","832","285","547","61","893","1443","0","61.88","19.75"
"66","000","00","002","0205","0000","1134","379","755","99","1233","1966","0","62.72","19.28"
"66","000","00","002","0205","1161","680","218","462","70","750","1211","0","61.93","18.0"
"66","000","00","002","0205","1162","454","161","293","29","483","755","0","63.97","21.32"
"66","000","00","002","0206","0000","1114","355","759","73","1187","1902","0","62.41","18.66"
"66","000","00","002","0206","1159","418","121","297","36","454","762","0","59.58","15.88"
"66","000","00","002","0206","1160","696","234","462","37","733","1140","0","64.3","20.53"
"66","000","00","002","0207","0000","1313","423","890","84","1397","2491","0","56.08","16.98"
"66","000","00","002","0207","1163","779","261","518","63","842","1491","0","56.47","17.51"
"66","000","00","002","0207","1164","534","162","372","21","555","1000","0","55.5","16.2"
"66","000","00","002","0208","0000","1241","424","817","81","1322","2215","0","59.68","19.14"
"66","000","00","002","0208","1165","634","225","409","48","682","1114","0","61.22","20.2"
"66","000","00","002","0208","1166","607","199","408","33","640","1101","0","58.13","18.07"
"66","000","00","002","0209","0000","3775","1291","2484","235","4010","6563","0","61.1","19.67"
"66","000","00","002","0209","1167","712","234","478","49","761","1169","0","65.1","20.02"
"66","000","00","002","0209","1168","740","235","505","73","813","1283","0","63.37","18.32"
"66","000","00","002","0209","1169","709","229","480","32","741","1168","0","63.44","19.61"
"66","000","00","002","0209","1170","733","248","485","38","771","1386","0","55.63","17.89"
"66","000","00","002","0209","1171","881","345","536","43","924","1557","0","59.34","22.16"
"66","000","00","002","0210","0000","2651","941","1710","156","2807","4658","0","60.26","20.2"
"66","000","00","002","0210","1172","754","264","490","58","812","1380","0","58.84","19.13"
"66","000","00","002","0210","1173","937","328","609","58","995","1674","0","59.44","19.59"
"66","000","00","002","0210","1174","960","349","611","40","1000","1604","0","62.34","21.76"
"66","000","00","002","0211","0000","2192","696","1496","116","2308","3743","0","61.66","18.59"
"66","000","00","002","0211","1179","729","208","521","32","761","1252","0","60.78","16.61"
"66","000","00","002","0211","1180","748","275","473","48","796","1250","0","63.68","22.0"
"66","000","00","002","0211","1181","715","213","502","36","751","1241","0","60.52","17.16"
"66","000","00","002","0212","0000","1345","459","886","107","1452","2606","0","55.72","17.61"
"66","000","00","002","0212","1182","668","246","422","42","710","1318","0","53.87","18.66"
"66","000","00","002","0212","1183","677","213","464","65","742","1288","0","57.61","16.54"
"66","000","00","002","0213","0000","2319","712","1607","159","2478","4096","0","60.5","17.38"
"66","000","00","002","0213","1184","847","267","580","55","902","1442","0","62.55","18.52"
"66","000","00","002","0213","1185","670","215","455","50","720","1202","0","59.9","17.89"
"66","000","00","002","0213","1186","802","230","572","54","856","1452","0","58.95","15.84"
"66","000","00","002","0214","0000","848","242","606","42","890","1693","0","52.57","14.29"
"66","000","00","002","0214","1190","848","242","606","42","890","1693","0","52.57","14.29"
"66","000","00","002","0215","0000","2231","674","1557","104","2335","4083","0","57.19","16.51"
"66","000","00","002","0215","1187","804","264","540","39","843","1480","0","56.96","17.84"
"66","000","00","002","0215","1188","969","259","710","31","1000","1736","0","57.6","14.92"
"66","000","00","002","0215","1189","458","151","307","34","492","867","0","56.75","17.42"
"66","000","00","002","0216","0000","4915","1648","3267","319","5234","8717","0","60.04","18.91"
"66","000","00","002","0216","1191","881","282","599","70","951","1538","0","61.83","18.34"
"66","000","00","002","0216","1192","909","315","594","101","1010","1593","0","63.4","19.77"
"66","000","00","002","0216","1193","784","265","519","25","809","1481","0","54.63","17.89"
"66","000","00","002","0216","1194","828","287","541","45","873","1414","0","61.74","20.3"
"66","000","00","002","0216","1195","730","251","479","30","760","1297","0","58.6","19.35"
"66","000","00","002","0216","1196","783","248","535","48","831","1394","0","59.61","17.79"
"66","000","00","002","0217","0000","3739","1283","2456","227","3966","6957","0","57.01","18.44"
"66","000","00","002","0217","1175","1042","377","665","52","1094","1815","0","60.28","20.77"
"66","000","00","002","0217","1176","907","298","609","55","962","1700","0","56.59","17.53"
"66","000","00","002","0217","1177","847","280","567","58","905","1592","0","56.85","17.59"
"66","000","00","002","0217","1178","943","328","615","62","1005","1850","0","54.32","17.73"
"66","000","00","003","0000","0000","60367","20975","39392","3321","63688","103643","125726","61.45","20.24"
"66","000","00","003","0301","0000","2072","697","1375","166","2238","3607","0","62.05","19.32"
"66","000","00","003","0301","1201","655","237","418","67","722","1130","0","63.89","20.97"
"66","000","00","003","0301","1202","727","220","507","57","784","1239","0","63.28","17.76"
"66","000","00","003","0301","1203","690","240","450","42","732","1238","0","59.13","19.39"
"66","000","00","003","0302","0000","2197","772","1425","171","2368","3862","0","61.32","19.99"
"66","000","00","003","0302","1204","735","254","481","54","789","1272","0","62.03","19.97"
"66","000","00","003","0302","1205","727","251","476","45","772","1273","0","60.64","19.72"
"66","000","00","003","0302","1206","735","267","468","72","807","1317","0","61.28","20.27"
"66","000","00","003","0303","0000","2153","822","1331","126","2279","3476","0","65.56","23.65"
"66","000","00","003","0303","1207","763","278","485","33","796","1160","0","68.62","23.97"
"66","000","00","003","0303","1208","737","290","447","54","791","1205","0","65.64","24.07"
"66","000","00","003","0303","1209","653","254","399","39","692","1111","0","62.29","22.86"
"66","000","00","003","0304","0000","1670","617","1053","87","1757","2826","0","62.17","21.83"
"66","000","00","003","0304","1210","853","338","515","48","901","1407","0","64.04","24.02"
"66","000","00","003","0304","1211","817","279","538","39","856","1419","0","60.32","19.66"
"66","000","00","003","0305","0000","1483","510","973","84","1567","2572","0","60.93","19.83"
"66","000","00","003","0305","1212","695","237","458","44","739","1157","0","63.87","20.48"
"66","000","00","003","0305","1213","788","273","515","40","828","1415","0","58.52","19.29"
"66","000","00","003","0306","0000","1639","553","1086","85","1724","2743","0","62.85","20.16"
"66","000","00","003","0306","1214","802","263","539","49","851","1289","0","66.02","20.4"
"66","000","00","003","0306","1215","837","290","547","36","873","1454","0","60.04","19.94"
"66","000","00","003","0307","0000","2439","868","1571","124","2563","4315","0","59.4","20.12"
"66","000","00","003","0307","1216","824","276","548","43","867","1491","0","58.15","18.51"
"66","000","00","003","0307","1217","810","286","524","25","835","1394","0","59.9","20.52"
"66","000","00","003","0307","1218","805","306","499","56","861","1430","0","60.21","21.4"
"66","000","00","003","0308","0000","2274","797","1477","216","2490","3836","0","64.91","20.78"
"66","000","00","003","0308","1219","741","267","474","101","842","1342","0","62.74","19.9"
"66","000","00","003","0308","1220","804","272","532","78","882","1304","0","67.64","20.86"
"66","000","00","003","0308","1221","729","258","471","37","766","1190","0","64.37","21.68"
"66","000","00","003","0309","0000","3116","1058","2058","186","3302","5320","0","62.07","19.89"
"66","000","00","003","0309","1222","703","203","500","52","755","1273","0","59.31","15.95"
"66","000","00","003","0309","1223","854","296","558","51","905","1387","0","65.25","21.34"
"66","000","00","003","0309","1224","786","292","494","33","819","1356","0","60.4","21.53"
"66","000","00","003","0309","1225","773","267","506","50","823","1304","0","63.11","20.48"
"66","000","00","003","0310","0000","2169","744","1425","115","2284","3842","0","59.45","19.36"
"66","000","00","003","0310","1230","743","218","525","55","798","1308","0","61.01","16.67"
"66","000","00","003","0310","1231","708","257","451","36","744","1250","0","59.52","20.56"
"66","000","00","003","0310","1232","718","269","449","24","742","1284","0","57.79","20.95"
"66","000","00","003","0311","0000","4574","1622","2952","206","4780","7672","0","62.3","21.14"
"66","000","00","003","0311","1240","1019","344","675","31","1050","1643","0","63.91","20.94"
"66","000","00","003","0311","1241","844","304","540","49","893","1423","0","62.75","21.36"
"66","000","00","003","0311","1242","875","292","583","46","921","1542","0","59.73","18.94"
"66","000","00","003","0311","1243","905","337","568","24","929","1533","0","60.6","21.98"
"66","000","00","003","0311","1244","931","345","586","56","987","1531","0","64.47","22.53"
"66","000","00","003","0312","0000","6089","2046","4043","326","6415","10764","0","59.6","19.01"
"66","000","00","003","0312","1248","933","307","626","49","982","1799","0","54.59","17.07"
"66","000","00","003","0312","1249","1029","331","698","59","1088","1708","0","63.7","19.38"
"66","000","00","003","0312","1250","911","305","606","60","971","1700","0","57.12","17.94"
"66","000","00","003","0312","1251","1062","322","740","30","1092","1751","0","62.36","18.39"
"66","000","00","003","0312","1252","1202","447","755","64","1266","2109","0","60.03","21.19"
"66","000","00","003","0312","1253","952","334","618","64","1016","1697","0","59.87","19.68"
"66","000","00","003","0313","0000","4906","1608","3298","234","5140","7918","0","64.92","20.31"
"66","000","00","003","0313","1258","749","260","489","55","804","1274","0","63.11","20.41"
"66","000","00","003","0313","1259","886","287","599","35","921","1390","0","66.26","20.65"
"66","000","00","003","0313","1260","823","262","561","27","850","1295","0","65.64","20.23"
"66","000","00","003","0313","1261","756","234","522","49","805","1312","0","61.36","17.84"
"66","000","00","003","0313","1262","871","287","584","33","904","1417","0","63.8","20.25"
"66","000","00","003","0313","1263","821","278","543","35","856","1230","0","69.59","22.6"
"66","000","00","003","0314","0000","2369","824","1545","157","2526","4174","0","60.52","19.74"
"66","000","00","003","0314","1264","726","242","484","60","786","1308","0","60.09","18.5"
"66","000","00","003","0314","1265","819","276","543","64","883","1467","0","60.19","18.81"
"66","000","00","003","0314","1266","824","306","518","33","857","1399","0","61.26","21.87"
"66","000","00","003","0315","0000","1156","383","773","75","1231","1938","0","63.52","19.76"
"66","000","00","003","0315","1197","538","177","361","35","573","937","0","61.15","18.89"
"66","000","00","003","0315","1198","618","206","412","40","658","1001","0","65.73","20.58"
"66","000","00","003","0316","0000","1555","518","1037","85","1640","2451","0","66.91","21.13"
"66","000","00","003","0316","1199","769","262","507","52","821","1249","0","65.73","20.98"
"66","000","00","003","0316","1200","786","256","530","33","819","1202","0","68.14","21.3"
"66","000","00","003","0317","0000","3248","1175","2073","160","3408","5388","0","63.25","21.81"
"66","000","00","003","0317","1226","788","269","519","30","818","1256","0","65.13","21.42"
"66","000","00","003","0317","1227","833","327","506","32","865","1364","0","63.42","23.97"
"66","000","00","003","0317","1228","779","288","491","71","850","1361","0","62.45","21.16"
"66","000","00","003","0317","1229","848","291","557","27","875","1407","0","62.19","20.68"
"66","000","00","003","0318","0000","2094","732","1362","141","2235","3501","0","63.84","20.91"
"66","000","00","003","0318","1233","687","253","434","62","749","1175","0","63.74","21.53"
"66","000","00","003","0318","1234","727","221","506","41","768","1158","0","66.32","19.08"
"66","000","00","003","0318","1235","680","258","422","38","718","1168","0","61.47","22.09"
"66","000","00","003","0319","0000","3778","1307","2471","122","3900","7241","0","53.86","18.05"
"66","000","00","003","0319","1236","992","326","666","47","1039","1626","0","63.9","20.05"
"66","000","00","003","0319","1237","873","326","547","24","897","2115","0","42.41","15.41"
"66","000","00","003","0319","1238","982","338","644","26","1008","1805","0","55.84","18.73"
"66","000","00","003","0319","1239","931","317","614","25","956","1695","0","56.4","18.7"
"66","000","00","003","0320","0000","2449","847","1602","135","2584","4415","0","58.53","19.18"
"66","000","00","003","0320","1245","724","219","505","46","770","1392","0","55.32","15.73"
"66","000","00","003","0320","1246","877","317","560","42","919","1592","0","57.73","19.91"
"66","000","00","003","0320","1247","848","311","537","47","895","1431","0","62.54","21.73"
"66","000","00","003","0321","0000","3885","1399","2486","177","4062","6474","0","62.74","21.61"
"66","000","00","003","0321","1254","825","322","503","39","864","1456","0","59.34","22.12"
"66","000","00","003","0321","1255","1102","388","714","47","1149","1726","0","66.57","22.48"
"66","000","00","003","0321","1256","1026","352","674","48","1074","1723","0","62.33","20.43"
"66","000","00","003","0321","1257","932","337","595","43","975","1569","0","62.14","21.48"
"66","000","00","003","0322","0000","3052","1076","1976","143","3195","5308","0","60.19","20.27"
"66","000","00","003","0322","1267","669","212","457","64","733","1207","0","60.73","17.56"
"66","000","00","003","0322","1268","748","248","500","26","774","1317","0","58.77","18.83"
"66","000","00","003","0322","1269","889","342","547","29","918","1563","0","58.73","21.88"
"66","000","00","003","0322","1270","746","274","472","24","770","1221","0","63.06","22.44"
"66","000","00","004","0000","0000","53248","19150","34098","2543","55791","95040","115551","58.7","20.15"
"66","000","00","004","0401","0000","1094","396","698","61","1155","1798","0","64.24","22.02"
"66","000","00","004","0401","1085","604","221","383","38","642","1020","0","62.94","21.67"
"66","000","00","004","0401","1086","490","175","315","23","513","778","0","65.94","22.49"
"66","000","00","004","0402","0000","829","306","523","35","864","1416","0","61.02","21.61"
"66","000","00","004","0402","1084","829","306","523","35","864","1416","0","61.02","21.61"
"66","000","00","004","0403","0000","1023","331","692","62","1085","2261","0","47.99","14.64"
"66","000","00","004","0403","1082","486","154","332","33","519","1400","0","37.07","11.0"
"66","000","00","004","0403","1083","537","177","360","29","566","861","0","65.74","20.56"
"66","000","00","004","0404","0000","1421","526","895","78","1499","2295","0","65.32","22.92"
"66","000","00","004","0404","1090","767","281","486","44","811","1251","0","64.83","22.46"
"66","000","00","004","0404","1091","654","245","409","34","688","1044","0","65.9","23.47"
"66","000","00","004","0405","0000","802","258","544","40","842","1465","0","57.47","17.61"
"66","000","00","004","0405","1087","802","258","544","40","842","1465","0","57.47","17.61"
"66","000","00","004","0406","0000","1086","362","724","46","1132","1885","0","60.05","19.2"
"66","000","00","004","0406","1088","582","174","408","20","602","1017","0","59.19","17.11"
"66","000","00","004","0406","1089","504","188","316","26","530","868","0","61.06","21.66"
"66","000","00","004","0407","0000","2716","1010","1706","123","2839","4791","0","59.26","21.08"
"66","000","00","004","0407","1092","824","312","512","38","862","1487","0","57.97","20.98"
"66","000","00","004","0407","1093","886","338","548","42","928","1573","0","59.0","21.49"
"66","000","00","004","0407","1094","1006","360","646","43","1049","1731","0","60.6","20.8"
"66","000","00","004","0408","0000","2289","779","1510","94","2383","3948","0","60.36","19.73"
"66","000","00","004","0408","1095","715","219","496","28","743","1209","0","61.46","18.11"
"66","000","00","004","0408","1096","864","296","568","40","904","1564","0","57.8","18.93"
"66","000","00","004","0408","1097","710","264","446","26","736","1175","0","62.64","22.47"
"66","000","00","004","0409","0000","3067","1116","1951","109","3176","5680","0","55.92","19.65"
"66","000","00","004","0409","1098","835","333","502","32","867","1505","0","57.61","22.13"
"66","000","00","004","0409","1099","832","291","541","34","866","1418","0","61.07","20.52"
"66","000","00","004","0409","1100","671","213","458","3","674","1497","0","45.02","14.23"
"66","000","00","004","0409","1101","729","279","450","40","769","1260","0","61.03","22.14"
"66","000","00","004","0410","0000","1225","431","794","105","1330","2330","0","57.08","18.5"
"66","000","00","004","0410","1116","584","209","375","71","655","1129","0","58.02","18.51"
"66","000","00","004","0410","1117","641","222","419","34","675","1201","0","56.2","18.48"
"66","000","00","004","0411","0000","1677","585","1092","94","1771","3196","0","55.41","18.3"
"66","000","00","004","0411","1114","913","298","615","51","964","1822","0","52.91","16.36"
"66","000","00","004","0411","1115","764","287","477","43","807","1374","0","58.73","20.89"
"66","000","00","004","0412","0000","1920","680","1240","109","2029","3502","0","57.94","19.42"
"66","000","00","004","0412","1118","885","290","595","54","939","1639","0","57.29","17.69"
"66","000","00","004","0412","1119","1035","390","645","55","1090","1863","0","58.51","20.93"
"66","000","00","004","0413","0000","1596","582","1014","89","1685","2846","0","59.21","20.45"
"66","000","00","004","0413","1102","807","292","515","43","850","1399","0","60.76","20.87"
"66","000","00","004","0413","1103","789","290","499","46","835","1447","0","57.71","20.04"
"66","000","00","004","0414","0000","3640","1371","2269","173","3813","6488","0","58.77","21.13"
"66","000","00","004","0414","1104","943","349","594","41","984","1683","0","58.47","20.74"
"66","000","00","004","0414","1105","915","337","578","47","962","1585","0","60.69","21.26"
"66","000","00","004","0414","1106","928","393","535","31","959","1557","0","61.59","25.24"
"66","000","00","004","0414","1107","854","292","562","54","908","1663","0","54.6","17.56"
"66","000","00","004","0415","0000","3180","1166","2014","173","3353","5656","0","59.28","20.62"
"66","000","00","004","0415","1122","734","268","466","32","766","1308","0","58.56","20.49"
"66","000","00","004","0415","1123","788","273","515","54","842","1433","0","58.76","19.05"
"66","000","00","004","0415","1124","787","294","493","37","824","1450","0","56.83","20.28"
"66","000","00","004","0415","1125","871","331","540","50","921","1465","0","62.87","22.59"
"66","000","00","004","0416","0000","3084","1064","2020","131","3215","5663","0","56.77","18.79"
"66","000","00","004","0416","1140","656","250","406","25","681","1139","0","59.79","21.95"
"66","000","00","004","0416","1141","661","223","438","23","684","1105","0","61.9","20.18"
"66","000","00","004","0416","1142","818","270","548","49","867","1498","0","57.88","18.02"
"66","000","00","004","0416","1143","949","321","628","34","983","1921","0","51.17","16.71"
"66","000","00","004","0417","0000","3542","1331","2211","163","3705","6075","0","60.99","21.91"
"66","000","00","004","0417","1133","929","328","601","37","966","1613","0","59.89","20.33"
"66","000","00","004","0417","1134","814","316","498","43","857","1454","0","58.94","21.73"
"66","000","00","004","0417","1135","954","361","593","31","985","1597","0","61.68","22.6"
"66","000","00","004","0417","1136","845","326","519","52","897","1411","0","63.57","23.1"
"66","000","00","004","0418","0000","3028","1158","1870","116","3144","5581","0","56.33","20.75"
"66","000","00","004","0418","1108","1077","433","644","48","1125","1921","0","58.56","22.54"
"66","000","00","004","0418","1109","1016","377","639","34","1050","1952","0","53.79","19.31"
"66","000","00","004","0418","1110","935","348","587","34","969","1708","0","56.73","20.37"
"66","000","00","004","0419","0000","3284","1172","2112","160","3444","5667","0","60.77","20.68"
"66","000","00","004","0419","1144","733","266","467","45","778","1340","0","58.06","19.85"
"66","000","00","004","0419","1145","932","327","605","29","961","1536","0","62.57","21.29"
"66","000","00","004","0419","1146","760","275","485","51","811","1361","0","59.59","20.21"
"66","000","00","004","0419","1147","859","304","555","35","894","1430","0","62.52","21.26"
"66","000","00","004","0420","0000","1527","539","988","76","1603","2794","0","57.37","19.29"
"66","000","00","004","0420","1128","827","307","520","48","875","1428","0","61.27","21.5"
"66","000","00","004","0420","1129","700","232","468","28","728","1366","0","53.29","16.98"
"66","000","00","004","0421","0000","1926","662","1264","104","2030","3600","0","56.39","18.39"
"66","000","00","004","0421","1126","942","314","628","52","994","1818","0","54.68","17.27"
"66","000","00","004","0421","1127","984","348","636","52","1036","1782","0","58.14","19.53"
"66","000","00","004","0422","0000","2724","948","1776","146","2870","4803","0","59.75","19.74"
"66","000","00","004","0422","1137","842","310","532","52","894","1493","0","59.88","20.76"
"66","000","00","004","0422","1138","943","293","650","42","985","1600","0","61.56","18.31"
"66","000","00","004","0422","1139","939","345","594","52","991","1710","0","57.95","20.18"
"66","000","00","004","0423","0000","2420","890","1530","78","2498","4187","0","59.66","21.26"
"66","000","00","004","0423","1130","821","307","514","38","859","1498","0","57.34","20.49"
"66","000","00","004","0423","1131","805","304","501","25","830","1350","0","61.48","22.52"
"66","000","00","004","0423","1132","794","279","515","15","809","1339","0","60.42","20.84"
"66","000","00","004","0424","0000","1655","570","1085","94","1749","2791","0","62.67","20.42"
"66","000","00","004","0424","1120","778","239","539","49","827","1287","0","64.26","18.57"
"66","000","00","004","0424","1121","877","331","546","45","922","1504","0","61.3","22.01"
"66","000","00","004","0425","0000","2493","917","1576","84","2577","4322","0","59.63","21.22"
"66","000","00","004","0425","1111","705","273","432","22","727","1131","0","64.28","24.14"
"66","000","00","004","0425","1112","1032","378","654","37","1069","1916","0","55.79","19.73"
"66","000","00","004","0425","1113","756","266","490","25","781","1275","0","61.25","20.86"
"66","000","00","005","0000","0000","67632","23371","44261","2943","70575","124621","147528","56.63","18.75"
"66","000","00","005","0501","0000","1066","377","689","78","1144","2047","0","55.89","18.42"
"66","000","00","005","0501","0985","523","185","338","37","560","1051","0","53.28","17.6"
"66","000","00","005","0501","0986","543","192","351","41","584","996","0","58.63","19.28"
"66","000","00","005","0502","0000","1920","608","1312","96","2016","3365","0","59.91","18.07"
"66","000","00","005","0502","0987","867","248","619","20","887","1504","0","58.98","16.49"
"66","000","00","005","0502","0988","557","193","364","48","605","975","0","62.05","19.79"
"66","000","00","005","0502","0989","496","167","329","28","524","886","0","59.14","18.85"
"66","000","00","005","0503","0000","722","250","472","56","778","1404","0","55.41","17.81"
"66","000","00","005","0503","0992","722","250","472","56","778","1404","0","55.41","17.81"
"66","000","00","005","0504","0000","851","283","568","29","880","1532","0","57.44","18.47"
"66","000","00","005","0504","0997","397","135","262","13","410","773","0","53.04","17.46"
"66","000","00","005","0504","0998","454","148","306","16","470","759","0","61.92","19.5"
"66","000","00","005","0505","0000","945","318","627","44","989","1683","0","58.76","18.89"
"66","000","00","005","0505","0995","423","150","273","22","445","704","0","63.21","21.31"
"66","000","00","005","0505","0996","522","168","354","22","544","979","0","55.57","17.16"
"66","000","00","005","0506","0000","1425","376","1049","63","1488","2650","0","56.15","14.19"
"66","000","00","005","0506","0999","804","204","600","40","844","1438","0","58.69","14.19"
"66","000","00","005","0506","1000","621","172","449","23","644","1212","0","53.14","14.19"
"66","000","00","005","0507","0000","1824","587","1237","69","1893","3176","0","59.6","18.48"
"66","000","00","005","0507","1001","961","330","631","32","993","1731","0","57.37","19.06"
"66","000","00","005","0507","1002","863","257","606","37","900","1445","0","62.28","17.79"
"66","000","00","005","0508","0000","2742","930","1812","132","2874","5461","0","52.63","17.03"
"66","000","00","005","0508","1003","1008","351","657","44","1052","1855","0","56.71","18.92"
"66","000","00","005","0508","1004","840","275","565","42","882","1728","0","51.04","15.91"
"66","000","00","005","0508","1005","894","304","590","46","940","1878","0","50.05","16.19"
"66","000","00","005","0509","0000","1709","450","1259","49","1758","3340","0","52.63","13.47"
"66","000","00","005","0509","1008","871","213","658","15","886","1761","0","50.31","12.1"
"66","000","00","005","0509","1009","838","237","601","34","872","1579","0","55.22","15.01"
"66","000","00","005","0510","0000","1428","470","958","49","1477","2482","0","59.51","18.94"
"66","000","00","005","0510","1012","819","268","551","32","851","1476","0","57.66","18.16"
"66","000","00","005","0510","1013","609","202","407","17","626","1006","0","62.23","20.08"
"66","000","00","005","0511","0000","2320","778","1542","101","2421","4309","0","56.18","18.06"
"66","000","00","005","0511","1014","775","236","539","46","821","1403","0","58.52","16.82"
"66","000","00","005","0511","1015","756","250","506","23","779","1446","0","53.87","17.29"
"66","000","00","005","0511","1016","789","292","497","32","821","1460","0","56.23","20.0"
"66","000","00","005","0512","0000","1367","490","877","35","1402","2260","0","62.04","21.68"
"66","000","00","005","0512","1017","705","249","456","18","723","1233","0","58.64","20.19"
"66","000","00","005","0512","1018","662","241","421","17","679","1027","0","66.11","23.47"
"66","000","00","005","0513","0000","3196","1181","2015","136","3332","5590","0","59.61","21.13"
"66","000","00","005","0513","1019","689","262","427","22","711","1207","0","58.91","21.71"
"66","000","00","005","0513","1020","700","258","442","22","722","1167","0","61.87","22.11"
"66","000","00","005","0513","1021","633","231","402","31","664","1150","0","57.74","20.09"
"66","000","00","005","0513","1022","584","207","377","40","624","1061","0","58.81","19.51"
"66","000","00","005","0513","1023","590","223","367","21","611","1005","0","60.8","22.19"
"66","000","00","005","0514","0000","2414","947","1467","106","2520","4077","0","61.81","23.23"
"66","000","00","005","0514","1024","806","370","436","11","817","1250","0","65.36","29.6"
"66","000","00","005","0514","1025","824","290","534","50","874","1448","0","60.36","20.03"
"66","000","00","005","0514","1026","784","287","497","45","829","1379","0","60.12","20.81"
"66","000","00","005","0515","0000","2291","759","1532","73","2364","5070","0","46.63","14.97"
"66","000","00","005","0515","1029","572","207","365","19","591","2078","0","28.44","9.96"
"66","000","00","005","0515","1030","910","280","630","34","944","1562","0","60.44","17.93"
"66","000","00","005","0515","1031","809","272","537","20","829","1430","0","57.97","19.02"
"66","000","00","005","0516","0000","2382","852","1530","86","2468","4440","0","55.59","19.19"
"66","000","00","005","0516","1045","733","261","472","28","761","1461","0","52.09","17.86"
"66","000","00","005","0516","1046","760","234","526","30","790","1310","0","60.31","17.86"
"66","000","00","005","0516","1047","889","357","532","28","917","1669","0","54.94","21.39"
"66","000","00","005","0517","0000","1991","714","1277","77","2068","3614","0","57.22","19.76"
"66","000","00","005","0517","1048","1072","395","677","47","1119","1932","0","57.92","20.45"
"66","000","00","005","0517","1049","919","319","600","30","949","1682","0","56.42","18.97"
"66","000","00","005","0518","0000","2635","944","1691","122","2757","4932","0","55.9","19.14"
"66","000","00","005","0518","1050","996","381","615","35","1031","1891","0","54.52","20.15"
"66","000","00","005","0518","1051","1013","348","665","51","1064","1882","0","56.54","18.49"
"66","000","00","005","0518","1052","626","215","411","36","662","1159","0","57.12","18.55"
"66","000","00","005","0519","0000","1449","460","989","90","1539","2613","0","58.9","17.6"
"66","000","00","005","0519","1068","760","221","539","44","804","1346","0","59.73","16.42"
"66","000","00","005","0519","1069","689","239","450","46","735","1267","0","58.01","18.86"
"66","000","00","005","0520","0000","2030","708","1322","95","2125","3752","0","56.64","18.87"
"66","000","00","005","0520","1010","1132","388","744","56","1188","2192","0","54.2","17.7"
"66","000","00","005","0520","1011","898","320","578","39","937","1560","0","60.06","20.51"
"66","000","00","005","0521","0000","3500","1268","2232","154","3654","6457","0","56.59","19.64"
"66","000","00","005","0521","1053","849","293","556","39","888","1553","0","57.18","18.87"
"66","000","00","005","0521","1054","858","320","538","35","893","1607","0","55.57","19.91"
"66","000","00","005","0521","1055","957","352","605","40","997","1773","0","56.23","19.85"
"66","000","00","005","0521","1056","836","303","533","40","876","1524","0","57.48","19.88"
"66","000","00","005","0522","0000","2994","963","2031","153","3147","5282","0","59.58","18.23"
"66","000","00","005","0522","1057","942","252","690","60","1002","1613","0","62.12","15.62"
"66","000","00","005","0522","1058","1067","359","708","45","1112","1877","0","59.24","19.13"
"66","000","00","005","0522","1059","985","352","633","48","1033","1792","0","57.65","19.64"
"66","000","00","005","0523","0000","3307","1216","2091","140","3447","6037","0","57.1","20.14"
"66","000","00","005","0523","1062","897","336","561","37","934","1556","0","60.03","21.59"
"66","000","00","005","0523","1063","809","305","504","25","834","1497","0","55.71","20.37"
"66","000","00","005","0523","1064","840","271","569","45","885","1550","0","57.1","17.48"
"66","000","00","005","0523","1065","761","304","457","33","794","1434","0","55.37","21.2"
"66","000","00","005","0524","0000","2066","743","1323","69","2135","3734","0","57.18","19.9"
"66","000","00","005","0524","1040","707","255","452","19","726","1243","0","58.41","20.51"
"66","000","00","005","0524","1041","634","218","416","17","651","1219","0","53.4","17.88"
"66","000","00","005","0524","1042","725","270","455","33","758","1272","0","59.59","21.23"
"66","000","00","005","0525","0000","2134","722","1412","77","2211","3777","0","58.54","19.12"
"66","000","00","005","0525","1034","759","244","515","30","789","1432","0","55.1","17.04"
"66","000","00","005","0525","1035","691","221","470","17","708","1157","0","61.19","19.1"
"66","000","00","005","0525","1036","684","257","427","30","714","1188","0","60.1","21.63"
"66","000","00","005","0526","0000","756","270","486","31","787","1437","0","54.77","18.79"
"66","000","00","005","0526","0983","756","270","486","31","787","1437","0","54.77","18.79"
"66","000","00","005","0527","0000","838","291","547","75","913","1708","0","53.45","17.04"
"66","000","00","005","0527","0984","838","291","547","75","913","1708","0","53.45","17.04"
"66","000","00","005","0528","0000","1057","418","639","61","1118","2214","0","50.5","18.88"
"66","000","00","005","0528","0990","572","233","339","34","606","1276","0","47.49","18.26"
"66","000","00","005","0528","0991","485","185","300","27","512","938","0","54.58","19.72"
"66","000","00","005","0529","0000","1006","380","626","57","1063","1865","0","57.0","20.38"
"66","000","00","005","0529","0993","547","197","350","16","563","996","0","56.53","19.78"
"66","000","00","005","0529","0994","459","183","276","41","500","869","0","57.54","21.06"
"66","000","00","005","0530","0000","1743","552","1191","110","1853","3348","0","55.35","16.49"
"66","000","00","005","0530","1006","881","277","604","60","941","1793","0","52.48","15.45"
"66","000","00","005","0530","1007","862","275","587","50","912","1555","0","58.65","17.68"
"66","000","00","005","0531","0000","1904","686","1218","76","1980","3519","0","56.27","19.49"
"66","000","00","005","0531","1027","917","326","591","43","960","1652","0","58.11","19.73"
"66","000","00","005","0531","1028","987","360","627","33","1020","1867","0","54.63","19.28"
"66","000","00","005","0532","0000","2352","819","1533","96","2448","4305","0","56.86","19.02"
"66","000","00","005","0532","1037","779","244","535","28","807","1419","0","56.87","17.2"
"66","000","00","005","0532","1038","874","312","562","33","907","1653","0","54.87","18.87"
"66","000","00","005","0532","1039","699","263","436","35","734","1233","0","59.53","21.33"
"66","000","00","005","0533","0000","1493","502","991","77","1570","2689","0","58.39","18.67"
"66","000","00","005","0533","1060","773","251","522","51","824","1392","0","59.2","18.03"
"66","000","00","005","0533","1061","720","251","469","26","746","1297","0","57.52","19.35"
"66","000","00","005","0534","0000","2021","755","1266","75","2096","3659","0","57.28","20.63"
"66","000","00","005","0534","1066","995","370","625","47","1042","1793","0","58.11","20.64"
"66","000","00","005","0534","1067","1026","385","641","28","1054","1866","0","56.48","20.63"
"66","000","00","005","0535","0000","1762","627","1135","55","1817","3065","0","59.28","20.46"
"66","000","00","005","0535","1043","746","263","483","19","765","1285","0","59.53","20.47"
"66","000","00","005","0535","1044","1016","364","652","36","1052","1780","0","59.1","20.45"
"66","000","00","005","0536","0000","1992","677","1315","51","2043","3728","0","54.8","18.16"
"66","000","00","005","0536","1032","1140","403","737","33","1173","2018","0","58.13","19.97"
"66","000","00","005","0536","1033","852","274","578","18","870","1710","0","50.88","16.02"
"66","000","00","006","0000","0000","102469","35684","66785","4496","106965","183814","228128","58.19","19.41"
"66","000","00","006","0601","0000","2708","998","1710","104","2812","4749","0","59.21","21.01"
"66","000","00","006","0601","0625","984","359","625","38","1022","1638","0","62.39","21.92"
"66","000","00","006","0601","0626","707","271","436","26","733","1335","0","54.91","20.3"
"66","000","00","006","0601","0627","1017","368","649","40","1057","1776","0","59.52","20.72"
"66","000","00","006","0602","0000","2877","985","1892","136","3013","5323","0","56.6","18.5"
"66","000","00","006","0602","0634","928","313","615","57","985","1749","0","56.32","17.9"
"66","000","00","006","0602","0635","1056","346","710","39","1095","1877","0","58.34","18.43"
"66","000","00","006","0602","0636","893","326","567","40","933","1697","0","54.98","19.21"
"66","000","00","006","0603","0000","2684","970","1714","114","2798","5447","0","51.37","17.81"
"66","000","00","006","0603","0637","874","301","573","33","907","1480","0","61.28","20.34"
"66","000","00","006","0603","0638","938","362","576","47","985","1483","0","66.42","24.41"
"66","000","00","006","0603","0639","872","307","565","34","906","2484","0","36.47","12.36"
"66","000","00","006","0604","0000","492","149","343","33","525","781","0","67.22","19.08"
"66","000","00","006","0604","0640","492","149","343","33","525","781","0","67.22","19.08"
"66","000","00","006","0605","0000","7422","2576","4846","237","7659","13148","0","58.25","19.59"
"66","000","00","006","0605","0641","853","282","571","44","897","1477","0","60.73","19.09"
"66","000","00","006","0605","0642","972","340","632","31","1003","1784","0","56.22","19.06"
"66","000","00","006","0605","0643","940","302","638","24","964","1686","0","57.18","17.91"
"66","000","00","006","0605","0644","936","334","602","26","962","1692","0","56.86","19.74"
"66","000","00","006","0605","0645","883","295","588","24","907","1659","0","54.67","17.78"
"66","000","00","006","0605","0646","958","358","600","25","983","1648","0","59.65","21.72"
"66","000","00","006","0605","0647","919","344","575","23","942","1536","0","61.33","22.4"
"66","000","00","006","0605","0648","961","321","640","40","1001","1666","0","60.08","19.27"
"66","000","00","006","0606","0000","2630","932","1698","110","2740","4812","0","56.94","19.37"
"66","000","00","006","0606","0649","820","292","528","37","857","1428","0","60.01","20.45"
"66","000","00","006","0606","0650","941","330","611","45","986","1810","0","54.48","18.23"
"66","000","00","006","0606","0651","869","310","559","28","897","1574","0","56.99","19.7"
"66","000","00","006","0607","0000","2417","819","1598","107","2524","4314","0","58.51","18.98"
"66","000","00","006","0607","0658","953","326","627","27","980","1714","0","57.18","19.02"
"66","000","00","006","0607","0659","803","233","570","41","844","1424","0","59.27","16.36"
"66","000","00","006","0607","0660","661","260","401","39","700","1176","0","59.52","22.11"
"66","000","00","006","0608","0000","1529","340","1189","81","1610","2739","0","58.78","12.41"
"66","000","00","006","0608","0665","699","120","579","55","754","1355","0","55.65","8.86"
"66","000","00","006","0608","0666","830","220","610","26","856","1384","0","61.85","15.9"
"66","000","00","006","0609","0000","2654","921","1733","126","2780","5068","0","54.85","18.17"
"66","000","00","006","0609","0679","904","313","591","60","964","1699","0","56.74","18.42"
"66","000","00","006","0609","0680","878","285","593","34","912","1715","0","53.18","16.62"
"66","000","00","006","0609","0681","872","323","549","32","904","1654","0","54.66","19.53"
"66","000","00","006","0610","0000","1791","618","1173","82","1873","3175","0","58.99","19.46"
"66","000","00","006","0610","0667","924","326","598","43","967","1613","0","59.95","20.21"
"66","000","00","006","0610","0668","867","292","575","39","906","1562","0","58.0","18.69"
"66","000","00","006","0611","0000","2304","755","1549","120","2424","3774","0","64.23","20.01"
"66","000","00","006","0611","0695","724","236","488","27","751","1221","0","61.51","19.33"
"66","000","00","006","0611","0696","812","249","563","42","854","1252","0","68.21","19.89"
"66","000","00","006","0611","0697","768","270","498","51","819","1301","0","62.95","20.75"
"66","000","00","006","0612","0000","1285","307","978","59","1344","2162","0","62.16","14.2"
"66","000","00","006","0612","0698","639","146","493","29","668","1049","0","63.68","13.92"
"66","000","00","006","0612","0699","646","161","485","30","676","1113","0","60.74","14.47"
"66","000","00","006","0613","0000","1671","491","1180","94","1765","3197","0","55.21","15.36"
"66","000","00","006","0613","0700","805","217","588","51","856","1557","0","54.98","13.94"
"66","000","00","006","0613","0701","866","274","592","43","909","1640","0","55.43","16.71"
"66","000","00","006","0614","0000","2641","853","1788","177","2818","4807","0","58.62","17.74"
"66","000","00","006","0614","0702","879","288","591","61","940","1402","0","67.05","20.54"
"66","000","00","006","0614","0703","852","276","576","56","908","1717","0","52.88","16.07"
"66","000","00","006","0614","0704","910","289","621","60","970","1688","0","57.46","17.12"
"66","000","00","006","0615","0000","2581","818","1763","171","2752","4904","0","56.12","16.68"
"66","000","00","006","0615","0705","634","197","437","89","723","1168","0","61.9","16.87"
"66","000","00","006","0615","0706","911","283","628","43","954","1729","0","55.18","16.37"
"66","000","00","006","0615","0707","1036","338","698","39","1075","2007","0","53.56","16.84"
"66","000","00","006","0616","0000","1280","448","832","90","1370","2364","0","57.95","18.95"
"66","000","00","006","0616","0708","730","268","462","69","799","1296","0","61.65","20.68"
"66","000","00","006","0616","0709","550","180","370","21","571","1068","0","53.46","16.85"
"66","000","00","006","0617","0000","1783","599","1184","97","1880","3343","0","56.24","17.92"
"66","000","00","006","0617","0710","848","270","578","61","909","1707","0","53.25","15.82"
"66","000","00","006","0617","0711","935","329","606","36","971","1636","0","59.35","20.11"
"66","000","00","006","0618","0000","6576","2266","4310","195","6771","12239","0","55.32","18.51"
"66","000","00","006","0618","0712","834","294","540","25","859","1761","0","48.78","16.7"
"66","000","00","006","0618","0713","752","274","478","29","781","1314","0","59.44","20.85"
"66","000","00","006","0618","0714","769","267","502","23","792","1233","0","64.23","21.65"
"66","000","00","006","0618","0715","822","264","558","32","854","1549","0","55.13","17.04"
"66","000","00","006","0618","0716","876","285","591","21","897","1639","0","54.73","17.39"
"66","000","00","006","0618","0717","782","205","577","29","811","1486","0","54.58","13.8"
"66","000","00","006","0618","0718","962","374","588","24","986","1806","0","54.6","20.71"
"66","000","00","006","0618","0719","779","303","476","12","791","1451","0","54.51","20.88"
"66","000","00","006","0619","0000","1560","542","1018","62","1622","2655","0","61.09","20.41"
"66","000","00","006","0619","0720","758","242","516","17","775","1302","0","59.52","18.59"
"66","000","00","006","0619","0721","802","300","502","45","847","1353","0","62.6","22.17"
"66","000","00","006","0620","0000","2620","874","1746","151","2771","4520","0","61.31","19.34"
"66","000","00","006","0620","0741","640","241","399","34","674","1206","0","55.89","19.98"
"66","000","00","006","0620","0742","631","185","446","59","690","1086","0","63.54","17.03"
"66","000","00","006","0620","0743","682","209","473","35","717","1088","0","65.9","19.21"
"66","000","00","006","0620","0744","667","239","428","23","690","1140","0","60.53","20.96"
"66","000","00","006","0621","0000","3472","1241","2231","117","3589","6178","0","58.09","20.09"
"66","000","00","006","0621","0682","896","316","580","16","912","1636","0","55.75","19.32"
"66","000","00","006","0621","0683","721","283","438","17","738","1298","0","56.86","21.8"
"66","000","00","006","0621","0684","795","276","519","46","841","1391","0","60.46","19.84"
"66","000","00","006","0621","0685","1060","366","694","38","1098","1853","0","59.26","19.75"
"66","000","00","006","0622","0000","1979","689","1290","85","2064","3629","0","56.88","18.99"
"66","000","00","006","0622","0686","962","330","632","46","1008","1820","0","55.38","18.13"
"66","000","00","006","0622","0687","1017","359","658","39","1056","1809","0","58.37","19.85"
"66","000","00","006","0623","0000","3755","1345","2410","163","3918","6663","0","58.8","20.19"
"66","000","00","006","0623","0691","951","331","620","41","992","1674","0","59.26","19.77"
"66","000","00","006","0623","0692","965","328","637","43","1008","1610","0","62.61","20.37"
"66","000","00","006","0623","0693","943","345","598","43","986","1695","0","58.17","20.35"
"66","000","00","006","0623","0694","896","341","555","36","932","1684","0","55.34","20.25"
"66","000","00","006","0624","0000","2571","793","1778","125","2696","4890","0","55.13","16.22"
"66","000","00","006","0624","0631","883","254","629","33","916","1710","0","53.57","14.85"
"66","000","00","006","0624","0632","813","275","538","39","852","1595","0","53.42","17.24"
"66","000","00","006","0624","0633","875","264","611","53","928","1585","0","58.55","16.66"
"66","000","00","006","0625","0000","2471","943","1528","89","2560","4205","0","60.88","22.43"
"66","000","00","006","0625","0672","912","332","580","28","940","1494","0","62.92","22.22"
"66","000","00","006","0625","0673","765","302","463","23","788","1325","0","59.47","22.79"
"66","000","00","006","0625","0674","794","309","485","38","832","1386","0","60.03","22.29"
"66","000","00","006","0626","0000","2427","892","1535","144","2571","4271","0","60.2","20.89"
"66","000","00","006","0626","0628","760","271","489","24","784","1351","0","58.03","20.06"
"66","000","00","006","0626","0629","784","283","501","35","819","1338","0","61.21","21.15"
"66","000","00","006","0626","0630","883","338","545","85","968","1582","0","61.19","21.37"
"66","000","00","006","0627","0000","2749","993","1756","103","2852","4987","0","57.19","19.91"
"66","000","00","006","0627","0652","936","330","606","18","954","1650","0","57.82","20.0"
"66","000","00","006","0627","0653","924","341","583","48","972","1681","0","57.82","20.29"
"66","000","00","006","0627","0654","889","322","567","37","926","1656","0","55.92","19.44"
"66","000","00","006","0628","0000","2473","952","1521","133","2606","4145","0","62.87","22.97"
"66","000","00","006","0628","0655","720","231","489","44","764","1243","0","61.46","18.58"
"66","000","00","006","0628","0656","892","410","482","55","947","1471","0","64.38","27.87"
"66","000","00","006","0628","0657","861","311","550","34","895","1431","0","62.54","21.73"
"66","000","00","006","0629","0000","3167","1079","2088","125","3292","5327","0","61.8","20.26"
"66","000","00","006","0629","0661","841","293","548","42","883","1456","0","60.65","20.12"
"66","000","00","006","0629","0662","890","329","561","24","914","1451","0","62.99","22.67"
"66","000","00","006","0629","0663","679","237","442","18","697","1063","0","65.57","22.3"
"66","000","00","006","0629","0664","757","220","537","41","798","1357","0","58.81","16.21"
"66","000","00","006","0630","0000","2117","794","1323","103","2220","3585","0","61.92","22.15"
"66","000","00","006","0630","0669","767","269","498","36","803","1219","0","65.87","22.07"
"66","000","00","006","0630","0670","713","276","437","28","741","1235","0","60.0","22.35"
"66","000","00","006","0630","0671","637","249","388","39","676","1131","0","59.77","22.02"
"66","000","00","006","0631","0000","3896","1563","2333","188","4084","7145","0","57.16","21.88"
"66","000","00","006","0631","0675","1017","475","542","60","1077","1816","0","59.31","26.16"
"66","000","00","006","0631","0676","919","327","592","24","943","1734","0","54.38","18.86"
"66","000","00","006","0631","0677","1010","398","612","59","1069","1777","0","60.16","22.4"
"66","000","00","006","0631","0678","950","363","587","45","995","1818","0","54.73","19.97"
"66","000","00","006","0632","0000","2540","826","1714","109","2649","4359","0","60.77","18.95"
"66","000","00","006","0632","0688","802","263","539","42","844","1352","0","62.43","19.45"
"66","000","00","006","0632","0689","851","267","584","41","892","1521","0","58.65","17.55"
"66","000","00","006","0632","0690","887","296","591","26","913","1486","0","61.44","19.92"
"66","000","00","006","0633","0000","2474","911","1563","141","2615","4285","0","61.03","21.26"
"66","000","00","006","0633","0733","858","334","524","54","912","1526","0","59.76","21.89"
"66","000","00","006","0633","0734","815","303","512","58","873","1425","0","61.26","21.26"
"66","000","00","006","0633","0735","801","274","527","29","830","1334","0","62.22","20.54"
"66","000","00","006","0634","0000","1851","651","1200","72","1923","3215","0","59.81","20.25"
"66","000","00","006","0634","0736","968","344","624","39","1007","1649","0","61.07","20.86"
"66","000","00","006","0634","0737","883","307","576","33","916","1566","0","58.49","19.6"
"66","000","00","006","0635","0000","2769","1004","1765","87","2856","4699","0","60.78","21.37"
"66","000","00","006","0635","0738","972","348","624","26","998","1629","0","61.26","21.36"
"66","000","00","006","0635","0739","936","341","595","32","968","1628","0","59.46","20.95"
"66","000","00","006","0635","0740","861","315","546","29","890","1442","0","61.72","21.84"
"66","000","00","006","0636","0000","1526","578","948","60","1586","3043","0","52.12","18.99"
"66","000","00","006","0636","0731","720","259","461","33","753","1541","0","48.86","16.81"
"66","000","00","006","0636","0732","806","319","487","27","833","1502","0","55.46","21.24"
"66","000","00","006","0637","0000","1581","610","971","55","1636","2917","0","56.09","20.91"
"66","000","00","006","0637","0729","796","314","482","23","819","1402","0","58.42","22.4"
"66","000","00","006","0637","0730","785","296","489","32","817","1515","0","53.93","19.54"
"66","000","00","006","0638","0000","4064","1516","2548","127","4191","7133","0","58.76","21.25"
"66","000","00","006","0638","0725","1028","369","659","36","1064","1847","0","57.61","19.98"
"66","000","00","006","0638","0726","1003","406","597","24","1027","1738","0","59.09","23.36"
"66","000","00","006","0638","0727","975","345","630","34","1009","1640","0","61.52","21.04"
"66","000","00","006","0638","0728","1058","396","662","33","1091","1908","0","57.18","20.75"
"66","000","00","006","0639","0000","3082","1043","2039","124","3206","5617","0","57.08","18.57"
"66","000","00","006","0639","0722","1213","411","802","52","1265","2162","0","58.51","19.01"
"66","000","00","006","0639","0723","826","280","546","34","860","1520","0","56.58","18.42"
"66","000","00","006","0639","0724","1043","352","691","38","1081","1935","0","55.87","18.19"
"66","000","00","007","0000","0000","78444","27215","51229","3663","82107","135448","170160","60.62","20.09"
"66","000","00","007","0701","0000","4919","1662","3257","211","5130","8349","0","61.44","19.91"
"66","000","00","007","0701","0745","769","256","513","41","810","1321","0","61.32","19.38"
"66","000","00","007","0701","0746","790","292","498","56","846","1346","0","62.85","21.69"
"66","000","00","007","0701","0747","828","257","571","43","871","1428","0","60.99","18.0"
"66","000","00","007","0701","0748","806","278","528","28","834","1442","0","57.84","19.28"
"66","000","00","007","0701","0749","886","292","594","20","906","1408","0","64.35","20.74"
"66","000","00","007","0701","0750","840","287","553","23","863","1404","0","61.47","20.44"
"66","000","00","007","0702","0000","6581","2406","4175","277","6858","10909","0","62.87","22.06"
"66","000","00","007","0702","0751","824","268","556","39","863","1354","0","63.74","19.79"
"66","000","00","007","0702","0752","802","309","493","36","838","1332","0","62.91","23.2"
"66","000","00","007","0702","0753","899","331","568","27","926","1463","0","63.29","22.62"
"66","000","00","007","0702","0754","802","305","497","49","851","1413","0","60.23","21.59"
"66","000","00","007","0702","0755","764","292","472","25","789","1218","0","64.78","23.97"
"66","000","00","007","0702","0756","762","262","500","31","793","1308","0","60.63","20.03"
"66","000","00","007","0702","0757","939","335","604","37","976","1527","0","63.92","21.94"
"66","000","00","007","0702","0758","789","304","485","33","822","1294","0","63.52","23.49"
"66","000","00","007","0703","0000","3249","1043","2206","172","3421","5848","0","58.5","17.84"
"66","000","00","007","0703","0759","786","264","522","27","813","1516","0","53.63","17.41"
"66","000","00","007","0703","0760","886","297","589","63","949","1529","0","62.07","19.42"
"66","000","00","007","0703","0761","813","248","565","50","863","1397","0","61.78","17.75"
"66","000","00","007","0703","0762","764","234","530","32","796","1406","0","56.61","16.64"
"66","000","00","007","0704","0000","2286","781","1505","138","2424","4409","0","54.98","17.71"
"66","000","00","007","0704","0763","793","251","542","34","827","1497","0","55.24","16.77"
"66","000","00","007","0704","0764","772","257","515","58","830","1424","0","58.29","18.05"
"66","000","00","007","0704","0765","721","273","448","46","767","1488","0","51.55","18.35"
"66","000","00","007","0705","0000","3277","1011","2266","167","3444","6387","0","53.92","15.83"
"66","000","00","007","0705","0768","689","230","459","49","738","1190","0","62.02","19.33"
"66","000","00","007","0705","0769","643","189","454","34","677","1174","0","57.67","16.1"
"66","000","00","007","0705","0770","707","237","470","13","720","1224","0","58.82","19.36"
"66","000","00","007","0705","0771","687","212","475","47","734","1466","0","50.07","14.46"
"66","000","00","007","0705","0772","551","143","408","24","575","1333","0","43.14","10.73"
"66","000","00","007","0706","0000","478","157","321","44","522","814","0","64.13","19.29"
"66","000","00","007","0706","0773","478","157","321","44","522","814","0","64.13","19.29"
"66","000","00","007","0707","0000","5283","1752","3531","288","5571","9662","0","57.66","18.13"
"66","000","00","007","0707","0774","762","217","545","42","804","1436","0","55.99","15.11"
"66","000","00","007","0707","0775","858","309","549","45","903","1515","0","59.6","20.4"
"66","000","00","007","0707","0776","716","240","476","81","797","1545","0","51.59","15.53"
"66","000","00","007","0707","0777","780","258","522","35","815","1383","0","58.93","18.66"
"66","000","00","007","0707","0778","836","269","567","26","862","1433","0","60.15","18.77"
"66","000","00","007","0707","0779","598","221","377","31","629","1134","0","55.47","19.49"
"66","000","00","007","0707","0780","733","238","495","28","761","1216","0","62.58","19.57"
"66","000","00","007","0708","0000","764","271","493","44","808","1397","0","57.84","19.4"
"66","000","00","007","0708","0785","764","271","493","44","808","1397","0","57.84","19.4"
"66","000","00","007","0709","0000","2711","863","1848","137","2848","4800","0","59.33","17.98"
"66","000","00","007","0709","0786","868","285","583","58","926","1607","0","57.62","17.73"
"66","000","00","007","0709","0787","914","304","610","37","951","1582","0","60.11","19.22"
"66","000","00","007","0709","0788","929","274","655","42","971","1611","0","60.27","17.01"
"66","000","00","007","0710","0000","4045","1389","2656","128","4173","6621","0","63.03","20.98"
"66","000","00","007","0710","0789","814","281","533","29","843","1322","0","63.77","21.26"
"66","000","00","007","0710","0790","825","283","542","34","859","1321","0","65.03","21.42"
"66","000","00","007","0710","0791","796","256","540","34","830","1360","0","61.03","18.82"
"66","000","00","007","0710","0792","829","273","556","12","841","1361","0","61.79","20.06"
"66","000","00","007","0710","0793","781","296","485","19","800","1257","0","63.64","23.55"
"66","000","00","007","0711","0000","3106","1128","1978","137","3243","5151","0","62.96","21.9"
"66","000","00","007","0711","0809","716","268","448","35","751","1171","0","64.13","22.89"
"66","000","00","007","0711","0810","747","279","468","50","797","1349","0","59.08","20.68"
"66","000","00","007","0711","0811","842","291","551","32","874","1368","0","63.89","21.27"
"66","000","00","007","0711","0812","801","290","511","20","821","1263","0","65.0","22.96"
"66","000","00","007","0712","0000","3603","1275","2328","154","3757","6052","0","62.08","21.07"
"66","000","00","007","0712","0822","1008","378","630","28","1036","1544","0","67.1","24.48"
"66","000","00","007","0712","0823","938","349","589","35","973","1482","0","65.65","23.55"
"66","000","00","007","0712","0824","883","276","607","49","932","1488","0","62.63","18.55"
"66","000","00","007","0712","0825","774","272","502","42","816","1538","0","53.06","17.69"
"66","000","00","007","0713","0000","2602","814","1788","162","2764","4239","0","65.2","19.2"
"66","000","00","007","0713","0805","639","212","427","52","691","981","0","70.44","21.61"
"66","000","00","007","0713","0806","646","200","446","55","701","1097","0","63.9","18.23"
"66","000","00","007","0713","0807","622","189","433","27","649","991","0","65.49","19.07"
"66","000","00","007","0713","0808","695","213","482","28","723","1170","0","61.79","18.21"
"66","000","00","007","0714","0000","836","277","559","107","943","1421","0","66.36","19.49"
"66","000","00","007","0714","0766","357","123","234","50","407","608","0","66.94","20.23"
"66","000","00","007","0714","0767","479","154","325","57","536","813","0","65.93","18.94"
"66","000","00","007","0715","0000","2886","1090","1796","130","3016","4733","0","63.72","23.03"
"66","000","00","007","0715","0836","783","403","380","26","809","1278","0","63.3","31.53"
"66","000","00","007","0715","0837","716","261","455","41","757","1144","0","66.17","22.81"
"66","000","00","007","0715","0838","673","259","414","38","711","1140","0","62.37","22.72"
"66","000","00","007","0715","0839","714","167","547","25","739","1171","0","63.11","14.26"
"66","000","00","007","0716","0000","2176","743","1433","107","2283","3673","0","62.16","20.23"
"66","000","00","007","0716","0829","740","234","506","45","785","1217","0","64.5","19.23"
"66","000","00","007","0716","0830","765","295","470","38","803","1347","0","59.61","21.9"
"66","000","00","007","0716","0831","671","214","457","24","695","1109","0","62.67","19.3"
"66","000","00","007","0717","0000","2958","1028","1930","149","3107","5144","0","60.4","19.98"
"66","000","00","007","0717","0832","878","320","558","25","903","1546","0","58.41","20.7"
"66","000","00","007","0717","0833","863","310","553","43","906","1408","0","64.35","22.02"
"66","000","00","007","0717","0834","577","164","413","27","604","1057","0","57.14","15.52"
"66","000","00","007","0717","0835","640","234","406","54","694","1133","0","61.25","20.65"
"66","000","00","007","0718","0000","2701","942","1759","147","2848","5184","0","54.94","18.17"
"66","000","00","007","0718","0826","1006","351","655","54","1060","1674","0","63.32","20.97"
"66","000","00","007","0718","0827","831","315","516","37","868","1996","0","43.49","15.78"
"66","000","00","007","0718","0828","864","276","588","56","920","1514","0","60.77","18.23"
"66","000","00","007","0719","0000","2183","775","1408","81","2264","3517","0","64.37","22.04"
"66","000","00","007","0719","0843","713","283","430","23","736","1139","0","64.62","24.85"
"66","000","00","007","0719","0844","761","259","502","25","786","1216","0","64.64","21.3"
"66","000","00","007","0719","0845","709","233","476","33","742","1162","0","63.86","20.05"
"66","000","00","007","0720","0000","2449","838","1611","113","2562","4276","0","59.92","19.6"
"66","000","00","007","0720","0840","809","285","524","33","842","1303","0","64.62","21.87"
"66","000","00","007","0720","0841","770","267","503","29","799","1402","0","56.99","19.04"
"66","000","00","007","0720","0842","870","286","584","51","921","1571","0","58.63","18.2"
"66","000","00","007","0721","0000","3570","1371","2199","156","3726","6405","0","58.17","21.41"
"66","000","00","007","0721","0813","917","350","567","44","961","1547","0","62.12","22.62"
"66","000","00","007","0721","0814","944","362","582","44","988","1649","0","59.92","21.95"
"66","000","00","007","0721","0815","907","331","576","30","937","1629","0","57.52","20.32"
"66","000","00","007","0721","0816","802","328","474","38","840","1580","0","53.16","20.76"
"66","000","00","007","0722","0000","4214","1502","2712","154","4368","7096","0","61.56","21.17"
"66","000","00","007","0722","0817","915","323","592","34","949","1444","0","65.72","22.37"
"66","000","00","007","0722","0818","814","279","535","21","835","1413","0","59.09","19.75"
"66","000","00","007","0722","0819","766","240","526","37","803","1377","0","58.32","17.43"
"66","000","00","007","0722","0820","903","370","533","33","936","1527","0","61.3","24.23"
"66","000","00","007","0722","0821","816","290","526","29","845","1335","0","63.3","21.72"
"66","000","00","007","0723","0000","2833","948","1885","148","2981","5132","0","58.09","18.47"
"66","000","00","007","0723","0781","670","241","429","65","735","1271","0","57.83","18.96"
"66","000","00","007","0723","0782","649","221","428","21","670","1203","0","55.69","18.37"
"66","000","00","007","0723","0783","722","246","476","23","745","1268","0","58.75","19.4"
"66","000","00","007","0723","0784","792","240","552","39","831","1390","0","59.78","17.27"
"66","000","00","007","0724","0000","4852","1729","3123","172","5024","7974","0","63.0","21.68"
"66","000","00","007","0724","0799","683","260","423","28","711","1102","0","64.52","23.59"
"66","000","00","007","0724","0800","1013","328","685","39","1052","1630","0","64.54","20.12"
"66","000","00","007","0724","0801","800","302","498","31","831","1333","0","62.34","22.66"
"66","000","00","007","0724","0802","799","294","505","22","821","1292","0","63.54","22.76"
"66","000","00","007","0724","0803","761","258","503","30","791","1272","0","62.19","20.28"
"66","000","00","007","0724","0804","796","287","509","22","818","1345","0","60.82","21.34"
"66","000","00","007","0725","0000","3882","1420","2462","140","4022","6255","0","64.3","22.7"
"66","000","00","007","0725","0794","756","266","490","27","783","1207","0","64.87","22.04"
"66","000","00","007","0725","0795","799","298","501","22","821","1282","0","64.04","23.24"
"66","000","00","007","0725","0796","793","304","489","29","822","1248","0","65.87","24.36"
"66","000","00","007","0725","0797","809","304","505","42","851","1304","0","65.26","23.31"
"66","000","00","007","0725","0798","725","248","477","20","745","1214","0","61.37","20.43"
"66","000","00","008","0000","0000","124916","41689","83227","5529","130445","227720","278096","57.28","18.31"
"66","000","00","008","0801","0000","1717","475","1242","65","1782","3258","0","54.7","14.58"
"66","000","00","008","0801","0850","602","204","398","17","619","1107","0","55.92","18.43"
"66","000","00","008","0801","0851","1115","271","844","48","1163","2151","0","54.07","12.6"
"66","000","00","008","0802","0000","1859","929","930","101","1960","3376","0","58.06","27.52"
"66","000","00","008","0802","0846","968","323","645","54","1022","1670","0","61.2","19.34"
"66","000","00","008","0802","0847","891","606","285","47","938","1706","0","54.98","35.52"
"66","000","00","008","0803","0000","3910","1287","2623","127","4037","7049","0","57.27","18.26"
"66","000","00","008","0803","0852","951","309","642","30","981","1612","0","60.86","19.17"
"66","000","00","008","0803","0853","947","306","641","42","989","1743","0","56.74","17.56"
"66","000","00","008","0803","0854","1116","375","741","33","1149","2099","0","54.74","17.87"
"66","000","00","008","0803","0855","896","297","599","22","918","1595","0","57.55","18.62"
"66","000","00","008","0804","0000","2870","1013","1857","79","2949","5567","0","52.97","18.2"
"66","000","00","008","0804","0924","898","316","582","30","928","1640","0","56.59","19.27"
"66","000","00","008","0804","0925","993","378","615","0","993","2052","0","48.39","18.42"
"66","000","00","008","0804","0926","979","319","660","49","1028","1875","0","54.83","17.01"
"66","000","00","008","0805","0000","2836","985","1851","130","2966","5056","0","58.66","19.48"
"66","000","00","008","0805","0943","948","364","584","60","1008","1661","0","60.69","21.91"
"66","000","00","008","0805","0944","948","319","629","32","980","1667","0","58.79","19.14"
"66","000","00","008","0805","0945","940","302","638","38","978","1728","0","56.6","17.48"
"66","000","00","008","0806","0000","2315","690","1625","100","2415","4533","0","53.28","15.22"
"66","000","00","008","0806","0860","812","264","548","36","848","1563","0","54.25","16.89"
"66","000","00","008","0806","0861","795","234","561","46","841","1559","0","53.94","15.01"
"66","000","00","008","0806","0862","708","192","516","18","726","1411","0","51.45","13.61"
"66","000","00","008","0807","0000","3222","1106","2116","150","3372","5930","0","56.86","18.65"
"66","000","00","008","0807","0894","837","289","548","46","883","1445","0","61.11","20.0"
"66","000","00","008","0807","0895","876","326","550","38","914","1842","0","49.62","17.7"
"66","000","00","008","0807","0896","692","234","458","26","718","1187","0","60.49","19.71"
"66","000","00","008","0807","0897","817","257","560","40","857","1456","0","58.86","17.65"
"66","000","00","008","0808","0000","7421","2340","5081","335","7756","12981","0","59.75","18.03"
"66","000","00","008","0808","0863","990","344","646","33","1023","1761","0","58.09","19.53"
"66","000","00","008","0808","0864","812","248","564","53","865","1361","0","63.56","18.22"
"66","000","00","008","0808","0865","998","292","706","53","1051","1852","0","56.75","15.77"
"66","000","00","008","0808","0866","1085","343","742","38","1123","1928","0","58.25","17.79"
"66","000","00","008","0808","0867","926","291","635","34","960","1492","0","64.34","19.5"
"66","000","00","008","0808","0868","1045","314","731","56","1101","1998","0","55.11","15.72"
"66","000","00","008","0808","0869","790","254","536","34","824","1272","0","64.78","19.97"
"66","000","00","008","0808","0870","775","254","521","34","809","1317","0","61.43","19.29"
"66","000","00","008","0809","0000","6355","2165","4190","288","6643","11817","0","56.22","18.32"
"66","000","00","008","0809","0871","654","209","445","53","707","1327","0","53.28","15.75"
"66","000","00","008","0809","0872","623","254","369","24","647","1280","0","50.55","19.84"
"66","000","00","008","0809","0873","944","288","656","46","990","1865","0","53.08","15.44"
"66","000","00","008","0809","0874","751","243","508","42","793","1230","0","64.47","19.76"
"66","000","00","008","0809","0875","709","234","475","34","743","1356","0","54.79","17.26"
"66","000","00","008","0809","0876","956","311","645","35","991","1732","0","57.22","17.96"
"66","000","00","008","0809","0877","918","327","591","29","947","1586","0","59.71","20.62"
"66","000","00","008","0809","0878","800","299","501","25","825","1441","0","57.25","20.75"
"66","000","00","008","0810","0000","5241","1725","3516","223","5464","9996","0","54.66","17.26"
"66","000","00","008","0810","0879","1044","351","693","65","1109","2045","0","54.23","17.16"
"66","000","00","008","0810","0880","958","335","623","46","1004","1914","0","52.46","17.5"
"66","000","00","008","0810","0881","1060","331","729","40","1100","1918","0","57.35","17.26"
"66","000","00","008","0810","0882","1052","328","724","32","1084","2079","0","52.14","15.78"
"66","000","00","008","0810","0883","1127","380","747","40","1167","2040","0","57.21","18.63"
"66","000","00","008","0811","0000","1026","315","711","40","1066","2037","0","52.33","15.46"
"66","000","00","008","0811","0890","1026","315","711","40","1066","2037","0","52.33","15.46"
"66","000","00","008","0812","0000","532","132","400","50","582","985","0","59.09","13.4"
"66","000","00","008","0812","0889","532","132","400","50","582","985","0","59.09","13.4"
"66","000","00","008","0813","0000","4899","1659","3240","174","5073","9749","0","52.04","17.02"
"66","000","00","008","0813","0884","968","340","628","42","1010","2027","0","49.83","16.77"
"66","000","00","008","0813","0885","747","208","539","38","785","1402","0","55.99","14.84"
"66","000","00","008","0813","0886","1014","342","672","47","1061","1826","0","58.11","18.73"
"66","000","00","008","0813","0887","1068","365","703","29","1097","2162","0","50.74","16.88"
"66","000","00","008","0813","0888","1102","404","698","18","1120","2332","0","48.03","17.32"
"66","000","00","008","0814","0000","1197","366","831","66","1263","2094","0","60.32","17.48"
"66","000","00","008","0814","0891","595","174","421","35","630","1032","0","61.05","16.86"
"66","000","00","008","0814","0892","602","192","410","31","633","1062","0","59.6","18.08"
"66","000","00","008","0815","0000","483","151","332","33","516","909","0","56.77","16.61"
"66","000","00","008","0815","0893","483","151","332","33","516","909","0","56.77","16.61"
"66","000","00","008","0816","0000","4634","1671","2963","205","4839","8139","0","59.45","20.53"
"66","000","00","008","0816","0915","839","323","516","49","888","1458","0","60.91","22.15"
"66","000","00","008","0816","0916","912","338","574","37","949","1571","0","60.41","21.51"
"66","000","00","008","0816","0917","901","304","597","47","948","1579","0","60.04","19.25"
"66","000","00","008","0816","0918","1043","370","673","44","1087","1849","0","58.79","20.01"
"66","000","00","008","0816","0919","939","336","603","28","967","1682","0","57.49","19.98"
"66","000","00","008","0817","0000","4327","1499","2828","172","4499","8903","0","50.53","16.84"
"66","000","00","008","0817","0949","1183","418","765","46","1229","2078","0","59.14","20.12"
"66","000","00","008","0817","0950","1122","358","764","42","1164","2059","0","56.53","17.39"
"66","000","00","008","0817","0951","992","361","631","55","1047","1792","0","58.43","20.15"
"66","000","00","008","0817","0952","1030","362","668","29","1059","2974","0","35.61","12.17"
"66","000","00","008","0818","0000","4670","1562","3108","188","4858","7936","0","61.21","19.68"
"66","000","00","008","0818","0954","1241","406","835","39","1280","2099","0","60.98","19.34"
"66","000","00","008","0818","0955","1134","401","733","47","1181","1823","0","64.78","22.0"
"66","000","00","008","0818","0956","1171","390","781","72","1243","2022","0","61.47","19.29"
"66","000","00","008","0818","0957","1124","365","759","30","1154","1992","0","57.93","18.32"
"66","000","00","008","0819","0000","922","229","693","58","980","1585","0","61.83","14.45"
"66","000","00","008","0819","0958","922","229","693","58","980","1585","0","61.83","14.45"
"66","000","00","008","0820","0000","5681","1801","3880","224","5905","9652","0","61.18","18.66"
"66","000","00","008","0820","0962","1022","300","722","41","1063","1755","0","60.57","17.09"
"66","000","00","008","0820","0963","988","347","641","30","1018","1497","0","68.0","23.18"
"66","000","00","008","0820","0964","942","286","656","52","994","1567","0","63.43","18.25"
"66","000","00","008","0820","0965","892","279","613","28","920","1624","0","56.65","17.18"
"66","000","00","008","0820","0966","944","286","658","48","992","1614","0","61.46","17.72"
"66","000","00","008","0820","0967","893","303","590","25","918","1595","0","57.55","19.0"
"66","000","00","008","0821","0000","2935","934","2001","130","3065","5219","0","58.73","17.9"
"66","000","00","008","0821","0959","920","304","616","40","960","1565","0","61.34","19.42"
"66","000","00","008","0821","0960","905","272","633","45","950","1780","0","53.37","15.28"
"66","000","00","008","0821","0961","1110","358","752","45","1155","1874","0","61.63","19.1"
"66","000","00","008","0822","0000","592","200","392","38","630","1072","0","58.77","18.66"
"66","000","00","008","0822","0953","592","200","392","38","630","1072","0","58.77","18.66"
"66","000","00","008","0823","0000","3709","1186","2523","242","3951","6608","0","59.79","17.95"
"66","000","00","008","0823","0979","1004","331","673","62","1066","1785","0","59.72","18.54"
"66","000","00","008","0823","0980","933","254","679","49","982","1596","0","61.53","15.91"
"66","000","00","008","0823","0981","989","347","642","62","1051","1731","0","60.72","20.05"
"66","000","00","008","0823","0982","783","254","529","69","852","1496","0","56.95","16.98"
"66","000","00","008","0824","0000","2595","828","1767","141","2736","4576","0","59.79","18.09"
"66","000","00","008","0824","0971","727","227","500","41","768","1372","0","55.98","16.55"
"66","000","00","008","0824","0972","798","255","543","52","850","1415","0","60.07","18.02"
"66","000","00","008","0824","0973","1070","346","724","48","1118","1789","0","62.49","19.34"
"66","000","00","008","0825","0000","2157","732","1425","156","2313","4210","0","54.94","17.39"
"66","000","00","008","0825","0968","894","345","549","64","958","1782","0","53.76","19.36"
"66","000","00","008","0825","0969","698","222","476","32","730","1357","0","53.8","16.36"
"66","000","00","008","0825","0970","565","165","400","60","625","1071","0","58.36","15.41"
"66","000","00","008","0826","0000","2831","961","1870","142","2973","5209","0","57.07","18.45"
"66","000","00","008","0826","0930","1067","349","718","30","1097","1889","0","58.07","18.48"
"66","000","00","008","0826","0931","919","324","595","56","975","1728","0","56.42","18.75"
"66","000","00","008","0826","0932","845","288","557","56","901","1592","0","56.6","18.09"
"66","000","00","008","0827","0000","1670","593","1077","77","1747","3180","0","54.94","18.65"
"66","000","00","008","0827","0933","869","313","556","45","914","1656","0","55.19","18.9"
"66","000","00","008","0827","0934","801","280","521","32","833","1524","0","54.66","18.37"
"66","000","00","008","0828","0000","3264","1137","2127","149","3413","6168","0","55.33","18.43"
"66","000","00","008","0828","0940","1028","341","687","49","1077","2033","0","52.98","16.77"
"66","000","00","008","0828","0941","1026","368","658","40","1066","1947","0","54.75","18.9"
"66","000","00","008","0828","0942","1210","428","782","60","1270","2188","0","58.04","19.56"
"66","000","00","008","0829","0000","2590","860","1730","139","2729","4803","0","56.82","17.91"
"66","000","00","008","0829","0908","936","333","603","45","981","1601","0","61.27","20.8"
"66","000","00","008","0829","0909","803","249","554","53","856","1527","0","56.06","16.31"
"66","000","00","008","0829","0910","851","278","573","41","892","1675","0","53.25","16.6"
"66","000","00","008","0830","0000","2862","925","1937","120","2982","5216","0","57.17","17.73"
"66","000","00","008","0830","0898","1028","322","706","52","1080","1866","0","57.88","17.26"
"66","000","00","008","0830","0899","859","281","578","46","905","1667","0","54.29","16.86"
"66","000","00","008","0830","0900","975","322","653","22","997","1683","0","59.24","19.13"
"66","000","00","008","0831","0000","2748","855","1893","119","2867","4895","0","58.57","17.47"
"66","000","00","008","0831","0976","839","262","577","47","886","1541","0","57.5","17.0"
"66","000","00","008","0831","0977","960","308","652","39","999","1669","0","59.86","18.45"
"66","000","00","008","0831","0978","949","285","664","33","982","1685","0","58.28","16.91"
"66","000","00","008","0832","0000","3607","1243","2364","85","3692","6364","0","58.01","19.53"
"66","000","00","008","0832","0901","902","333","569","20","922","1642","0","56.15","20.28"
"66","000","00","008","0832","0902","865","297","568","19","884","1475","0","59.93","20.14"
"66","000","00","008","0832","0903","890","284","606","20","910","1644","0","55.35","17.27"
"66","000","00","008","0832","0904","950","329","621","26","976","1603","0","60.89","20.52"
"66","000","00","008","0833","0000","3014","1033","1981","135","3149","5179","0","60.8","19.95"
"66","000","00","008","0833","0905","1098","372","726","67","1165","1949","0","59.77","19.09"
"66","000","00","008","0833","0906","1093","349","744","35","1128","1790","0","63.02","19.5"
"66","000","00","008","0833","0907","823","312","511","33","856","1440","0","59.44","21.67"
"66","000","00","008","0834","0000","1769","628","1141","102","1871","3159","0","59.23","19.88"
"66","000","00","008","0834","0848","831","292","539","51","882","1507","0","58.53","19.38"
"66","000","00","008","0834","0849","938","336","602","51","989","1652","0","59.87","20.34"
"66","000","00","008","0835","0000","2663","910","1753","109","2772","4735","0","58.54","19.22"
"66","000","00","008","0835","0935","860","295","565","35","895","1502","0","59.59","19.64"
"66","000","00","008","0835","0936","959","305","654","35","994","1772","0","56.09","17.21"
"66","000","00","008","0835","0937","844","310","534","39","883","1461","0","60.44","21.22"
"66","000","00","008","0836","0000","1989","725","1264","64","2053","3663","0","56.05","19.79"
"66","000","00","008","0836","0938","910","298","612","13","923","1769","0","52.18","16.85"
"66","000","00","008","0836","0939","1079","427","652","51","1130","1894","0","59.66","22.54"
"66","000","00","008","0837","0000","3350","1097","2253","167","3517","6379","0","55.13","17.2"
"66","000","00","008","0837","0911","770","251","519","40","810","1579","0","51.3","15.9"
"66","000","00","008","0837","0912","825","245","580","58","883","1524","0","57.94","16.08"
"66","000","00","008","0837","0913","888","286","602","33","921","1677","0","54.92","17.05"
"66","000","00","008","0837","0914","867","315","552","36","903","1599","0","56.47","19.7"
"66","000","00","008","0838","0000","2752","959","1793","90","2842","4844","0","58.67","19.8"
"66","000","00","008","0838","0946","908","287","621","36","944","1688","0","55.92","17.0"
"66","000","00","008","0838","0947","825","301","524","23","848","1475","0","57.49","20.41"
"66","000","00","008","0838","0948","1019","371","648","31","1050","1681","0","62.46","22.07"
"66","000","00","008","0839","0000","3762","1315","2447","129","3891","6576","0","59.17","20.0"
"66","000","00","008","0839","0920","948","304","644","26","974","1760","0","55.34","17.27"
"66","000","00","008","0839","0921","940","327","613","50","990","1699","0","58.27","19.25"
"66","000","00","008","0839","0922","985","355","630","47","1032","1626","0","63.47","21.83"
"66","000","00","008","0839","0923","889","329","560","6","895","1491","0","60.03","22.07"
"66","000","00","008","0840","0000","2480","851","1629","137","2617","4436","0","58.99","19.18"
"66","000","00","008","0840","0927","854","284","570","33","887","1559","0","56.9","18.22"
"66","000","00","008","0840","0928","832","293","539","52","884","1480","0","59.73","19.8"
"66","000","00","008","0840","0929","794","274","520","52","846","1397","0","60.56","19.61"
"66","000","00","008","0841","0000","3187","1041","2146","147","3334","5762","0","57.86","18.07"
"66","000","00","008","0841","0856","976","322","654","40","1016","1923","0","52.83","16.74"
"66","000","00","008","0841","0857","853","260","593","53","906","1641","0","55.21","15.84"
"66","000","00","008","0841","0858","720","249","471","28","748","1157","0","64.65","21.52"
"66","000","00","008","0841","0859","638","210","428","26","664","1041","0","63.78","20.17"
"66","000","00","008","0842","0000","2273","576","1697","103","2376","3915","0","60.69","14.71"
"66","000","00","008","0842","0974","1127","228","899","66","1193","1907","0","62.56","11.96"
"66","000","00","008","0842","0975","1146","348","798","37","1183","2008","0","58.91","17.33"
"66","000","00","009","0000","0000","77799","25365","52434","4495","82294","136658","166867","60.22","18.56"
"66","000","00","009","0901","0000","1267","399","868","92","1359","2292","0","59.29","17.41"
"66","000","00","009","0901","0394","514","168","346","50","564","983","0","57.38","17.09"
"66","000","00","009","0901","0395","753","231","522","42","795","1309","0","60.73","17.65"
"66","000","00","009","0902","0000","563","188","375","48","611","945","0","64.66","19.89"
"66","000","00","009","0902","0397","563","188","375","48","611","945","0","64.66","19.89"
"66","000","00","009","0903","0000","502","192","310","54","556","850","0","65.41","22.59"
"66","000","00","009","0903","0398","502","192","310","54","556","850","0","65.41","22.59"
"66","000","00","009","0904","0000","647","264","383","55","702","1116","0","62.9","23.66"
"66","000","00","009","0904","0396","647","264","383","55","702","1116","0","62.9","23.66"
"66","000","00","009","0905","0000","458","165","293","38","496","760","0","65.26","21.71"
"66","000","00","009","0905","0399","458","165","293","38","496","760","0","65.26","21.71"
"66","000","00","009","0906","0000","508","179","329","30","538","759","0","70.88","23.58"
"66","000","00","009","0906","0419","508","179","329","30","538","759","0","70.88","23.58"
"66","000","00","009","0907","0000","388","141","247","36","424","642","0","66.04","21.96"
"66","000","00","009","0907","0420","388","141","247","36","424","642","0","66.04","21.96"
"66","000","00","009","0908","0000","911","329","582","32","943","1647","0","57.26","19.98"
"66","000","00","009","0908","0415","911","329","582","32","943","1647","0","57.26","19.98"
"66","000","00","009","0909","0000","3010","995","2015","160","3170","4979","0","63.67","19.98"
"66","000","00","009","0909","0421","917","318","599","21","938","1528","0","61.39","20.81"
"66","000","00","009","0909","0422","1073","329","744","64","1137","1788","0","63.59","18.4"
"66","000","00","009","0909","0423","1020","348","672","75","1095","1663","0","65.84","20.93"
"66","000","00","009","0910","0000","1327","432","895","80","1407","2162","0","65.08","19.98"
"66","000","00","009","0910","0424","821","256","565","54","875","1260","0","69.44","20.32"
"66","000","00","009","0910","0425","506","176","330","26","532","902","0","58.98","19.51"
"66","000","00","009","0911","0000","872","310","562","41","913","1457","0","62.66","21.28"
"66","000","00","009","0911","0437","872","310","562","41","913","1457","0","62.66","21.28"
"66","000","00","009","0912","0000","702","233","469","32","734","1184","0","61.99","19.68"
"66","000","00","009","0912","0438","702","233","469","32","734","1184","0","61.99","19.68"
"66","000","00","009","0913","0000","1366","439","927","86","1452","2507","0","57.92","17.51"
"66","000","00","009","0913","0403","613","181","432","50","663","1145","0","57.9","15.81"
"66","000","00","009","0913","0404","753","258","495","36","789","1362","0","57.93","18.94"
"66","000","00","009","0914","0000","1704","505","1199","83","1787","2919","0","61.22","17.3"
"66","000","00","009","0914","0405","811","248","563","33","844","1389","0","60.76","17.85"
"66","000","00","009","0914","0406","893","257","636","50","943","1530","0","61.63","16.8"
"66","000","00","009","0915","0000","2221","690","1531","200","2421","4043","0","59.88","17.07"
"66","000","00","009","0915","0407","797","263","534","87","884","1471","0","60.1","17.88"
"66","000","00","009","0915","0408","783","245","538","71","854","1410","0","60.57","17.38"
"66","000","00","009","0915","0409","641","182","459","42","683","1162","0","58.78","15.66"
"66","000","00","009","0916","0000","4993","1524","3469","266","5259","8802","0","59.75","17.31"
"66","000","00","009","0916","0410","917","275","642","33","950","1656","0","57.37","16.61"
"66","000","00","009","0916","0411","1002","276","726","42","1044","1838","0","56.8","15.02"
"66","000","00","009","0916","0412","907","290","617","43","950","1666","0","57.02","17.41"
"66","000","00","009","0916","0413","1021","331","690","81","1102","1821","0","60.52","18.18"
"66","000","00","009","0916","0414","1146","352","794","67","1213","1821","0","66.61","19.33"
"66","000","00","009","0917","0000","772","271","501","71","843","1256","0","67.12","21.58"
"66","000","00","009","0917","0416","772","271","501","71","843","1256","0","67.12","21.58"
"66","000","00","009","0918","0000","1940","627","1313","111","2051","3345","0","61.32","18.74"
"66","000","00","009","0918","0417","935","298","637","61","996","1552","0","64.18","19.2"
"66","000","00","009","0918","0418","1005","329","676","50","1055","1793","0","58.84","18.35"
"66","000","00","009","0919","0000","5445","1723","3722","278","5723","9838","0","58.17","17.51"
"66","000","00","009","0919","0428","1054","305","749","48","1102","1873","0","58.84","16.28"
"66","000","00","009","0919","0429","1045","317","728","46","1091","1867","0","58.44","16.98"
"66","000","00","009","0919","0430","989","295","694","77","1066","1823","0","58.48","16.18"
"66","000","00","009","0919","0431","998","338","660","48","1046","1962","0","53.31","17.23"
"66","000","00","009","0919","0432","1359","468","891","59","1418","2313","0","61.31","20.23"
"66","000","00","009","0920","0000","3628","1140","2488","198","3826","6232","0","61.39","18.29"
"66","000","00","009","0920","0433","879","281","598","60","939","1510","0","62.19","18.61"
"66","000","00","009","0920","0434","1038","321","717","60","1098","1824","0","60.2","17.6"
"66","000","00","009","0920","0435","788","247","541","33","821","1363","0","60.23","18.12"
"66","000","00","009","0920","0436","923","291","632","45","968","1535","0","63.06","18.96"
"66","000","00","009","0921","0000","1666","506","1160","66","1732","2949","0","58.73","17.16"
"66","000","00","009","0921","0426","737","231","506","29","766","1357","0","56.45","17.02"
"66","000","00","009","0921","0427","929","275","654","37","966","1592","0","60.68","17.27"
"66","000","00","009","0922","0000","3249","1098","2151","193","3442","6306","0","54.58","17.41"
"66","000","00","009","0922","0439","1066","388","678","55","1121","2299","0","48.76","16.88"
"66","000","00","009","0922","0440","1070","328","742","86","1156","1940","0","59.59","16.91"
"66","000","00","009","0922","0441","1113","382","731","52","1165","2067","0","56.36","18.48"
"66","000","00","009","0923","0000","5493","1778","3715","346","5839","10123","0","57.68","17.56"
"66","000","00","009","0923","0442","1101","360","741","62","1163","2038","0","57.07","17.66"
"66","000","00","009","0923","0443","1017","354","663","44","1061","1835","0","57.82","19.29"
"66","000","00","009","0923","0444","1067","331","736","81","1148","1979","0","58.01","16.73"
"66","000","00","009","0923","0445","1073","340","733","73","1146","2014","0","56.9","16.88"
"66","000","00","009","0923","0446","1235","393","842","86","1321","2257","0","58.53","17.41"
"66","000","00","009","0924","0000","2714","838","1876","168","2882","4596","0","62.71","18.23"
"66","000","00","009","0924","0447","828","245","583","62","890","1406","0","63.3","17.43"
"66","000","00","009","0924","0448","820","280","540","48","868","1418","0","61.21","19.75"
"66","000","00","009","0924","0449","1066","313","753","58","1124","1772","0","63.43","17.66"
"66","000","00","009","0925","0000","6052","1897","4155","309","6361","10381","0","61.28","18.27"
"66","000","00","009","0925","0452","1012","319","693","72","1084","1758","0","61.66","18.15"
"66","000","00","009","0925","0453","938","300","638","52","990","1546","0","64.04","19.4"
"66","000","00","009","0925","0454","1084","288","796","49","1133","1815","0","62.42","15.87"
"66","000","00","009","0925","0455","1111","392","719","54","1165","1932","0","60.3","20.29"
"66","000","00","009","0925","0456","1058","358","700","51","1109","1770","0","62.66","20.23"
"66","000","00","009","0925","0457","849","240","609","31","880","1560","0","56.41","15.38"
"66","000","00","009","0926","0000","1613","514","1099","62","1675","2649","0","63.23","19.4"
"66","000","00","009","0926","0450","753","257","496","26","779","1202","0","64.81","21.38"
"66","000","00","009","0926","0451","860","257","603","36","896","1447","0","61.92","17.76"
"66","000","00","009","0927","0000","7345","2744","4601","430","7775","13032","0","59.66","21.06"
"66","000","00","009","0927","0458","1016","323","693","49","1065","1810","0","58.84","17.85"
"66","000","00","009","0927","0459","1005","365","640","42","1047","1653","0","63.34","22.08"
"66","000","00","009","0927","0460","814","572","242","54","868","1444","0","60.11","39.61"
"66","000","00","009","0927","0461","805","267","538","31","836","1318","0","63.43","20.26"
"66","000","00","009","0927","0462","891","337","554","67","958","1566","0","61.17","21.52"
"66","000","00","009","0927","0463","976","325","651","50","1026","1748","0","58.7","18.59"
"66","000","00","009","0927","0464","892","279","613","71","963","1772","0","54.35","15.74"
"66","000","00","009","0927","0465","946","276","670","66","1012","1721","0","58.8","16.04"
"66","000","00","009","0928","0000","2850","881","1969","93","2943","5065","0","58.1","17.39"
"66","000","00","009","0928","0400","907","284","623","9","916","1617","0","56.65","17.56"
"66","000","00","009","0928","0401","855","257","598","43","898","1677","0","53.55","15.32"
"66","000","00","009","0928","0402","1088","340","748","41","1129","1771","0","63.75","19.2"
"66","000","00","009","0929","0000","910","274","636","47","957","1578","0","60.65","17.36"
"66","000","00","009","0929","0466","910","274","636","47","957","1578","0","60.65","17.36"
"66","000","00","009","0930","0000","2965","1001","1964","138","3103","5227","0","59.36","19.15"
"66","000","00","009","0930","0467","1034","358","676","58","1092","1859","0","58.74","19.26"
"66","000","00","009","0930","0468","847","298","549","37","884","1479","0","59.77","20.15"
"66","000","00","009","0930","0469","1084","345","739","43","1127","1889","0","59.66","18.26"
"66","000","00","009","0931","0000","1759","603","1156","99","1858","3224","0","57.63","18.7"
"66","000","00","009","0931","0470","995","333","662","46","1041","1803","0","57.74","18.47"
"66","000","00","009","0931","0471","764","270","494","53","817","1421","0","57.49","19.0"
"66","000","00","009","0932","0000","1977","624","1353","146","2123","3359","0","63.2","18.58"
"66","000","00","009","0932","0472","937","311","626","69","1006","1585","0","63.47","19.62"
"66","000","00","009","0932","0473","1040","313","727","77","1117","1774","0","62.97","17.64"
"66","000","00","009","0933","0000","1190","336","854","73","1263","2132","0","59.24","15.76"
"66","000","00","009","0933","0474","1190","336","854","73","1263","2132","0","59.24","15.76"
"66","000","00","009","0934","0000","1553","457","1096","97","1650","2874","0","57.41","15.9"
"66","000","00","009","0934","0475","839","250","589","67","906","1515","0","59.8","16.5"
"66","000","00","009","0934","0476","714","207","507","30","744","1359","0","54.75","15.23"
"66","000","00","009","0935","0000","1231","408","823","82","1313","2082","0","63.06","19.6"
"66","000","00","009","0935","0477","556","189","367","43","599","948","0","63.19","19.94"
"66","000","00","009","0935","0478","675","219","456","39","714","1134","0","62.96","19.31"
"66","000","00","009","0936","0000","2008","660","1348","155","2163","3346","0","64.64","19.73"
"66","000","00","009","0936","0479","688","223","465","61","749","1114","0","67.24","20.02"
"66","000","00","009","0936","0480","594","191","403","44","638","1050","0","60.76","18.19"
"66","000","00","009","0936","0481","726","246","480","50","776","1182","0","65.65","20.81"
"66","000","00","010","0000","0000","23479","6696","16783","1855","25334","43181","50308","58.67","15.51"
"66","000","00","010","1001","0000","820","197","623","46","866","1357","0","63.82","14.52"
"66","000","00","010","1001","1540","820","197","623","46","866","1357","0","63.82","14.52"
"66","000","00","010","1002","0000","522","141","381","57","579","865","0","66.94","16.3"
"66","000","00","010","1002","1539","522","141","381","57","579","865","0","66.94","16.3"
"66","000","00","010","1003","0000","560","159","401","79","639","1031","0","61.98","15.42"
"66","000","00","010","1003","1538","560","159","401","79","639","1031","0","61.98","15.42"
"66","000","00","010","1004","0000","1128","300","828","57","1185","1850","0","64.05","16.22"
"66","000","00","010","1004","1536","573","154","419","26","599","984","0","60.87","15.65"
"66","000","00","010","1004","1537","555","146","409","31","586","866","0","67.67","16.86"
"66","000","00","010","1005","0000","1246","326","920","138","1384","2196","0","63.02","14.85"
"66","000","00","010","1005","1534","656","171","485","85","741","1169","0","63.39","14.63"
"66","000","00","010","1005","1535","590","155","435","53","643","1027","0","62.61","15.09"
"66","000","00","010","1006","0000","602","160","442","30","632","977","0","64.69","16.38"
"66","000","00","010","1006","1532","602","160","442","30","632","977","0","64.69","16.38"
"66","000","00","010","1007","0000","755","216","539","40","795","1395","0","56.99","15.48"
"66","000","00","010","1007","1533","755","216","539","40","795","1395","0","56.99","15.48"
"66","000","00","010","1008","0000","2042","553","1489","103","2145","3486","0","61.53","15.86"
"66","000","00","010","1008","1529","662","185","477","30","692","1222","0","56.63","15.14"
"66","000","00","010","1008","1530","761","204","557","46","807","1228","0","65.72","16.61"
"66","000","00","010","1008","1531","619","164","455","27","646","1036","0","62.36","15.83"
"66","000","00","010","1009","0000","961","241","720","83","1044","1878","0","55.59","12.83"
"66","000","00","010","1009","1527","455","108","347","17","472","872","0","54.13","12.39"
"66","000","00","010","1009","1528","506","133","373","66","572","1006","0","56.86","13.22"
"66","000","00","010","1010","0000","1992","917","1075","146","2138","3662","0","58.38","25.04"
"66","000","00","010","1010","1523","784","588","196","42","826","1372","0","60.2","42.86"
"66","000","00","010","1010","1524","746","216","530","47","793","1412","0","56.16","15.3"
"66","000","00","010","1010","1525","462","113","349","57","519","878","0","59.11","12.87"
"66","000","00","010","1011","0000","700","166","534","65","765","1475","0","51.86","11.25"
"66","000","00","010","1011","1526","700","166","534","65","765","1475","0","51.86","11.25"
"66","000","00","010","1012","0000","2716","746","1970","206","2922","4908","0","59.54","15.2"
"66","000","00","010","1012","1519","654","213","441","60","714","1335","0","53.48","15.96"
"66","000","00","010","1012","1520","641","200","441","60","701","1092","0","64.19","18.32"
"66","000","00","010","1012","1521","634","137","497","44","678","1050","0","64.57","13.05"
"66","000","00","010","1012","1522","787","196","591","42","829","1431","0","57.93","13.7"
"66","000","00","010","1013","0000","833","220","613","95","928","1628","0","57.0","13.51"
"66","000","00","010","1013","1518","833","220","613","95","928","1628","0","57.0","13.51"
"66","000","00","010","1014","0000","581","173","408","65","646","991","0","65.19","17.46"
"66","000","00","010","1014","1516","581","173","408","65","646","991","0","65.19","17.46"
"66","000","00","010","1015","0000","432","118","314","25","457","863","0","52.95","13.67"
"66","000","00","010","1015","1517","432","118","314","25","457","863","0","52.95","13.67"
"66","000","00","010","1016","0000","952","246","706","109","1061","1866","0","56.86","13.18"
"66","000","00","010","1016","1514","521","135","386","60","581","1007","0","57.7","13.41"
"66","000","00","010","1016","1515","431","111","320","49","480","859","0","55.88","12.92"
"66","000","00","010","1017","0000","661","160","501","62","723","1299","0","55.66","12.32"
"66","000","00","010","1017","1513","661","160","501","62","723","1299","0","55.66","12.32"
"66","000","00","010","1018","0000","1148","297","851","66","1214","1957","0","62.03","15.18"
"66","000","00","010","1018","1544","562","150","412","24","586","950","0","61.68","15.79"
"66","000","00","010","1018","1545","586","147","439","42","628","1007","0","62.36","14.6"
"66","000","00","010","1019","0000","1155","323","832","79","1234","2050","0","60.2","15.76"
"66","000","00","010","1019","1541","423","120","303","33","456","736","0","61.96","16.3"
"66","000","00","010","1019","1542","732","203","529","46","778","1314","0","59.21","15.45"
"66","000","00","010","1020","0000","814","236","578","105","919","1677","0","54.8","14.07"
"66","000","00","010","1020","1543","814","236","578","105","919","1677","0","54.8","14.07"
"66","000","00","010","1021","0000","595","170","425","38","633","1214","0","52.14","14.0"
"66","000","00","010","1021","1546","595","170","425","38","633","1214","0","52.14","14.0"
"66","000","00","010","1022","0000","936","246","690","84","1020","1809","0","56.38","13.6"
"66","000","00","010","1022","1547","481","106","375","43","524","907","0","57.77","11.69"
"66","000","00","010","1022","1548","455","140","315","41","496","902","0","54.99","15.52"
"66","000","00","010","1023","0000","318","92","226","12","330","720","0","45.83","12.78"
"66","000","00","010","1023","1549","318","92","226","12","330","720","0","45.83","12.78"
"66","000","00","010","1024","0000","314","93","221","14","328","666","0","49.25","13.96"
"66","000","00","010","1024","1550","314","93","221","14","328","666","0","49.25","13.96"
"66","000","00","010","1025","0000","696","200","496","51","747","1361","0","54.89","14.7"
"66","000","00","010","1025","1551","696","200","496","51","747","1361","0","54.89","14.7"
"66","000","00","011","0000","0000","34105","10769","23336","2368","36473","63069","77697","57.83","17.07"
"66","000","00","011","1101","0000","750","234","516","63","813","1356","0","59.96","17.26"
"66","000","00","011","1101","0001","750","234","516","63","813","1356","0","59.96","17.26"
"66","000","00","011","1102","0000","623","217","406","42","665","1059","0","62.8","20.49"
"66","000","00","011","1102","0002","623","217","406","42","665","1059","0","62.8","20.49"
"66","000","00","011","1103","0000","919","289","630","53","972","1568","0","61.99","18.43"
"66","000","00","011","1103","0003","413","139","274","30","443","694","0","63.83","20.03"
"66","000","00","011","1103","0004","506","150","356","23","529","874","0","60.53","17.16"
"66","000","00","011","1104","0000","407","113","294","22","429","763","0","56.23","14.81"
"66","000","00","011","1104","0005","407","113","294","22","429","763","0","56.23","14.81"
"66","000","00","011","1105","0000","1225","381","844","78","1303","2105","0","61.9","18.1"
"66","000","00","011","1105","0006","514","166","348","35","549","856","0","64.14","19.39"
"66","000","00","011","1105","0007","711","215","496","43","754","1249","0","60.37","17.21"
"66","000","00","011","1106","0000","1157","362","795","74","1231","2111","0","58.31","17.15"
"66","000","00","011","1106","0008","491","154","337","29","520","922","0","56.4","16.7"
"66","000","00","011","1106","0009","666","208","458","45","711","1189","0","59.8","17.49"
"66","000","00","011","1107","0000","1948","573","1375","153","2101","3374","0","62.27","16.98"
"66","000","00","011","1107","0010","642","185","457","47","689","1065","0","64.69","17.37"
"66","000","00","011","1107","0011","726","208","518","67","793","1252","0","63.34","16.61"
"66","000","00","011","1107","0012","580","180","400","39","619","1057","0","58.56","17.03"
"66","000","00","011","1108","0000","1201","361","840","72","1273","2091","0","60.88","17.26"
"66","000","00","011","1108","0013","569","171","398","35","604","1031","0","58.58","16.59"
"66","000","00","011","1108","0014","632","190","442","37","669","1060","0","63.11","17.92"
"66","000","00","011","1109","0000","2423","726","1697","144","2567","4405","0","58.27","16.48"
"66","000","00","011","1109","0015","723","218","505","46","769","1311","0","58.66","16.63"
"66","000","00","011","1109","0016","767","219","548","48","815","1424","0","57.23","15.38"
"66","000","00","011","1109","0017","933","289","644","50","983","1670","0","58.86","17.31"
"66","000","00","011","1110","0000","441","142","299","41","482","812","0","59.36","17.49"
"66","000","00","011","1110","0018","441","142","299","41","482","812","0","59.36","17.49"
"66","000","00","011","1111","0000","504","134","370","29","533","863","0","61.76","15.53"
"66","000","00","011","1111","0019","504","134","370","29","533","863","0","61.76","15.53"
"66","000","00","011","1112","0000","1763","510","1253","97","1860","3186","0","58.38","16.01"
"66","000","00","011","1112","0020","894","271","623","56","950","1598","0","59.45","16.96"
"66","000","00","011","1112","0021","869","239","630","41","910","1588","0","57.3","15.05"
"66","000","00","011","1113","0000","637","202","435","59","696","1197","0","58.15","16.88"
"66","000","00","011","1113","0022","637","202","435","59","696","1197","0","58.15","16.88"
"66","000","00","011","1114","0000","542","176","366","77","619","1106","0","55.97","15.91"
"66","000","00","011","1114","0023","542","176","366","77","619","1106","0","55.97","15.91"
"66","000","00","011","1115","0000","1032","303","729","84","1116","1772","0","62.98","17.1"
"66","000","00","011","1115","0024","522","161","361","46","568","903","0","62.9","17.83"
"66","000","00","011","1115","0025","510","142","368","38","548","869","0","63.06","16.34"
"66","000","00","011","1116","0000","2944","918","2026","215","3159","5269","0","59.95","17.42"
"66","000","00","011","1116","0026","746","240","506","41","787","1350","0","58.3","17.78"
"66","000","00","011","1116","0027","598","179","419","93","691","1144","0","60.4","15.65"
"66","000","00","011","1116","0028","697","187","510","45","742","1208","0","61.42","15.48"
"66","000","00","011","1116","0029","903","312","591","36","939","1567","0","59.92","19.91"
"66","000","00","011","1117","0000","1217","409","808","61","1278","2013","0","63.49","20.32"
"66","000","00","011","1117","0030","780","284","496","31","811","1246","0","65.09","22.79"
"66","000","00","011","1117","0031","437","125","312","30","467","767","0","60.89","16.3"
"66","000","00","011","1118","0000","1004","288","716","73","1077","1762","0","61.12","16.35"
"66","000","00","011","1118","0032","446","136","310","36","482","790","0","61.01","17.22"
"66","000","00","011","1118","0033","558","152","406","37","595","972","0","61.21","15.64"
"66","000","00","011","1119","0000","716","222","494","54","770","1388","0","55.48","15.99"
"66","000","00","011","1119","0034","716","222","494","54","770","1388","0","55.48","15.99"
"66","000","00","011","1120","0000","2455","1029","1426","113","2568","4432","0","57.94","23.22"
"66","000","00","011","1120","0035","680","195","485","36","716","1331","0","53.79","14.65"
"66","000","00","011","1120","0036","687","212","475","40","727","1167","0","62.3","18.17"
"66","000","00","011","1120","0037","1088","622","466","37","1125","1934","0","58.17","32.16"
"66","000","00","011","1121","0000","600","200","400","61","661","1263","0","52.34","15.84"
"66","000","00","011","1121","0038","600","200","400","61","661","1263","0","52.34","15.84"
"66","000","00","011","1122","0000","2060","640","1420","122","2182","3973","0","54.92","16.11"
"66","000","00","011","1122","0039","748","240","508","47","795","1390","0","57.19","17.27"
"66","000","00","011","1122","0040","550","166","384","44","594","1186","0","50.08","14.0"
"66","000","00","011","1122","0041","762","234","528","31","793","1397","0","56.76","16.75"
"66","000","00","011","1123","0000","1229","385","844","74","1303","2571","0","50.68","14.97"
"66","000","00","011","1123","0042","509","142","367","21","530","1173","0","45.18","12.11"
"66","000","00","011","1123","0043","720","243","477","53","773","1398","0","55.29","17.38"
"66","000","00","011","1124","0000","2782","897","1885","173","2955","5453","0","54.19","16.45"
"66","000","00","011","1124","0044","589","204","385","51","640","1228","0","52.12","16.61"
"66","000","00","011","1124","0045","642","200","442","40","682","1258","0","54.21","15.9"
"66","000","00","011","1124","0046","747","225","522","42","789","1435","0","54.98","15.68"
"66","000","00","011","1124","0047","804","268","536","40","844","1532","0","55.09","17.49"
"66","000","00","011","1125","0000","751","225","526","69","820","1522","0","53.88","14.78"
"66","000","00","011","1125","0048","351","102","249","31","382","652","0","58.59","15.64"
"66","000","00","011","1125","0049","400","123","277","38","438","870","0","50.34","14.14"
"66","000","00","011","1126","0000","886","252","634","58","944","1675","0","56.36","15.04"
"66","000","00","011","1126","0050","452","124","328","26","478","891","0","53.65","13.92"
"66","000","00","011","1126","0051","434","128","306","32","466","784","0","59.44","16.33"
"66","000","00","011","1127","0000","664","190","474","87","751","1368","0","54.9","13.89"
"66","000","00","011","1127","0052","664","190","474","87","751","1368","0","54.9","13.89"
"66","000","00","011","1128","0000","552","165","387","53","605","1126","0","53.73","14.65"
"66","000","00","011","1128","0053","552","165","387","53","605","1126","0","53.73","14.65"
"66","000","00","011","1129","0000","673","226","447","67","740","1486","0","49.8","15.21"
"66","000","00","011","1129","0054","673","226","447","67","740","1486","0","49.8","15.21"
"66","000","00","012","0000","0000","39102","12574","26528","2788","41890","71528","86659","58.56","17.58"
"66","000","00","012","1201","0000","559","197","362","28","587","1076","0","54.55","18.31"
"66","000","00","012","1201","0091","559","197","362","28","587","1076","0","54.55","18.31"
"66","000","00","012","1202","0000","584","211","373","41","625","953","0","65.58","22.14"
"66","000","00","012","1202","0092","584","211","373","41","625","953","0","65.58","22.14"
"66","000","00","012","1203","0000","1195","417","778","112","1307","2057","0","63.54","20.27"
"66","000","00","012","1203","0093","515","189","326","60","575","914","0","62.91","20.68"
"66","000","00","012","1203","0094","680","228","452","52","732","1143","0","64.04","19.95"
"66","000","00","012","1204","0000","396","136","260","28","424","680","0","62.35","20.0"
"66","000","00","012","1204","0095","396","136","260","28","424","680","0","62.35","20.0"
"66","000","00","012","1205","0000","1062","346","716","85","1147","1797","0","63.83","19.25"
"66","000","00","012","1205","0096","530","164","366","35","565","904","0","62.5","18.14"
"66","000","00","012","1205","0097","532","182","350","50","582","893","0","65.17","20.38"
"66","000","00","012","1206","0000","871","285","586","48","919","1577","0","58.28","18.07"
"66","000","00","012","1206","0098","871","285","586","48","919","1577","0","58.28","18.07"
"66","000","00","012","1207","0000","367","119","248","41","408","690","0","59.13","17.25"
"66","000","00","012","1207","0099","367","119","248","41","408","690","0","59.13","17.25"
"66","000","00","012","1208","0000","235","84","151","12","247","403","0","61.29","20.84"
"66","000","00","012","1208","0100","235","84","151","12","247","403","0","61.29","20.84"
"66","000","00","012","1209","0000","1206","401","805","102","1308","2190","0","59.73","18.31"
"66","000","00","012","1209","0101","782","266","516","63","845","1413","0","59.8","18.83"
"66","000","00","012","1209","0102","424","135","289","39","463","777","0","59.59","17.37"
"66","000","00","012","1210","0000","5411","1736","3675","242","5653","9237","0","61.2","18.79"
"66","000","00","012","1210","0103","767","227","540","34","801","1313","0","61.01","17.29"
"66","000","00","012","1210","0104","845","249","596","48","893","1439","0","62.06","17.3"
"66","000","00","012","1210","0105","663","221","442","33","696","1265","0","55.02","17.47"
"66","000","00","012","1210","0106","767","251","516","38","805","1277","0","63.04","19.66"
"66","000","00","012","1210","0107","742","239","503","32","774","1276","0","60.66","18.73"
"66","000","00","012","1210","0108","842","284","558","25","867","1376","0","63.01","20.64"
"66","000","00","012","1210","0109","785","265","520","32","817","1291","0","63.28","20.53"
"66","000","00","012","1211","0000","863","318","545","54","917","1510","0","60.73","21.06"
"66","000","00","012","1211","0110","863","318","545","54","917","1510","0","60.73","21.06"
"66","000","00","012","1212","0000","829","261","568","6","835","1524","0","54.79","17.13"
"66","000","00","012","1212","0111","829","261","568","6","835","1524","0","54.79","17.13"
"66","000","00","012","1213","0000","2354","745","1609","159","2513","4302","0","58.41","17.32"
"66","000","00","012","1213","0112","759","251","508","38","797","1474","0","54.07","17.03"
"66","000","00","012","1213","0113","802","247","555","52","854","1507","0","56.67","16.39"
"66","000","00","012","1213","0114","793","247","546","69","862","1321","0","65.25","18.7"
"66","000","00","012","1214","0000","1774","584","1190","111","1885","3293","0","57.24","17.73"
"66","000","00","012","1214","0115","578","186","392","35","613","1157","0","52.98","16.08"
"66","000","00","012","1214","0116","715","247","468","46","761","1255","0","60.64","19.68"
"66","000","00","012","1214","0117","481","151","330","30","511","881","0","58.0","17.14"
"66","000","00","012","1215","0000","1185","382","803","79","1264","2034","0","62.14","18.78"
"66","000","00","012","1215","0118","620","205","415","50","670","1083","0","61.87","18.93"
"66","000","00","012","1215","0119","565","177","388","29","594","951","0","62.46","18.61"
"66","000","00","012","1216","0000","2608","856","1752","204","2812","5145","0","54.66","16.64"
"66","000","00","012","1216","0120","743","238","505","40","783","1424","0","54.99","16.71"
"66","000","00","012","1216","0121","610","200","410","63","673","1233","0","54.58","16.22"
"66","000","00","012","1216","0122","585","204","381","49","634","1288","0","49.22","15.84"
"66","000","00","012","1216","0123","670","214","456","52","722","1200","0","60.17","17.83"
"66","000","00","012","1217","0000","1637","452","1185","48","1685","2745","0","61.38","16.47"
"66","000","00","012","1217","0124","935","214","721","25","960","1609","0","59.66","13.3"
"66","000","00","012","1217","0125","702","238","464","23","725","1136","0","63.82","20.95"
"66","000","00","012","1218","0000","672","189","483","65","737","1302","0","56.61","14.52"
"66","000","00","012","1218","0126","672","189","483","65","737","1302","0","56.61","14.52"
"66","000","00","012","1219","0000","702","242","460","78","780","1373","0","56.81","17.63"
"66","000","00","012","1219","0127","702","242","460","78","780","1373","0","56.81","17.63"
"66","000","00","012","1220","0000","590","211","379","66","656","1257","0","52.19","16.79"
"66","000","00","012","1220","0128","590","211","379","66","656","1257","0","52.19","16.79"
"66","000","00","012","1221","0000","557","175","382","68","625","1184","0","52.79","14.78"
"66","000","00","012","1221","0129","557","175","382","68","625","1184","0","52.79","14.78"
"66","000","00","012","1222","0000","685","188","497","64","749","1322","0","56.66","14.22"
"66","000","00","012","1222","0130","685","188","497","64","749","1322","0","56.66","14.22"
"66","000","00","012","1223","0000","1048","367","681","136","1184","2120","0","55.85","17.31"
"66","000","00","012","1223","0131","589","208","381","48","637","1193","0","53.39","17.44"
"66","000","00","012","1223","0132","459","159","300","88","547","927","0","59.01","17.15"
"66","000","00","012","1224","0000","1264","453","811","129","1393","2236","0","62.3","20.26"
"66","000","00","012","1224","0133","605","212","393","64","669","1073","0","62.35","19.76"
"66","000","00","012","1224","0134","659","241","418","65","724","1163","0","62.25","20.72"
"66","000","00","012","1225","0000","884","264","620","96","980","1757","0","55.78","15.03"
"66","000","00","012","1225","0135","443","124","319","35","478","855","0","55.91","14.5"
"66","000","00","012","1225","0136","441","140","301","61","502","902","0","55.65","15.52"
"66","000","00","012","1226","0000","1316","445","871","86","1402","2481","0","56.51","17.94"
"66","000","00","012","1226","0137","771","268","503","48","819","1415","0","57.88","18.94"
"66","000","00","012","1226","0138","545","177","368","38","583","1066","0","54.69","16.6"
"66","000","00","012","1227","0000","3938","1246","2692","248","4186","7264","0","57.63","17.15"
"66","000","00","012","1227","0139","730","250","480","68","798","1391","0","57.37","17.97"
"66","000","00","012","1227","0140","727","202","525","39","766","1449","0","52.86","13.94"
"66","000","00","012","1227","0141","784","246","538","51","835","1377","0","60.64","17.86"
"66","000","00","012","1227","0142","798","268","530","48","846","1423","0","59.45","18.83"
"66","000","00","012","1227","0143","899","280","619","42","941","1624","0","57.94","17.24"
"66","000","00","012","1228","0000","1368","442","926","141","1509","2822","0","53.47","15.66"
"66","000","00","012","1228","0144","579","211","368","75","654","1358","0","48.16","15.54"
"66","000","00","012","1228","0145","789","231","558","66","855","1464","0","58.4","15.78"
"66","000","00","012","1229","0000","677","236","441","68","745","1211","0","61.52","19.49"
"66","000","00","012","1229","0146","677","236","441","68","745","1211","0","61.52","19.49"
"66","000","00","012","1230","0000","657","182","475","68","725","1162","0","62.39","15.66"
"66","000","00","012","1230","0148","657","182","475","68","725","1162","0","62.39","15.66"
"66","000","00","012","1231","0000","825","206","619","51","876","1368","0","64.04","15.06"
"66","000","00","012","1231","0149","825","206","619","51","876","1368","0","64.04","15.06"
"66","000","00","012","1232","0000","783","198","585","24","807","1456","0","55.43","13.6"
"66","000","00","012","1232","0147","783","198","585","24","807","1456","0","55.43","13.6"
"66","000","00","013","0000","0000","40043","12711","27332","2280","42323","74207","93720","57.03","17.13"
"66","000","00","013","1301","0000","705","258","447","34","739","1380","0","53.55","18.7"
"66","000","00","013","1301","0186","705","258","447","34","739","1380","0","53.55","18.7"
"66","000","00","013","1302","0000","1193","480","713","59","1252","2028","0","61.74","23.67"
"66","000","00","013","1302","0187","495","160","335","27","522","852","0","61.27","18.78"
"66","000","00","013","1302","0188","698","320","378","32","730","1176","0","62.07","27.21"
"66","000","00","013","1303","0000","583","210","373","63","646","958","0","67.43","21.92"
"66","000","00","013","1303","0189","583","210","373","63","646","958","0","67.43","21.92"
"66","000","00","013","1304","0000","298","91","207","37","335","488","0","68.65","18.65"
"66","000","00","013","1304","0190","298","91","207","37","335","488","0","68.65","18.65"
"66","000","00","013","1305","0000","1341","477","864","88","1429","2462","0","58.04","19.37"
"66","000","00","013","1305","0191","653","241","412","39","692","1177","0","58.79","20.48"
"66","000","00","013","1305","0192","688","236","452","49","737","1285","0","57.35","18.37"
"66","000","00","013","1306","0000","2419","708","1711","124","2543","4336","0","58.65","16.33"
"66","000","00","013","1306","0195","776","238","538","34","810","1469","0","55.14","16.2"
"66","000","00","013","1306","0196","836","250","586","35","871","1423","0","61.21","17.57"
"66","000","00","013","1306","0197","807","220","587","55","862","1444","0","59.7","15.24"
"66","000","00","013","1307","0000","2800","943","1857","158","2958","5046","0","58.62","18.69"
"66","000","00","013","1307","0198","802","258","544","63","865","1469","0","58.88","17.56"
"66","000","00","013","1307","0199","1042","364","678","62","1104","1902","0","58.04","19.14"
"66","000","00","013","1307","0200","956","321","635","33","989","1675","0","59.04","19.16"
"66","000","00","013","1308","0000","3794","1280","2514","199","3993","6728","0","59.35","19.02"
"66","000","00","013","1308","0201","586","193","393","49","635","1098","0","57.83","17.58"
"66","000","00","013","1308","0202","890","311","579","47","937","1539","0","60.88","20.21"
"66","000","00","013","1308","0203","790","257","533","23","813","1329","0","61.17","19.34"
"66","000","00","013","1308","0204","679","228","451","31","710","1255","0","56.57","18.17"
"66","000","00","013","1308","0205","849","291","558","49","898","1507","0","59.59","19.31"
"66","000","00","013","1309","0000","3923","1256","2667","263","4186","7300","0","57.34","17.21"
"66","000","00","013","1309","0206","811","263","548","58","869","1463","0","59.4","17.98"
"66","000","00","013","1309","0207","651","216","435","57","708","1279","0","55.36","16.89"
"66","000","00","013","1309","0208","513","153","360","32","545","1024","0","53.22","14.94"
"66","000","00","013","1309","0209","705","213","492","55","760","1388","0","54.76","15.35"
"66","000","00","013","1309","0210","621","215","406","28","649","1074","0","60.43","20.02"
"66","000","00","013","1309","0211","622","196","426","33","655","1072","0","61.1","18.28"
"66","000","00","013","1310","0000","638","171","467","52","690","1107","0","62.33","15.45"
"66","000","00","013","1310","0212","638","171","467","52","690","1107","0","62.33","15.45"
"66","000","00","013","1311","0000","2436","748","1688","123","2559","4771","0","53.64","15.68"
"66","000","00","013","1311","0215","909","270","639","45","954","1633","0","58.42","16.53"
"66","000","00","013","1311","0216","779","243","536","48","827","1533","0","53.95","15.85"
"66","000","00","013","1311","0217","748","235","513","30","778","1605","0","48.47","14.64"
"66","000","00","013","1312","0000","1786","526","1260","112","1898","3629","0","52.3","14.49"
"66","000","00","013","1312","0213","940","280","660","52","992","1947","0","50.95","14.38"
"66","000","00","013","1312","0214","846","246","600","60","906","1682","0","53.86","14.63"
"66","000","00","013","1313","0000","869","251","618","30","899","1694","0","53.07","14.82"
"66","000","00","013","1313","0218","869","251","618","30","899","1694","0","53.07","14.82"
"66","000","00","013","1314","0000","2653","860","1793","113","2766","4944","0","55.95","17.39"
"66","000","00","013","1314","0219","827","275","552","50","877","1628","0","53.87","16.89"
"66","000","00","013","1314","0220","953","317","636","25","978","1665","0","58.74","19.04"
"66","000","00","013","1314","0221","873","268","605","38","911","1651","0","55.18","16.23"
"66","000","00","013","1315","0000","1889","528","1361","103","1992","3289","0","60.57","16.05"
"66","000","00","013","1315","0222","657","194","463","32","689","1108","0","62.18","17.51"
"66","000","00","013","1315","0223","658","186","472","42","700","1142","0","61.3","16.29"
"66","000","00","013","1315","0224","574","148","426","29","603","1039","0","58.04","14.24"
"66","000","00","013","1316","0000","2744","901","1843","150","2894","5270","0","54.91","17.1"
"66","000","00","013","1316","0225","950","311","639","66","1016","1840","0","55.22","16.9"
"66","000","00","013","1316","0226","1004","325","679","36","1040","1872","0","55.56","17.36"
"66","000","00","013","1316","0227","790","265","525","48","838","1558","0","53.79","17.01"
"66","000","00","013","1317","0000","2360","690","1670","121","2481","4314","0","57.51","15.99"
"66","000","00","013","1317","0232","863","270","593","44","907","1593","0","56.94","16.95"
"66","000","00","013","1317","0233","517","133","384","23","540","981","0","55.05","13.56"
"66","000","00","013","1317","0234","980","287","693","54","1034","1740","0","59.43","16.49"
"66","000","00","013","1318","0000","1329","393","936","63","1392","2294","0","60.68","17.13"
"66","000","00","013","1318","0235","721","240","481","47","768","1247","0","61.59","19.25"
"66","000","00","013","1318","0236","608","153","455","16","624","1047","0","59.6","14.61"
"66","000","00","013","1319","0000","1157","308","849","88","1245","2144","0","58.07","14.37"
"66","000","00","013","1319","0237","600","166","434","66","666","1119","0","59.52","14.83"
"66","000","00","013","1319","0238","557","142","415","22","579","1025","0","56.49","13.85"
"66","000","00","013","1320","0000","1808","585","1223","131","1939","3364","0","57.64","17.39"
"66","000","00","013","1320","0193","872","278","594","68","940","1736","0","54.15","16.01"
"66","000","00","013","1320","0194","936","307","629","63","999","1628","0","61.36","18.86"
"66","000","00","013","1321","0000","3318","1047","2271","169","3487","6661","0","52.35","15.72"
"66","000","00","013","1321","0228","867","283","584","38","905","1739","0","52.04","16.27"
"66","000","00","013","1321","0229","794","248","546","51","845","1672","0","50.54","14.83"
"66","000","00","013","1321","0230","879","268","611","31","910","1634","0","55.69","16.4"
"66","000","00","013","1321","0231","778","248","530","49","827","1616","0","51.18","15.35"
"66","000","00","014","0000","0000","25227","7915","17312","1665","26892","47040","58189","57.17","16.83"
"66","000","00","014","1401","0000","1662","572","1090","98","1760","3122","0","56.37","18.32"
"66","000","00","014","1401","0150","822","281","541","50","872","1541","0","56.59","18.23"
"66","000","00","014","1401","0151","840","291","549","48","888","1581","0","56.17","18.41"
"66","000","00","014","1402","0000","1105","362","743","67","1172","1959","0","59.83","18.48"
"66","000","00","014","1402","0152","597","196","401","45","642","1083","0","59.28","18.1"
"66","000","00","014","1402","0153","508","166","342","22","530","876","0","60.5","18.95"
"66","000","00","014","1403","0000","2048","651","1397","145","2193","3929","0","55.82","16.57"
"66","000","00","014","1403","0154","565","183","382","50","615","1043","0","58.96","17.55"
"66","000","00","014","1403","0155","736","230","506","41","777","1502","0","51.73","15.31"
"66","000","00","014","1403","0156","747","238","509","54","801","1384","0","57.88","17.2"
"66","000","00","014","1404","0000","325","98","227","26","351","517","0","67.89","18.96"
"66","000","00","014","1404","0157","325","98","227","26","351","517","0","67.89","18.96"
"66","000","00","014","1405","0000","703","219","484","50","753","1169","0","64.41","18.73"
"66","000","00","014","1405","0158","703","219","484","50","753","1169","0","64.41","18.73"
"66","000","00","014","1406","0000","484","163","321","40","524","863","0","60.72","18.89"
"66","000","00","014","1406","0159","484","163","321","40","524","863","0","60.72","18.89"
"66","000","00","014","1407","0000","3184","1044","2140","221","3405","6128","0","55.56","17.04"
"66","000","00","014","1407","0160","600","207","393","41","641","1277","0","50.2","16.21"
"66","000","00","014","1407","0161","903","294","609","42","945","1742","0","54.25","16.88"
"66","000","00","014","1407","0162","732","229","503","61","793","1342","0","59.09","17.06"
"66","000","00","014","1407","0163","949","314","635","77","1026","1767","0","58.06","17.77"
"66","000","00","014","1408","0000","2502","799","1703","146","2648","4974","0","53.24","16.06"
"66","000","00","014","1408","0164","750","268","482","48","798","1542","0","51.75","17.38"
"66","000","00","014","1408","0165","853","244","609","44","897","1636","0","54.83","14.91"
"66","000","00","014","1408","0166","899","287","612","54","953","1796","0","53.06","15.98"
"66","000","00","014","1409","0000","2298","679","1619","165","2463","4364","0","56.44","15.56"
"66","000","00","014","1409","0167","761","221","540","39","800","1450","0","55.17","15.24"
"66","000","00","014","1409","0168","767","219","548","89","856","1548","0","55.3","14.15"
"66","000","00","014","1409","0169","770","239","531","37","807","1366","0","59.08","17.5"
"66","000","00","014","1410","0000","4091","1164","2927","275","4366","7342","0","59.47","15.85"
"66","000","00","014","1410","0170","591","187","404","29","620","955","0","64.92","19.58"
"66","000","00","014","1410","0171","673","183","490","47","720","1305","0","55.17","14.02"
"66","000","00","014","1410","0172","707","164","543","28","735","1239","0","59.32","13.24"
"66","000","00","014","1410","0173","605","175","430","64","669","1079","0","62.0","16.22"
"66","000","00","014","1410","0174","659","193","466","36","695","1220","0","56.97","15.82"
"66","000","00","014","1410","0175","856","262","594","71","927","1544","0","60.04","16.97"
"66","000","00","014","1411","0000","3083","1011","2072","168","3251","5607","0","57.98","18.03"
"66","000","00","014","1411","0176","839","290","549","47","886","1460","0","60.68","19.86"
"66","000","00","014","1411","0177","747","233","514","40","787","1292","0","60.91","18.03"
"66","000","00","014","1411","0178","696","219","477","43","739","1300","0","56.85","16.85"
"66","000","00","014","1411","0179","801","269","532","38","839","1555","0","53.95","17.3"
"66","000","00","014","1412","0000","1222","391","831","96","1318","2308","0","57.11","16.94"
"66","000","00","014","1412","0180","536","176","360","42","578","1031","0","56.06","17.07"
"66","000","00","014","1412","0181","686","215","471","54","740","1277","0","57.95","16.84"
"66","000","00","014","1413","0000","1200","380","820","90","1290","2224","0","58.0","17.09"
"66","000","00","014","1413","0182","544","174","370","38","582","1037","0","56.12","16.78"
"66","000","00","014","1413","0183","656","206","450","52","708","1187","0","59.65","17.35"
"66","000","00","014","1414","0000","1320","382","938","78","1398","2534","0","55.17","15.07"
"66","000","00","014","1414","0184","714","204","510","44","758","1399","0","54.18","14.58"
"66","000","00","014","1414","0185","606","178","428","34","640","1135","0","56.39","15.68"
"66","000","00","015","0000","0000","24586","7622","16964","1666","26252","44962","54682","58.39","16.95"
"66","000","00","015","1501","0000","1093","318","775","104","1197","1987","0","60.24","16.0"
"66","000","00","015","1501","0357","505","154","351","42","547","852","0","64.2","18.08"
"66","000","00","015","1501","0358","588","164","424","62","650","1135","0","57.27","14.45"
"66","000","00","015","1502","0000","536","170","366","52","588","1079","0","54.49","15.76"
"66","000","00","015","1502","0359","536","170","366","52","588","1079","0","54.49","15.76"
"66","000","00","015","1503","0000","1741","528","1213","97","1838","3130","0","58.72","16.87"
"66","000","00","015","1503","0360","861","248","613","51","912","1539","0","59.26","16.11"
"66","000","00","015","1503","0361","880","280","600","46","926","1591","0","58.2","17.6"
"66","000","00","015","1504","0000","2156","651","1505","138","2294","3701","0","61.98","17.59"
"66","000","00","015","1504","0364","796","254","542","59","855","1428","0","59.87","17.79"
"66","000","00","015","1504","0365","740","235","505","43","783","1178","0","66.47","19.95"
"66","000","00","015","1504","0366","620","162","458","36","656","1095","0","59.91","14.79"
"66","000","00","015","1505","0000","1149","376","773","70","1219","2126","0","57.34","17.69"
"66","000","00","015","1505","0367","523","172","351","27","550","963","0","57.11","17.86"
"66","000","00","015","1505","0368","626","204","422","43","669","1163","0","57.52","17.54"
"66","000","00","015","1506","0000","2695","820","1875","149","2844","4712","0","60.36","17.4"
"66","000","00","015","1506","0369","590","191","399","29","619","1018","0","60.81","18.76"
"66","000","00","015","1506","0370","527","163","364","26","553","854","0","64.75","19.09"
"66","000","00","015","1506","0371","771","222","549","43","814","1485","0","54.81","14.95"
"66","000","00","015","1506","0372","807","244","563","51","858","1355","0","63.32","18.01"
"66","000","00","015","1507","0000","1058","340","718","102","1160","1986","0","58.41","17.12"
"66","000","00","015","1507","0373","422","142","280","47","469","840","0","55.83","16.9"
"66","000","00","015","1507","0374","636","198","438","55","691","1146","0","60.3","17.28"
"66","000","00","015","1508","0000","1922","573","1349","151","2073","3342","0","62.03","17.15"
"66","000","00","015","1508","0375","960","289","671","66","1026","1669","0","61.47","17.32"
"66","000","00","015","1508","0376","962","284","678","85","1047","1673","0","62.58","16.98"
"66","000","00","015","1509","0000","1919","637","1282","109","2028","3454","0","58.71","18.44"
"66","000","00","015","1509","0377","835","279","556","39","874","1493","0","58.54","18.69"
"66","000","00","015","1509","0378","603","210","393","53","656","1052","0","62.36","19.96"
"66","000","00","015","1509","0379","481","148","333","17","498","909","0","54.79","16.28"
"66","000","00","015","1510","0000","1381","418","963","129","1510","2433","0","62.06","17.18"
"66","000","00","015","1510","0380","615","194","421","64","679","1091","0","62.24","17.78"
"66","000","00","015","1510","0381","766","224","542","65","831","1342","0","61.92","16.69"
"66","000","00","015","1511","0000","1139","345","794","96","1235","2115","0","58.39","16.31"
"66","000","00","015","1511","0382","581","183","398","65","646","1138","0","56.77","16.08"
"66","000","00","015","1511","0383","558","162","396","31","589","977","0","60.29","16.58"
"66","000","00","015","1512","0000","739","216","523","42","781","1584","0","49.31","13.64"
"66","000","00","015","1512","0384","739","216","523","42","781","1584","0","49.31","13.64"
"66","000","00","015","1513","0000","1173","336","837","104","1277","2140","0","59.67","15.7"
"66","000","00","015","1513","0385","506","131","375","33","539","915","0","58.91","14.32"
"66","000","00","015","1513","0386","667","205","462","71","738","1225","0","60.24","16.73"
"66","000","00","015","1514","0000","1697","501","1196","65","1762","3152","0","55.9","15.89"
"66","000","00","015","1514","0387","841","249","592","34","875","1552","0","56.38","16.04"
"66","000","00","015","1514","0388","856","252","604","31","887","1600","0","55.44","15.75"
"66","000","00","015","1515","0000","678","209","469","41","719","1340","0","53.66","15.6"
"66","000","00","015","1515","0393","678","209","469","41","719","1340","0","53.66","15.6"
"66","000","00","015","1516","0000","1096","460","636","97","1193","2122","0","56.22","21.68"
"66","000","00","015","1516","0391","520","271","249","42","562","1055","0","53.27","25.69"
"66","000","00","015","1516","0392","576","189","387","55","631","1067","0","59.14","17.71"
"66","000","00","015","1517","0000","1006","301","705","57","1063","1885","0","56.39","15.97"
"66","000","00","015","1517","0389","505","148","357","30","535","942","0","56.79","15.71"
"66","000","00","015","1517","0390","501","153","348","27","528","943","0","55.99","16.22"
"66","000","00","015","1518","0000","1408","423","985","63","1471","2674","0","55.01","15.82"
"66","000","00","015","1518","0362","684","196","488","39","723","1376","0","52.54","14.24"
"66","000","00","015","1518","0363","724","227","497","24","748","1298","0","57.63","17.49"
"66","000","00","016","0000","0000","30278","9121","21157","2144","32422","54565","65692","59.42","16.72"
"66","000","00","016","1601","0000","1796","533","1263","117","1913","3243","0","58.99","16.44"
"66","000","00","016","1601","0482","926","277","649","62","988","1684","0","58.67","16.45"
"66","000","00","016","1601","0483","870","256","614","55","925","1559","0","59.33","16.42"
"66","000","00","016","1602","0000","1275","407","868","75","1350","2139","0","63.11","19.03"
"66","000","00","016","1602","0484","606","188","418","34","640","1095","0","58.45","17.17"
"66","000","00","016","1602","0485","669","219","450","41","710","1044","0","68.01","20.98"
"66","000","00","016","1603","0000","1528","466","1062","155","1683","2604","0","64.63","17.9"
"66","000","00","016","1603","0486","777","219","558","78","855","1310","0","65.27","16.72"
"66","000","00","016","1603","0487","751","247","504","77","828","1294","0","63.99","19.09"
"66","000","00","016","1604","0000","1209","361","848","120","1329","2165","0","61.39","16.67"
"66","000","00","016","1604","0488","635","188","447","56","691","1143","0","60.45","16.45"
"66","000","00","016","1604","0489","574","173","401","64","638","1022","0","62.43","16.93"
"66","000","00","016","1605","0000","3914","1192","2722","228","4142","7265","0","57.01","16.41"
"66","000","00","016","1605","0498","776","214","562","40","816","1452","0","56.2","14.74"
"66","000","00","016","1605","0499","895","268","627","60","955","1551","0","61.57","17.28"
"66","000","00","016","1605","0500","800","262","538","61","861","1567","0","54.95","16.72"
"66","000","00","016","1605","0501","803","260","543","38","841","1449","0","58.04","17.94"
"66","000","00","016","1605","0502","640","188","452","29","669","1246","0","53.69","15.09"
"66","000","00","016","1606","0000","3025","970","2055","247","3272","5267","0","62.12","18.42"
"66","000","00","016","1606","0503","806","224","582","54","860","1431","0","60.1","15.65"
"66","000","00","016","1606","0504","670","236","434","64","734","1163","0","63.11","20.29"
"66","000","00","016","1606","0505","838","279","559","74","912","1402","0","65.05","19.9"
"66","000","00","016","1606","0506","711","231","480","55","766","1271","0","60.27","18.17"
"66","000","00","016","1607","0000","1416","393","1023","125","1541","2510","0","61.39","15.66"
"66","000","00","016","1607","0507","676","196","480","59","735","1198","0","61.35","16.36"
"66","000","00","016","1607","0508","740","197","543","66","806","1312","0","61.43","15.02"
"66","000","00","016","1608","0000","1627","474","1153","95","1722","2885","0","59.69","16.43"
"66","000","00","016","1608","0512","898","254","644","59","957","1483","0","64.53","17.13"
"66","000","00","016","1608","0513","729","220","509","36","765","1402","0","54.56","15.69"
"66","000","00","016","1609","0000","2318","722","1596","123","2441","4329","0","56.39","16.68"
"66","000","00","016","1609","0509","846","257","589","61","907","1590","0","57.04","16.16"
"66","000","00","016","1609","0510","715","214","501","31","746","1324","0","56.34","16.16"
"66","000","00","016","1609","0511","757","251","506","31","788","1415","0","55.69","17.74"
"66","000","00","016","1610","0000","3936","1220","2716","277","4213","7224","0","58.32","16.89"
"66","000","00","016","1610","0514","666","208","458","51","717","1275","0","56.24","16.31"
"66","000","00","016","1610","0515","664","197","467","41","705","1288","0","54.74","15.3"
"66","000","00","016","1610","0516","561","147","414","56","617","1080","0","57.13","13.61"
"66","000","00","016","1610","0517","730","228","502","30","760","1344","0","56.55","16.96"
"66","000","00","016","1610","0518","619","200","419","49","668","1061","0","62.96","18.85"
"66","000","00","016","1610","0519","696","240","456","50","746","1176","0","63.44","20.41"
"66","000","00","016","1611","0000","1504","447","1057","124","1628","2562","0","63.54","17.45"
"66","000","00","016","1611","0520","722","218","504","58","780","1244","0","62.7","17.52"
"66","000","00","016","1611","0521","782","229","553","66","848","1318","0","64.34","17.37"
"66","000","00","016","1612","0000","1564","461","1103","124","1688","2794","0","60.42","16.5"
"66","000","00","016","1612","0522","765","225","540","47","812","1471","0","55.2","15.3"
"66","000","00","016","1612","0523","799","236","563","77","876","1323","0","66.21","17.84"
"66","000","00","016","1613","0000","1174","297","877","82","1256","2354","0","53.36","12.62"
"66","000","00","016","1613","0490","664","167","497","51","715","1269","0","56.34","13.16"
"66","000","00","016","1613","0491","510","130","380","31","541","1085","0","49.86","11.98"
"66","000","00","016","1614","0000","2230","636","1594","156","2386","4090","0","58.34","15.55"
"66","000","00","016","1614","0494","738","215","523","50","788","1390","0","56.69","15.47"
"66","000","00","016","1614","0495","802","229","573","66","868","1372","0","63.27","16.69"
"66","000","00","016","1614","0496","690","192","498","40","730","1328","0","54.97","14.46"
"66","000","00","016","1615","0000","1199","351","848","79","1278","2096","0","60.97","16.75"
"66","000","00","016","1615","0492","560","171","389","38","598","942","0","63.48","18.15"
"66","000","00","016","1615","0493","639","180","459","41","680","1154","0","58.93","15.6"
"66","000","00","016","1616","0000","563","191","372","17","580","1038","0","55.88","18.4"
"66","000","00","016","1616","0497","563","191","372","17","580","1038","0","55.88","18.4"
"66","000","00","017","0000","0000","49060","15257","33803","2572","51632","89487","108777","57.7","17.05"
"66","000","00","017","1701","0000","5919","1917","4002","336","6255","10976","0","56.99","17.47"
"66","000","00","017","1701","0573","923","308","615","78","1001","1630","0","61.41","18.9"
"66","000","00","017","1701","0574","846","260","586","43","889","1532","0","58.03","16.97"
"66","000","00","017","1701","0575","843","269","574","33","876","1677","0","52.24","16.04"
"66","000","00","017","1701","0576","887","276","611","58","945","1744","0","54.19","15.83"
"66","000","00","017","1701","0577","983","328","655","59","1042","1795","0","58.05","18.27"
"66","000","00","017","1701","0578","642","213","429","40","682","1171","0","58.24","18.19"
"66","000","00","017","1701","0579","795","263","532","25","820","1427","0","57.46","18.43"
"66","000","00","017","1702","0000","763","222","541","43","806","1306","0","61.72","17.0"
"66","000","00","017","1702","0570","763","222","541","43","806","1306","0","61.72","17.0"
"66","000","00","017","1703","0000","1355","420","935","90","1445","2287","0","63.18","18.36"
"66","000","00","017","1703","0571","657","211","446","42","699","1128","0","61.97","18.71"
"66","000","00","017","1703","0572","698","209","489","48","746","1159","0","64.37","18.03"
"66","000","00","017","1704","0000","5550","1685","3865","309","5859","10187","0","57.51","16.54"
"66","000","00","017","1704","0580","936","258","678","54","990","1709","0","57.93","15.1"
"66","000","00","017","1704","0581","937","286","651","49","986","1723","0","57.23","16.6"
"66","000","00","017","1704","0582","934","244","690","52","986","1782","0","55.33","13.69"
"66","000","00","017","1704","0583","717","218","499","50","767","1407","0","54.51","15.49"
"66","000","00","017","1704","0584","1018","343","675","26","1044","1771","0","58.95","19.37"
"66","000","00","017","1704","0585","1008","336","672","78","1086","1795","0","60.5","18.72"
"66","000","00","017","1705","0000","2916","937","1979","141","3057","5195","0","58.85","18.04"
"66","000","00","017","1705","0586","943","296","647","67","1010","1612","0","62.66","18.36"
"66","000","00","017","1705","0587","1033","326","707","36","1069","1894","0","56.44","17.21"
"66","000","00","017","1705","0588","940","315","625","38","978","1689","0","57.9","18.65"
"66","000","00","017","1706","0000","5170","1628","3542","230","5400","9343","0","57.8","17.42"
"66","000","00","017","1706","0599","949","292","657","49","998","1666","0","59.9","17.53"
"66","000","00","017","1706","0600","940","297","643","49","989","1750","0","56.51","16.97"
"66","000","00","017","1706","0601","786","226","560","32","818","1437","0","56.92","15.73"
"66","000","00","017","1706","0602","939","295","644","35","974","1735","0","56.14","17.0"
"66","000","00","017","1706","0603","878","284","594","37","915","1612","0","56.76","17.62"
"66","000","00","017","1706","0604","678","234","444","28","706","1143","0","61.77","20.47"
"66","000","00","017","1707","0000","6637","2121","4516","275","6912","11996","0","57.62","17.68"
"66","000","00","017","1707","0605","1113","338","775","41","1154","2096","0","55.06","16.13"
"66","000","00","017","1707","0606","894","293","601","47","941","1549","0","60.75","18.92"
"66","000","00","017","1707","0607","902","263","639","32","934","1573","0","59.38","16.72"
"66","000","00","017","1707","0608","849","239","610","31","880","1585","0","55.52","15.08"
"66","000","00","017","1707","0609","862","280","582","32","894","1572","0","56.87","17.81"
"66","000","00","017","1707","0610","1020","320","700","35","1055","1738","0","60.7","18.41"
"66","000","00","017","1707","0611","997","388","609","57","1054","1883","0","55.97","20.61"
"66","000","00","017","1708","0000","1632","463","1169","76","1708","2753","0","62.04","16.82"
"66","000","00","017","1708","0612","830","239","591","32","862","1401","0","61.53","17.06"
"66","000","00","017","1708","0613","802","224","578","44","846","1352","0","62.57","16.57"
"66","000","00","017","1709","0000","3219","969","2250","177","3396","5805","0","58.5","16.69"
"66","000","00","017","1709","0614","1162","329","833","79","1241","2085","0","59.52","15.78"
"66","000","00","017","1709","0615","1176","340","836","66","1242","2047","0","60.67","16.61"
"66","000","00","017","1709","0616","881","300","581","32","913","1673","0","54.57","17.93"
"66","000","00","017","1710","0000","2483","832","1651","172","2655","4599","0","57.73","18.09"
"66","000","00","017","1710","0617","1033","349","684","80","1113","1874","0","59.39","18.62"
"66","000","00","017","1710","0618","586","200","386","54","640","1051","0","60.89","19.03"
"66","000","00","017","1710","0619","864","283","581","38","902","1674","0","53.88","16.91"
"66","000","00","017","1711","0000","2049","633","1416","126","2175","3834","0","56.73","16.51"
"66","000","00","017","1711","0620","1019","308","711","58","1077","1831","0","58.82","16.82"
"66","000","00","017","1711","0621","1030","325","705","68","1098","2003","0","54.82","16.23"
"66","000","00","017","1712","0000","837","252","585","43","880","1535","0","57.33","16.42"
"66","000","00","017","1712","0622","837","252","585","43","880","1535","0","57.33","16.42"
"66","000","00","017","1713","0000","2033","552","1481","137","2170","4147","0","52.33","13.31"
"66","000","00","017","1713","0623","1092","301","791","76","1168","2286","0","51.09","13.17"
"66","000","00","017","1713","0624","941","251","690","61","1002","1861","0","53.84","13.49"
"66","000","00","017","1714","0000","2333","720","1613","142","2475","4347","0","56.94","16.56"
"66","000","00","017","1714","0589","781","246","535","43","824","1525","0","54.03","16.13"
"66","000","00","017","1714","0590","886","274","612","42","928","1622","0","57.21","16.89"
"66","000","00","017","1714","0591","666","200","466","57","723","1200","0","60.25","16.67"
"66","000","00","017","1715","0000","3578","1098","2480","148","3726","6729","0","55.37","16.32"
"66","000","00","017","1715","0592","718","216","502","20","738","1355","0","54.46","15.94"
"66","000","00","017","1715","0593","949","300","649","31","980","1777","0","55.15","16.88"
"66","000","00","017","1715","0594","1039","324","715","39","1078","1923","0","56.06","16.85"
"66","000","00","017","1715","0595","872","258","614","58","930","1674","0","55.56","15.41"
"66","000","00","017","1716","0000","2586","808","1778","127","2713","4448","0","60.99","18.17"
"66","000","00","017","1716","0596","879","290","589","36","915","1451","0","63.06","19.99"
"66","000","00","017","1716","0597","830","261","569","49","879","1486","0","59.15","17.56"
"66","000","00","017","1716","0598","877","257","620","42","919","1511","0","60.82","17.01"
"66","000","00","018","0000","0000","42056","13441","28615","2356","44412","77189","95703","57.54","17.41"
"66","000","00","018","1801","0000","2546","808","1738","139","2685","4378","0","61.33","18.46"
"66","000","00","018","1801","0527","904","295","609","45","949","1537","0","61.74","19.19"
"66","000","00","018","1801","0528","857","262","595","40","897","1439","0","62.33","18.21"
"66","000","00","018","1801","0529","785","251","534","54","839","1402","0","59.84","17.9"
"66","000","00","018","1802","0000","5179","1587","3592","319","5498","9096","0","60.44","17.45"
"66","000","00","018","1802","0553","960","294","666","39","999","1568","0","63.71","18.75"
"66","000","00","018","1802","0554","942","320","622","86","1028","1761","0","58.38","18.17"
"66","000","00","018","1802","0555","993","288","705","80","1073","1752","0","61.24","16.44"
"66","000","00","018","1802","0556","725","219","506","31","756","1264","0","59.81","17.33"
"66","000","00","018","1802","0557","770","211","559","37","807","1302","0","61.98","16.21"
"66","000","00","018","1802","0558","789","255","534","46","835","1449","0","57.63","17.6"
"66","000","00","018","1803","0000","3383","961","2422","201","3584","6169","0","58.1","15.58"
"66","000","00","018","1803","0559","926","253","673","81","1007","1621","0","62.12","15.61"
"66","000","00","018","1803","0560","859","262","597","67","926","1647","0","56.22","15.91"
"66","000","00","018","1803","0561","797","246","551","26","823","1441","0","57.11","17.07"
"66","000","00","018","1803","0562","801","200","601","27","828","1460","0","56.71","13.7"
"66","000","00","018","1804","0000","1872","569","1303","129","2001","3203","0","62.47","17.76"
"66","000","00","018","1804","0563","1057","316","741","74","1131","1832","0","61.74","17.25"
"66","000","00","018","1804","0564","815","253","562","55","870","1371","0","63.46","18.45"
"66","000","00","018","1805","0000","1790","448","1342","150","1940","3617","0","53.64","12.39"
"66","000","00","018","1805","0568","934","217","717","61","995","1733","0","57.41","12.52"
"66","000","00","018","1805","0569","856","231","625","89","945","1884","0","50.16","12.26"
"66","000","00","018","1806","0000","2340","721","1619","100","2440","4226","0","57.74","17.06"
"66","000","00","018","1806","0565","741","220","521","12","753","1418","0","53.1","15.51"
"66","000","00","018","1806","0566","856","255","601","34","890","1473","0","60.42","17.31"
"66","000","00","018","1806","0567","743","246","497","54","797","1335","0","59.7","18.43"
"66","000","00","018","1807","0000","2911","895","2016","153","3064","5183","0","59.12","17.27"
"66","000","00","018","1807","0533","1050","293","757","59","1109","1887","0","58.77","15.53"
"66","000","00","018","1807","0534","864","302","562","46","910","1480","0","61.49","20.41"
"66","000","00","018","1807","0535","997","300","697","48","1045","1816","0","57.54","16.52"
"66","000","00","018","1808","0000","2554","759","1795","160","2714","4728","0","57.4","16.05"
"66","000","00","018","1808","0542","860","231","629","72","932","1635","0","57.0","14.13"
"66","000","00","018","1808","0543","884","271","613","51","935","1565","0","59.74","17.32"
"66","000","00","018","1808","0544","810","257","553","37","847","1528","0","55.43","16.82"
"66","000","00","018","1809","0000","3107","949","2158","154","3261","6020","0","54.17","15.76"
"66","000","00","018","1809","0545","1035","291","744","34","1069","1963","0","54.46","14.82"
"66","000","00","018","1809","0546","1053","331","722","38","1091","2073","0","52.63","15.97"
"66","000","00","018","1809","0547","1019","327","692","82","1101","1984","0","55.49","16.48"
"66","000","00","018","1810","0000","3102","961","2141","180","3282","5882","0","55.8","16.34"
"66","000","00","018","1810","0536","910","306","604","66","976","1898","0","51.42","16.12"
"66","000","00","018","1810","0537","1092","308","784","61","1153","2008","0","57.42","15.34"
"66","000","00","018","1810","0538","1100","347","753","53","1153","1976","0","58.35","17.56"
"66","000","00","018","1811","0000","2581","807","1774","105","2686","4464","0","60.17","18.08"
"66","000","00","018","1811","0539","930","305","625","50","980","1673","0","58.58","18.23"
"66","000","00","018","1811","0540","850","254","596","33","883","1409","0","62.67","18.03"
"66","000","00","018","1811","0541","801","248","553","22","823","1382","0","59.55","17.95"
"66","000","00","018","1812","0000","3105","1167","1938","133","3238","5906","0","54.83","19.76"
"66","000","00","018","1812","0524","1118","333","785","53","1171","2027","0","57.77","16.43"
"66","000","00","018","1812","0525","987","328","659","38","1025","1967","0","52.11","16.68"
"66","000","00","018","1812","0526","1000","506","494","42","1042","1912","0","54.5","26.46"
"66","000","00","018","1813","0000","3184","1429","1755","167","3351","5941","0","56.4","24.05"
"66","000","00","018","1813","0530","1062","353","709","44","1106","2013","0","54.94","17.54"
"66","000","00","018","1813","0531","1056","717","339","64","1120","1917","0","58.42","37.4"
"66","000","00","018","1813","0532","1066","359","707","59","1125","2011","0","55.94","17.85"
"66","000","00","018","1814","0000","2623","816","1807","167","2790","4776","0","58.42","17.09"
"66","000","00","018","1814","0548","902","289","613","51","953","1688","0","56.46","17.12"
"66","000","00","018","1814","0549","766","245","521","35","801","1387","0","57.75","17.66"
"66","000","00","018","1814","0550","955","282","673","81","1036","1701","0","60.91","16.58"
"66","000","00","018","1815","0000","1779","564","1215","99","1878","3600","0","52.17","15.67"
"66","000","00","018","1815","0551","915","278","637","60","975","1721","0","56.65","16.15"
"66","000","00","018","1815","0552","864","286","578","39","903","1879","0","48.06","15.22"
"66","000","00","019","0000","0000","10501","2984","7517","684","11185","20860","24605","53.62","14.3"
"66","000","00","019","1901","0000","1832","533","1299","89","1921","3259","0","58.94","16.35"
"66","000","00","019","1901","1562","556","159","397","28","584","1011","0","57.76","15.73"
"66","000","00","019","1901","1563","663","183","480","39","702","1195","0","58.74","15.31"
"66","000","00","019","1901","1564","613","191","422","22","635","1053","0","60.3","18.14"
"66","000","00","019","1902","0000","870","221","649","42","912","1880","0","48.51","11.76"
"66","000","00","019","1902","1565","400","101","299","29","429","961","0","44.64","10.51"
"66","000","00","019","1902","1566","470","120","350","13","483","919","0","52.56","13.06"
"66","000","00","019","1903","0000","781","209","572","57","838","1367","0","61.3","15.29"
"66","000","00","019","1903","1567","781","209","572","57","838","1367","0","61.3","15.29"
"66","000","00","019","1904","0000","517","172","345","30","547","1010","0","54.16","17.03"
"66","000","00","019","1904","1568","517","172","345","30","547","1010","0","54.16","17.03"
"66","000","00","019","1905","0000","535","171","364","61","596","1169","0","50.98","14.63"
"66","000","00","019","1905","1569","535","171","364","61","596","1169","0","50.98","14.63"
"66","000","00","019","1906","0000","999","317","682","67","1066","1883","0","56.61","16.83"
"66","000","00","019","1906","1570","518","179","339","47","565","989","0","57.13","18.1"
"66","000","00","019","1906","1571","481","138","343","20","501","894","0","56.04","15.44"
"66","000","00","019","1907","0000","1382","392","990","57","1439","2936","0","49.01","13.35"
"66","000","00","019","1907","1572","521","134","387","18","539","1033","0","52.18","12.97"
"66","000","00","019","1907","1573","451","137","314","24","475","1058","0","44.9","12.95"
"66","000","00","019","1907","1574","410","121","289","15","425","845","0","50.3","14.32"
"66","000","00","019","1908","0000","357","91","266","28","385","576","0","66.84","15.8"
"66","000","00","019","1908","1575","357","91","266","28","385","576","0","66.84","15.8"
"66","000","00","019","1909","0000","1376","411","965","97","1473","2900","0","50.79","14.17"
"66","000","00","019","1909","1576","579","159","420","50","629","1229","0","51.18","12.94"
"66","000","00","019","1909","1577","412","139","273","21","433","890","0","48.65","15.62"
"66","000","00","019","1909","1578","385","113","272","26","411","781","0","52.62","14.47"
"66","000","00","019","1910","0000","643","181","462","38","681","1244","0","54.74","14.55"
"66","000","00","019","1910","1579","643","181","462","38","681","1244","0","54.74","14.55"
"66","000","00","019","1911","0000","359","103","256","37","396","889","0","44.54","11.59"
"66","000","00","019","1911","1580","71","22","49","8","79","213","0","37.09","10.33"
"66","000","00","019","1911","1581","288","81","207","29","317","676","0","46.89","11.98"
"66","000","00","019","1912","0000","261","56","205","23","284","585","0","48.55","9.57"
"66","000","00","019","1912","1582","261","56","205","23","284","585","0","48.55","9.57"
"66","000","00","019","1913","0000","589","127","462","58","647","1162","0","55.68","10.93"
"66","000","00","019","1913","1583","486","106","380","50","536","938","0","57.14","11.3"
"66","000","00","019","1913","1584","103","21","82","8","111","224","0","49.55","9.38"
"66","000","00","020","0000","0000","7073","2109","4964","552","7625","12880","14968","59.2","16.37"
"66","000","00","020","2001","0000","692","212","480","39","731","1244","0","58.76","17.04"
"66","000","00","020","2001","1552","692","212","480","39","731","1244","0","58.76","17.04"
"66","000","00","020","2002","0000","805","224","581","65","870","1539","0","56.53","14.55"
"66","000","00","020","2002","1553","805","224","581","65","870","1539","0","56.53","14.55"
"66","000","00","020","2003","0000","678","200","478","38","716","1202","0","59.57","16.64"
"66","000","00","020","2003","1554","678","200","478","38","716","1202","0","59.57","16.64"
"66","000","00","020","2004","0000","628","197","431","69","697","1272","0","54.8","15.49"
"66","000","00","020","2004","1555","628","197","431","69","697","1272","0","54.8","15.49"
"66","000","00","020","2005","0000","354","89","265","36","390","652","0","59.82","13.65"
"66","000","00","020","2005","1556","354","89","265","36","390","652","0","59.82","13.65"
"66","000","00","020","2006","0000","887","281","606","71","958","1457","0","65.75","19.29"
"66","000","00","020","2006","1557","887","281","606","71","958","1457","0","65.75","19.29"
"66","000","00","020","2007","0000","966","316","650","66","1032","1836","0","56.21","17.21"
"66","000","00","020","2007","1558","966","316","650","66","1032","1836","0","56.21","17.21"
"66","000","00","020","2008","0000","532","147","385","50","582","1001","0","58.14","14.69"
"66","000","00","020","2008","1559","532","147","385","50","582","1001","0","58.14","14.69"
"66","000","00","020","2009","0000","821","227","594","62","883","1448","0","60.98","15.68"
"66","000","00","020","2009","1560","821","227","594","62","883","1448","0","60.98","15.68"
"66","000","00","020","2010","0000","710","216","494","56","766","1229","0","62.33","17.58"
"66","000","00","020","2010","1561","710","216","494","56","766","1229","0","62.33","17.58"
"66","000","00","021","0000","0000","14859","4102","10757","1018","15877","27059","32202","58.68","15.16"
"66","000","00","021","2101","0000","564","154","410","39","603","1059","0","56.94","14.54"
"66","000","00","021","2101","0071","564","154","410","39","603","1059","0","56.94","14.54"
"66","000","00","021","2102","0000","1256","325","931","69","1325","2163","0","61.26","15.03"
"66","000","00","021","2102","0072","583","150","433","22","605","1013","0","59.72","14.81"
"66","000","00","021","2102","0073","673","175","498","47","720","1150","0","62.61","15.22"
"66","000","00","021","2103","0000","983","290","693","87","1070","1902","0","56.26","15.25"
"66","000","00","021","2103","0081","983","290","693","87","1070","1902","0","56.26","15.25"
"66","000","00","021","2104","0000","2731","698","2033","138","2869","4635","0","61.9","15.06"
"66","000","00","021","2104","0074","1127","297","830","53","1180","1855","0","63.61","16.01"
"66","000","00","021","2104","0075","763","187","576","37","800","1327","0","60.29","14.09"
"66","000","00","021","2104","0076","841","214","627","48","889","1453","0","61.18","14.73"
"66","000","00","021","2105","0000","2030","602","1428","161","2191","3446","0","63.58","17.47"
"66","000","00","021","2105","0082","685","204","481","46","731","1138","0","64.24","17.93"
"66","000","00","021","2105","0083","610","168","442","70","680","1065","0","63.85","15.77"
"66","000","00","021","2105","0084","735","230","505","45","780","1243","0","62.75","18.5"
"66","000","00","021","2106","0000","3335","904","2431","210","3545","6297","0","56.3","14.36"
"66","000","00","021","2106","0077","857","229","628","72","929","1653","0","56.2","13.85"
"66","000","00","021","2106","0078","836","210","626","39","875","1615","0","54.18","13.0"
"66","000","00","021","2106","0079","761","208","553","48","809","1470","0","55.03","14.15"
"66","000","00","021","2106","0080","881","257","624","51","932","1559","0","59.78","16.48"
"66","000","00","021","2107","0000","751","172","579","42","793","1391","0","57.01","12.37"
"66","000","00","021","2107","0088","751","172","579","42","793","1391","0","57.01","12.37"
"66","000","00","021","2108","0000","742","208","534","50","792","1216","0","65.13","17.11"
"66","000","00","021","2108","0087","742","208","534","50","792","1216","0","65.13","17.11"
"66","000","00","021","2109","0000","1084","348","736","100","1184","2131","0","55.56","16.33"
"66","000","00","021","2109","0085","474","153","321","54","528","962","0","54.89","15.9"
"66","000","00","021","2109","0086","610","195","415","46","656","1169","0","56.12","16.68"
"66","000","00","021","2110","0000","831","229","602","83","914","1616","0","56.56","14.17"
"66","000","00","021","2110","0089","831","229","602","83","914","1616","0","56.56","14.17"
"66","000","00","021","2111","0000","552","172","380","39","591","1203","0","49.13","14.3"
"66","000","00","021","2111","0090","552","172","380","39","591","1203","0","49.13","14.3"
"66","000","00","022","0000","0000","8923","2665","6258","829","9752","16520","19250","59.03","16.13"
"66","000","00","022","2201","0000","515","149","366","55","570","1068","0","53.37","13.95"
"66","000","00","022","2201","0055","515","149","366","55","570","1068","0","53.37","13.95"
"66","000","00","022","2202","0000","558","172","386","56","614","1050","0","58.48","16.38"
"66","000","00","022","2202","0056","558","172","386","56","614","1050","0","58.48","16.38"
"66","000","00","022","2203","0000","1414","435","979","129","1543","2643","0","58.38","16.46"
"66","000","00","022","2203","0057","692","239","453","68","760","1246","0","61.0","19.18"
"66","000","00","022","2203","0058","722","196","526","61","783","1397","0","56.05","14.03"
"66","000","00","022","2204","0000","828","247","581","112","940","1581","0","59.46","15.62"
"66","000","00","022","2204","0061","515","160","355","80","595","914","0","65.1","17.51"
"66","000","00","022","2204","0062","313","87","226","32","345","667","0","51.72","13.04"
"66","000","00","022","2205","0000","638","166","472","56","694","1170","0","59.32","14.19"
"66","000","00","022","2205","0060","638","166","472","56","694","1170","0","59.32","14.19"
"66","000","00","022","2206","0000","711","213","498","57","768","1227","0","62.59","17.36"
"66","000","00","022","2206","0059","711","213","498","57","768","1227","0","62.59","17.36"
"66","000","00","022","2207","0000","442","143","299","44","486","890","0","54.61","16.07"
"66","000","00","022","2207","0063","442","143","299","44","486","890","0","54.61","16.07"
"66","000","00","022","2208","0000","898","269","629","81","979","1744","0","56.14","15.42"
"66","000","00","022","2208","0064","676","210","466","60","736","1289","0","57.1","16.29"
"66","000","00","022","2208","0065","222","59","163","21","243","455","0","53.41","12.97"
"66","000","00","022","2209","0000","560","170","390","38","598","1028","0","58.17","16.54"
"66","000","00","022","2209","0066","560","170","390","38","598","1028","0","58.17","16.54"
"66","000","00","022","2210","0000","786","227","559","80","866","1446","0","59.89","15.7"
"66","000","00","022","2210","0067","786","227","559","80","866","1446","0","59.89","15.7"
"66","000","00","022","2211","0000","1012","285","727","82","1094","1750","0","62.51","16.29"
"66","000","00","022","2211","0068","418","122","296","28","446","688","0","64.83","17.73"
"66","000","00","022","2211","0069","594","163","431","54","648","1062","0","61.02","15.35"
"66","000","00","022","2212","0000","561","189","372","39","600","923","0","65.01","20.48"
"66","000","00","022","2212","0070","561","189","372","39","600","923","0","65.01","20.48"
"66","000","00","023","0000","0000","33794","10735","23059","2375","36169","61705","75275","58.62","17.4"
"66","000","00","023","2301","0000","4794","1568","3226","299","5093","8455","0","60.24","18.55"
"66","000","00","023","2301","0317","881","279","602","52","933","1480","0","63.04","18.85"
"66","000","00","023","2301","0318","1055","371","684","79","1134","1841","0","61.6","20.15"
"66","000","00","023","2301","0319","942","316","626","59","1001","1751","0","57.17","18.05"
"66","000","00","023","2301","0320","889","289","600","67","956","1547","0","61.8","18.68"
"66","000","00","023","2301","0321","1027","313","714","42","1069","1836","0","58.22","17.05"
"66","000","00","023","2302","0000","1407","506","901","164","1571","2534","0","62.0","19.97"
"66","000","00","023","2302","0322","735","282","453","96","831","1239","0","67.07","22.76"
"66","000","00","023","2302","0323","672","224","448","68","740","1295","0","57.14","17.3"
"66","000","00","023","2303","0000","2486","815","1671","178","2664","4707","0","56.6","17.31"
"66","000","00","023","2303","0324","667","231","436","53","720","1263","0","57.01","18.29"
"66","000","00","023","2303","0325","863","316","547","43","906","1622","0","55.86","19.48"
"66","000","00","023","2303","0326","956","268","688","82","1038","1822","0","56.97","14.71"
"66","000","00","023","2304","0000","2631","852","1779","154","2785","4813","0","57.86","17.7"
"66","000","00","023","2304","0327","1028","332","696","59","1087","1966","0","55.29","16.89"
"66","000","00","023","2304","0328","899","285","614","52","951","1615","0","58.89","17.65"
"66","000","00","023","2304","0329","704","235","469","43","747","1232","0","60.63","19.07"
"66","000","00","023","2305","0000","1293","421","872","82","1375","2512","0","54.74","16.76"
"66","000","00","023","2305","0330","709","220","489","40","749","1347","0","55.61","16.33"
"66","000","00","023","2305","0331","584","201","383","42","626","1165","0","53.73","17.25"
"66","000","00","023","2306","0000","7122","2232","4890","412","7534","12812","0","58.8","17.42"
"66","000","00","023","2306","0332","956","303","653","47","1003","1664","0","60.28","18.21"
"66","000","00","023","2306","0333","728","224","504","43","771","1230","0","62.68","18.21"
"66","000","00","023","2306","0334","894","267","627","92","986","1574","0","62.64","16.96"
"66","000","00","023","2306","0335","881","285","596","43","924","1452","0","63.64","19.63"
"66","000","00","023","2306","0336","971","286","685","58","1029","1879","0","54.76","15.22"
"66","000","00","023","2306","0337","879","296","583","41","920","1601","0","57.46","18.49"
"66","000","00","023","2306","0338","910","278","632","45","955","1546","0","61.77","17.98"
"66","000","00","023","2306","0339","903","293","610","43","946","1866","0","50.7","15.7"
"66","000","00","023","2307","0000","4044","1316","2728","262","4306","7449","0","57.81","17.67"
"66","000","00","023","2307","0340","1090","338","752","63","1153","1938","0","59.49","17.44"
"66","000","00","023","2307","0341","968","337","631","69","1037","1759","0","58.95","19.16"
"66","000","00","023","2307","0342","1035","348","687","76","1111","2061","0","53.91","16.89"
"66","000","00","023","2307","0343","951","293","658","54","1005","1691","0","59.43","17.33"
"66","000","00","023","2308","0000","1351","407","944","77","1428","2260","0","63.19","18.01"
"66","000","00","023","2308","0344","646","201","445","36","682","1039","0","65.64","19.35"
"66","000","00","023","2308","0345","705","206","499","41","746","1221","0","61.1","16.87"
"66","000","00","023","2309","0000","932","297","635","72","1004","1650","0","60.85","18.0"
"66","000","00","023","2309","0346","932","297","635","72","1004","1650","0","60.85","18.0"
"66","000","00","023","2310","0000","1231","420","811","83","1314","2157","0","60.92","19.47"
"66","000","00","023","2310","0347","537","184","353","44","581","937","0","62.01","19.64"
"66","000","00","023","2310","0348","694","236","458","39","733","1220","0","60.08","19.34"
"66","000","00","023","2311","0000","1023","303","720","121","1144","2139","0","53.48","14.17"
"66","000","00","023","2311","0349","1023","303","720","121","1144","2139","0","53.48","14.17"
"66","000","00","023","2312","0000","2401","699","1702","187","2588","4356","0","59.41","16.05"
"66","000","00","023","2312","0350","826","239","587","58","884","1371","0","64.48","17.43"
"66","000","00","023","2312","0351","695","201","494","60","755","1277","0","59.12","15.74"
"66","000","00","023","2312","0352","880","259","621","69","949","1708","0","55.56","15.16"
"66","000","00","023","2313","0000","1060","293","767","89","1149","2048","0","56.1","14.31"
"66","000","00","023","2313","0353","1060","293","767","89","1149","2048","0","56.1","14.31"
"66","000","00","023","2314","0000","856","269","587","54","910","1632","0","55.76","16.48"
"66","000","00","023","2314","0354","856","269","587","54","910","1632","0","55.76","16.48"
"66","000","00","023","2315","0000","729","218","511","76","805","1327","0","60.66","16.43"
"66","000","00","023","2315","0355","729","218","511","76","805","1327","0","60.66","16.43"
"66","000","00","023","2316","0000","434","119","315","65","499","854","0","58.43","13.93"
"66","000","00","023","2316","0356","434","119","315","65","499","854","0","58.43","13.93"
"66","000","00","024","0000","0000","26002","7860","18142","1772","27774","47457","57267","58.52","16.56"
"66","000","00","024","2401","0000","2340","683","1657","130","2470","4327","0","57.08","15.78"
"66","000","00","024","2401","0284","769","212","557","33","802","1415","0","56.68","14.98"
"66","000","00","024","2401","0285","695","215","480","51","746","1392","0","53.59","15.45"
"66","000","00","024","2401","0286","876","256","620","46","922","1520","0","60.66","16.84"
"66","000","00","024","2402","0000","527","165","362","56","583","862","0","67.63","19.14"
"66","000","00","024","2402","0287","527","165","362","56","583","862","0","67.63","19.14"
"66","000","00","024","2403","0000","2016","576","1440","131","2147","3558","0","60.34","16.19"
"66","000","00","024","2403","0288","734","200","534","48","782","1256","0","62.26","15.92"
"66","000","00","024","2403","0289","703","207","496","46","749","1292","0","57.97","16.02"
"66","000","00","024","2403","0290","579","169","410","37","616","1010","0","60.99","16.73"
"66","000","00","024","2404","0000","835","271","564","83","918","1485","0","61.82","18.25"
"66","000","00","024","2404","0291","835","271","564","83","918","1485","0","61.82","18.25"
"66","000","00","024","2405","0000","1380","419","961","132","1512","2440","0","61.97","17.17"
"66","000","00","024","2405","0292","710","210","500","58","768","1190","0","64.54","17.65"
"66","000","00","024","2405","0293","670","209","461","74","744","1250","0","59.52","16.72"
"66","000","00","024","2406","0000","1435","506","929","84","1519","2604","0","58.33","19.43"
"66","000","00","024","2406","0294","739","280","459","42","781","1310","0","59.62","21.37"
"66","000","00","024","2406","0295","696","226","470","42","738","1294","0","57.03","17.47"
"66","000","00","024","2407","0000","1753","503","1250","111","1864","3050","0","61.11","16.49"
"66","000","00","024","2407","0296","1031","292","739","60","1091","1734","0","62.92","16.84"
"66","000","00","024","2407","0297","722","211","511","51","773","1316","0","58.74","16.03"
"66","000","00","024","2408","0000","1257","406","851","75","1332","2127","0","62.62","19.09"
"66","000","00","024","2408","0298","471","159","312","40","511","854","0","59.84","18.62"
"66","000","00","024","2408","0299","786","247","539","35","821","1273","0","64.49","19.4"
"66","000","00","024","2409","0000","519","150","369","23","542","851","0","63.69","17.63"
"66","000","00","024","2409","0300","519","150","369","23","542","851","0","63.69","17.63"
"66","000","00","024","2410","0000","878","251","627","43","921","1629","0","56.54","15.41"
"66","000","00","024","2410","0301","878","251","627","43","921","1629","0","56.54","15.41"
"66","000","00","024","2411","0000","888","273","615","85","973","1709","0","56.93","15.97"
"66","000","00","024","2411","0302","888","273","615","85","973","1709","0","56.93","15.97"
"66","000","00","024","2412","0000","498","142","356","32","530","953","0","55.61","14.9"
"66","000","00","024","2412","0303","498","142","356","32","530","953","0","55.61","14.9"
"66","000","00","024","2413","0000","758","202","556","54","812","1336","0","60.78","15.12"
"66","000","00","024","2413","0304","758","202","556","54","812","1336","0","60.78","15.12"
"66","000","00","024","2414","0000","3859","1204","2655","272","4131","7282","0","56.73","16.53"
"66","000","00","024","2414","0305","1060","349","711","86","1146","2113","0","54.24","16.52"
"66","000","00","024","2414","0306","923","290","633","98","1021","1730","0","59.02","16.76"
"66","000","00","024","2414","0307","918","313","605","37","955","1692","0","56.44","18.5"
"66","000","00","024","2414","0308","958","252","706","51","1009","1747","0","57.76","14.42"
"66","000","00","024","2415","0000","2658","773","1885","167","2825","5020","0","56.27","15.4"
"66","000","00","024","2415","0309","894","290","604","65","959","1672","0","57.36","17.34"
"66","000","00","024","2415","0310","863","256","607","40","903","1675","0","53.91","15.28"
"66","000","00","024","2415","0311","901","227","674","62","963","1673","0","57.56","13.57"
"66","000","00","024","2416","0000","2489","771","1718","147","2636","4732","0","55.71","16.29"
"66","000","00","024","2416","0312","916","298","618","52","968","1636","0","59.17","18.22"
"66","000","00","024","2416","0313","888","270","618","66","954","1753","0","54.42","15.4"
"66","000","00","024","2416","0314","685","203","482","29","714","1343","0","53.16","15.12"
"66","000","00","024","2417","0000","1912","565","1347","147","2059","3492","0","58.96","16.18"
"66","000","00","024","2417","0315","968","314","654","56","1024","1822","0","56.2","17.23"
"66","000","00","024","2417","0316","944","251","693","91","1035","1670","0","61.98","15.03"
"66","000","00","025","0000","0000","33973","10744","23229","2116","36089","63584","77922","56.76","16.9"
"66","000","00","025","2501","0000","1693","528","1165","110","1803","3033","0","59.45","17.41"
"66","000","00","025","2501","0239","1001","324","677","63","1064","1758","0","60.52","18.43"
"66","000","00","025","2501","0240","692","204","488","47","739","1275","0","57.96","16.0"
"66","000","00","025","2502","0000","1347","404","943","86","1433","2782","0","51.51","14.52"
"66","000","00","025","2502","0241","651","196","455","32","683","1379","0","49.53","14.21"
"66","000","00","025","2502","0242","696","208","488","54","750","1403","0","53.46","14.83"
"66","000","00","025","2503","0000","1147","306","841","80","1227","1875","0","65.44","16.32"
"66","000","00","025","2503","0243","526","150","376","44","570","974","0","58.52","15.4"
"66","000","00","025","2503","0244","621","156","465","36","657","901","0","72.92","17.31"
"66","000","00","025","2504","0000","1808","636","1172","150","1958","3388","0","57.79","18.77"
"66","000","00","025","2504","0245","919","315","604","79","998","1779","0","56.1","17.71"
"66","000","00","025","2504","0246","889","321","568","71","960","1609","0","59.66","19.95"
"66","000","00","025","2505","0000","517","150","367","29","546","1038","0","52.6","14.45"
"66","000","00","025","2505","0247","517","150","367","29","546","1038","0","52.6","14.45"
"66","000","00","025","2506","0000","1300","385","915","94","1394","2249","0","61.98","17.12"
"66","000","00","025","2506","0248","761","234","527","57","818","1328","0","61.6","17.62"
"66","000","00","025","2506","0249","539","151","388","37","576","921","0","62.54","16.4"
"66","000","00","025","2507","0000","2453","733","1720","161","2614","5028","0","51.99","14.58"
"66","000","00","025","2507","0250","779","234","545","68","847","1609","0","52.64","14.54"
"66","000","00","025","2507","0251","599","185","414","21","620","1227","0","50.53","15.08"
"66","000","00","025","2507","0252","670","185","485","56","726","1278","0","56.81","14.48"
"66","000","00","025","2507","0253","405","129","276","16","421","914","0","46.06","14.11"
"66","000","00","025","2508","0000","1402","435","967","78","1480","2911","0","50.84","14.94"
"66","000","00","025","2508","0254","791","246","545","41","832","1678","0","49.58","14.66"
"66","000","00","025","2508","0255","611","189","422","37","648","1233","0","52.55","15.33"
"66","000","00","025","2509","0000","2598","802","1796","160","2758","4945","0","55.77","16.22"
"66","000","00","025","2509","0256","802","258","544","59","861","1520","0","56.64","16.97"
"66","000","00","025","2509","0257","944","280","664","43","987","1905","0","51.81","14.7"
"66","000","00","025","2509","0258","852","264","588","58","910","1520","0","59.87","17.37"
"66","000","00","025","2510","0000","2978","918","2060","166","3144","5692","0","55.24","16.13"
"66","000","00","025","2510","0259","690","202","488","62","752","1385","0","54.3","14.58"
"66","000","00","025","2510","0260","647","224","423","35","682","1212","0","56.27","18.48"
"66","000","00","025","2510","0261","794","230","564","27","821","1432","0","57.33","16.06"
"66","000","00","025","2510","0262","847","262","585","42","889","1663","0","53.46","15.75"
"66","000","00","025","2511","0000","3803","1264","2539","212","4015","7249","0","55.39","17.44"
"66","000","00","025","2511","0263","721","230","491","42","763","1422","0","53.66","16.17"
"66","000","00","025","2511","0264","747","249","498","70","817","1616","0","50.56","15.41"
"66","000","00","025","2511","0265","787","241","546","56","843","1422","0","59.28","16.95"
"66","000","00","025","2511","0266","654","221","433","38","692","1165","0","59.4","18.97"
"66","000","00","025","2511","0267","894","323","571","6","900","1624","0","55.42","19.89"
"66","000","00","025","2512","0000","1400","416","984","102","1502","2556","0","58.76","16.28"
"66","000","00","025","2512","0268","853","257","596","57","910","1613","0","56.42","15.93"
"66","000","00","025","2512","0269","547","159","388","45","592","943","0","62.78","16.86"
"66","000","00","025","2513","0000","3213","1000","2213","222","3435","6091","0","56.39","16.42"
"66","000","00","025","2513","0270","792","239","553","72","864","1595","0","54.17","14.98"
"66","000","00","025","2513","0271","823","260","563","66","889","1508","0","58.95","17.24"
"66","000","00","025","2513","0272","775","227","548","32","807","1479","0","54.56","15.35"
"66","000","00","025","2513","0273","823","274","549","52","875","1509","0","57.99","18.16"
"66","000","00","025","2514","0000","898","272","626","68","966","1582","0","61.06","17.19"
"66","000","00","025","2514","0274","898","272","626","68","966","1582","0","61.06","17.19"
"66","000","00","025","2515","0000","2672","868","1804","171","2843","4692","0","60.59","18.5"
"66","000","00","025","2515","0280","629","207","422","34","663","1121","0","59.14","18.47"
"66","000","00","025","2515","0281","576","193","383","46","622","987","0","63.02","19.55"
"66","000","00","025","2515","0282","661","222","439","50","711","1206","0","58.96","18.41"
"66","000","00","025","2515","0283","806","246","560","41","847","1378","0","61.47","17.85"
"66","000","00","025","2516","0000","4744","1627","3117","227","4971","8473","0","58.67","19.2"
"66","000","00","025","2516","0275","935","304","631","54","989","1725","0","57.33","17.62"
"66","000","00","025","2516","0276","894","265","629","39","933","1616","0","57.74","16.4"
"66","000","00","025","2516","0277","939","305","634","40","979","1657","0","59.08","18.41"
"66","000","00","025","2516","0278","993","389","604","39","1032","1774","0","58.17","21.93"
"66","000","00","025","2516","0279","983","364","619","55","1038","1701","0","61.02","21.4"
"66","000","00","026","0000","0000","31290","9513","21777","2297","33587","55225","65632","60.82","17.23"
"66","000","00","026","2601","0000","698","225","473","48","746","1205","0","61.91","18.67"
"66","000","00","026","2601","1470","698","225","473","48","746","1205","0","61.91","18.67"
"66","000","00","026","2602","0000","5111","1611","3500","336","5447","9281","0","58.69","17.36"
"66","000","00","026","2602","1471","868","269","599","49","917","1620","0","56.6","16.6"
"66","000","00","026","2602","1472","909","312","597","56","965","1559","0","61.9","20.01"
"66","000","00","026","2602","1473","892","296","596","65","957","1660","0","57.65","17.83"
"66","000","00","026","2602","1474","927","279","648","57","984","1602","0","61.42","17.42"
"66","000","00","026","2602","1475","686","216","470","47","733","1325","0","55.32","16.3"
"66","000","00","026","2602","1476","829","239","590","62","891","1515","0","58.81","15.78"
"66","000","00","026","2603","0000","2494","751","1743","150","2644","4738","0","55.8","15.85"
"66","000","00","026","2603","1477","812","248","564","54","866","1561","0","55.48","15.89"
"66","000","00","026","2603","1478","877","264","613","39","916","1691","0","54.17","15.61"
"66","000","00","026","2603","1479","805","239","566","57","862","1486","0","58.01","16.08"
"66","000","00","026","2604","0000","1360","376","984","101","1461","2333","0","62.62","16.12"
"66","000","00","026","2604","1480","567","160","407","44","611","975","0","62.67","16.41"
"66","000","00","026","2604","1481","793","216","577","57","850","1358","0","62.59","15.91"
"66","000","00","026","2605","0000","1242","376","866","73","1315","1996","0","65.88","18.84"
"66","000","00","026","2605","1482","718","224","494","31","749","1141","0","65.64","19.63"
"66","000","00","026","2605","1483","524","152","372","42","566","855","0","66.2","17.78"
"66","000","00","026","2606","0000","716","211","505","46","762","1202","0","63.39","17.55"
"66","000","00","026","2606","1484","716","211","505","46","762","1202","0","63.39","17.55"
"66","000","00","026","2607","0000","572","165","407","36","608","1078","0","56.4","15.31"
"66","000","00","026","2607","1485","572","165","407","36","608","1078","0","56.4","15.31"
"66","000","00","026","2608","0000","3417","1069","2348","196","3613","5834","0","61.93","18.32"
"66","000","00","026","2608","1486","871","292","579","61","932","1456","0","64.01","20.05"
"66","000","00","026","2608","1487","915","300","615","41","956","1573","0","60.78","19.07"
"66","000","00","026","2608","1488","901","255","646","42","943","1591","0","59.27","16.03"
"66","000","00","026","2608","1489","730","222","508","52","782","1214","0","64.42","18.29"
"66","000","00","026","2609","0000","1706","484","1222","119","1825","2936","0","62.16","16.49"
"66","000","00","026","2609","1508","805","215","590","56","861","1363","0","63.17","15.77"
"66","000","00","026","2609","1509","901","269","632","63","964","1573","0","61.28","17.1"
"66","000","00","026","2610","0000","2141","680","1461","134","2275","3910","0","58.18","17.39"
"66","000","00","026","2610","1490","685","199","486","46","731","1267","0","57.7","15.71"
"66","000","00","026","2610","1491","714","229","485","47","761","1277","0","59.59","17.93"
"66","000","00","026","2610","1492","742","252","490","41","783","1366","0","57.32","18.45"
"66","000","00","026","2611","0000","1168","378","790","75","1243","1857","0","66.94","20.36"
"66","000","00","026","2611","1493","642","219","423","48","690","994","0","69.42","22.03"
"66","000","00","026","2611","1494","526","159","367","27","553","863","0","64.08","18.42"
"66","000","00","026","2612","0000","1309","415","894","118","1427","2436","0","58.58","17.04"
"66","000","00","026","2612","1495","690","222","468","49","739","1274","0","58.01","17.43"
"66","000","00","026","2612","1496","619","193","426","69","688","1162","0","59.21","16.61"
"66","000","00","026","2613","0000","1537","429","1108","126","1663","2574","0","64.61","16.67"
"66","000","00","026","2613","1497","805","197","608","70","875","1252","0","69.89","15.73"
"66","000","00","026","2613","1498","732","232","500","56","788","1322","0","59.61","17.55"
"66","000","00","026","2614","0000","1403","440","963","124","1527","2642","0","57.8","16.65"
"66","000","00","026","2614","1504","651","225","426","68","719","1314","0","54.72","17.12"
"66","000","00","026","2614","1505","752","215","537","56","808","1328","0","60.84","16.19"
"66","000","00","026","2615","0000","1145","396","749","122","1267","2077","0","61.0","19.07"
"66","000","00","026","2615","1506","527","196","331","59","586","989","0","59.25","19.82"
"66","000","00","026","2615","1507","618","200","418","63","681","1088","0","62.59","18.38"
"66","000","00","026","2616","0000","592","162","430","86","678","1117","0","60.7","14.5"
"66","000","00","026","2616","1510","592","162","430","86","678","1117","0","60.7","14.5"
"66","000","00","026","2617","0000","1406","414","992","142","1548","2366","0","65.43","17.5"
"66","000","00","026","2617","1511","790","227","563","74","864","1342","0","64.38","16.92"
"66","000","00","026","2617","1512","616","187","429","68","684","1024","0","66.8","18.26"
"66","000","00","026","2618","0000","1319","428","891","131","1450","2272","0","63.82","18.84"
"66","000","00","026","2618","1499","667","207","460","44","711","1116","0","63.71","18.55"
"66","000","00","026","2618","1500","652","221","431","87","739","1156","0","63.93","19.12"
"66","000","00","026","2619","0000","1269","310","959","90","1359","2075","0","65.49","14.94"
"66","000","00","026","2619","1501","681","169","512","48","729","1147","0","63.56","14.73"
"66","000","00","026","2619","1502","588","141","447","42","630","928","0","67.89","15.19"
"66","000","00","026","2620","0000","685","193","492","44","729","1296","0","56.25","14.89"
"66","000","00","026","2620","1503","685","193","492","44","729","1296","0","56.25","14.89"
"66","000","00","027","0000","0000","81772","25949","55823","4731","86503","157926","191097","54.77","16.43"
"66","000","00","027","2701","0000","2793","852","1941","210","3003","5448","0","55.12","15.64"
"66","000","00","027","2701","1271","930","301","629","72","1002","1821","0","55.02","16.53"
"66","000","00","027","2701","1272","828","233","595","42","870","1680","0","51.79","13.87"
"66","000","00","027","2701","1273","1035","318","717","96","1131","1947","0","58.09","16.33"
"66","000","00","027","2702","0000","3069","983","2086","170","3239","5757","0","56.26","17.07"
"66","000","00","027","2702","1274","1062","322","740","75","1137","1910","0","59.53","16.86"
"66","000","00","027","2702","1275","975","321","654","42","1017","1894","0","53.7","16.95"
"66","000","00","027","2702","1276","1032","340","692","53","1085","1953","0","55.56","17.41"
"66","000","00","027","2703","0000","2105","668","1437","97","2202","4067","0","54.14","16.42"
"66","000","00","027","2703","1281","1049","320","729","67","1116","2011","0","55.49","15.91"
"66","000","00","027","2703","1282","1056","348","708","30","1086","2056","0","52.82","16.93"
"66","000","00","027","2704","0000","1841","585","1256","144","1985","3317","0","59.84","17.64"
"66","000","00","027","2704","1287","1055","348","707","70","1125","1886","0","59.65","18.45"
"66","000","00","027","2704","1288","786","237","549","74","860","1431","0","60.1","16.56"
"66","000","00","027","2705","0000","1514","450","1064","93","1607","2924","0","54.96","15.39"
"66","000","00","027","2705","1297","693","218","475","57","750","1378","0","54.43","15.82"
"66","000","00","027","2705","1298","821","232","589","36","857","1546","0","55.43","15.01"
"66","000","00","027","2706","0000","2092","616","1476","115","2207","4083","0","54.05","15.09"
"66","000","00","027","2706","1291","1058","305","753","62","1120","2048","0","54.69","14.89"
"66","000","00","027","2706","1292","1034","311","723","53","1087","2035","0","53.42","15.28"
"66","000","00","027","2707","0000","3079","940","2139","167","3246","6114","0","53.09","15.37"
"66","000","00","027","2707","1316","902","287","615","39","941","1623","0","57.98","17.68"
"66","000","00","027","2707","1317","733","208","525","42","775","1548","0","50.06","13.44"
"66","000","00","027","2707","1318","749","232","517","48","797","1442","0","55.27","16.09"
"66","000","00","027","2707","1319","695","213","482","38","733","1501","0","48.83","14.19"
"66","000","00","027","2708","0000","1669","510","1159","89","1758","3605","0","48.77","14.15"
"66","000","00","027","2708","1312","934","294","640","56","990","1654","0","59.85","17.78"
"66","000","00","027","2708","1313","735","216","519","33","768","1951","0","39.36","11.07"
"66","000","00","027","2709","0000","1853","554","1299","118","1971","3281","0","60.07","16.89"
"66","000","00","027","2709","1301","886","262","624","78","964","1582","0","60.94","16.56"
"66","000","00","027","2709","1302","967","292","675","40","1007","1699","0","59.27","17.19"
"66","000","00","027","2710","0000","2558","828","1730","154","2712","5163","0","52.53","16.04"
"66","000","00","027","2710","1307","904","309","595","35","939","1776","0","52.87","17.4"
"66","000","00","027","2710","1308","880","279","601","57","937","1729","0","54.19","16.14"
"66","000","00","027","2710","1309","774","240","534","62","836","1658","0","50.42","14.48"
"66","000","00","027","2711","0000","3855","1229","2626","179","4034","7262","0","55.55","16.92"
"66","000","00","027","2711","1325","1131","346","785","69","1200","2075","0","57.83","16.67"
"66","000","00","027","2711","1326","870","290","580","37","907","1723","0","52.64","16.83"
"66","000","00","027","2711","1327","1094","348","746","51","1145","2049","0","55.88","16.98"
"66","000","00","027","2711","1328","760","245","515","22","782","1415","0","55.27","17.31"
"66","000","00","027","2712","0000","3914","1231","2683","197","4111","7197","0","57.12","17.1"
"66","000","00","027","2712","1335","924","275","649","47","971","1667","0","58.25","16.5"
"66","000","00","027","2712","1336","976","305","671","54","1030","1793","0","57.45","17.01"
"66","000","00","027","2712","1337","1050","366","684","33","1083","1903","0","56.91","19.23"
"66","000","00","027","2712","1338","964","285","679","63","1027","1834","0","56.0","15.54"
"66","000","00","027","2713","0000","2976","992","1984","142","3118","5993","0","52.03","16.55"
"66","000","00","027","2713","1346","945","296","649","52","997","1974","0","50.51","14.99"
"66","000","00","027","2713","1347","993","324","669","43","1036","1828","0","56.67","17.72"
"66","000","00","027","2713","1348","1038","372","666","47","1085","2191","0","49.52","16.98"
"66","000","00","027","2714","0000","896","234","662","80","976","1825","0","53.48","12.82"
"66","000","00","027","2714","1349","896","234","662","80","976","1825","0","53.48","12.82"
"66","000","00","027","2715","0000","640","196","444","53","693","1225","0","56.57","16.0"
"66","000","00","027","2715","1351","640","196","444","53","693","1225","0","56.57","16.0"
"66","000","00","027","2716","0000","1589","448","1141","140","1729","3179","0","54.39","14.09"
"66","000","00","027","2716","1352","870","219","651","57","927","1678","0","55.24","13.05"
"66","000","00","027","2716","1353","719","229","490","83","802","1501","0","53.43","15.26"
"66","000","00","027","2717","0000","1491","627","864","117","1608","3094","0","51.97","20.27"
"66","000","00","027","2717","1357","697","240","457","40","737","1428","0","51.61","16.81"
"66","000","00","027","2717","1358","794","387","407","77","871","1666","0","52.28","23.23"
"66","000","00","027","2718","0000","2379","689","1690","162","2541","4710","0","53.95","14.63"
"66","000","00","027","2718","1361","624","177","447","46","670","1166","0","57.46","15.18"
"66","000","00","027","2718","1362","987","300","687","69","1056","1790","0","58.99","16.76"
"66","000","00","027","2718","1363","768","212","556","47","815","1754","0","46.47","12.09"
"66","000","00","027","2719","0000","410","97","313","38","448","699","0","64.09","13.88"
"66","000","00","027","2719","1356","410","97","313","38","448","699","0","64.09","13.88"
"66","000","00","027","2720","0000","3598","1086","2512","218","3816","6563","0","58.14","16.55"
"66","000","00","027","2720","1277","990","316","674","73","1063","1846","0","57.58","17.12"
"66","000","00","027","2720","1278","843","255","588","50","893","1493","0","59.81","17.08"
"66","000","00","027","2720","1279","845","229","616","47","892","1605","0","55.58","14.27"
"66","000","00","027","2720","1280","920","286","634","48","968","1619","0","59.79","17.67"
"66","000","00","027","2721","0000","2067","665","1402","117","2184","4094","0","53.35","16.24"
"66","000","00","027","2721","1289","997","334","663","63","1060","1930","0","54.92","17.31"
"66","000","00","027","2721","1290","1070","331","739","54","1124","2164","0","51.94","15.3"
"66","000","00","027","2722","0000","1860","609","1251","155","2015","3870","0","52.07","15.74"
"66","000","00","027","2722","1293","864","291","573","70","934","1685","0","55.43","17.27"
"66","000","00","027","2722","1294","996","318","678","85","1081","2185","0","49.47","14.55"
"66","000","00","027","2723","0000","1445","446","999","50","1495","2773","0","53.91","16.08"
"66","000","00","027","2723","1295","606","186","420","24","630","1176","0","53.57","15.82"
"66","000","00","027","2723","1296","839","260","579","26","865","1597","0","54.16","16.28"
"66","000","00","027","2724","0000","1911","621","1290","115","2026","3691","0","54.89","16.82"
"66","000","00","027","2724","1283","979","327","652","57","1036","1876","0","55.22","17.43"
"66","000","00","027","2724","1284","932","294","638","58","990","1815","0","54.55","16.2"
"66","000","00","027","2725","0000","1273","394","879","95","1368","2285","0","59.87","17.24"
"66","000","00","027","2725","1285","675","208","467","46","721","1281","0","56.28","16.24"
"66","000","00","027","2725","1286","598","186","412","49","647","1004","0","64.44","18.53"
"66","000","00","027","2726","0000","1456","464","992","103","1559","2943","0","52.97","15.77"
"66","000","00","027","2726","1299","902","301","601","60","962","1890","0","50.9","15.93"
"66","000","00","027","2726","1300","554","163","391","43","597","1053","0","56.7","15.48"
"66","000","00","027","2727","0000","2646","924","1722","79","2725","4703","0","57.94","19.65"
"66","000","00","027","2727","1339","801","241","560","33","834","1526","0","54.65","15.79"
"66","000","00","027","2727","1340","910","340","570","20","930","1483","0","62.71","22.93"
"66","000","00","027","2727","1341","935","343","592","26","961","1694","0","56.73","20.25"
"66","000","00","027","2728","0000","3718","1316","2402","126","3844","6795","0","56.57","19.37"
"66","000","00","027","2728","1342","946","313","633","29","975","1952","0","49.95","16.03"
"66","000","00","027","2728","1343","1044","346","698","46","1090","1995","0","54.64","17.34"
"66","000","00","027","2728","1344","747","259","488","14","761","1311","0","58.05","19.76"
"66","000","00","027","2728","1345","981","398","583","37","1018","1537","0","66.23","25.89"
"66","000","00","027","2729","0000","2926","955","1971","112","3038","5574","0","54.5","17.13"
"66","000","00","027","2729","1329","967","305","662","38","1005","1778","0","56.52","17.15"
"66","000","00","027","2729","1330","870","283","587","36","906","1706","0","53.11","16.59"
"66","000","00","027","2729","1331","1089","367","722","38","1127","2090","0","53.92","17.56"
"66","000","00","027","2730","0000","2470","801","1669","145","2615","5269","0","49.63","15.2"
"66","000","00","027","2730","1332","967","329","638","78","1045","2093","0","49.93","15.72"
"66","000","00","027","2730","1333","785","219","566","32","817","1688","0","48.4","12.97"
"66","000","00","027","2730","1334","718","253","465","35","753","1488","0","50.6","17.0"
"66","000","00","027","2731","0000","2925","969","1956","158","3083","6065","0","50.83","15.98"
"66","000","00","027","2731","1320","979","325","654","29","1008","2025","0","49.78","16.05"
"66","000","00","027","2731","1321","961","308","653","58","1019","1885","0","54.06","16.34"
"66","000","00","027","2731","1322","985","336","649","71","1056","2155","0","49.0","15.59"
"66","000","00","027","2732","0000","1724","549","1175","118","1842","3796","0","48.52","14.46"
"66","000","00","027","2732","1323","859","272","587","49","908","1775","0","51.15","15.32"
"66","000","00","027","2732","1324","865","277","588","69","934","2021","0","46.21","13.71"
"66","000","00","027","2733","0000","1894","549","1345","107","2001","3762","0","53.19","14.59"
"66","000","00","027","2733","1310","1015","277","738","53","1068","2010","0","53.13","13.78"
"66","000","00","027","2733","1311","879","272","607","54","933","1752","0","53.25","15.53"
"66","000","00","027","2734","0000","2567","819","1748","138","2705","4401","0","61.46","18.61"
"66","000","00","027","2734","1314","1279","411","868","80","1359","2170","0","62.63","18.94"
"66","000","00","027","2734","1315","1288","408","880","58","1346","2231","0","60.33","18.29"
"66","000","00","027","2735","0000","1288","424","864","98","1386","2556","0","54.23","16.59"
"66","000","00","027","2735","1303","751","258","493","63","814","1493","0","54.52","17.28"
"66","000","00","027","2735","1304","537","166","371","35","572","1063","0","53.81","15.62"
"66","000","00","027","2736","0000","1254","385","869","72","1326","2201","0","60.25","17.49"
"66","000","00","027","2736","1305","632","188","444","39","671","1117","0","60.07","16.83"
"66","000","00","027","2736","1306","622","197","425","33","655","1084","0","60.42","18.17"
"66","000","00","027","2737","0000","768","222","546","18","786","1559","0","50.42","14.24"
"66","000","00","027","2737","1350","768","222","546","18","786","1559","0","50.42","14.24"
"66","000","00","027","2738","0000","1890","607","1283","140","2030","3576","0","56.77","16.97"
"66","000","00","027","2738","1354","845","274","571","74","919","1450","0","63.38","18.9"
"66","000","00","027","2738","1355","1045","333","712","66","1111","2126","0","52.26","15.66"
"66","000","00","027","2739","0000","1369","415","954","102","1471","2507","0","58.68","16.55"
"66","000","00","027","2739","1359","674","207","467","41","715","1241","0","57.61","16.68"
"66","000","00","027","2739","1360","695","208","487","61","756","1266","0","59.72","16.43"
"66","000","00","028","0000","0000","91768","29508","62260","5115","96883","171769","211860","56.4","17.18"
"66","000","00","028","2801","0000","1914","613","1301","127","2041","3508","0","58.18","17.47"
"66","000","00","028","2801","1373","913","285","628","40","953","1697","0","56.16","16.79"
"66","000","00","028","2801","1374","1001","328","673","87","1088","1811","0","60.08","18.11"
"66","000","00","028","2802","0000","5204","1703","3501","288","5492","9923","0","55.35","17.16"
"66","000","00","028","2802","1375","986","297","689","50","1036","1830","0","56.61","16.23"
"66","000","00","028","2802","1376","867","265","602","99","966","2228","0","43.36","11.89"
"66","000","00","028","2802","1377","1048","343","705","64","1112","1997","0","55.68","17.18"
"66","000","00","028","2802","1378","1268","438","830","32","1300","2033","0","63.94","21.54"
"66","000","00","028","2802","1379","1035","360","675","43","1078","1835","0","58.75","19.62"
"66","000","00","028","2803","0000","1780","579","1201","110","1890","3418","0","55.3","16.94"
"66","000","00","028","2803","1384","841","270","571","61","902","1621","0","55.64","16.66"
"66","000","00","028","2803","1385","939","309","630","49","988","1797","0","54.98","17.2"
"66","000","00","028","2804","0000","3734","1255","2479","178","3912","7122","0","54.93","17.62"
"66","000","00","028","2804","1422","984","318","666","41","1025","1875","0","54.67","16.96"
"66","000","00","028","2804","1423","905","300","605","52","957","1670","0","57.31","17.96"
"66","000","00","028","2804","1424","983","337","646","55","1038","1898","0","54.69","17.76"
"66","000","00","028","2804","1425","862","300","562","30","892","1679","0","53.13","17.87"
"66","000","00","028","2805","0000","3695","1175","2520","236","3931","6924","0","56.77","16.97"
"66","000","00","028","2805","1386","649","198","451","26","675","1230","0","54.88","16.1"
"66","000","00","028","2805","1387","781","219","562","44","825","1488","0","55.44","14.72"
"66","000","00","028","2805","1388","730","266","464","68","798","1459","0","54.69","18.23"
"66","000","00","028","2805","1389","901","294","607","43","944","1647","0","57.32","17.85"
"66","000","00","028","2805","1390","634","198","436","55","689","1100","0","62.64","18.0"
"66","000","00","028","2806","0000","2205","822","1383","145","2350","3956","0","59.4","20.78"
"66","000","00","028","2806","1434","671","107","564","26","697","1103","0","63.19","9.7"
"66","000","00","028","2806","1435","775","530","245","59","834","1419","0","58.77","37.35"
"66","000","00","028","2806","1436","759","185","574","60","819","1434","0","57.11","12.9"
"66","000","00","028","2807","0000","2854","938","1916","124","2978","5587","0","53.3","16.79"
"66","000","00","028","2807","1437","909","275","634","42","951","1875","0","50.72","14.67"
"66","000","00","028","2807","1438","982","335","647","50","1032","1862","0","55.42","17.99"
"66","000","00","028","2807","1439","963","328","635","32","995","1850","0","53.78","17.73"
"66","000","00","028","2808","0000","4262","1311","2951","226","4488","8258","0","54.35","15.88"
"66","000","00","028","2808","1391","763","250","513","49","812","1410","0","57.59","17.73"
"66","000","00","028","2808","1392","892","265","627","69","961","1807","0","53.18","14.67"
"66","000","00","028","2808","1393","727","236","491","44","771","1331","0","57.93","17.73"
"66","000","00","028","2808","1394","941","227","714","29","970","1801","0","53.86","12.6"
"66","000","00","028","2808","1395","939","333","606","35","974","1909","0","51.02","17.44"
"66","000","00","028","2809","0000","1716","516","1200","115","1831","3355","0","54.58","15.38"
"66","000","00","028","2809","1399","874","261","613","68","942","1753","0","53.74","14.89"
"66","000","00","028","2809","1400","842","255","587","47","889","1602","0","55.49","15.92"
"66","000","00","028","2810","0000","2624","773","1851","163","2787","5278","0","52.8","14.65"
"66","000","00","028","2810","1451","910","264","646","49","959","1759","0","54.52","15.01"
"66","000","00","028","2810","1452","888","264","624","58","946","1783","0","53.06","14.81"
"66","000","00","028","2810","1453","826","245","581","56","882","1736","0","50.81","14.11"
"66","000","00","028","2811","0000","3866","1114","2752","246","4112","7599","0","54.11","14.66"
"66","000","00","028","2811","1458","959","295","664","65","1024","1836","0","55.77","16.07"
"66","000","00","028","2811","1459","993","290","703","64","1057","1913","0","55.25","15.16"
"66","000","00","028","2811","1460","943","274","669","76","1019","1913","0","53.27","14.32"
"66","000","00","028","2811","1461","971","255","716","41","1012","1937","0","52.25","13.16"
"66","000","00","028","2812","0000","2302","758","1544","155","2457","4237","0","57.99","17.89"
"66","000","00","028","2812","1401","623","215","408","48","671","1144","0","58.65","18.79"
"66","000","00","028","2812","1402","919","281","638","59","978","1655","0","59.09","16.98"
"66","000","00","028","2812","1403","760","262","498","48","808","1438","0","56.19","18.22"
"66","000","00","028","2813","0000","548","198","350","50","598","1000","0","59.8","19.8"
"66","000","00","028","2813","1404","548","198","350","50","598","1000","0","59.8","19.8"
"66","000","00","028","2814","0000","4484","1424","3060","241","4725","8369","0","56.46","17.02"
"66","000","00","028","2814","1405","908","295","613","56","964","1711","0","56.34","17.24"
"66","000","00","028","2814","1406","906","264","642","13","919","1698","0","54.12","15.55"
"66","000","00","028","2814","1407","998","305","693","77","1075","1914","0","56.17","15.94"
"66","000","00","028","2814","1408","832","297","535","31","863","1465","0","58.91","20.27"
"66","000","00","028","2814","1409","840","263","577","64","904","1581","0","57.18","16.64"
"66","000","00","028","2815","0000","2121","675","1446","83","2204","4438","0","49.66","15.21"
"66","000","00","028","2815","1414","568","181","387","26","594","1204","0","49.34","15.03"
"66","000","00","028","2815","1415","867","278","589","27","894","1761","0","50.77","15.79"
"66","000","00","028","2815","1416","686","216","470","30","716","1473","0","48.61","14.66"
"66","000","00","028","2816","0000","4449","1289","3160","337","4786","8428","0","56.79","15.29"
"66","000","00","028","2816","1417","879","257","622","71","950","1675","0","56.72","15.34"
"66","000","00","028","2816","1418","930","274","656","56","986","1755","0","56.18","15.61"
"66","000","00","028","2816","1419","863","273","590","79","942","1593","0","59.13","17.14"
"66","000","00","028","2816","1420","923","203","720","67","990","1799","0","55.03","11.28"
"66","000","00","028","2816","1421","854","282","572","64","918","1606","0","57.16","17.56"
"66","000","00","028","2817","0000","6168","1910","4258","331","6499","11504","0","56.49","16.6"
"66","000","00","028","2817","1462","780","227","553","40","820","1508","0","54.38","15.05"
"66","000","00","028","2817","1463","767","234","533","34","801","1340","0","59.78","17.46"
"66","000","00","028","2817","1464","917","271","646","56","973","1656","0","58.76","16.36"
"66","000","00","028","2817","1465","703","203","500","31","734","1290","0","56.9","15.74"
"66","000","00","028","2817","1466","885","279","606","35","920","1655","0","55.59","16.86"
"66","000","00","028","2817","1467","614","213","401","23","637","1260","0","50.56","16.9"
"66","000","00","028","2817","1468","720","244","476","26","746","1247","0","59.82","19.57"
"66","000","00","028","2817","1469","782","239","543","86","868","1548","0","56.07","15.44"
"66","000","00","028","2818","0000","5079","1607","3472","327","5406","9578","0","56.44","16.78"
"66","000","00","028","2818","1445","836","262","574","58","894","1701","0","52.56","15.4"
"66","000","00","028","2818","1446","778","249","529","55","833","1549","0","53.78","16.07"
"66","000","00","028","2818","1447","903","276","627","43","946","1567","0","60.37","17.61"
"66","000","00","028","2818","1448","876","273","603","51","927","1614","0","57.43","16.91"
"66","000","00","028","2818","1449","969","316","653","78","1047","1811","0","57.81","17.45"
"66","000","00","028","2818","1450","717","231","486","42","759","1336","0","56.81","17.29"
"66","000","00","028","2819","0000","5153","1913","3240","278","5431","10155","0","53.48","18.84"
"66","000","00","028","2819","1364","817","260","557","33","850","1614","0","52.66","16.11"
"66","000","00","028","2819","1365","769","236","533","38","807","1599","0","50.47","14.76"
"66","000","00","028","2819","1366","818","547","271","56","874","1715","0","50.96","31.9"
"66","000","00","028","2819","1367","714","216","498","22","736","1264","0","58.23","17.09"
"66","000","00","028","2819","1368","724","240","484","34","758","1416","0","53.53","16.95"
"66","000","00","028","2819","1369","623","191","432","33","656","1188","0","55.22","16.08"
"66","000","00","028","2819","1370","688","223","465","62","750","1359","0","55.19","16.41"
"66","000","00","028","2820","0000","1591","468","1123","91","1682","2860","0","58.81","16.36"
"66","000","00","028","2820","1371","803","242","561","47","850","1457","0","58.34","16.61"
"66","000","00","028","2820","1372","788","226","562","44","832","1403","0","59.3","16.11"
"66","000","00","028","2821","0000","3351","1103","2248","128","3479","5775","0","60.24","19.1"
"66","000","00","028","2821","1380","708","237","471","25","733","1268","0","57.81","18.69"
"66","000","00","028","2821","1381","916","289","627","46","962","1645","0","58.48","17.57"
"66","000","00","028","2821","1382","906","312","594","29","935","1561","0","59.9","19.99"
"66","000","00","028","2821","1383","821","265","556","28","849","1301","0","65.26","20.37"
"66","000","00","028","2822","0000","2175","674","1501","150","2325","4102","0","56.68","16.43"
"66","000","00","028","2822","1426","700","219","481","57","757","1373","0","55.13","15.95"
"66","000","00","028","2822","1427","695","208","487","57","752","1299","0","57.89","16.01"
"66","000","00","028","2822","1428","780","247","533","36","816","1430","0","57.06","17.27"
"66","000","00","028","2823","0000","5640","1880","3760","191","5831","9149","0","63.73","20.55"
"66","000","00","028","2823","1429","1105","354","751","39","1144","1805","0","63.38","19.61"
"66","000","00","028","2823","1430","1156","426","730","17","1173","1806","0","64.95","23.59"
"66","000","00","028","2823","1431","1141","383","758","45","1186","1826","0","64.95","20.97"
"66","000","00","028","2823","1432","1130","329","801","50","1180","1805","0","65.37","18.23"
"66","000","00","028","2823","1433","1108","388","720","40","1148","1907","0","60.2","20.35"
"66","000","00","028","2824","0000","4823","1612","3211","248","5071","8472","0","59.86","19.03"
"66","000","00","028","2824","1440","875","278","597","60","935","1622","0","57.64","17.14"
"66","000","00","028","2824","1441","965","302","663","52","1017","1638","0","62.09","18.44"
"66","000","00","028","2824","1442","957","302","655","62","1019","1633","0","62.4","18.49"
"66","000","00","028","2824","1443","912","321","591","41","953","1662","0","57.34","19.31"
"66","000","00","028","2824","1444","1114","409","705","33","1147","1917","0","59.83","21.34"
"66","000","00","028","2825","0000","2704","965","1739","146","2850","5238","0","54.41","18.42"
"66","000","00","028","2825","1396","813","307","506","55","868","1699","0","51.09","18.07"
"66","000","00","028","2825","1397","893","304","589","47","940","1627","0","57.78","18.68"
"66","000","00","028","2825","1398","998","354","644","44","1042","1912","0","54.5","18.51"
"66","000","00","028","2826","0000","4105","1222","2883","225","4330","7648","0","56.62","15.98"
"66","000","00","028","2826","1454","1013","300","713","53","1066","1874","0","56.88","16.01"
"66","000","00","028","2826","1455","990","327","663","72","1062","1889","0","56.22","17.31"
"66","000","00","028","2826","1456","1007","268","739","63","1070","1947","0","54.96","13.76"
"66","000","00","028","2826","1457","1095","327","768","37","1132","1938","0","58.41","16.87"
"66","000","00","028","2827","0000","3221","1011","2210","176","3397","5888","0","57.69","17.17"
"66","000","00","028","2827","1410","843","230","613","57","900","1509","0","59.64","15.24"
"66","000","00","028","2827","1411","822","247","575","28","850","1570","0","54.14","15.73"
"66","000","00","028","2827","1412","792","276","516","35","827","1425","0","58.04","19.37"
"66","000","00","028","2827","1413","764","258","506","56","820","1384","0","59.25","18.64"
"66","000","00","029","0000","0000","5628","1280","4348","376","6004","9498","11066","63.21","13.48"
"66","000","00","029","2901","0000","1166","300","866","81","1247","1919","0","64.98","15.63"
"66","000","00","029","2901","1585","568","169","399","46","614","956","0","64.23","17.68"
"66","000","00","029","2901","1586","598","131","467","35","633","963","0","65.73","13.6"
"66","000","00","029","2902","0000","256","74","182","15","271","456","0","59.43","16.23"
"66","000","00","029","2902","1587","256","74","182","15","271","456","0","59.43","16.23"
"66","000","00","029","2903","0000","975","189","786","69","1044","1647","0","63.39","11.48"
"66","000","00","029","2903","1588","606","118","488","54","660","1011","0","65.28","11.67"
"66","000","00","029","2903","1589","369","71","298","15","384","636","0","60.38","11.16"
"66","000","00","029","2904","0000","309","85","224","12","321","451","0","71.18","18.85"
"66","000","00","029","2904","1595","309","85","224","12","321","451","0","71.18","18.85"
"66","000","00","029","2905","0000","737","132","605","44","781","1051","0","74.31","12.56"
"66","000","00","029","2905","1590","174","27","147","7","181","270","0","67.04","10.0"
"66","000","00","029","2905","1591","337","55","282","20","357","460","0","77.61","11.96"
"66","000","00","029","2905","1592","226","50","176","17","243","321","0","75.7","15.58"
"66","000","00","029","2906","0000","697","200","497","50","747","1119","0","66.76","17.87"
"66","000","00","029","2906","1593","480","143","337","36","516","783","0","65.9","18.26"
"66","000","00","029","2906","1594","217","57","160","14","231","336","0","68.75","16.96"
"66","000","00","029","2907","0000","992","207","785","70","1062","1985","0","53.5","10.43"
"66","000","00","029","2907","1596","193","35","158","15","208","366","0","56.83","9.56"
"66","000","00","029","2907","1597","350","79","271","12","362","771","0","46.95","10.25"
"66","000","00","029","2907","1598","292","61","231","29","321","574","0","55.92","10.63"
"66","000","00","029","2907","1599","157","32","125","14","171","274","0","62.41","11.68"
"66","000","00","029","2908","0000","496","93","403","35","531","870","0","61.03","10.69"
"66","000","00","029","2908","1600","80","20","60","7","87","157","0","55.41","12.74"
"66","000","00","029","2908","1601","416","73","343","28","444","713","0","62.27","10.24"
"67","000","00","000","0000","0000","773733","270957","502776","45753","819486","1594821","1883804","51.38","16.99"
"67","000","00","001","0000","0000","30859","10841","20018","1481","32340","64949","77651","49.79","16.69"
"67","000","00","001","0101","0000","2344","771","1573","130","2474","4741","0","52.18","16.26"
"67","000","00","001","0101","0116","751","248","503","44","795","1693","0","46.96","14.65"
"67","000","00","001","0101","0117","819","275","544","53","872","1561","0","55.86","17.62"
"67","000","00","001","0101","0118","774","248","526","33","807","1487","0","54.27","16.68"
"67","000","00","001","0102","0000","1149","402","747","35","1184","2299","0","51.5","17.49"
"67","000","00","001","0102","0119","624","206","418","15","639","1232","0","51.87","16.72"
"67","000","00","001","0102","0120","525","196","329","20","545","1067","0","51.08","18.37"
"67","000","00","001","0103","0000","1396","498","898","62","1458","2885","0","50.54","17.26"
"67","000","00","001","0103","0121","624","227","397","32","656","1419","0","46.23","16.0"
"67","000","00","001","0103","0122","772","271","501","30","802","1466","0","54.71","18.49"
"67","000","00","001","0107","0000","1473","552","921","53","1526","2940","0","51.9","18.78"
"67","000","00","001","0107","0126","469","177","292","32","501","888","0","56.42","19.93"
"67","000","00","001","0107","0127","560","219","341","9","569","1115","0","51.03","19.64"
"67","000","00","001","0107","0128","444","156","288","12","456","937","0","48.67","16.65"
"67","000","00","001","0108","0000","2078","618","1460","101","2179","4214","0","51.71","14.67"
"67","000","00","001","0108","0129","653","135","518","33","686","1387","0","49.46","9.73"
"67","000","00","001","0108","0130","716","249","467","43","759","1526","0","49.74","16.32"
"67","000","00","001","0108","0131","709","234","475","25","734","1301","0","56.42","17.99"
"67","000","00","001","0109","0000","661","242","419","34","695","1193","0","58.26","20.28"
"67","000","00","001","0109","0136","661","242","419","34","695","1193","0","58.26","20.28"
"67","000","00","001","0110","0000","558","261","297","13","571","1439","0","39.68","18.14"
"67","000","00","001","0110","0137","558","261","297","13","571","1439","0","39.68","18.14"
"67","000","00","001","0112","0000","1011","331","680","41","1052","2460","0","42.76","13.46"
"67","000","00","001","0112","0140","502","181","321","24","526","1233","0","42.66","14.68"
"67","000","00","001","0112","0141","509","150","359","17","526","1227","0","42.87","12.22"
"67","000","00","001","0113","0000","971","321","650","51","1022","1797","0","56.87","17.86"
"67","000","00","001","0113","0138","777","252","525","34","811","1438","0","56.4","17.52"
"67","000","00","001","0113","0139","194","69","125","17","211","359","0","58.77","19.22"
"67","000","00","001","0114","0000","1376","501","875","46","1422","3250","0","43.75","15.42"
"67","000","00","001","0114","0142","584","202","382","22","606","1320","0","45.91","15.3"
"67","000","00","001","0114","0143","792","299","493","24","816","1930","0","42.28","15.49"
"67","000","00","001","0115","0000","2070","715","1355","106","2176","4419","0","49.24","16.18"
"67","000","00","001","0115","0150","795","273","522","33","828","1595","0","51.91","17.12"
"67","000","00","001","0115","0151","420","143","277","20","440","959","0","45.88","14.91"
"67","000","00","001","0115","0152","855","299","556","53","908","1865","0","48.69","16.03"
"67","000","00","001","0116","0000","713","255","458","73","786","1678","0","46.84","15.2"
"67","000","00","001","0116","0153","713","255","458","73","786","1678","0","46.84","15.2"
"67","000","00","001","0117","0000","569","190","379","53","622","1373","0","45.3","13.84"
"67","000","00","001","0117","0154","569","190","379","53","622","1373","0","45.3","13.84"
"67","000","00","001","0118","0000","624","229","395","26","650","1722","0","37.75","13.3"
"67","000","00","001","0118","0155","519","184","335","25","544","1431","0","38.02","12.86"
"67","000","00","001","0118","0156","105","45","60","1","106","291","0","36.43","15.46"
"67","000","00","001","0119","0000","823","312","511","33","856","1749","0","48.94","17.84"
"67","000","00","001","0119","0157","823","312","511","33","856","1749","0","48.94","17.84"
"67","000","00","001","0120","0000","1730","600","1130","103","1833","3683","0","49.77","16.29"
"67","000","00","001","0120","0158","821","275","546","30","851","1862","0","45.7","14.77"
"67","000","00","001","0120","0159","909","325","584","73","982","1821","0","53.93","17.85"
"67","000","00","001","0121","0000","807","273","534","54","861","1845","0","46.67","14.8"
"67","000","00","001","0121","0160","807","273","534","54","861","1845","0","46.67","14.8"
"67","000","00","001","0125","0000","744","261","483","86","830","1644","0","50.49","15.88"
"67","000","00","001","0125","0163","355","131","224","56","411","703","0","58.46","18.63"
"67","000","00","001","0125","0164","389","130","259","30","419","941","0","44.53","13.82"
"67","000","00","001","0126","0000","341","114","227","10","351","944","0","37.18","12.08"
"67","000","00","001","0126","0161","196","56","140","9","205","542","0","37.82","10.33"
"67","000","00","001","0126","0162","145","58","87","1","146","402","0","36.32","14.43"
"67","000","00","001","0127","0000","2355","828","1527","92","2447","4729","0","51.74","17.51"
"67","000","00","001","0127","0144","761","266","495","28","789","1501","0","52.56","17.72"
"67","000","00","001","0127","0145","696","238","458","27","723","1475","0","49.02","16.14"
"67","000","00","001","0127","0146","898","324","574","37","935","1753","0","53.34","18.48"
"67","000","00","001","0128","0000","2368","848","1520","82","2450","4922","0","49.78","17.23"
"67","000","00","001","0128","0147","838","319","519","26","864","1748","0","49.43","18.25"
"67","000","00","001","0128","0148","852","294","558","41","893","1741","0","51.29","16.89"
"67","000","00","001","0128","0149","678","235","443","15","693","1433","0","48.36","16.4"
"67","000","00","001","0129","0000","3349","1230","2119","111","3460","6235","0","55.49","19.73"
"67","000","00","001","0129","0132","837","285","552","33","870","1538","0","56.57","18.53"
"67","000","00","001","0129","0133","823","296","527","34","857","1584","0","54.1","18.69"
"67","000","00","001","0129","0134","871","339","532","21","892","1583","0","56.35","21.42"
"67","000","00","001","0129","0135","818","310","508","23","841","1530","0","54.97","20.26"
"67","000","00","001","0130","0000","1349","489","860","86","1435","2788","0","51.47","17.54"
"67","000","00","001","0130","0123","527","207","320","45","572","932","0","61.37","22.21"
"67","000","00","001","0130","0124","483","168","315","19","502","1099","0","45.68","15.29"
"67","000","00","001","0130","0125","339","114","225","22","361","757","0","47.69","15.06"
"67","000","00","002","0000","0000","9815","3508","6307","774","10589","22121","25397","47.87","15.86"
"67","000","00","002","0201","0000","739","255","484","77","816","1517","0","53.79","16.81"
"67","000","00","002","0201","0085","499","162","337","59","558","1037","0","53.81","15.62"
"67","000","00","002","0201","0086","240","93","147","18","258","480","0","53.75","19.38"
"67","000","00","002","0208","0000","1693","585","1108","92","1785","3743","0","47.69","15.63"
"67","000","00","002","0208","0093","361","132","229","16","377","863","0","43.68","15.3"
"67","000","00","002","0208","0094","637","210","427","21","658","1373","0","47.92","15.29"
"67","000","00","002","0208","0095","695","243","452","55","750","1507","0","49.77","16.12"
"67","000","00","002","0210","0000","313","110","203","36","349","921","0","37.89","11.94"
"67","000","00","002","0210","0099","313","110","203","36","349","921","0","37.89","11.94"
"67","000","00","002","0211","0000","1706","574","1132","139","1845","3640","0","50.69","15.77"
"67","000","00","002","0211","0096","673","236","437","55","728","1374","0","52.98","17.18"
"67","000","00","002","0211","0097","539","191","348","40","579","1244","0","46.54","15.35"
"67","000","00","002","0211","0098","494","147","347","44","538","1022","0","52.64","14.38"
"67","000","00","002","0214","0000","703","218","485","54","757","1653","0","45.8","13.19"
"67","000","00","002","0214","0107","418","143","275","22","440","925","0","47.57","15.46"
"67","000","00","002","0214","0108","285","75","210","32","317","728","0","43.54","10.3"
"67","000","00","002","0226","0000","796","293","503","52","848","1454","0","58.32","20.15"
"67","000","00","002","0226","0087","359","138","221","22","381","636","0","59.91","21.7"
"67","000","00","002","0226","0088","162","58","104","8","170","321","0","52.96","18.07"
"67","000","00","002","0226","0089","275","97","178","22","297","497","0","59.76","19.52"
"67","000","00","002","0227","0000","832","416","416","48","880","1607","0","54.76","25.89"
"67","000","00","002","0227","0090","422","284","138","16","438","759","0","57.71","37.42"
"67","000","00","002","0227","0091","151","53","98","13","164","341","0","48.09","15.54"
"67","000","00","002","0227","0092","259","79","180","19","278","507","0","54.83","15.58"
"67","000","00","002","0228","0000","692","231","461","48","740","1539","0","48.08","15.01"
"67","000","00","002","0228","0102","360","114","246","18","378","761","0","49.67","14.98"
"67","000","00","002","0228","0103","127","45","82","9","136","285","0","47.72","15.79"
"67","000","00","002","0228","0104","205","72","133","21","226","493","0","45.84","14.6"
"67","000","00","002","0229","0000","662","252","410","43","705","1583","0","44.54","15.92"
"67","000","00","002","0229","0100","422","152","270","36","458","847","0","54.07","17.95"
"67","000","00","002","0229","0101","240","100","140","7","247","736","0","33.56","13.59"
"67","000","00","002","0230","0000","345","108","237","28","373","1013","0","36.82","10.66"
"67","000","00","002","0230","0105","216","65","151","21","237","621","0","38.16","10.47"
"67","000","00","002","0230","0106","129","43","86","7","136","392","0","34.69","10.97"
"67","000","00","002","0231","0000","386","141","245","55","441","1120","0","39.38","12.59"
"67","000","00","002","0231","0112","264","97","167","29","293","755","0","38.81","12.85"
"67","000","00","002","0231","0113","122","44","78","26","148","365","0","40.55","12.05"
"67","000","00","002","0232","0000","359","102","257","51","410","902","0","45.45","11.31"
"67","000","00","002","0232","0109","62","15","47","18","80","214","0","37.38","7.01"
"67","000","00","002","0232","0110","162","44","118","15","177","387","0","45.74","11.37"
"67","000","00","002","0232","0111","135","43","92","18","153","301","0","50.83","14.29"
"67","000","00","002","0233","0000","589","223","366","51","640","1429","0","44.79","15.61"
"67","000","00","002","0233","0114","391","150","241","28","419","935","0","44.81","16.04"
"67","000","00","002","0233","0115","198","73","125","23","221","494","0","44.74","14.78"
"67","000","00","003","0000","0000","9891","3476","6415","838","10729","24894","28152","43.1","13.96"
"67","000","00","003","0301","0000","817","299","518","84","901","1722","0","52.32","17.36"
"67","000","00","003","0301","0030","558","200","358","69","627","1176","0","53.32","17.01"
"67","000","00","003","0301","0031","259","99","160","15","274","546","0","50.18","18.13"
"67","000","00","003","0302","0000","1475","511","964","88","1563","2921","0","53.51","17.49"
"67","000","00","003","0302","0032","445","181","264","21","466","859","0","54.25","21.07"
"67","000","00","003","0302","0033","495","160","335","30","525","946","0","55.5","16.91"
"67","000","00","003","0302","0034","535","170","365","37","572","1116","0","51.25","15.23"
"67","000","00","003","0303","0000","523","173","350","25","548","1397","0","39.23","12.38"
"67","000","00","003","0303","0035","523","173","350","25","548","1397","0","39.23","12.38"
"67","000","00","003","0304","0000","669","237","432","62","731","1627","0","44.93","14.57"
"67","000","00","003","0304","0036","289","106","183","16","305","756","0","40.34","14.02"
"67","000","00","003","0304","0037","380","131","249","46","426","871","0","48.91","15.04"
"67","000","00","003","0305","0000","415","135","280","31","446","897","0","49.72","15.05"
"67","000","00","003","0305","0038","415","135","280","31","446","897","0","49.72","15.05"
"67","000","00","003","0306","0000","460","173","287","50","510","1356","0","37.61","12.76"
"67","000","00","003","0306","0039","242","94","148","34","276","784","0","35.2","11.99"
"67","000","00","003","0306","0040","218","79","139","16","234","572","0","40.91","13.81"
"67","000","00","003","0307","0000","141","42","99","9","150","457","0","32.82","9.19"
"67","000","00","003","0307","0041","141","42","99","9","150","457","0","32.82","9.19"
"67","000","00","003","0308","0000","201","63","138","11","212","600","0","35.33","10.5"
"67","000","00","003","0308","0042","201","63","138","11","212","600","0","35.33","10.5"
"67","000","00","003","0309","0000","108","39","69","3","111","375","0","29.6","10.4"
"67","000","00","003","0309","0043","108","39","69","3","111","375","0","29.6","10.4"
"67","000","00","003","0310","0000","121","47","74","12","133","508","0","26.18","9.25"
"67","000","00","003","0310","0044","121","47","74","12","133","508","0","26.18","9.25"
"67","000","00","003","0311","0000","406","116","290","28","434","1305","0","33.26","8.89"
"67","000","00","003","0311","0047","253","68","185","12","265","799","0","33.17","8.51"
"67","000","00","003","0311","0048","153","48","105","16","169","506","0","33.4","9.49"
"67","000","00","003","0312","0000","300","103","197","20","320","1022","0","31.31","10.08"
"67","000","00","003","0312","0045","188","64","124","13","201","631","0","31.85","10.14"
"67","000","00","003","0312","0046","112","39","73","7","119","391","0","30.43","9.97"
"67","000","00","003","0314","0000","493","185","308","25","518","1443","0","35.9","12.82"
"67","000","00","003","0314","0051","244","100","144","11","255","744","0","34.27","13.44"
"67","000","00","003","0314","0052","249","85","164","14","263","699","0","37.63","12.16"
"67","000","00","003","0318","0000","347","124","223","40","387","884","0","43.78","14.03"
"67","000","00","003","0318","0055","347","124","223","40","387","884","0","43.78","14.03"
"67","000","00","003","0319","0000","195","56","139","14","209","740","0","28.24","7.57"
"67","000","00","003","0319","0056","195","56","139","14","209","740","0","28.24","7.57"
"67","000","00","003","0320","0000","513","165","348","51","564","1334","0","42.28","12.37"
"67","000","00","003","0320","0057","513","165","348","51","564","1334","0","42.28","12.37"
"67","000","00","003","0321","0000","294","112","182","58","352","723","0","48.69","15.49"
"67","000","00","003","0321","0058","294","112","182","58","352","723","0","48.69","15.49"
"67","000","00","003","0322","0000","335","115","220","45","380","682","0","55.72","16.86"
"67","000","00","003","0322","0059","335","115","220","45","380","682","0","55.72","16.86"
"67","000","00","003","0325","0000","865","321","544","55","920","2011","0","45.75","15.96"
"67","000","00","003","0325","0049","350","133","217","22","372","832","0","44.71","15.99"
"67","000","00","003","0325","0050","515","188","327","33","548","1179","0","46.48","15.95"
"67","000","00","003","0326","0000","614","238","376","66","680","1492","0","45.58","15.95"
"67","000","00","003","0326","0053","208","76","132","12","220","633","0","34.76","12.01"
"67","000","00","003","0326","0054","406","162","244","54","460","859","0","53.55","18.86"
"67","000","00","003","0327","0000","599","222","377","61","660","1398","0","47.21","15.88"
"67","000","00","003","0327","0060","397","160","237","41","438","855","0","51.23","18.71"
"67","000","00","003","0327","0061","202","62","140","20","222","543","0","40.88","11.42"
"67","000","00","004","0000","0000","8530","2872","5658","766","9296","18804","21212","49.44","15.27"
"67","000","00","004","0401","0000","873","321","552","50","923","1791","0","51.54","17.92"
"67","000","00","004","0401","0165","534","197","337","43","577","1166","0","49.49","16.9"
"67","000","00","004","0401","0166","339","124","215","7","346","625","0","55.36","19.84"
"67","000","00","004","0402","0000","742","254","488","45","787","1572","0","50.06","16.16"
"67","000","00","004","0402","0167","301","96","205","22","323","738","0","43.77","13.01"
"67","000","00","004","0402","0168","441","158","283","23","464","834","0","55.64","18.94"
"67","000","00","004","0403","0000","477","173","304","31","508","1104","0","46.01","15.67"
"67","000","00","004","0403","0169","477","173","304","31","508","1104","0","46.01","15.67"
"67","000","00","004","0404","0000","1317","423","894","99","1416","2735","0","51.77","15.47"
"67","000","00","004","0404","0170","454","154","300","18","472","1015","0","46.5","15.17"
"67","000","00","004","0404","0171","863","269","594","81","944","1720","0","54.88","15.64"
"67","000","00","004","0405","0000","595","208","387","64","659","1391","0","47.38","14.95"
"67","000","00","004","0405","0172","595","208","387","64","659","1391","0","47.38","14.95"
"67","000","00","004","0406","0000","316","97","219","20","336","743","0","45.22","13.06"
"67","000","00","004","0406","0173","188","60","128","10","198","425","0","46.59","14.12"
"67","000","00","004","0406","0174","128","37","91","10","138","318","0","43.4","11.64"
"67","000","00","004","0407","0000","646","218","428","72","718","1483","0","48.42","14.7"
"67","000","00","004","0407","0175","337","114","223","35","372","753","0","49.4","15.14"
"67","000","00","004","0407","0176","309","104","205","37","346","730","0","47.4","14.25"
"67","000","00","004","0408","0000","860","275","585","90","950","1809","0","52.52","15.2"
"67","000","00","004","0408","0177","317","105","212","37","354","725","0","48.83","14.48"
"67","000","00","004","0408","0178","391","124","267","35","426","787","0","54.13","15.76"
"67","000","00","004","0408","0179","152","46","106","18","170","297","0","57.24","15.49"
"67","000","00","004","0409","0000","652","218","434","85","737","1313","0","56.13","16.6"
"67","000","00","004","0409","0180","340","102","238","34","374","673","0","55.57","15.16"
"67","000","00","004","0409","0181","312","116","196","51","363","640","0","56.72","18.13"
"67","000","00","004","0410","0000","263","105","158","32","295","660","0","44.7","15.91"
"67","000","00","004","0410","0182","263","105","158","32","295","660","0","44.7","15.91"
"67","000","00","004","0411","0000","585","199","386","37","622","1414","0","43.99","14.07"
"67","000","00","004","0411","0183","498","172","326","33","531","1212","0","43.81","14.19"
"67","000","00","004","0411","0184","87","27","60","4","91","202","0","45.05","13.37"
"67","000","00","004","0412","0000","513","162","351","71","584","1207","0","48.38","13.42"
"67","000","00","004","0412","0185","439","134","305","70","509","1049","0","48.52","12.77"
"67","000","00","004","0412","0186","74","28","46","1","75","158","0","47.47","17.72"
"67","000","00","004","0413","0000","691","219","472","70","761","1582","0","48.1","13.84"
"67","000","00","004","0413","0187","409","136","273","55","464","921","0","50.38","14.77"
"67","000","00","004","0413","0188","220","68","152","12","232","504","0","46.03","13.49"
"67","000","00","004","0413","0189","62","15","47","3","65","157","0","41.4","9.55"
"67","000","00","005","0000","0000","8750","2975","5775","867","9617","20841","23424","46.14","14.27"
"67","000","00","005","0501","0000","818","259","559","55","873","1641","0","53.2","15.78"
"67","000","00","005","0501","0001","386","122","264","40","426","743","0","57.34","16.42"
"67","000","00","005","0501","0002","432","137","295","15","447","898","0","49.78","15.26"
"67","000","00","005","0502","0000","577","213","364","67","644","1320","0","48.79","16.14"
"67","000","00","005","0502","0003","334","120","214","35","369","786","0","46.95","15.27"
"67","000","00","005","0502","0004","243","93","150","32","275","534","0","51.5","17.42"
"67","000","00","005","0503","0000","556","212","344","81","637","1266","0","50.32","16.75"
"67","000","00","005","0503","0005","467","157","310","64","531","1034","0","51.35","15.18"
"67","000","00","005","0503","0006","89","55","34","17","106","232","0","45.69","23.71"
"67","000","00","005","0504","0000","562","188","374","57","619","1316","0","47.04","14.29"
"67","000","00","005","0504","0007","203","66","137","30","233","479","0","48.64","13.78"
"67","000","00","005","0504","0008","359","122","237","27","386","837","0","46.12","14.58"
"67","000","00","005","0510","0000","562","172","390","39","601","1399","0","42.96","12.29"
"67","000","00","005","0510","0021","336","109","227","14","350","958","0","36.53","11.38"
"67","000","00","005","0510","0022","226","63","163","25","251","441","0","56.92","14.29"
"67","000","00","005","0511","0000","773","261","512","117","890","1673","0","53.2","15.6"
"67","000","00","005","0511","0023","302","113","189","59","361","677","0","53.32","16.69"
"67","000","00","005","0511","0024","471","148","323","58","529","996","0","53.11","14.86"
"67","000","00","005","0512","0000","531","175","356","24","555","1255","0","44.22","13.94"
"67","000","00","005","0512","0025","531","175","356","24","555","1255","0","44.22","13.94"
"67","000","00","005","0513","0000","503","164","339","21","524","1231","0","42.57","13.32"
"67","000","00","005","0513","0026","279","104","175","14","293","678","0","43.22","15.34"
"67","000","00","005","0513","0027","224","60","164","7","231","553","0","41.77","10.85"
"67","000","00","005","0514","0000","733","256","477","47","780","1805","0","43.21","14.18"
"67","000","00","005","0514","0028","213","75","138","15","228","616","0","37.01","12.18"
"67","000","00","005","0514","0029","520","181","339","32","552","1189","0","46.43","15.22"
"67","000","00","005","0518","0000","611","201","410","79","690","1475","0","46.78","13.63"
"67","000","00","005","0518","0013","154","40","114","19","173","371","0","46.63","10.78"
"67","000","00","005","0518","0014","290","108","182","37","327","676","0","48.37","15.98"
"67","000","00","005","0518","0015","167","53","114","23","190","428","0","44.39","12.38"
"67","000","00","005","0519","0000","400","135","265","47","447","1002","0","44.61","13.47"
"67","000","00","005","0519","0016","203","66","137","8","211","547","0","38.57","12.07"
"67","000","00","005","0519","0017","197","69","128","39","236","455","0","51.87","15.16"
"67","000","00","005","0522","0000","744","238","506","109","853","2003","0","42.59","11.88"
"67","000","00","005","0522","0018","349","109","240","55","404","984","0","41.06","11.08"
"67","000","00","005","0522","0019","192","75","117","32","224","483","0","46.38","15.53"
"67","000","00","005","0522","0020","203","54","149","22","225","536","0","41.98","10.07"
"67","000","00","005","0523","0000","818","302","516","51","869","2242","0","38.76","13.47"
"67","000","00","005","0523","0009","419","161","258","29","448","1085","0","41.29","14.84"
"67","000","00","005","0523","0010","399","141","258","22","421","1157","0","36.39","12.19"
"67","000","00","005","0524","0000","562","199","363","73","635","1213","0","52.35","16.41"
"67","000","00","005","0524","0011","335","99","236","50","385","755","0","50.99","13.11"
"67","000","00","005","0524","0012","227","100","127","23","250","458","0","54.59","21.83"
"67","000","00","006","0000","0000","6293","2089","4204","647","6940","18471","20870","37.57","11.31"
"67","000","00","006","0601","0000","568","168","400","51","619","1401","0","44.18","11.99"
"67","000","00","006","0601","0062","568","168","400","51","619","1401","0","44.18","11.99"
"67","000","00","006","0602","0000","894","282","612","77","971","2488","0","39.03","11.33"
"67","000","00","006","0602","0063","407","107","300","30","437","1185","0","36.88","9.03"
"67","000","00","006","0602","0064","487","175","312","47","534","1303","0","40.98","13.43"
"67","000","00","006","0603","0000","508","167","341","61","569","1453","0","39.16","11.49"
"67","000","00","006","0603","0065","266","83","183","28","294","732","0","40.16","11.34"
"67","000","00","006","0603","0066","242","84","158","33","275","721","0","38.14","11.65"
"67","000","00","006","0604","0000","357","113","244","27","384","943","0","40.72","11.98"
"67","000","00","006","0604","0068","357","113","244","27","384","943","0","40.72","11.98"
"67","000","00","006","0605","0000","348","127","221","51","399","1104","0","36.14","11.5"
"67","000","00","006","0605","0067","348","127","221","51","399","1104","0","36.14","11.5"
"67","000","00","006","0606","0000","388","142","246","65","453","1249","0","36.27","11.37"
"67","000","00","006","0606","0069","155","52","103","4","159","653","0","24.35","7.96"
"67","000","00","006","0606","0070","233","90","143","61","294","596","0","49.33","15.1"
"67","000","00","006","0607","0000","347","131","216","51","398","878","0","45.33","14.92"
"67","000","00","006","0607","0071","347","131","216","51","398","878","0","45.33","14.92"
"67","000","00","006","0608","0000","95","31","64","3","98","425","0","23.06","7.29"
"67","000","00","006","0608","0075","95","31","64","3","98","425","0","23.06","7.29"
"67","000","00","006","0609","0000","138","39","99","7","145","394","0","36.8","9.9"
"67","000","00","006","0609","0076","138","39","99","7","145","394","0","36.8","9.9"
"67","000","00","006","0610","0000","157","50","107","30","187","373","0","50.13","13.4"
"67","000","00","006","0610","0077","157","50","107","30","187","373","0","50.13","13.4"
"67","000","00","006","0611","0000","617","170","447","40","657","2144","0","30.64","7.93"
"67","000","00","006","0611","0078","406","109","297","33","439","1257","0","34.92","8.67"
"67","000","00","006","0611","0079","211","61","150","7","218","887","0","24.58","6.88"
"67","000","00","006","0612","0000","170","39","131","7","177","658","0","26.9","5.93"
"67","000","00","006","0612","0080","170","39","131","7","177","658","0","26.9","5.93"
"67","000","00","006","0613","0000","300","87","213","23","323","1101","0","29.34","7.9"
"67","000","00","006","0613","0081","300","87","213","23","323","1101","0","29.34","7.9"
"67","000","00","006","0614","0000","273","78","195","16","289","1057","0","27.34","7.38"
"67","000","00","006","0614","0082","273","78","195","16","289","1057","0","27.34","7.38"
"67","000","00","006","0615","0000","376","115","261","46","422","909","0","46.42","12.65"
"67","000","00","006","0615","0083","276","80","196","29","305","639","0","47.73","12.52"
"67","000","00","006","0615","0084","100","35","65","17","117","270","0","43.33","12.96"
"67","000","00","006","0616","0000","757","350","407","92","849","1894","0","44.83","18.48"
"67","000","00","006","0616","0072","279","170","109","42","321","771","0","41.63","22.05"
"67","000","00","006","0616","0073","194","76","118","16","210","483","0","43.48","15.73"
"67","000","00","006","0616","0074","284","104","180","34","318","640","0","49.69","16.25"
"67","000","00","007","0000","0000","17581","6621","10960","1048","18629","37963","44306","49.07","17.44"
"67","000","00","007","0703","0000","1368","508","860","82","1450","2587","0","56.05","19.64"
"67","000","00","007","0703","0385","651","256","395","51","702","1262","0","55.63","20.29"
"67","000","00","007","0703","0386","717","252","465","31","748","1325","0","56.45","19.02"
"67","000","00","007","0704","0000","1221","493","728","48","1269","2505","0","50.66","19.68"
"67","000","00","007","0704","0387","671","265","406","25","696","1384","0","50.29","19.15"
"67","000","00","007","0704","0388","550","228","322","23","573","1121","0","51.12","20.34"
"67","000","00","007","0705","0000","1032","399","633","49","1081","2120","0","50.99","18.82"
"67","000","00","007","0705","0383","274","108","166","16","290","523","0","55.45","20.65"
"67","000","00","007","0705","0384","758","291","467","33","791","1597","0","49.53","18.22"
"67","000","00","007","0706","0000","931","382","549","33","964","1975","0","48.81","19.34"
"67","000","00","007","0706","0389","477","190","287","12","489","1021","0","47.89","18.61"
"67","000","00","007","0706","0390","454","192","262","21","475","954","0","49.79","20.13"
"67","000","00","007","0707","0000","657","243","414","30","687","1513","0","45.41","16.06"
"67","000","00","007","0707","0391","657","243","414","30","687","1513","0","45.41","16.06"
"67","000","00","007","0709","0000","1583","541","1042","93","1676","3530","0","47.48","15.33"
"67","000","00","007","0709","0392","736","246","490","31","767","1726","0","44.44","14.25"
"67","000","00","007","0709","0393","847","295","552","62","909","1804","0","50.39","16.35"
"67","000","00","007","0710","0000","498","172","326","27","525","1106","0","47.47","15.55"
"67","000","00","007","0710","0394","498","172","326","27","525","1106","0","47.47","15.55"
"67","000","00","007","0711","0000","1353","496","857","90","1443","2805","0","51.44","17.68"
"67","000","00","007","0711","0395","734","273","461","43","777","1503","0","51.7","18.16"
"67","000","00","007","0711","0396","619","223","396","47","666","1302","0","51.15","17.13"
"67","000","00","007","0714","0000","1023","390","633","55","1078","2330","0","46.27","16.74"
"67","000","00","007","0714","0399","725","267","458","40","765","1612","0","47.46","16.56"
"67","000","00","007","0714","0400","298","123","175","15","313","718","0","43.59","17.13"
"67","000","00","007","0715","0000","682","249","433","25","707","1656","0","42.69","15.04"
"67","000","00","007","0715","0401","682","249","433","25","707","1656","0","42.69","15.04"
"67","000","00","007","0717","0000","980","406","574","93","1073","2332","0","46.01","17.41"
"67","000","00","007","0717","0402","599","255","344","66","665","1355","0","49.08","18.82"
"67","000","00","007","0717","0403","381","151","230","27","408","977","0","41.76","15.46"
"67","000","00","007","0719","0000","903","346","557","50","953","2105","0","45.27","16.44"
"67","000","00","007","0719","0404","430","163","267","26","456","1012","0","45.06","16.11"
"67","000","00","007","0719","0405","328","128","200","19","347","626","0","55.43","20.45"
"67","000","00","007","0719","0406","145","55","90","5","150","467","0","32.12","11.78"
"67","000","00","007","0721","0000","537","189","348","27","564","1260","0","44.76","15.0"
"67","000","00","007","0721","0407","537","189","348","27","564","1260","0","44.76","15.0"
"67","000","00","007","0722","0000","537","182","355","45","582","1111","0","52.39","16.38"
"67","000","00","007","0722","0408","537","182","355","45","582","1111","0","52.39","16.38"
"67","000","00","007","0724","0000","638","267","371","69","707","1348","0","52.45","19.81"
"67","000","00","007","0724","0409","276","117","159","20","296","550","0","53.82","21.27"
"67","000","00","007","0724","0410","362","150","212","49","411","798","0","51.5","18.8"
"67","000","00","007","0728","0000","381","158","223","21","402","941","0","42.72","16.79"
"67","000","00","007","0728","0413","381","158","223","21","402","941","0","42.72","16.79"
"67","000","00","007","0730","0000","929","348","581","55","984","1865","0","52.76","18.66"
"67","000","00","007","0730","0381","576","213","363","38","614","1205","0","50.95","17.68"
"67","000","00","007","0730","0382","353","135","218","17","370","660","0","56.06","20.45"
"67","000","00","007","0731","0000","784","295","489","75","859","1682","0","51.07","17.54"
"67","000","00","007","0731","0411","449","158","291","62","511","852","0","59.98","18.54"
"67","000","00","007","0731","0412","335","137","198","13","348","830","0","41.93","16.51"
"67","000","00","007","0732","0000","839","304","535","38","877","1770","0","49.55","17.18"
"67","000","00","007","0732","0414","567","206","361","29","596","1158","0","51.47","17.79"
"67","000","00","007","0732","0415","272","98","174","9","281","612","0","45.92","16.01"
"67","000","00","007","0733","0000","705","253","452","43","748","1422","0","52.6","17.79"
"67","000","00","007","0733","0397","299","113","186","13","312","645","0","48.37","17.52"
"67","000","00","007","0733","0398","406","140","266","30","436","777","0","56.11","18.02"
"67","000","00","008","0000","0000","8923","3091","5832","913","9836","20947","23938","46.96","14.76"
"67","000","00","008","0801","0000","633","210","423","45","678","1558","0","43.52","13.48"
"67","000","00","008","0801","0343","633","210","423","45","678","1558","0","43.52","13.48"
"67","000","00","008","0802","0000","808","295","513","70","878","2005","0","43.79","14.71"
"67","000","00","008","0802","0344","426","172","254","28","454","1112","0","40.83","15.47"
"67","000","00","008","0802","0345","382","123","259","42","424","893","0","47.48","13.77"
"67","000","00","008","0803","0000","629","190","439","49","678","1623","0","41.77","11.71"
"67","000","00","008","0803","0346","629","190","439","49","678","1623","0","41.77","11.71"
"67","000","00","008","0804","0000","704","254","450","66","770","1568","0","49.11","16.2"
"67","000","00","008","0804","0347","704","254","450","66","770","1568","0","49.11","16.2"
"67","000","00","008","0805","0000","883","276","607","54","937","1938","0","48.35","14.24"
"67","000","00","008","0805","0348","467","132","335","38","505","985","0","51.27","13.4"
"67","000","00","008","0805","0349","416","144","272","16","432","953","0","45.33","15.11"
"67","000","00","008","0806","0000","903","361","542","176","1079","2108","0","51.19","17.13"
"67","000","00","008","0806","0350","366","164","202","112","478","1031","0","46.36","15.91"
"67","000","00","008","0806","0351","537","197","340","64","601","1077","0","55.8","18.29"
"67","000","00","008","0811","0000","856","279","577","81","937","1894","0","49.47","14.73"
"67","000","00","008","0811","0356","445","134","311","48","493","959","0","51.41","13.97"
"67","000","00","008","0811","0357","411","145","266","33","444","935","0","47.49","15.51"
"67","000","00","008","0812","0000","415","152","263","46","461","893","0","51.62","17.02"
"67","000","00","008","0812","0358","415","152","263","46","461","893","0","51.62","17.02"
"67","000","00","008","0813","0000","601","193","408","74","675","1293","0","52.2","14.93"
"67","000","00","008","0813","0359","601","193","408","74","675","1293","0","52.2","14.93"
"67","000","00","008","0816","0000","995","351","644","76","1071","2255","0","47.49","15.57"
"67","000","00","008","0816","0354","538","192","346","50","588","1164","0","50.52","16.49"
"67","000","00","008","0816","0355","457","159","298","26","483","1091","0","44.27","14.57"
"67","000","00","008","0817","0000","602","199","403","52","654","1557","0","42.0","12.78"
"67","000","00","008","0817","0352","259","100","159","36","295","703","0","41.96","14.22"
"67","000","00","008","0817","0353","343","99","244","16","359","854","0","42.04","11.59"
"67","000","00","008","0818","0000","894","331","563","124","1018","2255","0","45.14","14.68"
"67","000","00","008","0818","0360","517","198","319","108","625","1185","0","52.74","16.71"
"67","000","00","008","0818","0361","377","133","244","16","393","1070","0","36.73","12.43"
"67","000","00","009","0000","0000","8431","3197","5234","830","9261","19144","22196","48.38","16.7"
"67","000","00","009","0901","0000","1336","520","816","115","1451","2908","0","49.9","17.88"
"67","000","00","009","0901","0362","418","149","269","51","469","819","0","57.26","18.19"
"67","000","00","009","0901","0363","309","123","186","18","327","645","0","50.7","19.07"
"67","000","00","009","0901","0364","609","248","361","46","655","1444","0","45.36","17.17"
"67","000","00","009","0902","0000","1075","404","671","80","1155","2725","0","42.39","14.83"
"67","000","00","009","0902","0365","616","235","381","40","656","1554","0","42.21","15.12"
"67","000","00","009","0902","0366","459","169","290","40","499","1171","0","42.61","14.43"
"67","000","00","009","0903","0000","583","198","385","65","648","1351","0","47.96","14.66"
"67","000","00","009","0903","0367","583","198","385","65","648","1351","0","47.96","14.66"
"67","000","00","009","0905","0000","781","283","498","120","901","1929","0","46.71","14.67"
"67","000","00","009","0905","0368","396","138","258","72","468","1010","0","46.34","13.66"
"67","000","00","009","0905","0369","385","145","240","48","433","919","0","47.12","15.78"
"67","000","00","009","0906","0000","1551","563","988","168","1719","3360","0","51.16","16.76"
"67","000","00","009","0906","0370","604","225","379","58","662","1369","0","48.36","16.44"
"67","000","00","009","0906","0371","445","167","278","63","508","976","0","52.05","17.11"
"67","000","00","009","0906","0372","502","171","331","47","549","1015","0","54.09","16.85"
"67","000","00","009","0907","0000","932","460","472","77","1009","2115","0","47.71","21.75"
"67","000","00","009","0907","0373","502","317","185","25","527","1176","0","44.81","26.96"
"67","000","00","009","0907","0374","430","143","287","52","482","939","0","51.33","15.23"
"67","000","00","009","0908","0000","747","298","449","84","831","1593","0","52.17","18.71"
"67","000","00","009","0908","0375","330","134","196","43","373","712","0","52.39","18.82"
"67","000","00","009","0908","0376","417","164","253","41","458","881","0","51.99","18.62"
"67","000","00","009","0909","0000","631","212","419","60","691","1184","0","58.36","17.91"
"67","000","00","009","0909","0377","631","212","419","60","691","1184","0","58.36","17.91"
"67","000","00","009","0910","0000","340","107","233","25","365","599","0","60.93","17.86"
"67","000","00","009","0910","0378","340","107","233","25","365","599","0","60.93","17.86"
"67","000","00","009","0911","0000","236","74","162","9","245","759","0","32.28","9.75"
"67","000","00","009","0911","0379","236","74","162","9","245","759","0","32.28","9.75"
"67","000","00","009","0912","0000","219","78","141","27","246","621","0","39.61","12.56"
"67","000","00","009","0912","0380","219","78","141","27","246","621","0","39.61","12.56"
"67","000","00","010","0000","0000","8419","3068","5351","669","9088","18675","21329","48.66","16.43"
"67","000","00","010","1001","0000","908","313","595","57","965","2069","0","46.64","15.13"
"67","000","00","010","1001","0416","474","157","317","17","491","1104","0","44.47","14.22"
"67","000","00","010","1001","0417","434","156","278","40","474","965","0","49.12","16.17"
"67","000","00","010","1002","0000","1474","569","905","133","1607","3055","0","52.6","18.63"
"67","000","00","010","1002","0418","658","265","393","42","700","1402","0","49.93","18.9"
"67","000","00","010","1002","0419","816","304","512","91","907","1653","0","54.87","18.39"
"67","000","00","010","1005","0000","113","48","65","8","121","402","0","30.1","11.94"
"67","000","00","010","1005","0422","113","48","65","8","121","402","0","30.1","11.94"
"67","000","00","010","1006","0000","874","322","552","39","913","1957","0","46.65","16.45"
"67","000","00","010","1006","0423","479","186","293","10","489","982","0","49.8","18.94"
"67","000","00","010","1006","0424","395","136","259","29","424","975","0","43.49","13.95"
"67","000","00","010","1007","0000","1631","562","1069","94","1725","3375","0","51.11","16.65"
"67","000","00","010","1007","0425","376","130","246","23","399","802","0","49.75","16.21"
"67","000","00","010","1007","0426","569","190","379","37","606","1118","0","54.2","16.99"
"67","000","00","010","1007","0427","686","242","444","34","720","1455","0","49.48","16.63"
"67","000","00","010","1008","0000","574","185","389","32","606","1208","0","50.17","15.31"
"67","000","00","010","1008","0428","574","185","389","32","606","1208","0","50.17","15.31"
"67","000","00","010","1013","0000","357","121","236","21","378","873","0","43.3","13.86"
"67","000","00","010","1013","0435","357","121","236","21","378","873","0","43.3","13.86"
"67","000","00","010","1014","0000","517","190","327","60","577","1250","0","46.16","15.2"
"67","000","00","010","1014","0420","405","151","254","47","452","966","0","46.79","15.63"
"67","000","00","010","1014","0421","112","39","73","13","125","284","0","44.01","13.73"
"67","000","00","010","1015","0000","1183","444","739","145","1328","2586","0","51.35","17.17"
"67","000","00","010","1015","0431","211","69","142","27","238","501","0","47.5","13.77"
"67","000","00","010","1015","0432","346","133","213","55","401","728","0","55.08","18.27"
"67","000","00","010","1015","0433","383","160","223","29","412","842","0","48.93","19.0"
"67","000","00","010","1015","0434","243","82","161","34","277","515","0","53.79","15.92"
"67","000","00","010","1016","0000","788","314","474","80","868","1900","0","45.68","16.53"
"67","000","00","010","1016","0429","560","216","344","60","620","1293","0","47.95","16.71"
"67","000","00","010","1016","0430","228","98","130","20","248","607","0","40.86","16.14"
"67","000","00","011","0000","0000","3717","1171","2546","426","4143","8654","9643","47.87","13.53"
"67","000","00","011","1101","0000","363","111","252","54","417","1021","0","40.84","10.87"
"67","000","00","011","1101","0436","279","91","188","49","328","759","0","43.21","11.99"
"67","000","00","011","1101","0437","84","20","64","5","89","262","0","33.97","7.63"
"67","000","00","011","1102","0000","225","75","150","17","242","646","0","37.46","11.61"
"67","000","00","011","1102","0438","225","75","150","17","242","646","0","37.46","11.61"
"67","000","00","011","1103","0000","543","188","355","57","600","1473","0","40.73","12.76"
"67","000","00","011","1103","0439","543","188","355","57","600","1473","0","40.73","12.76"
"67","000","00","011","1104","0000","431","125","306","66","497","915","0","54.32","13.66"
"67","000","00","011","1104","0440","431","125","306","66","497","915","0","54.32","13.66"
"67","000","00","011","1105","0000","405","154","251","34","439","779","0","56.35","19.77"
"67","000","00","011","1105","0441","405","154","251","34","439","779","0","56.35","19.77"
"67","000","00","011","1106","0000","346","131","215","43","389","637","0","61.07","20.57"
"67","000","00","011","1106","0442","346","131","215","43","389","637","0","61.07","20.57"
"67","000","00","011","1107","0000","408","133","275","34","442","993","0","44.51","13.39"
"67","000","00","011","1107","0443","408","133","275","34","442","993","0","44.51","13.39"
"67","000","00","011","1108","0000","361","79","282","48","409","766","0","53.39","10.31"
"67","000","00","011","1108","0444","361","79","282","48","409","766","0","53.39","10.31"
"67","000","00","011","1109","0000","382","109","273","40","422","841","0","50.18","12.96"
"67","000","00","011","1109","0445","382","109","273","40","422","841","0","50.18","12.96"
"67","000","00","011","1110","0000","253","66","187","33","286","583","0","49.06","11.32"
"67","000","00","011","1110","0446","253","66","187","33","286","583","0","49.06","11.32"
"67","000","00","012","0000","0000","24806","8520","16286","1494","26300","50407","59087","52.18","16.9"
"67","000","00","012","1201","0000","1195","412","783","73","1268","2220","0","57.12","18.56"
"67","000","00","012","1201","0282","729","240","489","48","777","1391","0","55.86","17.25"
"67","000","00","012","1201","0283","466","172","294","25","491","829","0","59.23","20.75"
"67","000","00","012","1202","0000","1227","409","818","55","1282","2853","0","44.94","14.34"
"67","000","00","012","1202","0284","607","206","401","38","645","1401","0","46.04","14.7"
"67","000","00","012","1202","0285","620","203","417","17","637","1452","0","43.87","13.98"
"67","000","00","012","1203","0000","2790","1033","1757","188","2978","5611","0","53.07","18.41"
"67","000","00","012","1203","0286","683","226","457","65","748","1382","0","54.12","16.35"
"67","000","00","012","1203","0287","735","247","488","41","776","1463","0","53.04","16.88"
"67","000","00","012","1203","0288","608","285","323","32","640","1280","0","50.0","22.27"
"67","000","00","012","1203","0289","764","275","489","50","814","1486","0","54.78","18.51"
"67","000","00","012","1204","0000","2017","685","1332","114","2131","4204","0","50.69","16.29"
"67","000","00","012","1204","0297","692","235","457","30","722","1425","0","50.67","16.49"
"67","000","00","012","1204","0298","622","215","407","37","659","1255","0","52.51","17.13"
"67","000","00","012","1204","0299","703","235","468","47","750","1524","0","49.21","15.42"
"67","000","00","012","1205","0000","2885","914","1971","197","3082","5877","0","52.44","15.55"
"67","000","00","012","1205","0290","712","273","439","49","761","1378","0","55.22","19.81"
"67","000","00","012","1205","0291","683","148","535","40","723","1505","0","48.04","9.83"
"67","000","00","012","1205","0292","921","289","632","44","965","1860","0","51.88","15.54"
"67","000","00","012","1205","0293","569","204","365","64","633","1134","0","55.82","17.99"
"67","000","00","012","1206","0000","2067","686","1381","55","2122","4059","0","52.28","16.9"
"67","000","00","012","1206","0303","704","243","461","26","730","1381","0","52.86","17.6"
"67","000","00","012","1206","0304","672","224","448","16","688","1364","0","50.44","16.42"
"67","000","00","012","1206","0305","691","219","472","13","704","1314","0","53.58","16.67"
"67","000","00","012","1207","0000","1089","336","753","82","1171","2125","0","55.11","15.81"
"67","000","00","012","1207","0306","600","186","414","50","650","1164","0","55.84","15.98"
"67","000","00","012","1207","0307","489","150","339","32","521","961","0","54.21","15.61"
"67","000","00","012","1212","0000","996","306","690","71","1067","2209","0","48.3","13.85"
"67","000","00","012","1212","0312","679","199","480","42","721","1507","0","47.84","13.21"
"67","000","00","012","1212","0313","317","107","210","29","346","702","0","49.29","15.24"
"67","000","00","012","1219","0000","720","216","504","57","777","1513","0","51.35","14.28"
"67","000","00","012","1219","0319","720","216","504","57","777","1513","0","51.35","14.28"
"67","000","00","012","1220","0000","1033","415","618","83","1116","2410","0","46.31","17.22"
"67","000","00","012","1220","0320","285","109","176","20","305","714","0","42.72","15.27"
"67","000","00","012","1220","0321","327","135","192","41","368","745","0","49.4","18.12"
"67","000","00","012","1220","0322","421","171","250","22","443","951","0","46.58","17.98"
"67","000","00","012","1222","0000","499","178","321","35","534","1072","0","49.81","16.6"
"67","000","00","012","1222","0310","333","116","217","23","356","689","0","51.67","16.84"
"67","000","00","012","1222","0311","166","62","104","12","178","383","0","46.48","16.19"
"67","000","00","012","1223","0000","2626","922","1704","119","2745","5111","0","53.71","18.04"
"67","000","00","012","1223","0294","733","252","481","29","762","1426","0","53.44","17.67"
"67","000","00","012","1223","0295","894","327","567","48","942","1779","0","52.95","18.38"
"67","000","00","012","1223","0296","999","343","656","42","1041","1906","0","54.62","18.0"
"67","000","00","012","1224","0000","1076","450","626","50","1126","2137","0","52.69","21.06"
"67","000","00","012","1224","0308","590","186","404","38","628","1218","0","51.56","15.27"
"67","000","00","012","1224","0309","486","264","222","12","498","919","0","54.19","28.73"
"67","000","00","012","1225","0000","985","318","667","71","1056","1844","0","57.27","17.25"
"67","000","00","012","1225","0314","472","143","329","32","504","907","0","55.57","15.77"
"67","000","00","012","1225","0315","513","175","338","39","552","937","0","58.91","18.68"
"67","000","00","012","1226","0000","1289","432","857","148","1437","2798","0","51.36","15.44"
"67","000","00","012","1226","0316","465","168","297","86","551","1030","0","53.5","16.31"
"67","000","00","012","1226","0317","469","151","318","42","511","981","0","52.09","15.39"
"67","000","00","012","1226","0318","355","113","242","20","375","787","0","47.65","14.36"
"67","000","00","012","1227","0000","2312","808","1504","96","2408","4364","0","55.18","18.52"
"67","000","00","012","1227","0300","810","307","503","22","832","1631","0","51.01","18.82"
"67","000","00","012","1227","0301","823","271","552","42","865","1546","0","55.95","17.53"
"67","000","00","012","1227","0302","679","230","449","32","711","1187","0","59.9","19.38"
"67","000","00","013","0000","0000","10039","3357","6682","668","10707","22567","25725","47.45","14.88"
"67","000","00","013","1301","0000","1843","615","1228","138","1981","3852","0","51.43","15.97"
"67","000","00","013","1301","0216","656","219","437","36","692","1370","0","50.51","15.99"
"67","000","00","013","1301","0217","568","195","373","41","609","1117","0","54.52","17.46"
"67","000","00","013","1301","0218","619","201","418","61","680","1365","0","49.82","14.73"
"67","000","00","013","1302","0000","1045","383","662","41","1086","2235","0","48.59","17.14"
"67","000","00","013","1302","0221","504","195","309","22","526","1052","0","50.0","18.54"
"67","000","00","013","1302","0222","541","188","353","19","560","1183","0","47.34","15.89"
"67","000","00","013","1303","0000","448","130","318","21","469","1238","0","37.88","10.5"
"67","000","00","013","1303","0227","303","86","217","16","319","832","0","38.34","10.34"
"67","000","00","013","1303","0228","145","44","101","5","150","406","0","36.95","10.84"
"67","000","00","013","1304","0000","392","132","260","33","425","818","0","51.96","16.14"
"67","000","00","013","1304","0229","392","132","260","33","425","818","0","51.96","16.14"
"67","000","00","013","1305","0000","856","292","564","49","905","1900","0","47.63","15.37"
"67","000","00","013","1305","0213","309","108","201","23","332","635","0","52.28","17.01"
"67","000","00","013","1305","0214","367","126","241","14","381","822","0","46.35","15.33"
"67","000","00","013","1305","0215","180","58","122","12","192","443","0","43.34","13.09"
"67","000","00","013","1306","0000","1226","425","801","78","1304","2409","0","54.13","17.64"
"67","000","00","013","1306","0208","444","156","288","40","484","862","0","56.15","18.1"
"67","000","00","013","1306","0209","334","116","218","10","344","611","0","56.3","18.99"
"67","000","00","013","1306","0210","448","153","295","28","476","936","0","50.85","16.35"
"67","000","00","013","1307","0000","931","326","605","63","994","1935","0","51.37","16.85"
"67","000","00","013","1307","0211","483","168","315","31","514","1066","0","48.22","15.76"
"67","000","00","013","1307","0212","448","158","290","32","480","869","0","55.24","18.18"
"67","000","00","013","1308","0000","513","181","332","44","557","1241","0","44.88","14.59"
"67","000","00","013","1308","0224","513","181","332","44","557","1241","0","44.88","14.59"
"67","000","00","013","1309","0000","390","130","260","16","406","1052","0","38.59","12.36"
"67","000","00","013","1309","0230","390","130","260","16","406","1052","0","38.59","12.36"
"67","000","00","013","1310","0000","898","268","630","78","976","2116","0","46.12","12.67"
"67","000","00","013","1310","0219","666","197","469","47","713","1489","0","47.88","13.23"
"67","000","00","013","1310","0220","232","71","161","31","263","627","0","41.95","11.32"
"67","000","00","013","1311","0000","394","119","275","21","415","979","0","42.39","12.16"
"67","000","00","013","1311","0223","394","119","275","21","415","979","0","42.39","12.16"
"67","000","00","013","1312","0000","547","168","379","40","587","1369","0","42.88","12.27"
"67","000","00","013","1312","0231","228","73","155","14","242","578","0","41.87","12.63"
"67","000","00","013","1312","0232","159","52","107","19","178","430","0","41.4","12.09"
"67","000","00","013","1312","0233","160","43","117","7","167","361","0","46.26","11.91"
"67","000","00","013","1313","0000","556","188","368","46","602","1423","0","42.3","13.21"
"67","000","00","013","1313","0225","302","102","200","19","321","843","0","38.08","12.1"
"67","000","00","013","1313","0226","254","86","168","27","281","580","0","48.45","14.83"
"67","000","00","014","0000","0000","9584","3256","6328","568","10152","21564","24724","47.08","15.1"
"67","000","00","014","1401","0000","1493","515","978","62","1555","3148","0","49.4","16.36"
"67","000","00","014","1401","0323","452","155","297","13","465","933","0","49.84","16.61"
"67","000","00","014","1401","0324","447","158","289","25","472","901","0","52.39","17.54"
"67","000","00","014","1401","0325","594","202","392","24","618","1314","0","47.03","15.37"
"67","000","00","014","1402","0000","1002","387","615","60","1062","2401","0","44.23","16.12"
"67","000","00","014","1402","0329","705","278","427","43","748","1663","0","44.98","16.72"
"67","000","00","014","1402","0330","297","109","188","17","314","738","0","42.55","14.77"
"67","000","00","014","1403","0000","776","268","508","57","833","1593","0","52.29","16.82"
"67","000","00","014","1403","0331","610","199","411","38","648","1211","0","53.51","16.43"
"67","000","00","014","1403","0332","166","69","97","19","185","382","0","48.43","18.06"
"67","000","00","014","1404","0000","742","219","523","35","777","1624","0","47.84","13.49"
"67","000","00","014","1404","0333","354","104","250","20","374","786","0","47.58","13.23"
"67","000","00","014","1404","0334","388","115","273","15","403","838","0","48.09","13.72"
"67","000","00","014","1405","0000","566","229","337","45","611","1449","0","42.17","15.8"
"67","000","00","014","1405","0335","566","229","337","45","611","1449","0","42.17","15.8"
"67","000","00","014","1406","0000","601","188","413","25","626","1479","0","42.33","12.71"
"67","000","00","014","1406","0336","601","188","413","25","626","1479","0","42.33","12.71"
"67","000","00","014","1407","0000","377","111","266","47","424","763","0","55.57","14.55"
"67","000","00","014","1407","0337","377","111","266","47","424","763","0","55.57","14.55"
"67","000","00","014","1408","0000","565","177","388","16","581","1297","0","44.8","13.65"
"67","000","00","014","1408","0338","565","177","388","16","581","1297","0","44.8","13.65"
"67","000","00","014","1409","0000","611","210","401","32","643","1393","0","46.16","15.08"
"67","000","00","014","1409","0339","611","210","401","32","643","1393","0","46.16","15.08"
"67","000","00","014","1410","0000","565","199","366","34","599","1349","0","44.4","14.75"
"67","000","00","014","1410","0340","370","126","244","13","383","958","0","39.98","13.15"
"67","000","00","014","1410","0341","195","73","122","21","216","391","0","55.24","18.67"
"67","000","00","014","1411","0000","377","113","264","46","423","805","0","52.55","14.04"
"67","000","00","014","1411","0342","377","113","264","46","423","805","0","52.55","14.04"
"67","000","00","014","1412","0000","1909","640","1269","109","2018","4263","0","47.34","15.01"
"67","000","00","014","1412","0326","642","223","419","51","693","1349","0","51.37","16.53"
"67","000","00","014","1412","0327","527","180","347","36","563","1014","0","55.52","17.75"
"67","000","00","014","1412","0328","740","237","503","22","762","1900","0","40.11","12.47"
"67","000","00","015","0000","0000","8480","2723","5757","620","9100","19950","22810","45.61","13.65"
"67","000","00","015","1501","0000","498","169","329","27","525","1042","0","50.38","16.22"
"67","000","00","015","1501","0258","242","83","159","12","254","534","0","47.57","15.54"
"67","000","00","015","1501","0259","256","86","170","15","271","508","0","53.35","16.93"
"67","000","00","015","1502","0000","256","83","173","5","261","665","0","39.25","12.48"
"67","000","00","015","1502","0260","256","83","173","5","261","665","0","39.25","12.48"
"67","000","00","015","1504","0000","344","108","236","18","362","834","0","43.41","12.95"
"67","000","00","015","1504","0261","344","108","236","18","362","834","0","43.41","12.95"
"67","000","00","015","1505","0000","343","88","255","10","353","810","0","43.58","10.86"
"67","000","00","015","1505","0262","343","88","255","10","353","810","0","43.58","10.86"
"67","000","00","015","1506","0000","162","41","121","8","170","480","0","35.42","8.54"
"67","000","00","015","1506","0263","162","41","121","8","170","480","0","35.42","8.54"
"67","000","00","015","1507","0000","164","45","119","10","174","445","0","39.1","10.11"
"67","000","00","015","1507","0264","164","45","119","10","174","445","0","39.1","10.11"
"67","000","00","015","1508","0000","603","189","414","33","636","1618","0","39.31","11.68"
"67","000","00","015","1508","0266","324","104","220","15","339","838","0","40.45","12.41"
"67","000","00","015","1508","0267","279","85","194","18","297","780","0","38.08","10.9"
"67","000","00","015","1509","0000","182","67","115","13","195","350","0","55.71","19.14"
"67","000","00","015","1509","0268","182","67","115","13","195","350","0","55.71","19.14"
"67","000","00","015","1510","0000","473","166","307","49","522","907","0","57.55","18.3"
"67","000","00","015","1510","0269","473","166","307","49","522","907","0","57.55","18.3"
"67","000","00","015","1511","0000","325","86","239","19","344","780","0","44.1","11.03"
"67","000","00","015","1511","0270","325","86","239","19","344","780","0","44.1","11.03"
"67","000","00","015","1512","0000","1102","355","747","44","1146","2571","0","44.57","13.81"
"67","000","00","015","1512","0271","709","242","467","26","735","1658","0","44.33","14.6"
"67","000","00","015","1512","0272","393","113","280","18","411","913","0","45.02","12.38"
"67","000","00","015","1515","0000","800","277","523","61","861","1898","0","45.36","14.59"
"67","000","00","015","1515","0273","551","206","345","54","605","1202","0","50.33","17.14"
"67","000","00","015","1515","0274","249","71","178","7","256","696","0","36.78","10.2"
"67","000","00","015","1517","0000","180","48","132","14","194","680","0","28.53","7.06"
"67","000","00","015","1517","0265","180","48","132","14","194","680","0","28.53","7.06"
"67","000","00","015","1518","0000","652","216","436","60","712","1269","0","56.11","17.02"
"67","000","00","015","1518","0275","291","100","191","29","320","647","0","49.46","15.46"
"67","000","00","015","1518","0276","361","116","245","31","392","622","0","63.02","18.65"
"67","000","00","015","1519","0000","890","292","598","94","984","1873","0","52.54","15.59"
"67","000","00","015","1519","0277","602","179","423","71","673","1175","0","57.28","15.23"
"67","000","00","015","1519","0278","288","113","175","23","311","698","0","44.56","16.19"
"67","000","00","015","1521","0000","463","146","317","49","512","983","0","52.09","14.85"
"67","000","00","015","1521","0279","463","146","317","49","512","983","0","52.09","14.85"
"67","000","00","015","1522","0000","500","165","335","41","541","1366","0","39.6","12.08"
"67","000","00","015","1522","0280","500","165","335","41","541","1366","0","39.6","12.08"
"67","000","00","015","1523","0000","543","182","361","65","608","1379","0","44.09","13.2"
"67","000","00","015","1523","0281","543","182","361","65","608","1379","0","44.09","13.2"
"67","000","00","016","0000","0000","7207","2093","5114","609","7816","17754","19691","44.02","11.79"
"67","000","00","016","1601","0000","587","200","387","51","638","1110","0","57.48","18.02"
"67","000","00","016","1601","0234","587","200","387","51","638","1110","0","57.48","18.02"
"67","000","00","016","1613","0000","329","108","221","16","345","849","0","40.64","12.72"
"67","000","00","016","1613","0250","329","108","221","16","345","849","0","40.64","12.72"
"67","000","00","016","1614","0000","237","65","172","22","259","645","0","40.16","10.08"
"67","000","00","016","1614","0251","237","65","172","22","259","645","0","40.16","10.08"
"67","000","00","016","1615","0000","447","107","340","35","482","1353","0","35.62","7.91"
"67","000","00","016","1615","0252","254","63","191","27","281","690","0","40.72","9.13"
"67","000","00","016","1615","0253","193","44","149","8","201","663","0","30.32","6.64"
"67","000","00","016","1616","0000","495","136","359","25","520","1175","0","44.26","11.57"
"67","000","00","016","1616","0254","495","136","359","25","520","1175","0","44.26","11.57"
"67","000","00","016","1617","0000","742","227","515","119","861","1898","0","45.36","11.96"
"67","000","00","016","1617","0255","277","83","194","29","306","837","0","36.56","9.92"
"67","000","00","016","1617","0256","465","144","321","90","555","1061","0","52.31","13.57"
"67","000","00","016","1618","0000","334","102","232","13","347","976","0","35.55","10.45"
"67","000","00","016","1618","0257","334","102","232","13","347","976","0","35.55","10.45"
"67","000","00","016","1619","0000","426","128","298","19","445","1223","0","36.39","10.47"
"67","000","00","016","1619","0245","233","70","163","8","241","650","0","37.08","10.77"
"67","000","00","016","1619","0246","193","58","135","11","204","573","0","35.6","10.12"
"67","000","00","016","1620","0000","996","237","759","48","1044","2387","0","43.74","9.93"
"67","000","00","016","1620","0235","551","101","450","23","574","1418","0","40.48","7.12"
"67","000","00","016","1620","0236","445","136","309","25","470","969","0","48.5","14.04"
"67","000","00","016","1621","0000","1159","391","768","84","1243","2482","0","50.08","15.75"
"67","000","00","016","1621","0237","266","86","180","37","303","519","0","58.38","16.57"
"67","000","00","016","1621","0238","528","180","348","13","541","1106","0","48.92","16.27"
"67","000","00","016","1621","0239","243","94","149","27","270","542","0","49.82","17.34"
"67","000","00","016","1621","0240","122","31","91","7","129","315","0","40.95","9.84"
"67","000","00","016","1622","0000","773","217","556","131","904","2032","0","44.49","10.68"
"67","000","00","016","1622","0241","219","69","150","23","242","584","0","41.44","11.82"
"67","000","00","016","1622","0242","177","60","117","6","183","398","0","45.98","15.08"
"67","000","00","016","1622","0243","166","15","151","87","253","608","0","41.61","2.47"
"67","000","00","016","1622","0244","211","73","138","15","226","442","0","51.13","16.52"
"67","000","00","016","1623","0000","682","175","507","46","728","1624","0","44.83","10.78"
"67","000","00","016","1623","0247","231","68","163","4","235","617","0","38.09","11.02"
"67","000","00","016","1623","0248","251","62","189","22","273","573","0","47.64","10.82"
"67","000","00","016","1623","0249","200","45","155","20","220","434","0","50.69","10.37"
"67","000","00","017","0000","0000","3816","1139","2677","260","4076","9925","11099","41.07","11.48"
"67","000","00","017","1701","0000","558","143","415","17","575","1341","0","42.88","10.66"
"67","000","00","017","1701","0196","302","76","226","7","309","742","0","41.64","10.24"
"67","000","00","017","1701","0197","256","67","189","10","266","599","0","44.41","11.19"
"67","000","00","017","1702","0000","168","57","111","9","177","473","0","37.42","12.05"
"67","000","00","017","1702","0201","168","57","111","9","177","473","0","37.42","12.05"
"67","000","00","017","1705","0000","360","115","245","22","382","838","0","45.58","13.72"
"67","000","00","017","1705","0192","171","41","130","5","176","456","0","38.6","8.99"
"67","000","00","017","1705","0193","189","74","115","17","206","382","0","53.93","19.37"
"67","000","00","017","1706","0000","308","86","222","17","325","954","0","34.07","9.01"
"67","000","00","017","1706","0202","308","86","222","17","325","954","0","34.07","9.01"
"67","000","00","017","1707","0000","394","110","284","41","435","1200","0","36.25","9.17"
"67","000","00","017","1707","0204","225","59","166","12","237","679","0","34.9","8.69"
"67","000","00","017","1707","0205","169","51","118","29","198","521","0","38.0","9.79"
"67","000","00","017","1709","0000","299","94","205","25","324","745","0","43.49","12.62"
"67","000","00","017","1709","0194","160","46","114","21","181","356","0","50.84","12.92"
"67","000","00","017","1709","0195","139","48","91","4","143","389","0","36.76","12.34"
"67","000","00","017","1711","0000","367","93","274","30","397","737","0","53.87","12.62"
"67","000","00","017","1711","0203","367","93","274","30","397","737","0","53.87","12.62"
"67","000","00","017","1713","0000","366","127","239","25","391","885","0","44.18","14.35"
"67","000","00","017","1713","0190","211","82","129","14","225","484","0","46.49","16.94"
"67","000","00","017","1713","0191","155","45","110","11","166","401","0","41.4","11.22"
"67","000","00","017","1714","0000","558","175","383","45","603","1484","0","40.63","11.79"
"67","000","00","017","1714","0198","224","70","154","26","250","594","0","42.09","11.78"
"67","000","00","017","1714","0199","230","69","161","15","245","572","0","42.83","12.06"
"67","000","00","017","1714","0200","104","36","68","4","108","318","0","33.96","11.32"
"67","000","00","017","1715","0000","438","139","299","29","467","1268","0","36.83","10.96"
"67","000","00","017","1715","0206","208","64","144","18","226","632","0","35.76","10.13"
"67","000","00","017","1715","0207","230","75","155","11","241","636","0","37.89","11.79"
"67","000","00","018","0000","0000","18593","6530","12063","1427","20020","37296","43516","53.68","17.51"
"67","000","00","018","1801","0000","1765","692","1073","122","1887","3165","0","59.62","21.86"
"67","000","00","018","1801","0581","426","121","305","25","451","746","0","60.46","16.22"
"67","000","00","018","1801","0582","620","219","401","33","653","1102","0","59.26","19.87"
"67","000","00","018","1801","0583","205","58","147","11","216","370","0","58.38","15.68"
"67","000","00","018","1801","0584","514","294","220","53","567","947","0","59.87","31.05"
"67","000","00","018","1802","0000","1976","679","1297","183","2159","3951","0","54.64","17.19"
"67","000","00","018","1802","0585","545","172","373","58","603","1154","0","52.25","14.9"
"67","000","00","018","1802","0586","549","214","335","58","607","1082","0","56.1","19.78"
"67","000","00","018","1802","0587","567","202","365","44","611","1075","0","56.84","18.79"
"67","000","00","018","1802","0588","315","91","224","23","338","640","0","52.81","14.22"
"67","000","00","018","1803","0000","1298","444","854","81","1379","2757","0","50.02","16.1"
"67","000","00","018","1803","0589","200","72","128","15","215","410","0","52.44","17.56"
"67","000","00","018","1803","0590","253","75","178","24","277","533","0","51.97","14.07"
"67","000","00","018","1803","0591","446","171","275","21","467","836","0","55.86","20.45"
"67","000","00","018","1803","0592","399","126","273","21","420","978","0","42.94","12.88"
"67","000","00","018","1804","0000","2158","783","1375","149","2307","4380","0","52.67","17.88"
"67","000","00","018","1804","0593","702","270","432","31","733","1348","0","54.38","20.03"
"67","000","00","018","1804","0594","499","167","332","39","538","1015","0","53.0","16.45"
"67","000","00","018","1804","0595","548","189","359","33","581","1228","0","47.31","15.39"
"67","000","00","018","1804","0596","409","157","252","46","455","789","0","57.67","19.9"
"67","000","00","018","1809","0000","1679","586","1093","86","1765","3272","0","53.94","17.91"
"67","000","00","018","1809","0597","510","173","337","23","533","1022","0","52.15","16.93"
"67","000","00","018","1809","0598","506","163","343","16","522","1021","0","51.13","15.96"
"67","000","00","018","1809","0599","663","250","413","47","710","1229","0","57.77","20.34"
"67","000","00","018","1810","0000","996","363","633","44","1040","2165","0","48.04","16.77"
"67","000","00","018","1810","0600","577","207","370","24","601","1153","0","52.12","17.95"
"67","000","00","018","1810","0601","419","156","263","20","439","1012","0","43.38","15.42"
"67","000","00","018","1811","0000","748","272","476","53","801","1458","0","54.94","18.66"
"67","000","00","018","1811","0602","748","272","476","53","801","1458","0","54.94","18.66"
"67","000","00","018","1812","0000","1674","571","1103","118","1792","3220","0","55.65","17.73"
"67","000","00","018","1812","0603","860","283","577","57","917","1645","0","55.74","17.2"
"67","000","00","018","1812","0604","542","188","354","47","589","1016","0","57.97","18.5"
"67","000","00","018","1812","0605","272","100","172","14","286","559","0","51.16","17.89"
"67","000","00","018","1813","0000","1530","573","957","68","1598","2784","0","57.4","20.58"
"67","000","00","018","1813","0606","655","237","418","26","681","1222","0","55.73","19.39"
"67","000","00","018","1813","0607","875","336","539","42","917","1562","0","58.71","21.51"
"67","000","00","018","1814","0000","941","314","627","96","1037","2007","0","51.67","15.65"
"67","000","00","018","1814","0608","444","154","290","30","474","994","0","47.69","15.49"
"67","000","00","018","1814","0609","497","160","337","66","563","1013","0","55.58","15.79"
"67","000","00","018","1815","0000","1084","353","731","101","1185","2218","0","53.43","15.92"
"67","000","00","018","1815","0610","614","209","405","58","672","1197","0","56.14","17.46"
"67","000","00","018","1815","0611","470","144","326","43","513","1021","0","50.24","14.1"
"67","000","00","018","1816","0000","586","197","389","60","646","1428","0","45.24","13.8"
"67","000","00","018","1816","0612","586","197","389","60","646","1428","0","45.24","13.8"
"67","000","00","018","1817","0000","189","74","115","27","216","456","0","47.37","16.23"
"67","000","00","018","1817","0613","189","74","115","27","216","456","0","47.37","16.23"
"67","000","00","018","1818","0000","1092","340","752","104","1196","2134","0","56.04","15.93"
"67","000","00","018","1818","0614","532","164","368","50","582","1037","0","56.12","15.81"
"67","000","00","018","1818","0615","560","176","384","54","614","1097","0","55.97","16.04"
"67","000","00","018","1819","0000","455","152","303","47","502","902","0","55.65","16.85"
"67","000","00","018","1819","0616","455","152","303","47","502","902","0","55.65","16.85"
"67","000","00","018","1820","0000","422","137","285","88","510","999","0","51.05","13.71"
"67","000","00","018","1820","0617","422","137","285","88","510","999","0","51.05","13.71"
"67","000","00","019","0000","0000","19179","7092","12087","1284","20463","39950","48870","51.22","17.75"
"67","000","00","019","1901","0000","506","170","336","15","521","1132","0","46.02","15.02"
"67","000","00","019","1901","0492","506","170","336","15","521","1132","0","46.02","15.02"
"67","000","00","019","1902","0000","1840","686","1154","122","1962","3935","0","49.86","17.43"
"67","000","00","019","1902","0493","855","312","543","57","912","1845","0","49.43","16.91"
"67","000","00","019","1902","0494","985","374","611","65","1050","2090","0","50.24","17.89"
"67","000","00","019","1903","0000","2728","1035","1693","153","2881","5301","0","54.35","19.52"
"67","000","00","019","1903","0495","818","303","515","57","875","1582","0","55.31","19.15"
"67","000","00","019","1903","0496","998","394","604","56","1054","1901","0","55.44","20.73"
"67","000","00","019","1903","0497","912","338","574","40","952","1818","0","52.37","18.59"
"67","000","00","019","1904","0000","1372","498","874","83","1455","2700","0","53.89","18.44"
"67","000","00","019","1904","0498","807","283","524","51","858","1639","0","52.35","17.27"
"67","000","00","019","1904","0499","565","215","350","32","597","1061","0","56.27","20.26"
"67","000","00","019","1905","0000","934","312","622","62","996","1786","0","55.77","17.47"
"67","000","00","019","1905","0500","934","312","622","62","996","1786","0","55.77","17.47"
"67","000","00","019","1908","0000","730","276","454","56","786","1581","0","49.72","17.46"
"67","000","00","019","1908","0502","730","276","454","56","786","1581","0","49.72","17.46"
"67","000","00","019","1909","0000","568","234","334","88","656","1240","0","52.9","18.87"
"67","000","00","019","1909","0503","568","234","334","88","656","1240","0","52.9","18.87"
"67","000","00","019","1910","0000","714","254","460","30","744","1743","0","42.69","14.57"
"67","000","00","019","1910","0504","714","254","460","30","744","1743","0","42.69","14.57"
"67","000","00","019","1911","0000","652","263","389","47","699","1246","0","56.1","21.11"
"67","000","00","019","1911","0505","652","263","389","47","699","1246","0","56.1","21.11"
"67","000","00","019","1912","0000","873","297","576","41","914","1899","0","48.13","15.64"
"67","000","00","019","1912","0506","448","164","284","28","476","961","0","49.53","17.07"
"67","000","00","019","1912","0507","425","133","292","13","438","938","0","46.7","14.18"
"67","000","00","019","1913","0000","356","131","225","13","369","722","0","51.11","18.14"
"67","000","00","019","1913","0508","356","131","225","13","369","722","0","51.11","18.14"
"67","000","00","019","1914","0000","465","155","310","27","492","1062","0","46.33","14.6"
"67","000","00","019","1914","0509","465","155","310","27","492","1062","0","46.33","14.6"
"67","000","00","019","1915","0000","797","280","517","79","876","1715","0","51.08","16.33"
"67","000","00","019","1915","0510","797","280","517","79","876","1715","0","51.08","16.33"
"67","000","00","019","1918","0000","754","297","457","67","821","1574","0","52.16","18.87"
"67","000","00","019","1918","0513","754","297","457","67","821","1574","0","52.16","18.87"
"67","000","00","019","1919","0000","625","221","404","70","695","1535","0","45.28","14.4"
"67","000","00","019","1919","0514","625","221","404","70","695","1535","0","45.28","14.4"
"67","000","00","019","1920","0000","523","204","319","60","583","1106","0","52.71","18.44"
"67","000","00","019","1920","0515","523","204","319","60","583","1106","0","52.71","18.44"
"67","000","00","019","1921","0000","2062","751","1311","132","2194","4240","0","51.75","17.71"
"67","000","00","019","1921","0516","652","223","429","35","687","1402","0","49.0","15.91"
"67","000","00","019","1921","0517","804","268","536","63","867","1458","0","59.47","18.38"
"67","000","00","019","1921","0518","606","260","346","34","640","1380","0","46.38","18.84"
"67","000","00","019","1922","0000","577","175","402","34","611","1147","0","53.27","15.26"
"67","000","00","019","1922","0501","577","175","402","34","611","1147","0","53.27","15.26"
"67","000","00","019","1923","0000","896","309","587","86","982","1985","0","49.47","15.57"
"67","000","00","019","1923","0511","493","172","321","55","548","1120","0","48.93","15.36"
"67","000","00","019","1923","0512","403","137","266","31","434","865","0","50.17","15.84"
"67","000","00","019","1924","0000","1207","544","663","19","1226","2301","0","53.28","23.64"
"67","000","00","019","1924","0519","636","282","354","7","643","1232","0","52.19","22.89"
"67","000","00","019","1924","0520","571","262","309","12","583","1069","0","54.54","24.51"
"67","000","00","020","0000","0000","15355","5374","9981","957","16312","30386","36824","53.68","17.69"
"67","000","00","020","2001","0000","1457","510","947","82","1539","2928","0","52.56","17.42"
"67","000","00","020","2001","0545","441","155","286","29","470","960","0","48.96","16.15"
"67","000","00","020","2001","0546","617","216","401","36","653","1118","0","58.41","19.32"
"67","000","00","020","2001","0547","399","139","260","17","416","850","0","48.94","16.35"
"67","000","00","020","2002","0000","3102","1070","2032","215","3317","6063","0","54.71","17.65"
"67","000","00","020","2002","0548","611","217","394","48","659","1241","0","53.1","17.49"
"67","000","00","020","2002","0549","672","234","438","33","705","1297","0","54.36","18.04"
"67","000","00","020","2002","0550","499","162","337","43","542","962","0","56.34","16.84"
"67","000","00","020","2002","0551","659","220","439","40","699","1237","0","56.51","17.78"
"67","000","00","020","2002","0552","661","237","424","51","712","1326","0","53.7","17.87"
"67","000","00","020","2003","0000","1269","474","795","90","1359","2516","0","54.01","18.84"
"67","000","00","020","2003","0553","639","237","402","58","697","1211","0","57.56","19.57"
"67","000","00","020","2003","0554","630","237","393","32","662","1305","0","50.73","18.16"
"67","000","00","020","2004","0000","344","108","236","33","377","688","0","54.8","15.7"
"67","000","00","020","2004","0555","344","108","236","33","377","688","0","54.8","15.7"
"67","000","00","020","2005","0000","488","178","310","28","516","911","0","56.64","19.54"
"67","000","00","020","2005","0556","488","178","310","28","516","911","0","56.64","19.54"
"67","000","00","020","2006","0000","707","256","451","30","737","1525","0","48.33","16.79"
"67","000","00","020","2006","0557","707","256","451","30","737","1525","0","48.33","16.79"
"67","000","00","020","2007","0000","1505","525","980","47","1552","3262","0","47.58","16.09"
"67","000","00","020","2007","0558","448","169","279","7","455","1091","0","41.7","15.49"
"67","000","00","020","2007","0559","552","182","370","15","567","1122","0","50.53","16.22"
"67","000","00","020","2007","0560","505","174","331","25","530","1049","0","50.52","16.59"
"67","000","00","020","2008","0000","2146","744","1402","98","2244","4457","0","50.35","16.69"
"67","000","00","020","2008","0561","699","264","435","17","716","1564","0","45.78","16.88"
"67","000","00","020","2008","0562","768","254","514","44","812","1515","0","53.6","16.77"
"67","000","00","020","2008","0563","679","226","453","37","716","1378","0","51.96","16.4"
"67","000","00","020","2009","0000","1000","374","626","128","1128","1787","0","63.12","20.93"
"67","000","00","020","2009","0564","474","179","295","41","515","827","0","62.27","21.64"
"67","000","00","020","2009","0565","526","195","331","87","613","960","0","63.85","20.31"
"67","000","00","020","2010","0000","1700","579","1121","113","1813","3388","0","53.51","17.09"
"67","000","00","020","2010","0566","460","141","319","40","500","951","0","52.58","14.83"
"67","000","00","020","2010","0567","651","218","433","43","694","1264","0","54.91","17.25"
"67","000","00","020","2010","0568","589","220","369","30","619","1173","0","52.77","18.76"
"67","000","00","020","2011","0000","1637","556","1081","93","1730","2861","0","60.47","19.43"
"67","000","00","020","2011","0569","373","125","248","18","391","684","0","57.16","18.27"
"67","000","00","020","2011","0570","602","190","412","46","648","1055","0","61.42","18.01"
"67","000","00","020","2011","0571","662","241","421","29","691","1122","0","61.59","21.48"
"67","000","00","021","0000","0000","12726","4337","8389","919","13645","26104","30522","52.27","16.61"
"67","000","00","021","2101","0000","1171","390","781","94","1265","2150","0","58.84","18.14"
"67","000","00","021","2101","0521","709","236","473","61","770","1251","0","61.55","18.86"
"67","000","00","021","2101","0522","462","154","308","33","495","899","0","55.06","17.13"
"67","000","00","021","2102","0000","1034","322","712","102","1136","2054","0","55.31","15.68"
"67","000","00","021","2102","0523","547","189","358","61","608","1106","0","54.97","17.09"
"67","000","00","021","2102","0524","487","133","354","41","528","948","0","55.7","14.03"
"67","000","00","021","2103","0000","667","252","415","31","698","1442","0","48.4","17.48"
"67","000","00","021","2103","0525","667","252","415","31","698","1442","0","48.4","17.48"
"67","000","00","021","2104","0000","1062","340","722","91","1153","2186","0","52.74","15.55"
"67","000","00","021","2104","0526","641","225","416","54","695","1385","0","50.18","16.25"
"67","000","00","021","2104","0527","421","115","306","37","458","801","0","57.18","14.36"
"67","000","00","021","2106","0000","685","239","446","61","746","1517","0","49.18","15.75"
"67","000","00","021","2106","0528","319","112","207","24","343","736","0","46.6","15.22"
"67","000","00","021","2106","0529","366","127","239","37","403","781","0","51.6","16.26"
"67","000","00","021","2107","0000","890","285","605","54","944","1657","0","56.97","17.2"
"67","000","00","021","2107","0530","419","141","278","16","435","795","0","54.72","17.74"
"67","000","00","021","2107","0531","471","144","327","38","509","862","0","59.05","16.71"
"67","000","00","021","2108","0000","1363","415","948","56","1419","2872","0","49.41","14.45"
"67","000","00","021","2108","0532","686","202","484","29","715","1487","0","48.08","13.58"
"67","000","00","021","2108","0533","677","213","464","27","704","1385","0","50.83","15.38"
"67","000","00","021","2109","0000","901","449","452","69","970","2612","0","37.14","17.19"
"67","000","00","021","2109","0534","301","250","51","28","329","1518","0","21.67","16.47"
"67","000","00","021","2109","0535","600","199","401","41","641","1094","0","58.59","18.19"
"67","000","00","021","2112","0000","376","124","252","35","411","716","0","57.4","17.32"
"67","000","00","021","2112","0538","376","124","252","35","411","716","0","57.4","17.32"
"67","000","00","021","2113","0000","1265","446","819","69","1334","2435","0","54.78","18.32"
"67","000","00","021","2113","0539","773","267","506","43","816","1492","0","54.69","17.9"
"67","000","00","021","2113","0540","492","179","313","26","518","943","0","54.93","18.98"
"67","000","00","021","2114","0000","1312","428","884","92","1404","2541","0","55.25","16.84"
"67","000","00","021","2114","0541","606","187","419","29","635","1157","0","54.88","16.16"
"67","000","00","021","2114","0542","706","241","465","63","769","1384","0","55.56","17.41"
"67","000","00","021","2117","0000","799","289","510","57","856","1578","0","54.25","18.31"
"67","000","00","021","2117","0543","486","176","310","40","526","967","0","54.4","18.2"
"67","000","00","021","2117","0544","313","113","200","17","330","611","0","54.01","18.49"
"67","000","00","021","2118","0000","1201","358","843","108","1309","2344","0","55.84","15.27"
"67","000","00","021","2118","0536","796","243","553","86","882","1590","0","55.47","15.28"
"67","000","00","021","2118","0537","405","115","290","22","427","754","0","56.63","15.25"
"67","000","00","022","0000","0000","2641","928","1713","228","2869","6511","7328","44.06","14.25"
"67","000","00","022","2201","0000","603","200","403","88","691","1691","0","40.86","11.83"
"67","000","00","022","2201","0572","306","103","203","56","362","855","0","42.34","12.05"
"67","000","00","022","2201","0573","297","97","200","32","329","836","0","39.35","11.6"
"67","000","00","022","2202","0000","676","241","435","71","747","1541","0","48.48","15.64"
"67","000","00","022","2202","0574","337","128","209","39","376","753","0","49.93","17.0"
"67","000","00","022","2202","0575","339","113","226","32","371","788","0","47.08","14.34"
"67","000","00","022","2203","0000","461","158","303","33","494","984","0","50.2","16.06"
"67","000","00","022","2203","0576","461","158","303","33","494","984","0","50.2","16.06"
"67","000","00","022","2204","0000","413","166","247","10","423","972","0","43.52","17.08"
"67","000","00","022","2204","0577","413","166","247","10","423","972","0","43.52","17.08"
"67","000","00","022","2205","0000","166","46","120","3","169","553","0","30.56","8.32"
"67","000","00","022","2205","0578","166","46","120","3","169","553","0","30.56","8.32"
"67","000","00","022","2206","0000","151","58","93","6","157","378","0","41.53","15.34"
"67","000","00","022","2206","0579","151","58","93","6","157","378","0","41.53","15.34"
"67","000","00","022","2207","0000","171","59","112","17","188","392","0","47.96","15.05"
"67","000","00","022","2207","0580","171","59","112","17","188","392","0","47.96","15.05"
"67","000","00","023","0000","0000","5543","1665","3878","462","6005","12357","14021","48.6","13.47"
"67","000","00","023","2301","0000","577","177","400","28","605","1242","0","48.71","14.25"
"67","000","00","023","2301","0466","577","177","400","28","605","1242","0","48.71","14.25"
"67","000","00","023","2302","0000","1734","505","1229","145","1879","3637","0","51.66","13.89"
"67","000","00","023","2302","0467","562","142","420","36","598","1141","0","52.41","12.45"
"67","000","00","023","2302","0468","319","98","221","25","344","698","0","49.28","14.04"
"67","000","00","023","2302","0469","399","140","259","27","426","849","0","50.18","16.49"
"67","000","00","023","2302","0470","454","125","329","57","511","949","0","53.85","13.17"
"67","000","00","023","2303","0000","533","167","366","29","562","1212","0","46.37","13.78"
"67","000","00","023","2303","0471","294","95","199","21","315","618","0","50.97","15.37"
"67","000","00","023","2303","0472","239","72","167","8","247","594","0","41.58","12.12"
"67","000","00","023","2304","0000","613","195","418","52","665","1439","0","46.21","13.55"
"67","000","00","023","2304","0473","374","123","251","16","390","927","0","42.07","13.27"
"67","000","00","023","2304","0474","239","72","167","36","275","512","0","53.71","14.06"
"67","000","00","023","2305","0000","218","69","149","24","242","509","0","47.54","13.56"
"67","000","00","023","2305","0475","218","69","149","24","242","509","0","47.54","13.56"
"67","000","00","023","2306","0000","243","70","173","24","267","496","0","53.83","14.11"
"67","000","00","023","2306","0476","243","70","173","24","267","496","0","53.83","14.11"
"67","000","00","023","2307","0000","339","101","238","13","352","759","0","46.38","13.31"
"67","000","00","023","2307","0477","339","101","238","13","352","759","0","46.38","13.31"
"67","000","00","023","2308","0000","578","152","426","61","639","1456","0","43.89","10.44"
"67","000","00","023","2308","0478","252","68","184","8","260","669","0","38.86","10.16"
"67","000","00","023","2308","0479","326","84","242","53","379","787","0","48.16","10.67"
"67","000","00","023","2309","0000","254","80","174","38","292","620","0","47.1","12.9"
"67","000","00","023","2309","0480","254","80","174","38","292","620","0","47.1","12.9"
"67","000","00","023","2310","0000","454","149","305","48","502","987","0","50.86","15.1"
"67","000","00","023","2310","0481","454","149","305","48","502","987","0","50.86","15.1"
"67","000","00","024","0000","0000","3539","995","2544","319","3858","8528","9572","45.24","11.67"
"67","000","00","024","2401","0000","853","231","622","99","952","1848","0","51.52","12.5"
"67","000","00","024","2401","0447","420","97","323","56","476","978","0","48.67","9.92"
"67","000","00","024","2401","0448","433","134","299","43","476","870","0","54.71","15.4"
"67","000","00","024","2402","0000","384","88","296","14","398","1160","0","34.31","7.59"
"67","000","00","024","2402","0449","384","88","296","14","398","1160","0","34.31","7.59"
"67","000","00","024","2403","0000","288","72","216","15","303","699","0","43.35","10.3"
"67","000","00","024","2403","0450","288","72","216","15","303","699","0","43.35","10.3"
"67","000","00","024","2404","0000","374","102","272","14","388","990","0","39.19","10.3"
"67","000","00","024","2404","0451","374","102","272","14","388","990","0","39.19","10.3"
"67","000","00","024","2405","0000","387","140","247","28","415","928","0","44.72","15.09"
"67","000","00","024","2405","0452","387","140","247","28","415","928","0","44.72","15.09"
"67","000","00","024","2406","0000","280","71","209","39","319","660","0","48.33","10.76"
"67","000","00","024","2406","0453","280","71","209","39","319","660","0","48.33","10.76"
"67","000","00","024","2407","0000","973","291","682","110","1083","2243","0","48.28","12.97"
"67","000","00","024","2407","0454","513","155","358","74","587","1187","0","49.45","13.06"
"67","000","00","024","2407","0455","460","136","324","36","496","1056","0","46.97","12.88"
"67","000","00","025","0000","0000","3385","1054","2331","323","3708","7786","8741","47.62","13.54"
"67","000","00","025","2501","0000","680","243","437","82","762","1385","0","55.02","17.55"
"67","000","00","025","2501","0456","338","120","218","37","375","690","0","54.35","17.39"
"67","000","00","025","2501","0457","342","123","219","45","387","695","0","55.68","17.7"
"67","000","00","025","2502","0000","321","93","228","37","358","806","0","44.42","11.54"
"67","000","00","025","2502","0458","321","93","228","37","358","806","0","44.42","11.54"
"67","000","00","025","2503","0000","192","56","136","13","205","425","0","48.24","13.18"
"67","000","00","025","2503","0461","192","56","136","13","205","425","0","48.24","13.18"
"67","000","00","025","2504","0000","246","76","170","30","276","559","0","49.37","13.6"
"67","000","00","025","2504","0462","246","76","170","30","276","559","0","49.37","13.6"
"67","000","00","025","2505","0000","233","65","168","39","272","654","0","41.59","9.94"
"67","000","00","025","2505","0459","233","65","168","39","272","654","0","41.59","9.94"
"67","000","00","025","2506","0000","251","97","154","33","284","783","0","36.27","12.39"
"67","000","00","025","2506","0460","251","97","154","33","284","783","0","36.27","12.39"
"67","000","00","025","2507","0000","491","156","335","33","524","1189","0","44.07","13.12"
"67","000","00","025","2507","0463","491","156","335","33","524","1189","0","44.07","13.12"
"67","000","00","025","2508","0000","506","143","363","34","540","1044","0","51.72","13.7"
"67","000","00","025","2508","0464","506","143","363","34","540","1044","0","51.72","13.7"
"67","000","00","025","2509","0000","465","125","340","22","487","941","0","51.75","13.28"
"67","000","00","025","2509","0465","465","125","340","22","487","941","0","51.75","13.28"
"67","000","00","026","0000","0000","1746","501","1245","232","1978","4418","4801","44.77","11.34"
"67","000","00","026","2601","0000","165","51","114","24","189","392","0","48.21","13.01"
"67","000","00","026","2601","0482","165","51","114","24","189","392","0","48.21","13.01"
"67","000","00","026","2602","0000","299","92","207","39","338","644","0","52.48","14.29"
"67","000","00","026","2602","0483","299","92","207","39","338","644","0","52.48","14.29"
"67","000","00","026","2603","0000","172","51","121","16","188","468","0","40.17","10.9"
"67","000","00","026","2603","0484","172","51","121","16","188","468","0","40.17","10.9"
"67","000","00","026","2604","0000","288","72","216","39","327","753","0","43.43","9.56"
"67","000","00","026","2604","0485","288","72","216","39","327","753","0","43.43","9.56"
"67","000","00","026","2605","0000","137","39","98","24","161","345","0","46.67","11.3"
"67","000","00","026","2605","0486","137","39","98","24","161","345","0","46.67","11.3"
"67","000","00","026","2606","0000","153","47","106","16","169","393","0","43.0","11.96"
"67","000","00","026","2606","0487","153","47","106","16","169","393","0","43.0","11.96"
"67","000","00","026","2607","0000","185","56","129","41","226","504","0","44.84","11.11"
"67","000","00","026","2607","0491","185","56","129","41","226","504","0","44.84","11.11"
"67","000","00","026","2608","0000","178","46","132","17","195","420","0","46.43","10.95"
"67","000","00","026","2608","0488","178","46","132","17","195","420","0","46.43","10.95"
"67","000","00","026","2609","0000","106","28","78","12","118","313","0","37.7","8.95"
"67","000","00","026","2609","0489","106","28","78","12","118","313","0","37.7","8.95"
"67","000","00","026","2610","0000","63","19","44","4","67","186","0","36.02","10.22"
"67","000","00","026","2610","0490","63","19","44","4","67","186","0","36.02","10.22"
"67","000","00","027","0000","0000","32379","10819","21560","2074","34453","64632","75797","53.31","16.74"
"67","000","00","027","2701","0000","2751","967","1784","233","2984","5381","0","55.45","17.97"
"67","000","00","027","2701","1188","670","241","429","61","731","1318","0","55.46","18.29"
"67","000","00","027","2701","1189","717","247","470","51","768","1406","0","54.62","17.57"
"67","000","00","027","2701","1190","709","235","474","56","765","1465","0","52.22","16.04"
"67","000","00","027","2701","1191","655","244","411","65","720","1192","0","60.4","20.47"
"67","000","00","027","2702","0000","1396","491","905","151","1547","2749","0","56.28","17.86"
"67","000","00","027","2702","1192","764","268","496","59","823","1429","0","57.59","18.75"
"67","000","00","027","2702","1193","632","223","409","92","724","1320","0","54.85","16.89"
"67","000","00","027","2703","0000","1479","476","1003","122","1601","2703","0","59.23","17.61"
"67","000","00","027","2703","1194","756","244","512","77","833","1373","0","60.67","17.77"
"67","000","00","027","2703","1195","723","232","491","45","768","1330","0","57.74","17.44"
"67","000","00","027","2704","0000","3636","1199","2437","171","3807","7201","0","52.87","16.65"
"67","000","00","027","2704","1196","915","307","608","33","948","1687","0","56.19","18.2"
"67","000","00","027","2704","1197","701","264","437","54","755","1491","0","50.64","17.71"
"67","000","00","027","2704","1198","518","169","349","28","546","1151","0","47.44","14.68"
"67","000","00","027","2704","1199","710","211","499","17","727","1407","0","51.67","15.0"
"67","000","00","027","2704","1200","792","248","544","39","831","1465","0","56.72","16.93"
"67","000","00","027","2705","0000","4725","1577","3148","278","5003","9066","0","55.18","17.39"
"67","000","00","027","2705","1201","729","250","479","32","761","1335","0","57.0","18.73"
"67","000","00","027","2705","1202","725","247","478","61","786","1490","0","52.75","16.58"
"67","000","00","027","2705","1203","808","276","532","44","852","1453","0","58.64","19.0"
"67","000","00","027","2705","1204","491","181","310","15","506","990","0","51.11","18.28"
"67","000","00","027","2705","1205","844","256","588","43","887","1573","0","56.39","16.27"
"67","000","00","027","2705","1206","512","166","346","54","566","1031","0","54.9","16.1"
"67","000","00","027","2705","1207","616","201","415","29","645","1194","0","54.02","16.83"
"67","000","00","027","2706","0000","1622","580","1042","97","1719","3342","0","51.44","17.35"
"67","000","00","027","2706","1208","606","216","390","45","651","1268","0","51.34","17.03"
"67","000","00","027","2706","1209","488","186","302","36","524","929","0","56.4","20.02"
"67","000","00","027","2706","1210","528","178","350","16","544","1145","0","47.51","15.55"
"67","000","00","027","2707","0000","4543","1562","2981","313","4856","9116","0","53.27","17.13"
"67","000","00","027","2707","1211","696","240","456","41","737","1413","0","52.16","16.99"
"67","000","00","027","2707","1212","704","224","480","83","787","1465","0","53.72","15.29"
"67","000","00","027","2707","1213","751","246","505","43","794","1390","0","57.12","17.7"
"67","000","00","027","2707","1214","695","253","442","70","765","1396","0","54.8","18.12"
"67","000","00","027","2707","1215","946","346","600","52","998","1906","0","52.36","18.15"
"67","000","00","027","2707","1216","751","253","498","24","775","1546","0","50.13","16.36"
"67","000","00","027","2708","0000","2855","998","1857","186","3041","5833","0","52.13","17.11"
"67","000","00","027","2708","1217","672","258","414","22","694","1546","0","44.89","16.69"
"67","000","00","027","2708","1218","733","233","500","50","783","1399","0","55.97","16.65"
"67","000","00","027","2708","1219","843","303","540","81","924","1748","0","52.86","17.33"
"67","000","00","027","2708","1220","607","204","403","33","640","1140","0","56.14","17.89"
"67","000","00","027","2711","0000","1274","414","860","62","1336","2763","0","48.35","14.98"
"67","000","00","027","2711","1223","669","216","453","34","703","1414","0","49.72","15.28"
"67","000","00","027","2711","1224","605","198","407","28","633","1349","0","46.92","14.68"
"67","000","00","027","2712","0000","2265","762","1503","117","2382","4659","0","51.13","16.36"
"67","000","00","027","2712","1225","715","244","471","22","737","1471","0","50.1","16.59"
"67","000","00","027","2712","1226","674","238","436","19","693","1324","0","52.34","17.98"
"67","000","00","027","2712","1227","589","163","426","52","641","1310","0","48.93","12.44"
"67","000","00","027","2712","1228","287","117","170","24","311","554","0","56.14","21.12"
"67","000","00","027","2713","0000","719","170","549","31","750","1395","0","53.76","12.19"
"67","000","00","027","2713","1229","719","170","549","31","750","1395","0","53.76","12.19"
"67","000","00","027","2714","0000","628","177","451","15","643","1264","0","50.87","14.0"
"67","000","00","027","2714","1230","628","177","451","15","643","1264","0","50.87","14.0"
"67","000","00","027","2715","0000","999","323","676","85","1084","2108","0","51.42","15.32"
"67","000","00","027","2715","1231","578","172","406","60","638","1180","0","54.07","14.58"
"67","000","00","027","2715","1232","421","151","270","25","446","928","0","48.06","16.27"
"67","000","00","027","2716","0000","968","335","633","46","1014","2084","0","48.66","16.07"
"67","000","00","027","2716","1233","435","149","286","17","452","965","0","46.84","15.44"
"67","000","00","027","2716","1234","533","186","347","29","562","1119","0","50.22","16.62"
"67","000","00","027","2717","0000","1281","403","878","95","1376","2672","0","51.5","15.08"
"67","000","00","027","2717","1235","605","187","418","51","656","1206","0","54.39","15.51"
"67","000","00","027","2717","1236","676","216","460","44","720","1466","0","49.11","14.73"
"67","000","00","027","2719","0000","1238","385","853","72","1310","2296","0","57.06","16.77"
"67","000","00","027","2719","1221","634","202","432","30","664","1277","0","52.0","15.82"
"67","000","00","027","2719","1222","604","183","421","42","646","1019","0","63.4","17.96"
"67","000","00","028","0000","0000","28716","9988","18728","1767","30483","57387","68391","53.12","17.4"
"67","000","00","028","2801","0000","2980","999","1981","207","3187","5916","0","53.87","16.89"
"67","000","00","028","2801","1237","742","232","510","65","807","1560","0","51.73","14.87"
"67","000","00","028","2801","1238","779","255","524","58","837","1383","0","60.52","18.44"
"67","000","00","028","2801","1239","753","275","478","39","792","1491","0","53.12","18.44"
"67","000","00","028","2801","1240","706","237","469","45","751","1482","0","50.67","15.99"
"67","000","00","028","2802","0000","1642","583","1059","124","1766","3756","0","47.02","15.52"
"67","000","00","028","2802","1244","544","202","342","37","581","1336","0","43.49","15.12"
"67","000","00","028","2802","1245","523","175","348","65","588","1183","0","49.7","14.79"
"67","000","00","028","2802","1246","575","206","369","22","597","1237","0","48.26","16.65"
"67","000","00","028","2803","0000","1198","407","791","72","1270","2293","0","55.39","17.75"
"67","000","00","028","2803","1271","669","233","436","44","713","1245","0","57.27","18.71"
"67","000","00","028","2803","1272","529","174","355","28","557","1048","0","53.15","16.6"
"67","000","00","028","2804","0000","1703","568","1135","103","1806","3286","0","54.96","17.29"
"67","000","00","028","2804","1249","567","190","377","2","569","1105","0","51.49","17.19"
"67","000","00","028","2804","1250","563","201","362","39","602","1099","0","54.78","18.29"
"67","000","00","028","2804","1251","573","177","396","62","635","1082","0","58.69","16.36"
"67","000","00","028","2805","0000","1620","546","1074","94","1714","3301","0","51.92","16.54"
"67","000","00","028","2805","1254","534","185","349","38","572","1090","0","52.48","16.97"
"67","000","00","028","2805","1255","557","193","364","29","586","1131","0","51.81","17.06"
"67","000","00","028","2805","1256","529","168","361","27","556","1080","0","51.48","15.56"
"67","000","00","028","2806","0000","1641","561","1080","118","1759","3285","0","53.55","17.08"
"67","000","00","028","2806","1259","555","201","354","60","615","1128","0","54.52","17.82"
"67","000","00","028","2806","1260","532","180","352","23","555","1055","0","52.61","17.06"
"67","000","00","028","2806","1261","554","180","374","35","589","1102","0","53.45","16.33"
"67","000","00","028","2807","0000","1102","397","705","84","1186","2101","0","56.45","18.9"
"67","000","00","028","2807","1262","550","206","344","42","592","1068","0","55.43","19.29"
"67","000","00","028","2807","1263","552","191","361","42","594","1033","0","57.5","18.49"
"67","000","00","028","2808","0000","712","245","467","20","732","1772","0","41.31","13.83"
"67","000","00","028","2808","1264","712","245","467","20","732","1772","0","41.31","13.83"
"67","000","00","028","2809","0000","1517","529","988","92","1609","2943","0","54.67","17.97"
"67","000","00","028","2809","1265","712","247","465","60","772","1399","0","55.18","17.66"
"67","000","00","028","2809","1266","805","282","523","32","837","1544","0","54.21","18.26"
"67","000","00","028","2810","0000","300","110","190","8","308","684","0","45.03","16.08"
"67","000","00","028","2810","1267","300","110","190","8","308","684","0","45.03","16.08"
"67","000","00","028","2811","0000","1015","381","634","81","1096","1853","0","59.15","20.56"
"67","000","00","028","2811","1268","469","173","296","31","500","839","0","59.59","20.62"
"67","000","00","028","2811","1269","546","208","338","50","596","1014","0","58.78","20.51"
"67","000","00","028","2812","0000","675","232","443","32","707","1906","0","37.09","12.17"
"67","000","00","028","2812","1270","675","232","443","32","707","1906","0","37.09","12.17"
"67","000","00","028","2813","0000","1243","423","820","53","1296","2586","0","50.12","16.36"
"67","000","00","028","2813","1273","588","192","396","22","610","1175","0","51.91","16.34"
"67","000","00","028","2813","1274","655","231","424","31","686","1411","0","48.62","16.37"
"67","000","00","028","2814","0000","1663","633","1030","97","1760","3192","0","55.14","19.83"
"67","000","00","028","2814","1275","821","312","509","35","856","1514","0","56.54","20.61"
"67","000","00","028","2814","1276","842","321","521","62","904","1678","0","53.87","19.13"
"67","000","00","028","2815","0000","1043","356","687","83","1126","1958","0","57.51","18.18"
"67","000","00","028","2815","1277","491","190","301","31","522","949","0","55.01","20.02"
"67","000","00","028","2815","1278","552","166","386","52","604","1009","0","59.86","16.45"
"67","000","00","028","2816","0000","1014","352","662","35","1049","1740","0","60.29","20.23"
"67","000","00","028","2816","1279","593","218","375","5","598","984","0","60.77","22.15"
"67","000","00","028","2816","1280","421","134","287","30","451","756","0","59.66","17.72"
"67","000","00","028","2817","0000","1638","562","1076","103","1741","2945","0","59.12","19.08"
"67","000","00","028","2817","1281","838","280","558","43","881","1478","0","59.61","18.94"
"67","000","00","028","2817","1282","800","282","518","60","860","1467","0","58.62","19.22"
"67","000","00","028","2818","0000","2109","781","1328","106","2215","4145","0","53.44","18.84"
"67","000","00","028","2818","1241","694","249","445","23","717","1330","0","53.91","18.72"
"67","000","00","028","2818","1242","738","274","464","48","786","1399","0","56.18","19.59"
"67","000","00","028","2818","1243","677","258","419","35","712","1416","0","50.28","18.22"
"67","000","00","028","2819","0000","1162","403","759","76","1238","2457","0","50.39","16.4"
"67","000","00","028","2819","1257","492","164","328","22","514","1121","0","45.85","14.63"
"67","000","00","028","2819","1258","670","239","431","54","724","1336","0","54.19","17.89"
"67","000","00","028","2820","0000","1143","401","742","88","1231","2282","0","53.94","17.57"
"67","000","00","028","2820","1247","583","202","381","55","638","1133","0","56.31","17.83"
"67","000","00","028","2820","1248","560","199","361","33","593","1149","0","51.61","17.32"
"67","000","00","028","2821","0000","1596","519","1077","91","1687","2986","0","56.5","17.38"
"67","000","00","028","2821","1252","809","258","551","38","847","1519","0","55.76","16.98"
"67","000","00","028","2821","1253","787","261","526","53","840","1467","0","57.26","17.79"
"67","000","00","029","0000","0000","14826","4948","9878","1096","15922","29913","34387","53.23","16.54"
"67","000","00","029","2901","0000","1150","389","761","59","1209","2138","0","56.55","18.19"
"67","000","00","029","2901","1283","496","161","335","25","521","982","0","53.05","16.4"
"67","000","00","029","2901","1284","654","228","426","34","688","1156","0","59.52","19.72"
"67","000","00","029","2902","0000","1052","361","691","74","1126","2049","0","54.95","17.62"
"67","000","00","029","2902","1285","475","154","321","18","493","1006","0","49.01","15.31"
"67","000","00","029","2902","1286","577","207","370","56","633","1043","0","60.69","19.85"
"67","000","00","029","2903","0000","1568","554","1014","129","1697","3319","0","51.13","16.69"
"67","000","00","029","2903","1287","505","183","322","82","587","1012","0","58.0","18.08"
"67","000","00","029","2903","1288","450","156","294","15","465","1013","0","45.9","15.4"
"67","000","00","029","2903","1289","613","215","398","32","645","1294","0","49.85","16.62"
"67","000","00","029","2904","0000","1188","396","792","72","1260","2430","0","51.85","16.3"
"67","000","00","029","2904","1290","596","200","396","42","638","1264","0","50.47","15.82"
"67","000","00","029","2904","1291","592","196","396","30","622","1166","0","53.34","16.81"
"67","000","00","029","2905","0000","485","183","302","15","500","1018","0","49.12","17.98"
"67","000","00","029","2905","1292","485","183","302","15","500","1018","0","49.12","17.98"
"67","000","00","029","2906","0000","302","89","213","42","344","733","0","46.93","12.14"
"67","000","00","029","2906","1293","302","89","213","42","344","733","0","46.93","12.14"
"67","000","00","029","2907","0000","1736","541","1195","90","1826","3152","0","57.93","17.16"
"67","000","00","029","2907","1294","617","169","448","28","645","1093","0","59.01","15.46"
"67","000","00","029","2907","1295","577","183","394","29","606","1081","0","56.06","16.93"
"67","000","00","029","2907","1296","542","189","353","33","575","978","0","58.79","19.33"
"67","000","00","029","2908","0000","1520","493","1027","130","1650","3133","0","52.67","15.74"
"67","000","00","029","2908","1297","512","167","345","17","529","1116","0","47.4","14.96"
"67","000","00","029","2908","1298","481","138","343","40","521","972","0","53.6","14.2"
"67","000","00","029","2908","1299","527","188","339","73","600","1045","0","57.42","17.99"
"67","000","00","029","2909","0000","983","364","619","77","1060","1879","0","56.41","19.37"
"67","000","00","029","2909","1300","436","170","266","35","471","872","0","54.01","19.5"
"67","000","00","029","2909","1301","547","194","353","42","589","1007","0","58.49","19.27"
"67","000","00","029","2912","0000","747","252","495","76","823","1524","0","54.0","16.54"
"67","000","00","029","2912","1306","397","130","267","62","459","804","0","57.09","16.17"
"67","000","00","029","2912","1307","350","122","228","14","364","720","0","50.56","16.94"
"67","000","00","029","2913","0000","532","168","364","32","564","1201","0","46.96","13.99"
"67","000","00","029","2913","1308","370","119","251","19","389","843","0","46.14","14.12"
"67","000","00","029","2913","1309","162","49","113","13","175","358","0","48.88","13.69"
"67","000","00","029","2916","0000","871","280","591","44","915","1867","0","49.01","15.0"
"67","000","00","029","2916","1312","395","128","267","19","414","904","0","45.8","14.16"
"67","000","00","029","2916","1313","476","152","324","25","501","963","0","52.02","15.78"
"67","000","00","029","2917","0000","259","104","155","14","273","489","0","55.83","21.27"
"67","000","00","029","2917","1314","259","104","155","14","273","489","0","55.83","21.27"
"67","000","00","029","2918","0000","1768","557","1211","163","1931","3475","0","55.57","16.03"
"67","000","00","029","2918","1302","417","145","272","41","458","763","0","60.03","19.0"
"67","000","00","029","2918","1303","304","93","211","30","334","630","0","53.02","14.76"
"67","000","00","029","2918","1304","494","150","344","62","556","959","0","57.98","15.64"
"67","000","00","029","2918","1305","553","169","384","30","583","1123","0","51.91","15.05"
"67","000","00","029","2919","0000","665","217","448","79","744","1506","0","49.4","14.41"
"67","000","00","029","2919","1310","367","127","240","61","428","797","0","53.7","15.93"
"67","000","00","029","2919","1311","298","90","208","18","316","709","0","44.57","12.69"
"67","000","00","030","0000","0000","1652","485","1167","150","1802","3713","3999","48.53","13.06"
"67","000","00","030","3001","0000","480","169","311","55","535","1047","0","51.1","16.14"
"67","000","00","030","3001","1315","480","169","311","55","535","1047","0","51.1","16.14"
"67","000","00","030","3002","0000","284","67","217","16","300","630","0","47.62","10.63"
"67","000","00","030","3002","1316","284","67","217","16","300","630","0","47.62","10.63"
"67","000","00","030","3003","0000","52","12","40","4","56","141","0","39.72","8.51"
"67","000","00","030","3003","1317","52","12","40","4","56","141","0","39.72","8.51"
"67","000","00","030","3004","0000","163","51","112","17","180","367","0","49.05","13.9"
"67","000","00","030","3004","1318","163","51","112","17","180","367","0","49.05","13.9"
"67","000","00","030","3005","0000","167","46","121","13","180","337","0","53.41","13.65"
"67","000","00","030","3005","1319","167","46","121","13","180","337","0","53.41","13.65"
"67","000","00","030","3006","0000","137","42","95","3","140","318","0","44.03","13.21"
"67","000","00","030","3006","1320","137","42","95","3","140","318","0","44.03","13.21"
"67","000","00","030","3007","0000","192","44","148","22","214","427","0","50.12","10.3"
"67","000","00","030","3007","1321","192","44","148","22","214","427","0","50.12","10.3"
"67","000","00","030","3008","0000","177","54","123","20","197","446","0","44.17","12.11"
"67","000","00","030","3008","1322","177","54","123","20","197","446","0","44.17","12.11"
"67","000","00","031","0000","0000","97034","34171","62863","4478","101512","195001","234921","52.06","17.52"
"67","000","00","031","3101","0000","2684","943","1741","134","2818","5671","0","49.69","16.63"
"67","000","00","031","3101","0708","703","233","470","61","764","1398","0","54.65","16.67"
"67","000","00","031","3101","0709","638","229","409","25","663","1478","0","44.86","15.49"
"67","000","00","031","3101","0710","707","261","446","18","725","1442","0","50.28","18.1"
"67","000","00","031","3101","0711","636","220","416","30","666","1353","0","49.22","16.26"
"67","000","00","031","3102","0000","3224","1132","2092","150","3374","6821","0","49.46","16.6"
"67","000","00","031","3102","0719","790","297","493","48","838","1709","0","49.03","17.38"
"67","000","00","031","3102","0720","794","277","517","38","832","1717","0","48.46","16.13"
"67","000","00","031","3102","0721","813","283","530","33","846","1759","0","48.1","16.09"
"67","000","00","031","3102","0722","827","275","552","31","858","1636","0","52.44","16.81"
"67","000","00","031","3103","0000","3904","1336","2568","179","4083","8791","0","46.45","15.2"
"67","000","00","031","3103","0728","739","240","499","25","764","1389","0","55.0","17.28"
"67","000","00","031","3103","0729","683","259","424","43","726","1369","0","53.03","18.92"
"67","000","00","031","3103","0730","713","227","486","60","773","1415","0","54.63","16.04"
"67","000","00","031","3103","0731","623","214","409","7","630","1386","0","45.45","15.44"
"67","000","00","031","3103","0732","416","147","269","7","423","1747","0","24.21","8.41"
"67","000","00","031","3103","0733","730","249","481","37","767","1485","0","51.65","16.77"
"67","000","00","031","3104","0000","3344","1178","2166","173","3517","7088","0","49.62","16.62"
"67","000","00","031","3104","0734","840","308","532","53","893","1747","0","51.12","17.63"
"67","000","00","031","3104","0735","758","275","483","37","795","1744","0","45.58","15.77"
"67","000","00","031","3104","0736","821","274","547","33","854","1797","0","47.52","15.25"
"67","000","00","031","3104","0737","925","321","604","50","975","1800","0","54.17","17.83"
"67","000","00","031","3105","0000","3000","1099","1901","107","3107","5710","0","54.41","19.25"
"67","000","00","031","3105","0745","786","279","507","37","823","1531","0","53.76","18.22"
"67","000","00","031","3105","0746","715","250","465","29","744","1327","0","56.07","18.84"
"67","000","00","031","3105","0747","749","272","477","13","762","1456","0","52.34","18.68"
"67","000","00","031","3105","0748","750","298","452","28","778","1396","0","55.73","21.35"
"67","000","00","031","3106","0000","1311","464","847","75","1386","2525","0","54.89","18.38"
"67","000","00","031","3106","0785","691","246","445","53","744","1285","0","57.9","19.14"
"67","000","00","031","3106","0786","620","218","402","22","642","1240","0","51.77","17.58"
"67","000","00","031","3107","0000","1365","466","899","80","1445","2670","0","54.12","17.45"
"67","000","00","031","3107","0787","633","216","417","46","679","1343","0","50.56","16.08"
"67","000","00","031","3107","0788","732","250","482","34","766","1327","0","57.72","18.84"
"67","000","00","031","3108","0000","986","378","608","42","1028","1862","0","55.21","20.3"
"67","000","00","031","3108","0758","464","193","271","18","482","924","0","52.16","20.89"
"67","000","00","031","3108","0759","522","185","337","24","546","938","0","58.21","19.72"
"67","000","00","031","3109","0000","758","276","482","58","816","1453","0","56.16","19.0"
"67","000","00","031","3109","0760","507","185","322","32","539","957","0","56.32","19.33"
"67","000","00","031","3109","0761","251","91","160","26","277","496","0","55.85","18.35"
"67","000","00","031","3110","0000","2362","841","1521","97","2459","4886","0","50.33","17.21"
"67","000","00","031","3110","0762","862","309","553","47","909","1717","0","52.94","18.0"
"67","000","00","031","3110","0763","750","276","474","31","781","1615","0","48.36","17.09"
"67","000","00","031","3110","0764","750","256","494","19","769","1554","0","49.49","16.47"
"67","000","00","031","3111","0000","1262","436","826","85","1347","2276","0","59.18","19.16"
"67","000","00","031","3111","0772","485","170","315","32","517","890","0","58.09","19.1"
"67","000","00","031","3111","0773","581","202","379","34","615","1018","0","60.41","19.84"
"67","000","00","031","3111","0774","196","64","132","19","215","368","0","58.42","17.39"
"67","000","00","031","3112","0000","1705","594","1111","107","1812","3366","0","53.83","17.65"
"67","000","00","031","3112","0795","541","194","347","51","592","1117","0","53.0","17.37"
"67","000","00","031","3112","0796","505","177","328","18","523","1069","0","48.92","16.56"
"67","000","00","031","3112","0797","659","223","436","38","697","1180","0","59.07","18.9"
"67","000","00","031","3113","0000","1816","644","1172","156","1972","3542","0","55.67","18.18"
"67","000","00","031","3113","0798","583","197","386","67","650","1176","0","55.27","16.75"
"67","000","00","031","3113","0799","567","206","361","41","608","1158","0","52.5","17.79"
"67","000","00","031","3113","0800","666","241","425","48","714","1208","0","59.11","19.95"
"67","000","00","031","3114","0000","3858","1415","2443","165","4023","7237","0","55.59","19.55"
"67","000","00","031","3114","0801","750","274","476","56","806","1501","0","53.7","18.25"
"67","000","00","031","3114","0802","699","245","454","22","721","1298","0","55.55","18.88"
"67","000","00","031","3114","0803","789","286","503","21","810","1542","0","52.53","18.55"
"67","000","00","031","3114","0804","830","304","526","31","861","1537","0","56.02","19.78"
"67","000","00","031","3114","0805","790","306","484","35","825","1359","0","60.71","22.52"
"67","000","00","031","3115","0000","1783","664","1119","112","1895","3835","0","49.41","17.31"
"67","000","00","031","3115","0806","511","178","333","26","537","1139","0","47.15","15.63"
"67","000","00","031","3115","0807","545","200","345","30","575","1158","0","49.65","17.27"
"67","000","00","031","3115","0808","727","286","441","56","783","1538","0","50.91","18.6"
"67","000","00","031","3116","0000","2993","1085","1908","129","3122","5872","0","53.17","18.48"
"67","000","00","031","3116","0809","561","180","381","17","578","1166","0","49.57","15.44"
"67","000","00","031","3116","0810","598","213","385","22","620","1228","0","50.49","17.35"
"67","000","00","031","3116","0811","635","231","404","41","676","1200","0","56.33","19.25"
"67","000","00","031","3116","0812","607","248","359","31","638","1131","0","56.41","21.93"
"67","000","00","031","3116","0813","592","213","379","18","610","1147","0","53.18","18.57"
"67","000","00","031","3117","0000","1891","665","1226","105","1996","4027","0","49.57","16.51"
"67","000","00","031","3117","0814","679","237","442","53","732","1442","0","50.76","16.44"
"67","000","00","031","3117","0815","646","235","411","22","668","1325","0","50.42","17.74"
"67","000","00","031","3117","0816","566","193","373","30","596","1260","0","47.3","15.32"
"67","000","00","031","3118","0000","1108","390","718","122","1230","2099","0","58.6","18.58"
"67","000","00","031","3118","0793","507","198","309","69","576","983","0","58.6","20.14"
"67","000","00","031","3118","0794","601","192","409","53","654","1116","0","58.6","17.2"
"67","000","00","031","3119","0000","893","253","640","53","946","1988","0","47.59","12.73"
"67","000","00","031","3119","0820","463","124","339","34","497","1012","0","49.11","12.25"
"67","000","00","031","3119","0821","430","129","301","19","449","976","0","46.0","13.22"
"67","000","00","031","3120","0000","4100","1325","2775","169","4269","8430","0","50.64","15.72"
"67","000","00","031","3120","0825","673","207","466","30","703","1307","0","53.79","15.84"
"67","000","00","031","3120","0826","686","215","471","24","710","1482","0","47.91","14.51"
"67","000","00","031","3120","0827","608","203","405","24","632","1341","0","47.13","15.14"
"67","000","00","031","3120","0828","670","228","442","31","701","1376","0","50.94","16.57"
"67","000","00","031","3120","0829","659","209","450","32","691","1390","0","49.71","15.04"
"67","000","00","031","3120","0830","804","263","541","28","832","1534","0","54.24","17.14"
"67","000","00","031","3121","0000","884","328","556","72","956","1796","0","53.23","18.26"
"67","000","00","031","3121","0823","447","157","290","40","487","859","0","56.69","18.28"
"67","000","00","031","3121","0824","437","171","266","32","469","937","0","50.05","18.25"
"67","000","00","031","3122","0000","554","166","388","35","589","1151","0","51.17","14.42"
"67","000","00","031","3122","0838","554","166","388","35","589","1151","0","51.17","14.42"
"67","000","00","031","3123","0000","3082","1355","1727","174","3256","5980","0","54.45","22.66"
"67","000","00","031","3123","0789","784","300","484","32","816","1565","0","52.14","19.17"
"67","000","00","031","3123","0790","753","279","474","70","823","1476","0","55.76","18.9"
"67","000","00","031","3123","0791","739","475","264","36","775","1476","0","52.51","32.18"
"67","000","00","031","3123","0792","806","301","505","36","842","1463","0","57.55","20.57"
"67","000","00","031","3124","0000","1154","251","903","56","1210","2097","0","57.7","11.97"
"67","000","00","031","3124","0839","626","104","522","34","660","1026","0","64.33","10.14"
"67","000","00","031","3124","0840","528","147","381","22","550","1071","0","51.35","13.73"
"67","000","00","031","3125","0000","1655","580","1075","95","1750","3387","0","51.67","17.12"
"67","000","00","031","3125","0843","853","285","568","54","907","1687","0","53.76","16.89"
"67","000","00","031","3125","0844","802","295","507","41","843","1700","0","49.59","17.35"
"67","000","00","031","3126","0000","3747","1278","2469","147","3894","7729","0","50.38","16.54"
"67","000","00","031","3126","0845","776","274","502","27","803","1444","0","55.61","18.98"
"67","000","00","031","3126","0846","735","239","496","27","762","1485","0","51.31","16.09"
"67","000","00","031","3126","0847","791","255","536","33","824","1717","0","47.99","14.85"
"67","000","00","031","3126","0848","763","272","491","38","801","1701","0","47.09","15.99"
"67","000","00","031","3126","0849","682","238","444","22","704","1382","0","50.94","17.22"
"67","000","00","031","3127","0000","2841","1038","1803","169","3010","6072","0","49.57","17.09"
"67","000","00","031","3127","0778","686","232","454","47","733","1405","0","52.17","16.51"
"67","000","00","031","3127","0779","677","250","427","51","728","1445","0","50.38","17.3"
"67","000","00","031","3127","0780","810","313","497","42","852","1687","0","50.5","18.55"
"67","000","00","031","3127","0781","668","243","425","29","697","1535","0","45.41","15.83"
"67","000","00","031","3128","0000","279","82","197","11","290","531","0","54.61","15.44"
"67","000","00","031","3128","0822","279","82","197","11","290","531","0","54.61","15.44"
"67","000","00","031","3129","0000","2894","966","1928","101","2995","5725","0","52.31","16.87"
"67","000","00","031","3129","0768","749","256","493","19","768","1457","0","52.71","17.57"
"67","000","00","031","3129","0769","765","265","500","15","780","1451","0","53.76","18.26"
"67","000","00","031","3129","0770","651","227","424","39","690","1423","0","48.49","15.95"
"67","000","00","031","3129","0771","729","218","511","28","757","1394","0","54.3","15.64"
"67","000","00","031","3130","0000","3770","1278","2492","138","3908","7784","0","50.21","16.42"
"67","000","00","031","3130","0723","721","254","467","42","763","1442","0","52.91","17.61"
"67","000","00","031","3130","0724","756","270","486","20","776","1545","0","50.23","17.48"
"67","000","00","031","3130","0725","763","223","540","34","797","1565","0","50.93","14.25"
"67","000","00","031","3130","0726","786","281","505","28","814","1684","0","48.34","16.69"
"67","000","00","031","3130","0727","744","250","494","14","758","1548","0","48.97","16.15"
"67","000","00","031","3131","0000","2783","1029","1754","108","2891","5428","0","53.26","18.96"
"67","000","00","031","3131","0715","630","246","384","26","656","1317","0","49.81","18.68"
"67","000","00","031","3131","0716","674","215","459","31","705","1376","0","51.24","15.63"
"67","000","00","031","3131","0717","699","259","440","28","727","1361","0","53.42","19.03"
"67","000","00","031","3131","0718","780","309","471","23","803","1374","0","58.44","22.49"
"67","000","00","031","3132","0000","1740","593","1147","63","1803","3447","0","52.31","17.2"
"67","000","00","031","3132","0712","572","201","371","28","600","1160","0","51.72","17.33"
"67","000","00","031","3132","0713","593","198","395","25","618","1122","0","55.08","17.65"
"67","000","00","031","3132","0714","575","194","381","10","585","1165","0","50.21","16.65"
"67","000","00","031","3133","0000","2937","1146","1791","98","3035","5917","0","51.29","19.37"
"67","000","00","031","3133","0749","800","272","528","44","844","1636","0","51.59","16.63"
"67","000","00","031","3133","0750","839","322","517","25","864","1592","0","54.27","20.23"
"67","000","00","031","3133","0751","945","432","513","15","960","2017","0","47.6","21.42"
"67","000","00","031","3133","0752","353","120","233","14","367","672","0","54.61","17.86"
"67","000","00","031","3134","0000","2146","840","1306","69","2215","4811","0","46.04","17.46"
"67","000","00","031","3134","0755","724","272","452","17","741","1660","0","44.64","16.39"
"67","000","00","031","3134","0756","666","272","394","27","693","1561","0","44.39","17.42"
"67","000","00","031","3134","0757","756","296","460","25","781","1590","0","49.12","18.62"
"67","000","00","031","3135","0000","1516","567","949","55","1571","3113","0","50.47","18.21"
"67","000","00","031","3135","0753","756","257","499","22","778","1611","0","48.29","15.95"
"67","000","00","031","3135","0754","760","310","450","33","793","1502","0","52.8","20.64"
"67","000","00","031","3136","0000","1948","721","1227","90","2038","3776","0","53.97","19.09"
"67","000","00","031","3136","0775","677","238","439","43","720","1208","0","59.6","19.7"
"67","000","00","031","3136","0776","588","222","366","27","615","1187","0","51.81","18.7"
"67","000","00","031","3136","0777","683","261","422","20","703","1381","0","50.91","18.9"
"67","000","00","031","3137","0000","4859","1655","3204","164","5023","9284","0","54.1","17.83"
"67","000","00","031","3137","0831","782","247","535","31","813","1460","0","55.68","16.92"
"67","000","00","031","3137","0832","689","227","462","14","703","1383","0","50.83","16.41"
"67","000","00","031","3137","0833","668","232","436","26","694","1299","0","53.43","17.86"
"67","000","00","031","3137","0834","695","247","448","15","710","1264","0","56.17","19.54"
"67","000","00","031","3137","0835","737","269","468","31","768","1355","0","56.68","19.85"
"67","000","00","031","3137","0836","683","220","463","23","706","1414","0","49.93","15.56"
"67","000","00","031","3137","0837","605","213","392","24","629","1109","0","56.72","19.21"
"67","000","00","031","3138","0000","4088","1359","2729","173","4261","7603","0","56.04","17.87"
"67","000","00","031","3138","0740","842","280","562","17","859","1519","0","56.55","18.43"
"67","000","00","031","3138","0741","783","253","530","58","841","1497","0","56.18","16.9"
"67","000","00","031","3138","0742","796","237","559","15","811","1509","0","53.74","15.71"
"67","000","00","031","3138","0743","848","263","585","61","909","1542","0","58.95","17.06"
"67","000","00","031","3138","0744","819","326","493","22","841","1536","0","54.75","21.22"
"67","000","00","031","3139","0000","1612","543","1069","75","1687","2764","0","61.03","19.65"
"67","000","00","031","3139","0841","827","279","548","45","872","1387","0","62.87","20.12"
"67","000","00","031","3139","0842","785","264","521","30","815","1377","0","59.19","19.17"
"67","000","00","031","3140","0000","2306","772","1534","101","2407","4846","0","49.67","15.93"
"67","000","00","031","3140","0817","751","242","509","50","801","1631","0","49.11","14.84"
"67","000","00","031","3140","0818","741","246","495","29","770","1549","0","49.71","15.88"
"67","000","00","031","3140","0819","814","284","530","22","836","1666","0","50.18","17.05"
"67","000","00","031","3141","0000","1713","557","1156","43","1756","3428","0","51.23","16.25"
"67","000","00","031","3141","0738","821","245","576","15","836","1720","0","48.6","14.24"
"67","000","00","031","3141","0739","892","312","580","28","920","1708","0","53.86","18.27"
"67","000","00","031","3142","0000","2329","825","1504","75","2404","4498","0","53.45","18.34"
"67","000","00","031","3142","0782","804","283","521","33","837","1542","0","54.28","18.35"
"67","000","00","031","3142","0783","799","273","526","25","824","1618","0","50.93","16.87"
"67","000","00","031","3142","0784","726","269","457","17","743","1338","0","55.53","20.1"
"67","000","00","031","3143","0000","1850","658","1192","68","1918","3685","0","52.05","17.86"
"67","000","00","031","3143","0765","583","189","394","18","601","1196","0","50.25","15.8"
"67","000","00","031","3143","0766","641","246","395","24","665","1274","0","52.2","19.31"
"67","000","00","031","3143","0767","626","223","403","26","652","1215","0","53.66","18.35"
"67","000","00","032","0000","0000","80506","29616","50890","3419","83925","153359","186117","54.72","19.31"
"67","000","00","032","3201","0000","1118","428","690","41","1159","2191","0","52.9","19.53"
"67","000","00","032","3201","1170","1118","428","690","41","1159","2191","0","52.9","19.53"
"67","000","00","032","3202","0000","1520","567","953","119","1639","2944","0","55.67","19.26"
"67","000","00","032","3202","1166","645","241","404","70","715","1287","0","55.56","18.73"
"67","000","00","032","3202","1167","875","326","549","49","924","1657","0","55.76","19.67"
"67","000","00","032","3203","0000","3340","1106","2234","138","3478","6583","0","52.83","16.8"
"67","000","00","032","3203","1113","993","350","643","70","1063","2067","0","51.43","16.93"
"67","000","00","032","3203","1114","1140","341","799","27","1167","2153","0","54.2","15.84"
"67","000","00","032","3203","1115","1207","415","792","41","1248","2363","0","52.81","17.56"
"67","000","00","032","3204","0000","1601","594","1007","88","1689","2869","0","58.87","20.7"
"67","000","00","032","3204","1097","876","321","555","58","934","1491","0","62.64","21.53"
"67","000","00","032","3204","1098","725","273","452","30","755","1378","0","54.79","19.81"
"67","000","00","032","3205","0000","2399","878","1521","129","2528","4730","0","53.45","18.56"
"67","000","00","032","3205","1180","770","280","490","35","805","1486","0","54.17","18.84"
"67","000","00","032","3205","1181","832","285","547","45","877","1560","0","56.22","18.27"
"67","000","00","032","3205","1182","797","313","484","49","846","1684","0","50.24","18.59"
"67","000","00","032","3206","0000","2034","724","1310","91","2125","4455","0","47.7","16.25"
"67","000","00","032","3206","1118","927","316","611","42","969","2115","0","45.82","14.94"
"67","000","00","032","3206","1119","1107","408","699","49","1156","2340","0","49.4","17.44"
"67","000","00","032","3207","0000","1505","559","946","100","1605","2932","0","54.74","19.07"
"67","000","00","032","3207","1139","766","277","489","45","811","1489","0","54.47","18.6"
"67","000","00","032","3207","1140","739","282","457","55","794","1443","0","55.02","19.54"
"67","000","00","032","3208","0000","2700","1066","1634","87","2787","4858","0","57.37","21.94"
"67","000","00","032","3208","1141","880","374","506","30","910","1498","0","60.75","24.97"
"67","000","00","032","3208","1142","890","339","551","19","909","1622","0","56.04","20.9"
"67","000","00","032","3208","1143","930","353","577","38","968","1738","0","55.7","20.31"
"67","000","00","032","3209","0000","1329","497","832","62","1391","2433","0","57.17","20.43"
"67","000","00","032","3209","1161","601","226","375","16","617","1101","0","56.04","20.53"
"67","000","00","032","3209","1162","728","271","457","46","774","1332","0","58.11","20.35"
"67","000","00","032","3210","0000","1650","641","1009","58","1708","3086","0","55.35","20.77"
"67","000","00","032","3210","1158","830","320","510","26","856","1589","0","53.87","20.14"
"67","000","00","032","3210","1159","820","321","499","32","852","1497","0","56.91","21.44"
"67","000","00","032","3211","0000","691","243","448","47","738","1386","0","53.25","17.53"
"67","000","00","032","3211","1160","691","243","448","47","738","1386","0","53.25","17.53"
"67","000","00","032","3212","0000","2234","736","1498","70","2304","4048","0","56.92","18.18"
"67","000","00","032","3212","1173","1052","333","719","39","1091","1863","0","58.56","17.87"
"67","000","00","032","3212","1174","1182","403","779","31","1213","2185","0","55.51","18.44"
"67","000","00","032","3213","0000","2625","959","1666","114","2739","5122","0","53.48","18.72"
"67","000","00","032","3213","1129","853","311","542","36","889","1708","0","52.05","18.21"
"67","000","00","032","3213","1130","827","292","535","32","859","1560","0","55.06","18.72"
"67","000","00","032","3213","1131","945","356","589","46","991","1854","0","53.45","19.2"
"67","000","00","032","3214","0000","2466","859","1607","88","2554","4865","0","52.5","17.66"
"67","000","00","032","3214","1120","1275","476","799","38","1313","2474","0","53.07","19.24"
"67","000","00","032","3214","1121","1191","383","808","50","1241","2391","0","51.9","16.02"
"67","000","00","032","3215","0000","888","354","534","32","920","1602","0","57.43","22.1"
"67","000","00","032","3215","1177","888","354","534","32","920","1602","0","57.43","22.1"
"67","000","00","032","3216","0000","786","275","511","78","864","1556","0","55.53","17.67"
"67","000","00","032","3216","1176","786","275","511","78","864","1556","0","55.53","17.67"
"67","000","00","032","3217","0000","2313","865","1448","58","2371","4335","0","54.69","19.95"
"67","000","00","032","3217","1133","1069","402","667","28","1097","2093","0","52.41","19.21"
"67","000","00","032","3217","1134","1244","463","781","30","1274","2242","0","56.82","20.65"
"67","000","00","032","3218","0000","726","228","498","52","778","1517","0","51.29","15.03"
"67","000","00","032","3218","1165","726","228","498","52","778","1517","0","51.29","15.03"
"67","000","00","032","3219","0000","2667","992","1675","131","2798","4992","0","56.05","19.87"
"67","000","00","032","3219","1102","918","361","557","30","948","1639","0","57.84","22.03"
"67","000","00","032","3219","1103","897","343","554","43","940","1724","0","54.52","19.9"
"67","000","00","032","3219","1104","852","288","564","58","910","1629","0","55.86","17.68"
"67","000","00","032","3220","0000","2285","1198","1087","117","2402","4484","0","53.57","26.72"
"67","000","00","032","3220","1168","1154","749","405","68","1222","2238","0","54.6","33.47"
"67","000","00","032","3220","1169","1131","449","682","49","1180","2246","0","52.54","19.99"
"67","000","00","032","3221","0000","1034","400","634","41","1075","1986","0","54.13","20.14"
"67","000","00","032","3221","1156","584","228","356","11","595","1090","0","54.59","20.92"
"67","000","00","032","3221","1157","450","172","278","30","480","896","0","53.57","19.2"
"67","000","00","032","3222","0000","2273","860","1413","112","2385","4242","0","56.22","20.27"
"67","000","00","032","3222","1148","807","311","496","24","831","1427","0","58.23","21.79"
"67","000","00","032","3222","1149","722","272","450","50","772","1427","0","54.1","19.06"
"67","000","00","032","3222","1150","744","277","467","38","782","1388","0","56.34","19.96"
"67","000","00","032","3223","0000","674","289","385","21","695","1131","0","61.45","25.55"
"67","000","00","032","3223","1151","674","289","385","21","695","1131","0","61.45","25.55"
"67","000","00","032","3224","0000","2520","1025","1495","56","2576","4615","0","55.82","22.21"
"67","000","00","032","3224","1183","885","351","534","30","915","1653","0","55.35","21.23"
"67","000","00","032","3224","1184","847","372","475","11","858","1554","0","55.21","23.94"
"67","000","00","032","3224","1185","788","302","486","15","803","1408","0","57.03","21.45"
"67","000","00","032","3225","0000","2615","937","1678","105","2720","4874","0","55.81","19.22"
"67","000","00","032","3225","1122","903","335","568","33","936","1673","0","55.95","20.02"
"67","000","00","032","3225","1123","836","298","538","28","864","1594","0","54.2","18.7"
"67","000","00","032","3225","1124","876","304","572","44","920","1607","0","57.25","18.92"
"67","000","00","032","3226","0000","1615","543","1072","68","1683","2982","0","56.44","18.21"
"67","000","00","032","3226","1116","745","246","499","40","785","1427","0","55.01","17.24"
"67","000","00","032","3226","1117","870","297","573","28","898","1555","0","57.75","19.1"
"67","000","00","032","3227","0000","1789","615","1174","75","1864","3593","0","51.88","17.12"
"67","000","00","032","3227","1146","866","308","558","33","899","1829","0","49.15","16.84"
"67","000","00","032","3227","1147","923","307","616","42","965","1764","0","54.71","17.4"
"67","000","00","032","3228","0000","795","270","525","39","834","1721","0","48.46","15.69"
"67","000","00","032","3228","1175","795","270","525","39","834","1721","0","48.46","15.69"
"67","000","00","032","3229","0000","2228","782","1446","112","2340","4240","0","55.19","18.44"
"67","000","00","032","3229","1171","1037","374","663","46","1083","2063","0","52.5","18.13"
"67","000","00","032","3229","1172","1191","408","783","66","1257","2177","0","57.74","18.74"
"67","000","00","032","3230","0000","1358","459","899","60","1418","2447","0","57.95","18.76"
"67","000","00","032","3230","1163","648","223","425","25","673","1185","0","56.79","18.82"
"67","000","00","032","3230","1164","710","236","474","35","745","1262","0","59.03","18.7"
"67","000","00","032","3231","0000","1547","537","1010","85","1632","2983","0","54.71","18.0"
"67","000","00","032","3231","1144","749","282","467","48","797","1501","0","53.1","18.79"
"67","000","00","032","3231","1145","798","255","543","37","835","1482","0","56.34","17.21"
"67","000","00","032","3232","0000","2465","882","1583","101","2566","4472","0","57.38","19.72"
"67","000","00","032","3232","1099","853","325","528","43","896","1552","0","57.73","20.94"
"67","000","00","032","3232","1100","758","254","504","14","772","1326","0","58.22","19.16"
"67","000","00","032","3232","1101","854","303","551","44","898","1594","0","56.34","19.01"
"67","000","00","032","3233","0000","1183","357","826","56","1239","2296","0","53.96","15.55"
"67","000","00","032","3233","1111","568","173","395","31","599","1039","0","57.65","16.65"
"67","000","00","032","3233","1112","615","184","431","25","640","1257","0","50.91","14.64"
"67","000","00","032","3234","0000","1096","392","704","33","1129","2278","0","49.56","17.21"
"67","000","00","032","3234","1132","1096","392","704","33","1129","2278","0","49.56","17.21"
"67","000","00","032","3235","0000","1599","584","1015","52","1651","2933","0","56.29","19.91"
"67","000","00","032","3235","1105","765","278","487","19","784","1399","0","56.04","19.87"
"67","000","00","032","3235","1106","834","306","528","33","867","1534","0","56.52","19.95"
"67","000","00","032","3236","0000","971","351","620","75","1046","1882","0","55.58","18.65"
"67","000","00","032","3236","1154","465","155","310","36","501","935","0","53.58","16.58"
"67","000","00","032","3236","1155","506","196","310","39","545","947","0","57.55","20.7"
"67","000","00","032","3237","0000","1050","376","674","52","1102","1996","0","55.21","18.84"
"67","000","00","032","3237","1152","515","195","320","30","545","1000","0","54.5","19.5"
"67","000","00","032","3237","1153","535","181","354","22","557","996","0","55.92","18.17"
"67","000","00","032","3238","0000","1424","521","903","84","1508","2905","0","51.91","17.93"
"67","000","00","032","3238","1178","760","268","492","50","810","1523","0","53.18","17.6"
"67","000","00","032","3238","1179","664","253","411","34","698","1382","0","50.51","18.31"
"67","000","00","032","3239","0000","2192","813","1379","55","2247","3980","0","56.46","20.43"
"67","000","00","032","3239","1186","1185","394","791","27","1212","2084","0","58.16","18.91"
"67","000","00","032","3239","1187","1007","419","588","28","1035","1896","0","54.59","22.1"
"67","000","00","032","3240","0000","1962","708","1254","69","2031","4492","0","45.21","15.76"
"67","000","00","032","3240","1095","1030","360","670","41","1071","2681","0","39.95","13.43"
"67","000","00","032","3240","1096","932","348","584","28","960","1811","0","53.01","19.22"
"67","000","00","032","3241","0000","3247","1195","2052","116","3363","5929","0","56.72","20.16"
"67","000","00","032","3241","1107","913","347","566","28","941","1656","0","56.82","20.95"
"67","000","00","032","3241","1108","696","229","467","35","731","1322","0","55.3","17.32"
"67","000","00","032","3241","1109","851","347","504","25","876","1620","0","54.07","21.42"
"67","000","00","032","3241","1110","787","272","515","28","815","1331","0","61.23","20.44"
"67","000","00","032","3242","0000","1709","593","1116","98","1807","3308","0","54.63","17.93"
"67","000","00","032","3242","1127","844","277","567","67","911","1696","0","53.71","16.33"
"67","000","00","032","3242","1128","865","316","549","31","896","1612","0","55.58","19.6"
"67","000","00","032","3243","0000","2518","960","1558","49","2567","4456","0","57.61","21.54"
"67","000","00","032","3243","1125","1188","453","735","22","1210","2087","0","57.98","21.71"
"67","000","00","032","3243","1126","1330","507","823","27","1357","2369","0","57.28","21.4"
"67","000","00","032","3244","0000","1446","530","916","44","1490","2470","0","60.32","21.46"
"67","000","00","032","3244","1135","662","248","414","30","692","1152","0","60.07","21.53"
"67","000","00","032","3244","1136","784","282","502","14","798","1318","0","60.55","21.4"
"67","000","00","032","3245","0000","2319","868","1451","61","2380","4160","0","57.21","20.87"
"67","000","00","032","3245","1137","1201","457","744","36","1237","2200","0","56.23","20.77"
"67","000","00","032","3245","1138","1118","411","707","25","1143","1960","0","58.32","20.97"
"67","000","00","033","0000","0000","52808","18076","34732","3166","55974","108650","124790","51.52","16.64"
"67","000","00","033","3301","0000","838","284","554","43","881","1637","0","53.82","17.35"
"67","000","00","033","3301","1024","838","284","554","43","881","1637","0","53.82","17.35"
"67","000","00","033","3303","0000","397","158","239","10","407","871","0","46.73","18.14"
"67","000","00","033","3303","1025","397","158","239","10","407","871","0","46.73","18.14"
"67","000","00","033","3304","0000","815","312","503","54","869","1390","0","62.52","22.45"
"67","000","00","033","3304","1026","323","132","191","18","341","589","0","57.89","22.41"
"67","000","00","033","3304","1027","492","180","312","36","528","801","0","65.92","22.47"
"67","000","00","033","3305","0000","1189","403","786","71","1260","2262","0","55.7","17.82"
"67","000","00","033","3305","1035","594","198","396","26","620","1127","0","55.01","17.57"
"67","000","00","033","3305","1036","595","205","390","45","640","1135","0","56.39","18.06"
"67","000","00","033","3306","0000","1121","416","705","72","1193","2277","0","52.39","18.27"
"67","000","00","033","3306","1037","624","230","394","47","671","1263","0","53.13","18.21"
"67","000","00","033","3306","1038","497","186","311","25","522","1014","0","51.48","18.34"
"67","000","00","033","3307","0000","1314","476","838","50","1364","2774","0","49.17","17.16"
"67","000","00","033","3307","1031","589","209","380","26","615","1204","0","51.08","17.36"
"67","000","00","033","3307","1032","725","267","458","24","749","1570","0","47.71","17.01"
"67","000","00","033","3308","0000","1776","576","1200","132","1908","3209","0","59.46","17.95"
"67","000","00","033","3308","1028","529","166","363","39","568","990","0","57.37","16.77"
"67","000","00","033","3308","1029","705","227","478","36","741","1222","0","60.64","18.58"
"67","000","00","033","3308","1030","542","183","359","57","599","997","0","60.08","18.36"
"67","000","00","033","3309","0000","1500","524","976","115","1615","3006","0","53.73","17.43"
"67","000","00","033","3309","1047","791","251","540","44","835","1542","0","54.15","16.28"
"67","000","00","033","3309","1048","709","273","436","71","780","1464","0","53.28","18.65"
"67","000","00","033","3311","0000","1952","701","1251","145","2097","4217","0","49.73","16.62"
"67","000","00","033","3311","1052","622","214","408","67","689","1419","0","48.56","15.08"
"67","000","00","033","3311","1053","630","226","404","40","670","1333","0","50.26","16.95"
"67","000","00","033","3311","1054","700","261","439","38","738","1465","0","50.38","17.82"
"67","000","00","033","3313","0000","1750","594","1156","117","1867","3607","0","51.76","16.47"
"67","000","00","033","3313","1055","573","211","362","23","596","1099","0","54.23","19.2"
"67","000","00","033","3313","1056","538","183","355","19","557","1133","0","49.16","16.15"
"67","000","00","033","3313","1057","639","200","439","75","714","1375","0","51.93","14.55"
"67","000","00","033","3314","0000","892","286","606","77","969","2064","0","46.95","13.86"
"67","000","00","033","3314","1082","892","286","606","77","969","2064","0","46.95","13.86"
"67","000","00","033","3315","0000","1027","324","703","101","1128","2173","0","51.91","14.91"
"67","000","00","033","3315","1079","586","169","417","65","651","1119","0","58.18","15.1"
"67","000","00","033","3315","1080","441","155","286","36","477","1054","0","45.26","14.71"
"67","000","00","033","3316","0000","593","198","395","48","641","1245","0","51.49","15.9"
"67","000","00","033","3316","1081","593","198","395","48","641","1245","0","51.49","15.9"
"67","000","00","033","3317","0000","1430","479","951","42","1472","3429","0","42.93","13.97"
"67","000","00","033","3317","1083","813","286","527","21","834","2056","0","40.56","13.91"
"67","000","00","033","3317","1084","617","193","424","21","638","1373","0","46.47","14.06"
"67","000","00","033","3318","0000","1039","365","674","61","1100","2109","0","52.16","17.31"
"67","000","00","033","3318","1093","500","159","341","28","528","1093","0","48.31","14.55"
"67","000","00","033","3318","1094","539","206","333","33","572","1016","0","56.3","20.28"
"67","000","00","033","3319","0000","1027","353","674","62","1089","2162","0","50.37","16.33"
"67","000","00","033","3319","1091","406","139","267","20","426","897","0","47.49","15.5"
"67","000","00","033","3319","1092","621","214","407","42","663","1265","0","52.41","16.92"
"67","000","00","033","3320","0000","1283","468","815","104","1387","2544","0","54.52","18.4"
"67","000","00","033","3320","1089","587","226","361","58","645","1186","0","54.38","19.06"
"67","000","00","033","3320","1090","696","242","454","46","742","1358","0","54.64","17.82"
"67","000","00","033","3321","0000","1263","427","836","53","1316","2272","0","57.92","18.79"
"67","000","00","033","3321","1017","642","227","415","26","668","1150","0","58.09","19.74"
"67","000","00","033","3321","1018","621","200","421","27","648","1122","0","57.75","17.83"
"67","000","00","033","3322","0000","2226","753","1473","117","2343","4507","0","51.99","16.71"
"67","000","00","033","3322","1019","676","216","460","35","711","1444","0","49.24","14.96"
"67","000","00","033","3322","1020","837","303","534","43","880","1765","0","49.86","17.17"
"67","000","00","033","3322","1021","713","234","479","39","752","1298","0","57.94","18.03"
"67","000","00","033","3323","0000","1615","549","1066","100","1715","3392","0","50.56","16.19"
"67","000","00","033","3323","1015","663","216","447","39","702","1221","0","57.49","17.69"
"67","000","00","033","3323","1016","952","333","619","61","1013","2171","0","46.66","15.34"
"67","000","00","033","3324","0000","1714","539","1175","54","1768","3398","0","52.03","15.86"
"67","000","00","033","3324","1022","773","232","541","30","803","1458","0","55.08","15.91"
"67","000","00","033","3324","1023","941","307","634","24","965","1940","0","49.74","15.82"
"67","000","00","033","3325","0000","1147","427","720","65","1212","2298","0","52.74","18.58"
"67","000","00","033","3325","1033","634","255","379","46","680","1222","0","55.65","20.87"
"67","000","00","033","3325","1034","513","172","341","19","532","1076","0","49.44","15.99"
"67","000","00","033","3326","0000","1598","540","1058","99","1697","3341","0","50.79","16.16"
"67","000","00","033","3326","1061","864","288","576","61","925","1640","0","56.4","17.56"
"67","000","00","033","3326","1062","734","252","482","38","772","1701","0","45.39","14.81"
"67","000","00","033","3327","0000","1732","604","1128","80","1812","3306","0","54.81","18.27"
"67","000","00","033","3327","1039","794","273","521","45","839","1491","0","56.27","18.31"
"67","000","00","033","3327","1040","938","331","607","35","973","1815","0","53.61","18.24"
"67","000","00","033","3328","0000","2386","782","1604","152","2538","5017","0","50.59","15.59"
"67","000","00","033","3328","1044","749","203","546","55","804","1626","0","49.45","12.48"
"67","000","00","033","3328","1045","835","288","547","30","865","1761","0","49.12","16.35"
"67","000","00","033","3328","1046","802","291","511","67","869","1630","0","53.31","17.85"
"67","000","00","033","3329","0000","1113","358","755","55","1168","2734","0","42.72","13.09"
"67","000","00","033","3329","1068","565","179","386","21","586","1657","0","35.37","10.8"
"67","000","00","033","3329","1069","548","179","369","34","582","1077","0","54.04","16.62"
"67","000","00","033","3330","0000","2536","883","1653","128","2664","5719","0","46.58","15.44"
"67","000","00","033","3330","1072","881","281","600","29","910","1985","0","45.84","14.16"
"67","000","00","033","3330","1073","869","313","556","49","918","2017","0","45.51","15.52"
"67","000","00","033","3330","1074","786","289","497","50","836","1717","0","48.69","16.83"
"67","000","00","033","3331","0000","858","304","554","57","915","1624","0","56.34","18.72"
"67","000","00","033","3331","1075","486","158","328","35","521","929","0","56.08","17.01"
"67","000","00","033","3331","1076","372","146","226","22","394","695","0","56.69","21.01"
"67","000","00","033","3332","0000","2602","860","1742","116","2718","5094","0","53.36","16.88"
"67","000","00","033","3332","1065","982","315","667","57","1039","1774","0","58.57","17.76"
"67","000","00","033","3332","1066","791","270","521","46","837","1613","0","51.89","16.74"
"67","000","00","033","3332","1067","829","275","554","13","842","1707","0","49.33","16.11"
"67","000","00","033","3333","0000","1622","525","1097","153","1775","3568","0","49.75","14.71"
"67","000","00","033","3333","1063","687","208","479","63","750","1541","0","48.67","13.5"
"67","000","00","033","3333","1064","935","317","618","90","1025","2027","0","50.57","15.64"
"67","000","00","033","3334","0000","2316","800","1516","101","2417","4809","0","50.26","16.64"
"67","000","00","033","3334","1058","799","306","493","23","822","1781","0","46.15","17.18"
"67","000","00","033","3334","1059","829","273","556","47","876","1542","0","56.81","17.7"
"67","000","00","033","3334","1060","688","221","467","31","719","1486","0","48.38","14.87"
"67","000","00","033","3335","0000","2490","886","1604","87","2577","5092","0","50.61","17.4"
"67","000","00","033","3335","1041","700","269","431","16","716","1398","0","51.22","19.24"
"67","000","00","033","3335","1042","884","296","588","33","917","2107","0","43.52","14.05"
"67","000","00","033","3335","1043","906","321","585","38","944","1587","0","59.48","20.23"
"67","000","00","033","3336","0000","818","236","582","41","859","1781","0","48.23","13.25"
"67","000","00","033","3336","1077","452","133","319","25","477","997","0","47.84","13.34"
"67","000","00","033","3336","1078","366","103","263","16","382","784","0","48.72","13.14"
"67","000","00","033","3337","0000","893","333","560","90","983","1775","0","55.38","18.76"
"67","000","00","033","3337","1087","512","190","322","57","569","1031","0","55.19","18.43"
"67","000","00","033","3337","1088","381","143","238","33","414","744","0","55.65","19.22"
"67","000","00","033","3338","0000","817","269","548","87","904","1762","0","51.31","15.27"
"67","000","00","033","3338","1085","430","137","293","30","460","1002","0","45.91","13.67"
"67","000","00","033","3338","1086","387","132","255","57","444","760","0","58.42","17.37"
"67","000","00","033","3339","0000","1220","436","784","73","1293","2434","0","53.12","17.91"
"67","000","00","033","3339","1070","601","209","392","32","633","1185","0","53.42","17.64"
"67","000","00","033","3339","1071","619","227","392","41","660","1249","0","52.84","18.17"
"67","000","00","033","3340","0000","1899","648","1251","154","2053","3751","0","54.73","17.28"
"67","000","00","033","3340","1049","831","259","572","78","909","1727","0","52.63","15.0"
"67","000","00","033","3340","1050","603","232","371","53","656","1085","0","60.46","21.38"
"67","000","00","033","3340","1051","465","157","308","23","488","939","0","51.97","16.72"
"67","000","00","034","0000","0000","57356","20680","36676","2527","59883","110906","132020","53.99","18.65"
"67","000","00","034","3401","0000","1643","557","1086","103","1746","3501","0","49.87","15.91"
"67","000","00","034","3401","0850","847","289","558","64","911","1793","0","50.81","16.12"
"67","000","00","034","3401","0851","796","268","528","39","835","1708","0","48.89","15.69"
"67","000","00","034","3404","0000","1137","347","790","54","1191","2030","0","58.67","17.09"
"67","000","00","034","3404","0862","591","165","426","31","622","1076","0","57.81","15.33"
"67","000","00","034","3404","0863","546","182","364","23","569","954","0","59.64","19.08"
"67","000","00","034","3405","0000","1345","469","876","57","1402","2451","0","57.2","19.14"
"67","000","00","034","3405","0858","604","194","410","29","633","1189","0","53.24","16.32"
"67","000","00","034","3405","0859","741","275","466","28","769","1262","0","60.94","21.79"
"67","000","00","034","3407","0000","1027","355","672","34","1061","1964","0","54.02","18.08"
"67","000","00","034","3407","0867","502","171","331","16","518","974","0","53.18","17.56"
"67","000","00","034","3407","0868","525","184","341","18","543","990","0","54.85","18.59"
"67","000","00","034","3408","0000","1170","420","750","46","1216","2069","0","58.77","20.3"
"67","000","00","034","3408","0869","604","234","370","21","625","1016","0","61.52","23.03"
"67","000","00","034","3408","0870","566","186","380","25","591","1053","0","56.13","17.66"
"67","000","00","034","3418","0000","2069","783","1286","111","2180","4291","0","50.8","18.25"
"67","000","00","034","3418","0926","657","248","409","21","678","1502","0","45.14","16.51"
"67","000","00","034","3418","0927","759","270","489","34","793","1470","0","53.95","18.37"
"67","000","00","034","3418","0928","653","265","388","56","709","1319","0","53.75","20.09"
"67","000","00","034","3419","0000","1046","382","664","32","1078","1864","0","57.83","20.49"
"67","000","00","034","3419","0860","594","230","364","16","610","1017","0","59.98","22.62"
"67","000","00","034","3419","0861","452","152","300","16","468","847","0","55.25","17.95"
"67","000","00","034","3420","0000","2643","1084","1559","71","2714","4824","0","56.26","22.47"
"67","000","00","034","3420","0908","941","385","556","15","956","1709","0","55.94","22.53"
"67","000","00","034","3420","0909","878","382","496","31","909","1517","0","59.92","25.18"
"67","000","00","034","3420","0910","824","317","507","25","849","1598","0","53.13","19.84"
"67","000","00","034","3423","0000","1510","537","973","57","1567","3203","0","48.92","16.77"
"67","000","00","034","3423","0894","510","203","307","14","524","1091","0","48.03","18.61"
"67","000","00","034","3423","0895","498","159","339","17","515","993","0","51.86","16.01"
"67","000","00","034","3423","0896","502","175","327","26","528","1119","0","47.18","15.64"
"67","000","00","034","3424","0000","2318","869","1449","95","2413","4442","0","54.32","19.56"
"67","000","00","034","3424","0897","879","327","552","49","928","1685","0","55.07","19.41"
"67","000","00","034","3424","0898","719","283","436","11","730","1368","0","53.36","20.69"
"67","000","00","034","3424","0899","720","259","461","35","755","1389","0","54.36","18.65"
"67","000","00","034","3425","0000","1668","647","1021","57","1725","3296","0","52.34","19.63"
"67","000","00","034","3425","0919","853","325","528","34","887","1662","0","53.37","19.55"
"67","000","00","034","3425","0920","815","322","493","23","838","1634","0","51.29","19.71"
"67","000","00","034","3426","0000","2684","949","1735","161","2845","5387","0","52.81","17.62"
"67","000","00","034","3426","0923","960","344","616","57","1017","1874","0","54.27","18.36"
"67","000","00","034","3426","0924","880","304","576","42","922","1760","0","52.39","17.27"
"67","000","00","034","3426","0925","844","301","543","62","906","1753","0","51.68","17.17"
"67","000","00","034","3432","0000","713","264","449","50","763","1466","0","52.05","18.01"
"67","000","00","034","3432","0871","713","264","449","50","763","1466","0","52.05","18.01"
"67","000","00","034","3433","0000","910","329","581","90","1000","1829","0","54.67","17.99"
"67","000","00","034","3433","0884","456","147","309","55","511","892","0","57.29","16.48"
"67","000","00","034","3433","0885","454","182","272","35","489","937","0","52.19","19.42"
"67","000","00","034","3438","0000","1806","747","1059","44","1850","3800","0","48.68","19.66"
"67","000","00","034","3438","0852","505","211","294","9","514","997","0","51.55","21.16"
"67","000","00","034","3438","0853","637","274","363","16","653","1452","0","44.97","18.87"
"67","000","00","034","3438","0854","664","262","402","19","683","1351","0","50.56","19.39"
"67","000","00","034","3439","0000","1602","517","1085","81","1683","3079","0","54.66","16.79"
"67","000","00","034","3439","0872","815","271","544","38","853","1535","0","55.57","17.65"
"67","000","00","034","3439","0873","787","246","541","43","830","1544","0","53.76","15.93"
"67","000","00","034","3440","0000","2367","889","1478","108","2475","4317","0","57.33","20.59"
"67","000","00","034","3440","0905","743","252","491","51","794","1340","0","59.25","18.81"
"67","000","00","034","3440","0906","779","313","466","31","810","1464","0","55.33","21.38"
"67","000","00","034","3440","0907","845","324","521","26","871","1513","0","57.57","21.41"
"67","000","00","034","3441","0000","1606","580","1026","68","1674","2975","0","56.27","19.5"
"67","000","00","034","3441","0915","745","260","485","35","780","1391","0","56.07","18.69"
"67","000","00","034","3441","0916","861","320","541","33","894","1584","0","56.44","20.2"
"67","000","00","034","3442","0000","1984","700","1284","87","2071","3665","0","56.51","19.1"
"67","000","00","034","3442","0921","963","336","627","53","1016","1793","0","56.66","18.74"
"67","000","00","034","3442","0922","1021","364","657","34","1055","1872","0","56.36","19.44"
"67","000","00","034","3443","0000","1905","664","1241","47","1952","3596","0","54.28","18.46"
"67","000","00","034","3443","0929","1015","334","681","34","1049","1876","0","55.92","17.8"
"67","000","00","034","3443","0930","890","330","560","13","903","1720","0","52.5","19.19"
"67","000","00","034","3444","0000","2046","604","1442","128","2174","4008","0","54.24","15.07"
"67","000","00","034","3444","0864","633","196","437","61","694","1300","0","53.38","15.08"
"67","000","00","034","3444","0865","704","199","505","33","737","1390","0","53.02","14.32"
"67","000","00","034","3444","0866","709","209","500","34","743","1318","0","56.37","15.86"
"67","000","00","034","3445","0000","2014","681","1333","88","2102","3534","0","59.48","19.27"
"67","000","00","034","3445","0855","785","280","505","43","828","1323","0","62.59","21.16"
"67","000","00","034","3445","0856","592","192","400","20","612","1073","0","57.04","17.89"
"67","000","00","034","3445","0857","637","209","428","25","662","1138","0","58.17","18.37"
"67","000","00","034","3446","0000","2827","1112","1715","130","2957","5305","0","55.74","20.96"
"67","000","00","034","3446","0874","937","496","441","46","983","1760","0","55.85","28.18"
"67","000","00","034","3446","0875","686","229","457","20","706","1372","0","51.46","16.69"
"67","000","00","034","3446","0876","556","179","377","31","587","1002","0","58.58","17.86"
"67","000","00","034","3446","0877","648","208","440","33","681","1171","0","58.16","17.76"
"67","000","00","034","3447","0000","1963","670","1293","87","2050","3964","0","51.72","16.9"
"67","000","00","034","3447","0891","752","277","475","30","782","1522","0","51.38","18.2"
"67","000","00","034","3447","0892","647","214","433","19","666","1278","0","52.11","16.74"
"67","000","00","034","3447","0893","564","179","385","38","602","1164","0","51.72","15.38"
"67","000","00","034","3448","0000","2443","742","1701","126","2569","4860","0","52.86","15.27"
"67","000","00","034","3448","0878","613","195","418","21","634","1285","0","49.34","15.18"
"67","000","00","034","3448","0879","522","149","373","24","546","1036","0","52.7","14.38"
"67","000","00","034","3448","0880","709","224","485","40","749","1392","0","53.81","16.09"
"67","000","00","034","3448","0881","599","174","425","41","640","1147","0","55.8","15.17"
"67","000","00","034","3449","0000","1467","489","978","56","1523","3085","0","49.37","15.85"
"67","000","00","034","3449","0882","669","208","461","25","694","1526","0","45.48","13.63"
"67","000","00","034","3449","0883","798","281","517","31","829","1559","0","53.18","18.02"
"67","000","00","034","3450","0000","1352","506","846","56","1408","2797","0","50.34","18.09"
"67","000","00","034","3450","0889","670","243","427","45","715","1346","0","53.12","18.05"
"67","000","00","034","3450","0890","682","263","419","11","693","1451","0","47.76","18.13"
"67","000","00","034","3451","0000","1935","719","1216","108","2043","4176","0","48.92","17.22"
"67","000","00","034","3451","0886","787","281","506","46","833","1449","0","57.49","19.39"
"67","000","00","034","3451","0887","590","219","371","25","615","1160","0","53.02","18.88"
"67","000","00","034","3451","0888","558","219","339","37","595","1567","0","37.97","13.98"
"67","000","00","034","3452","0000","1741","671","1070","56","1797","3124","0","57.52","21.48"
"67","000","00","034","3452","0900","826","326","500","20","846","1469","0","57.59","22.19"
"67","000","00","034","3452","0901","915","345","570","36","951","1655","0","57.46","20.85"
"67","000","00","034","3453","0000","2273","829","1444","58","2331","4187","0","55.67","19.8"
"67","000","00","034","3453","0902","700","256","444","21","721","1261","0","57.18","20.3"
"67","000","00","034","3453","0903","764","270","494","13","777","1490","0","52.15","18.12"
"67","000","00","034","3453","0904","809","303","506","24","833","1436","0","58.01","21.1"
"67","000","00","034","3454","0000","1307","513","794","79","1386","2613","0","53.04","19.63"
"67","000","00","034","3454","0911","705","294","411","33","738","1399","0","52.75","21.02"
"67","000","00","034","3454","0912","602","219","383","46","648","1214","0","53.38","18.04"
"67","000","00","034","3455","0000","1253","517","736","51","1304","2212","0","58.95","23.37"
"67","000","00","034","3455","0913","585","239","346","15","600","1064","0","56.39","22.46"
"67","000","00","034","3455","0914","668","278","390","36","704","1148","0","61.32","24.22"
"67","000","00","034","3456","0000","1582","538","1044","51","1633","2992","0","54.58","17.98"
"67","000","00","034","3456","0917","868","297","571","24","892","1595","0","55.92","18.62"
"67","000","00","034","3456","0918","714","241","473","27","741","1397","0","53.04","17.25"
"67","000","00","035","0000","0000","79023","27446","51577","4606","83629","159654","193163","52.38","17.19"
"67","000","00","035","3501","0000","1319","527","792","26","1345","2549","0","52.77","20.67"
"67","000","00","035","3501","0618","1319","527","792","26","1345","2549","0","52.77","20.67"
"67","000","00","035","3502","0000","2208","794","1414","116","2324","4600","0","50.52","17.26"
"67","000","00","035","3502","0624","951","332","619","47","998","2143","0","46.57","15.49"
"67","000","00","035","3502","0625","1257","462","795","69","1326","2457","0","53.97","18.8"
"67","000","00","035","3503","0000","2272","756","1516","115","2387","4477","0","53.32","16.89"
"67","000","00","035","3503","0619","1136","372","764","57","1193","2321","0","51.4","16.03"
"67","000","00","035","3503","0620","1136","384","752","58","1194","2156","0","55.38","17.81"
"67","000","00","035","3504","0000","2503","797","1706","184","2687","4799","0","55.99","16.61"
"67","000","00","035","3504","0621","913","292","621","58","971","1662","0","58.42","17.57"
"67","000","00","035","3504","0622","816","250","566","75","891","1512","0","58.93","16.53"
"67","000","00","035","3504","0623","774","255","519","51","825","1625","0","50.77","15.69"
"67","000","00","035","3505","0000","2294","859","1435","139","2433","4512","0","53.92","19.04"
"67","000","00","035","3505","0626","1129","404","725","72","1201","2148","0","55.91","18.81"
"67","000","00","035","3505","0627","1165","455","710","67","1232","2364","0","52.12","19.25"
"67","000","00","035","3506","0000","1517","532","985","103","1620","2805","0","57.75","18.97"
"67","000","00","035","3506","0644","812","266","546","37","849","1447","0","58.67","18.38"
"67","000","00","035","3506","0645","705","266","439","66","771","1358","0","56.77","19.59"
"67","000","00","035","3507","0000","1859","706","1153","114","1973","3494","0","56.47","20.21"
"67","000","00","035","3507","0639","901","361","540","64","965","1721","0","56.07","20.98"
"67","000","00","035","3507","0640","958","345","613","50","1008","1773","0","56.85","19.46"
"67","000","00","035","3508","0000","2086","747","1339","103","2189","4546","0","48.15","16.43"
"67","000","00","035","3508","0631","974","360","614","63","1037","2291","0","45.26","15.71"
"67","000","00","035","3508","0632","1112","387","725","40","1152","2255","0","51.09","17.16"
"67","000","00","035","3509","0000","2928","958","1970","147","3075","5977","0","51.45","16.03"
"67","000","00","035","3509","0633","883","338","545","57","940","1940","0","48.45","17.42"
"67","000","00","035","3509","0634","1047","280","767","43","1090","2013","0","54.15","13.91"
"67","000","00","035","3509","0635","998","340","658","47","1045","2024","0","51.63","16.8"
"67","000","00","035","3510","0000","3042","1100","1942","135","3177","5933","0","53.55","18.54"
"67","000","00","035","3510","0628","869","380","489","40","909","1868","0","48.66","20.34"
"67","000","00","035","3510","0629","992","353","639","56","1048","1797","0","58.32","19.64"
"67","000","00","035","3510","0630","1181","367","814","39","1220","2268","0","53.79","16.18"
"67","000","00","035","3511","0000","1086","377","709","82","1168","2188","0","53.38","17.23"
"67","000","00","035","3511","0654","1086","377","709","82","1168","2188","0","53.38","17.23"
"67","000","00","035","3512","0000","952","321","631","83","1035","1835","0","56.4","17.49"
"67","000","00","035","3512","0659","952","321","631","83","1035","1835","0","56.4","17.49"
"67","000","00","035","3513","0000","2100","742","1358","133","2233","4646","0","48.06","15.97"
"67","000","00","035","3513","0655","1097","386","711","76","1173","2399","0","48.9","16.09"
"67","000","00","035","3513","0656","1003","356","647","57","1060","2247","0","47.17","15.84"
"67","000","00","035","3514","0000","665","220","445","54","719","1165","0","61.72","18.88"
"67","000","00","035","3514","0657","665","220","445","54","719","1165","0","61.72","18.88"
"67","000","00","035","3515","0000","2490","867","1623","146","2636","5476","0","48.14","15.83"
"67","000","00","035","3515","0670","666","226","440","42","708","1547","0","45.77","14.61"
"67","000","00","035","3515","0671","860","311","549","44","904","1784","0","50.67","17.43"
"67","000","00","035","3515","0672","964","330","634","60","1024","2145","0","47.74","15.38"
"67","000","00","035","3516","0000","1373","494","879","91","1464","2728","0","53.67","18.11"
"67","000","00","035","3516","0668","900","300","600","48","948","1763","0","53.77","17.02"
"67","000","00","035","3516","0669","473","194","279","43","516","965","0","53.47","20.1"
"67","000","00","035","3517","0000","1114","400","714","107","1221","1978","0","61.73","20.22"
"67","000","00","035","3517","0693","510","180","330","47","557","905","0","61.55","19.89"
"67","000","00","035","3517","0694","604","220","384","60","664","1073","0","61.88","20.5"
"67","000","00","035","3518","0000","3602","1248","2354","146","3748","7488","0","50.05","16.67"
"67","000","00","035","3518","0673","1279","471","808","51","1330","2443","0","54.44","19.28"
"67","000","00","035","3518","0674","1095","379","716","35","1130","2565","0","44.05","14.78"
"67","000","00","035","3518","0675","1228","398","830","60","1288","2480","0","51.94","16.05"
"67","000","00","035","3519","0000","569","197","372","53","622","977","0","63.66","20.16"
"67","000","00","035","3519","0662","569","197","372","53","622","977","0","63.66","20.16"
"67","000","00","035","3520","0000","2080","761","1319","140","2220","4517","0","49.15","16.85"
"67","000","00","035","3520","0676","983","363","620","76","1059","2349","0","45.08","15.45"
"67","000","00","035","3520","0677","1097","398","699","64","1161","2168","0","53.55","18.36"
"67","000","00","035","3521","0000","1526","571","955","109","1635","3228","0","50.65","17.69"
"67","000","00","035","3521","0666","647","225","422","53","700","1319","0","53.07","17.06"
"67","000","00","035","3521","0667","879","346","533","56","935","1909","0","48.98","18.12"
"67","000","00","035","3522","0000","1620","568","1052","87","1707","3339","0","51.12","17.01"
"67","000","00","035","3522","0663","733","255","478","34","767","1642","0","46.71","15.53"
"67","000","00","035","3522","0664","887","313","574","53","940","1697","0","55.39","18.44"
"67","000","00","035","3523","0000","903","299","604","48","951","1966","0","48.37","15.21"
"67","000","00","035","3523","0665","903","299","604","48","951","1966","0","48.37","15.21"
"67","000","00","035","3524","0000","833","263","570","47","880","1501","0","58.63","17.52"
"67","000","00","035","3524","0707","833","263","570","47","880","1501","0","58.63","17.52"
"67","000","00","035","3525","0000","907","297","610","66","973","1797","0","54.15","16.53"
"67","000","00","035","3525","0660","907","297","610","66","973","1797","0","54.15","16.53"
"67","000","00","035","3526","0000","1029","370","659","69","1098","2223","0","49.39","16.64"
"67","000","00","035","3526","0661","1029","370","659","69","1098","2223","0","49.39","16.64"
"67","000","00","035","3527","0000","856","269","587","58","914","1579","0","57.88","17.04"
"67","000","00","035","3527","0695","856","269","587","58","914","1579","0","57.88","17.04"
"67","000","00","035","3528","0000","688","256","432","33","721","1462","0","49.32","17.51"
"67","000","00","035","3528","0700","688","256","432","33","721","1462","0","49.32","17.51"
"67","000","00","035","3529","0000","568","172","396","50","618","1044","0","59.2","16.48"
"67","000","00","035","3529","0701","568","172","396","50","618","1044","0","59.2","16.48"
"67","000","00","035","3530","0000","1469","507","962","121","1590","3070","0","51.79","16.51"
"67","000","00","035","3530","0696","889","300","589","84","973","1876","0","51.87","15.99"
"67","000","00","035","3530","0697","580","207","373","37","617","1194","0","51.68","17.34"
"67","000","00","035","3531","0000","663","199","464","19","682","1380","0","49.42","14.42"
"67","000","00","035","3531","0699","663","199","464","19","682","1380","0","49.42","14.42"
"67","000","00","035","3532","0000","570","178","392","25","595","1475","0","40.34","12.07"
"67","000","00","035","3532","0698","570","178","392","25","595","1475","0","40.34","12.07"
"67","000","00","035","3533","0000","736","254","482","58","794","1293","0","61.41","19.64"
"67","000","00","035","3533","0702","357","134","223","38","395","603","0","65.51","22.22"
"67","000","00","035","3533","0703","379","120","259","20","399","690","0","57.83","17.39"
"67","000","00","035","3534","0000","680","238","442","43","723","1447","0","49.97","16.45"
"67","000","00","035","3534","0704","680","238","442","43","723","1447","0","49.97","16.45"
"67","000","00","035","3535","0000","566","175","391","32","598","910","0","65.71","19.23"
"67","000","00","035","3535","0705","566","175","391","32","598","910","0","65.71","19.23"
"67","000","00","035","3536","0000","827","264","563","67","894","1850","0","48.32","14.27"
"67","000","00","035","3536","0706","827","264","563","67","894","1850","0","48.32","14.27"
"67","000","00","035","3537","0000","1077","349","728","73","1150","2143","0","53.66","16.29"
"67","000","00","035","3537","0638","1077","349","728","73","1150","2143","0","53.66","16.29"
"67","000","00","035","3538","0000","1500","552","948","95","1595","2791","0","57.15","19.78"
"67","000","00","035","3538","0636","918","349","569","65","983","1613","0","60.94","21.64"
"67","000","00","035","3538","0637","582","203","379","30","612","1178","0","51.95","17.23"
"67","000","00","035","3539","0000","2295","850","1445","97","2392","4412","0","54.22","19.27"
"67","000","00","035","3539","0641","749","291","458","18","767","1428","0","53.71","20.38"
"67","000","00","035","3539","0642","846","284","562","45","891","1626","0","54.8","17.47"
"67","000","00","035","3539","0643","700","275","425","34","734","1358","0","54.05","20.25"
"67","000","00","035","3540","0000","1704","654","1050","132","1836","3120","0","58.85","20.96"
"67","000","00","035","3540","0680","943","400","543","76","1019","1627","0","62.63","24.59"
"67","000","00","035","3540","0681","761","254","507","56","817","1493","0","54.72","17.01"
"67","000","00","035","3541","0000","2157","741","1416","149","2306","4273","0","53.97","17.34"
"67","000","00","035","3541","0682","724","240","484","63","787","1397","0","56.34","17.18"
"67","000","00","035","3541","0683","694","237","457","50","744","1416","0","52.54","16.74"
"67","000","00","035","3541","0684","739","264","475","36","775","1460","0","53.08","18.08"
"67","000","00","035","3542","0000","1657","577","1080","85","1742","3661","0","47.58","15.76"
"67","000","00","035","3542","0691","797","297","500","55","852","1815","0","46.94","16.36"
"67","000","00","035","3542","0692","860","280","580","30","890","1846","0","48.21","15.17"
"67","000","00","035","3543","0000","2084","591","1493","74","2158","4437","0","48.64","13.32"
"67","000","00","035","3543","0646","1011","337","674","32","1043","2116","0","49.29","15.93"
"67","000","00","035","3543","0647","1073","254","819","42","1115","2321","0","48.04","10.94"
"67","000","00","035","3544","0000","1939","686","1253","84","2023","4044","0","50.02","16.96"
"67","000","00","035","3544","0648","1034","363","671","30","1064","2117","0","50.26","17.15"
"67","000","00","035","3544","0649","905","323","582","54","959","1927","0","49.77","16.76"
"67","000","00","035","3545","0000","2155","747","1408","124","2279","4576","0","49.8","16.32"
"67","000","00","035","3545","0650","1065","386","679","82","1147","2242","0","51.16","17.22"
"67","000","00","035","3545","0651","1090","361","729","42","1132","2334","0","48.5","15.47"
"67","000","00","035","3546","0000","1960","681","1279","97","2057","3809","0","54.0","17.88"
"67","000","00","035","3546","0686","1033","369","664","65","1098","2070","0","53.04","17.83"
"67","000","00","035","3546","0687","927","312","615","32","959","1739","0","55.15","17.94"
"67","000","00","035","3547","0000","1562","524","1038","72","1634","3305","0","49.44","15.85"
"67","000","00","035","3547","0678","803","269","534","42","845","1630","0","51.84","16.5"
"67","000","00","035","3547","0679","759","255","504","30","789","1675","0","47.1","15.22"
"67","000","00","035","3548","0000","735","251","484","42","777","1539","0","50.49","16.31"
"67","000","00","035","3548","0658","735","251","484","42","777","1539","0","50.49","16.31"
"67","000","00","035","3549","0000","976","324","652","34","1010","2222","0","45.45","14.58"
"67","000","00","035","3549","0685","976","324","652","34","1010","2222","0","45.45","14.58"
"67","000","00","035","3550","0000","2833","982","1851","180","3013","5433","0","55.46","18.07"
"67","000","00","035","3550","0688","877","302","575","65","942","1830","0","51.48","16.5"
"67","000","00","035","3550","0689","993","327","666","63","1056","1803","0","58.57","18.14"
"67","000","00","035","3550","0690","963","353","610","52","1015","1800","0","56.39","19.61"
"67","000","00","035","3551","0000","1889","654","1235","119","2008","3635","0","55.24","17.99"
"67","000","00","035","3551","0652","943","330","613","49","992","1822","0","54.45","18.11"
"67","000","00","035","3551","0653","946","324","622","70","1016","1813","0","56.04","17.87"
"67","000","00","036","0000","0000","27172","9779","17393","1048","28220","55379","66677","50.96","17.66"
"67","000","00","036","3602","0000","918","297","621","72","990","2001","0","49.48","14.84"
"67","000","00","036","3602","1014","918","297","621","72","990","2001","0","49.48","14.84"
"67","000","00","036","3604","0000","192","62","130","5","197","438","0","44.98","14.16"
"67","000","00","036","3604","1007","192","62","130","5","197","438","0","44.98","14.16"
"67","000","00","036","3605","0000","2438","859","1579","87","2525","4954","0","50.97","17.34"
"67","000","00","036","3605","0986","1210","394","816","56","1266","2547","0","49.71","15.47"
"67","000","00","036","3605","0987","1228","465","763","31","1259","2407","0","52.31","19.32"
"67","000","00","036","3606","0000","2034","756","1278","58","2092","4202","0","49.79","17.99"
"67","000","00","036","3606","0988","937","355","582","32","969","2070","0","46.81","17.15"
"67","000","00","036","3606","0989","1097","401","696","26","1123","2132","0","52.67","18.81"
"67","000","00","036","3607","0000","2476","879","1597","78","2554","4810","0","53.1","18.27"
"67","000","00","036","3607","0990","785","261","524","14","799","1450","0","55.1","18.0"
"67","000","00","036","3607","0991","790","308","482","18","808","1605","0","50.34","19.19"
"67","000","00","036","3607","0992","901","310","591","46","947","1755","0","53.96","17.66"
"67","000","00","036","3608","0000","3302","1198","2104","131","3433","7011","0","48.97","17.09"
"67","000","00","036","3608","0993","791","276","515","24","815","1728","0","47.16","15.97"
"67","000","00","036","3608","0994","721","262","459","27","748","1754","0","42.65","14.94"
"67","000","00","036","3608","0995","831","331","500","41","872","1686","0","51.72","19.63"
"67","000","00","036","3608","0996","959","329","630","39","998","1843","0","54.15","17.85"
"67","000","00","036","3609","0000","2635","938","1697","113","2748","4994","0","55.03","18.78"
"67","000","00","036","3609","0983","924","326","598","46","970","1753","0","55.33","18.6"
"67","000","00","036","3609","0984","926","355","571","36","962","1859","0","51.75","19.1"
"67","000","00","036","3609","0985","785","257","528","31","816","1382","0","59.04","18.6"
"67","000","00","036","3610","0000","3441","1352","2089","114","3555","6842","0","51.96","19.76"
"67","000","00","036","3610","1003","894","349","545","32","926","1675","0","55.28","20.84"
"67","000","00","036","3610","1004","987","399","588","38","1025","1979","0","51.79","20.16"
"67","000","00","036","3610","1005","782","298","484","17","799","1602","0","49.88","18.6"
"67","000","00","036","3610","1006","778","306","472","27","805","1586","0","50.76","19.29"
"67","000","00","036","3611","0000","3597","1296","2301","90","3687","7611","0","48.44","17.03"
"67","000","00","036","3611","0999","796","328","468","14","810","1653","0","49.0","19.84"
"67","000","00","036","3611","1000","815","271","544","16","831","1697","0","48.97","15.97"
"67","000","00","036","3611","1001","984","355","629","33","1017","2154","0","47.21","16.48"
"67","000","00","036","3611","1002","1002","342","660","27","1029","2107","0","48.84","16.23"
"67","000","00","036","3612","0000","1545","569","976","45","1590","2853","0","55.73","19.94"
"67","000","00","036","3612","0997","857","315","542","31","888","1565","0","56.74","20.13"
"67","000","00","036","3612","0998","688","254","434","14","702","1288","0","54.5","19.72"
"67","000","00","036","3615","0000","1621","625","996","82","1703","3403","0","50.04","18.37"
"67","000","00","036","3615","1008","854","334","520","48","902","1780","0","50.67","18.76"
"67","000","00","036","3615","1009","767","291","476","34","801","1623","0","49.35","17.93"
"67","000","00","036","3616","0000","1626","547","1079","106","1732","3443","0","50.3","15.89"
"67","000","00","036","3616","1010","998","334","664","71","1069","2157","0","49.56","15.48"
"67","000","00","036","3616","1011","628","213","415","35","663","1286","0","51.56","16.56"
"67","000","00","036","3617","0000","1347","401","946","67","1414","2817","0","50.2","14.24"
"67","000","00","036","3617","1012","745","230","515","44","789","1492","0","52.88","15.42"
"67","000","00","036","3617","1013","602","171","431","23","625","1325","0","47.17","12.91"
"67","000","00","037","0000","0000","34413","12476","21937","1793","36206","65261","78093","55.48","19.12"
"67","000","00","037","3705","0000","2030","708","1322","109","2139","3854","0","55.5","18.37"
"67","000","00","037","3705","0931","695","285","410","45","740","1332","0","55.56","21.4"
"67","000","00","037","3705","0932","693","227","466","28","721","1246","0","57.87","18.22"
"67","000","00","037","3705","0933","642","196","446","36","678","1276","0","53.13","15.36"
"67","000","00","037","3707","0000","1681","678","1003","60","1741","3047","0","57.14","22.25"
"67","000","00","037","3707","0934","868","352","516","35","903","1583","0","57.04","22.24"
"67","000","00","037","3707","0935","813","326","487","25","838","1464","0","57.24","22.27"
"67","000","00","037","3709","0000","1393","530","863","43","1436","2602","0","55.19","20.37"
"67","000","00","037","3709","0936","637","252","385","11","648","1234","0","52.51","20.42"
"67","000","00","037","3709","0937","756","278","478","32","788","1368","0","57.6","20.32"
"67","000","00","037","3711","0000","1122","361","761","67","1189","2538","0","46.85","14.22"
"67","000","00","037","3711","0938","516","130","386","30","546","1322","0","41.3","9.83"
"67","000","00","037","3711","0939","606","231","375","37","643","1216","0","52.88","19.0"
"67","000","00","037","3716","0000","1339","465","874","59","1398","2526","0","55.34","18.41"
"67","000","00","037","3716","0940","665","249","416","28","693","1289","0","53.76","19.32"
"67","000","00","037","3716","0941","674","216","458","31","705","1237","0","56.99","17.46"
"67","000","00","037","3722","0000","1770","643","1127","120","1890","3455","0","54.7","18.61"
"67","000","00","037","3722","0942","543","202","341","27","570","1189","0","47.94","16.99"
"67","000","00","037","3722","0943","631","221","410","53","684","1201","0","56.95","18.4"
"67","000","00","037","3722","0944","596","220","376","40","636","1065","0","59.72","20.66"
"67","000","00","037","3725","0000","2014","721","1293","107","2121","3505","0","60.51","20.57"
"67","000","00","037","3725","0945","563","189","374","52","615","1055","0","58.29","17.91"
"67","000","00","037","3725","0946","686","280","406","28","714","1170","0","61.03","23.93"
"67","000","00","037","3725","0947","765","252","513","27","792","1280","0","61.88","19.69"
"67","000","00","037","3731","0000","1381","486","895","68","1449","2515","0","57.61","19.32"
"67","000","00","037","3731","0948","671","249","422","24","695","1223","0","56.83","20.36"
"67","000","00","037","3731","0949","710","237","473","44","754","1292","0","58.36","18.34"
"67","000","00","037","3733","0000","3005","1158","1847","105","3110","5398","0","57.61","21.45"
"67","000","00","037","3733","0950","574","213","361","15","589","993","0","59.32","21.45"
"67","000","00","037","3733","0951","808","321","487","38","846","1541","0","54.9","20.83"
"67","000","00","037","3733","0952","952","371","581","35","987","1652","0","59.75","22.46"
"67","000","00","037","3733","0953","671","253","418","17","688","1212","0","56.77","20.87"
"67","000","00","037","3734","0000","2609","939","1670","139","2748","4876","0","56.36","19.26"
"67","000","00","037","3734","0954","876","321","555","70","946","1621","0","58.36","19.8"
"67","000","00","037","3734","0955","906","350","556","30","936","1660","0","56.39","21.08"
"67","000","00","037","3734","0956","827","268","559","39","866","1595","0","54.29","16.8"
"67","000","00","037","3739","0000","1925","660","1265","96","2021","3557","0","56.82","18.55"
"67","000","00","037","3739","0957","736","275","461","32","768","1436","0","53.48","19.15"
"67","000","00","037","3739","0958","689","235","454","37","726","1265","0","57.39","18.58"
"67","000","00","037","3739","0959","500","150","350","27","527","856","0","61.57","17.52"
"67","000","00","037","3740","0000","1814","672","1142","106","1920","3297","0","58.23","20.38"
"67","000","00","037","3740","0960","597","202","395","31","628","1168","0","53.77","17.29"
"67","000","00","037","3740","0961","631","251","380","37","668","1134","0","58.91","22.13"
"67","000","00","037","3740","0962","586","219","367","38","624","995","0","62.71","22.01"
"67","000","00","037","3741","0000","1521","530","991","53","1574","2578","0","61.06","20.56"
"67","000","00","037","3741","0963","791","256","535","23","814","1313","0","62.0","19.5"
"67","000","00","037","3741","0964","730","274","456","30","760","1265","0","60.08","21.66"
"67","000","00","037","3742","0000","1614","605","1009","110","1724","3150","0","54.73","19.21"
"67","000","00","037","3742","0965","617","233","384","34","651","1215","0","53.58","19.18"
"67","000","00","037","3742","0966","648","231","417","43","691","1248","0","55.37","18.51"
"67","000","00","037","3742","0967","349","141","208","33","382","687","0","55.6","20.52"
"67","000","00","037","3743","0000","1112","400","712","94","1206","2110","0","57.16","18.96"
"67","000","00","037","3743","0968","581","214","367","58","639","1139","0","56.1","18.79"
"67","000","00","037","3743","0969","531","186","345","36","567","971","0","58.39","19.16"
"67","000","00","037","3744","0000","1899","681","1218","113","2012","3978","0","50.58","17.12"
"67","000","00","037","3744","0970","508","177","331","42","550","1254","0","43.86","14.11"
"67","000","00","037","3744","0971","532","187","345","35","567","979","0","57.92","19.1"
"67","000","00","037","3744","0972","859","317","542","36","895","1745","0","51.29","18.17"
"67","000","00","037","3745","0000","1241","445","796","72","1313","2510","0","52.31","17.73"
"67","000","00","037","3745","0973","550","192","358","36","586","1074","0","54.56","17.88"
"67","000","00","037","3745","0974","691","253","438","36","727","1436","0","50.63","17.62"
"67","000","00","037","3746","0000","1080","423","657","63","1143","2029","0","56.33","20.85"
"67","000","00","037","3746","0975","474","190","284","30","504","865","0","58.27","21.97"
"67","000","00","037","3746","0976","606","233","373","33","639","1164","0","54.9","20.02"
"67","000","00","037","3747","0000","1906","686","1220","96","2002","4067","0","49.23","16.87"
"67","000","00","037","3747","0977","604","239","365","29","633","1285","0","49.26","18.6"
"67","000","00","037","3747","0978","561","186","375","33","594","1078","0","55.1","17.25"
"67","000","00","037","3747","0979","741","261","480","34","775","1704","0","45.48","15.32"
"67","000","00","037","3748","0000","1957","685","1272","113","2070","3669","0","56.42","18.67"
"67","000","00","037","3748","0980","701","235","466","55","756","1296","0","58.33","18.13"
"67","000","00","037","3748","0981","591","208","383","36","627","1128","0","55.59","18.44"
"67","000","00","037","3748","0982","665","242","423","22","687","1245","0","55.18","19.44"
"64","000","00","000","0000","0000","1306583","436565","870018","78331","1384914","2353342","2772624","58.85","18.55"
"64","000","00","001","0000","0000","11890","4613","7277","575","12465","21617","24098","57.66","21.34"
"64","000","00","001","0101","0000","770","283","487","48","818","1304","0","62.73","21.7"
"64","000","00","001","0101","0845","770","283","487","48","818","1304","0","62.73","21.7"
"64","000","00","001","0102","0000","196","77","119","25","221","357","0","61.9","21.57"
"64","000","00","001","0102","0846","196","77","119","25","221","357","0","61.9","21.57"
"64","000","00","001","0103","0000","361","138","223","26","387","651","0","59.45","21.2"
"64","000","00","001","0103","0847","361","138","223","26","387","651","0","59.45","21.2"
"64","000","00","001","0104","0000","642","219","423","28","670","1322","0","50.68","16.57"
"64","000","00","001","0104","0848","642","219","423","28","670","1322","0","50.68","16.57"
"64","000","00","001","0105","0000","613","439","174","23","636","1056","0","60.23","41.57"
"64","000","00","001","0105","0849","613","439","174","23","636","1056","0","60.23","41.57"
"64","000","00","001","0106","0000","1163","422","741","42","1205","2034","0","59.24","20.75"
"64","000","00","001","0106","0850","553","220","333","11","564","904","0","62.39","24.34"
"64","000","00","001","0106","0851","610","202","408","31","641","1130","0","56.73","17.88"
"64","000","00","001","0107","0000","499","163","336","18","517","840","0","61.55","19.4"
"64","000","00","001","0107","0852","499","163","336","18","517","840","0","61.55","19.4"
"64","000","00","001","0108","0000","412","166","246","27","439","616","0","71.27","26.95"
"64","000","00","001","0108","0853","412","166","246","27","439","616","0","71.27","26.95"
"64","000","00","001","0109","0000","704","294","410","36","740","1397","0","52.97","21.05"
"64","000","00","001","0109","0854","704","294","410","36","740","1397","0","52.97","21.05"
"64","000","00","001","0110","0000","431","159","272","16","447","766","0","58.36","20.76"
"64","000","00","001","0110","0855","431","159","272","16","447","766","0","58.36","20.76"
"64","000","00","001","0111","0000","967","358","609","55","1022","1644","0","62.17","21.78"
"64","000","00","001","0111","0856","480","198","282","35","515","839","0","61.38","23.6"
"64","000","00","001","0111","0857","487","160","327","20","507","805","0","62.98","19.88"
"64","000","00","001","0112","0000","397","144","253","15","412","750","0","54.93","19.2"
"64","000","00","001","0112","0858","397","144","253","15","412","750","0","54.93","19.2"
"64","000","00","001","0113","0000","537","199","338","26","563","986","0","57.1","20.18"
"64","000","00","001","0113","0859","537","199","338","26","563","986","0","57.1","20.18"
"64","000","00","001","0114","0000","559","192","367","9","568","1068","0","53.18","17.98"
"64","000","00","001","0114","0860","559","192","367","9","568","1068","0","53.18","17.98"
"64","000","00","001","0115","0000","593","225","368","43","636","1060","0","60.0","21.23"
"64","000","00","001","0115","0861","593","225","368","43","636","1060","0","60.0","21.23"
"64","000","00","001","0116","0000","435","148","287","25","460","805","0","57.14","18.39"
"64","000","00","001","0116","0862","435","148","287","25","460","805","0","57.14","18.39"
"64","000","00","001","0117","0000","981","382","599","47","1028","1994","0","51.55","19.16"
"64","000","00","001","0117","0863","526","205","321","22","548","1073","0","51.07","19.11"
"64","000","00","001","0117","0864","455","177","278","25","480","921","0","52.12","19.22"
"64","000","00","001","0118","0000","627","238","389","18","645","1171","0","55.08","20.32"
"64","000","00","001","0118","0865","627","238","389","18","645","1171","0","55.08","20.32"
"64","000","00","001","0119","0000","349","134","215","11","360","594","0","60.61","22.56"
"64","000","00","001","0119","0866","349","134","215","11","360","594","0","60.61","22.56"
"64","000","00","001","0120","0000","348","120","228","19","367","592","0","61.99","20.27"
"64","000","00","001","0120","0867","348","120","228","19","367","592","0","61.99","20.27"
"64","000","00","001","0121","0000","306","113","193","18","324","610","0","53.11","18.52"
"64","000","00","001","0121","0868","306","113","193","18","324","610","0","53.11","18.52"
"64","000","00","002","0000","0000","65320","22321","42999","3097","68417","114979","139894","59.5","19.41"
"64","000","00","002","0201","0000","1112","386","726","69","1181","1959","0","60.29","19.7"
"64","000","00","002","0201","0768","486","154","332","27","513","959","0","53.49","16.06"
"64","000","00","002","0201","0769","626","232","394","42","668","1000","0","66.8","23.2"
"64","000","00","002","0202","0000","1194","354","840","48","1242","1995","0","62.26","17.74"
"64","000","00","002","0202","0770","520","144","376","11","531","910","0","58.35","15.82"
"64","000","00","002","0202","0771","674","210","464","37","711","1085","0","65.53","19.35"
"64","000","00","002","0203","0000","2311","720","1591","119","2430","4147","0","58.6","17.36"
"64","000","00","002","0203","0772","694","236","458","47","741","1484","0","49.93","15.9"
"64","000","00","002","0203","0773","818","246","572","22","840","1393","0","60.3","17.66"
"64","000","00","002","0203","0774","799","238","561","50","849","1270","0","66.85","18.74"
"64","000","00","002","0204","0000","1956","645","1311","104","2060","3402","0","60.55","18.96"
"64","000","00","002","0204","0775","589","205","384","29","618","1055","0","58.58","19.43"
"64","000","00","002","0204","0776","660","220","440","29","689","1172","0","58.79","18.77"
"64","000","00","002","0204","0777","707","220","487","46","753","1175","0","64.09","18.72"
"64","000","00","002","0205","0000","724","256","468","36","760","1274","0","59.65","20.09"
"64","000","00","002","0205","0778","724","256","468","36","760","1274","0","59.65","20.09"
"64","000","00","002","0206","0000","541","191","350","37","578","1085","0","53.27","17.6"
"64","000","00","002","0206","0779","541","191","350","37","578","1085","0","53.27","17.6"
"64","000","00","002","0207","0000","1407","480","927","89","1496","2444","0","61.21","19.64"
"64","000","00","002","0207","0780","802","276","526","48","850","1470","0","57.82","18.78"
"64","000","00","002","0207","0781","605","204","401","41","646","974","0","66.32","20.94"
"64","000","00","002","0208","0000","2112","699","1413","145","2257","3719","0","60.69","18.8"
"64","000","00","002","0208","0782","731","256","475","66","797","1275","0","62.51","20.08"
"64","000","00","002","0208","0783","661","206","455","52","713","1206","0","59.12","17.08"
"64","000","00","002","0208","0784","720","237","483","27","747","1238","0","60.34","19.14"
"64","000","00","002","0209","0000","483","91","392","15","498","721","0","69.07","12.62"
"64","000","00","002","0209","0785","483","91","392","15","498","721","0","69.07","12.62"
"64","000","00","002","0210","0000","657","223","434","27","684","1220","0","56.07","18.28"
"64","000","00","002","0210","0786","657","223","434","27","684","1220","0","56.07","18.28"
"64","000","00","002","0211","0000","941","323","618","41","982","1966","0","49.95","16.43"
"64","000","00","002","0211","0787","941","323","618","41","982","1966","0","49.95","16.43"
"64","000","00","002","0212","0000","1780","599","1181","106","1886","3442","0","54.79","17.4"
"64","000","00","002","0212","0788","877","286","591","79","956","1722","0","55.52","16.61"
"64","000","00","002","0212","0789","903","313","590","27","930","1720","0","54.07","18.2"
"64","000","00","002","0213","0000","1358","387","971","102","1460","2656","0","54.97","14.57"
"64","000","00","002","0213","0790","752","259","493","73","825","1287","0","64.1","20.12"
"64","000","00","002","0213","0791","606","128","478","29","635","1369","0","46.38","9.35"
"64","000","00","002","0214","0000","1738","554","1184","64","1802","2992","0","60.23","18.52"
"64","000","00","002","0214","0792","785","231","554","22","807","1222","0","66.04","18.9"
"64","000","00","002","0214","0793","953","323","630","42","995","1770","0","56.21","18.25"
"64","000","00","002","0215","0000","8725","3091","5634","287","9012","14867","0","60.62","20.79"
"64","000","00","002","0215","0794","1046","371","675","30","1076","1860","0","57.85","19.95"
"64","000","00","002","0215","0795","1030","376","654","44","1074","1857","0","57.84","20.25"
"64","000","00","002","0215","0796","1082","378","704","29","1111","1841","0","60.35","20.53"
"64","000","00","002","0215","0797","1085","384","701","42","1127","1830","0","61.58","20.98"
"64","000","00","002","0215","0798","1032","366","666","51","1083","1809","0","59.87","20.23"
"64","000","00","002","0215","0799","1126","413","713","39","1165","1894","0","61.51","21.81"
"64","000","00","002","0215","0800","1143","385","758","18","1161","1882","0","61.69","20.46"
"64","000","00","002","0215","0801","1181","418","763","34","1215","1894","0","64.15","22.07"
"64","000","00","002","0216","0000","12592","4594","7998","356","12948","20876","0","62.02","22.01"
"64","000","00","002","0216","0802","972","302","670","38","1010","1745","0","57.88","17.31"
"64","000","00","002","0216","0803","1044","395","649","18","1062","1887","0","56.28","20.93"
"64","000","00","002","0216","0804","1193","442","751","35","1228","1891","0","64.94","23.37"
"64","000","00","002","0216","0805","1136","398","738","35","1171","1903","0","61.53","20.91"
"64","000","00","002","0216","0806","1189","451","738","30","1219","1998","0","61.01","22.57"
"64","000","00","002","0216","0807","1093","401","692","35","1128","1912","0","59.0","20.97"
"64","000","00","002","0216","0808","1157","406","751","50","1207","1923","0","62.77","21.11"
"64","000","00","002","0216","0809","1135","451","684","26","1161","1888","0","61.49","23.89"
"64","000","00","002","0216","0810","1150","403","747","24","1174","1873","0","62.68","21.52"
"64","000","00","002","0216","0811","1326","549","777","23","1349","1959","0","68.86","28.02"
"64","000","00","002","0216","0812","1197","396","801","42","1239","1897","0","65.31","20.88"
"64","000","00","002","0217","0000","9474","3314","6160","251","9725","16100","0","60.4","20.58"
"64","000","00","002","0217","0813","1404","497","907","35","1439","2362","0","60.92","21.04"
"64","000","00","002","0217","0814","1122","381","741","26","1148","1850","0","62.05","20.59"
"64","000","00","002","0217","0815","1161","418","743","30","1191","1928","0","61.77","21.68"
"64","000","00","002","0217","0816","1092","365","727","29","1121","1937","0","57.87","18.84"
"64","000","00","002","0217","0817","1197","443","754","50","1247","2123","0","58.74","20.87"
"64","000","00","002","0217","0818","1141","356","785","19","1160","1861","0","62.33","19.13"
"64","000","00","002","0217","0819","1096","373","723","25","1121","1892","0","59.25","19.71"
"64","000","00","002","0217","0820","1261","481","780","37","1298","2147","0","60.46","22.4"
"64","000","00","002","0218","0000","2309","787","1522","73","2382","3938","0","60.49","19.98"
"64","000","00","002","0218","0821","1137","382","755","32","1169","1897","0","61.62","20.14"
"64","000","00","002","0218","0822","1172","405","767","41","1213","2041","0","59.43","19.84"
"64","000","00","002","0219","0000","1815","579","1236","99","1914","3176","0","60.26","18.23"
"64","000","00","002","0219","0823","733","229","504","55","788","1309","0","60.2","17.49"
"64","000","00","002","0219","0824","1082","350","732","44","1126","1867","0","60.31","18.75"
"64","000","00","002","0220","0000","1625","496","1129","69","1694","2556","0","66.28","19.41"
"64","000","00","002","0220","0825","760","236","524","23","783","1152","0","67.97","20.49"
"64","000","00","002","0220","0826","865","260","605","46","911","1404","0","64.89","18.52"
"64","000","00","002","0221","0000","499","167","332","19","518","1210","0","42.81","13.8"
"64","000","00","002","0221","0827","499","167","332","19","518","1210","0","42.81","13.8"
"64","000","00","002","0222","0000","623","223","400","41","664","1135","0","58.5","19.65"
"64","000","00","002","0222","0828","623","223","400","41","664","1135","0","58.5","19.65"
"64","000","00","002","0223","0000","600","212","388","72","672","1831","0","36.7","11.58"
"64","000","00","002","0223","0829","600","212","388","72","672","1831","0","36.7","11.58"
"64","000","00","002","0224","0000","707","231","476","59","766","1288","0","59.47","17.93"
"64","000","00","002","0224","0830","707","231","476","59","766","1288","0","59.47","17.93"
"64","000","00","002","0225","0000","660","202","458","36","696","1241","0","56.08","16.28"
"64","000","00","002","0225","0831","660","202","458","36","696","1241","0","56.08","16.28"
"64","000","00","002","0226","0000","766","273","493","55","821","1342","0","61.18","20.34"
"64","000","00","002","0226","0832","766","273","493","55","821","1342","0","61.18","20.34"
"64","000","00","002","0227","0000","777","258","519","104","881","1422","0","61.95","18.14"
"64","000","00","002","0227","0833","777","258","519","104","881","1422","0","61.95","18.14"
"64","000","00","002","0228","0000","829","265","564","92","921","1453","0","63.39","18.24"
"64","000","00","002","0228","0834","829","265","564","92","921","1453","0","63.39","18.24"
"64","000","00","002","0229","0000","365","117","248","40","405","616","0","65.75","18.99"
"64","000","00","002","0229","0835","365","117","248","40","405","616","0","65.75","18.99"
"64","000","00","002","0230","0000","442","150","292","60","502","834","0","60.19","17.99"
"64","000","00","002","0230","0836","442","150","292","60","502","834","0","60.19","17.99"
"64","000","00","002","0231","0000","518","171","347","59","577","969","0","59.55","17.65"
"64","000","00","002","0231","0837","518","171","347","59","577","969","0","59.55","17.65"
"64","000","00","002","0232","0000","511","187","324","74","585","978","0","59.82","19.12"
"64","000","00","002","0232","0838","511","187","324","74","585","978","0","59.82","19.12"
"64","000","00","002","0233","0000","450","166","284","52","502","760","0","66.05","21.84"
"64","000","00","002","0233","0839","450","166","284","52","502","760","0","66.05","21.84"
"64","000","00","002","0234","0000","677","243","434","67","744","1248","0","59.62","19.47"
"64","000","00","002","0234","0840","677","243","434","67","744","1248","0","59.62","19.47"
"64","000","00","002","0235","0000","587","199","388","25","612","1143","0","53.54","17.41"
"64","000","00","002","0235","0841","587","199","388","25","612","1143","0","53.54","17.41"
"64","000","00","002","0236","0000","622","231","391","75","697","1358","0","51.33","17.01"
"64","000","00","002","0236","0842","622","231","391","75","697","1358","0","51.33","17.01"
"64","000","00","002","0237","0000","523","162","361","20","543","1036","0","52.41","15.64"
"64","000","00","002","0237","0843","523","162","361","20","543","1036","0","52.41","15.64"
"64","000","00","002","0238","0000","310","95","215","10","320","580","0","55.17","16.38"
"64","000","00","002","0238","0844","310","95","215","10","320","580","0","55.17","16.38"
"64","000","00","003","0000","0000","94271","30605","63666","3966","98237","161367","196749","60.88","18.97"
"64","000","00","003","0301","0000","837","260","577","58","895","2604","0","34.37","9.98"
"64","000","00","003","0301","0534","837","260","577","58","895","2604","0","34.37","9.98"
"64","000","00","003","0302","0000","573","190","383","72","645","1037","0","62.2","18.32"
"64","000","00","003","0302","0535","573","190","383","72","645","1037","0","62.2","18.32"
"64","000","00","003","0303","0000","315","119","196","42","357","542","0","65.87","21.96"
"64","000","00","003","0303","0536","315","119","196","42","357","542","0","65.87","21.96"
"64","000","00","003","0304","0000","340","108","232","51","391","635","0","61.57","17.01"
"64","000","00","003","0304","0537","340","108","232","51","391","635","0","61.57","17.01"
"64","000","00","003","0305","0000","253","95","158","11","264","518","0","50.97","18.34"
"64","000","00","003","0305","0538","253","95","158","11","264","518","0","50.97","18.34"
"64","000","00","003","0306","0000","409","152","257","51","460","813","0","56.58","18.7"
"64","000","00","003","0306","0539","409","152","257","51","460","813","0","56.58","18.7"
"64","000","00","003","0307","0000","468","154","314","69","537","889","0","60.4","17.32"
"64","000","00","003","0307","0540","468","154","314","69","537","889","0","60.4","17.32"
"64","000","00","003","0308","0000","405","147","258","66","471","731","0","64.43","20.11"
"64","000","00","003","0308","0541","405","147","258","66","471","731","0","64.43","20.11"
"64","000","00","003","0309","0000","1752","596","1156","81","1833","3301","0","55.53","18.06"
"64","000","00","003","0309","0542","775","267","508","43","818","1592","0","51.38","16.77"
"64","000","00","003","0309","0543","977","329","648","38","1015","1709","0","59.39","19.25"
"64","000","00","003","0311","0000","854","212","642","69","923","1588","0","58.12","13.35"
"64","000","00","003","0311","0544","854","212","642","69","923","1588","0","58.12","13.35"
"64","000","00","003","0312","0000","192","48","144","10","202","358","0","56.42","13.41"
"64","000","00","003","0312","0545","192","48","144","10","202","358","0","56.42","13.41"
"64","000","00","003","0313","0000","442","77","365","15","457","666","0","68.62","11.56"
"64","000","00","003","0313","0546","442","77","365","15","457","666","0","68.62","11.56"
"64","000","00","003","0315","0000","949","283","666","61","1010","1748","0","57.78","16.19"
"64","000","00","003","0315","0547","949","283","666","61","1010","1748","0","57.78","16.19"
"64","000","00","003","0316","0000","1448","415","1033","115","1563","2436","0","64.16","17.04"
"64","000","00","003","0316","0548","712","184","528","55","767","1196","0","64.13","15.38"
"64","000","00","003","0316","0549","736","231","505","60","796","1240","0","64.19","18.63"
"64","000","00","003","0317","0000","1562","295","1267","67","1629","2575","0","63.26","11.46"
"64","000","00","003","0317","0550","845","175","670","34","879","1402","0","62.7","12.48"
"64","000","00","003","0317","0551","717","120","597","33","750","1173","0","63.94","10.23"
"64","000","00","003","0319","0000","449","115","334","13","462","641","0","72.07","17.94"
"64","000","00","003","0319","0552","449","115","334","13","462","641","0","72.07","17.94"
"64","000","00","003","0321","0000","508","191","317","40","548","951","0","57.62","20.08"
"64","000","00","003","0321","0553","508","191","317","40","548","951","0","57.62","20.08"
"64","000","00","003","0322","0000","399","146","253","32","431","732","0","58.88","19.95"
"64","000","00","003","0322","0554","399","146","253","32","431","732","0","58.88","19.95"
"64","000","00","003","0323","0000","174","56","118","12","186","339","0","54.87","16.52"
"64","000","00","003","0323","0555","174","56","118","12","186","339","0","54.87","16.52"
"64","000","00","003","0324","0000","294","89","205","12","306","519","0","58.96","17.15"
"64","000","00","003","0324","0556","294","89","205","12","306","519","0","58.96","17.15"
"64","000","00","003","0325","0000","294","114","180","48","342","514","0","66.54","22.18"
"64","000","00","003","0325","0557","294","114","180","48","342","514","0","66.54","22.18"
"64","000","00","003","0326","0000","415","117","298","50","465","720","0","64.58","16.25"
"64","000","00","003","0326","0558","415","117","298","50","465","720","0","64.58","16.25"
"64","000","00","003","0327","0000","231","80","151","38","269","411","0","65.45","19.46"
"64","000","00","003","0327","0559","231","80","151","38","269","411","0","65.45","19.46"
"64","000","00","003","0328","0000","361","139","222","42","403","603","0","66.83","23.05"
"64","000","00","003","0328","0560","361","139","222","42","403","603","0","66.83","23.05"
"64","000","00","003","0329","0000","504","188","316","64","568","904","0","62.83","20.8"
"64","000","00","003","0329","0561","504","188","316","64","568","904","0","62.83","20.8"
"64","000","00","003","0330","0000","663","161","502","39","702","1318","0","53.26","12.22"
"64","000","00","003","0330","0562","663","161","502","39","702","1318","0","53.26","12.22"
"64","000","00","003","0331","0000","504","179","325","24","528","966","0","54.66","18.53"
"64","000","00","003","0331","0563","504","179","325","24","528","966","0","54.66","18.53"
"64","000","00","003","0332","0000","3267","803","2464","155","3422","5792","0","59.08","13.86"
"64","000","00","003","0332","0564","788","246","542","30","818","1440","0","56.81","17.08"
"64","000","00","003","0332","0565","1084","250","834","37","1121","1990","0","56.33","12.56"
"64","000","00","003","0332","0566","652","144","508","31","683","1090","0","62.66","13.21"
"64","000","00","003","0332","0567","743","163","580","57","800","1272","0","62.89","12.81"
"64","000","00","003","0334","0000","1929","574","1355","43","1972","3059","0","64.47","18.76"
"64","000","00","003","0334","0568","982","230","752","22","1004","1558","0","64.44","14.76"
"64","000","00","003","0334","0569","947","344","603","21","968","1501","0","64.49","22.92"
"64","000","00","003","0335","0000","242","79","163","7","249","360","0","69.17","21.94"
"64","000","00","003","0335","0570","242","79","163","7","249","360","0","69.17","21.94"
"64","000","00","003","0336","0000","1554","342","1212","42","1596","2694","0","59.24","12.69"
"64","000","00","003","0336","0571","761","145","616","25","786","1335","0","58.88","10.86"
"64","000","00","003","0336","0572","793","197","596","17","810","1359","0","59.6","14.5"
"64","000","00","003","0337","0000","894","243","651","41","935","1487","0","62.88","16.34"
"64","000","00","003","0337","0573","894","243","651","41","935","1487","0","62.88","16.34"
"64","000","00","003","0338","0000","909","195","714","49","958","1637","0","58.52","11.91"
"64","000","00","003","0338","0574","909","195","714","49","958","1637","0","58.52","11.91"
"64","000","00","003","0339","0000","7830","2746","5084","315","8145","13089","0","62.23","20.98"
"64","000","00","003","0339","0575","941","327","614","39","980","1553","0","63.1","21.06"
"64","000","00","003","0339","0576","961","351","610","50","1011","1564","0","64.64","22.44"
"64","000","00","003","0339","0577","1130","387","743","42","1172","1788","0","65.55","21.64"
"64","000","00","003","0339","0578","1170","409","761","74","1244","2028","0","61.34","20.17"
"64","000","00","003","0339","0579","1158","443","715","15","1173","2037","0","57.58","21.75"
"64","000","00","003","0339","0580","1265","421","844","44","1309","2101","0","62.3","20.04"
"64","000","00","003","0339","0581","1205","408","797","51","1256","2018","0","62.24","20.22"
"64","000","00","003","0340","0000","14875","5353","9522","506","15381","25058","0","61.38","21.36"
"64","000","00","003","0340","0582","1222","448","774","58","1280","1925","0","66.49","23.27"
"64","000","00","003","0340","0583","1111","411","700","38","1149","1989","0","57.77","20.66"
"64","000","00","003","0340","0584","948","331","617","20","968","1780","0","54.38","18.6"
"64","000","00","003","0340","0585","1064","375","689","27","1091","1778","0","61.36","21.09"
"64","000","00","003","0340","0586","894","309","585","23","917","1496","0","61.3","20.66"
"64","000","00","003","0340","0587","938","325","613","37","975","1538","0","63.39","21.13"
"64","000","00","003","0340","0588","1219","434","785","41","1260","2058","0","61.22","21.09"
"64","000","00","003","0340","0589","1189","437","752","32","1221","1992","0","61.3","21.94"
"64","000","00","003","0340","0590","1228","465","763","57","1285","2058","0","62.44","22.59"
"64","000","00","003","0340","0591","1240","444","796","39","1279","2090","0","61.2","21.24"
"64","000","00","003","0340","0592","1261","456","805","37","1298","2157","0","60.18","21.14"
"64","000","00","003","0340","0593","1275","441","834","41","1316","2096","0","62.79","21.04"
"64","000","00","003","0340","0594","1286","477","809","56","1342","2101","0","63.87","22.7"
"64","000","00","003","0341","0000","2849","986","1863","196","3045","4843","0","62.87","20.36"
"64","000","00","003","0341","0595","922","295","627","73","995","1649","0","60.34","17.89"
"64","000","00","003","0341","0596","830","277","553","71","901","1516","0","59.43","18.27"
"64","000","00","003","0341","0597","1097","414","683","52","1149","1678","0","68.47","24.67"
"64","000","00","003","0342","0000","7672","2541","5131","278","7950","13054","0","60.9","19.47"
"64","000","00","003","0342","0598","1075","356","719","76","1151","1898","0","60.64","18.76"
"64","000","00","003","0342","0599","1086","345","741","41","1127","1837","0","61.35","18.78"
"64","000","00","003","0342","0600","1060","342","718","28","1088","1922","0","56.61","17.79"
"64","000","00","003","0342","0601","1076","368","708","52","1128","1785","0","63.19","20.62"
"64","000","00","003","0342","0602","1106","363","743","18","1124","1886","0","59.6","19.25"
"64","000","00","003","0342","0603","1149","384","765","35","1184","1895","0","62.48","20.26"
"64","000","00","003","0342","0604","1120","383","737","28","1148","1831","0","62.7","20.92"
"64","000","00","003","0343","0000","16682","5527","11155","492","17174","27814","0","61.75","19.87"
"64","000","00","003","0343","0605","1166","318","848","37","1203","2050","0","58.68","15.51"
"64","000","00","003","0343","0606","1445","488","957","36","1481","2251","0","65.79","21.68"
"64","000","00","003","0343","0607","1343","455","888","30","1373","2126","0","64.58","21.4"
"64","000","00","003","0343","0608","1066","342","724","27","1093","1928","0","56.69","17.74"
"64","000","00","003","0343","0609","1244","417","827","32","1276","2166","0","58.91","19.25"
"64","000","00","003","0343","0610","1246","373","873","42","1288","2031","0","63.42","18.37"
"64","000","00","003","0343","0611","1198","397","801","37","1235","1987","0","62.15","19.98"
"64","000","00","003","0343","0612","1321","445","876","32","1353","2166","0","62.47","20.54"
"64","000","00","003","0343","0613","1089","396","693","58","1147","1856","0","61.8","21.34"
"64","000","00","003","0343","0614","1394","493","901","29","1423","2289","0","62.17","21.54"
"64","000","00","003","0343","0615","1156","364","792","36","1192","1973","0","60.42","18.45"
"64","000","00","003","0343","0616","1076","375","701","52","1128","1818","0","62.05","20.63"
"64","000","00","003","0343","0617","902","312","590","20","922","1565","0","58.91","19.94"
"64","000","00","003","0343","0618","1036","352","684","24","1060","1608","0","65.92","21.89"
"64","000","00","003","0344","0000","19973","6490","13483","590","20563","33421","0","61.53","19.42"
"64","000","00","003","0344","0619","1142","405","737","34","1176","1812","0","64.9","22.35"
"64","000","00","003","0344","0620","1027","342","685","20","1047","1821","0","57.5","18.78"
"64","000","00","003","0344","0621","1182","413","769","42","1224","1907","0","64.18","21.66"
"64","000","00","003","0344","0622","1039","316","723","34","1073","1812","0","59.22","17.44"
"64","000","00","003","0344","0623","1132","371","761","36","1168","1833","0","63.72","20.24"
"64","000","00","003","0344","0624","1106","396","710","40","1146","1850","0","61.95","21.41"
"64","000","00","003","0344","0625","990","319","671","50","1040","1738","0","59.84","18.35"
"64","000","00","003","0344","0626","1187","382","805","34","1221","1864","0","65.5","20.49"
"64","000","00","003","0344","0627","1164","391","773","33","1197","1887","0","63.43","20.72"
"64","000","00","003","0344","0628","1034","328","706","25","1059","1870","0","56.63","17.54"
"64","000","00","003","0344","0629","1102","366","736","21","1123","1866","0","60.18","19.61"
"64","000","00","003","0344","0630","1085","366","719","14","1099","1862","0","59.02","19.66"
"64","000","00","003","0344","0631","1103","357","746","21","1124","1816","0","61.89","19.66"
"64","000","00","003","0344","0632","1108","337","771","36","1144","1833","0","62.41","18.39"
"64","000","00","003","0344","0633","1015","333","682","44","1059","1676","0","63.19","19.87"
"64","000","00","003","0344","0634","1104","327","777","36","1140","1843","0","61.86","17.74"
"64","000","00","003","0344","0635","1149","374","775","27","1176","1872","0","62.82","19.98"
"64","000","00","003","0344","0636","1304","367","937","43","1347","2259","0","59.63","16.25"
"64","000","00","004","0000","0000","86167","28585","57582","5512","91679","153132","185318","59.87","18.67"
"64","000","00","004","0401","0000","11333","3838","7495","493","11826","20704","0","57.12","18.54"
"64","000","00","004","0401","0435","797","269","528","39","836","1309","0","63.87","20.55"
"64","000","00","004","0401","0436","834","285","549","28","862","1408","0","61.22","20.24"
"64","000","00","004","0401","0437","1049","350","699","50","1099","1851","0","59.37","18.91"
"64","000","00","004","0401","0438","932","308","624","51","983","1578","0","62.29","19.52"
"64","000","00","004","0401","0439","948","330","618","27","975","1715","0","56.85","19.24"
"64","000","00","004","0401","0440","884","286","598","19","903","1611","0","56.05","17.75"
"64","000","00","004","0401","0441","1045","321","724","63","1108","2024","0","54.74","15.86"
"64","000","00","004","0401","0442","972","341","631","34","1006","1890","0","53.23","18.04"
"64","000","00","004","0401","0443","920","312","608","23","943","1762","0","53.52","17.71"
"64","000","00","004","0401","0444","980","335","645","53","1033","1888","0","54.71","17.74"
"64","000","00","004","0401","0445","969","346","623","63","1032","1822","0","56.64","18.99"
"64","000","00","004","0401","0446","1003","355","648","43","1046","1846","0","56.66","19.23"
"64","000","00","004","0402","0000","2243","805","1438","135","2378","3940","0","60.36","20.43"
"64","000","00","004","0402","0447","735","243","492","61","796","1268","0","62.78","19.16"
"64","000","00","004","0402","0448","753","257","496","41","794","1240","0","64.03","20.73"
"64","000","00","004","0402","0449","755","305","450","33","788","1432","0","55.03","21.3"
"64","000","00","004","0403","0000","3293","1102","2191","227","3520","5991","0","58.75","18.39"
"64","000","00","004","0403","0450","849","314","535","44","893","1490","0","59.93","21.07"
"64","000","00","004","0403","0451","859","278","581","50","909","1464","0","62.09","18.99"
"64","000","00","004","0403","0452","755","255","500","65","820","1435","0","57.14","17.77"
"64","000","00","004","0403","0453","830","255","575","68","898","1602","0","56.05","15.92"
"64","000","00","004","0404","0000","1659","595","1064","124","1783","3091","0","57.68","19.25"
"64","000","00","004","0404","0454","806","278","528","50","856","1500","0","57.07","18.53"
"64","000","00","004","0404","0455","853","317","536","74","927","1591","0","58.27","19.92"
"64","000","00","004","0405","0000","1697","611","1086","140","1837","3197","0","57.46","19.11"
"64","000","00","004","0405","0458","828","314","514","71","899","1559","0","57.67","20.14"
"64","000","00","004","0405","0459","869","297","572","69","938","1638","0","57.26","18.13"
"64","000","00","004","0406","0000","1482","523","959","86","1568","3138","0","49.97","16.67"
"64","000","00","004","0406","0456","618","227","391","44","662","1669","0","39.66","13.6"
"64","000","00","004","0406","0457","864","296","568","42","906","1469","0","61.67","20.15"
"64","000","00","004","0407","0000","2131","720","1411","177","2308","3872","0","59.61","18.6"
"64","000","00","004","0407","0460","1075","354","721","82","1157","1960","0","59.03","18.06"
"64","000","00","004","0407","0461","1056","366","690","95","1151","1912","0","60.2","19.14"
"64","000","00","004","0408","0000","2576","826","1750","127","2703","4678","0","57.78","17.66"
"64","000","00","004","0408","0462","849","264","585","52","901","1559","0","57.79","16.93"
"64","000","00","004","0408","0463","762","257","505","45","807","1423","0","56.71","18.06"
"64","000","00","004","0408","0464","965","305","660","30","995","1696","0","58.67","17.98"
"64","000","00","004","0409","0000","1579","541","1038","228","1807","3020","0","59.83","17.91"
"64","000","00","004","0409","0465","753","261","492","131","884","1493","0","59.21","17.48"
"64","000","00","004","0409","0466","826","280","546","97","923","1527","0","60.45","18.34"
"64","000","00","004","0410","0000","1237","411","826","129","1366","2217","0","61.61","18.54"
"64","000","00","004","0410","0467","589","174","415","58","647","1020","0","63.43","17.06"
"64","000","00","004","0410","0468","648","237","411","71","719","1197","0","60.07","19.8"
"64","000","00","004","0411","0000","1698","629","1069","147","1845","3446","0","53.54","18.25"
"64","000","00","004","0411","0469","776","310","466","72","848","1528","0","55.5","20.29"
"64","000","00","004","0411","0470","922","319","603","75","997","1918","0","51.98","16.63"
"64","000","00","004","0412","0000","771","259","512","78","849","1458","0","58.23","17.76"
"64","000","00","004","0412","0471","771","259","512","78","849","1458","0","58.23","17.76"
"64","000","00","004","0413","0000","2090","683","1407","163","2253","3635","0","61.98","18.79"
"64","000","00","004","0413","0472","1024","335","689","81","1105","1790","0","61.73","18.72"
"64","000","00","004","0413","0473","1066","348","718","82","1148","1845","0","62.22","18.86"
"64","000","00","004","0414","0000","8823","2914","5909","442","9265","15761","0","58.78","18.49"
"64","000","00","004","0414","0474","1189","402","787","55","1244","2037","0","61.07","19.73"
"64","000","00","004","0414","0475","1057","351","706","56","1113","1964","0","56.67","17.87"
"64","000","00","004","0414","0476","1138","382","756","28","1166","2006","0","58.13","19.04"
"64","000","00","004","0414","0477","1065","367","698","41","1106","1951","0","56.69","18.81"
"64","000","00","004","0414","0478","1050","347","703","60","1110","1951","0","56.89","17.79"
"64","000","00","004","0414","0479","1142","352","790","68","1210","2008","0","60.26","17.53"
"64","000","00","004","0414","0480","1084","347","737","81","1165","1923","0","60.58","18.04"
"64","000","00","004","0414","0481","1098","366","732","53","1151","1921","0","59.92","19.05"
"64","000","00","004","0415","0000","550","191","359","30","580","832","0","69.71","22.96"
"64","000","00","004","0415","0482","550","191","359","30","580","832","0","69.71","22.96"
"64","000","00","004","0416","0000","1292","448","844","112","1404","2281","0","61.55","19.64"
"64","000","00","004","0416","0483","640","216","424","52","692","1156","0","59.86","18.69"
"64","000","00","004","0416","0484","652","232","420","60","712","1125","0","63.29","20.62"
"64","000","00","004","0417","0000","1515","485","1030","96","1611","2562","0","62.88","18.93"
"64","000","00","004","0417","0485","632","210","422","53","685","1060","0","64.62","19.81"
"64","000","00","004","0417","0486","883","275","608","43","926","1502","0","61.65","18.31"
"64","000","00","004","0418","0000","1551","525","1026","135","1686","2956","0","57.04","17.76"
"64","000","00","004","0418","0487","780","274","506","78","858","1404","0","61.11","19.52"
"64","000","00","004","0418","0488","771","251","520","57","828","1552","0","53.35","16.17"
"64","000","00","004","0419","0000","1455","436","1019","110","1565","2775","0","56.4","15.71"
"64","000","00","004","0419","0489","783","257","526","58","841","1460","0","57.6","17.6"
"64","000","00","004","0419","0490","672","179","493","52","724","1315","0","55.06","13.61"
"64","000","00","004","0420","0000","1227","403","824","101","1328","2140","0","62.06","18.83"
"64","000","00","004","0420","0491","619","209","410","51","670","1062","0","63.09","19.68"
"64","000","00","004","0420","0492","608","194","414","50","658","1078","0","61.04","18.0"
"64","000","00","004","0421","0000","1179","407","772","146","1325","1978","0","66.99","20.58"
"64","000","00","004","0421","0493","537","186","351","75","612","914","0","66.96","20.35"
"64","000","00","004","0421","0494","642","221","421","71","713","1064","0","67.01","20.77"
"64","000","00","004","0422","0000","3081","975","2106","161","3242","5350","0","60.6","18.22"
"64","000","00","004","0422","0495","984","320","664","62","1046","1705","0","61.35","18.77"
"64","000","00","004","0422","0496","987","286","701","58","1045","1728","0","60.47","16.55"
"64","000","00","004","0422","0497","1110","369","741","41","1151","1917","0","60.04","19.25"
"64","000","00","004","0423","0000","758","194","564","67","825","1439","0","57.33","13.48"
"64","000","00","004","0423","0498","758","194","564","67","825","1439","0","57.33","13.48"
"64","000","00","004","0424","0000","2532","755","1777","181","2713","4196","0","64.66","17.99"
"64","000","00","004","0424","0499","759","231","528","63","822","1287","0","63.87","17.95"
"64","000","00","004","0424","0500","903","268","635","65","968","1504","0","64.36","17.82"
"64","000","00","004","0424","0501","870","256","614","53","923","1405","0","65.69","18.22"
"64","000","00","004","0425","0000","1521","518","1003","117","1638","2582","0","63.44","20.06"
"64","000","00","004","0425","0502","716","243","473","75","791","1287","0","61.46","18.88"
"64","000","00","004","0425","0503","805","275","530","42","847","1295","0","65.41","21.24"
"64","000","00","004","0426","0000","1935","632","1303","101","2036","3132","0","65.01","20.18"
"64","000","00","004","0426","0504","868","294","574","59","927","1483","0","62.51","19.82"
"64","000","00","004","0426","0505","1067","338","729","42","1109","1649","0","67.25","20.5"
"64","000","00","004","0427","0000","1248","466","782","102","1350","2023","0","66.73","23.04"
"64","000","00","004","0427","0506","604","220","384","47","651","998","0","65.23","22.04"
"64","000","00","004","0427","0507","644","246","398","55","699","1025","0","68.2","24.0"
"64","000","00","004","0428","0000","1953","593","1360","126","2079","3124","0","66.55","18.98"
"64","000","00","004","0428","0508","1070","330","740","53","1123","1671","0","67.21","19.75"
"64","000","00","004","0428","0509","883","263","620","73","956","1453","0","65.79","18.1"
"64","000","00","004","0429","0000","1851","574","1277","122","1973","3326","0","59.32","17.26"
"64","000","00","004","0429","0510","931","302","629","72","1003","1673","0","59.95","18.05"
"64","000","00","004","0429","0511","920","272","648","50","970","1653","0","58.68","16.45"
"64","000","00","004","0430","0000","1318","448","870","102","1420","2161","0","65.71","20.73"
"64","000","00","004","0430","0512","590","189","401","53","643","1034","0","62.19","18.28"
"64","000","00","004","0430","0513","728","259","469","49","777","1127","0","68.94","22.98"
"64","000","00","004","0431","0000","2524","819","1705","149","2673","4512","0","59.24","18.15"
"64","000","00","004","0431","0514","858","290","568","60","918","1575","0","58.29","18.41"
"64","000","00","004","0431","0515","902","276","626","47","949","1559","0","60.87","17.7"
"64","000","00","004","0431","0516","764","253","511","42","806","1378","0","58.49","18.36"
"64","000","00","004","0432","0000","1982","588","1394","127","2109","3435","0","61.4","17.12"
"64","000","00","004","0432","0517","1002","298","704","57","1059","1714","0","61.79","17.39"
"64","000","00","004","0432","0518","980","290","690","70","1050","1721","0","61.01","16.85"
"64","000","00","004","0433","0000","4986","1574","3412","291","5277","8227","0","64.14","19.13"
"64","000","00","004","0433","0519","932","272","660","75","1007","1628","0","61.86","16.71"
"64","000","00","004","0433","0520","999","321","678","72","1071","1590","0","67.36","20.19"
"64","000","00","004","0433","0521","924","290","634","71","995","1628","0","61.12","17.81"
"64","000","00","004","0433","0522","1115","361","754","29","1144","1739","0","65.78","20.76"
"64","000","00","004","0433","0523","1016","330","686","44","1060","1642","0","64.56","20.1"
"64","000","00","004","0434","0000","2630","871","1759","124","2754","4997","0","55.11","17.43"
"64","000","00","004","0434","0524","920","317","603","49","969","1766","0","54.87","17.95"
"64","000","00","004","0434","0525","815","275","540","48","863","1482","0","58.23","18.56"
"64","000","00","004","0434","0526","895","279","616","27","922","1749","0","52.72","15.95"
"64","000","00","004","0435","0000","3933","1350","2583","145","4078","6433","0","63.39","20.99"
"64","000","00","004","0435","0527","926","336","590","41","967","1591","0","60.78","21.12"
"64","000","00","004","0435","0528","970","327","643","26","996","1545","0","64.47","21.17"
"64","000","00","004","0435","0529","1046","349","697","31","1077","1651","0","65.23","21.14"
"64","000","00","004","0435","0530","991","338","653","47","1038","1646","0","63.06","20.53"
"64","000","00","004","0436","0000","900","310","590","63","963","1496","0","64.37","20.72"
"64","000","00","004","0436","0531","900","310","590","63","963","1496","0","64.37","20.72"
"64","000","00","004","0437","0000","1634","566","1068","108","1742","3027","0","57.55","18.7"
"64","000","00","004","0437","0532","743","223","520","72","815","1403","0","58.09","15.89"
"64","000","00","004","0437","0533","891","343","548","36","927","1624","0","57.08","21.12"
"64","000","00","005","0000","0000","162993","56856","106137","8385","171378","289519","341230","59.19","19.64"
"64","000","00","005","0501","0000","2039","661","1378","171","2210","3875","0","57.03","17.06"
"64","000","00","005","0501","0887","1058","362","696","77","1135","1893","0","59.96","19.12"
"64","000","00","005","0501","0888","981","299","682","94","1075","1982","0","54.24","15.09"
"64","000","00","005","0502","0000","4033","1359","2674","213","4246","7408","0","57.32","18.35"
"64","000","00","005","0502","0889","897","285","612","77","974","1661","0","58.64","17.16"
"64","000","00","005","0502","0890","1052","376","676","21","1073","1894","0","56.65","19.85"
"64","000","00","005","0502","0891","1011","327","684","44","1055","1839","0","57.37","17.78"
"64","000","00","005","0502","0892","1073","371","702","71","1144","2014","0","56.8","18.42"
"64","000","00","005","0503","0000","2042","701","1341","155","2197","3913","0","56.15","17.91"
"64","000","00","005","0503","0893","1018","322","696","109","1127","1897","0","59.41","16.97"
"64","000","00","005","0503","0894","1024","379","645","46","1070","2016","0","53.08","18.8"
"64","000","00","005","0504","0000","1948","593","1355","107","2055","3673","0","55.95","16.14"
"64","000","00","005","0504","0895","968","280","688","57","1025","1924","0","53.27","14.55"
"64","000","00","005","0504","0896","980","313","667","50","1030","1749","0","58.89","17.9"
"64","000","00","005","0505","0000","3995","1398","2597","198","4193","7080","0","59.22","19.75"
"64","000","00","005","0505","0897","1105","381","724","66","1171","1845","0","63.47","20.65"
"64","000","00","005","0505","0898","921","327","594","40","961","1724","0","55.74","18.97"
"64","000","00","005","0505","0899","1049","352","697","42","1091","1889","0","57.76","18.63"
"64","000","00","005","0505","0900","920","338","582","50","970","1622","0","59.8","20.84"
"64","000","00","005","0506","0000","1992","674","1318","94","2086","3393","0","61.48","19.86"
"64","000","00","005","0506","0901","1088","375","713","33","1121","1870","0","59.95","20.05"
"64","000","00","005","0506","0902","904","299","605","61","965","1523","0","63.36","19.63"
"64","000","00","005","0507","0000","11691","4182","7509","444","12135","20639","0","58.8","20.26"
"64","000","00","005","0507","0903","1010","323","687","57","1067","2006","0","53.19","16.1"
"64","000","00","005","0507","0904","1257","477","780","58","1315","2076","0","63.34","22.98"
"64","000","00","005","0507","0905","1168","452","716","24","1192","2073","0","57.5","21.8"
"64","000","00","005","0507","0906","1169","399","770","41","1210","2045","0","59.17","19.51"
"64","000","00","005","0507","0907","1000","360","640","63","1063","2070","0","51.35","17.39"
"64","000","00","005","0507","0908","1093","370","723","52","1145","2035","0","56.27","18.18"
"64","000","00","005","0507","0909","1244","488","756","46","1290","2075","0","62.17","23.52"
"64","000","00","005","0507","0910","1177","406","771","42","1219","2053","0","59.38","19.78"
"64","000","00","005","0507","0911","1268","465","803","30","1298","2063","0","62.92","22.54"
"64","000","00","005","0507","0912","1305","442","863","31","1336","2143","0","62.34","20.63"
"64","000","00","005","0508","0000","4569","1649","2920","235","4804","8519","0","56.39","19.36"
"64","000","00","005","0508","0913","942","333","609","65","1007","1746","0","57.67","19.07"
"64","000","00","005","0508","0914","885","303","582","25","910","1735","0","52.45","17.46"
"64","000","00","005","0508","0915","859","311","548","55","914","1655","0","55.23","18.79"
"64","000","00","005","0508","0916","898","336","562","50","948","1583","0","59.89","21.23"
"64","000","00","005","0508","0917","985","366","619","40","1025","1800","0","56.94","20.33"
"64","000","00","005","0509","0000","4055","1194","2861","131","4186","7001","0","59.79","17.05"
"64","000","00","005","0509","0918","1022","334","688","24","1046","1730","0","60.46","19.31"
"64","000","00","005","0509","0919","980","134","846","26","1006","1715","0","58.66","7.81"
"64","000","00","005","0509","0920","979","337","642","40","1019","1691","0","60.26","19.93"
"64","000","00","005","0509","0921","1074","389","685","41","1115","1865","0","59.79","20.86"
"64","000","00","005","0510","0000","1247","428","819","91","1338","1990","0","67.24","21.51"
"64","000","00","005","0510","0922","669","242","427","28","697","1073","0","64.96","22.55"
"64","000","00","005","0510","0923","578","186","392","63","641","917","0","69.9","20.28"
"64","000","00","005","0511","0000","933","310","623","48","981","1647","0","59.56","18.82"
"64","000","00","005","0511","0924","933","310","623","48","981","1647","0","59.56","18.82"
"64","000","00","005","0512","0000","2998","1026","1972","154","3152","5126","0","61.49","20.02"
"64","000","00","005","0512","0925","955","334","621","66","1021","1654","0","61.73","20.19"
"64","000","00","005","0512","0926","975","335","640","45","1020","1639","0","62.23","20.44"
"64","000","00","005","0512","0927","1068","357","711","43","1111","1833","0","60.61","19.48"
"64","000","00","005","0513","0000","2288","950","1338","117","2405","4401","0","54.65","21.59"
"64","000","00","005","0513","0928","854","327","527","38","892","1362","0","65.49","24.01"
"64","000","00","005","0513","0929","537","325","212","55","592","1557","0","38.02","20.87"
"64","000","00","005","0513","0930","897","298","599","24","921","1482","0","62.15","20.11"
"64","000","00","005","0514","0000","2815","1006","1809","89","2904","4583","0","63.36","21.95"
"64","000","00","005","0514","0931","949","325","624","40","989","1563","0","63.28","20.79"
"64","000","00","005","0514","0932","910","338","572","28","938","1497","0","62.66","22.58"
"64","000","00","005","0514","0933","956","343","613","21","977","1523","0","64.15","22.52"
"64","000","00","005","0515","0000","4481","1546","2935","190","4671","7198","0","64.89","21.48"
"64","000","00","005","0515","0934","832","281","551","40","872","1293","0","67.44","21.73"
"64","000","00","005","0515","0935","1010","387","623","46","1056","1662","0","63.54","23.29"
"64","000","00","005","0515","0936","826","274","552","44","870","1441","0","60.37","19.01"
"64","000","00","005","0515","0937","869","284","585","33","902","1326","0","68.02","21.42"
"64","000","00","005","0515","0938","944","320","624","27","971","1476","0","65.79","21.68"
"64","000","00","005","0516","0000","1866","646","1220","60","1926","3586","0","53.71","18.01"
"64","000","00","005","0516","0939","1028","356","672","34","1062","1968","0","53.96","18.09"
"64","000","00","005","0516","0940","838","290","548","26","864","1618","0","53.4","17.92"
"64","000","00","005","0517","0000","2815","1088","1727","123","2938","5000","0","58.76","21.76"
"64","000","00","005","0517","0941","1046","495","551","39","1085","1873","0","57.93","26.43"
"64","000","00","005","0517","0942","843","295","548","56","899","1487","0","60.46","19.84"
"64","000","00","005","0517","0943","926","298","628","28","954","1640","0","58.17","18.17"
"64","000","00","005","0518","0000","2123","734","1389","62","2185","3858","0","56.64","19.03"
"64","000","00","005","0518","0944","1056","350","706","25","1081","1889","0","57.23","18.53"
"64","000","00","005","0518","0945","1067","384","683","37","1104","1969","0","56.07","19.5"
"64","000","00","005","0519","0000","3690","1281","2409","238","3928","6475","0","60.66","19.78"
"64","000","00","005","0519","0946","802","279","523","92","894","1466","0","60.98","19.03"
"64","000","00","005","0519","0947","989","338","651","55","1044","1697","0","61.52","19.92"
"64","000","00","005","0519","0948","976","328","648","45","1021","1663","0","61.4","19.72"
"64","000","00","005","0519","0949","923","336","587","46","969","1649","0","58.76","20.38"
"64","000","00","005","0520","0000","1659","553","1106","55","1714","2981","0","57.5","18.55"
"64","000","00","005","0520","0950","839","274","565","32","871","1486","0","58.61","18.44"
"64","000","00","005","0520","0951","820","279","541","23","843","1495","0","56.39","18.66"
"64","000","00","005","0521","0000","1820","684","1136","61","1881","3041","0","61.85","22.49"
"64","000","00","005","0521","0952","964","360","604","28","992","1548","0","64.08","23.26"
"64","000","00","005","0521","0953","856","324","532","33","889","1493","0","59.54","21.7"
"64","000","00","005","0522","0000","4536","1608","2928","171","4707","7649","0","61.54","21.02"
"64","000","00","005","0522","0954","886","293","593","25","911","1445","0","63.04","20.28"
"64","000","00","005","0522","0955","869","295","574","30","899","1529","0","58.8","19.29"
"64","000","00","005","0522","0956","855","282","573","31","886","1506","0","58.83","18.73"
"64","000","00","005","0522","0957","948","349","599","31","979","1549","0","63.2","22.53"
"64","000","00","005","0522","0958","978","389","589","54","1032","1620","0","63.7","24.01"
"64","000","00","005","0523","0000","1826","620","1206","106","1932","3038","0","63.59","20.41"
"64","000","00","005","0523","0959","928","322","606","63","991","1550","0","63.94","20.77"
"64","000","00","005","0523","0960","898","298","600","43","941","1488","0","63.24","20.03"
"64","000","00","005","0524","0000","1570","513","1057","86","1656","2667","0","62.09","19.24"
"64","000","00","005","0524","0961","795","280","515","44","839","1335","0","62.85","20.97"
"64","000","00","005","0524","0962","775","233","542","42","817","1332","0","61.34","17.49"
"64","000","00","005","0525","0000","3092","1121","1971","154","3246","5268","0","61.62","21.28"
"64","000","00","005","0525","0963","1019","385","634","69","1088","1764","0","61.68","21.83"
"64","000","00","005","0525","0964","1041","363","678","35","1076","1811","0","59.41","20.04"
"64","000","00","005","0525","0965","1032","373","659","50","1082","1693","0","63.91","22.03"
"64","000","00","005","0526","0000","2933","1055","1878","152","3085","4867","0","63.39","21.68"
"64","000","00","005","0526","0966","1034","366","668","68","1102","1684","0","65.44","21.73"
"64","000","00","005","0526","0967","811","303","508","51","862","1464","0","58.88","20.7"
"64","000","00","005","0526","0968","1088","386","702","33","1121","1719","0","65.21","22.45"
"64","000","00","005","0527","0000","3861","1362","2499","167","4028","6858","0","58.73","19.86"
"64","000","00","005","0527","0969","1001","362","639","28","1029","1749","0","58.83","20.7"
"64","000","00","005","0527","0970","1043","377","666","41","1084","1908","0","56.81","19.76"
"64","000","00","005","0527","0971","910","308","602","62","972","1573","0","61.79","19.58"
"64","000","00","005","0527","0972","907","315","592","36","943","1628","0","57.92","19.35"
"64","000","00","005","0528","0000","2280","762","1518","151","2431","4095","0","59.37","18.61"
"64","000","00","005","0528","0973","691","240","451","57","748","1377","0","54.32","17.43"
"64","000","00","005","0528","0974","933","320","613","43","976","1530","0","63.79","20.92"
"64","000","00","005","0528","0975","656","202","454","51","707","1188","0","59.51","17.0"
"64","000","00","005","0529","0000","2830","968","1862","160","2990","6302","0","47.45","15.36"
"64","000","00","005","0529","0976","811","264","547","37","848","2791","0","30.38","9.46"
"64","000","00","005","0529","0977","1046","357","689","54","1100","1840","0","59.78","19.4"
"64","000","00","005","0529","0978","973","347","626","69","1042","1671","0","62.36","20.77"
"64","000","00","005","0530","0000","4799","1723","3076","212","5011","7969","0","62.88","21.62"
"64","000","00","005","0530","0979","935","340","595","48","983","1624","0","60.53","20.94"
"64","000","00","005","0530","0980","1019","382","637","44","1063","1555","0","68.36","24.57"
"64","000","00","005","0530","0981","936","344","592","48","984","1489","0","66.08","23.1"
"64","000","00","005","0530","0982","993","347","646","46","1039","1662","0","62.52","20.88"
"64","000","00","005","0530","0983","916","310","606","26","942","1639","0","57.47","18.91"
"64","000","00","005","0531","0000","2133","697","1436","109","2242","3840","0","58.39","18.15"
"64","000","00","005","0531","0984","1037","341","696","63","1100","1872","0","58.76","18.22"
"64","000","00","005","0531","0985","1096","356","740","46","1142","1968","0","58.03","18.09"
"64","000","00","005","0532","0000","1525","499","1026","148","1673","3005","0","55.67","16.61"
"64","000","00","005","0532","0986","700","218","482","86","786","1471","0","53.43","14.82"
"64","000","00","005","0532","0987","825","281","544","62","887","1534","0","57.82","18.32"
"64","000","00","005","0533","0000","2690","896","1794","147","2837","5282","0","53.71","16.96"
"64","000","00","005","0533","0988","829","257","572","76","905","1659","0","54.55","15.49"
"64","000","00","005","0533","0989","905","290","615","32","937","1815","0","51.63","15.98"
"64","000","00","005","0533","0990","956","349","607","39","995","1808","0","55.03","19.3"
"64","000","00","005","0534","0000","1415","465","950","57","1472","2630","0","55.97","17.68"
"64","000","00","005","0534","0991","630","203","427","39","669","1224","0","54.66","16.58"
"64","000","00","005","0534","0992","785","262","523","18","803","1406","0","57.11","18.63"
"64","000","00","005","0535","0000","1074","358","716","70","1144","1889","0","60.56","18.95"
"64","000","00","005","0535","0993","498","177","321","36","534","945","0","56.51","18.73"
"64","000","00","005","0535","0994","576","181","395","34","610","944","0","64.62","19.17"
"64","000","00","005","0536","0000","1792","597","1195","145","1937","3142","0","61.65","19.0"
"64","000","00","005","0536","0995","929","327","602","81","1010","1669","0","60.52","19.59"
"64","000","00","005","0536","0996","863","270","593","64","927","1473","0","62.93","18.33"
"64","000","00","005","0537","0000","1529","543","986","98","1627","3558","0","45.73","15.26"
"64","000","00","005","0537","0997","905","329","576","52","957","1876","0","51.01","17.54"
"64","000","00","005","0537","0998","624","214","410","46","670","1682","0","39.83","12.72"
"64","000","00","005","0538","0000","6430","2319","4111","220","6650","11459","0","58.03","20.24"
"64","000","00","005","0538","0999","929","360","569","41","970","1791","0","54.16","20.1"
"64","000","00","005","0538","1000","1050","370","680","46","1096","1808","0","60.62","20.46"
"64","000","00","005","0538","1001","956","332","624","52","1008","1798","0","56.06","18.46"
"64","000","00","005","0538","1002","1159","447","712","42","1201","2030","0","59.16","22.02"
"64","000","00","005","0538","1003","1178","407","771","23","1201","2034","0","59.05","20.01"
"64","000","00","005","0538","1004","1158","403","755","16","1174","1998","0","58.76","20.17"
"64","000","00","005","0539","0000","2096","800","1296","70","2166","3879","0","55.84","20.62"
"64","000","00","005","0539","1005","1019","360","659","32","1051","1914","0","54.91","18.81"
"64","000","00","005","0539","1006","1077","440","637","38","1115","1965","0","56.74","22.39"
"64","000","00","005","0540","0000","1042","406","636","58","1100","1885","0","58.36","21.54"
"64","000","00","005","0540","1007","1042","406","636","58","1100","1885","0","58.36","21.54"
"64","000","00","005","0541","0000","1343","452","891","76","1419","2277","0","62.32","19.85"
"64","000","00","005","0541","1008","766","265","501","12","778","1220","0","63.77","21.72"
"64","000","00","005","0541","1009","577","187","390","64","641","1057","0","60.64","17.69"
"64","000","00","005","0542","0000","1324","579","745","66","1390","2784","0","49.93","20.8"
"64","000","00","005","0542","1010","667","264","403","32","699","1434","0","48.74","18.41"
"64","000","00","005","0542","1011","657","315","342","34","691","1350","0","51.19","23.33"
"64","000","00","005","0543","0000","914","341","573","41","955","1826","0","52.3","18.67"
"64","000","00","005","0543","1012","425","151","274","20","445","872","0","51.03","17.32"
"64","000","00","005","0543","1013","489","190","299","21","510","954","0","53.46","19.92"
"64","000","00","005","0544","0000","2570","933","1637","92","2662","4415","0","60.29","21.13"
"64","000","00","005","0544","1014","996","359","637","20","1016","1689","0","60.15","21.26"
"64","000","00","005","0544","1015","793","295","498","15","808","1390","0","58.13","21.22"
"64","000","00","005","0544","1016","781","279","502","57","838","1336","0","62.72","20.88"
"64","000","00","005","0545","0000","2637","971","1666","140","2777","4402","0","63.08","22.06"
"64","000","00","005","0545","1017","920","341","579","41","961","1437","0","66.88","23.73"
"64","000","00","005","0545","1018","849","304","545","29","878","1452","0","60.47","20.94"
"64","000","00","005","0545","1019","868","326","542","70","938","1513","0","62.0","21.55"
"64","000","00","005","0546","0000","1749","626","1123","163","1912","2848","0","67.13","21.98"
"64","000","00","005","0546","1020","882","335","547","81","963","1467","0","65.64","22.84"
"64","000","00","005","0546","1021","867","291","576","82","949","1381","0","68.72","21.07"
"64","000","00","005","0547","0000","1427","523","904","83","1510","2444","0","61.78","21.4"
"64","000","00","005","0547","1022","624","229","395","47","671","1117","0","60.07","20.5"
"64","000","00","005","0547","1023","803","294","509","36","839","1327","0","63.23","22.16"
"64","000","00","005","0548","0000","784","256","528","33","817","1304","0","62.65","19.63"
"64","000","00","005","0548","1024","784","256","528","33","817","1304","0","62.65","19.63"
"64","000","00","005","0549","0000","802","277","525","34","836","1483","0","56.37","18.68"
"64","000","00","005","0549","1025","802","277","525","34","836","1483","0","56.37","18.68"
"64","000","00","005","0550","0000","891","307","584","34","925","1473","0","62.8","20.84"
"64","000","00","005","0550","1026","891","307","584","34","925","1473","0","62.8","20.84"
"64","000","00","005","0551","0000","569","198","371","37","606","980","0","61.84","20.2"
"64","000","00","005","0551","1027","569","198","371","37","606","980","0","61.84","20.2"
"64","000","00","005","0552","0000","1541","614","927","97","1638","2639","0","62.07","23.27"
"64","000","00","005","0552","1028","820","354","466","58","878","1409","0","62.31","25.12"
"64","000","00","005","0552","1029","721","260","461","39","760","1230","0","61.79","21.14"
"64","000","00","005","0553","0000","1295","455","840","103","1398","2154","0","64.9","21.12"
"64","000","00","005","0553","1030","628","224","404","56","684","1024","0","66.8","21.88"
"64","000","00","005","0553","1031","667","231","436","47","714","1130","0","63.19","20.44"
"64","000","00","005","0554","0000","970","315","655","34","1004","1889","0","53.15","16.68"
"64","000","00","005","0554","1032","970","315","655","34","1004","1889","0","53.15","16.68"
"64","000","00","005","0555","0000","803","265","538","34","837","1427","0","58.65","18.57"
"64","000","00","005","0555","1033","803","265","538","34","837","1427","0","58.65","18.57"
"64","000","00","005","0556","0000","474","122","352","25","499","791","0","63.08","15.42"
"64","000","00","005","0556","1034","474","122","352","25","499","791","0","63.08","15.42"
"64","000","00","005","0557","0000","696","219","477","72","768","1079","0","71.18","20.3"
"64","000","00","005","0557","1035","696","219","477","72","768","1079","0","71.18","20.3"
"64","000","00","005","0558","0000","840","292","548","64","904","1492","0","60.59","19.57"
"64","000","00","005","0558","1036","840","292","548","64","904","1492","0","60.59","19.57"
"64","000","00","005","0559","0000","1225","418","807","69","1294","2021","0","64.03","20.68"
"64","000","00","005","0559","1037","609","208","401","54","663","1020","0","65.0","20.39"
"64","000","00","005","0559","1038","616","210","406","15","631","1001","0","63.04","20.98"
"64","000","00","005","0560","0000","1742","587","1155","81","1823","3052","0","59.73","19.23"
"64","000","00","005","0560","1039","911","302","609","42","953","1581","0","60.28","19.1"
"64","000","00","005","0560","1040","831","285","546","39","870","1471","0","59.14","19.37"
"64","000","00","005","0561","0000","2246","728","1518","112","2358","3760","0","62.71","19.36"
"64","000","00","005","0561","1041","708","243","465","17","725","1151","0","62.99","21.11"
"64","000","00","005","0561","1042","812","260","552","48","860","1334","0","64.47","19.49"
"64","000","00","005","0561","1043","726","225","501","47","773","1275","0","60.63","17.65"
"64","000","00","005","0562","0000","2165","766","1399","94","2259","4051","0","55.76","18.91"
"64","000","00","005","0562","1044","743","256","487","36","779","1688","0","46.15","15.17"
"64","000","00","005","0562","1045","699","250","449","37","736","1214","0","60.63","20.59"
"64","000","00","005","0562","1046","723","260","463","21","744","1149","0","64.75","22.63"
"64","000","00","005","0563","0000","942","311","631","79","1021","1667","0","61.25","18.66"
"64","000","00","005","0563","1047","942","311","631","79","1021","1667","0","61.25","18.66"
"64","000","00","005","0564","0000","935","360","575","31","966","1786","0","54.09","20.16"
"64","000","00","005","0564","1048","935","360","575","31","966","1786","0","54.09","20.16"
"64","000","00","005","0565","0000","1062","350","712","71","1133","1821","0","62.22","19.22"
"64","000","00","005","0565","1049","532","172","360","22","554","896","0","61.83","19.2"
"64","000","00","005","0565","1050","530","178","352","49","579","925","0","62.59","19.24"
"64","000","00","005","0566","0000","420","141","279","53","473","684","0","69.15","20.61"
"64","000","00","005","0566","1051","420","141","279","53","473","684","0","69.15","20.61"
"64","000","00","005","0567","0000","600","227","373","60","660","981","0","67.28","23.14"
"64","000","00","005","0567","1052","600","227","373","60","660","981","0","67.28","23.14"
"64","000","00","005","0568","0000","687","230","457","73","760","1383","0","54.95","16.63"
"64","000","00","005","0568","1053","687","230","457","73","760","1383","0","54.95","16.63"
"64","000","00","005","0569","0000","798","266","532","39","837","1382","0","60.56","19.25"
"64","000","00","005","0569","1054","798","266","532","39","837","1382","0","60.56","19.25"
"64","000","00","005","0570","0000","447","163","284","26","473","808","0","58.54","20.17"
"64","000","00","005","0570","1055","447","163","284","26","473","808","0","58.54","20.17"
"64","000","00","005","0572","0000","704","260","444","25","729","1197","0","60.9","21.72"
"64","000","00","005","0572","1056","704","260","444","25","729","1197","0","60.9","21.72"
"64","000","00","005","0573","0000","2323","761","1562","129","2452","4047","0","60.59","18.8"
"64","000","00","005","0573","1057","745","220","525","43","788","1344","0","58.63","16.37"
"64","000","00","005","0573","1058","775","271","504","63","838","1344","0","62.35","20.16"
"64","000","00","005","0573","1059","803","270","533","23","826","1359","0","60.78","19.87"
"64","000","00","005","0574","0000","630","209","421","55","685","1073","0","63.84","19.48"
"64","000","00","005","0574","1060","630","209","421","55","685","1073","0","63.84","19.48"
"64","000","00","005","0575","0000","637","214","423","43","680","1186","0","57.34","18.04"
"64","000","00","005","0575","1061","637","214","423","43","680","1186","0","57.34","18.04"
"64","000","00","005","0576","0000","954","335","619","72","1026","1749","0","58.66","19.15"
"64","000","00","005","0576","1062","954","335","619","72","1026","1749","0","58.66","19.15"
"64","000","00","005","0577","0000","463","149","314","18","481","877","0","54.85","16.99"
"64","000","00","005","0577","1063","463","149","314","18","481","877","0","54.85","16.99"
"64","000","00","005","0578","0000","839","276","563","87","926","1402","0","66.05","19.69"
"64","000","00","005","0578","1064","839","276","563","87","926","1402","0","66.05","19.69"
"64","000","00","005","0579","0000","479","151","328","23","502","769","0","65.28","19.64"
"64","000","00","005","0579","1065","479","151","328","23","502","769","0","65.28","19.64"
"64","000","00","005","0581","0000","1365","446","919","87","1452","2477","0","58.62","18.01"
"64","000","00","005","0581","1066","720","229","491","46","766","1207","0","63.46","18.97"
"64","000","00","005","0581","1067","645","217","428","41","686","1270","0","54.02","17.09"
"64","000","00","005","0582","0000","700","266","434","46","746","1248","0","59.78","21.31"
"64","000","00","005","0582","1068","700","266","434","46","746","1248","0","59.78","21.31"
"64","000","00","005","0583","0000","747","267","480","53","800","1263","0","63.34","21.14"
"64","000","00","005","0583","1069","747","267","480","53","800","1263","0","63.34","21.14"
"64","000","00","005","0584","0000","641","197","444","33","674","1101","0","61.22","17.89"
"64","000","00","005","0584","1070","641","197","444","33","674","1101","0","61.22","17.89"
"64","000","00","005","0585","0000","671","245","426","19","690","1116","0","61.83","21.95"
"64","000","00","005","0585","1071","671","245","426","19","690","1116","0","61.83","21.95"
"64","000","00","005","0586","0000","667","221","446","41","708","1152","0","61.46","19.18"
"64","000","00","005","0586","1072","667","221","446","41","708","1152","0","61.46","19.18"
"64","000","00","005","0587","0000","611","231","380","58","669","1057","0","63.29","21.85"
"64","000","00","005","0587","1073","611","231","380","58","669","1057","0","63.29","21.85"
"64","000","00","005","0588","0000","1112","361","751","63","1175","2033","0","57.8","17.76"
"64","000","00","005","0588","1074","515","164","351","42","557","971","0","57.36","16.89"
"64","000","00","005","0588","1075","597","197","400","21","618","1062","0","58.19","18.55"
"64","000","00","006","0000","0000","25873","9445","16428","1336","27209","44355","50942","61.34","21.29"
"64","000","00","006","0601","0000","1065","385","680","70","1135","1791","0","63.37","21.5"
"64","000","00","006","0601","1098","468","167","301","28","496","828","0","59.9","20.17"
"64","000","00","006","0601","1099","597","218","379","42","639","963","0","66.36","22.64"
"64","000","00","006","0602","0000","580","187","393","20","600","1075","0","55.81","17.4"
"64","000","00","006","0602","1100","580","187","393","20","600","1075","0","55.81","17.4"
"64","000","00","006","0603","0000","1706","648","1058","55","1761","2926","0","60.18","22.15"
"64","000","00","006","0603","1101","864","327","537","23","887","1488","0","59.61","21.98"
"64","000","00","006","0603","1102","842","321","521","32","874","1438","0","60.78","22.32"
"64","000","00","006","0604","0000","615","235","380","29","644","1049","0","61.39","22.4"
"64","000","00","006","0604","1103","615","235","380","29","644","1049","0","61.39","22.4"
"64","000","00","006","0605","0000","849","292","557","73","922","1378","0","66.91","21.19"
"64","000","00","006","0605","1104","849","292","557","73","922","1378","0","66.91","21.19"
"64","000","00","006","0606","0000","415","125","290","27","442","666","0","66.37","18.77"
"64","000","00","006","0606","1105","415","125","290","27","442","666","0","66.37","18.77"
"64","000","00","006","0607","0000","583","218","365","16","599","981","0","61.06","22.22"
"64","000","00","006","0607","1106","583","218","365","16","599","981","0","61.06","22.22"
"64","000","00","006","0608","0000","1150","372","778","51","1201","1920","0","62.55","19.38"
"64","000","00","006","0608","1107","588","197","391","29","617","933","0","66.13","21.11"
"64","000","00","006","0608","1108","562","175","387","22","584","987","0","59.17","17.73"
"64","000","00","006","0609","0000","596","206","390","30","626","988","0","63.36","20.85"
"64","000","00","006","0609","1109","596","206","390","30","626","988","0","63.36","20.85"
"64","000","00","006","0610","0000","460","166","294","34","494","735","0","67.21","22.59"
"64","000","00","006","0610","1110","460","166","294","34","494","735","0","67.21","22.59"
"64","000","00","006","0611","0000","761","289","472","32","793","1317","0","60.21","21.94"
"64","000","00","006","0611","1111","761","289","472","32","793","1317","0","60.21","21.94"
"64","000","00","006","0612","0000","434","140","294","16","450","800","0","56.25","17.5"
"64","000","00","006","0612","1112","434","140","294","16","450","800","0","56.25","17.5"
"64","000","00","006","0613","0000","1127","370","757","55","1182","1881","0","62.84","19.67"
"64","000","00","006","0613","1113","579","191","388","35","614","968","0","63.43","19.73"
"64","000","00","006","0613","1114","548","179","369","20","568","913","0","62.21","19.61"
"64","000","00","006","0614","0000","1660","833","827","57","1717","2617","0","65.61","31.83"
"64","000","00","006","0614","1115","869","340","529","16","885","1389","0","63.71","24.48"
"64","000","00","006","0614","1116","791","493","298","41","832","1228","0","67.75","40.15"
"64","000","00","006","0615","0000","1381","477","904","80","1461","2312","0","63.19","20.63"
"64","000","00","006","0615","1117","718","257","461","55","773","1211","0","63.83","21.22"
"64","000","00","006","0615","1118","663","220","443","25","688","1101","0","62.49","19.98"
"64","000","00","006","0616","0000","1058","412","646","49","1107","1625","0","68.12","25.35"
"64","000","00","006","0616","1119","466","172","294","18","484","752","0","64.36","22.87"
"64","000","00","006","0616","1120","592","240","352","31","623","873","0","71.36","27.49"
"64","000","00","006","0617","0000","2001","720","1281","88","2089","3345","0","62.45","21.52"
"64","000","00","006","0617","1121","939","329","610","45","984","1609","0","61.16","20.45"
"64","000","00","006","0617","1122","1062","391","671","43","1105","1736","0","63.65","22.52"
"64","000","00","006","0618","0000","723","251","472","22","745","1258","0","59.22","19.95"
"64","000","00","006","0618","1123","723","251","472","22","745","1258","0","59.22","19.95"
"64","000","00","006","0619","0000","657","248","409","38","695","1105","0","62.9","22.44"
"64","000","00","006","0619","1124","657","248","409","38","695","1105","0","62.9","22.44"
"64","000","00","006","0620","0000","495","153","342","43","538","851","0","63.22","17.98"
"64","000","00","006","0620","1125","495","153","342","43","538","851","0","63.22","17.98"
"64","000","00","006","0621","0000","603","214","389","43","646","1011","0","63.9","21.17"
"64","000","00","006","0621","1126","603","214","389","43","646","1011","0","63.9","21.17"
"64","000","00","006","0622","0000","1148","414","734","90","1238","1893","0","65.4","21.87"
"64","000","00","006","0622","1127","566","201","365","55","621","888","0","69.93","22.64"
"64","000","00","006","0622","1128","582","213","369","35","617","1005","0","61.39","21.19"
"64","000","00","006","0623","0000","1436","544","892","58","1494","2763","0","54.07","19.69"
"64","000","00","006","0623","1129","611","218","393","21","632","1375","0","45.96","15.85"
"64","000","00","006","0623","1130","825","326","499","37","862","1388","0","62.1","23.49"
"64","000","00","006","0624","0000","396","122","274","37","433","719","0","60.22","16.97"
"64","000","00","006","0624","1131","396","122","274","37","433","719","0","60.22","16.97"
"64","000","00","006","0625","0000","603","225","378","56","659","1077","0","61.19","20.89"
"64","000","00","006","0625","1132","603","225","378","56","659","1077","0","61.19","20.89"
"64","000","00","006","0626","0000","440","166","274","16","456","875","0","52.11","18.97"
"64","000","00","006","0626","1133","440","166","274","16","456","875","0","52.11","18.97"
"64","000","00","006","0627","0000","515","187","328","18","533","936","0","56.94","19.98"
"64","000","00","006","0627","1134","515","187","328","18","533","936","0","56.94","19.98"
"64","000","00","006","0628","0000","500","186","314","64","564","944","0","59.75","19.7"
"64","000","00","006","0628","1135","500","186","314","64","564","944","0","59.75","19.7"
"64","000","00","006","0629","0000","437","160","277","24","461","833","0","55.34","19.21"
"64","000","00","006","0629","1136","437","160","277","24","461","833","0","55.34","19.21"
"64","000","00","006","0630","0000","418","138","280","9","427","708","0","60.31","19.49"
"64","000","00","006","0630","1137","418","138","280","9","427","708","0","60.31","19.49"
"64","000","00","006","0631","0000","422","146","276","14","436","741","0","58.84","19.7"
"64","000","00","006","0631","1138","422","146","276","14","436","741","0","58.84","19.7"
"64","000","00","006","0632","0000","639","216","423","22","661","1235","0","53.52","17.49"
"64","000","00","006","0632","1139","639","216","423","22","661","1235","0","53.52","17.49"
"64","000","00","007","0000","0000","13771","4776","8995","738","14509","23928","26732","60.64","19.96"
"64","000","00","007","0701","0000","370","131","239","18","388","673","0","57.65","19.47"
"64","000","00","007","0701","1076","370","131","239","18","388","673","0","57.65","19.47"
"64","000","00","007","0702","0000","604","202","402","33","637","1022","0","62.33","19.77"
"64","000","00","007","0702","1077","604","202","402","33","637","1022","0","62.33","19.77"
"64","000","00","007","0703","0000","731","242","489","30","761","1324","0","57.48","18.28"
"64","000","00","007","0703","1078","731","242","489","30","761","1324","0","57.48","18.28"
"64","000","00","007","0704","0000","478","166","312","34","512","839","0","61.03","19.79"
"64","000","00","007","0704","1079","478","166","312","34","512","839","0","61.03","19.79"
"64","000","00","007","0705","0000","562","205","357","48","610","975","0","62.56","21.03"
"64","000","00","007","0705","1080","562","205","357","48","610","975","0","62.56","21.03"
"64","000","00","007","0706","0000","2045","692","1353","94","2139","3587","0","59.63","19.29"
"64","000","00","007","0706","1081","1020","349","671","52","1072","1806","0","59.36","19.32"
"64","000","00","007","0706","1082","1025","343","682","42","1067","1781","0","59.91","19.26"
"64","000","00","007","0707","0000","434","148","286","24","458","717","0","63.88","20.64"
"64","000","00","007","0707","1083","434","148","286","24","458","717","0","63.88","20.64"
"64","000","00","007","0708","0000","624","219","405","12","636","1097","0","57.98","19.96"
"64","000","00","007","0708","1084","624","219","405","12","636","1097","0","57.98","19.96"
"64","000","00","007","0709","0000","932","341","591","25","957","1633","0","58.6","20.88"
"64","000","00","007","0709","1085","932","341","591","25","957","1633","0","58.6","20.88"
"64","000","00","007","0710","0000","487","180","307","30","517","759","0","68.12","23.72"
"64","000","00","007","0710","1086","487","180","307","30","517","759","0","68.12","23.72"
"64","000","00","007","0711","0000","580","206","374","37","617","948","0","65.08","21.73"
"64","000","00","007","0711","1087","580","206","374","37","617","948","0","65.08","21.73"
"64","000","00","007","0712","0000","484","167","317","76","560","1009","0","55.5","16.55"
"64","000","00","007","0712","1088","484","167","317","76","560","1009","0","55.5","16.55"
"64","000","00","007","0713","0000","563","204","359","24","587","945","0","62.12","21.59"
"64","000","00","007","0713","1089","563","204","359","24","587","945","0","62.12","21.59"
"64","000","00","007","0714","0000","913","332","581","46","959","1529","0","62.72","21.71"
"64","000","00","007","0714","1090","455","167","288","14","469","772","0","60.75","21.63"
"64","000","00","007","0714","1091","458","165","293","32","490","757","0","64.73","21.8"
"64","000","00","007","0715","0000","641","222","419","28","669","1047","0","63.9","21.2"
"64","000","00","007","0715","1092","641","222","419","28","669","1047","0","63.9","21.2"
"64","000","00","007","0716","0000","587","190","397","43","630","985","0","63.96","19.29"
"64","000","00","007","0716","1093","587","190","397","43","630","985","0","63.96","19.29"
"64","000","00","007","0717","0000","918","330","588","22","940","1674","0","56.15","19.71"
"64","000","00","007","0717","1094","918","330","588","22","940","1674","0","56.15","19.71"
"64","000","00","007","0718","0000","599","186","413","43","642","1088","0","59.01","17.1"
"64","000","00","007","0718","1095","599","186","413","43","642","1088","0","59.01","17.1"
"64","000","00","007","0719","0000","556","196","360","48","604","893","0","67.64","21.95"
"64","000","00","007","0719","1096","556","196","360","48","604","893","0","67.64","21.95"
"64","000","00","007","0720","0000","663","217","446","23","686","1184","0","57.94","18.33"
"64","000","00","007","0720","1097","663","217","446","23","686","1184","0","57.94","18.33"
"64","000","00","008","0000","0000","85524","29700","55824","4183","89707","146786","169840","61.11","20.23"
"64","000","00","008","0801","0000","431","170","261","20","451","718","0","62.81","23.68"
"64","000","00","008","0801","1140","431","170","261","20","451","718","0","62.81","23.68"
"64","000","00","008","0802","0000","825","263","562","40","865","1492","0","57.98","17.63"
"64","000","00","008","0802","1141","825","263","562","40","865","1492","0","57.98","17.63"
"64","000","00","008","0803","0000","703","235","468","46","749","1210","0","61.9","19.42"
"64","000","00","008","0803","1142","703","235","468","46","749","1210","0","61.9","19.42"
"64","000","00","008","0804","0000","836","283","553","28","864","1617","0","53.43","17.5"
"64","000","00","008","0804","1143","836","283","553","28","864","1617","0","53.43","17.5"
"64","000","00","008","0805","0000","817","259","558","79","896","1428","0","62.75","18.14"
"64","000","00","008","0805","1144","817","259","558","79","896","1428","0","62.75","18.14"
"64","000","00","008","0806","0000","745","265","480","35","780","1444","0","54.02","18.35"
"64","000","00","008","0806","1145","745","265","480","35","780","1444","0","54.02","18.35"
"64","000","00","008","0807","0000","790","252","538","59","849","1452","0","58.47","17.36"
"64","000","00","008","0807","1146","790","252","538","59","849","1452","0","58.47","17.36"
"64","000","00","008","0808","0000","325","98","227","29","354","554","0","63.9","17.69"
"64","000","00","008","0808","1147","325","98","227","29","354","554","0","63.9","17.69"
"64","000","00","008","0809","0000","1066","362","704","28","1094","1928","0","56.74","18.78"
"64","000","00","008","0809","1148","538","184","354","15","553","950","0","58.21","19.37"
"64","000","00","008","0809","1149","528","178","350","13","541","978","0","55.32","18.2"
"64","000","00","008","0810","0000","1939","660","1279","81","2020","3718","0","54.33","17.75"
"64","000","00","008","0810","1150","859","283","576","41","900","1673","0","53.8","16.92"
"64","000","00","008","0810","1151","1080","377","703","40","1120","2045","0","54.77","18.44"
"64","000","00","008","0811","0000","546","177","369","52","598","939","0","63.68","18.85"
"64","000","00","008","0811","1152","546","177","369","52","598","939","0","63.68","18.85"
"64","000","00","008","0812","0000","671","263","408","38","709","1284","0","55.22","20.48"
"64","000","00","008","0812","1153","671","263","408","38","709","1284","0","55.22","20.48"
"64","000","00","008","0813","0000","1001","361","640","41","1042","1746","0","59.68","20.68"
"64","000","00","008","0813","1154","538","178","360","24","562","908","0","61.89","19.6"
"64","000","00","008","0813","1155","463","183","280","17","480","838","0","57.28","21.84"
"64","000","00","008","0814","0000","753","271","482","30","783","1267","0","61.8","21.39"
"64","000","00","008","0814","1156","753","271","482","30","783","1267","0","61.8","21.39"
"64","000","00","008","0815","0000","1012","326","686","73","1085","1768","0","61.37","18.44"
"64","000","00","008","0815","1157","599","204","395","53","652","994","0","65.59","20.52"
"64","000","00","008","0815","1158","413","122","291","20","433","774","0","55.94","15.76"
"64","000","00","008","0816","0000","658","237","421","19","677","1121","0","60.39","21.14"
"64","000","00","008","0816","1159","658","237","421","19","677","1121","0","60.39","21.14"
"64","000","00","008","0817","0000","1719","609","1110","111","1830","2999","0","61.02","20.31"
"64","000","00","008","0817","1160","843","302","541","43","886","1474","0","60.11","20.49"
"64","000","00","008","0817","1161","876","307","569","68","944","1525","0","61.9","20.13"
"64","000","00","008","0818","0000","1309","487","822","58","1367","2161","0","63.26","22.54"
"64","000","00","008","0818","1162","685","250","435","23","708","1147","0","61.73","21.8"
"64","000","00","008","0818","1163","624","237","387","35","659","1014","0","64.99","23.37"
"64","000","00","008","0819","0000","1775","630","1145","95","1870","2995","0","62.44","21.04"
"64","000","00","008","0819","1164","872","323","549","43","915","1496","0","61.16","21.59"
"64","000","00","008","0819","1165","903","307","596","52","955","1499","0","63.71","20.48"
"64","000","00","008","0820","0000","1235","420","815","61","1296","1977","0","65.55","21.24"
"64","000","00","008","0820","1166","687","239","448","27","714","1138","0","62.74","21.0"
"64","000","00","008","0820","1167","548","181","367","34","582","839","0","69.37","21.57"
"64","000","00","008","0821","0000","711","252","459","31","742","2088","0","35.54","12.07"
"64","000","00","008","0821","1168","711","252","459","31","742","2088","0","35.54","12.07"
"64","000","00","008","0822","0000","1893","666","1227","72","1965","3271","0","60.07","20.36"
"64","000","00","008","0822","1169","984","358","626","27","1011","1648","0","61.35","21.72"
"64","000","00","008","0822","1170","909","308","601","45","954","1623","0","58.78","18.98"
"64","000","00","008","0823","0000","1218","430","788","46","1264","1932","0","65.42","22.26"
"64","000","00","008","0823","1171","1218","430","788","46","1264","1932","0","65.42","22.26"
"64","000","00","008","0824","0000","1559","509","1050","36","1595","2283","0","69.86","22.3"
"64","000","00","008","0824","1172","769","236","533","17","786","1127","0","69.74","20.94"
"64","000","00","008","0824","1173","790","273","517","19","809","1156","0","69.98","23.62"
"64","000","00","008","0825","0000","902","304","598","32","934","1465","0","63.75","20.75"
"64","000","00","008","0825","1174","902","304","598","32","934","1465","0","63.75","20.75"
"64","000","00","008","0826","0000","355","119","236","22","377","690","0","54.64","17.25"
"64","000","00","008","0826","1175","355","119","236","22","377","690","0","54.64","17.25"
"64","000","00","008","0827","0000","693","122","571","77","770","1283","0","60.02","9.51"
"64","000","00","008","0827","1176","693","122","571","77","770","1283","0","60.02","9.51"
"64","000","00","008","0828","0000","1596","530","1066","95","1691","2745","0","61.6","19.31"
"64","000","00","008","0828","1177","816","280","536","63","879","1432","0","61.38","19.55"
"64","000","00","008","0828","1178","780","250","530","32","812","1313","0","61.84","19.04"
"64","000","00","008","0829","0000","859","295","564","34","893","1579","0","56.55","18.68"
"64","000","00","008","0829","1179","859","295","564","34","893","1579","0","56.55","18.68"
"64","000","00","008","0830","0000","1675","558","1117","101","1776","2834","0","62.67","19.69"
"64","000","00","008","0830","1180","804","291","513","60","864","1385","0","62.38","21.01"
"64","000","00","008","0830","1181","871","267","604","41","912","1449","0","62.94","18.43"
"64","000","00","008","0831","0000","1119","398","721","48","1167","1834","0","63.63","21.7"
"64","000","00","008","0831","1182","1119","398","721","48","1167","1834","0","63.63","21.7"
"64","000","00","008","0832","0000","1763","612","1151","78","1841","2867","0","64.21","21.35"
"64","000","00","008","0832","1183","863","309","554","51","914","1436","0","63.65","21.52"
"64","000","00","008","0832","1184","900","303","597","27","927","1431","0","64.78","21.17"
"64","000","00","008","0833","0000","1705","615","1090","54","1759","2718","0","64.72","22.63"
"64","000","00","008","0833","1185","793","275","518","22","815","1248","0","65.3","22.04"
"64","000","00","008","0833","1186","912","340","572","32","944","1470","0","64.22","23.13"
"64","000","00","008","0834","0000","969","311","658","54","1023","1540","0","66.43","20.19"
"64","000","00","008","0834","1187","969","311","658","54","1023","1540","0","66.43","20.19"
"64","000","00","008","0835","0000","1411","506","905","33","1444","2213","0","65.25","22.86"
"64","000","00","008","0835","1188","859","313","546","24","883","1374","0","64.26","22.78"
"64","000","00","008","0835","1189","552","193","359","9","561","839","0","66.87","23.0"
"64","000","00","008","0836","0000","1351","451","900","33","1384","2084","0","66.41","21.64"
"64","000","00","008","0836","1190","676","249","427","20","696","1022","0","68.1","24.36"
"64","000","00","008","0836","1191","675","202","473","13","688","1062","0","64.78","19.02"
"64","000","00","008","0837","0000","1376","499","877","30","1406","2195","0","64.05","22.73"
"64","000","00","008","0837","1192","671","244","427","13","684","1078","0","63.45","22.63"
"64","000","00","008","0837","1193","705","255","450","17","722","1117","0","64.64","22.83"
"64","000","00","008","0838","0000","902","278","624","48","950","1516","0","62.66","18.34"
"64","000","00","008","0838","1194","902","278","624","48","950","1516","0","62.66","18.34"
"64","000","00","008","0839","0000","780","307","473","109","889","1440","0","61.74","21.32"
"64","000","00","008","0839","1195","780","307","473","109","889","1440","0","61.74","21.32"
"64","000","00","008","0840","0000","982","346","636","54","1036","1727","0","59.99","20.03"
"64","000","00","008","0840","1196","483","183","300","34","517","839","0","61.62","21.81"
"64","000","00","008","0840","1197","499","163","336","20","519","888","0","58.45","18.36"
"64","000","00","008","0841","0000","1372","496","876","60","1432","2105","0","68.03","23.56"
"64","000","00","008","0841","1198","693","266","427","28","721","1101","0","65.49","24.16"
"64","000","00","008","0841","1199","679","230","449","32","711","1004","0","70.82","22.91"
"64","000","00","008","0842","0000","2285","773","1512","119","2404","3779","0","63.61","20.46"
"64","000","00","008","0842","1200","837","270","567","48","885","1427","0","62.02","18.92"
"64","000","00","008","0842","1201","691","226","465","28","719","1168","0","61.56","19.35"
"64","000","00","008","0842","1202","757","277","480","43","800","1184","0","67.57","23.4"
"64","000","00","008","0843","0000","1052","376","676","40","1092","1823","0","59.9","20.63"
"64","000","00","008","0843","1203","597","218","379","29","626","974","0","64.27","22.38"
"64","000","00","008","0843","1204","455","158","297","11","466","849","0","54.89","18.61"
"64","000","00","008","0844","0000","1084","366","718","35","1119","1821","0","61.45","20.1"
"64","000","00","008","0844","1205","1084","366","718","35","1119","1821","0","61.45","20.1"
"64","000","00","008","0845","0000","2362","809","1553","90","2452","3906","0","62.78","20.71"
"64","000","00","008","0845","1206","787","263","524","44","831","1306","0","63.63","20.14"
"64","000","00","008","0845","1207","746","250","496","19","765","1185","0","64.56","21.1"
"64","000","00","008","0845","1208","829","296","533","27","856","1415","0","60.49","20.92"
"64","000","00","008","0846","0000","1140","511","629","95","1235","1926","0","64.12","26.53"
"64","000","00","008","0846","1209","597","320","277","44","641","962","0","66.63","33.26"
"64","000","00","008","0846","1210","543","191","352","51","594","964","0","61.62","19.81"
"64","000","00","008","0847","0000","901","328","573","24","925","1524","0","60.7","21.52"
"64","000","00","008","0847","1211","901","328","573","24","925","1524","0","60.7","21.52"
"64","000","00","008","0848","0000","877","318","559","23","900","1455","0","61.86","21.86"
"64","000","00","008","0848","1212","877","318","559","23","900","1455","0","61.86","21.86"
"64","000","00","008","0849","0000","1365","497","868","55","1420","2528","0","56.17","19.66"
"64","000","00","008","0849","1213","658","236","422","40","698","1272","0","54.87","18.55"
"64","000","00","008","0849","1214","707","261","446","15","722","1256","0","57.48","20.78"
"64","000","00","008","0850","0000","664","200","464","32","696","1203","0","57.86","16.63"
"64","000","00","008","0850","1215","664","200","464","32","696","1203","0","57.86","16.63"
"64","000","00","008","0851","0000","644","194","450","29","673","1062","0","63.37","18.27"
"64","000","00","008","0851","1216","644","194","450","29","673","1062","0","63.37","18.27"
"64","000","00","008","0852","0000","1160","420","740","112","1272","1860","0","68.39","22.58"
"64","000","00","008","0852","1217","528","196","332","46","574","850","0","67.53","23.06"
"64","000","00","008","0852","1218","632","224","408","66","698","1010","0","69.11","22.18"
"64","000","00","008","0853","0000","1143","299","844","65","1208","2055","0","58.78","14.55"
"64","000","00","008","0853","1219","580","109","471","27","607","1118","0","54.29","9.75"
"64","000","00","008","0853","1220","563","190","373","38","601","937","0","64.14","20.28"
"64","000","00","008","0854","0000","1485","506","979","55","1540","2676","0","57.55","18.91"
"64","000","00","008","0854","1221","764","238","526","30","794","1493","0","53.18","15.94"
"64","000","00","008","0854","1222","721","268","453","25","746","1183","0","63.06","22.65"
"64","000","00","008","0855","0000","1466","483","983","73","1539","2680","0","57.43","18.02"
"64","000","00","008","0855","1223","689","221","468","31","720","1318","0","54.63","16.77"
"64","000","00","008","0855","1224","777","262","515","42","819","1362","0","60.13","19.24"
"64","000","00","008","0856","0000","1455","479","976","110","1565","2583","0","60.59","18.54"
"64","000","00","008","0856","1225","616","196","420","65","681","1102","0","61.8","17.79"
"64","000","00","008","0856","1226","839","283","556","45","884","1481","0","59.69","19.11"
"64","000","00","008","0857","0000","1017","362","655","60","1077","1786","0","60.3","20.27"
"64","000","00","008","0857","1227","545","193","352","39","584","878","0","66.51","21.98"
"64","000","00","008","0857","1228","472","169","303","21","493","908","0","54.3","18.61"
"64","000","00","008","0858","0000","1244","431","813","72","1316","2147","0","61.29","20.07"
"64","000","00","008","0858","1229","651","245","406","41","692","1056","0","65.53","23.2"
"64","000","00","008","0858","1230","593","186","407","31","624","1091","0","57.2","17.05"
"64","000","00","008","0859","0000","1285","462","823","51","1336","2039","0","65.52","22.66"
"64","000","00","008","0859","1231","597","214","383","24","621","976","0","63.63","21.93"
"64","000","00","008","0859","1232","688","248","440","27","715","1063","0","67.26","23.33"
"64","000","00","008","0860","0000","1646","584","1062","79","1725","2774","0","62.18","21.05"
"64","000","00","008","0860","1233","877","300","577","51","928","1484","0","62.53","20.22"
"64","000","00","008","0860","1234","769","284","485","28","797","1290","0","61.78","22.02"
"64","000","00","008","0861","0000","2877","985","1892","123","3000","4982","0","60.22","19.77"
"64","000","00","008","0861","1235","1014","355","659","56","1070","1740","0","61.49","20.4"
"64","000","00","008","0861","1236","912","288","624","47","959","1594","0","60.16","18.07"
"64","000","00","008","0861","1237","951","342","609","20","971","1648","0","58.92","20.75"
"64","000","00","008","0862","0000","2237","719","1518","96","2333","3730","0","62.55","19.28"
"64","000","00","008","0862","1238","771","242","529","42","813","1236","0","65.78","19.58"
"64","000","00","008","0862","1239","715","240","475","35","750","1211","0","61.93","19.82"
"64","000","00","008","0862","1240","751","237","514","19","770","1283","0","60.02","18.47"
"64","000","00","008","0863","0000","2016","692","1324","109","2125","3522","0","60.34","19.65"
"64","000","00","008","0863","1241","987","362","625","59","1046","1804","0","57.98","20.07"
"64","000","00","008","0863","1242","1029","330","699","50","1079","1718","0","62.81","19.21"
"64","000","00","008","0864","0000","2381","1109","1272","133","2514","4053","0","62.03","27.36"
"64","000","00","008","0864","1243","781","278","503","38","819","1297","0","63.15","21.43"
"64","000","00","008","0864","1244","844","294","550","58","902","1449","0","62.25","20.29"
"64","000","00","008","0864","1245","756","537","219","37","793","1307","0","60.67","41.09"
"64","000","00","008","0865","0000","1486","527","959","103","1589","2434","0","65.28","21.65"
"64","000","00","008","0865","1246","711","244","467","40","751","1184","0","63.43","20.61"
"64","000","00","008","0865","1247","775","283","492","63","838","1250","0","67.04","22.64"
"64","000","00","008","0866","0000","1466","478","988","50","1516","2531","0","59.9","18.89"
"64","000","00","008","0866","1248","709","253","456","26","735","1248","0","58.89","20.27"
"64","000","00","008","0866","1249","757","225","532","24","781","1283","0","60.87","17.54"
"64","000","00","008","0867","0000","2206","800","1406","81","2287","3718","0","61.51","21.52"
"64","000","00","008","0867","1250","681","200","481","30","711","1121","0","63.43","17.84"
"64","000","00","008","0867","1251","742","230","512","25","767","1258","0","60.97","18.28"
"64","000","00","008","0867","1252","783","370","413","26","809","1339","0","60.42","27.63"
"64","000","00","008","0868","0000","1089","356","733","57","1146","1986","0","57.7","17.93"
"64","000","00","008","0868","1253","1089","356","733","57","1146","1986","0","57.7","17.93"
"64","000","00","008","0869","0000","1144","404","740","42","1186","1976","0","60.02","20.45"
"64","000","00","008","0869","1254","569","190","379","27","596","1028","0","57.98","18.48"
"64","000","00","008","0869","1255","575","214","361","15","590","948","0","62.24","22.57"
"64","000","00","009","0000","0000","89040","30275","58765","5948","94988","161797","188516","58.71","18.71"
"64","000","00","009","0901","0000","4456","1802","2654","357","4813","9323","0","51.63","19.33"
"64","000","00","009","0901","1484","889","284","605","112","1001","1809","0","55.33","15.7"
"64","000","00","009","0901","1485","924","298","626","79","1003","1835","0","54.66","16.24"
"64","000","00","009","0901","1486","783","282","501","61","844","1890","0","44.66","14.92"
"64","000","00","009","0901","1487","961","338","623","51","1012","2013","0","50.27","16.79"
"64","000","00","009","0901","1488","899","600","299","54","953","1776","0","53.66","33.78"
"64","000","00","009","0902","0000","1102","417","685","153","1255","2377","0","52.8","17.54"
"64","000","00","009","0902","1489","754","285","469","80","834","1705","0","48.91","16.72"
"64","000","00","009","0902","1490","348","132","216","73","421","672","0","62.65","19.64"
"64","000","00","009","0903","0000","2555","926","1629","213","2768","5013","0","55.22","18.47"
"64","000","00","009","0903","1491","766","264","502","88","854","1726","0","49.48","15.3"
"64","000","00","009","0903","1492","872","330","542","37","909","1597","0","56.92","20.66"
"64","000","00","009","0903","1493","917","332","585","88","1005","1690","0","59.47","19.64"
"64","000","00","009","0904","0000","1331","414","917","131","1462","2239","0","65.3","18.49"
"64","000","00","009","0904","1494","627","192","435","64","691","1080","0","63.98","17.78"
"64","000","00","009","0904","1495","704","222","482","67","771","1159","0","66.52","19.15"
"64","000","00","009","0905","0000","672","226","446","68","740","1314","0","56.32","17.2"
"64","000","00","009","0905","1496","672","226","446","68","740","1314","0","56.32","17.2"
"64","000","00","009","0906","0000","1071","361","710","90","1161","1898","0","61.17","19.02"
"64","000","00","009","0906","1497","508","163","345","57","565","896","0","63.06","18.19"
"64","000","00","009","0906","1498","563","198","365","33","596","1002","0","59.48","19.76"
"64","000","00","009","0907","0000","986","341","645","91","1077","2765","0","38.95","12.33"
"64","000","00","009","0907","1499","986","341","645","91","1077","2765","0","38.95","12.33"
"64","000","00","009","0908","0000","326","104","222","57","383","600","0","63.83","17.33"
"64","000","00","009","0908","1500","326","104","222","57","383","600","0","63.83","17.33"
"64","000","00","009","0909","0000","520","172","348","34","554","1466","0","37.79","11.73"
"64","000","00","009","0909","1501","520","172","348","34","554","1466","0","37.79","11.73"
"64","000","00","009","0910","0000","758","254","504","52","810","1449","0","55.9","17.53"
"64","000","00","009","0910","1502","758","254","504","52","810","1449","0","55.9","17.53"
"64","000","00","009","0911","0000","1194","356","838","129","1323","2239","0","59.09","15.9"
"64","000","00","009","0911","1503","506","141","365","51","557","991","0","56.21","14.23"
"64","000","00","009","0911","1504","688","215","473","78","766","1248","0","61.38","17.23"
"64","000","00","009","0912","0000","594","201","393","92","686","1066","0","64.35","18.86"
"64","000","00","009","0912","1505","594","201","393","92","686","1066","0","64.35","18.86"
"64","000","00","009","0913","0000","362","133","229","31","393","706","0","55.67","18.84"
"64","000","00","009","0913","1506","362","133","229","31","393","706","0","55.67","18.84"
"64","000","00","009","0914","0000","351","103","248","37","388","713","0","54.42","14.45"
"64","000","00","009","0914","1507","351","103","248","37","388","713","0","54.42","14.45"
"64","000","00","009","0915","0000","684","240","444","46","730","1344","0","54.32","17.86"
"64","000","00","009","0915","1508","684","240","444","46","730","1344","0","54.32","17.86"
"64","000","00","009","0916","0000","911","331","580","103","1014","1729","0","58.65","19.14"
"64","000","00","009","0916","1509","474","180","294","55","529","856","0","61.8","21.03"
"64","000","00","009","0916","1510","437","151","286","48","485","873","0","55.56","17.3"
"64","000","00","009","0917","0000","1098","373","725","71","1169","2226","0","52.52","16.76"
"64","000","00","009","0917","1511","541","169","372","55","596","1114","0","53.5","15.17"
"64","000","00","009","0917","1512","557","204","353","16","573","1112","0","51.53","18.35"
"64","000","00","009","0918","0000","1033","364","669","91","1124","1984","0","56.65","18.35"
"64","000","00","009","0918","1513","548","201","347","57","605","1044","0","57.95","19.25"
"64","000","00","009","0918","1514","485","163","322","34","519","940","0","55.21","17.34"
"64","000","00","009","0919","0000","2281","787","1494","170","2451","4064","0","60.31","19.37"
"64","000","00","009","0919","1515","640","198","442","72","712","1342","0","53.06","14.75"
"64","000","00","009","0919","1516","873","310","563","55","928","1402","0","66.19","22.11"
"64","000","00","009","0919","1517","768","279","489","43","811","1320","0","61.44","21.14"
"64","000","00","009","0920","0000","526","162","364","53","579","958","0","60.44","16.91"
"64","000","00","009","0920","1518","526","162","364","53","579","958","0","60.44","16.91"
"64","000","00","009","0921","0000","1693","576","1117","100","1793","2735","0","65.56","21.06"
"64","000","00","009","0921","1519","844","281","563","31","875","1276","0","68.57","22.02"
"64","000","00","009","0921","1520","849","295","554","69","918","1459","0","62.92","20.22"
"64","000","00","009","0922","0000","373","119","254","19","392","761","0","51.51","15.64"
"64","000","00","009","0922","1521","373","119","254","19","392","761","0","51.51","15.64"
"64","000","00","009","0923","0000","578","216","362","26","604","1093","0","55.26","19.76"
"64","000","00","009","0923","1522","578","216","362","26","604","1093","0","55.26","19.76"
"64","000","00","009","0924","0000","2838","773","2065","93","2931","4899","0","59.83","15.78"
"64","000","00","009","0924","1523","937","234","703","39","976","1521","0","64.17","15.38"
"64","000","00","009","0924","1524","947","252","695","24","971","1557","0","62.36","16.18"
"64","000","00","009","0924","1525","954","287","667","30","984","1821","0","54.04","15.76"
"64","000","00","009","0925","0000","1375","272","1103","43","1418","2112","0","67.14","12.88"
"64","000","00","009","0925","1526","707","103","604","30","737","1066","0","69.14","9.66"
"64","000","00","009","0925","1527","668","169","499","13","681","1046","0","65.11","16.16"
"64","000","00","009","0928","0000","1940","633","1307","128","2068","3432","0","60.26","18.44"
"64","000","00","009","0928","1528","958","316","642","46","1004","1709","0","58.75","18.49"
"64","000","00","009","0928","1529","982","317","665","82","1064","1723","0","61.75","18.4"
"64","000","00","009","0929","0000","2534","896","1638","106","2640","3994","0","66.1","22.43"
"64","000","00","009","0929","1530","758","275","483","32","790","1202","0","65.72","22.88"
"64","000","00","009","0929","1531","827","296","531","39","866","1279","0","67.71","23.14"
"64","000","00","009","0929","1532","949","325","624","35","984","1513","0","65.04","21.48"
"64","000","00","009","0930","0000","740","238","502","21","761","1260","0","60.4","18.89"
"64","000","00","009","0930","1533","740","238","502","21","761","1260","0","60.4","18.89"
"64","000","00","009","0931","0000","1415","504","911","107","1522","2279","0","66.78","22.11"
"64","000","00","009","0931","1534","687","245","442","69","756","1139","0","66.37","21.51"
"64","000","00","009","0931","1535","728","259","469","38","766","1140","0","67.19","22.72"
"64","000","00","009","0932","0000","1664","593","1071","108","1772","2821","0","62.81","21.02"
"64","000","00","009","0932","1536","852","317","535","72","924","1462","0","63.2","21.68"
"64","000","00","009","0932","1537","812","276","536","36","848","1359","0","62.4","20.31"
"64","000","00","009","0933","0000","1001","343","658","72","1073","2037","0","52.68","16.84"
"64","000","00","009","0933","1538","1001","343","658","72","1073","2037","0","52.68","16.84"
"64","000","00","009","0934","0000","1542","508","1034","28","1570","2717","0","57.78","18.7"
"64","000","00","009","0934","1539","793","271","522","12","805","1410","0","57.09","19.22"
"64","000","00","009","0934","1540","749","237","512","16","765","1307","0","58.53","18.13"
"64","000","00","009","0935","0000","1675","584","1091","136","1811","3003","0","60.31","19.45"
"64","000","00","009","0935","1541","823","282","541","72","895","1512","0","59.19","18.65"
"64","000","00","009","0935","1542","852","302","550","64","916","1491","0","61.44","20.25"
"64","000","00","009","0936","0000","1658","539","1119","115","1773","3143","0","56.41","17.15"
"64","000","00","009","0936","1543","894","286","608","62","956","1621","0","58.98","17.64"
"64","000","00","009","0936","1544","764","253","511","53","817","1522","0","53.68","16.62"
"64","000","00","009","0937","0000","3088","1083","2005","201","3289","5348","0","61.5","20.25"
"64","000","00","009","0937","1545","908","318","590","54","962","1593","0","60.39","19.96"
"64","000","00","009","0937","1546","1088","378","710","71","1159","1885","0","61.49","20.05"
"64","000","00","009","0937","1547","1092","387","705","76","1168","1870","0","62.46","20.7"
"64","000","00","009","0938","0000","1612","518","1094","69","1681","2736","0","61.44","18.93"
"64","000","00","009","0938","1548","827","278","549","23","850","1388","0","61.24","20.03"
"64","000","00","009","0938","1549","785","240","545","46","831","1348","0","61.65","17.8"
"64","000","00","009","0939","0000","1532","492","1040","134","1666","2705","0","61.59","18.19"
"64","000","00","009","0939","1550","688","206","482","93","781","1341","0","58.24","15.36"
"64","000","00","009","0939","1551","844","286","558","41","885","1364","0","64.88","20.97"
"64","000","00","009","0940","0000","1485","490","995","135","1620","2693","0","60.16","18.2"
"64","000","00","009","0940","1552","772","254","518","63","835","1367","0","61.08","18.58"
"64","000","00","009","0940","1553","713","236","477","72","785","1326","0","59.2","17.8"
"64","000","00","009","0941","0000","1268","428","840","53","1321","2178","0","60.65","19.65"
"64","000","00","009","0941","1554","584","194","390","37","621","1059","0","58.64","18.32"
"64","000","00","009","0941","1555","684","234","450","16","700","1119","0","62.56","20.91"
"64","000","00","009","0942","0000","3837","1337","2500","148","3985","6642","0","60.0","20.13"
"64","000","00","009","0942","1556","841","298","543","38","879","1565","0","56.17","19.04"
"64","000","00","009","0942","1557","842","284","558","68","910","1549","0","58.75","18.33"
"64","000","00","009","0942","1558","1080","379","701","17","1097","1691","0","64.87","22.41"
"64","000","00","009","0942","1559","1074","376","698","25","1099","1837","0","59.83","20.47"
"64","000","00","009","0943","0000","1342","458","884","70","1412","2218","0","63.66","20.65"
"64","000","00","009","0943","1560","684","237","447","17","701","1092","0","64.19","21.7"
"64","000","00","009","0943","1561","658","221","437","53","711","1126","0","63.14","19.63"
"64","000","00","009","0944","0000","2445","859","1586","124","2569","4106","0","62.57","20.92"
"64","000","00","009","0944","1562","638","216","422","69","707","1215","0","58.19","17.78"
"64","000","00","009","0944","1563","844","314","530","32","876","1443","0","60.71","21.76"
"64","000","00","009","0944","1564","963","329","634","23","986","1448","0","68.09","22.72"
"64","000","00","009","0945","0000","1780","613","1167","138","1918","3251","0","59.0","18.86"
"64","000","00","009","0945","1565","943","329","614","71","1014","1648","0","61.53","19.96"
"64","000","00","009","0945","1566","837","284","553","67","904","1603","0","56.39","17.72"
"64","000","00","009","0946","0000","786","285","501","31","817","1596","0","51.19","17.86"
"64","000","00","009","0946","1567","786","285","501","31","817","1596","0","51.19","17.86"
"64","000","00","009","0947","0000","2489","819","1670","175","2664","4607","0","57.83","17.78"
"64","000","00","009","0947","1568","745","219","526","27","772","1450","0","53.24","15.1"
"64","000","00","009","0947","1569","774","272","502","75","849","1510","0","56.23","18.01"
"64","000","00","009","0947","1570","970","328","642","73","1043","1647","0","63.33","19.91"
"64","000","00","009","0948","0000","1440","498","942","95","1535","2726","0","56.31","18.27"
"64","000","00","009","0948","1571","726","242","484","55","781","1342","0","58.2","18.03"
"64","000","00","009","0948","1572","714","256","458","40","754","1384","0","54.48","18.5"
"64","000","00","009","0949","0000","2635","914","1721","132","2767","4620","0","59.89","19.78"
"64","000","00","009","0949","1573","790","260","530","57","847","1479","0","57.27","17.58"
"64","000","00","009","0949","1574","917","292","625","30","947","1546","0","61.25","18.89"
"64","000","00","009","0949","1575","928","362","566","45","973","1595","0","61.0","22.7"
"64","000","00","009","0950","0000","1267","399","868","82","1349","2283","0","59.09","17.48"
"64","000","00","009","0950","1576","695","216","479","56","751","1201","0","62.53","17.99"
"64","000","00","009","0950","1577","572","183","389","26","598","1082","0","55.27","16.91"
"64","000","00","009","0951","0000","1011","314","697","119","1130","1928","0","58.61","16.29"
"64","000","00","009","0951","1578","506","179","327","40","546","996","0","54.82","17.97"
"64","000","00","009","0951","1579","505","135","370","79","584","932","0","62.66","14.48"
"64","000","00","009","0952","0000","2132","729","1403","86","2218","3574","0","62.06","20.4"
"64","000","00","009","0952","1580","661","201","460","37","698","1146","0","60.91","17.54"
"64","000","00","009","0952","1581","638","230","408","29","667","1096","0","60.86","20.99"
"64","000","00","009","0952","1582","833","298","535","20","853","1332","0","64.04","22.37"
"64","000","00","009","0953","0000","1985","690","1295","145","2130","3477","0","61.26","19.84"
"64","000","00","009","0953","1583","663","234","429","37","700","1175","0","59.57","19.91"
"64","000","00","009","0953","1584","553","186","367","52","605","986","0","61.36","18.86"
"64","000","00","009","0953","1585","769","270","499","56","825","1316","0","62.69","20.52"
"64","000","00","009","0954","0000","1724","616","1108","133","1857","3181","0","58.38","19.36"
"64","000","00","009","0954","1586","765","285","480","62","827","1559","0","53.05","18.28"
"64","000","00","009","0954","1587","959","331","628","71","1030","1622","0","63.5","20.41"
"64","000","00","009","0955","0000","1471","488","983","100","1571","2609","0","60.21","18.7"
"64","000","00","009","0955","1588","724","224","500","32","756","1310","0","57.71","17.1"
"64","000","00","009","0955","1589","747","264","483","68","815","1299","0","62.74","20.32"
"64","000","00","009","0956","0000","1474","472","1002","95","1569","2566","0","61.15","18.39"
"64","000","00","009","0956","1590","736","234","502","63","799","1191","0","67.09","19.65"
"64","000","00","009","0956","1591","738","238","500","32","770","1375","0","56.0","17.31"
"64","000","00","009","0957","0000","1398","463","935","59","1457","2513","0","57.98","18.42"
"64","000","00","009","0957","1592","756","248","508","30","786","1338","0","58.74","18.54"
"64","000","00","009","0957","1593","642","215","427","29","671","1175","0","57.11","18.3"
"64","000","00","009","0958","0000","1437","488","949","87","1524","2544","0","59.91","19.18"
"64","000","00","009","0958","1594","733","248","485","33","766","1357","0","56.45","18.28"
"64","000","00","009","0958","1595","704","240","464","54","758","1187","0","63.86","20.22"
"64","000","00","009","0959","0000","1372","482","890","95","1467","2383","0","61.56","20.23"
"64","000","00","009","0959","1596","648","213","435","41","689","1164","0","59.19","18.3"
"64","000","00","009","0959","1597","724","269","455","54","778","1219","0","63.82","22.07"
"64","000","00","009","0960","0000","2500","908","1592","149","2649","4454","0","59.47","20.39"
"64","000","00","009","0960","1598","785","270","515","23","808","1428","0","56.58","18.91"
"64","000","00","009","0960","1599","804","279","525","82","886","1495","0","59.26","18.66"
"64","000","00","009","0960","1600","911","359","552","44","955","1531","0","62.38","23.45"
"64","000","00","009","0961","0000","1693","571","1122","122","1815","3100","0","58.55","18.42"
"64","000","00","009","0961","1601","846","302","544","57","903","1509","0","59.84","20.01"
"64","000","00","009","0961","1602","847","269","578","65","912","1591","0","57.32","16.91"
"64","000","00","010","0000","0000","11974","4223","7751","1017","12991","24860","28533","52.26","16.99"
"64","000","00","010","1001","0000","655","232","423","90","745","1177","0","63.3","19.71"
"64","000","00","010","1001","0869","655","232","423","90","745","1177","0","63.3","19.71"
"64","000","00","010","1002","0000","533","163","370","54","587","1109","0","52.93","14.7"
"64","000","00","010","1002","0870","533","163","370","54","587","1109","0","52.93","14.7"
"64","000","00","010","1003","0000","766","286","480","20","786","1642","0","47.87","17.42"
"64","000","00","010","1003","0871","766","286","480","20","786","1642","0","47.87","17.42"
"64","000","00","010","1004","0000","1101","364","737","127","1228","2321","0","52.91","15.68"
"64","000","00","010","1004","0872","592","184","408","77","669","1209","0","55.33","15.22"
"64","000","00","010","1004","0873","509","180","329","50","559","1112","0","50.27","16.19"
"64","000","00","010","1005","0000","1425","442","983","115","1540","2943","0","52.33","15.02"
"64","000","00","010","1005","0874","781","240","541","85","866","1483","0","58.4","16.18"
"64","000","00","010","1005","0875","644","202","442","30","674","1460","0","46.16","13.84"
"64","000","00","010","1006","0000","866","327","539","121","987","1572","0","62.79","20.8"
"64","000","00","010","1006","0876","866","327","539","121","987","1572","0","62.79","20.8"
"64","000","00","010","1007","0000","640","211","429","28","668","1384","0","48.27","15.25"
"64","000","00","010","1007","0877","640","211","429","28","668","1384","0","48.27","15.25"
"64","000","00","010","1008","0000","1233","394","839","85","1318","2629","0","50.13","14.99"
"64","000","00","010","1008","0878","653","202","451","36","689","1390","0","49.57","14.53"
"64","000","00","010","1008","0879","580","192","388","49","629","1239","0","50.77","15.5"
"64","000","00","010","1009","0000","999","343","656","96","1095","2045","0","53.55","16.77"
"64","000","00","010","1009","0880","999","343","656","96","1095","2045","0","53.55","16.77"
"64","000","00","010","1010","0000","1354","417","937","110","1464","2759","0","53.06","15.11"
"64","000","00","010","1010","0881","427","116","311","23","450","893","0","50.39","12.99"
"64","000","00","010","1010","0882","927","301","626","87","1014","1866","0","54.34","16.13"
"64","000","00","010","1011","0000","735","258","477","43","778","1874","0","41.52","13.77"
"64","000","00","010","1011","0883","735","258","477","43","778","1874","0","41.52","13.77"
"64","000","00","010","1012","0000","398","129","269","63","461","893","0","51.62","14.45"
"64","000","00","010","1012","0884","398","129","269","63","461","893","0","51.62","14.45"
"64","000","00","010","1013","0000","1269","657","612","65","1334","2512","0","53.11","26.15"
"64","000","00","010","1013","0885","662","440","222","28","690","1215","0","56.79","36.21"
"64","000","00","010","1013","0886","607","217","390","37","644","1297","0","49.65","16.73"
"64","000","00","011","0000","0000","73685","25181","48504","4154","77839","132733","157685","58.64","18.97"
"64","000","00","011","1101","0000","1367","442","925","85","1452","2279","0","63.71","19.39"
"64","000","00","011","1101","1603","687","237","450","27","714","1108","0","64.44","21.39"
"64","000","00","011","1101","1604","680","205","475","58","738","1171","0","63.02","17.51"
"64","000","00","011","1102","0000","1854","653","1201","34","1888","3225","0","58.54","20.25"
"64","000","00","011","1102","1605","970","364","606","15","985","1557","0","63.26","23.38"
"64","000","00","011","1102","1606","884","289","595","19","903","1668","0","54.14","17.33"
"64","000","00","011","1103","0000","1535","502","1033","50","1585","2555","0","62.04","19.65"
"64","000","00","011","1103","1607","748","233","515","19","767","1183","0","64.84","19.7"
"64","000","00","011","1103","1608","787","269","518","31","818","1372","0","59.62","19.61"
"64","000","00","011","1104","0000","1018","340","678","56","1074","1737","0","61.83","19.57"
"64","000","00","011","1104","1609","1018","340","678","56","1074","1737","0","61.83","19.57"
"64","000","00","011","1105","0000","1636","550","1086","110","1746","3144","0","55.53","17.49"
"64","000","00","011","1105","1610","841","316","525","67","908","1586","0","57.25","19.92"
"64","000","00","011","1105","1611","795","234","561","43","838","1558","0","53.79","15.02"
"64","000","00","011","1106","0000","1528","491","1037","107","1635","2533","0","64.55","19.38"
"64","000","00","011","1106","1612","792","258","534","62","854","1284","0","66.51","20.09"
"64","000","00","011","1106","1613","736","233","503","45","781","1249","0","62.53","18.65"
"64","000","00","011","1107","0000","1060","371","689","86","1146","2400","0","47.75","15.46"
"64","000","00","011","1107","1614","1060","371","689","86","1146","2400","0","47.75","15.46"
"64","000","00","011","1108","0000","1299","450","849","61","1360","2260","0","60.18","19.91"
"64","000","00","011","1108","1615","702","243","459","31","733","1181","0","62.07","20.58"
"64","000","00","011","1108","1616","597","207","390","30","627","1079","0","58.11","19.18"
"64","000","00","011","1109","0000","1463","508","955","94","1557","2576","0","60.44","19.72"
"64","000","00","011","1109","1617","747","276","471","42","789","1335","0","59.1","20.67"
"64","000","00","011","1109","1618","716","232","484","52","768","1241","0","61.89","18.69"
"64","000","00","011","1110","0000","3243","968","2275","167","3410","5796","0","58.83","16.7"
"64","000","00","011","1110","1619","811","160","651","43","854","1513","0","56.44","10.58"
"64","000","00","011","1110","1620","788","249","539","55","843","1349","0","62.49","18.46"
"64","000","00","011","1110","1621","805","253","552","46","851","1483","0","57.38","17.06"
"64","000","00","011","1110","1622","839","306","533","23","862","1451","0","59.41","21.09"
"64","000","00","011","1111","0000","1452","487","965","81","1533","2503","0","61.25","19.46"
"64","000","00","011","1111","1623","655","212","443","26","681","1241","0","54.88","17.08"
"64","000","00","011","1111","1624","797","275","522","55","852","1262","0","67.51","21.79"
"64","000","00","011","1112","0000","1912","616","1296","121","2033","3690","0","55.09","16.69"
"64","000","00","011","1112","1625","990","316","674","84","1074","1813","0","59.24","17.43"
"64","000","00","011","1112","1626","922","300","622","37","959","1877","0","51.09","15.98"
"64","000","00","011","1113","0000","1656","808","848","57","1713","2844","0","60.23","28.41"
"64","000","00","011","1113","1627","785","527","258","29","814","1391","0","58.52","37.89"
"64","000","00","011","1113","1628","871","281","590","28","899","1453","0","61.87","19.34"
"64","000","00","011","1114","0000","2327","835","1492","124","2451","4056","0","60.43","20.59"
"64","000","00","011","1114","1629","779","252","527","38","817","1374","0","59.46","18.34"
"64","000","00","011","1114","1630","758","232","526","39","797","1348","0","59.12","17.21"
"64","000","00","011","1114","1631","790","351","439","47","837","1334","0","62.74","26.31"
"64","000","00","011","1115","0000","2470","894","1576","105","2575","4369","0","58.94","20.46"
"64","000","00","011","1115","1632","813","292","521","25","838","1433","0","58.48","20.38"
"64","000","00","011","1115","1633","759","282","477","17","776","1448","0","53.59","19.48"
"64","000","00","011","1115","1634","898","320","578","63","961","1488","0","64.58","21.51"
"64","000","00","011","1116","0000","1593","542","1051","99","1692","2584","0","65.48","20.98"
"64","000","00","011","1116","1635","735","242","493","57","792","1278","0","61.97","18.94"
"64","000","00","011","1116","1636","858","300","558","42","900","1306","0","68.91","22.97"
"64","000","00","011","1117","0000","1907","611","1296","132","2039","3265","0","62.45","18.71"
"64","000","00","011","1117","1637","917","252","665","72","989","1625","0","60.86","15.51"
"64","000","00","011","1117","1638","990","359","631","60","1050","1640","0","64.02","21.89"
"64","000","00","011","1118","0000","1596","488","1108","92","1688","2944","0","57.34","16.58"
"64","000","00","011","1118","1639","844","256","588","42","886","1506","0","58.83","17.0"
"64","000","00","011","1118","1640","752","232","520","50","802","1438","0","55.77","16.13"
"64","000","00","011","1119","0000","1358","404","954","54","1412","2272","0","62.15","17.78"
"64","000","00","011","1119","1641","721","215","506","32","753","1105","0","68.14","19.46"
"64","000","00","011","1119","1642","637","189","448","22","659","1167","0","56.47","16.2"
"64","000","00","011","1120","0000","2430","799","1631","95","2525","4039","0","62.52","19.78"
"64","000","00","011","1120","1643","868","274","594","27","895","1420","0","63.03","19.3"
"64","000","00","011","1120","1644","862","303","559","40","902","1380","0","65.36","21.96"
"64","000","00","011","1120","1645","700","222","478","28","728","1239","0","58.76","17.92"
"64","000","00","011","1121","0000","1865","946","919","90","1955","3207","0","60.96","29.5"
"64","000","00","011","1121","1646","927","627","300","37","964","1563","0","61.68","40.12"
"64","000","00","011","1121","1647","938","319","619","53","991","1644","0","60.28","19.4"
"64","000","00","011","1122","0000","6028","2234","3794","343","6371","11107","0","57.36","20.11"
"64","000","00","011","1122","1648","1038","643","395","62","1100","1895","0","58.05","33.93"
"64","000","00","011","1122","1649","917","287","630","89","1006","1748","0","57.55","16.42"
"64","000","00","011","1122","1650","922","309","613","54","976","1579","0","61.81","19.57"
"64","000","00","011","1122","1651","1142","408","734","43","1185","2135","0","55.5","19.11"
"64","000","00","011","1122","1652","961","221","740","56","1017","1728","0","58.85","12.79"
"64","000","00","011","1122","1653","1048","366","682","39","1087","2022","0","53.76","18.1"
"64","000","00","011","1123","0000","2064","624","1440","138","2202","3916","0","56.23","15.93"
"64","000","00","011","1123","1654","640","187","453","24","664","1329","0","49.96","14.07"
"64","000","00","011","1123","1655","713","213","500","44","757","1320","0","57.35","16.14"
"64","000","00","011","1123","1656","711","224","487","70","781","1267","0","61.64","17.68"
"64","000","00","011","1124","0000","1535","524","1011","112","1647","2587","0","63.66","20.26"
"64","000","00","011","1124","1657","755","254","501","76","831","1298","0","64.02","19.57"
"64","000","00","011","1124","1658","780","270","510","36","816","1289","0","63.3","20.95"
"64","000","00","011","1125","0000","1758","529","1229","86","1844","3028","0","60.9","17.47"
"64","000","00","011","1125","1659","894","270","624","45","939","1534","0","61.21","17.6"
"64","000","00","011","1125","1660","864","259","605","41","905","1494","0","60.58","17.34"
"64","000","00","011","1126","0000","1568","474","1094","131","1699","2721","0","62.44","17.42"
"64","000","00","011","1126","1661","759","213","546","77","836","1377","0","60.71","15.47"
"64","000","00","011","1126","1662","809","261","548","54","863","1344","0","64.21","19.42"
"64","000","00","011","1127","0000","3205","1031","2174","148","3353","5757","0","58.24","17.91"
"64","000","00","011","1127","1663","833","287","546","49","882","1508","0","58.49","19.03"
"64","000","00","011","1127","1664","743","253","490","28","771","1400","0","55.07","18.07"
"64","000","00","011","1127","1665","865","273","592","48","913","1457","0","62.66","18.74"
"64","000","00","011","1127","1666","764","218","546","23","787","1392","0","56.54","15.66"
"64","000","00","011","1128","0000","2318","777","1541","126","2444","4487","0","54.47","17.32"
"64","000","00","011","1128","1667","1033","374","659","61","1094","1983","0","55.17","18.86"
"64","000","00","011","1128","1668","667","229","438","26","693","1204","0","57.56","19.02"
"64","000","00","011","1128","1669","618","174","444","39","657","1300","0","50.54","13.38"
"64","000","00","011","1129","0000","1951","614","1337","118","2069","3423","0","60.44","17.94"
"64","000","00","011","1129","1670","1061","317","744","96","1157","1857","0","62.3","17.07"
"64","000","00","011","1129","1671","890","297","593","22","912","1566","0","58.24","18.97"
"64","000","00","011","1130","0000","1586","539","1047","115","1701","2579","0","65.96","20.9"
"64","000","00","011","1130","1672","841","280","561","47","888","1343","0","66.12","20.85"
"64","000","00","011","1130","1673","745","259","486","68","813","1236","0","65.78","20.95"
"64","000","00","011","1131","0000","4406","1548","2858","207","4613","7715","0","59.79","20.06"
"64","000","00","011","1131","1674","919","311","608","81","1000","1564","0","63.94","19.88"
"64","000","00","011","1131","1675","842","289","553","33","875","1484","0","58.96","19.47"
"64","000","00","011","1131","1676","830","275","555","28","858","1477","0","58.09","18.62"
"64","000","00","011","1131","1677","908","367","541","28","936","1482","0","63.16","24.76"
"64","000","00","011","1131","1678","907","306","601","37","944","1708","0","55.27","17.92"
"64","000","00","011","1132","0000","1925","666","1259","91","2016","3576","0","56.38","18.62"
"64","000","00","011","1132","1679","999","318","681","69","1068","1867","0","57.2","17.03"
"64","000","00","011","1132","1680","926","348","578","22","948","1709","0","55.47","20.36"
"64","000","00","011","1133","0000","1507","468","1039","105","1612","3121","0","51.65","15.0"
"64","000","00","011","1133","1681","725","239","486","60","785","1425","0","55.09","16.77"
"64","000","00","011","1133","1682","782","229","553","45","827","1696","0","48.76","13.5"
"64","000","00","011","1134","0000","1571","541","1030","108","1679","3053","0","55.0","17.72"
"64","000","00","011","1134","1683","740","268","472","35","775","1522","0","50.92","17.61"
"64","000","00","011","1134","1684","831","273","558","73","904","1531","0","59.05","17.83"
"64","000","00","011","1135","0000","1089","357","732","132","1221","2215","0","55.12","16.12"
"64","000","00","011","1135","1685","1089","357","732","132","1221","2215","0","55.12","16.12"
"64","000","00","011","1136","0000","1578","559","1019","84","1662","3050","0","54.49","18.33"
"64","000","00","011","1136","1686","798","272","526","45","843","1515","0","55.64","17.95"
"64","000","00","011","1136","1687","780","287","493","39","819","1535","0","53.36","18.7"
"64","000","00","011","1137","0000","1295","441","854","59","1354","2493","0","54.31","17.69"
"64","000","00","011","1137","1688","687","224","463","26","713","1276","0","55.88","17.55"
"64","000","00","011","1137","1689","608","217","391","33","641","1217","0","52.67","17.83"
"64","000","00","011","1138","0000","1732","550","1182","151","1883","3627","0","51.92","15.16"
"64","000","00","011","1138","1690","794","250","544","61","855","1707","0","50.09","14.65"
"64","000","00","011","1138","1691","938","300","638","90","1028","1920","0","53.54","15.63"
"64","000","00","012","0000","0000","169625","55770","113855","9216","178841","300510","359100","59.51","18.56"
"64","000","00","012","1201","0000","263","91","172","6","269","423","0","63.59","21.51"
"64","000","00","012","1201","1306","263","91","172","6","269","423","0","63.59","21.51"
"64","000","00","012","1202","0000","352","121","231","18","370","618","0","59.87","19.58"
"64","000","00","012","1202","1305","352","121","231","18","370","618","0","59.87","19.58"
"64","000","00","012","1203","0000","732","221","511","48","780","1312","0","59.45","16.84"
"64","000","00","012","1203","1307","732","221","511","48","780","1312","0","59.45","16.84"
"64","000","00","012","1204","0000","579","209","370","44","623","875","0","71.2","23.89"
"64","000","00","012","1204","1321","579","209","370","44","623","875","0","71.2","23.89"
"64","000","00","012","1205","0000","501","161","340","30","531","882","0","60.2","18.25"
"64","000","00","012","1205","1314","501","161","340","30","531","882","0","60.2","18.25"
"64","000","00","012","1206","0000","1212","428","784","44","1256","1982","0","63.37","21.59"
"64","000","00","012","1206","1308","444","166","278","24","468","769","0","60.86","21.59"
"64","000","00","012","1206","1309","768","262","506","20","788","1213","0","64.96","21.6"
"64","000","00","012","1207","0000","671","241","430","47","718","1080","0","66.48","22.31"
"64","000","00","012","1207","1256","671","241","430","47","718","1080","0","66.48","22.31"
"64","000","00","012","1208","0000","2115","693","1422","131","2246","3395","0","66.16","20.41"
"64","000","00","012","1208","1334","728","264","464","49","777","1159","0","67.04","22.78"
"64","000","00","012","1208","1335","630","180","450","43","673","1127","0","59.72","15.97"
"64","000","00","012","1208","1336","757","249","508","39","796","1109","0","71.78","22.45"
"64","000","00","012","1209","0000","4487","1503","2984","233","4720","8473","0","55.71","17.74"
"64","000","00","012","1209","1268","822","260","562","77","899","1496","0","60.09","17.38"
"64","000","00","012","1209","1269","994","360","634","54","1048","2094","0","50.05","17.19"
"64","000","00","012","1209","1270","920","300","620","20","940","1672","0","56.22","17.94"
"64","000","00","012","1209","1271","949","331","618","19","968","1761","0","54.97","18.8"
"64","000","00","012","1209","1272","802","252","550","63","865","1450","0","59.66","17.38"
"64","000","00","012","1210","0000","480","162","318","33","513","819","0","62.64","19.78"
"64","000","00","012","1210","1257","480","162","318","33","513","819","0","62.64","19.78"
"64","000","00","012","1211","0000","2064","747","1317","113","2177","3533","0","61.62","21.14"
"64","000","00","012","1211","1277","724","275","449","50","774","1247","0","62.07","22.05"
"64","000","00","012","1211","1278","631","234","397","37","668","1087","0","61.45","21.53"
"64","000","00","012","1211","1279","709","238","471","26","735","1199","0","61.3","19.85"
"64","000","00","012","1212","0000","2764","1004","1760","135","2899","4957","0","58.48","20.25"
"64","000","00","012","1212","1260","737","228","509","35","772","1223","0","63.12","18.64"
"64","000","00","012","1212","1261","712","324","388","38","750","1207","0","62.14","26.84"
"64","000","00","012","1212","1262","708","231","477","32","740","1339","0","55.27","17.25"
"64","000","00","012","1212","1263","607","221","386","30","637","1188","0","53.62","18.6"
"64","000","00","012","1213","0000","1335","394","941","60","1395","2465","0","56.59","15.98"
"64","000","00","012","1213","1340","772","232","540","46","818","1432","0","57.12","16.2"
"64","000","00","012","1213","1341","563","162","401","14","577","1033","0","55.86","15.68"
"64","000","00","012","1214","0000","3181","1001","2180","161","3342","5972","0","55.96","16.76"
"64","000","00","012","1214","1362","813","282","531","42","855","1521","0","56.21","18.54"
"64","000","00","012","1214","1363","701","202","499","42","743","1407","0","52.81","14.36"
"64","000","00","012","1214","1364","886","296","590","52","938","1542","0","60.83","19.2"
"64","000","00","012","1214","1365","781","221","560","25","806","1502","0","53.66","14.71"
"64","000","00","012","1215","0000","2381","484","1897","114","2495","4111","0","60.69","11.77"
"64","000","00","012","1215","1366","780","235","545","42","822","1320","0","62.27","17.8"
"64","000","00","012","1215","1367","806","146","660","33","839","1507","0","55.67","9.69"
"64","000","00","012","1215","1368","795","103","692","39","834","1284","0","64.95","8.02"
"64","000","00","012","1216","0000","2610","821","1789","169","2779","4722","0","58.85","17.39"
"64","000","00","012","1216","1445","601","170","431","39","640","1058","0","60.49","16.07"
"64","000","00","012","1216","1446","583","179","404","50","633","976","0","64.86","18.34"
"64","000","00","012","1216","1447","790","252","538","32","822","1545","0","53.2","16.31"
"64","000","00","012","1216","1448","636","220","416","48","684","1143","0","59.84","19.25"
"64","000","00","012","1217","0000","3583","1167","2416","221","3804","6769","0","56.2","17.24"
"64","000","00","012","1217","1407","689","214","475","35","724","1314","0","55.1","16.29"
"64","000","00","012","1217","1408","825","258","567","27","852","1649","0","51.67","15.65"
"64","000","00","012","1217","1409","818","263","555","99","917","1601","0","57.28","16.43"
"64","000","00","012","1217","1410","647","241","406","18","665","1155","0","57.58","20.87"
"64","000","00","012","1217","1411","604","191","413","42","646","1050","0","61.52","18.19"
"64","000","00","012","1218","0000","2891","914","1977","175","3066","4988","0","61.47","18.32"
"64","000","00","012","1218","1342","726","220","506","69","795","1253","0","63.45","17.56"
"64","000","00","012","1218","1343","705","235","470","23","728","1217","0","59.82","19.31"
"64","000","00","012","1218","1344","778","228","550","42","820","1267","0","64.72","18.0"
"64","000","00","012","1218","1345","682","231","451","41","723","1251","0","57.79","18.47"
"64","000","00","012","1219","0000","2760","935","1825","128","2888","4562","0","63.31","20.5"
"64","000","00","012","1219","1325","635","216","419","30","665","974","0","68.28","22.18"
"64","000","00","012","1219","1326","574","191","383","30","604","987","0","61.2","19.35"
"64","000","00","012","1219","1327","770","244","526","20","790","1210","0","65.29","20.17"
"64","000","00","012","1219","1328","781","284","497","48","829","1391","0","59.6","20.42"
"64","000","00","012","1220","0000","2312","1007","1305","86","2398","3682","0","65.13","27.35"
"64","000","00","012","1220","1337","1154","351","803","49","1203","1879","0","64.02","18.68"
"64","000","00","012","1220","1338","1158","656","502","37","1195","1803","0","66.28","36.38"
"64","000","00","012","1221","0000","914","308","606","99","1013","2513","0","40.31","12.26"
"64","000","00","012","1221","1316","471","166","305","64","535","853","0","62.72","19.46"
"64","000","00","012","1221","1317","443","142","301","35","478","1660","0","28.8","8.55"
"64","000","00","012","1222","0000","1616","505","1111","108","1724","2926","0","58.92","17.26"
"64","000","00","012","1222","1369","758","259","499","40","798","1441","0","55.38","17.97"
"64","000","00","012","1222","1370","858","246","612","68","926","1485","0","62.36","16.57"
"64","000","00","012","1224","0000","1890","619","1271","88","1978","3411","0","57.99","18.15"
"64","000","00","012","1224","1275","1013","365","648","57","1070","1713","0","62.46","21.31"
"64","000","00","012","1224","1276","877","254","623","31","908","1698","0","53.47","14.96"
"64","000","00","012","1225","0000","1589","528","1061","61","1650","2870","0","57.49","18.4"
"64","000","00","012","1225","1387","836","301","535","20","856","1525","0","56.13","19.74"
"64","000","00","012","1225","1388","753","227","526","41","794","1345","0","59.03","16.88"
"64","000","00","012","1226","0000","2795","959","1836","126","2921","4708","0","62.04","20.37"
"64","000","00","012","1226","1383","532","182","350","42","574","942","0","60.93","19.32"
"64","000","00","012","1226","1384","692","218","474","20","712","1206","0","59.04","18.08"
"64","000","00","012","1226","1385","725","258","467","26","751","1159","0","64.8","22.26"
"64","000","00","012","1226","1386","846","301","545","38","884","1401","0","63.1","21.48"
"64","000","00","012","1227","0000","3630","1248","2382","276","3906","6189","0","63.11","20.16"
"64","000","00","012","1227","1429","816","284","532","62","878","1405","0","62.49","20.21"
"64","000","00","012","1227","1430","660","224","436","56","716","1097","0","65.27","20.42"
"64","000","00","012","1227","1431","743","240","503","74","817","1248","0","65.46","19.23"
"64","000","00","012","1227","1432","701","264","437","63","764","1225","0","62.37","21.55"
"64","000","00","012","1227","1433","710","236","474","21","731","1214","0","60.21","19.44"
"64","000","00","012","1228","0000","1758","561","1197","163","1921","3269","0","58.76","17.16"
"64","000","00","012","1228","1437","519","153","366","47","566","968","0","58.47","15.81"
"64","000","00","012","1228","1438","628","203","425","55","683","1200","0","56.92","16.92"
"64","000","00","012","1228","1439","611","205","406","61","672","1101","0","61.04","18.62"
"64","000","00","012","1229","0000","3131","1026","2105","233","3364","5759","0","58.41","17.82"
"64","000","00","012","1229","1474","589","185","404","45","634","1042","0","60.84","17.75"
"64","000","00","012","1229","1475","606","198","408","57","663","1098","0","60.38","18.03"
"64","000","00","012","1229","1476","660","214","446","29","689","1284","0","53.66","16.67"
"64","000","00","012","1229","1477","648","225","423","43","691","1242","0","55.64","18.12"
"64","000","00","012","1229","1478","628","204","424","59","687","1093","0","62.85","18.66"
"64","000","00","012","1230","0000","3009","909","2100","198","3207","5398","0","59.41","16.84"
"64","000","00","012","1230","1349","842","283","559","22","864","1588","0","54.41","17.82"
"64","000","00","012","1230","1350","753","173","580","48","801","1255","0","63.82","13.78"
"64","000","00","012","1230","1351","699","243","456","63","762","1264","0","60.28","19.22"
"64","000","00","012","1230","1352","715","210","505","65","780","1291","0","60.42","16.27"
"64","000","00","012","1231","0000","2841","929","1912","125","2966","4819","0","61.55","19.28"
"64","000","00","012","1231","1346","866","251","615","70","936","1563","0","59.88","16.06"
"64","000","00","012","1231","1347","1179","400","779","15","1194","1888","0","63.24","21.19"
"64","000","00","012","1231","1348","796","278","518","40","836","1368","0","61.11","20.32"
"64","000","00","012","1232","0000","1848","627","1221","123","1971","3455","0","57.05","18.15"
"64","000","00","012","1232","1465","620","217","403","47","667","1154","0","57.8","18.8"
"64","000","00","012","1232","1466","651","225","426","53","704","1153","0","61.06","19.51"
"64","000","00","012","1232","1467","577","185","392","23","600","1148","0","52.26","16.11"
"64","000","00","012","1233","0000","3057","1017","2040","181","3238","5211","0","62.14","19.52"
"64","000","00","012","1233","1397","759","250","509","26","785","1388","0","56.56","18.01"
"64","000","00","012","1233","1398","703","234","469","81","784","1241","0","63.17","18.86"
"64","000","00","012","1233","1399","830","290","540","52","882","1394","0","63.27","20.8"
"64","000","00","012","1233","1400","765","243","522","22","787","1188","0","66.25","20.45"
"64","000","00","012","1234","0000","2089","661","1428","146","2235","3815","0","58.58","17.33"
"64","000","00","012","1234","1371","652","177","475","62","714","1205","0","59.25","14.69"
"64","000","00","012","1234","1372","658","205","453","29","687","1284","0","53.5","15.97"
"64","000","00","012","1234","1373","779","279","500","55","834","1326","0","62.9","21.04"
"64","000","00","012","1235","0000","3343","847","2496","154","3497","5984","0","58.44","14.15"
"64","000","00","012","1235","1359","1167","257","910","62","1229","2173","0","56.56","11.83"
"64","000","00","012","1235","1360","1271","378","893","51","1322","2255","0","58.63","16.76"
"64","000","00","012","1235","1361","905","212","693","41","946","1556","0","60.8","13.62"
"64","000","00","012","1236","0000","2161","776","1385","85","2246","3999","0","56.16","19.4"
"64","000","00","012","1236","1404","641","231","410","31","672","1216","0","55.26","19.0"
"64","000","00","012","1236","1405","684","253","431","36","720","1318","0","54.63","19.2"
"64","000","00","012","1236","1406","836","292","544","18","854","1465","0","58.29","19.93"
"64","000","00","012","1237","0000","1978","694","1284","143","2121","3295","0","64.37","21.06"
"64","000","00","012","1237","1374","625","222","403","31","656","1096","0","59.85","20.26"
"64","000","00","012","1237","1375","710","268","442","60","770","1182","0","65.14","22.67"
"64","000","00","012","1237","1376","643","204","439","52","695","1017","0","68.34","20.06"
"64","000","00","012","1238","0000","1322","440","882","99","1421","2479","0","57.32","17.75"
"64","000","00","012","1238","1377","646","221","425","73","719","1198","0","60.02","18.45"
"64","000","00","012","1238","1378","676","219","457","26","702","1281","0","54.8","17.1"
"64","000","00","012","1239","0000","4952","1652","3300","198","5150","8716","0","59.09","18.95"
"64","000","00","012","1239","1291","1030","366","664","43","1073","1751","0","61.28","20.9"
"64","000","00","012","1239","1292","1037","352","685","38","1075","1758","0","61.15","20.02"
"64","000","00","012","1239","1293","966","303","663","70","1036","1749","0","59.23","17.32"
"64","000","00","012","1239","1294","955","309","646","23","978","1746","0","56.01","17.7"
"64","000","00","012","1239","1295","964","322","642","24","988","1712","0","57.71","18.81"
"64","000","00","012","1240","0000","7193","2101","5092","275","7468","12977","0","57.55","16.19"
"64","000","00","012","1240","1421","884","249","635","30","914","1688","0","54.15","14.75"
"64","000","00","012","1240","1422","924","280","644","52","976","1657","0","58.9","16.9"
"64","000","00","012","1240","1423","874","277","597","46","920","1729","0","53.21","16.02"
"64","000","00","012","1240","1424","944","314","630","45","989","1628","0","60.75","19.29"
"64","000","00","012","1240","1425","941","302","639","17","958","1891","0","50.66","15.97"
"64","000","00","012","1240","1426","859","153","706","35","894","1594","0","56.09","9.6"
"64","000","00","012","1240","1427","848","245","603","18","866","1342","0","64.53","18.26"
"64","000","00","012","1240","1428","919","281","638","32","951","1448","0","65.68","19.41"
"64","000","00","012","1241","0000","1127","402","725","90","1217","1926","0","63.19","20.87"
"64","000","00","012","1241","1258","486","158","328","51","537","851","0","63.1","18.57"
"64","000","00","012","1241","1259","641","244","397","39","680","1075","0","63.26","22.7"
"64","000","00","012","1242","0000","1935","652","1283","127","2062","3418","0","60.33","19.08"
"64","000","00","012","1242","1318","656","224","432","34","690","1124","0","61.39","19.93"
"64","000","00","012","1242","1319","634","238","396","61","695","1112","0","62.5","21.4"
"64","000","00","012","1242","1320","645","190","455","32","677","1182","0","57.28","16.07"
"64","000","00","012","1243","0000","1785","590","1195","172","1957","2966","0","65.98","19.89"
"64","000","00","012","1243","1471","624","192","432","33","657","1026","0","64.04","18.71"
"64","000","00","012","1243","1472","600","205","395","81","681","993","0","68.58","20.64"
"64","000","00","012","1243","1473","561","193","368","58","619","947","0","65.36","20.38"
"64","000","00","012","1244","0000","3271","1091","2180","176","3447","5672","0","60.77","19.23"
"64","000","00","012","1244","1329","624","218","406","19","643","1241","0","51.81","17.57"
"64","000","00","012","1244","1330","618","217","401","37","655","1000","0","65.5","21.7"
"64","000","00","012","1244","1331","653","213","440","30","683","1092","0","62.55","19.51"
"64","000","00","012","1244","1332","782","252","530","37","819","1308","0","62.61","19.27"
"64","000","00","012","1244","1333","594","191","403","53","647","1031","0","62.75","18.53"
"64","000","00","012","1245","0000","1053","309","744","62","1115","2045","0","54.52","15.11"
"64","000","00","012","1245","1339","1053","309","744","62","1115","2045","0","54.52","15.11"
"64","000","00","012","1246","0000","2849","934","1915","145","2994","4742","0","63.14","19.7"
"64","000","00","012","1246","1310","698","204","494","38","736","1107","0","66.49","18.43"
"64","000","00","012","1246","1311","691","211","480","34","725","1188","0","61.03","17.76"
"64","000","00","012","1246","1312","725","279","446","22","747","1183","0","63.14","23.58"
"64","000","00","012","1246","1313","735","240","495","51","786","1264","0","62.18","18.99"
"64","000","00","012","1247","0000","2002","731","1271","109","2111","3351","0","63.0","21.81"
"64","000","00","012","1247","1322","603","224","379","43","646","1040","0","62.12","21.54"
"64","000","00","012","1247","1323","684","250","434","20","704","1094","0","64.35","22.85"
"64","000","00","012","1247","1324","715","257","458","46","761","1217","0","62.53","21.12"
"64","000","00","012","1248","0000","3396","1187","2209","180","3576","6178","0","57.88","19.21"
"64","000","00","012","1248","1286","643","205","438","33","676","1247","0","54.21","16.44"
"64","000","00","012","1248","1287","810","271","539","49","859","1538","0","55.85","17.62"
"64","000","00","012","1248","1288","614","199","415","35","649","1097","0","59.16","18.14"
"64","000","00","012","1248","1289","638","244","394","22","660","1221","0","54.05","19.98"
"64","000","00","012","1248","1290","691","268","423","41","732","1075","0","68.09","24.93"
"64","000","00","012","1249","0000","2450","812","1638","162","2612","4308","0","60.63","18.85"
"64","000","00","012","1249","1481","759","237","522","43","802","1309","0","61.27","18.11"
"64","000","00","012","1249","1482","912","338","574","49","961","1627","0","59.07","20.77"
"64","000","00","012","1249","1483","779","237","542","70","849","1372","0","61.88","17.27"
"64","000","00","012","1250","0000","1440","436","1004","59","1499","2520","0","59.48","17.3"
"64","000","00","012","1250","1353","704","205","499","33","737","1224","0","60.21","16.75"
"64","000","00","012","1250","1354","736","231","505","26","762","1296","0","58.8","17.82"
"64","000","00","012","1251","0000","667","221","446","40","707","1007","0","70.21","21.95"
"64","000","00","012","1251","1315","667","221","446","40","707","1007","0","70.21","21.95"
"64","000","00","012","1253","0000","2312","720","1592","172","2484","4102","0","60.56","17.55"
"64","000","00","012","1253","1264","595","176","419","49","644","1055","0","61.04","16.68"
"64","000","00","012","1253","1265","587","191","396","56","643","1109","0","57.98","17.22"
"64","000","00","012","1253","1266","487","151","336","33","520","756","0","68.78","19.97"
"64","000","00","012","1253","1267","643","202","441","34","677","1182","0","57.28","17.09"
"64","000","00","012","1254","0000","851","307","544","49","900","2551","0","35.28","12.03"
"64","000","00","012","1254","1449","233","112","121","17","250","1301","0","19.22","8.61"
"64","000","00","012","1254","1450","618","195","423","32","650","1250","0","52.0","15.6"
"64","000","00","012","1255","0000","4594","1450","3144","252","4846","7753","0","62.5","18.7"
"64","000","00","012","1255","1459","801","236","565","26","827","1291","0","64.06","18.28"
"64","000","00","012","1255","1460","553","198","355","50","603","938","0","64.29","21.11"
"64","000","00","012","1255","1461","1030","303","727","28","1058","1783","0","59.34","16.99"
"64","000","00","012","1255","1462","656","218","438","33","689","1105","0","62.35","19.73"
"64","000","00","012","1255","1463","755","241","514","79","834","1392","0","59.91","17.31"
"64","000","00","012","1255","1464","799","254","545","36","835","1244","0","67.12","20.42"
"64","000","00","012","1256","0000","4798","1572","3226","195","4993","8179","0","61.05","19.22"
"64","000","00","012","1256","1280","852","227","625","47","899","1559","0","57.67","14.56"
"64","000","00","012","1256","1281","733","247","486","33","766","1233","0","62.12","20.03"
"64","000","00","012","1256","1282","735","266","469","49","784","1277","0","61.39","20.83"
"64","000","00","012","1256","1283","847","261","586","20","867","1481","0","58.54","17.62"
"64","000","00","012","1256","1284","732","253","479","23","755","1154","0","65.42","21.92"
"64","000","00","012","1256","1285","899","318","581","23","922","1475","0","62.51","21.56"
"64","000","00","012","1257","0000","2150","705","1445","149","2299","4340","0","52.97","16.24"
"64","000","00","012","1257","1468","720","236","484","107","827","1432","0","57.75","16.48"
"64","000","00","012","1257","1469","616","222","394","23","639","1429","0","44.72","15.54"
"64","000","00","012","1257","1470","814","247","567","19","833","1479","0","56.32","16.7"
"64","000","00","012","1258","0000","1407","472","935","91","1498","2689","0","55.71","17.55"
"64","000","00","012","1258","1273","730","263","467","32","762","1455","0","52.37","18.08"
"64","000","00","012","1258","1274","677","209","468","59","736","1234","0","59.64","16.94"
"64","000","00","012","1259","0000","2333","821","1512","107","2440","4003","0","60.95","20.51"
"64","000","00","012","1259","1296","731","237","494","22","753","1247","0","60.38","19.01"
"64","000","00","012","1259","1297","832","304","528","39","871","1409","0","61.82","21.58"
"64","000","00","012","1259","1298","770","280","490","46","816","1347","0","60.58","20.79"
"64","000","00","012","1260","0000","5367","1829","3538","161","5528","9265","0","59.67","19.74"
"64","000","00","012","1260","1299","996","353","643","24","1020","1771","0","57.59","19.93"
"64","000","00","012","1260","1300","912","336","576","15","927","1537","0","60.31","21.86"
"64","000","00","012","1260","1301","958","312","646","21","979","1605","0","61.0","19.44"
"64","000","00","012","1260","1302","799","248","551","39","838","1375","0","60.95","18.04"
"64","000","00","012","1260","1303","840","273","567","41","881","1393","0","63.24","19.6"
"64","000","00","012","1260","1304","862","307","555","21","883","1584","0","55.74","19.38"
"64","000","00","012","1261","0000","1247","372","875","61","1308","2055","0","63.65","18.1"
"64","000","00","012","1261","1355","523","175","348","35","558","826","0","67.55","21.19"
"64","000","00","012","1261","1356","724","197","527","26","750","1229","0","61.03","16.03"
"64","000","00","012","1262","0000","1568","475","1093","81","1649","2685","0","61.42","17.69"
"64","000","00","012","1262","1357","868","267","601","36","904","1467","0","61.62","18.2"
"64","000","00","012","1262","1358","700","208","492","45","745","1218","0","61.17","17.08"
"64","000","00","012","1263","0000","1617","558","1059","71","1688","2584","0","65.33","21.59"
"64","000","00","012","1263","1379","840","286","554","30","870","1358","0","64.06","21.06"
"64","000","00","012","1263","1380","777","272","505","41","818","1226","0","66.72","22.19"
"64","000","00","012","1264","0000","1380","457","923","75","1455","2298","0","63.32","19.89"
"64","000","00","012","1264","1381","672","215","457","44","716","1098","0","65.21","19.58"
"64","000","00","012","1264","1382","708","242","466","31","739","1200","0","61.58","20.17"
"64","000","00","012","1265","0000","2050","688","1362","98","2148","3785","0","56.75","18.18"
"64","000","00","012","1265","1401","665","213","452","33","698","1112","0","62.77","19.15"
"64","000","00","012","1265","1402","557","173","384","36","593","1198","0","49.5","14.44"
"64","000","00","012","1265","1403","828","302","526","29","857","1475","0","58.1","20.47"
"64","000","00","012","1266","0000","1311","417","894","47","1358","2286","0","59.41","18.24"
"64","000","00","012","1266","1389","725","215","510","28","753","1180","0","63.81","18.22"
"64","000","00","012","1266","1390","586","202","384","19","605","1106","0","54.7","18.26"
"64","000","00","012","1267","0000","2575","894","1681","118","2693","4313","0","62.44","20.73"
"64","000","00","012","1267","1394","794","269","525","18","812","1361","0","59.66","19.76"
"64","000","00","012","1267","1395","840","299","541","49","889","1416","0","62.78","21.12"
"64","000","00","012","1267","1396","941","326","615","51","992","1536","0","64.58","21.22"
"64","000","00","012","1268","0000","2423","860","1563","116","2539","4061","0","62.52","21.18"
"64","000","00","012","1268","1391","864","304","560","57","921","1442","0","63.87","21.08"
"64","000","00","012","1268","1392","829","297","532","32","861","1376","0","62.57","21.58"
"64","000","00","012","1268","1393","730","259","471","27","757","1243","0","60.9","20.84"
"64","000","00","012","1269","0000","1387","463","924","61","1448","2515","0","57.57","18.41"
"64","000","00","012","1269","1415","668","242","426","37","705","1190","0","59.24","20.34"
"64","000","00","012","1269","1416","719","221","498","24","743","1325","0","56.08","16.68"
"64","000","00","012","1270","0000","2529","1018","1511","143","2672","4481","0","59.63","22.72"
"64","000","00","012","1270","1417","613","180","433","48","661","1049","0","63.01","17.16"
"64","000","00","012","1270","1418","592","410","182","30","622","1026","0","60.62","39.96"
"64","000","00","012","1270","1419","674","219","455","50","724","1152","0","62.85","19.01"
"64","000","00","012","1270","1420","650","209","441","15","665","1254","0","53.03","16.67"
"64","000","00","012","1271","0000","2368","782","1586","125","2493","4456","0","55.95","17.55"
"64","000","00","012","1271","1412","735","231","504","16","751","1417","0","53.0","16.3"
"64","000","00","012","1271","1413","833","274","559","56","889","1525","0","58.3","17.97"
"64","000","00","012","1271","1414","800","277","523","53","853","1514","0","56.34","18.3"
"64","000","00","012","1272","0000","2482","684","1798","147","2629","4447","0","59.12","15.38"
"64","000","00","012","1272","1440","725","125","600","41","766","1369","0","55.95","9.13"
"64","000","00","012","1272","1441","858","295","563","53","911","1542","0","59.08","19.13"
"64","000","00","012","1272","1442","899","264","635","53","952","1536","0","61.98","17.19"
"64","000","00","012","1273","0000","1552","540","1012","111","1663","2834","0","58.68","19.05"
"64","000","00","012","1273","1443","745","265","480","34","779","1382","0","56.37","19.18"
"64","000","00","012","1273","1444","807","275","532","77","884","1452","0","60.88","18.94"
"64","000","00","012","1274","0000","1454","471","983","70","1524","2432","0","62.66","19.37"
"64","000","00","012","1274","1455","683","220","463","51","734","1125","0","65.24","19.56"
"64","000","00","012","1274","1456","771","251","520","19","790","1307","0","60.44","19.2"
"64","000","00","012","1275","0000","2968","1020","1948","220","3188","5431","0","58.7","18.78"
"64","000","00","012","1275","1451","661","225","436","51","712","1208","0","58.94","18.63"
"64","000","00","012","1275","1452","667","208","459","76","743","1202","0","61.81","17.3"
"64","000","00","012","1275","1453","810","299","511","58","868","1499","0","57.91","19.95"
"64","000","00","012","1275","1454","830","288","542","35","865","1522","0","56.83","18.92"
"64","000","00","012","1276","0000","1498","498","1000","110","1608","2657","0","60.52","18.74"
"64","000","00","012","1276","1457","790","258","532","51","841","1405","0","59.86","18.36"
"64","000","00","012","1276","1458","708","240","468","59","767","1252","0","61.26","19.17"
"64","000","00","012","1277","0000","1448","512","936","62","1510","2706","0","55.8","18.92"
"64","000","00","012","1277","1479","725","266","459","42","767","1353","0","56.69","19.66"
"64","000","00","012","1277","1480","723","246","477","20","743","1353","0","54.92","18.18"
"64","000","00","012","1278","0000","3592","1109","2483","125","3717","6056","0","61.38","18.31"
"64","000","00","012","1278","1434","1237","412","825","22","1259","2032","0","61.96","20.28"
"64","000","00","012","1278","1435","1103","317","786","53","1156","1927","0","59.99","16.45"
"64","000","00","012","1278","1436","1252","380","872","50","1302","2097","0","62.09","18.12"
"64","000","00","013","0000","0000","30734","10174","20560","2234","32968","59129","69829","55.76","17.21"
"64","000","00","013","1301","0000","1505","499","1006","113","1618","2824","0","57.29","17.67"
"64","000","00","013","1301","1773","706","242","464","61","767","1262","0","60.78","19.18"
"64","000","00","013","1301","1774","799","257","542","52","851","1562","0","54.48","16.45"
"64","000","00","013","1302","0000","1809","621","1188","123","1932","3252","0","59.41","19.1"
"64","000","00","013","1302","1775","600","205","395","24","624","1078","0","57.88","19.02"
"64","000","00","013","1302","1776","586","204","382","43","629","979","0","64.25","20.84"
"64","000","00","013","1302","1777","623","212","411","56","679","1195","0","56.82","17.74"
"64","000","00","013","1303","0000","2011","647","1364","161","2172","3929","0","55.28","16.47"
"64","000","00","013","1303","1778","690","223","467","66","756","1380","0","54.78","16.16"
"64","000","00","013","1303","1779","668","210","458","66","734","1280","0","57.34","16.41"
"64","000","00","013","1303","1780","653","214","439","29","682","1269","0","53.74","16.86"
"64","000","00","013","1304","0000","1352","429","923","71","1423","2794","0","50.93","15.35"
"64","000","00","013","1304","1781","656","228","428","27","683","1568","0","43.56","14.54"
"64","000","00","013","1304","1782","696","201","495","44","740","1226","0","60.36","16.39"
"64","000","00","013","1305","0000","1577","471","1106","106","1683","2939","0","57.26","16.03"
"64","000","00","013","1305","1783","768","234","534","51","819","1480","0","55.34","15.81"
"64","000","00","013","1305","1784","809","237","572","55","864","1459","0","59.22","16.24"
"64","000","00","013","1306","0000","1226","382","844","170","1396","2488","0","56.11","15.35"
"64","000","00","013","1306","1785","798","267","531","52","850","1593","0","53.36","16.76"
"64","000","00","013","1306","1786","428","115","313","118","546","895","0","61.01","12.85"
"64","000","00","013","1307","0000","2356","804","1552","202","2558","4455","0","57.42","18.05"
"64","000","00","013","1307","1787","543","177","366","32","575","1110","0","51.8","15.95"
"64","000","00","013","1307","1788","676","240","436","55","731","1348","0","54.23","17.8"
"64","000","00","013","1307","1789","494","178","316","55","549","912","0","60.2","19.52"
"64","000","00","013","1307","1790","643","209","434","60","703","1085","0","64.79","19.26"
"64","000","00","013","1308","0000","1017","305","712","71","1088","1834","0","59.32","16.63"
"64","000","00","013","1308","1791","517","164","353","24","541","955","0","56.65","17.17"
"64","000","00","013","1308","1792","500","141","359","47","547","879","0","62.23","16.04"
"64","000","00","013","1309","0000","1802","612","1190","138","1940","3449","0","56.25","17.74"
"64","000","00","013","1309","1793","540","194","346","59","599","1103","0","54.31","17.59"
"64","000","00","013","1309","1794","623","206","417","62","685","1054","0","64.99","19.54"
"64","000","00","013","1309","1795","639","212","427","17","656","1292","0","50.77","16.41"
"64","000","00","013","1310","0000","783","283","500","24","807","1683","0","47.95","16.82"
"64","000","00","013","1310","1796","783","283","500","24","807","1683","0","47.95","16.82"
"64","000","00","013","1311","0000","854","267","587","93","947","1619","0","58.49","16.49"
"64","000","00","013","1311","1797","323","96","227","29","352","607","0","57.99","15.82"
"64","000","00","013","1311","1798","531","171","360","64","595","1012","0","58.79","16.9"
"64","000","00","013","1312","0000","982","301","681","73","1055","1960","0","53.83","15.36"
"64","000","00","013","1312","1799","569","177","392","50","619","1046","0","59.18","16.92"
"64","000","00","013","1312","1800","413","124","289","23","436","914","0","47.7","13.57"
"64","000","00","013","1313","0000","2159","841","1318","144","2303","3874","0","59.45","21.71"
"64","000","00","013","1313","1801","790","285","505","51","841","1405","0","59.86","20.28"
"64","000","00","013","1313","1802","739","343","396","56","795","1299","0","61.2","26.4"
"64","000","00","013","1313","1803","630","213","417","37","667","1170","0","57.01","18.21"
"64","000","00","013","1314","0000","583","202","381","37","620","1299","0","47.73","15.55"
"64","000","00","013","1314","1804","583","202","381","37","620","1299","0","47.73","15.55"
"64","000","00","013","1315","0000","996","327","669","48","1044","1880","0","55.53","17.39"
"64","000","00","013","1315","1805","561","184","377","25","586","1031","0","56.84","17.85"
"64","000","00","013","1315","1806","435","143","292","23","458","849","0","53.95","16.84"
"64","000","00","013","1316","0000","911","312","599","84","995","1776","0","56.02","17.57"
"64","000","00","013","1316","1807","399","148","251","57","456","838","0","54.42","17.66"
"64","000","00","013","1316","1808","512","164","348","27","539","938","0","57.46","17.48"
"64","000","00","013","1317","0000","938","309","629","83","1021","1837","0","55.58","16.82"
"64","000","00","013","1317","1809","507","164","343","32","539","1051","0","51.28","15.6"
"64","000","00","013","1317","1810","431","145","286","51","482","786","0","61.32","18.45"
"64","000","00","013","1318","0000","499","164","335","61","560","894","0","62.64","18.34"
"64","000","00","013","1318","1811","499","164","335","61","560","894","0","62.64","18.34"
"64","000","00","013","1319","0000","289","109","180","17","306","749","0","40.85","14.55"
"64","000","00","013","1319","1812","289","109","180","17","306","749","0","40.85","14.55"
"64","000","00","013","1320","0000","1682","537","1145","113","1795","2963","0","60.58","18.12"
"64","000","00","013","1320","1813","856","273","583","33","889","1485","0","59.87","18.38"
"64","000","00","013","1320","1814","826","264","562","80","906","1478","0","61.3","17.86"
"64","000","00","013","1321","0000","1333","471","862","102","1435","2383","0","60.22","19.77"
"64","000","00","013","1321","1815","798","278","520","58","856","1345","0","63.64","20.67"
"64","000","00","013","1321","1816","535","193","342","44","579","1038","0","55.78","18.59"
"64","000","00","013","1322","0000","1808","587","1221","52","1860","3366","0","55.26","17.44"
"64","000","00","013","1322","1817","663","229","434","24","687","1203","0","57.11","19.04"
"64","000","00","013","1322","1818","635","203","432","18","653","1138","0","57.38","17.84"
"64","000","00","013","1322","1819","510","155","355","10","520","1025","0","50.73","15.12"
"64","000","00","013","1323","0000","1259","386","873","102","1361","2559","0","53.18","15.08"
"64","000","00","013","1323","1820","697","218","479","83","780","1341","0","58.17","16.26"
"64","000","00","013","1323","1821","562","168","394","19","581","1218","0","47.7","13.79"
"64","000","00","013","1324","0000","1003","308","695","46","1049","2323","0","45.16","13.26"
"64","000","00","013","1324","1822","493","148","345","25","518","1147","0","45.16","12.9"
"64","000","00","013","1324","1823","510","160","350","21","531","1176","0","45.15","13.61"
"64","000","00","014","0000","0000","52139","16588","35551","3391","55530","97309","112334","57.07","17.05"
"64","000","00","014","1401","0000","689","254","435","41","730","1445","0","50.52","17.58"
"64","000","00","014","1401","1692","345","120","225","25","370","727","0","50.89","16.51"
"64","000","00","014","1401","1693","344","134","210","16","360","718","0","50.14","18.66"
"64","000","00","014","1402","0000","2631","784","1847","126","2757","5733","0","48.09","13.68"
"64","000","00","014","1402","1694","651","200","451","37","688","1340","0","51.34","14.93"
"64","000","00","014","1402","1695","707","230","477","37","744","1575","0","47.24","14.6"
"64","000","00","014","1402","1696","245","66","179","18","263","444","0","59.23","14.86"
"64","000","00","014","1402","1697","1028","288","740","34","1062","2374","0","44.73","12.13"
"64","000","00","014","1403","0000","3455","1102","2353","261","3716","6681","0","55.62","16.49"
"64","000","00","014","1403","1698","658","213","445","69","727","1291","0","56.31","16.5"
"64","000","00","014","1403","1699","740","234","506","73","813","1400","0","58.07","16.71"
"64","000","00","014","1403","1700","732","224","508","29","761","1390","0","54.75","16.12"
"64","000","00","014","1403","1701","726","230","496","56","782","1401","0","55.82","16.42"
"64","000","00","014","1403","1702","599","201","398","34","633","1199","0","52.79","16.76"
"64","000","00","014","1404","0000","1214","398","816","69","1283","2405","0","53.35","16.55"
"64","000","00","014","1404","1703","582","201","381","25","607","1210","0","50.17","16.61"
"64","000","00","014","1404","1704","632","197","435","44","676","1195","0","56.57","16.49"
"64","000","00","014","1405","0000","2381","820","1561","154","2535","4595","0","55.17","17.85"
"64","000","00","014","1405","1705","594","192","402","29","623","1166","0","53.43","16.47"
"64","000","00","014","1405","1706","721","243","478","42","763","1353","0","56.39","17.96"
"64","000","00","014","1405","1707","601","217","384","59","660","1052","0","62.74","20.63"
"64","000","00","014","1405","1708","465","168","297","24","489","1024","0","47.75","16.41"
"64","000","00","014","1406","0000","2310","711","1599","168","2478","4334","0","57.18","16.41"
"64","000","00","014","1406","1709","660","200","460","22","682","1189","0","57.36","16.82"
"64","000","00","014","1406","1710","832","260","572","85","917","1512","0","60.65","17.2"
"64","000","00","014","1406","1711","818","251","567","61","879","1633","0","53.83","15.37"
"64","000","00","014","1407","0000","2202","729","1473","162","2364","3795","0","62.29","19.21"
"64","000","00","014","1407","1712","687","222","465","61","748","1214","0","61.61","18.29"
"64","000","00","014","1407","1713","753","256","497","67","820","1258","0","65.18","20.35"
"64","000","00","014","1407","1714","762","251","511","34","796","1323","0","60.17","18.97"
"64","000","00","014","1408","0000","1326","410","916","94","1420","2288","0","62.06","17.92"
"64","000","00","014","1408","1715","727","225","502","37","764","1253","0","60.97","17.96"
"64","000","00","014","1408","1716","599","185","414","57","656","1035","0","63.38","17.87"
"64","000","00","014","1409","0000","5918","1895","4023","356","6274","10761","0","58.3","17.61"
"64","000","00","014","1409","1717","603","182","421","33","636","1106","0","57.5","16.46"
"64","000","00","014","1409","1718","645","192","453","41","686","1195","0","57.41","16.07"
"64","000","00","014","1409","1719","611","201","410","17","628","1051","0","59.75","19.12"
"64","000","00","014","1409","1720","794","288","506","62","856","1425","0","60.07","20.21"
"64","000","00","014","1409","1721","856","279","577","58","914","1635","0","55.9","17.06"
"64","000","00","014","1409","1722","756","243","513","59","815","1359","0","59.97","17.88"
"64","000","00","014","1409","1723","753","236","517","59","812","1361","0","59.66","17.34"
"64","000","00","014","1409","1724","900","274","626","27","927","1629","0","56.91","16.82"
"64","000","00","014","1410","0000","4023","1255","2768","211","4234","7606","0","55.67","16.5"
"64","000","00","014","1410","1725","835","229","606","42","877","1518","0","57.77","15.09"
"64","000","00","014","1410","1726","831","272","559","64","895","1620","0","55.25","16.79"
"64","000","00","014","1410","1727","843","273","570","18","861","1648","0","52.25","16.57"
"64","000","00","014","1410","1728","756","236","520","55","811","1385","0","58.56","17.04"
"64","000","00","014","1410","1729","758","245","513","32","790","1435","0","55.05","17.07"
"64","000","00","014","1411","0000","963","290","673","51","1014","1835","0","55.26","15.8"
"64","000","00","014","1411","1730","566","169","397","22","588","1046","0","56.21","16.16"
"64","000","00","014","1411","1731","397","121","276","29","426","789","0","53.99","15.34"
"64","000","00","014","1412","0000","865","313","552","65","930","1642","0","56.64","19.06"
"64","000","00","014","1412","1732","460","167","293","33","493","909","0","54.24","18.37"
"64","000","00","014","1412","1733","405","146","259","32","437","733","0","59.62","19.92"
"64","000","00","014","1413","0000","1274","440","834","88","1362","2475","0","55.03","17.78"
"64","000","00","014","1413","1734","785","278","507","61","846","1553","0","54.48","17.9"
"64","000","00","014","1413","1735","489","162","327","27","516","922","0","55.97","17.57"
"64","000","00","014","1414","0000","1569","534","1035","158","1727","3001","0","57.55","17.79"
"64","000","00","014","1414","1736","525","169","356","63","588","1012","0","58.1","16.7"
"64","000","00","014","1414","1737","483","165","318","60","543","968","0","56.1","17.05"
"64","000","00","014","1414","1738","561","200","361","35","596","1021","0","58.37","19.59"
"64","000","00","014","1415","0000","690","215","475","69","759","1554","0","48.84","13.84"
"64","000","00","014","1415","1739","690","215","475","69","759","1554","0","48.84","13.84"
"64","000","00","014","1416","0000","3169","1037","2132","168","3337","6101","0","54.7","17.0"
"64","000","00","014","1416","1740","640","206","434","46","686","1120","0","61.25","18.39"
"64","000","00","014","1416","1741","720","231","489","44","764","1225","0","62.37","18.86"
"64","000","00","014","1416","1742","490","156","334","22","512","1320","0","38.79","11.82"
"64","000","00","014","1416","1743","709","231","478","42","751","1317","0","57.02","17.54"
"64","000","00","014","1416","1744","610","213","397","14","624","1119","0","55.76","19.03"
"64","000","00","014","1417","0000","4319","1364","2955","246","4565","7467","0","61.14","18.27"
"64","000","00","014","1417","1745","676","217","459","51","727","1190","0","61.09","18.24"
"64","000","00","014","1417","1746","708","215","493","47","755","1229","0","61.43","17.49"
"64","000","00","014","1417","1747","710","213","497","43","753","1178","0","63.92","18.08"
"64","000","00","014","1417","1748","765","245","520","27","792","1272","0","62.26","19.26"
"64","000","00","014","1417","1749","771","268","503","24","795","1413","0","56.26","18.97"
"64","000","00","014","1417","1750","689","206","483","54","743","1185","0","62.7","17.38"
"64","000","00","014","1418","0000","309","77","232","9","318","553","0","57.5","13.92"
"64","000","00","014","1418","1751","309","77","232","9","318","553","0","57.5","13.92"
"64","000","00","014","1419","0000","3811","1248","2563","221","4032","6837","0","58.97","18.25"
"64","000","00","014","1419","1752","568","181","387","58","626","1121","0","55.84","16.15"
"64","000","00","014","1419","1753","697","244","453","24","721","1227","0","58.76","19.89"
"64","000","00","014","1419","1754","660","216","444","58","718","1058","0","67.86","20.42"
"64","000","00","014","1419","1755","667","215","452","30","697","1209","0","57.65","17.78"
"64","000","00","014","1419","1756","638","187","451","23","661","1100","0","60.09","17.0"
"64","000","00","014","1419","1757","581","205","376","28","609","1122","0","54.28","18.27"
"64","000","00","014","1420","0000","1182","345","837","84","1266","2175","0","58.21","15.86"
"64","000","00","014","1420","1758","583","189","394","62","645","983","0","65.62","19.23"
"64","000","00","014","1420","1759","599","156","443","22","621","1192","0","52.1","13.09"
"64","000","00","014","1421","0000","874","242","632","52","926","1548","0","59.82","15.63"
"64","000","00","014","1421","1760","378","112","266","26","404","719","0","56.19","15.58"
"64","000","00","014","1421","1761","496","130","366","26","522","829","0","62.97","15.68"
"64","000","00","014","1422","0000","1094","337","757","111","1205","1846","0","65.28","18.26"
"64","000","00","014","1422","1762","472","132","340","60","532","771","0","69.0","17.12"
"64","000","00","014","1422","1763","622","205","417","51","673","1075","0","62.6","19.07"
"64","000","00","014","1423","0000","1957","623","1334","195","2152","3669","0","58.65","16.98"
"64","000","00","014","1423","1764","720","215","505","77","797","1280","0","62.27","16.8"
"64","000","00","014","1423","1765","605","198","407","92","697","1179","0","59.12","16.79"
"64","000","00","014","1423","1766","632","210","422","26","658","1210","0","54.38","17.36"
"64","000","00","014","1424","0000","111","30","81","6","117","189","0","61.9","15.87"
"64","000","00","014","1424","1767","111","30","81","6","117","189","0","61.9","15.87"
"64","000","00","014","1425","0000","3803","1135","2668","226","4029","6774","0","59.48","16.76"
"64","000","00","014","1425","1768","702","198","504","50","752","1228","0","61.24","16.12"
"64","000","00","014","1425","1769","642","171","471","36","678","1170","0","57.95","14.62"
"64","000","00","014","1425","1770","826","244","582","48","874","1416","0","61.72","17.23"
"64","000","00","014","1425","1771","859","278","581","45","904","1482","0","61.0","18.76"
"64","000","00","014","1425","1772","774","244","530","47","821","1478","0","55.55","16.51"
"64","000","00","015","0000","0000","19169","6166","13003","1427","20596","36772","42431","56.01","16.77"
"64","000","00","015","1501","0000","1554","488","1066","59","1613","2701","0","59.72","18.07"
"64","000","00","015","1501","0736","738","245","493","30","768","1386","0","55.41","17.68"
"64","000","00","015","1501","0737","816","243","573","29","845","1315","0","64.26","18.48"
"64","000","00","015","1502","0000","2631","766","1865","147","2778","5000","0","55.56","15.32"
"64","000","00","015","1502","0738","1288","348","940","56","1344","2461","0","54.61","14.14"
"64","000","00","015","1502","0739","689","211","478","27","716","1274","0","56.2","16.56"
"64","000","00","015","1502","0740","654","207","447","64","718","1265","0","56.76","16.36"
"64","000","00","015","1503","0000","2112","725","1387","132","2244","4126","0","54.39","17.57"
"64","000","00","015","1503","0741","778","254","524","64","842","1504","0","55.98","16.89"
"64","000","00","015","1503","0742","522","182","340","22","544","1049","0","51.86","17.35"
"64","000","00","015","1503","0743","812","289","523","46","858","1573","0","54.55","18.37"
"64","000","00","015","1504","0000","1204","351","853","75","1279","2328","0","54.94","15.08"
"64","000","00","015","1504","0744","528","163","365","29","557","1121","0","49.69","14.54"
"64","000","00","015","1504","0745","676","188","488","46","722","1207","0","59.82","15.58"
"64","000","00","015","1505","0000","1258","398","860","67","1325","2258","0","58.68","17.63"
"64","000","00","015","1505","0746","605","186","419","32","637","1134","0","56.17","16.4"
"64","000","00","015","1505","0747","653","212","441","35","688","1124","0","61.21","18.86"
"64","000","00","015","1506","0000","1846","625","1221","216","2062","3492","0","59.05","17.9"
"64","000","00","015","1506","0748","622","199","423","86","708","1259","0","56.24","15.81"
"64","000","00","015","1506","0749","634","226","408","62","696","1105","0","62.99","20.45"
"64","000","00","015","1506","0750","590","200","390","68","658","1128","0","58.33","17.73"
"64","000","00","015","1507","0000","520","161","359","77","597","1079","0","55.33","14.92"
"64","000","00","015","1507","0751","520","161","359","77","597","1079","0","55.33","14.92"
"64","000","00","015","1508","0000","517","276","241","31","548","1025","0","53.46","26.93"
"64","000","00","015","1508","0752","517","276","241","31","548","1025","0","53.46","26.93"
"64","000","00","015","1509","0000","481","160","321","52","533","950","0","56.11","16.84"
"64","000","00","015","1509","0753","481","160","321","52","533","950","0","56.11","16.84"
"64","000","00","015","1510","0000","730","266","464","80","810","1433","0","56.52","18.56"
"64","000","00","015","1510","0754","730","266","464","80","810","1433","0","56.52","18.56"
"64","000","00","015","1511","0000","700","232","468","44","744","1575","0","47.24","14.73"
"64","000","00","015","1511","0755","377","114","263","27","404","794","0","50.88","14.36"
"64","000","00","015","1511","0756","323","118","205","17","340","781","0","43.53","15.11"
"64","000","00","015","1512","0000","632","208","424","21","653","1318","0","49.54","15.78"
"64","000","00","015","1512","0757","632","208","424","21","653","1318","0","49.54","15.78"
"64","000","00","015","1513","0000","837","293","544","65","902","1783","0","50.59","16.43"
"64","000","00","015","1513","0758","369","127","242","40","409","736","0","55.57","17.26"
"64","000","00","015","1513","0759","468","166","302","25","493","1047","0","47.09","15.85"
"64","000","00","015","1514","0000","1270","406","864","98","1368","2457","0","55.68","16.52"
"64","000","00","015","1514","0760","690","231","459","62","752","1271","0","59.17","18.17"
"64","000","00","015","1514","0761","580","175","405","36","616","1186","0","51.94","14.76"
"64","000","00","015","1515","0000","540","179","361","57","597","1007","0","59.29","17.78"
"64","000","00","015","1515","0762","540","179","361","57","597","1007","0","59.29","17.78"
"64","000","00","015","1516","0000","797","262","535","73","870","1594","0","54.58","16.44"
"64","000","00","015","1516","0763","465","158","307","55","520","859","0","60.54","18.39"
"64","000","00","015","1516","0764","332","104","228","18","350","735","0","47.62","14.15"
"64","000","00","015","1517","0000","1193","300","893","110","1303","1926","0","67.65","15.58"
"64","000","00","015","1517","0765","572","191","381","79","651","1046","0","62.24","18.26"
"64","000","00","015","1517","0766","621","109","512","31","652","880","0","74.09","12.39"
"64","000","00","015","1518","0000","347","70","277","23","370","720","0","51.39","9.72"
"64","000","00","015","1518","0767","347","70","277","23","370","720","0","51.39","9.72"
"64","000","00","016","0000","0000","16106","5753","10353","1205","17311","30046","34591","57.61","19.15"
"64","000","00","016","1601","0000","475","153","322","64","539","950","0","56.74","16.11"
"64","000","00","016","1601","0637","475","153","322","64","539","950","0","56.74","16.11"
"64","000","00","016","1602","0000","1472","576","896","60","1532","3162","0","48.45","18.22"
"64","000","00","016","1602","0638","661","321","340","27","688","1306","0","52.68","24.58"
"64","000","00","016","1602","0639","811","255","556","33","844","1856","0","45.47","13.74"
"64","000","00","016","1603","0000","2788","968","1820","190","2978","4968","0","59.94","19.48"
"64","000","00","016","1603","0640","596","205","391","47","643","986","0","65.21","20.79"
"64","000","00","016","1603","0641","531","194","337","42","573","1116","0","51.34","17.38"
"64","000","00","016","1603","0642","745","273","472","62","807","1253","0","64.41","21.79"
"64","000","00","016","1603","0643","916","296","620","39","955","1613","0","59.21","18.35"
"64","000","00","016","1604","0000","868","305","563","39","907","1679","0","54.02","18.17"
"64","000","00","016","1604","0659","332","126","206","15","347","745","0","46.58","16.91"
"64","000","00","016","1604","0660","536","179","357","24","560","934","0","59.96","19.16"
"64","000","00","016","1605","0000","1451","510","941","118","1569","2661","0","58.96","19.17"
"64","000","00","016","1605","0646","559","181","378","51","610","1004","0","60.76","18.03"
"64","000","00","016","1605","0647","483","160","323","41","524","879","0","59.61","18.2"
"64","000","00","016","1605","0648","409","169","240","26","435","778","0","55.91","21.72"
"64","000","00","016","1606","0000","2961","1096","1865","315","3276","5391","0","60.77","20.33"
"64","000","00","016","1606","0649","615","224","391","60","675","1110","0","60.81","20.18"
"64","000","00","016","1606","0650","670","281","389","148","818","1432","0","57.12","19.62"
"64","000","00","016","1606","0651","833","280","553","40","873","1466","0","59.55","19.1"
"64","000","00","016","1606","0652","843","311","532","67","910","1383","0","65.8","22.49"
"64","000","00","016","1607","0000","2644","966","1678","172","2816","4950","0","56.89","19.52"
"64","000","00","016","1607","0653","917","325","592","69","986","1645","0","59.94","19.76"
"64","000","00","016","1607","0654","753","268","485","47","800","1555","0","51.45","17.23"
"64","000","00","016","1607","0655","974","373","601","56","1030","1750","0","58.86","21.31"
"64","000","00","016","1608","0000","1756","609","1147","162","1918","3156","0","60.77","19.3"
"64","000","00","016","1608","0656","612","214","398","52","664","1111","0","59.77","19.26"
"64","000","00","016","1608","0657","626","223","403","69","695","1133","0","61.34","19.68"
"64","000","00","016","1608","0658","518","172","346","41","559","912","0","61.29","18.86"
"64","000","00","016","1609","0000","1691","570","1121","85","1776","3129","0","56.76","18.22"
"64","000","00","016","1609","0644","738","254","484","38","776","1455","0","53.33","17.46"
"64","000","00","016","1609","0645","953","316","637","47","1000","1674","0","59.74","18.88"
"64","000","00","017","0000","0000","41162","13068","28094","1991","43153","73611","87415","58.62","17.75"
"64","000","00","017","1701","0000","2466","735","1731","97","2563","4050","0","63.28","18.15"
"64","000","00","017","1701","0661","1126","335","791","38","1164","1777","0","65.5","18.85"
"64","000","00","017","1701","0662","1340","400","940","59","1399","2273","0","61.55","17.6"
"64","000","00","017","1702","0000","4457","1413","3044","232","4689","7511","0","62.43","18.81"
"64","000","00","017","1702","0663","842","268","574","76","918","1384","0","66.33","19.36"
"64","000","00","017","1702","0664","641","199","442","49","690","1170","0","58.97","17.01"
"64","000","00","017","1702","0665","766","269","497","53","819","1216","0","67.35","22.12"
"64","000","00","017","1702","0666","883","272","611","23","906","1598","0","56.7","17.02"
"64","000","00","017","1702","0667","1325","405","920","31","1356","2143","0","63.28","18.9"
"64","000","00","017","1703","0000","1439","480","959","135","1574","2638","0","59.67","18.2"
"64","000","00","017","1703","0668","684","231","453","68","752","1300","0","57.85","17.77"
"64","000","00","017","1703","0669","755","249","506","67","822","1338","0","61.43","18.61"
"64","000","00","017","1704","0000","1917","588","1329","124","2041","3823","0","53.39","15.38"
"64","000","00","017","1704","0670","640","209","431","22","662","1217","0","54.4","17.17"
"64","000","00","017","1704","0671","555","151","404","62","617","1202","0","51.33","12.56"
"64","000","00","017","1704","0672","722","228","494","40","762","1404","0","54.27","16.24"
"64","000","00","017","1705","0000","439","142","297","42","481","830","0","57.95","17.11"
"64","000","00","017","1705","0673","439","142","297","42","481","830","0","57.95","17.11"
"64","000","00","017","1706","0000","2529","803","1726","131","2660","5417","0","49.1","14.82"
"64","000","00","017","1706","0674","764","228","536","45","809","1802","0","44.89","12.65"
"64","000","00","017","1706","0675","949","307","642","59","1008","1877","0","53.7","16.36"
"64","000","00","017","1706","0676","816","268","548","27","843","1738","0","48.5","15.42"
"64","000","00","017","1707","0000","4833","1569","3264","231","5064","8679","0","58.35","18.08"
"64","000","00","017","1707","0677","821","304","517","55","876","1549","0","56.55","19.63"
"64","000","00","017","1707","0678","891","284","607","47","938","1579","0","59.4","17.99"
"64","000","00","017","1707","0679","750","205","545","32","782","1406","0","55.62","14.58"
"64","000","00","017","1707","0680","833","273","560","28","861","1461","0","58.93","18.69"
"64","000","00","017","1707","0681","774","265","509","47","821","1311","0","62.62","20.21"
"64","000","00","017","1707","0682","764","238","526","22","786","1373","0","57.25","17.33"
"64","000","00","017","1708","0000","1156","390","766","46","1202","2216","0","54.24","17.6"
"64","000","00","017","1708","0683","526","202","324","13","539","1035","0","52.08","19.52"
"64","000","00","017","1708","0684","630","188","442","33","663","1181","0","56.14","15.92"
"64","000","00","017","1709","0000","9317","2972","6345","349","9666","15899","0","60.8","18.69"
"64","000","00","017","1709","0685","898","344","554","37","935","1670","0","55.99","20.6"
"64","000","00","017","1709","0686","871","282","589","24","895","1576","0","56.79","17.89"
"64","000","00","017","1709","0687","933","304","629","46","979","1576","0","62.12","19.29"
"64","000","00","017","1709","0688","1156","352","804","31","1187","1915","0","61.98","18.38"
"64","000","00","017","1709","0689","963","289","674","31","994","1758","0","56.54","16.44"
"64","000","00","017","1709","0690","1159","337","822","45","1204","1892","0","63.64","17.81"
"64","000","00","017","1709","0691","1173","369","804","52","1225","2025","0","60.49","18.22"
"64","000","00","017","1709","0692","1204","379","825","48","1252","2014","0","62.16","18.82"
"64","000","00","017","1709","0693","960","316","644","35","995","1473","0","67.55","21.45"
"64","000","00","017","1710","0000","1054","346","708","48","1102","1923","0","57.31","17.99"
"64","000","00","017","1710","0694","516","172","344","29","545","979","0","55.67","17.57"
"64","000","00","017","1710","0695","538","174","364","19","557","944","0","59.0","18.43"
"64","000","00","017","1711","0000","1342","421","921","101","1443","2481","0","58.16","16.97"
"64","000","00","017","1711","0696","635","212","423","66","701","1153","0","60.8","18.39"
"64","000","00","017","1711","0697","707","209","498","35","742","1328","0","55.87","15.74"
"64","000","00","017","1712","0000","934","299","635","66","1000","1657","0","60.35","18.04"
"64","000","00","017","1712","0698","934","299","635","66","1000","1657","0","60.35","18.04"
"64","000","00","017","1713","0000","2629","812","1817","122","2751","4564","0","60.28","17.79"
"64","000","00","017","1713","0699","778","259","519","50","828","1545","0","53.59","16.76"
"64","000","00","017","1713","0700","849","250","599","41","890","1417","0","62.81","17.64"
"64","000","00","017","1713","0701","1002","303","699","31","1033","1602","0","64.48","18.91"
"64","000","00","017","1714","0000","2205","708","1497","82","2287","3737","0","61.2","18.95"
"64","000","00","017","1714","0702","1122","343","779","51","1173","1823","0","64.34","18.82"
"64","000","00","017","1714","0703","1083","365","718","31","1114","1914","0","58.2","19.07"
"64","000","00","017","1715","0000","3327","1032","2295","137","3464","6019","0","57.55","17.15"
"64","000","00","017","1715","0704","1114","349","765","51","1165","1992","0","58.48","17.52"
"64","000","00","017","1715","0705","1035","305","730","41","1076","2045","0","52.62","14.91"
"64","000","00","017","1715","0706","1178","378","800","45","1223","1982","0","61.71","19.07"
"64","000","00","017","1716","0000","1118","358","760","48","1166","2167","0","53.81","16.52"
"64","000","00","017","1716","0707","1118","358","760","48","1166","2167","0","53.81","16.52"
"64","000","00","018","0000","0000","22538","7877","14661","1305","23843","39191","44387","60.84","20.1"
"64","000","00","018","1801","0000","5546","1981","3565","311","5857","10030","0","58.39","19.75"
"64","000","00","018","1801","0708","930","308","622","57","987","1678","0","58.82","18.36"
"64","000","00","018","1801","0709","855","284","571","61","916","1682","0","54.46","16.88"
"64","000","00","018","1801","0710","720","248","472","47","767","1225","0","62.61","20.24"
"64","000","00","018","1801","0711","685","236","449","49","734","1322","0","55.52","17.85"
"64","000","00","018","1801","0712","701","222","479","37","738","1215","0","60.74","18.27"
"64","000","00","018","1801","0713","928","313","615","47","975","1779","0","54.81","17.59"
"64","000","00","018","1801","0714","727","370","357","13","740","1129","0","65.54","32.77"
"64","000","00","018","1802","0000","2756","983","1773","124","2880","4682","0","61.51","21.0"
"64","000","00","018","1802","0715","813","274","539","46","859","1374","0","62.52","19.94"
"64","000","00","018","1802","0716","624","225","399","30","654","1089","0","60.06","20.66"
"64","000","00","018","1802","0717","1319","484","835","48","1367","2219","0","61.6","21.81"
"64","000","00","018","1803","0000","5910","2117","3793","273","6183","9817","0","62.98","21.56"
"64","000","00","018","1803","0718","943","345","598","35","978","1634","0","59.85","21.11"
"64","000","00","018","1803","0719","935","304","631","52","987","1553","0","63.55","19.58"
"64","000","00","018","1803","0720","951","344","607","43","994","1572","0","63.23","21.88"
"64","000","00","018","1803","0721","1030","375","655","38","1068","1688","0","63.27","22.22"
"64","000","00","018","1803","0722","987","376","611","41","1028","1626","0","63.22","23.12"
"64","000","00","018","1803","0723","1064","373","691","64","1128","1744","0","64.68","21.39"
"64","000","00","018","1804","0000","2039","633","1406","155","2194","3548","0","61.84","17.84"
"64","000","00","018","1804","0724","651","193","458","43","694","1230","0","56.42","15.69"
"64","000","00","018","1804","0725","704","235","469","70","774","1201","0","64.45","19.57"
"64","000","00","018","1804","0726","684","205","479","42","726","1117","0","65.0","18.35"
"64","000","00","018","1805","0000","3503","1291","2212","254","3757","6462","0","58.14","19.98"
"64","000","00","018","1805","0727","679","180","499","60","739","1255","0","58.88","14.34"
"64","000","00","018","1805","0728","737","227","510","33","770","1432","0","53.77","15.85"
"64","000","00","018","1805","0729","698","500","198","31","729","1370","0","53.21","36.5"
"64","000","00","018","1805","0730","779","222","557","77","856","1364","0","62.76","16.28"
"64","000","00","018","1805","0731","610","162","448","53","663","1041","0","63.69","15.56"
"64","000","00","018","1806","0000","479","150","329","61","540","702","0","76.92","21.37"
"64","000","00","018","1806","0732","479","150","329","61","540","702","0","76.92","21.37"
"64","000","00","018","1807","0000","2305","722","1583","127","2432","3950","0","61.57","18.28"
"64","000","00","018","1807","0733","686","215","471","50","736","1212","0","60.73","17.74"
"64","000","00","018","1807","0734","706","200","506","51","757","1289","0","58.73","15.52"
"64","000","00","018","1807","0735","913","307","606","26","939","1449","0","64.8","21.19"
"64","000","00","019","0000","0000","47247","14680","32567","2620","49867","81244","97072","61.38","18.07"
"64","000","00","019","1901","0000","730","224","506","44","774","1159","0","66.78","19.33"
"64","000","00","019","1901","0268","730","224","506","44","774","1159","0","66.78","19.33"
"64","000","00","019","1902","0000","2493","818","1675","91","2584","4358","0","59.29","18.77"
"64","000","00","019","1902","0261","847","285","562","30","877","1345","0","65.2","21.19"
"64","000","00","019","1902","0262","480","161","319","18","498","1045","0","47.66","15.41"
"64","000","00","019","1902","0263","617","178","439","27","644","1051","0","61.27","16.94"
"64","000","00","019","1902","0264","549","194","355","16","565","917","0","61.61","21.16"
"64","000","00","019","1903","0000","2008","597","1411","106","2114","3239","0","65.27","18.43"
"64","000","00","019","1903","0265","587","222","365","28","615","934","0","65.85","23.77"
"64","000","00","019","1903","0266","654","168","486","41","695","1097","0","63.35","15.31"
"64","000","00","019","1903","0267","767","207","560","37","804","1208","0","66.56","17.14"
"64","000","00","019","1904","0000","587","204","383","39","626","1018","0","61.49","20.04"
"64","000","00","019","1904","0269","587","204","383","39","626","1018","0","61.49","20.04"
"64","000","00","019","1905","0000","2387","741","1646","61","2448","4091","0","59.84","18.11"
"64","000","00","019","1905","0274","742","229","513","30","772","1328","0","58.13","17.24"
"64","000","00","019","1905","0275","812","249","563","16","828","1382","0","59.91","18.02"
"64","000","00","019","1905","0276","833","263","570","15","848","1381","0","61.4","19.04"
"64","000","00","019","1906","0000","676","239","437","28","704","1316","0","53.5","18.16"
"64","000","00","019","1906","0270","676","239","437","28","704","1316","0","53.5","18.16"
"64","000","00","019","1907","0000","1791","445","1346","57","1848","2895","0","63.83","15.37"
"64","000","00","019","1907","0325","782","198","584","35","817","1336","0","61.15","14.82"
"64","000","00","019","1907","0326","760","153","607","12","772","1218","0","63.38","12.56"
"64","000","00","019","1907","0327","249","94","155","10","259","341","0","75.95","27.57"
"64","000","00","019","1908","0000","230","67","163","10","240","318","0","75.47","21.07"
"64","000","00","019","1908","0332","230","67","163","10","240","318","0","75.47","21.07"
"64","000","00","019","1909","0000","1565","488","1077","70","1635","2795","0","58.5","17.46"
"64","000","00","019","1909","0293","740","238","502","39","779","1283","0","60.72","18.55"
"64","000","00","019","1909","0294","825","250","575","31","856","1512","0","56.61","16.53"
"64","000","00","019","1910","0000","754","239","515","32","786","1413","0","55.63","16.91"
"64","000","00","019","1910","0309","754","239","515","32","786","1413","0","55.63","16.91"
"64","000","00","019","1911","0000","2117","685","1432","140","2257","3607","0","62.57","18.99"
"64","000","00","019","1911","0304","749","248","501","34","783","1272","0","61.56","19.5"
"64","000","00","019","1911","0305","646","206","440","50","696","1080","0","64.44","19.07"
"64","000","00","019","1911","0306","722","231","491","56","778","1255","0","61.99","18.41"
"64","000","00","019","1912","0000","3307","1115","2192","146","3453","5535","0","62.38","20.14"
"64","000","00","019","1912","0300","816","280","536","35","851","1360","0","62.57","20.59"
"64","000","00","019","1912","0301","833","254","579","21","854","1363","0","62.66","18.64"
"64","000","00","019","1912","0302","840","327","513","38","878","1352","0","64.94","24.19"
"64","000","00","019","1912","0303","818","254","564","52","870","1460","0","59.59","17.4"
"64","000","00","019","1913","0000","1065","322","743","46","1111","1613","0","68.88","19.96"
"64","000","00","019","1913","0330","541","167","374","34","575","851","0","67.57","19.62"
"64","000","00","019","1913","0331","524","155","369","12","536","762","0","70.34","20.34"
"64","000","00","019","1914","0000","435","144","291","81","516","756","0","68.25","19.05"
"64","000","00","019","1914","0320","435","144","291","81","516","756","0","68.25","19.05"
"64","000","00","019","1915","0000","406","110","296","20","426","866","0","49.19","12.7"
"64","000","00","019","1915","0323","406","110","296","20","426","866","0","49.19","12.7"
"64","000","00","019","1916","0000","1896","623","1273","112","2008","3350","0","59.94","18.6"
"64","000","00","019","1916","0297","643","215","428","46","689","1096","0","62.86","19.62"
"64","000","00","019","1916","0298","617","204","413","34","651","1066","0","61.07","19.14"
"64","000","00","019","1916","0299","636","204","432","32","668","1188","0","56.23","17.17"
"64","000","00","019","1917","0000","2179","709","1470","114","2293","3849","0","59.57","18.42"
"64","000","00","019","1917","0277","716","248","468","60","776","1282","0","60.53","19.34"
"64","000","00","019","1917","0278","701","222","479","15","716","1240","0","57.74","17.9"
"64","000","00","019","1917","0279","762","239","523","39","801","1327","0","60.36","18.01"
"64","000","00","019","1918","0000","2333","745","1588","110","2443","4065","0","60.1","18.33"
"64","000","00","019","1918","0271","756","243","513","35","791","1345","0","58.81","18.07"
"64","000","00","019","1918","0272","766","248","518","40","806","1295","0","62.24","19.15"
"64","000","00","019","1918","0273","811","254","557","35","846","1425","0","59.37","17.82"
"64","000","00","019","1919","0000","3502","1068","2434","199","3701","6674","0","55.45","16.0"
"64","000","00","019","1919","0280","934","330","604","36","970","1736","0","55.88","19.01"
"64","000","00","019","1919","0281","904","294","610","45","949","1566","0","60.6","18.77"
"64","000","00","019","1919","0282","767","177","590","53","820","1779","0","46.09","9.95"
"64","000","00","019","1919","0283","897","267","630","65","962","1593","0","60.39","16.76"
"64","000","00","019","1920","0000","3233","925","2308","179","3412","5402","0","63.16","17.12"
"64","000","00","019","1920","0284","862","258","604","63","925","1480","0","62.5","17.43"
"64","000","00","019","1920","0285","798","215","583","28","826","1364","0","60.56","15.76"
"64","000","00","019","1920","0286","824","239","585","43","867","1410","0","61.49","16.95"
"64","000","00","019","1920","0287","749","213","536","45","794","1148","0","69.16","18.55"
"64","000","00","019","1921","0000","1103","375","728","47","1150","1830","0","62.84","20.49"
"64","000","00","019","1921","0289","576","198","378","26","602","969","0","62.13","20.43"
"64","000","00","019","1921","0290","527","177","350","21","548","861","0","63.65","20.56"
"64","000","00","019","1922","0000","1111","360","751","42","1153","1808","0","63.77","19.91"
"64","000","00","019","1922","0310","455","149","306","13","468","765","0","61.18","19.48"
"64","000","00","019","1922","0311","656","211","445","29","685","1043","0","65.68","20.23"
"64","000","00","019","1923","0000","1112","351","761","74","1186","1837","0","64.56","19.11"
"64","000","00","019","1923","0312","420","126","294","35","455","844","0","53.91","14.93"
"64","000","00","019","1923","0313","692","225","467","39","731","993","0","73.62","22.66"
"64","000","00","019","1924","0000","608","229","379","67","675","1038","0","65.03","22.06"
"64","000","00","019","1924","0314","608","229","379","67","675","1038","0","65.03","22.06"
"64","000","00","019","1925","0000","982","336","646","69","1051","1712","0","61.39","19.63"
"64","000","00","019","1925","0291","432","143","289","21","453","823","0","55.04","17.38"
"64","000","00","019","1925","0292","550","193","357","48","598","889","0","67.27","21.71"
"64","000","00","019","1926","0000","1975","619","1356","175","2150","3442","0","62.46","17.98"
"64","000","00","019","1926","0315","583","169","414","77","660","1070","0","61.68","15.79"
"64","000","00","019","1926","0316","632","217","415","61","693","1023","0","67.74","21.21"
"64","000","00","019","1926","0317","760","233","527","37","797","1349","0","59.08","17.27"
"64","000","00","019","1927","0000","842","200","642","60","902","1753","0","51.45","11.41"
"64","000","00","019","1927","0318","652","130","522","46","698","1452","0","48.07","8.95"
"64","000","00","019","1927","0319","190","70","120","14","204","301","0","67.77","23.26"
"64","000","00","019","1928","0000","913","278","635","90","1003","1587","0","63.2","17.52"
"64","000","00","019","1928","0321","381","106","275","23","404","733","0","55.12","14.46"
"64","000","00","019","1928","0322","532","172","360","67","599","854","0","70.14","20.14"
"64","000","00","019","1929","0000","527","207","320","51","578","978","0","59.1","21.17"
"64","000","00","019","1929","0324","527","207","320","51","578","978","0","59.1","21.17"
"64","000","00","019","1930","0000","1334","392","942","87","1421","2175","0","65.33","18.02"
"64","000","00","019","1930","0307","585","162","423","44","629","938","0","67.06","17.27"
"64","000","00","019","1930","0308","749","230","519","43","792","1237","0","64.03","18.59"
"64","000","00","019","1931","0000","371","126","245","40","411","625","0","65.76","20.16"
"64","000","00","019","1931","0288","371","126","245","40","411","625","0","65.76","20.16"
"64","000","00","019","1932","0000","1349","427","922","90","1439","2245","0","64.1","19.02"
"64","000","00","019","1932","0295","618","200","418","54","672","983","0","68.36","20.35"
"64","000","00","019","1932","0296","731","227","504","36","767","1262","0","60.78","17.99"
"64","000","00","019","1933","0000","1326","272","1054","43","1369","1895","0","72.24","14.35"
"64","000","00","019","1933","0328","685","140","545","31","716","955","0","74.97","14.66"
"64","000","00","019","1933","0329","641","132","509","12","653","940","0","69.47","14.04"
"64","000","00","020","0000","0000","18666","6321","12345","1594","20260","32565","37647","62.21","19.41"
"64","000","00","020","2001","0000","1257","456","801","111","1368","2078","0","65.83","21.94"
"64","000","00","020","2001","0404","611","233","378","69","680","1005","0","67.66","23.18"
"64","000","00","020","2001","0405","646","223","423","42","688","1073","0","64.12","20.78"
"64","000","00","020","2002","0000","676","217","459","26","702","1129","0","62.18","19.22"
"64","000","00","020","2002","0406","676","217","459","26","702","1129","0","62.18","19.22"
"64","000","00","020","2003","0000","1321","452","869","105","1426","2335","0","61.07","19.36"
"64","000","00","020","2003","0407","713","244","469","73","786","1244","0","63.18","19.61"
"64","000","00","020","2003","0408","608","208","400","32","640","1091","0","58.66","19.07"
"64","000","00","020","2004","0000","1481","507","974","107","1588","2469","0","64.32","20.53"
"64","000","00","020","2004","0409","825","281","544","52","877","1329","0","65.99","21.14"
"64","000","00","020","2004","0410","656","226","430","55","711","1140","0","62.37","19.82"
"64","000","00","020","2005","0000","691","224","467","68","759","1220","0","62.21","18.36"
"64","000","00","020","2005","0411","691","224","467","68","759","1220","0","62.21","18.36"
"64","000","00","020","2006","0000","1356","463","893","151","1507","2362","0","63.8","19.6"
"64","000","00","020","2006","0412","652","213","439","63","715","1047","0","68.29","20.34"
"64","000","00","020","2006","0413","704","250","454","88","792","1315","0","60.23","19.01"
"64","000","00","020","2007","0000","799","272","527","92","891","1411","0","63.15","19.28"
"64","000","00","020","2007","0414","379","131","248","32","411","691","0","59.48","18.96"
"64","000","00","020","2007","0415","420","141","279","60","480","720","0","66.67","19.58"
"64","000","00","020","2008","0000","1874","664","1210","213","2087","3271","0","63.8","20.3"
"64","000","00","020","2008","0416","653","255","398","90","743","1192","0","62.33","21.39"
"64","000","00","020","2008","0417","767","266","501","83","850","1318","0","64.49","20.18"
"64","000","00","020","2008","0418","454","143","311","40","494","761","0","64.91","18.79"
"64","000","00","020","2009","0000","880","317","563","61","941","1560","0","60.32","20.32"
"64","000","00","020","2009","0419","547","188","359","29","576","973","0","59.2","19.32"
"64","000","00","020","2009","0420","333","129","204","32","365","587","0","62.18","21.98"
"64","000","00","020","2010","0000","1493","544","949","79","1572","2421","0","64.93","22.47"
"64","000","00","020","2010","0421","491","170","321","40","531","812","0","65.39","20.94"
"64","000","00","020","2010","0422","204","73","131","15","219","343","0","63.85","21.28"
"64","000","00","020","2010","0423","798","301","497","24","822","1266","0","64.93","23.78"
"64","000","00","020","2011","0000","1188","350","838","122","1310","2012","0","65.11","17.4"
"64","000","00","020","2011","0424","666","198","468","79","745","1128","0","66.05","17.55"
"64","000","00","020","2011","0425","522","152","370","43","565","884","0","63.91","17.19"
"64","000","00","020","2012","0000","1344","413","931","133","1477","2446","0","60.38","16.88"
"64","000","00","020","2012","0426","625","195","430","70","695","1187","0","58.55","16.43"
"64","000","00","020","2012","0427","719","218","501","63","782","1259","0","62.11","17.32"
"64","000","00","020","2013","0000","690","218","472","65","755","1361","0","55.47","16.02"
"64","000","00","020","2013","0428","690","218","472","65","755","1361","0","55.47","16.02"
"64","000","00","020","2014","0000","335","105","230","29","364","671","0","54.25","15.65"
"64","000","00","020","2014","0429","335","105","230","29","364","671","0","54.25","15.65"
"64","000","00","020","2015","0000","2187","735","1452","187","2374","3689","0","64.35","19.92"
"64","000","00","020","2015","0430","726","265","461","50","776","1215","0","63.87","21.81"
"64","000","00","020","2015","0431","736","212","524","72","808","1255","0","64.38","16.89"
"64","000","00","020","2015","0432","725","258","467","65","790","1219","0","64.81","21.16"
"64","000","00","020","2016","0000","760","253","507","37","797","1372","0","58.09","18.44"
"64","000","00","020","2016","0433","760","253","507","37","797","1372","0","58.09","18.44"
"64","000","00","020","2017","0000","334","131","203","8","342","758","0","45.12","17.28"
"64","000","00","020","2017","0434","334","131","203","8","342","758","0","45.12","17.28"
"64","000","00","021","0000","0000","13753","4398","9355","1159","14912","26012","29809","57.33","16.91"
"64","000","00","021","2101","0000","586","171","415","71","657","1152","0","57.03","14.84"
"64","000","00","021","2101","0333","586","171","415","71","657","1152","0","57.03","14.84"
"64","000","00","021","2102","0000","1206","368","838","86","1292","2094","0","61.7","17.57"
"64","000","00","021","2102","0334","610","198","412","35","645","1120","0","57.59","17.68"
"64","000","00","021","2102","0335","596","170","426","51","647","974","0","66.43","17.45"
"64","000","00","021","2103","0000","1612","575","1037","106","1718","3353","0","51.24","17.15"
"64","000","00","021","2103","0336","559","188","371","17","576","1019","0","56.53","18.45"
"64","000","00","021","2103","0337","546","216","330","56","602","1058","0","56.9","20.42"
"64","000","00","021","2103","0338","469","160","309","29","498","1017","0","48.97","15.73"
"64","000","00","021","2103","0339","38","11","27","4","42","259","0","16.22","4.25"
"64","000","00","021","2104","0000","1536","450","1086","125","1661","2652","0","62.63","16.97"
"64","000","00","021","2104","0340","561","155","406","52","613","926","0","66.2","16.74"
"64","000","00","021","2104","0341","314","103","211","14","328","624","0","52.56","16.51"
"64","000","00","021","2104","0342","661","192","469","59","720","1102","0","65.34","17.42"
"64","000","00","021","2105","0000","1252","431","821","121","1373","2433","0","56.43","17.71"
"64","000","00","021","2105","0343","534","166","368","47","581","1072","0","54.2","15.49"
"64","000","00","021","2105","0344","718","265","453","74","792","1361","0","58.19","19.47"
"64","000","00","021","2106","0000","257","68","189","31","288","472","0","61.02","14.41"
"64","000","00","021","2106","0345","257","68","189","31","288","472","0","61.02","14.41"
"64","000","00","021","2107","0000","1264","374","890","115","1379","2331","0","59.16","16.04"
"64","000","00","021","2107","0346","597","169","428","45","642","1197","0","53.63","14.12"
"64","000","00","021","2107","0347","667","205","462","70","737","1134","0","64.99","18.08"
"64","000","00","021","2108","0000","2060","668","1392","137","2197","3757","0","58.48","17.78"
"64","000","00","021","2108","0348","602","189","413","36","638","1148","0","55.57","16.46"
"64","000","00","021","2108","0349","595","202","393","61","656","1207","0","54.35","16.74"
"64","000","00","021","2108","0350","863","277","586","40","903","1402","0","64.41","19.76"
"64","000","00","021","2109","0000","1870","672","1198","168","2038","3401","0","59.92","19.76"
"64","000","00","021","2109","0351","549","194","355","59","608","1000","0","60.8","19.4"
"64","000","00","021","2109","0352","622","233","389","59","681","1110","0","61.35","20.99"
"64","000","00","021","2109","0353","699","245","454","50","749","1291","0","58.02","18.98"
"64","000","00","021","2110","0000","948","288","660","118","1066","1895","0","56.25","15.2"
"64","000","00","021","2110","0354","418","130","288","72","490","797","0","61.48","16.31"
"64","000","00","021","2110","0355","530","158","372","46","576","1098","0","52.46","14.39"
"64","000","00","021","2111","0000","1162","333","829","81","1243","2472","0","50.28","13.47"
"64","000","00","021","2111","0356","697","209","488","55","752","1393","0","53.98","15.0"
"64","000","00","021","2111","0357","465","124","341","26","491","1079","0","45.51","11.49"
"64","000","00","022","0000","0000","2879","897","1982","325","3204","6671","7196","48.03","13.45"
"64","000","00","022","2201","0000","156","42","114","8","164","369","0","44.44","11.38"
"64","000","00","022","2201","0237","156","42","114","8","164","369","0","44.44","11.38"
"64","000","00","022","2202","0000","373","130","243","32","405","1062","0","38.14","12.24"
"64","000","00","022","2202","0238","263","94","169","17","280","656","0","42.68","14.33"
"64","000","00","022","2202","0239","110","36","74","15","125","406","0","30.79","8.87"
"64","000","00","022","2203","0000","166","65","101","26","192","380","0","50.53","17.11"
"64","000","00","022","2203","0240","166","65","101","26","192","380","0","50.53","17.11"
"64","000","00","022","2204","0000","188","42","146","15","203","379","0","53.56","11.08"
"64","000","00","022","2204","0241","188","42","146","15","203","379","0","53.56","11.08"
"64","000","00","022","2205","0000","299","78","221","55","354","625","0","56.64","12.48"
"64","000","00","022","2205","0242","299","78","221","55","354","625","0","56.64","12.48"
"64","000","00","022","2206","0000","449","154","295","18","467","946","0","49.37","16.28"
"64","000","00","022","2206","0243","449","154","295","18","467","946","0","49.37","16.28"
"64","000","00","022","2207","0000","335","93","242","43","378","794","0","47.61","11.71"
"64","000","00","022","2207","0244","335","93","242","43","378","794","0","47.61","11.71"
"64","000","00","022","2208","0000","148","42","106","21","169","382","0","44.24","10.99"
"64","000","00","022","2208","0245","148","42","106","21","169","382","0","44.24","10.99"
"64","000","00","022","2209","0000","157","60","97","43","200","513","0","38.99","11.7"
"64","000","00","022","2209","0246","157","60","97","43","200","513","0","38.99","11.7"
"64","000","00","022","2210","0000","608","191","417","64","672","1221","0","55.04","15.64"
"64","000","00","022","2210","0247","287","92","195","21","308","601","0","51.25","15.31"
"64","000","00","022","2210","0248","321","99","222","43","364","620","0","58.71","15.97"
"64","000","00","023","0000","0000","12492","4353","8139","792","13284","24534","28676","54.15","17.74"
"64","000","00","023","2301","0000","594","372","222","37","631","1299","0","48.58","28.64"
"64","000","00","023","2301","0216","594","372","222","37","631","1299","0","48.58","28.64"
"64","000","00","023","2302","0000","1014","313","701","50","1064","2005","0","53.07","15.61"
"64","000","00","023","2302","0217","574","178","396","28","602","1107","0","54.38","16.08"
"64","000","00","023","2302","0218","440","135","305","22","462","898","0","51.45","15.03"
"64","000","00","023","2303","0000","619","212","407","69","688","1259","0","54.65","16.84"
"64","000","00","023","2303","0219","619","212","407","69","688","1259","0","54.65","16.84"
"64","000","00","023","2304","0000","1115","383","732","53","1168","2143","0","54.5","17.87"
"64","000","00","023","2304","0220","797","280","517","42","839","1579","0","53.13","17.73"
"64","000","00","023","2304","0221","318","103","215","11","329","564","0","58.33","18.26"
"64","000","00","023","2305","0000","450","162","288","48","498","768","0","64.84","21.09"
"64","000","00","023","2305","0222","450","162","288","48","498","768","0","64.84","21.09"
"64","000","00","023","2306","0000","2547","863","1684","156","2703","4886","0","55.32","17.66"
"64","000","00","023","2306","0223","580","205","375","57","637","1092","0","58.33","18.77"
"64","000","00","023","2306","0224","577","192","385","50","627","1099","0","57.05","17.47"
"64","000","00","023","2306","0225","617","200","417","25","642","1134","0","56.61","17.64"
"64","000","00","023","2306","0226","773","266","507","24","797","1561","0","51.06","17.04"
"64","000","00","023","2307","0000","1371","480","891","101","1472","2649","0","55.57","18.12"
"64","000","00","023","2307","0227","841","301","540","64","905","1533","0","59.03","19.63"
"64","000","00","023","2307","0228","530","179","351","37","567","1116","0","50.81","16.04"
"64","000","00","023","2308","0000","1194","416","778","76","1270","2314","0","54.88","17.98"
"64","000","00","023","2308","0229","556","193","363","27","583","1054","0","55.31","18.31"
"64","000","00","023","2308","0230","638","223","415","49","687","1260","0","54.52","17.7"
"64","000","00","023","2309","0000","739","234","505","60","799","1504","0","53.13","15.56"
"64","000","00","023","2309","0231","739","234","505","60","799","1504","0","53.13","15.56"
"64","000","00","023","2310","0000","799","249","550","39","838","1671","0","50.15","14.9"
"64","000","00","023","2310","0232","381","125","256","21","402","848","0","47.41","14.74"
"64","000","00","023","2310","0233","418","124","294","18","436","823","0","52.98","15.07"
"64","000","00","023","2311","0000","552","161","391","34","586","1021","0","57.39","15.77"
"64","000","00","023","2311","0234","552","161","391","34","586","1021","0","57.39","15.77"
"64","000","00","023","2312","0000","1498","508","990","69","1567","3015","0","51.97","16.85"
"64","000","00","023","2312","0235","856","311","545","25","881","1715","0","51.37","18.13"
"64","000","00","023","2312","0236","642","197","445","44","686","1300","0","52.77","15.15"
"64","000","00","024","0000","0000","23980","7908","16072","1964","25944","43850","52578","59.17","18.03"
"64","000","00","024","2401","0000","1722","563","1159","147","1869","3222","0","58.01","17.47"
"64","000","00","024","2401","0175","522","172","350","25","547","1026","0","53.31","16.76"
"64","000","00","024","2401","0176","569","187","382","62","631","1069","0","59.03","17.49"
"64","000","00","024","2401","0177","631","204","427","60","691","1127","0","61.31","18.1"
"64","000","00","024","2402","0000","619","157","462","57","676","1179","0","57.34","13.32"
"64","000","00","024","2402","0178","619","157","462","57","676","1179","0","57.34","13.32"
"64","000","00","024","2403","0000","624","213","411","78","702","1237","0","56.75","17.22"
"64","000","00","024","2403","0179","624","213","411","78","702","1237","0","56.75","17.22"
"64","000","00","024","2404","0000","614","211","403","47","661","1096","0","60.31","19.25"
"64","000","00","024","2404","0180","614","211","403","47","661","1096","0","60.31","19.25"
"64","000","00","024","2405","0000","739","240","499","65","804","1272","0","63.21","18.87"
"64","000","00","024","2405","0181","739","240","499","65","804","1272","0","63.21","18.87"
"64","000","00","024","2406","0000","1238","366","872","114","1352","2309","0","58.55","15.85"
"64","000","00","024","2406","0182","639","183","456","58","697","1182","0","58.97","15.48"
"64","000","00","024","2406","0183","599","183","416","56","655","1127","0","58.12","16.24"
"64","000","00","024","2407","0000","1128","397","731","113","1241","2088","0","59.43","19.01"
"64","000","00","024","2407","0184","526","187","339","49","575","956","0","60.15","19.56"
"64","000","00","024","2407","0185","602","210","392","64","666","1132","0","58.83","18.55"
"64","000","00","024","2408","0000","1748","579","1169","173","1921","3333","0","57.64","17.37"
"64","000","00","024","2408","0186","570","193","377","86","656","1025","0","64.0","18.83"
"64","000","00","024","2408","0187","539","172","367","27","566","1007","0","56.21","17.08"
"64","000","00","024","2408","0188","639","214","425","60","699","1301","0","53.73","16.45"
"64","000","00","024","2409","0000","1386","464","922","104","1490","2652","0","56.18","17.5"
"64","000","00","024","2409","0189","474","141","333","39","513","885","0","57.97","15.93"
"64","000","00","024","2409","0190","394","139","255","18","412","837","0","49.22","16.61"
"64","000","00","024","2409","0191","518","184","334","47","565","930","0","60.75","19.78"
"64","000","00","024","2410","0000","923","311","612","97","1020","1804","0","56.54","17.24"
"64","000","00","024","2410","0192","367","130","237","40","407","781","0","52.11","16.65"
"64","000","00","024","2410","0193","556","181","375","57","613","1023","0","59.92","17.69"
"64","000","00","024","2411","0000","1863","629","1234","125","1988","3400","0","58.47","18.5"
"64","000","00","024","2411","0194","983","335","648","73","1056","1763","0","59.9","19.0"
"64","000","00","024","2411","0195","880","294","586","52","932","1637","0","56.93","17.96"
"64","000","00","024","2412","0000","1231","390","841","103","1334","2247","0","59.37","17.36"
"64","000","00","024","2412","0196","563","182","381","44","607","1070","0","56.73","17.01"
"64","000","00","024","2412","0197","668","208","460","59","727","1177","0","61.77","17.67"
"64","000","00","024","2413","0000","1666","558","1108","123","1789","3050","0","58.66","18.3"
"64","000","00","024","2413","0198","551","188","363","43","594","1007","0","58.99","18.67"
"64","000","00","024","2413","0199","556","199","357","41","597","1026","0","58.19","19.4"
"64","000","00","024","2413","0200","559","171","388","39","598","1017","0","58.8","16.81"
"64","000","00","024","2414","0000","1319","447","872","87","1406","2353","0","59.75","19.0"
"64","000","00","024","2414","0201","700","250","450","37","737","1264","0","58.31","19.78"
"64","000","00","024","2414","0202","619","197","422","50","669","1089","0","61.43","18.09"
"64","000","00","024","2415","0000","461","157","304","36","497","851","0","58.4","18.45"
"64","000","00","024","2415","0203","461","157","304","36","497","851","0","58.4","18.45"
"64","000","00","024","2416","0000","1124","359","765","113","1237","1948","0","63.5","18.43"
"64","000","00","024","2416","0204","553","186","367","77","630","1011","0","62.31","18.4"
"64","000","00","024","2416","0205","571","173","398","36","607","937","0","64.78","18.46"
"64","000","00","024","2417","0000","960","331","629","40","1000","1730","0","57.8","19.13"
"64","000","00","024","2417","0206","410","127","283","16","426","820","0","51.95","15.49"
"64","000","00","024","2417","0207","550","204","346","24","574","910","0","63.08","22.42"
"64","000","00","024","2418","0000","444","163","281","50","494","867","0","56.98","18.8"
"64","000","00","024","2418","0208","444","163","281","50","494","867","0","56.98","18.8"
"64","000","00","024","2419","0000","1514","514","1000","116","1630","2737","0","59.55","18.78"
"64","000","00","024","2419","0209","518","171","347","31","549","937","0","58.59","18.25"
"64","000","00","024","2419","0210","487","191","296","36","523","900","0","58.11","21.22"
"64","000","00","024","2419","0211","509","152","357","49","558","900","0","62.0","16.89"
"64","000","00","024","2420","0000","2657","859","1798","176","2833","4475","0","63.31","19.2"
"64","000","00","024","2420","0212","526","161","365","36","562","918","0","61.22","17.54"
"64","000","00","024","2420","0213","523","180","343","40","563","870","0","64.71","20.69"
"64","000","00","024","2420","0214","678","233","445","46","724","1150","0","62.96","20.26"
"64","000","00","024","2420","0215","930","285","645","54","984","1537","0","64.02","18.54"
"64","000","00","025","0000","0000","13437","4289","9148","942","14379","25729","29812","55.89","16.67"
"64","000","00","025","2501","0000","530","142","388","42","572","1112","0","51.44","12.77"
"64","000","00","025","2501","0151","530","142","388","42","572","1112","0","51.44","12.77"
"64","000","00","025","2502","0000","511","160","351","77","588","1017","0","57.82","15.73"
"64","000","00","025","2502","0152","511","160","351","77","588","1017","0","57.82","15.73"
"64","000","00","025","2503","0000","402","153","249","25","427","796","0","53.64","19.22"
"64","000","00","025","2503","0153","402","153","249","25","427","796","0","53.64","19.22"
"64","000","00","025","2504","0000","1240","430","810","64","1304","2194","0","59.43","19.6"
"64","000","00","025","2504","0154","643","231","412","30","673","1079","0","62.37","21.41"
"64","000","00","025","2504","0155","597","199","398","34","631","1115","0","56.59","17.85"
"64","000","00","025","2505","0000","1336","323","1013","68","1404","2630","0","53.38","12.28"
"64","000","00","025","2505","0156","675","100","575","38","713","1311","0","54.39","7.63"
"64","000","00","025","2505","0157","661","223","438","30","691","1319","0","52.39","16.91"
"64","000","00","025","2506","0000","2128","637","1491","154","2282","3634","0","62.8","17.53"
"64","000","00","025","2506","0158","735","226","509","56","791","1244","0","63.59","18.17"
"64","000","00","025","2506","0159","736","214","522","42","778","1227","0","63.41","17.44"
"64","000","00","025","2506","0160","657","197","460","56","713","1163","0","61.31","16.94"
"64","000","00","025","2507","0000","552","181","371","46","598","981","0","60.96","18.45"
"64","000","00","025","2507","0161","552","181","371","46","598","981","0","60.96","18.45"
"64","000","00","025","2508","0000","2039","673","1366","116","2155","3680","0","58.56","18.29"
"64","000","00","025","2508","0162","406","127","279","18","424","780","0","54.36","16.28"
"64","000","00","025","2508","0163","430","127","303","44","474","832","0","56.97","15.26"
"64","000","00","025","2508","0164","605","200","405","37","642","1017","0","63.13","19.67"
"64","000","00","025","2508","0165","598","219","379","17","615","1051","0","58.52","20.84"
"64","000","00","025","2509","0000","927","286","641","78","1005","1804","0","55.71","15.85"
"64","000","00","025","2509","0166","489","155","334","29","518","941","0","55.05","16.47"
"64","000","00","025","2509","0167","438","131","307","49","487","863","0","56.43","15.18"
"64","000","00","025","2510","0000","577","223","354","53","630","1160","0","54.31","19.22"
"64","000","00","025","2510","0168","577","223","354","53","630","1160","0","54.31","19.22"
"64","000","00","025","2511","0000","1039","381","658","91","1130","2212","0","51.08","17.22"
"64","000","00","025","2511","0169","450","168","282","34","484","1090","0","44.4","15.41"
"64","000","00","025","2511","0170","589","213","376","57","646","1122","0","57.58","18.98"
"64","000","00","025","2512","0000","523","182","341","28","551","1123","0","49.07","16.21"
"64","000","00","025","2512","0171","523","182","341","28","551","1123","0","49.07","16.21"
"64","000","00","025","2513","0000","355","115","240","28","383","684","0","55.99","16.81"
"64","000","00","025","2513","0172","355","115","240","28","383","684","0","55.99","16.81"
"64","000","00","025","2514","0000","1278","403","875","72","1350","2702","0","49.96","14.91"
"64","000","00","025","2514","0173","601","183","418","24","625","1249","0","50.04","14.65"
"64","000","00","025","2514","0174","677","220","457","48","725","1453","0","49.9","15.14"
"64","000","00","026","0000","0000","13056","4510","8546","1111","14167","26212","30055","54.05","17.21"
"64","000","00","026","2601","0000","457","156","301","19","476","976","0","48.77","15.98"
"64","000","00","026","2601","0130","457","156","301","19","476","976","0","48.77","15.98"
"64","000","00","026","2602","0000","427","147","280","59","486","887","0","54.79","16.57"
"64","000","00","026","2602","0131","427","147","280","59","486","887","0","54.79","16.57"
"64","000","00","026","2603","0000","854","262","592","38","892","1710","0","52.16","15.32"
"64","000","00","026","2603","0132","854","262","592","38","892","1710","0","52.16","15.32"
"64","000","00","026","2604","0000","1971","598","1373","102","2073","3751","0","55.27","15.94"
"64","000","00","026","2604","0133","537","152","385","48","585","1280","0","45.7","11.88"
"64","000","00","026","2604","0134","735","227","508","29","764","1314","0","58.14","17.28"
"64","000","00","026","2604","0135","699","219","480","25","724","1157","0","62.58","18.93"
"64","000","00","026","2605","0000","903","615","288","87","990","1785","0","55.46","34.45"
"64","000","00","026","2605","0136","903","615","288","87","990","1785","0","55.46","34.45"
"64","000","00","026","2606","0000","570","197","373","54","624","1139","0","54.78","17.3"
"64","000","00","026","2606","0142","570","197","373","54","624","1139","0","54.78","17.3"
"64","000","00","026","2607","0000","1536","493","1043","174","1710","2961","0","57.75","16.65"
"64","000","00","026","2607","0143","680","219","461","86","766","1363","0","56.2","16.07"
"64","000","00","026","2607","0144","856","274","582","88","944","1598","0","59.07","17.15"
"64","000","00","026","2608","0000","394","114","280","43","437","925","0","47.24","12.32"
"64","000","00","026","2608","0146","394","114","280","43","437","925","0","47.24","12.32"
"64","000","00","026","2609","0000","544","167","377","52","596","1111","0","53.65","15.03"
"64","000","00","026","2609","0145","544","167","377","52","596","1111","0","53.65","15.03"
"64","000","00","026","2610","0000","574","186","388","52","626","1148","0","54.53","16.2"
"64","000","00","026","2610","0147","574","186","388","52","626","1148","0","54.53","16.2"
"64","000","00","026","2611","0000","1178","380","798","112","1290","2087","0","61.81","18.21"
"64","000","00","026","2611","0137","423","133","290","65","488","838","0","58.23","15.87"
"64","000","00","026","2611","0138","755","247","508","47","802","1249","0","64.21","19.78"
"64","000","00","026","2612","0000","537","202","335","76","613","1116","0","54.93","18.1"
"64","000","00","026","2612","0139","537","202","335","76","613","1116","0","54.93","18.1"
"64","000","00","026","2613","0000","462","165","297","51","513","978","0","52.45","16.87"
"64","000","00","026","2613","0140","462","165","297","51","513","978","0","52.45","16.87"
"64","000","00","026","2614","0000","490","157","333","35","525","1125","0","46.67","13.96"
"64","000","00","026","2614","0141","490","157","333","35","525","1125","0","46.67","13.96"
"64","000","00","026","2615","0000","2159","671","1488","157","2316","4513","0","51.32","14.87"
"64","000","00","026","2615","0148","654","186","468","35","689","1353","0","50.92","13.75"
"64","000","00","026","2615","0149","671","200","471","60","731","1331","0","54.92","15.03"
"64","000","00","026","2615","0150","834","285","549","62","896","1829","0","48.99","15.58"
"64","000","00","027","0000","0000","7046","2323","4723","527","7573","12001","13888","63.1","19.36"
"64","000","00","027","2701","0000","937","296","641","91","1028","1574","0","65.31","18.81"
"64","000","00","027","2701","0249","466","146","320","39","505","756","0","66.8","19.31"
"64","000","00","027","2701","0250","471","150","321","52","523","818","0","63.94","18.34"
"64","000","00","027","2702","0000","1130","415","715","85","1215","1817","0","66.87","22.84"
"64","000","00","027","2702","0251","570","262","308","31","601","866","0","69.4","30.25"
"64","000","00","027","2702","0252","560","153","407","54","614","951","0","64.56","16.09"
"64","000","00","027","2703","0000","1278","415","863","87","1365","2339","0","58.36","17.74"
"64","000","00","027","2703","0253","581","184","397","50","631","992","0","63.61","18.55"
"64","000","00","027","2703","0254","316","123","193","15","331","682","0","48.53","18.04"
"64","000","00","027","2703","0255","381","108","273","22","403","665","0","60.6","16.24"
"64","000","00","027","2704","0000","188","69","119","15","203","371","0","54.72","18.6"
"64","000","00","027","2704","0256","188","69","119","15","203","371","0","54.72","18.6"
"64","000","00","027","2705","0000","1514","474","1040","101","1615","2532","0","63.78","18.72"
"64","000","00","027","2705","0257","671","219","452","61","732","1114","0","65.71","19.66"
"64","000","00","027","2705","0258","843","255","588","40","883","1418","0","62.27","17.98"
"64","000","00","027","2706","0000","1999","654","1345","148","2147","3368","0","63.75","19.42"
"64","000","00","027","2706","0259","876","276","600","79","955","1477","0","64.66","18.69"
"64","000","00","027","2706","0260","1123","378","745","69","1192","1891","0","63.04","19.99"
"64","000","00","028","0000","0000","9331","2893","6438","889","10220","16487","19266","61.99","17.55"
"64","000","00","028","2801","0000","681","194","487","67","748","1246","0","60.03","15.57"
"64","000","00","028","2801","0358","681","194","487","67","748","1246","0","60.03","15.57"
"64","000","00","028","2802","0000","1087","354","733","120","1207","1840","0","65.6","19.24"
"64","000","00","028","2802","0359","498","164","334","56","554","885","0","62.6","18.53"
"64","000","00","028","2802","0360","589","190","399","64","653","955","0","68.38","19.9"
"64","000","00","028","2803","0000","282","92","190","34","316","534","0","59.18","17.23"
"64","000","00","028","2803","0361","282","92","190","34","316","534","0","59.18","17.23"
"64","000","00","028","2804","0000","422","122","300","28","450","738","0","60.98","16.53"
"64","000","00","028","2804","0362","422","122","300","28","450","738","0","60.98","16.53"
"64","000","00","028","2805","0000","1060","314","746","85","1145","1732","0","66.11","18.13"
"64","000","00","028","2805","0363","540","157","383","37","577","855","0","67.49","18.36"
"64","000","00","028","2805","0364","520","157","363","48","568","877","0","64.77","17.9"
"64","000","00","028","2806","0000","904","307","597","89","993","1589","0","62.49","19.32"
"64","000","00","028","2806","0365","451","143","308","55","506","781","0","64.79","18.31"
"64","000","00","028","2806","0366","453","164","289","34","487","808","0","60.27","20.3"
"64","000","00","028","2807","0000","887","281","606","86","973","1729","0","56.28","16.25"
"64","000","00","028","2807","0367","439","126","313","31","470","904","0","51.99","13.94"
"64","000","00","028","2807","0368","448","155","293","55","503","825","0","60.97","18.79"
"64","000","00","028","2808","0000","1159","382","777","85","1244","2037","0","61.07","18.75"
"64","000","00","028","2808","0370","553","203","350","29","582","1013","0","57.45","20.04"
"64","000","00","028","2808","0371","606","179","427","56","662","1024","0","64.65","17.48"
"64","000","00","028","2809","0000","469","129","340","60","529","941","0","56.22","13.71"
"64","000","00","028","2809","0369","469","129","340","60","529","941","0","56.22","13.71"
"64","000","00","028","2810","0000","440","135","305","17","457","861","0","53.08","15.68"
"64","000","00","028","2810","0372","440","135","305","17","457","861","0","53.08","15.68"
"64","000","00","028","2811","0000","648","215","433","82","730","1163","0","62.77","18.49"
"64","000","00","028","2811","0373","648","215","433","82","730","1163","0","62.77","18.49"
"64","000","00","028","2812","0000","1292","368","924","136","1428","2077","0","68.75","17.72"
"64","000","00","028","2812","0374","733","208","525","67","800","1216","0","65.79","17.11"
"64","000","00","028","2812","0375","559","160","399","69","628","861","0","72.94","18.58"
"64","000","00","029","0000","0000","16862","5238","11624","1304","18166","31025","35896","58.55","16.88"
"64","000","00","029","2901","0000","1187","354","833","134","1321","2124","0","62.19","16.67"
"64","000","00","029","2901","0376","616","159","457","68","684","1061","0","64.47","14.99"
"64","000","00","029","2901","0377","571","195","376","66","637","1063","0","59.92","18.34"
"64","000","00","029","2902","0000","1079","370","709","60","1139","2047","0","55.64","18.08"
"64","000","00","029","2902","0378","547","187","360","31","578","969","0","59.65","19.3"
"64","000","00","029","2902","0379","532","183","349","29","561","1078","0","52.04","16.98"
"64","000","00","029","2903","0000","1161","417","744","121","1282","2231","0","57.46","18.69"
"64","000","00","029","2903","0380","462","165","297","62","524","838","0","62.53","19.69"
"64","000","00","029","2903","0381","352","104","248","39","391","611","0","63.99","17.02"
"64","000","00","029","2903","0382","347","148","199","20","367","782","0","46.93","18.93"
"64","000","00","029","2904","0000","877","288","589","66","943","1451","0","64.99","19.85"
"64","000","00","029","2904","0383","877","288","589","66","943","1451","0","64.99","19.85"
"64","000","00","029","2905","0000","612","217","395","23","635","1144","0","55.51","18.97"
"64","000","00","029","2905","0384","612","217","395","23","635","1144","0","55.51","18.97"
"64","000","00","029","2906","0000","1015","399","616","69","1084","1827","0","59.33","21.84"
"64","000","00","029","2906","0389","650","264","386","31","681","1112","0","61.24","23.74"
"64","000","00","029","2906","0390","365","135","230","38","403","715","0","56.36","18.88"
"64","000","00","029","2907","0000","1179","353","826","173","1352","2072","0","65.25","17.04"
"64","000","00","029","2907","0394","607","174","433","95","702","1052","0","66.73","16.54"
"64","000","00","029","2907","0395","572","179","393","78","650","1020","0","63.73","17.55"
"64","000","00","029","2908","0000","1489","455","1034","73","1562","2855","0","54.71","15.94"
"64","000","00","029","2908","0396","649","195","454","41","690","1260","0","54.76","15.48"
"64","000","00","029","2908","0397","840","260","580","32","872","1595","0","54.67","16.3"
"64","000","00","029","2909","0000","1254","342","912","73","1327","2361","0","56.2","14.49"
"64","000","00","029","2909","0398","455","128","327","46","501","829","0","60.43","15.44"
"64","000","00","029","2909","0399","799","214","585","27","826","1532","0","53.92","13.97"
"64","000","00","029","2910","0000","504","136","368","23","527","975","0","54.05","13.95"
"64","000","00","029","2910","0385","504","136","368","23","527","975","0","54.05","13.95"
"64","000","00","029","2911","0000","1983","611","1372","165","2148","3608","0","59.53","16.93"
"64","000","00","029","2911","0386","715","209","506","45","760","1317","0","57.71","15.87"
"64","000","00","029","2911","0387","673","218","455","83","756","1218","0","62.07","17.9"
"64","000","00","029","2911","0388","595","184","411","37","632","1073","0","58.9","17.15"
"64","000","00","029","2912","0000","1187","356","831","91","1278","2250","0","56.8","15.82"
"64","000","00","029","2912","0391","664","194","470","58","722","1311","0","55.07","14.8"
"64","000","00","029","2912","0392","523","162","361","33","556","939","0","59.21","17.25"
"64","000","00","029","2913","0000","493","136","357","23","516","824","0","62.62","16.5"
"64","000","00","029","2913","0393","493","136","357","23","516","824","0","62.62","16.5"
"64","000","00","029","2914","0000","1354","372","982","124","1478","2338","0","63.22","15.91"
"64","000","00","029","2914","0400","738","206","532","45","783","1195","0","65.52","17.24"
"64","000","00","029","2914","0401","616","166","450","79","695","1143","0","60.8","14.52"
"64","000","00","029","2915","0000","1488","432","1056","86","1574","2918","0","53.94","14.8"
"64","000","00","029","2915","0402","688","193","495","48","736","1186","0","62.06","16.27"
"64","000","00","029","2915","0403","800","239","561","38","838","1732","0","48.38","13.8"
"64","000","00","030","0000","0000","16473","5654","10819","1483","17956","31996","36695","56.12","17.67"
"64","000","00","030","3001","0000","1139","356","783","90","1229","2185","0","56.25","16.29"
"64","000","00","030","3001","0060","589","196","393","49","638","1060","0","60.19","18.49"
"64","000","00","030","3001","0061","550","160","390","41","591","1125","0","52.53","14.22"
"64","000","00","030","3002","0000","1358","436","922","64","1422","2338","0","60.82","18.65"
"64","000","00","030","3002","0062","634","198","436","38","672","1100","0","61.09","18.0"
"64","000","00","030","3002","0063","724","238","486","26","750","1238","0","60.58","19.22"
"64","000","00","030","3003","0000","892","288","604","37","929","1660","0","55.96","17.35"
"64","000","00","030","3003","0064","531","163","368","22","553","933","0","59.27","17.47"
"64","000","00","030","3003","0065","361","125","236","15","376","727","0","51.72","17.19"
"64","000","00","030","3004","0000","916","310","606","81","997","1815","0","54.93","17.08"
"64","000","00","030","3004","0066","555","180","375","51","606","1071","0","56.58","16.81"
"64","000","00","030","3004","0067","361","130","231","30","391","744","0","52.55","17.47"
"64","000","00","030","3005","0000","684","205","479","49","733","1469","0","49.9","13.96"
"64","000","00","030","3005","0068","509","156","353","29","538","1100","0","48.91","14.18"
"64","000","00","030","3005","0069","175","49","126","20","195","369","0","52.85","13.28"
"64","000","00","030","3006","0000","598","175","423","21","619","1398","0","44.28","12.52"
"64","000","00","030","3006","0070","388","105","283","11","399","888","0","44.93","11.82"
"64","000","00","030","3006","0071","210","70","140","10","220","510","0","43.14","13.73"
"64","000","00","030","3007","0000","561","167","394","89","650","1042","0","62.38","16.03"
"64","000","00","030","3007","0072","561","167","394","89","650","1042","0","62.38","16.03"
"64","000","00","030","3008","0000","387","103","284","45","432","791","0","54.61","13.02"
"64","000","00","030","3008","0073","387","103","284","45","432","791","0","54.61","13.02"
"64","000","00","030","3009","0000","1073","363","710","119","1192","2157","0","55.26","16.83"
"64","000","00","030","3009","0074","498","163","335","69","567","939","0","60.38","17.36"
"64","000","00","030","3009","0075","575","200","375","50","625","1218","0","51.31","16.42"
"64","000","00","030","3010","0000","78","21","57","20","98","178","0","55.06","11.8"
"64","000","00","030","3010","0076","78","21","57","20","98","178","0","55.06","11.8"
"64","000","00","030","3011","0000","1074","352","722","87","1161","1971","0","58.9","17.86"
"64","000","00","030","3011","0077","544","167","377","47","591","946","0","62.47","17.65"
"64","000","00","030","3011","0078","530","185","345","40","570","1025","0","55.61","18.05"
"64","000","00","030","3012","0000","577","479","98","123","700","1040","0","67.31","46.06"
"64","000","00","030","3012","0079","577","479","98","123","700","1040","0","67.31","46.06"
"64","000","00","030","3013","0000","852","302","550","72","924","1563","0","59.12","19.32"
"64","000","00","030","3013","0080","526","188","338","50","576","900","0","64.0","20.89"
"64","000","00","030","3013","0081","326","114","212","22","348","663","0","52.49","17.19"
"64","000","00","030","3014","0000","1039","354","685","77","1116","2014","0","55.41","17.58"
"64","000","00","030","3014","0082","492","157","335","48","540","954","0","56.6","16.46"
"64","000","00","030","3014","0083","547","197","350","29","576","1060","0","54.34","18.58"
"64","000","00","030","3015","0000","1811","597","1214","147","1958","3323","0","58.92","17.97"
"64","000","00","030","3015","0084","613","198","415","54","667","1110","0","60.09","17.84"
"64","000","00","030","3015","0085","581","204","377","52","633","1062","0","59.6","19.21"
"64","000","00","030","3015","0086","617","195","422","41","658","1151","0","57.17","16.94"
"64","000","00","030","3016","0000","1032","273","759","74","1106","2206","0","50.14","12.38"
"64","000","00","030","3016","0087","145","42","103","21","166","266","0","62.41","15.79"
"64","000","00","030","3016","0088","370","115","255","23","393","633","0","62.09","18.17"
"64","000","00","030","3016","0089","517","116","401","30","547","1307","0","41.85","8.88"
"64","000","00","030","3017","0000","370","130","240","64","434","754","0","57.56","17.24"
"64","000","00","030","3017","0090","370","130","240","64","434","754","0","57.56","17.24"
"64","000","00","030","3018","0000","631","215","416","109","740","1296","0","57.1","16.59"
"64","000","00","030","3018","0091","631","215","416","109","740","1296","0","57.1","16.59"
"64","000","00","030","3019","0000","366","120","246","19","385","839","0","45.89","14.3"
"64","000","00","030","3019","0092","366","120","246","19","385","839","0","45.89","14.3"
"64","000","00","030","3020","0000","692","207","485","66","758","1329","0","57.04","15.58"
"64","000","00","030","3020","0093","692","207","485","66","758","1329","0","57.04","15.58"
"64","000","00","030","3021","0000","343","201","142","30","373","628","0","59.39","32.01"
"64","000","00","030","3021","0094","343","201","142","30","373","628","0","59.39","32.01"
"64","000","00","031","0000","0000","17780","4922","12858","1641","19421","35311","39630","55.0","13.94"
"64","000","00","031","3101","0000","1300","375","925","108","1408","2613","0","53.88","14.35"
"64","000","00","031","3101","0095","615","186","429","79","694","1175","0","59.06","15.83"
"64","000","00","031","3101","0096","685","189","496","29","714","1438","0","49.65","13.14"
"64","000","00","031","3102","0000","1247","327","920","104","1351","2416","0","55.92","13.53"
"64","000","00","031","3102","0097","470","116","354","42","512","989","0","51.77","11.73"
"64","000","00","031","3102","0098","777","211","566","62","839","1427","0","58.79","14.79"
"64","000","00","031","3103","0000","1387","387","1000","119","1506","2572","0","58.55","15.05"
"64","000","00","031","3103","0099","678","195","483","56","734","1309","0","56.07","14.9"
"64","000","00","031","3103","0100","709","192","517","63","772","1263","0","61.12","15.2"
"64","000","00","031","3104","0000","1104","303","801","118","1222","2061","0","59.29","14.7"
"64","000","00","031","3104","0101","557","146","411","51","608","997","0","60.98","14.64"
"64","000","00","031","3104","0102","547","157","390","67","614","1064","0","57.71","14.76"
"64","000","00","031","3105","0000","769","211","558","65","834","1498","0","55.67","14.09"
"64","000","00","031","3105","0103","769","211","558","65","834","1498","0","55.67","14.09"
"64","000","00","031","3106","0000","1118","273","845","141","1259","2150","0","58.56","12.7"
"64","000","00","031","3106","0104","581","145","436","76","657","1119","0","58.71","12.96"
"64","000","00","031","3106","0105","537","128","409","65","602","1031","0","58.39","12.42"
"64","000","00","031","3107","0000","1256","353","903","115","1371","2508","0","54.67","14.07"
"64","000","00","031","3107","0106","691","179","512","72","763","1437","0","53.1","12.46"
"64","000","00","031","3107","0107","565","174","391","43","608","1071","0","56.77","16.25"
"64","000","00","031","3108","0000","667","150","517","60","727","1462","0","49.73","10.26"
"64","000","00","031","3108","0108","351","73","278","35","386","687","0","56.19","10.63"
"64","000","00","031","3108","0109","316","77","239","25","341","775","0","44.0","9.94"
"64","000","00","031","3109","0000","624","182","442","75","699","1353","0","51.66","13.45"
"64","000","00","031","3109","0110","624","182","442","75","699","1353","0","51.66","13.45"
"64","000","00","031","3110","0000","544","172","372","48","592","1191","0","49.71","14.44"
"64","000","00","031","3110","0111","544","172","372","48","592","1191","0","49.71","14.44"
"64","000","00","031","3111","0000","1054","290","764","87","1141","2084","0","54.75","13.92"
"64","000","00","031","3111","0112","403","114","289","41","444","906","0","49.01","12.58"
"64","000","00","031","3111","0113","651","176","475","46","697","1178","0","59.17","14.94"
"64","000","00","031","3112","0000","584","168","416","31","615","1252","0","49.12","13.42"
"64","000","00","031","3112","0114","584","168","416","31","615","1252","0","49.12","13.42"
"64","000","00","031","3113","0000","826","229","597","49","875","1549","0","56.49","14.78"
"64","000","00","031","3113","0115","826","229","597","49","875","1549","0","56.49","14.78"
"64","000","00","031","3114","0000","1125","294","831","79","1204","2204","0","54.63","13.34"
"64","000","00","031","3114","0116","522","124","398","47","569","1088","0","52.3","11.4"
"64","000","00","031","3114","0117","603","170","433","32","635","1116","0","56.9","15.23"
"64","000","00","031","3115","0000","947","312","635","92","1039","1793","0","57.95","17.4"
"64","000","00","031","3115","0118","490","164","326","37","527","977","0","53.94","16.79"
"64","000","00","031","3115","0119","457","148","309","55","512","816","0","62.75","18.14"
"64","000","00","031","3116","0000","914","247","667","85","999","1898","0","52.63","13.01"
"64","000","00","031","3116","0120","422","105","317","26","448","955","0","46.91","10.99"
"64","000","00","031","3116","0121","492","142","350","59","551","943","0","58.43","15.06"
"64","000","00","031","3117","0000","686","180","506","39","725","1371","0","52.88","13.13"
"64","000","00","031","3117","0122","686","180","506","39","725","1371","0","52.88","13.13"
"64","000","00","031","3118","0000","976","277","699","100","1076","1834","0","58.67","15.1"
"64","000","00","031","3118","0123","458","136","322","54","512","919","0","55.71","14.8"
"64","000","00","031","3118","0124","518","141","377","46","564","915","0","61.64","15.41"
"64","000","00","031","3119","0000","652","192","460","126","778","1502","0","51.8","12.78"
"64","000","00","031","3119","0125","387","116","271","70","457","828","0","55.19","14.01"
"64","000","00","031","3119","0126","265","76","189","56","321","674","0","47.63","11.28"
"64","000","00","032","0000","0000","4837","1451","3386","642","5479","11501","12984","47.64","12.62"
"64","000","00","032","3201","0000","354","123","231","23","377","760","0","49.61","16.18"
"64","000","00","032","3201","0020","354","123","231","23","377","760","0","49.61","16.18"
"64","000","00","032","3202","0000","269","79","190","38","307","666","0","46.1","11.86"
"64","000","00","032","3202","0021","269","79","190","38","307","666","0","46.1","11.86"
"64","000","00","032","3203","0000","353","118","235","51","404","704","0","57.39","16.76"
"64","000","00","032","3203","0022","353","118","235","51","404","704","0","57.39","16.76"
"64","000","00","032","3204","0000","452","138","314","58","510","1003","0","50.85","13.76"
"64","000","00","032","3204","0023","452","138","314","58","510","1003","0","50.85","13.76"
"64","000","00","032","3205","0000","559","145","414","108","667","1382","0","48.26","10.49"
"64","000","00","032","3205","0024","559","145","414","108","667","1382","0","48.26","10.49"
"64","000","00","032","3206","0000","355","111","244","63","418","986","0","42.39","11.26"
"64","000","00","032","3206","0025","355","111","244","63","418","986","0","42.39","11.26"
"64","000","00","032","3207","0000","483","153","330","47","530","1046","0","50.67","14.63"
"64","000","00","032","3207","0026","483","153","330","47","530","1046","0","50.67","14.63"
"64","000","00","032","3208","0000","328","109","219","51","379","812","0","46.67","13.42"
"64","000","00","032","3208","0027","328","109","219","51","379","812","0","46.67","13.42"
"64","000","00","032","3209","0000","600","171","429","64","664","1431","0","46.4","11.95"
"64","000","00","032","3209","0028","600","171","429","64","664","1431","0","46.4","11.95"
"64","000","00","032","3210","0000","411","91","320","69","480","912","0","52.63","9.98"
"64","000","00","032","3210","0029","411","91","320","69","480","912","0","52.63","9.98"
"64","000","00","032","3211","0000","548","180","368","52","600","1472","0","40.76","12.23"
"64","000","00","032","3211","0030","548","180","368","52","600","1472","0","40.76","12.23"
"64","000","00","032","3212","0000","125","33","92","18","143","327","0","43.73","10.09"
"64","000","00","032","3212","0031","125","33","92","18","143","327","0","43.73","10.09"
"64","000","00","033","0000","0000","2408","706","1702","279","2687","5417","6051","49.6","13.03"
"64","000","00","033","3301","0000","169","37","132","7","176","472","0","37.29","7.84"
"64","000","00","033","3301","0013","169","37","132","7","176","472","0","37.29","7.84"
"64","000","00","033","3302","0000","496","136","360","58","554","882","0","62.81","15.42"
"64","000","00","033","3302","0014","496","136","360","58","554","882","0","62.81","15.42"
"64","000","00","033","3303","0000","325","98","227","31","356","668","0","53.29","14.67"
"64","000","00","033","3303","0015","325","98","227","31","356","668","0","53.29","14.67"
"64","000","00","033","3304","0000","689","211","478","106","795","1581","0","50.28","13.35"
"64","000","00","033","3304","0016","689","211","478","106","795","1581","0","50.28","13.35"
"64","000","00","033","3305","0000","226","65","161","15","241","673","0","35.81","9.66"
"64","000","00","033","3305","0017","226","65","161","15","241","673","0","35.81","9.66"
"64","000","00","033","3306","0000","252","69","183","41","293","607","0","48.27","11.37"
"64","000","00","033","3306","0018","252","69","183","41","293","607","0","48.27","11.37"
"64","000","00","033","3307","0000","251","90","161","21","272","534","0","50.94","16.85"
"64","000","00","033","3307","0019","251","90","161","21","272","534","0","50.94","16.85"
"64","000","00","034","0000","0000","4335","1437","2898","460","4795","10607","11828","45.21","13.55"
"64","000","00","034","3401","0000","255","64","191","63","318","640","0","49.69","10.0"
"64","000","00","034","3401","0032","255","64","191","63","318","640","0","49.69","10.0"
"64","000","00","034","3402","0000","288","63","225","27","315","696","0","45.26","9.05"
"64","000","00","034","3402","0033","288","63","225","27","315","696","0","45.26","9.05"
"64","000","00","034","3403","0000","437","119","318","47","484","1284","0","37.69","9.27"
"64","000","00","034","3403","0034","437","119","318","47","484","1284","0","37.69","9.27"
"64","000","00","034","3404","0000","545","167","378","64","609","1509","0","40.36","11.07"
"64","000","00","034","3404","0035","407","112","295","37","444","1027","0","43.23","10.91"
"64","000","00","034","3404","0036","138","55","83","27","165","482","0","34.23","11.41"
"64","000","00","034","3405","0000","799","237","562","112","911","1627","0","55.99","14.57"
"64","000","00","034","3405","0037","799","237","562","112","911","1627","0","55.99","14.57"
"64","000","00","034","3406","0000","694","183","511","31","725","1630","0","44.48","11.23"
"64","000","00","034","3406","0038","694","183","511","31","725","1630","0","44.48","11.23"
"64","000","00","034","3407","0000","591","389","202","76","667","1261","0","52.89","30.85"
"64","000","00","034","3407","0041","591","389","202","76","667","1261","0","52.89","30.85"
"64","000","00","034","3408","0000","726","215","511","40","766","1960","0","39.08","10.97"
"64","000","00","034","3408","0039","341","110","231","21","362","973","0","37.2","11.31"
"64","000","00","034","3408","0040","385","105","280","19","404","987","0","40.93","10.64"
"64","000","00","035","0000","0000","5660","1695","3965","645","6305","13002","14465","48.49","13.04"
"64","000","00","035","3501","0000","403","91","312","56","459","969","0","47.37","9.39"
"64","000","00","035","3501","0042","403","91","312","56","459","969","0","47.37","9.39"
"64","000","00","035","3502","0000","247","89","158","18","265","652","0","40.64","13.65"
"64","000","00","035","3502","0043","247","89","158","18","265","652","0","40.64","13.65"
"64","000","00","035","3503","0000","436","135","301","74","510","961","0","53.07","14.05"
"64","000","00","035","3503","0044","436","135","301","74","510","961","0","53.07","14.05"
"64","000","00","035","3504","0000","168","37","131","9","177","426","0","41.55","8.69"
"64","000","00","035","3504","0045","168","37","131","9","177","426","0","41.55","8.69"
"64","000","00","035","3505","0000","167","42","125","18","185","398","0","46.48","10.55"
"64","000","00","035","3505","0046","167","42","125","18","185","398","0","46.48","10.55"
"64","000","00","035","3506","0000","214","69","145","17","231","508","0","45.47","13.58"
"64","000","00","035","3506","0047","214","69","145","17","231","508","0","45.47","13.58"
"64","000","00","035","3507","0000","519","148","371","54","573","980","0","58.47","15.1"
"64","000","00","035","3507","0048","519","148","371","54","573","980","0","58.47","15.1"
"64","000","00","035","3508","0000","498","151","347","39","537","1225","0","43.84","12.33"
"64","000","00","035","3508","0049","498","151","347","39","537","1225","0","43.84","12.33"
"64","000","00","035","3509","0000","811","279","532","144","955","1722","0","55.46","16.2"
"64","000","00","035","3509","0050","811","279","532","144","955","1722","0","55.46","16.2"
"64","000","00","035","3510","0000","249","86","163","26","275","560","0","49.11","15.36"
"64","000","00","035","3510","0051","249","86","163","26","275","560","0","49.11","15.36"
"64","000","00","035","3511","0000","322","99","223","23","345","801","0","43.07","12.36"
"64","000","00","035","3511","0052","322","99","223","23","345","801","0","43.07","12.36"
"64","000","00","035","3512","0000","201","58","143","15","216","423","0","51.06","13.71"
"64","000","00","035","3512","0053","201","58","143","15","216","423","0","51.06","13.71"
"64","000","00","035","3513","0000","209","73","136","27","236","497","0","47.48","14.69"
"64","000","00","035","3513","0054","209","73","136","27","236","497","0","47.48","14.69"
"64","000","00","035","3514","0000","304","84","220","25","329","677","0","48.6","12.41"
"64","000","00","035","3514","0055","304","84","220","25","329","677","0","48.6","12.41"
"64","000","00","035","3515","0000","210","46","164","15","225","593","0","37.94","7.76"
"64","000","00","035","3515","0056","210","46","164","15","225","593","0","37.94","7.76"
"64","000","00","035","3516","0000","229","71","158","42","271","597","0","45.39","11.89"
"64","000","00","035","3516","0057","229","71","158","42","271","597","0","45.39","11.89"
"64","000","00","035","3517","0000","139","35","104","10","149","343","0","43.44","10.2"
"64","000","00","035","3517","0058","139","35","104","10","149","343","0","43.44","10.2"
"64","000","00","035","3518","0000","334","102","232","33","367","670","0","54.78","15.22"
"64","000","00","035","3518","0059","334","102","232","33","367","670","0","54.78","15.22"
"64","000","00","036","0000","0000","1058","246","812","52","1110","1615","1999","68.73","15.23"
"64","000","00","036","3601","0000","469","100","369","17","486","726","0","66.94","13.77"
"64","000","00","036","3601","0129","469","100","369","17","486","726","0","66.94","13.77"
"64","000","00","036","3602","0000","254","70","184","14","268","382","0","70.16","18.32"
"64","000","00","036","3602","0128","254","70","184","14","268","382","0","70.16","18.32"
"64","000","00","036","3603","0000","335","76","259","21","356","507","0","70.22","14.99"
"64","000","00","036","3603","0127","335","76","259","21","356","507","0","70.22","14.99"
"64","000","00","037","0000","0000","1835","385","1450","100","1935","3498","4310","55.32","11.01"
"64","000","00","037","3701","0000","361","76","285","13","374","783","0","47.77","9.71"
"64","000","00","037","3701","0005","361","76","285","13","374","783","0","47.77","9.71"
"64","000","00","037","3702","0000","232","69","163","25","257","472","0","54.45","14.62"
"64","000","00","037","3702","0008","232","69","163","25","257","472","0","54.45","14.62"
"64","000","00","037","3703","0000","388","65","323","28","416","612","0","67.97","10.62"
"64","000","00","037","3703","0007","388","65","323","28","416","612","0","67.97","10.62"
"64","000","00","037","3704","0000","282","64","218","7","289","632","0","45.73","10.13"
"64","000","00","037","3704","0006","282","64","218","7","289","632","0","45.73","10.13"
"64","000","00","037","3705","0000","113","19","94","5","118","223","0","52.91","8.52"
"64","000","00","037","3705","0004","113","19","94","5","118","223","0","52.91","8.52"
"64","000","00","037","3706","0000","186","25","161","7","193","279","0","69.18","8.96"
"64","000","00","037","3706","0003","186","25","161","7","193","279","0","69.18","8.96"
"64","000","00","037","3707","0000","159","26","133","13","172","233","0","73.82","11.16"
"64","000","00","037","3707","0002","159","26","133","13","172","233","0","73.82","11.16"
"64","000","00","037","3708","0000","114","41","73","2","116","264","0","43.94","15.53"
"64","000","00","037","3708","0001","114","41","73","2","116","264","0","43.94","15.53"
"64","000","00","038","0000","0000","1467","283","1184","122","1589","2424","3143","65.55","11.67"
"64","000","00","038","3801","0000","735","186","549","85","820","1326","0","61.84","14.03"
"64","000","00","038","3801","0009","367","94","273","31","398","741","0","53.71","12.69"
"64","000","00","038","3801","0010","368","92","276","54","422","585","0","72.14","15.73"
"64","000","00","038","3802","0000","442","65","377","30","472","609","0","77.5","10.67"
"64","000","00","038","3802","0011","442","65","377","30","472","609","0","77.5","10.67"
"64","000","00","038","3803","0000","290","32","258","7","297","489","0","60.74","6.54"
"64","000","00","038","3803","0012","290","32","258","7","297","489","0","60.74","6.54"
"10","004","00","000","0000","0000","240493","77180","163313","11783","252276","445051","556307","56.68","17.34"
"10","004","00","001","0000","0000","77051","27936","49115","2874","79925","137129","186411","58.28","20.37"
"10","004","00","001","0101","0000","3481","1372","2109","79","3560","5988","0","59.45","22.91"
"10","004","00","001","0101","0041","743","266","477","14","757","1301","0","58.19","20.45"
"10","004","00","001","0101","0042","1028","417","611","18","1046","1798","0","58.18","23.19"
"10","004","00","001","0101","0043","829","403","426","22","851","1427","0","59.64","28.24"
"10","004","00","001","0101","0044","881","286","595","25","906","1462","0","61.97","19.56"
"10","004","00","001","0102","0000","5603","2016","3587","116","5719","9417","0","60.73","21.41"
"10","004","00","001","0102","0001","829","286","543","23","852","1319","0","64.59","21.68"
"10","004","00","001","0102","0002","792","278","514","13","805","1321","0","60.94","21.04"
"10","004","00","001","0102","0003","776","262","514","25","801","1272","0","62.97","20.6"
"10","004","00","001","0102","0004","835","293","542","16","851","1467","0","58.01","19.97"
"10","004","00","001","0102","0005","694","268","426","19","713","1226","0","58.16","21.86"
"10","004","00","001","0102","0006","797","281","516","10","807","1412","0","57.15","19.9"
"10","004","00","001","0102","0007","880","348","532","10","890","1400","0","63.57","24.86"
"10","004","00","001","0103","0000","5776","2672","3104","145","5921","10185","0","58.13","26.23"
"10","004","00","001","0103","0008","854","356","498","25","879","1415","0","62.12","25.16"
"10","004","00","001","0103","0009","789","314","475","14","803","1361","0","59.0","23.07"
"10","004","00","001","0103","0010","822","381","441","13","835","1515","0","55.12","25.15"
"10","004","00","001","0103","0011","856","519","337","38","894","1495","0","59.8","34.72"
"10","004","00","001","0103","0012","812","325","487","30","842","1417","0","59.42","22.94"
"10","004","00","001","0103","0013","877","407","470","12","889","1548","0","57.43","26.29"
"10","004","00","001","0103","0014","766","370","396","13","779","1434","0","54.32","25.8"
"10","004","00","001","0104","0000","3829","1443","2386","110","3939","6515","0","60.46","22.15"
"10","004","00","001","0104","0015","789","289","500","27","816","1385","0","58.92","20.87"
"10","004","00","001","0104","0016","770","275","495","26","796","1247","0","63.83","22.05"
"10","004","00","001","0104","0017","773","303","470","22","795","1373","0","57.9","22.07"
"10","004","00","001","0104","0018","850","364","486","9","859","1345","0","63.87","27.06"
"10","004","00","001","0104","0019","647","212","435","26","673","1165","0","57.77","18.2"
"10","004","00","001","0105","0000","1459","587","872","51","1510","2376","0","63.55","24.71"
"10","004","00","001","0105","0020","728","302","426","26","754","1164","0","64.78","25.95"
"10","004","00","001","0105","0021","731","285","446","25","756","1212","0","62.38","23.51"
"10","004","00","001","0106","0000","1548","411","1137","51","1599","3083","0","51.87","13.33"
"10","004","00","001","0106","0022","743","195","548","19","762","1507","0","50.56","12.94"
"10","004","00","001","0106","0023","805","216","589","32","837","1576","0","53.11","13.71"
"10","004","00","001","0107","0000","3330","1122","2208","141","3471","6111","0","56.8","18.36"
"10","004","00","001","0107","0056","761","236","525","27","788","1477","0","53.35","15.98"
"10","004","00","001","0107","0057","940","340","600","33","973","1611","0","60.4","21.1"
"10","004","00","001","0107","0058","862","289","573","46","908","1555","0","58.39","18.59"
"10","004","00","001","0107","0059","767","257","510","35","802","1468","0","54.63","17.51"
"10","004","00","001","0108","0000","4957","1610","3347","220","5177","8856","0","58.46","18.18"
"10","004","00","001","0108","0060","871","279","592","29","900","1509","0","59.64","18.49"
"10","004","00","001","0108","0061","861","268","593","29","890","1602","0","55.56","16.73"
"10","004","00","001","0108","0062","783","256","527","35","818","1448","0","56.49","17.68"
"10","004","00","001","0108","0063","767","253","514","31","798","1318","0","60.55","19.2"
"10","004","00","001","0108","0064","966","341","625","36","1002","1634","0","61.32","20.87"
"10","004","00","001","0108","0065","709","213","496","60","769","1345","0","57.17","15.84"
"10","004","00","001","0109","0000","2878","955","1923","120","2998","5746","0","52.18","16.62"
"10","004","00","001","0109","0069","826","271","555","35","861","1483","0","58.06","18.27"
"10","004","00","001","0109","0070","711","237","474","39","750","1332","0","56.31","17.79"
"10","004","00","001","0109","0071","739","237","502","28","767","1482","0","51.75","15.99"
"10","004","00","001","0109","0072","602","210","392","18","620","1449","0","42.79","14.49"
"10","004","00","001","0110","0000","2960","1010","1950","120","3080","5703","0","54.01","17.71"
"10","004","00","001","0110","0073","703","219","484","17","720","1319","0","54.59","16.6"
"10","004","00","001","0110","0074","696","212","484","33","729","1332","0","54.73","15.92"
"10","004","00","001","0110","0075","718","266","452","31","749","1412","0","53.05","18.84"
"10","004","00","001","0110","0076","843","313","530","39","882","1640","0","53.78","19.09"
"10","004","00","001","0111","0000","3721","1237","2484","177","3898","6849","0","56.91","18.06"
"10","004","00","001","0111","0077","728","237","491","30","758","1323","0","57.29","17.91"
"10","004","00","001","0111","0078","803","283","520","48","851","1428","0","59.59","19.82"
"10","004","00","001","0111","0079","856","280","576","41","897","1533","0","58.51","18.26"
"10","004","00","001","0111","0080","701","257","444","22","723","1346","0","53.71","19.09"
"10","004","00","001","0111","0081","633","180","453","36","669","1219","0","54.88","14.77"
"10","004","00","001","0112","0000","2443","782","1661","106","2549","4458","0","57.18","17.54"
"10","004","00","001","0112","0086","790","245","545","41","831","1383","0","60.09","17.72"
"10","004","00","001","0112","0087","868","287","581","42","910","1569","0","58.0","18.29"
"10","004","00","001","0112","0088","785","250","535","23","808","1506","0","53.65","16.6"
"10","004","00","001","0113","0000","1074","344","730","60","1134","1951","0","58.12","17.63"
"10","004","00","001","0113","0089","486","135","351","21","507","877","0","57.81","15.39"
"10","004","00","001","0113","0090","588","209","379","39","627","1074","0","58.38","19.46"
"10","004","00","001","0114","0000","1426","475","951","72","1498","2425","0","61.77","19.59"
"10","004","00","001","0114","0091","682","227","455","23","705","1089","0","64.74","20.84"
"10","004","00","001","0114","0092","744","248","496","49","793","1336","0","59.36","18.56"
"10","004","00","001","0115","0000","1231","510","721","86","1317","2143","0","61.46","23.8"
"10","004","00","001","0115","0094","586","301","285","42","628","937","0","67.02","32.12"
"10","004","00","001","0115","0095","645","209","436","44","689","1206","0","57.13","17.33"
"10","004","00","001","0116","0000","654","213","441","47","701","1205","0","58.17","17.68"
"10","004","00","001","0116","0096","654","213","441","47","701","1205","0","58.17","17.68"
"10","004","00","001","0117","0000","873","292","581","57","930","1585","0","58.68","18.42"
"10","004","00","001","0117","0098","489","148","341","37","526","917","0","57.36","16.14"
"10","004","00","001","0117","0099","384","144","240","20","404","668","0","60.48","21.56"
"10","004","00","001","0118","0000","990","472","518","87","1077","1914","0","56.27","24.66"
"10","004","00","001","0118","0102","533","155","378","67","600","977","0","61.41","15.86"
"10","004","00","001","0118","0103","457","317","140","20","477","937","0","50.91","33.83"
"10","004","00","001","0119","0000","964","336","628","65","1029","1718","0","59.9","19.56"
"10","004","00","001","0119","0097","964","336","628","65","1029","1718","0","59.9","19.56"
"10","004","00","001","0120","0000","827","289","538","99","926","1606","0","57.66","18.0"
"10","004","00","001","0120","0100","422","143","279","39","461","824","0","55.95","17.35"
"10","004","00","001","0120","0101","405","146","259","60","465","782","0","59.46","18.67"
"10","004","00","001","0121","0000","3607","1270","2337","86","3693","6176","0","59.8","20.56"
"10","004","00","001","0121","0030","725","254","471","17","742","1196","0","62.04","21.24"
"10","004","00","001","0121","0031","723","241","482","20","743","1235","0","60.16","19.51"
"10","004","00","001","0121","0032","674","247","427","14","688","1204","0","57.14","20.51"
"10","004","00","001","0121","0033","781","261","520","21","802","1308","0","61.31","19.95"
"10","004","00","001","0121","0034","704","267","437","14","718","1233","0","58.23","21.65"
"10","004","00","001","0122","0000","3028","1046","1982","155","3183","5664","0","56.2","18.47"
"10","004","00","001","0122","0082","845","275","570","51","896","1466","0","61.12","18.76"
"10","004","00","001","0122","0083","598","244","354","34","632","1147","0","55.1","21.27"
"10","004","00","001","0122","0084","741","259","482","35","776","1529","0","50.75","16.94"
"10","004","00","001","0122","0085","844","268","576","35","879","1522","0","57.75","17.61"
"10","004","00","001","0123","0000","571","188","383","32","603","1058","0","56.99","17.77"
"10","004","00","001","0123","0093","571","188","383","32","603","1058","0","56.99","17.77"
"10","004","00","001","0124","0000","2312","791","1521","71","2383","3738","0","63.75","21.16"
"10","004","00","001","0124","0049","705","267","438","18","723","1181","0","61.22","22.61"
"10","004","00","001","0124","0050","836","292","544","28","864","1329","0","65.01","21.97"
"10","004","00","001","0124","0051","771","232","539","25","796","1228","0","64.82","18.89"
"10","004","00","001","0125","0000","3292","1271","2021","104","3396","5989","0","56.7","21.22"
"10","004","00","001","0125","0052","844","324","520","32","876","1552","0","56.44","20.88"
"10","004","00","001","0125","0053","869","291","578","24","893","1480","0","60.34","19.66"
"10","004","00","001","0125","0054","803","283","520","15","818","1487","0","55.01","19.03"
"10","004","00","001","0125","0055","776","373","403","33","809","1470","0","55.03","25.37"
"10","004","00","001","0126","0000","1898","527","1371","86","1984","3204","0","61.92","16.45"
"10","004","00","001","0126","0066","586","100","486","22","608","958","0","63.47","10.44"
"10","004","00","001","0126","0067","679","233","446","26","705","1112","0","63.4","20.95"
"10","004","00","001","0126","0068","633","194","439","38","671","1134","0","59.17","17.11"
"10","004","00","001","0127","0000","3112","1287","1825","112","3224","5749","0","56.08","22.39"
"10","004","00","001","0127","0024","807","303","504","25","832","1464","0","56.83","20.7"
"10","004","00","001","0127","0025","794","325","469","24","818","1428","0","57.28","22.76"
"10","004","00","001","0127","0026","715","372","343","16","731","1442","0","50.69","25.8"
"10","004","00","001","0127","0027","796","287","509","47","843","1415","0","59.58","20.28"
"10","004","00","001","0128","0000","1765","747","1018","36","1801","3417","0","52.71","21.86"
"10","004","00","001","0128","0028","841","349","492","17","858","1666","0","51.5","20.95"
"10","004","00","001","0128","0029","924","398","526","19","943","1751","0","53.85","22.73"
"10","004","00","001","0129","0000","1991","683","1308","53","2044","3312","0","61.71","20.62"
"10","004","00","001","0129","0035","660","216","444","13","673","1129","0","59.61","19.13"
"10","004","00","001","0129","0036","650","232","418","11","661","1069","0","61.83","21.7"
"10","004","00","001","0129","0037","681","235","446","29","710","1114","0","63.73","21.1"
"10","004","00","001","0130","0000","2030","767","1263","61","2091","3265","0","64.04","23.49"
"10","004","00","001","0130","0038","666","243","423","27","693","1103","0","62.83","22.03"
"10","004","00","001","0130","0039","653","252","401","16","669","1029","0","65.01","24.49"
"10","004","00","001","0130","0040","711","272","439","18","729","1133","0","64.34","24.01"
"10","004","00","001","0131","0000","3421","1211","2210","69","3490","5723","0","60.98","21.16"
"10","004","00","001","0131","0045","837","294","543","16","853","1342","0","63.56","21.91"
"10","004","00","001","0131","0046","886","308","578","15","901","1480","0","60.88","20.81"
"10","004","00","001","0131","0047","912","333","579","18","930","1645","0","56.53","20.24"
"10","004","00","001","0131","0048","786","276","510","20","806","1256","0","64.17","21.97"
"10","004","00","002","0000","0000","40656","12563","28093","1955","42611","78794","96358","54.08","15.94"
"10","004","00","002","0201","0000","143","29","114","13","156","309","0","50.49","9.39"
"10","004","00","002","0201","0104","143","29","114","13","156","309","0","50.49","9.39"
"10","004","00","002","0202","0000","188","61","127","26","214","416","0","51.44","14.66"
"10","004","00","002","0202","0105","188","61","127","26","214","416","0","51.44","14.66"
"10","004","00","002","0203","0000","191","53","138","7","198","386","0","51.3","13.73"
"10","004","00","002","0203","0106","191","53","138","7","198","386","0","51.3","13.73"
"10","004","00","002","0204","0000","1112","319","793","43","1155","2225","0","51.91","14.34"
"10","004","00","002","0204","0107","454","128","326","25","479","950","0","50.42","13.47"
"10","004","00","002","0204","0108","658","191","467","18","676","1275","0","53.02","14.98"
"10","004","00","002","0205","0000","1713","498","1215","101","1814","3283","0","55.25","15.17"
"10","004","00","002","0205","0116","681","214","467","39","720","1292","0","55.73","16.56"
"10","004","00","002","0205","0117","547","140","407","21","568","1111","0","51.13","12.6"
"10","004","00","002","0205","0118","485","144","341","41","526","880","0","59.77","16.36"
"10","004","00","002","0206","0000","4643","1327","3316","231","4874","9177","0","53.11","14.46"
"10","004","00","002","0206","0109","626","163","463","31","657","1213","0","54.16","13.44"
"10","004","00","002","0206","0110","839","257","582","32","871","1548","0","56.27","16.6"
"10","004","00","002","0206","0111","598","181","417","26","624","1246","0","50.08","14.53"
"10","004","00","002","0206","0112","548","163","385","27","575","1252","0","45.93","13.02"
"10","004","00","002","0206","0113","681","168","513","39","720","1359","0","52.98","12.36"
"10","004","00","002","0206","0114","642","186","456","35","677","1255","0","53.94","14.82"
"10","004","00","002","0206","0115","709","209","500","41","750","1304","0","57.52","16.03"
"10","004","00","002","0207","0000","2436","711","1725","121","2557","4569","0","55.96","15.56"
"10","004","00","002","0207","0121","573","164","409","38","611","1126","0","54.26","14.56"
"10","004","00","002","0207","0122","551","158","393","40","591","1073","0","55.08","14.73"
"10","004","00","002","0207","0123","664","199","465","30","694","1215","0","57.12","16.38"
"10","004","00","002","0207","0124","648","190","458","13","661","1155","0","57.23","16.45"
"10","004","00","002","0208","0000","367","118","249","22","389","704","0","55.26","16.76"
"10","004","00","002","0208","0128","367","118","249","22","389","704","0","55.26","16.76"
"10","004","00","002","0209","0000","1389","425","964","46","1435","3048","0","47.08","13.94"
"10","004","00","002","0209","0129","363","99","264","19","382","951","0","40.17","10.41"
"10","004","00","002","0209","0130","544","188","356","19","563","984","0","57.22","19.11"
"10","004","00","002","0209","0131","482","138","344","8","490","1113","0","44.03","12.4"
"10","004","00","002","0210","0000","766","217","549","59","825","1357","0","60.8","15.99"
"10","004","00","002","0210","0132","336","90","246","21","357","595","0","60.0","15.13"
"10","004","00","002","0210","0133","430","127","303","38","468","762","0","61.42","16.67"
"10","004","00","002","0211","0000","787","235","552","53","840","1400","0","60.0","16.79"
"10","004","00","002","0211","0142","401","117","284","38","439","715","0","61.4","16.36"
"10","004","00","002","0211","0143","386","118","268","15","401","685","0","58.54","17.23"
"10","004","00","002","0212","0000","1899","561","1338","88","1987","3875","0","51.28","14.48"
"10","004","00","002","0212","0136","615","166","449","29","644","1310","0","49.16","12.67"
"10","004","00","002","0212","0137","667","191","476","38","705","1434","0","49.16","13.32"
"10","004","00","002","0212","0138","617","204","413","21","638","1131","0","56.41","18.04"
"10","004","00","002","0213","0000","1729","533","1196","70","1799","3317","0","54.24","16.07"
"10","004","00","002","0213","0139","515","163","352","16","531","967","0","54.91","16.86"
"10","004","00","002","0213","0140","587","176","411","25","612","1196","0","51.17","14.72"
"10","004","00","002","0213","0141","627","194","433","29","656","1154","0","56.85","16.81"
"10","004","00","002","0214","0000","3703","1182","2521","139","3842","7555","0","50.85","15.65"
"10","004","00","002","0214","0149","622","213","409","17","639","1248","0","51.2","17.07"
"10","004","00","002","0214","0150","564","203","361","15","579","1263","0","45.84","16.07"
"10","004","00","002","0214","0151","585","162","423","31","616","1232","0","50.0","13.15"
"10","004","00","002","0214","0152","521","158","363","23","544","1143","0","47.59","13.82"
"10","004","00","002","0214","0153","817","262","555","19","836","1529","0","54.68","17.14"
"10","004","00","002","0214","0154","594","184","410","34","628","1140","0","55.09","16.14"
"10","004","00","002","0215","0000","3168","1068","2100","176","3344","6204","0","53.9","17.21"
"10","004","00","002","0215","0156","639","218","421","21","660","1345","0","49.07","16.21"
"10","004","00","002","0215","0157","686","258","428","49","735","1381","0","53.22","18.68"
"10","004","00","002","0215","0158","720","256","464","43","763","1379","0","55.33","18.56"
"10","004","00","002","0215","0159","566","160","406","37","603","1033","0","58.37","15.49"
"10","004","00","002","0215","0160","557","176","381","26","583","1066","0","54.69","16.51"
"10","004","00","002","0216","0000","2360","766","1594","96","2456","4350","0","56.46","17.61"
"10","004","00","002","0216","0169","594","195","399","30","624","1083","0","57.62","18.01"
"10","004","00","002","0216","0170","578","207","371","30","608","1102","0","55.17","18.78"
"10","004","00","002","0216","0171","579","179","400","21","600","1068","0","56.18","16.76"
"10","004","00","002","0216","0172","609","185","424","15","624","1097","0","56.88","16.86"
"10","004","00","002","0217","0000","992","301","691","43","1035","1871","0","55.32","16.09"
"10","004","00","002","0217","0173","494","142","352","18","512","962","0","53.22","14.76"
"10","004","00","002","0217","0174","498","159","339","25","523","909","0","57.54","17.49"
"10","004","00","002","0218","0000","285","82","203","18","303","603","0","50.25","13.6"
"10","004","00","002","0218","0175","285","82","203","18","303","603","0","50.25","13.6"
"10","004","00","002","0219","0000","5343","1830","3513","226","5569","10396","0","53.57","17.6"
"10","004","00","002","0219","0161","515","142","373","40","555","938","0","59.17","15.14"
"10","004","00","002","0219","0162","545","167","378","42","587","952","0","61.66","17.54"
"10","004","00","002","0219","0163","846","292","554","36","882","1468","0","60.08","19.89"
"10","004","00","002","0219","0164","960","445","515","21","981","1915","0","51.23","23.24"
"10","004","00","002","0219","0165","605","191","414","34","639","1220","0","52.38","15.66"
"10","004","00","002","0219","0166","516","160","356","16","532","1166","0","45.63","13.72"
"10","004","00","002","0219","0167","717","229","488","16","733","1492","0","49.13","15.35"
"10","004","00","002","0219","0168","639","204","435","21","660","1245","0","53.01","16.39"
"10","004","00","002","0220","0000","958","294","664","55","1013","1727","0","58.66","17.02"
"10","004","00","002","0220","0125","453","144","309","34","487","852","0","57.16","16.9"
"10","004","00","002","0220","0126","505","150","355","21","526","875","0","60.11","17.14"
"10","004","00","002","0221","0000","1071","316","755","49","1120","1914","0","58.52","16.51"
"10","004","00","002","0221","0119","377","120","257","17","394","670","0","58.81","17.91"
"10","004","00","002","0221","0120","694","196","498","32","726","1244","0","58.36","15.76"
"10","004","00","002","0222","0000","625","188","437","27","652","1070","0","60.93","17.57"
"10","004","00","002","0222","0127","625","188","437","27","652","1070","0","60.93","17.57"
"10","004","00","002","0223","0000","3644","1074","2570","175","3819","6892","0","55.41","15.58"
"10","004","00","002","0223","0144","680","210","470","39","719","1352","0","53.18","15.53"
"10","004","00","002","0223","0145","764","218","546","42","806","1407","0","57.29","15.49"
"10","004","00","002","0223","0146","721","220","501","26","747","1362","0","54.85","16.15"
"10","004","00","002","0223","0147","742","212","530","23","765","1330","0","57.52","15.94"
"10","004","00","002","0223","0148","737","214","523","45","782","1441","0","54.27","14.85"
"10","004","00","002","0224","0000","811","276","535","38","849","1576","0","53.87","17.51"
"10","004","00","002","0224","0134","410","142","268","20","430","763","0","56.36","18.61"
"10","004","00","002","0224","0135","401","134","267","18","419","813","0","51.54","16.48"
"10","004","00","002","0225","0000","333","99","234","33","366","570","0","64.21","17.37"
"10","004","00","002","0225","0155","333","99","234","33","366","570","0","64.21","17.37"
"10","004","00","003","0000","0000","15428","4611","10817","889","16317","28894","33106","56.47","15.96"
"10","004","00","003","0301","0000","625","182","443","34","659","1139","0","57.86","15.98"
"10","004","00","003","0301","0194","625","182","443","34","659","1139","0","57.86","15.98"
"10","004","00","003","0302","0000","483","116","367","11","494","861","0","57.38","13.47"
"10","004","00","003","0302","0195","483","116","367","11","494","861","0","57.38","13.47"
"10","004","00","003","0303","0000","2101","642","1459","108","2209","4271","0","51.72","15.03"
"10","004","00","003","0303","0196","541","162","379","23","564","1093","0","51.6","14.82"
"10","004","00","003","0303","0197","480","144","336","31","511","978","0","52.25","14.72"
"10","004","00","003","0303","0198","490","151","339","23","513","1040","0","49.33","14.52"
"10","004","00","003","0303","0199","590","185","405","31","621","1160","0","53.53","15.95"
"10","004","00","003","0304","0000","1062","266","796","71","1133","1965","0","57.66","13.54"
"10","004","00","003","0304","0184","509","108","401","29","538","948","0","56.75","11.39"
"10","004","00","003","0304","0185","553","158","395","42","595","1017","0","58.51","15.54"
"10","004","00","003","0305","0000","1817","579","1238","79","1896","3320","0","57.11","17.44"
"10","004","00","003","0305","0186","690","215","475","28","718","1176","0","61.05","18.28"
"10","004","00","003","0305","0187","659","212","447","40","699","1122","0","62.3","18.89"
"10","004","00","003","0305","0188","468","152","316","11","479","1022","0","46.87","14.87"
"10","004","00","003","0306","0000","945","283","662","51","996","1829","0","54.46","15.47"
"10","004","00","003","0306","0182","511","148","363","26","537","924","0","58.12","16.02"
"10","004","00","003","0306","0183","434","135","299","25","459","905","0","50.72","14.92"
"10","004","00","003","0307","0000","1435","391","1044","75","1510","2526","0","59.78","15.48"
"10","004","00","003","0307","0179","495","127","368","29","524","935","0","56.04","13.58"
"10","004","00","003","0307","0180","415","113","302","20","435","753","0","57.77","15.01"
"10","004","00","003","0307","0181","525","151","374","26","551","838","0","65.75","18.02"
"10","004","00","003","0308","0000","557","155","402","30","587","983","0","59.72","15.77"
"10","004","00","003","0308","0176","557","155","402","30","587","983","0","59.72","15.77"
"10","004","00","003","0309","0000","348","134","214","20","368","597","0","61.64","22.45"
"10","004","00","003","0309","0177","348","134","214","20","368","597","0","61.64","22.45"
"10","004","00","003","0310","0000","587","177","410","19","606","1070","0","56.64","16.54"
"10","004","00","003","0310","0178","587","177","410","19","606","1070","0","56.64","16.54"
"10","004","00","003","0311","0000","1022","315","707","55","1077","1832","0","58.79","17.19"
"10","004","00","003","0311","0200","547","188","359","29","576","950","0","60.63","19.79"
"10","004","00","003","0311","0201","475","127","348","26","501","882","0","56.8","14.4"
"10","004","00","003","0312","0000","1304","430","874","87","1391","2493","0","55.8","17.25"
"10","004","00","003","0312","0202","694","232","462","47","741","1281","0","57.85","18.11"
"10","004","00","003","0312","0203","610","198","412","40","650","1212","0","53.63","16.34"
"10","004","00","003","0313","0000","448","114","334","37","485","1013","0","47.88","11.25"
"10","004","00","003","0313","0204","448","114","334","37","485","1013","0","47.88","11.25"
"10","004","00","003","0314","0000","371","120","251","31","402","630","0","63.81","19.05"
"10","004","00","003","0314","0205","371","120","251","31","402","630","0","63.81","19.05"
"10","004","00","003","0315","0000","626","204","422","53","679","1144","0","59.35","17.83"
"10","004","00","003","0315","0193","626","204","422","53","679","1144","0","59.35","17.83"
"10","004","00","003","0316","0000","680","203","477","37","717","1429","0","50.17","14.21"
"10","004","00","003","0316","0189","680","203","477","37","717","1429","0","50.17","14.21"
"10","004","00","003","0317","0000","270","73","197","34","304","451","0","67.41","16.19"
"10","004","00","003","0317","0190","270","73","197","34","304","451","0","67.41","16.19"
"10","004","00","003","0318","0000","386","130","256","24","410","724","0","56.63","17.96"
"10","004","00","003","0318","0191","386","130","256","24","410","724","0","56.63","17.96"
"10","004","00","003","0319","0000","361","97","264","33","394","617","0","63.86","15.72"
"10","004","00","003","0319","0192","361","97","264","33","394","617","0","63.86","15.72"
"10","004","00","004","0000","0000","13209","3759","9450","834","14043","24712","28659","56.83","15.21"
"10","004","00","004","0401","0000","290","70","220","19","309","480","0","64.38","14.58"
"10","004","00","004","0401","0206","290","70","220","19","309","480","0","64.38","14.58"
"10","004","00","004","0402","0000","1073","334","739","61","1134","1923","0","58.97","17.37"
"10","004","00","004","0402","0207","517","167","350","23","540","903","0","59.8","18.49"
"10","004","00","004","0402","0208","556","167","389","38","594","1020","0","58.24","16.37"
"10","004","00","004","0403","0000","391","118","273","15","406","705","0","57.59","16.74"
"10","004","00","004","0403","0209","391","118","273","15","406","705","0","57.59","16.74"
"10","004","00","004","0404","0000","1933","533","1400","105","2038","3618","0","56.33","14.73"
"10","004","00","004","0404","0210","550","151","399","30","580","1056","0","54.92","14.3"
"10","004","00","004","0404","0211","666","177","489","36","702","1275","0","55.06","13.88"
"10","004","00","004","0404","0212","717","205","512","39","756","1287","0","58.74","15.93"
"10","004","00","004","0405","0000","537","176","361","36","573","1046","0","54.78","16.83"
"10","004","00","004","0405","0214","537","176","361","36","573","1046","0","54.78","16.83"
"10","004","00","004","0406","0000","431","130","301","35","466","771","0","60.44","16.86"
"10","004","00","004","0406","0213","431","130","301","35","466","771","0","60.44","16.86"
"10","004","00","004","0407","0000","559","142","417","44","603","1030","0","58.54","13.79"
"10","004","00","004","0407","0215","559","142","417","44","603","1030","0","58.54","13.79"
"10","004","00","004","0408","0000","1814","556","1258","120","1934","3653","0","52.94","15.22"
"10","004","00","004","0408","0216","659","208","451","31","690","1208","0","57.12","17.22"
"10","004","00","004","0408","0217","518","151","367","15","533","1095","0","48.68","13.79"
"10","004","00","004","0408","0218","637","197","440","74","711","1350","0","52.67","14.59"
"10","004","00","004","0409","0000","701","201","500","47","748","1362","0","54.92","14.76"
"10","004","00","004","0409","0220","701","201","500","47","748","1362","0","54.92","14.76"
"10","004","00","004","0410","0000","246","72","174","23","269","551","0","48.82","13.07"
"10","004","00","004","0410","0222","246","72","174","23","269","551","0","48.82","13.07"
"10","004","00","004","0411","0000","290","80","210","29","319","572","0","55.77","13.99"
"10","004","00","004","0411","0224","290","80","210","29","319","572","0","55.77","13.99"
"10","004","00","004","0412","0000","481","99","382","25","506","943","0","53.66","10.5"
"10","004","00","004","0412","0225","481","99","382","25","506","943","0","53.66","10.5"
"10","004","00","004","0413","0000","176","54","122","15","191","461","0","41.43","11.71"
"10","004","00","004","0413","0223","176","54","122","15","191","461","0","41.43","11.71"
"10","004","00","004","0414","0000","429","135","294","42","471","808","0","58.29","16.71"
"10","004","00","004","0414","0226","429","135","294","42","471","808","0","58.29","16.71"
"10","004","00","004","0415","0000","1065","297","768","53","1118","1826","0","61.23","16.27"
"10","004","00","004","0415","0227","551","153","398","31","582","923","0","63.06","16.58"
"10","004","00","004","0415","0228","514","144","370","22","536","903","0","59.36","15.95"
"10","004","00","004","0416","0000","482","129","353","30","512","824","0","62.14","15.66"
"10","004","00","004","0416","0230","482","129","353","30","512","824","0","62.14","15.66"
"10","004","00","004","0417","0000","346","92","254","14","360","559","0","64.4","16.46"
"10","004","00","004","0417","0231","346","92","254","14","360","559","0","64.4","16.46"
"10","004","00","004","0418","0000","506","155","351","28","534","854","0","62.53","18.15"
"10","004","00","004","0418","0232","506","155","351","28","534","854","0","62.53","18.15"
"10","004","00","004","0419","0000","511","152","359","25","536","846","0","63.36","17.97"
"10","004","00","004","0419","0219","511","152","359","25","536","846","0","63.36","17.97"
"10","004","00","004","0420","0000","423","105","318","27","450","903","0","49.83","11.63"
"10","004","00","004","0420","0221","423","105","318","27","450","903","0","49.83","11.63"
"10","004","00","004","0421","0000","525","129","396","41","566","977","0","57.93","13.2"
"10","004","00","004","0421","0229","525","129","396","41","566","977","0","57.93","13.2"
"10","004","00","005","0000","0000","34162","10422","23740","1657","35819","63511","77604","56.4","16.41"
"10","004","00","005","0501","0000","733","240","493","37","770","1272","0","60.53","18.87"
"10","004","00","005","0501","0245","733","240","493","37","770","1272","0","60.53","18.87"
"10","004","00","005","0502","0000","484","143","341","32","516","851","0","60.63","16.8"
"10","004","00","005","0502","0244","484","143","341","32","516","851","0","60.63","16.8"
"10","004","00","005","0503","0000","2267","690","1577","115","2382","3993","0","59.65","17.28"
"10","004","00","005","0503","0241","778","264","514","44","822","1444","0","56.93","18.28"
"10","004","00","005","0503","0242","799","224","575","45","844","1347","0","62.66","16.63"
"10","004","00","005","0503","0243","690","202","488","26","716","1202","0","59.57","16.81"
"10","004","00","005","0504","0000","2914","880","2034","137","3051","5202","0","58.65","16.92"
"10","004","00","005","0504","0250","733","234","499","32","765","1402","0","54.56","16.69"
"10","004","00","005","0504","0251","665","191","474","39","704","1183","0","59.51","16.15"
"10","004","00","005","0504","0252","747","223","524","31","778","1282","0","60.69","17.39"
"10","004","00","005","0504","0253","769","232","537","35","804","1335","0","60.22","17.38"
"10","004","00","005","0505","0000","1613","445","1168","92","1705","2835","0","60.14","15.7"
"10","004","00","005","0505","0246","698","180","518","39","737","1275","0","57.8","14.12"
"10","004","00","005","0505","0247","915","265","650","53","968","1560","0","62.05","16.99"
"10","004","00","005","0506","0000","2530","741","1789","131","2661","4714","0","56.45","15.72"
"10","004","00","005","0506","0238","948","310","638","50","998","1719","0","58.06","18.03"
"10","004","00","005","0506","0239","688","191","497","35","723","1162","0","62.22","16.44"
"10","004","00","005","0506","0240","894","240","654","46","940","1833","0","51.28","13.09"
"10","004","00","005","0507","0000","1525","462","1063","74","1599","2898","0","55.18","15.94"
"10","004","00","005","0507","0233","692","213","479","33","725","1393","0","52.05","15.29"
"10","004","00","005","0507","0234","833","249","584","41","874","1505","0","58.07","16.54"
"10","004","00","005","0508","0000","1578","446","1132","77","1655","3140","0","52.71","14.2"
"10","004","00","005","0508","0258","574","179","395","39","613","1193","0","51.38","15.0"
"10","004","00","005","0508","0259","1004","267","737","38","1042","1947","0","53.52","13.71"
"10","004","00","005","0509","0000","623","194","429","59","682","1125","0","60.62","17.24"
"10","004","00","005","0509","0260","623","194","429","59","682","1125","0","60.62","17.24"
"10","004","00","005","0510","0000","1536","454","1082","77","1613","2783","0","57.96","16.31"
"10","004","00","005","0510","0261","573","157","416","38","611","1050","0","58.19","14.95"
"10","004","00","005","0510","0262","963","297","666","39","1002","1733","0","57.82","17.14"
"10","004","00","005","0511","0000","1333","402","931","60","1393","2346","0","59.38","17.14"
"10","004","00","005","0511","0263","729","231","498","31","760","1284","0","59.19","17.99"
"10","004","00","005","0511","0264","604","171","433","29","633","1062","0","59.6","16.1"
"10","004","00","005","0512","0000","829","214","615","56","885","1547","0","57.21","13.83"
"10","004","00","005","0512","0265","829","214","615","56","885","1547","0","57.21","13.83"
"10","004","00","005","0513","0000","1285","350","935","71","1356","2197","0","61.72","15.93"
"10","004","00","005","0513","0256","634","162","472","37","671","1082","0","62.01","14.97"
"10","004","00","005","0513","0257","651","188","463","34","685","1115","0","61.43","16.86"
"10","004","00","005","0514","0000","2517","808","1709","128","2645","5072","0","52.15","15.93"
"10","004","00","005","0514","0270","570","201","369","31","601","1058","0","56.81","19.0"
"10","004","00","005","0514","0271","510","163","347","17","527","1220","0","43.2","13.36"
"10","004","00","005","0514","0272","722","246","476","29","751","1333","0","56.34","18.45"
"10","004","00","005","0514","0273","715","198","517","51","766","1461","0","52.43","13.55"
"10","004","00","005","0515","0000","1641","493","1148","78","1719","3233","0","53.17","15.25"
"10","004","00","005","0515","0277","712","213","499","29","741","1495","0","49.57","14.25"
"10","004","00","005","0515","0278","402","114","288","30","432","752","0","57.45","15.16"
"10","004","00","005","0515","0279","527","166","361","19","546","986","0","55.38","16.84"
"10","004","00","005","0516","0000","2825","1192","1633","88","2913","5896","0","49.41","20.22"
"10","004","00","005","0516","0266","718","201","517","26","744","1494","0","49.8","13.45"
"10","004","00","005","0516","0267","755","540","215","29","784","1634","0","47.98","33.05"
"10","004","00","005","0516","0268","665","235","430","18","683","1444","0","47.3","16.27"
"10","004","00","005","0516","0269","687","216","471","15","702","1324","0","53.02","16.31"
"10","004","00","005","0517","0000","1892","582","1310","57","1949","3370","0","57.83","17.27"
"10","004","00","005","0517","0254","895","293","602","38","933","1493","0","62.49","19.62"
"10","004","00","005","0517","0255","997","289","708","19","1016","1877","0","54.13","15.4"
"10","004","00","005","0518","0000","1618","453","1165","90","1708","2876","0","59.39","15.75"
"10","004","00","005","0518","0248","677","199","478","58","735","1147","0","64.08","17.35"
"10","004","00","005","0518","0249","941","254","687","32","973","1729","0","56.28","14.69"
"10","004","00","005","0519","0000","2351","619","1732","93","2444","4123","0","59.28","15.01"
"10","004","00","005","0519","0235","733","217","516","30","763","1188","0","64.23","18.27"
"10","004","00","005","0519","0236","697","166","531","32","729","1267","0","57.54","13.1"
"10","004","00","005","0519","0237","921","236","685","31","952","1668","0","57.07","14.15"
"10","004","00","005","0520","0000","2068","614","1454","105","2173","4038","0","53.81","15.21"
"10","004","00","005","0520","0274","756","233","523","32","788","1429","0","55.14","16.31"
"10","004","00","005","0520","0275","686","205","481","26","712","1506","0","47.28","13.61"
"10","004","00","005","0520","0276","626","176","450","47","673","1103","0","61.02","15.96"
"10","004","00","006","0000","0000","24395","7296","17099","1239","25634","45790","56957","55.98","15.93"
"10","004","00","006","0601","0000","541","167","374","43","584","1080","0","54.07","15.46"
"10","004","00","006","0601","0280","541","167","374","43","584","1080","0","54.07","15.46"
"10","004","00","006","0602","0000","891","270","621","58","949","1799","0","52.75","15.01"
"10","004","00","006","0602","0288","430","134","296","29","459","824","0","55.7","16.26"
"10","004","00","006","0602","0289","461","136","325","29","490","975","0","50.26","13.95"
"10","004","00","006","0603","0000","942","279","663","62","1004","1841","0","54.54","15.15"
"10","004","00","006","0603","0281","446","138","308","22","468","887","0","52.76","15.56"
"10","004","00","006","0603","0282","496","141","355","40","536","954","0","56.18","14.78"
"10","004","00","006","0604","0000","1402","476","926","107","1509","2743","0","55.01","17.35"
"10","004","00","006","0604","0291","789","256","533","55","844","1477","0","57.14","17.33"
"10","004","00","006","0604","0292","613","220","393","52","665","1266","0","52.53","17.38"
"10","004","00","006","0605","0000","894","271","623","73","967","1765","0","54.79","15.35"
"10","004","00","006","0605","0286","482","143","339","45","527","891","0","59.15","16.05"
"10","004","00","006","0605","0287","412","128","284","28","440","874","0","50.34","14.65"
"10","004","00","006","0606","0000","445","165","280","38","483","847","0","57.02","19.48"
"10","004","00","006","0606","0290","445","165","280","38","483","847","0","57.02","19.48"
"10","004","00","006","0607","0000","1735","546","1189","104","1839","3232","0","56.9","16.89"
"10","004","00","006","0607","0283","540","172","368","35","575","1003","0","57.33","17.15"
"10","004","00","006","0607","0284","575","169","406","29","604","1106","0","54.61","15.28"
"10","004","00","006","0607","0285","620","205","415","40","660","1123","0","58.77","18.25"
"10","004","00","006","0608","0000","2765","799","1966","136","2901","5237","0","55.39","15.26"
"10","004","00","006","0608","0305","753","209","544","34","787","1302","0","60.45","16.05"
"10","004","00","006","0608","0306","748","204","544","39","787","1410","0","55.82","14.47"
"10","004","00","006","0608","0307","668","199","469","27","695","1267","0","54.85","15.71"
"10","004","00","006","0608","0308","596","187","409","36","632","1258","0","50.24","14.86"
"10","004","00","006","0609","0000","1031","278","753","106","1137","2092","0","54.35","13.29"
"10","004","00","006","0609","0293","497","137","360","63","560","1029","0","54.42","13.31"
"10","004","00","006","0609","0294","534","141","393","43","577","1063","0","54.28","13.26"
"10","004","00","006","0610","0000","1355","404","951","43","1398","2500","0","55.92","16.16"
"10","004","00","006","0610","0295","566","163","403","23","589","1055","0","55.83","15.45"
"10","004","00","006","0610","0296","789","241","548","20","809","1445","0","55.99","16.68"
"10","004","00","006","0611","0000","2450","709","1741","73","2523","4382","0","57.58","16.18"
"10","004","00","006","0611","0311","655","177","478","24","679","1157","0","58.69","15.3"
"10","004","00","006","0611","0312","546","155","391","24","570","1089","0","52.34","14.23"
"10","004","00","006","0611","0313","651","195","456","10","661","1160","0","56.98","16.81"
"10","004","00","006","0611","0314","598","182","416","15","613","976","0","62.81","18.65"
"10","004","00","006","0612","0000","733","113","620","39","772","1486","0","51.95","7.6"
"10","004","00","006","0612","0303","733","113","620","39","772","1486","0","51.95","7.6"
"10","004","00","006","0613","0000","621","170","451","48","669","1067","0","62.7","15.93"
"10","004","00","006","0613","0304","621","170","451","48","669","1067","0","62.7","15.93"
"10","004","00","006","0614","0000","2099","631","1468","64","2163","3519","0","61.47","17.93"
"10","004","00","006","0614","0297","845","256","589","22","867","1413","0","61.36","18.12"
"10","004","00","006","0614","0298","606","186","420","16","622","971","0","64.06","19.16"
"10","004","00","006","0614","0299","648","189","459","26","674","1135","0","59.38","16.65"
"10","004","00","006","0615","0000","2257","710","1547","100","2357","4188","0","56.28","16.95"
"10","004","00","006","0615","0300","649","210","439","32","681","1269","0","53.66","16.55"
"10","004","00","006","0615","0301","676","195","481","34","710","1257","0","56.48","15.51"
"10","004","00","006","0615","0302","932","305","627","34","966","1662","0","58.12","18.35"
"10","004","00","006","0616","0000","2866","918","1948","100","2966","5339","0","55.55","17.19"
"10","004","00","006","0616","0315","782","253","529","30","812","1443","0","56.27","17.53"
"10","004","00","006","0616","0316","614","204","410","21","635","1247","0","50.92","16.36"
"10","004","00","006","0616","0317","767","239","528","14","781","1411","0","55.35","16.94"
"10","004","00","006","0616","0318","703","222","481","35","738","1238","0","59.61","17.93"
"10","004","00","006","0617","0000","1368","390","978","45","1413","2673","0","52.86","14.59"
"10","004","00","006","0617","0309","592","183","409","19","611","1217","0","50.21","15.04"
"10","004","00","006","0617","0310","776","207","569","26","802","1456","0","55.08","14.22"
"10","004","00","007","0000","0000","9557","2855","6702","645","10202","17293","20043","58.99","16.51"
"10","004","00","007","0701","0000","361","96","265","20","381","534","0","71.35","17.98"
"10","004","00","007","0701","0320","361","96","265","20","381","534","0","71.35","17.98"
"10","004","00","007","0702","0000","229","74","155","13","242","417","0","58.03","17.75"
"10","004","00","007","0702","0319","229","74","155","13","242","417","0","58.03","17.75"
"10","004","00","007","0703","0000","540","168","372","25","565","963","0","58.67","17.45"
"10","004","00","007","0703","0321","540","168","372","25","565","963","0","58.67","17.45"
"10","004","00","007","0704","0000","251","25","226","21","272","418","0","65.07","5.98"
"10","004","00","007","0704","0322","251","25","226","21","272","418","0","65.07","5.98"
"10","004","00","007","0705","0000","1330","377","953","78","1408","2666","0","52.81","14.14"
"10","004","00","007","0705","0323","680","177","503","44","724","1312","0","55.18","13.49"
"10","004","00","007","0705","0324","650","200","450","34","684","1354","0","50.52","14.77"
"10","004","00","007","0706","0000","862","259","603","102","964","1582","0","60.94","16.37"
"10","004","00","007","0706","0325","447","151","296","28","475","785","0","60.51","19.24"
"10","004","00","007","0706","0326","415","108","307","74","489","797","0","61.36","13.55"
"10","004","00","007","0707","0000","367","94","273","28","395","623","0","63.4","15.09"
"10","004","00","007","0707","0327","367","94","273","28","395","623","0","63.4","15.09"
"10","004","00","007","0708","0000","402","103","299","39","441","759","0","58.1","13.57"
"10","004","00","007","0708","0328","402","103","299","39","441","759","0","58.1","13.57"
"10","004","00","007","0709","0000","1242","377","865","79","1321","2401","0","55.02","15.7"
"10","004","00","007","0709","0329","603","202","401","45","648","1272","0","50.94","15.88"
"10","004","00","007","0709","0330","639","175","464","34","673","1129","0","59.61","15.5"
"10","004","00","007","0710","0000","899","283","616","68","967","1552","0","62.31","18.23"
"10","004","00","007","0710","0331","417","134","283","27","444","713","0","62.27","18.79"
"10","004","00","007","0710","0332","482","149","333","41","523","839","0","62.34","17.76"
"10","004","00","007","0711","0000","2465","816","1649","125","2590","4276","0","60.57","19.08"
"10","004","00","007","0711","0333","710","214","496","29","739","1123","0","65.81","19.06"
"10","004","00","007","0711","0334","572","188","384","19","591","981","0","60.24","19.16"
"10","004","00","007","0711","0335","608","235","373","52","660","1078","0","61.22","21.8"
"10","004","00","007","0711","0336","575","179","396","25","600","1094","0","54.84","16.36"
"10","004","00","007","0712","0000","609","183","426","47","656","1102","0","59.53","16.61"
"10","004","00","007","0712","0337","609","183","426","47","656","1102","0","59.53","16.61"
"10","004","00","008","0000","0000","6249","1742","4507","452","6701","11346","13013","59.06","15.35"
"10","004","00","008","0801","0000","1939","576","1363","125","2064","3404","0","60.63","16.92"
"10","004","00","008","0801","0338","705","217","488","44","749","1231","0","60.84","17.63"
"10","004","00","008","0801","0339","586","168","418","42","628","1041","0","60.33","16.14"
"10","004","00","008","0801","0340","648","191","457","39","687","1132","0","60.69","16.87"
"10","004","00","008","0802","0000","482","131","351","36","518","859","0","60.3","15.25"
"10","004","00","008","0802","0341","482","131","351","36","518","859","0","60.3","15.25"
"10","004","00","008","0803","0000","104","23","81","13","117","204","0","57.35","11.27"
"10","004","00","008","0803","0342","104","23","81","13","117","204","0","57.35","11.27"
"10","004","00","008","0804","0000","90","21","69","10","100","222","0","45.05","9.46"
"10","004","00","008","0804","0343","90","21","69","10","100","222","0","45.05","9.46"
"10","004","00","008","0805","0000","188","51","137","30","218","338","0","64.5","15.09"
"10","004","00","008","0805","0344","188","51","137","30","218","338","0","64.5","15.09"
"10","004","00","008","0806","0000","471","111","360","21","492","916","0","53.71","12.12"
"10","004","00","008","0806","0345","471","111","360","21","492","916","0","53.71","12.12"
"10","004","00","008","0807","0000","211","50","161","20","231","463","0","49.89","10.8"
"10","004","00","008","0807","0348","211","50","161","20","231","463","0","49.89","10.8"
"10","004","00","008","0808","0000","526","137","389","61","587","978","0","60.02","14.01"
"10","004","00","008","0808","0349","389","98","291","49","438","690","0","63.48","14.2"
"10","004","00","008","0808","0350","137","39","98","12","149","288","0","51.74","13.54"
"10","004","00","008","0809","0000","922","274","648","56","978","1553","0","62.97","17.64"
"10","004","00","008","0809","0351","413","129","284","28","441","685","0","64.38","18.83"
"10","004","00","008","0809","0352","509","145","364","28","537","868","0","61.87","16.71"
"10","004","00","008","0810","0000","911","247","664","56","967","1561","0","61.95","15.82"
"10","004","00","008","0810","0353","911","247","664","56","967","1561","0","61.95","15.82"
"10","004","00","008","0811","0000","405","121","284","24","429","848","0","50.59","14.27"
"10","004","00","008","0811","0346","227","65","162","13","240","573","0","41.88","11.34"
"10","004","00","008","0811","0347","178","56","122","11","189","275","0","68.73","20.36"
"10","004","00","009","0000","0000","4396","1549","2847","238","4634","8180","9352","56.65","18.94"
"10","004","00","009","0901","0000","593","190","403","9","602","1158","0","51.99","16.41"
"10","004","00","009","0901","0354","593","190","403","9","602","1158","0","51.99","16.41"
"10","004","00","009","0902","0000","689","236","453","51","740","1238","0","59.77","19.06"
"10","004","00","009","0902","0355","689","236","453","51","740","1238","0","59.77","19.06"
"10","004","00","009","0903","0000","1392","433","959","81","1473","2584","0","57.0","16.76"
"10","004","00","009","0903","0357","519","147","372","26","545","931","0","58.54","15.79"
"10","004","00","009","0903","0358","873","286","587","55","928","1653","0","56.14","17.3"
"10","004","00","009","0904","0000","453","129","324","32","485","845","0","57.4","15.27"
"10","004","00","009","0904","0359","453","129","324","32","485","845","0","57.4","15.27"
"10","004","00","009","0905","0000","201","54","147","14","215","384","0","55.99","14.06"
"10","004","00","009","0905","0360","201","54","147","14","215","384","0","55.99","14.06"
"10","004","00","009","0906","0000","426","303","123","10","436","763","0","57.14","39.71"
"10","004","00","009","0906","0361","426","303","123","10","436","763","0","57.14","39.71"
"10","004","00","009","0907","0000","324","111","213","16","340","580","0","58.62","19.14"
"10","004","00","009","0907","0356","324","111","213","16","340","580","0","58.62","19.14"
"10","004","00","009","0908","0000","166","61","105","17","183","333","0","54.95","18.32"
"10","004","00","009","0908","0362","166","61","105","17","183","333","0","54.95","18.32"
"10","004","00","009","0909","0000","152","32","120","8","160","295","0","54.24","10.85"
"10","004","00","009","0909","0363","152","32","120","8","160","295","0","54.24","10.85"
"10","004","00","010","0000","0000","7199","2608","4591","410","7609","12973","14681","58.65","20.1"
"10","004","00","010","1001","0000","1419","715","704","69","1488","2595","0","57.34","27.55"
"10","004","00","010","1001","0364","609","206","403","53","662","1158","0","57.17","17.79"
"10","004","00","010","1001","0365","810","509","301","16","826","1437","0","57.48","35.42"
"10","004","00","010","1002","0000","1062","383","679","41","1103","1900","0","58.05","20.16"
"10","004","00","010","1002","0368","1062","383","679","41","1103","1900","0","58.05","20.16"
"10","004","00","010","1003","0000","515","177","338","26","541","1056","0","51.23","16.76"
"10","004","00","010","1003","0369","515","177","338","26","541","1056","0","51.23","16.76"
"10","004","00","010","1004","0000","690","188","502","62","752","1205","0","62.41","15.6"
"10","004","00","010","1004","0370","690","188","502","62","752","1205","0","62.41","15.6"
"10","004","00","010","1005","0000","489","144","345","30","519","846","0","61.35","17.02"
"10","004","00","010","1005","0372","489","144","345","30","519","846","0","61.35","17.02"
"10","004","00","010","1006","0000","409","125","284","31","440","766","0","57.44","16.32"
"10","004","00","010","1006","0371","409","125","284","31","440","766","0","57.44","16.32"
"10","004","00","010","1007","0000","343","120","223","13","356","554","0","64.26","21.66"
"10","004","00","010","1007","0375","343","120","223","13","356","554","0","64.26","21.66"
"10","004","00","010","1008","0000","453","143","310","36","489","804","0","60.82","17.79"
"10","004","00","010","1008","0373","453","143","310","36","489","804","0","60.82","17.79"
"10","004","00","010","1009","0000","356","121","235","13","369","607","0","60.79","19.93"
"10","004","00","010","1009","0374","356","121","235","13","369","607","0","60.79","19.93"
"10","004","00","010","1010","0000","1463","492","971","89","1552","2640","0","58.79","18.64"
"10","004","00","010","1010","0366","792","266","526","47","839","1470","0","57.07","18.1"
"10","004","00","010","1010","0367","671","226","445","42","713","1170","0","60.94","19.32"
"10","004","00","011","0000","0000","2781","742","2039","279","3060","5068","5638","60.38","14.64"
"10","004","00","011","1101","0000","516","139","377","56","572","879","0","65.07","15.81"
"10","004","00","011","1101","0376","516","139","377","56","572","879","0","65.07","15.81"
"10","004","00","011","1102","0000","389","125","264","42","431","683","0","63.1","18.3"
"10","004","00","011","1102","0377","389","125","264","42","431","683","0","63.1","18.3"
"10","004","00","011","1103","0000","334","102","232","33","367","604","0","60.76","16.89"
"10","004","00","011","1103","0378","334","102","232","33","367","604","0","60.76","16.89"
"10","004","00","011","1104","0000","777","187","590","81","858","1406","0","61.02","13.3"
"10","004","00","011","1104","0381","777","187","590","81","858","1406","0","61.02","13.3"
"10","004","00","011","1105","0000","291","61","230","25","316","615","0","51.38","9.92"
"10","004","00","011","1105","0379","178","40","138","20","198","339","0","58.41","11.8"
"10","004","00","011","1105","0380","113","21","92","5","118","276","0","42.75","7.61"
"10","004","00","011","1106","0000","474","128","346","42","516","881","0","58.57","14.53"
"10","004","00","011","1106","0382","260","61","199","29","289","462","0","62.55","13.2"
"10","004","00","011","1106","0383","214","67","147","13","227","419","0","54.18","15.99"
"10","004","00","012","0000","0000","3536","710","2826","217","3753","7364","9683","50.96","9.64"
"10","004","00","012","1201","0000","271","56","215","28","299","599","0","49.92","9.35"
"10","004","00","012","1201","0386","92","19","73","19","111","225","0","49.33","8.44"
"10","004","00","012","1201","0387","179","37","142","9","188","374","0","50.27","9.89"
"10","004","00","012","1202","0000","400","102","298","12","412","831","0","49.58","12.27"
"10","004","00","012","1202","0384","218","52","166","7","225","474","0","47.47","10.97"
"10","004","00","012","1202","0385","182","50","132","5","187","357","0","52.38","14.01"
"10","004","00","012","1203","0000","579","103","476","34","613","1263","0","48.54","8.16"
"10","004","00","012","1203","0388","319","66","253","17","336","773","0","43.47","8.54"
"10","004","00","012","1203","0389","260","37","223","17","277","490","0","56.53","7.55"
"10","004","00","012","1204","0000","368","64","304","48","416","613","0","67.86","10.44"
"10","004","00","012","1204","0392","368","64","304","48","416","613","0","67.86","10.44"
"10","004","00","012","1205","0000","573","95","478","17","590","1191","0","49.54","7.98"
"10","004","00","012","1205","0390","225","42","183","5","230","531","0","43.31","7.91"
"10","004","00","012","1205","0391","348","53","295","12","360","660","0","54.55","8.03"
"10","004","00","012","1206","0000","671","121","550","28","699","1294","0","54.02","9.35"
"10","004","00","012","1206","0393","290","72","218","4","294","593","0","49.58","12.14"
"10","004","00","012","1206","0394","301","41","260","20","321","575","0","55.83","7.13"
"10","004","00","012","1206","0395","80","8","72","4","84","126","0","66.67","6.35"
"10","004","00","012","1207","0000","674","169","505","50","724","1573","0","46.03","10.74"
"10","004","00","012","1207","0396","228","40","188","3","231","499","0","46.29","8.02"
"10","004","00","012","1207","0397","283","78","205","29","312","785","0","39.75","9.94"
"10","004","00","012","1207","0398","163","51","112","18","181","289","0","62.63","17.65"
"10","004","00","013","0000","0000","1874","387","1487","94","1968","3997","4802","49.24","9.68"
"10","004","00","013","1301","0000","676","140","536","41","717","1385","0","51.77","10.11"
"10","004","00","013","1301","0399","370","70","300","27","397","672","0","59.08","10.42"
"10","004","00","013","1301","0400","306","70","236","14","320","713","0","44.88","9.82"
"10","004","00","013","1302","0000","368","74","294","5","373","727","0","51.31","10.18"
"10","004","00","013","1302","0403","368","74","294","5","373","727","0","51.31","10.18"
"10","004","00","013","1303","0000","165","31","134","9","174","395","0","44.05","7.85"
"10","004","00","013","1303","0404","165","31","134","9","174","395","0","44.05","7.85"
"10","004","00","013","1304","0000","665","142","523","39","704","1490","0","47.25","9.53"
"10","004","00","013","1304","0401","238","52","186","3","241","594","0","40.57","8.75"
"10","004","00","013","1304","0402","427","90","337","36","463","896","0","51.67","10.04"
"10","005","00","000","0000","0000","246982","74809","172173","15638","262620","461580","549798","56.9","16.21"
"10","005","00","001","0000","0000","40872","12854","28018","1971","42843","74249","88300","57.7","17.31"
"10","005","00","001","0101","0000","602","189","413","28","630","1087","0","57.96","17.39"
"10","005","00","001","0101","0001","602","189","413","28","630","1087","0","57.96","17.39"
"10","005","00","001","0102","0000","2321","698","1623","112","2433","4075","0","59.71","17.13"
"10","005","00","001","0102","0049","609","156","453","32","641","1003","0","63.91","15.55"
"10","005","00","001","0102","0050","549","190","359","21","570","1000","0","57.0","19.0"
"10","005","00","001","0102","0051","563","163","400","29","592","1047","0","56.54","15.57"
"10","005","00","001","0102","0052","600","189","411","30","630","1025","0","61.46","18.44"
"10","005","00","001","0103","0000","544","166","378","21","565","1018","0","55.5","16.31"
"10","005","00","001","0103","0002","544","166","378","21","565","1018","0","55.5","16.31"
"10","005","00","001","0104","0000","1292","354","938","58","1350","2234","0","60.43","15.85"
"10","005","00","001","0104","0009","633","177","456","27","660","1115","0","59.19","15.87"
"10","005","00","001","0104","0010","659","177","482","31","690","1119","0","61.66","15.82"
"10","005","00","001","0105","0000","2083","662","1421","109","2192","3685","0","59.48","17.96"
"10","005","00","001","0105","0011","661","216","445","36","697","1132","0","61.57","19.08"
"10","005","00","001","0105","0012","701","205","496","38","739","1289","0","57.33","15.9"
"10","005","00","001","0105","0013","721","241","480","35","756","1264","0","59.81","19.07"
"10","005","00","001","0106","0000","2013","634","1379","111","2124","3702","0","57.37","17.13"
"10","005","00","001","0106","0006","697","219","478","30","727","1203","0","60.43","18.2"
"10","005","00","001","0106","0007","738","207","531","40","778","1306","0","59.57","15.85"
"10","005","00","001","0106","0008","578","208","370","41","619","1193","0","51.89","17.44"
"10","005","00","001","0107","0000","1779","536","1243","90","1869","3358","0","55.66","15.96"
"10","005","00","001","0107","0003","630","183","447","16","646","1156","0","55.88","15.83"
"10","005","00","001","0107","0004","551","164","387","31","582","1118","0","52.06","14.67"
"10","005","00","001","0107","0005","598","189","409","43","641","1084","0","59.13","17.44"
"10","005","00","001","0108","0000","472","118","354","20","492","870","0","56.55","13.56"
"10","005","00","001","0108","0014","472","118","354","20","492","870","0","56.55","13.56"
"10","005","00","001","0109","0000","1651","504","1147","89","1740","3163","0","55.01","15.93"
"10","005","00","001","0109","0015","480","147","333","37","517","1008","0","51.29","14.58"
"10","005","00","001","0109","0016","550","166","384","23","573","1078","0","53.15","15.4"
"10","005","00","001","0109","0017","621","191","430","29","650","1077","0","60.35","17.73"
"10","005","00","001","0110","0000","461","137","324","41","502","894","0","56.15","15.32"
"10","005","00","001","0110","0019","461","137","324","41","502","894","0","56.15","15.32"
"10","005","00","001","0111","0000","283","77","206","23","306","522","0","58.62","14.75"
"10","005","00","001","0111","0020","283","77","206","23","306","522","0","58.62","14.75"
"10","005","00","001","0112","0000","485","143","342","25","510","880","0","57.95","16.25"
"10","005","00","001","0112","0018","485","143","342","25","510","880","0","57.95","16.25"
"10","005","00","001","0113","0000","2277","694","1583","124","2401","3964","0","60.57","17.51"
"10","005","00","001","0113","0024","674","218","456","36","710","1272","0","55.82","17.14"
"10","005","00","001","0113","0025","657","190","467","50","707","1112","0","63.58","17.09"
"10","005","00","001","0113","0026","533","167","366","13","546","813","0","67.16","20.54"
"10","005","00","001","0113","0027","413","119","294","25","438","767","0","57.11","15.51"
"10","005","00","001","0114","0000","818","274","544","52","870","1376","0","63.23","19.91"
"10","005","00","001","0114","0021","818","274","544","52","870","1376","0","63.23","19.91"
"10","005","00","001","0115","0000","943","320","623","39","982","1597","0","61.49","20.04"
"10","005","00","001","0115","0031","353","111","242","14","367","607","0","60.46","18.29"
"10","005","00","001","0115","0032","590","209","381","25","615","990","0","62.12","21.11"
"10","005","00","001","0116","0000","2739","866","1873","165","2904","5087","0","57.09","17.02"
"10","005","00","001","0116","0033","600","182","418","74","674","1230","0","54.8","14.8"
"10","005","00","001","0116","0034","766","232","534","30","796","1372","0","58.02","16.91"
"10","005","00","001","0116","0035","678","224","454","31","709","1213","0","58.45","18.47"
"10","005","00","001","0116","0036","695","228","467","30","725","1272","0","57.0","17.92"
"10","005","00","001","0117","0000","1758","524","1234","46","1804","3157","0","57.14","16.6"
"10","005","00","001","0117","0028","564","168","396","18","582","1010","0","57.62","16.63"
"10","005","00","001","0117","0029","653","200","453","15","668","1182","0","56.51","16.92"
"10","005","00","001","0117","0030","541","156","385","13","554","965","0","57.41","16.17"
"10","005","00","001","0118","0000","1943","569","1374","84","2027","3496","0","57.98","16.28"
"10","005","00","001","0118","0037","725","185","540","25","750","1221","0","61.43","15.15"
"10","005","00","001","0118","0038","608","194","414","42","650","1104","0","58.88","17.57"
"10","005","00","001","0118","0039","610","190","420","17","627","1171","0","53.54","16.23"
"10","005","00","001","0119","0000","2290","680","1610","107","2397","4135","0","57.97","16.44"
"10","005","00","001","0119","0040","745","210","535","41","786","1392","0","56.47","15.09"
"10","005","00","001","0119","0041","785","221","564","14","799","1356","0","58.92","16.3"
"10","005","00","001","0119","0042","760","249","511","52","812","1387","0","58.54","17.95"
"10","005","00","001","0120","0000","615","168","447","33","648","1180","0","54.92","14.24"
"10","005","00","001","0120","0063","615","168","447","33","648","1180","0","54.92","14.24"
"10","005","00","001","0121","0000","2058","654","1404","80","2138","3644","0","58.67","17.95"
"10","005","00","001","0121","0057","669","197","472","21","690","1125","0","61.33","17.51"
"10","005","00","001","0121","0058","666","214","452","29","695","1241","0","56.0","17.24"
"10","005","00","001","0121","0059","723","243","480","30","753","1278","0","58.92","19.01"
"10","005","00","001","0122","0000","2692","770","1922","106","2798","5200","0","53.81","14.81"
"10","005","00","001","0122","0053","592","148","444","19","611","1130","0","54.07","13.1"
"10","005","00","001","0122","0054","631","207","424","22","653","1146","0","56.98","18.06"
"10","005","00","001","0122","0055","795","256","539","30","825","1432","0","57.61","17.88"
"10","005","00","001","0122","0056","674","159","515","35","709","1492","0","47.52","10.66"
"10","005","00","001","0123","0000","1340","406","934","68","1408","2472","0","56.96","16.42"
"10","005","00","001","0123","0022","731","224","507","29","760","1391","0","54.64","16.1"
"10","005","00","001","0123","0023","609","182","427","39","648","1081","0","59.94","16.84"
"10","005","00","001","0124","0000","824","259","565","44","868","1665","0","52.13","15.56"
"10","005","00","001","0124","0066","403","103","300","23","426","796","0","53.52","12.94"
"10","005","00","001","0124","0067","421","156","265","21","442","869","0","50.86","17.95"
"10","005","00","001","0125","0000","1905","603","1302","84","1989","3412","0","58.29","17.67"
"10","005","00","001","0125","0043","639","218","421","35","674","1206","0","55.89","18.08"
"10","005","00","001","0125","0044","616","176","440","25","641","1004","0","63.84","17.53"
"10","005","00","001","0125","0045","650","209","441","24","674","1202","0","56.07","17.39"
"10","005","00","001","0126","0000","1764","748","1016","76","1840","2900","0","63.45","25.79"
"10","005","00","001","0126","0046","615","204","411","26","641","1052","0","60.93","19.39"
"10","005","00","001","0126","0047","526","367","159","19","545","873","0","62.43","42.04"
"10","005","00","001","0126","0048","623","177","446","31","654","975","0","67.08","18.15"
"10","005","00","001","0127","0000","1088","560","528","52","1140","1984","0","57.46","28.23"
"10","005","00","001","0127","0064","612","202","410","24","636","1072","0","59.33","18.84"
"10","005","00","001","0127","0065","476","358","118","28","504","912","0","55.26","39.25"
"10","005","00","001","0128","0000","1832","541","1291","84","1916","3492","0","54.87","15.49"
"10","005","00","001","0128","0060","707","209","498","18","725","1293","0","56.07","16.16"
"10","005","00","001","0128","0061","683","209","474","29","712","1342","0","53.06","15.57"
"10","005","00","001","0128","0062","442","123","319","37","479","857","0","55.89","14.35"
"10","005","00","002","0000","0000","20793","6245","14548","1583","22376","38890","45367","57.54","16.06"
"10","005","00","002","0201","0000","1228","376","852","88","1316","2219","0","59.31","16.94"
"10","005","00","002","0201","0183","486","143","343","38","524","873","0","60.02","16.38"
"10","005","00","002","0201","0184","742","233","509","50","792","1346","0","58.84","17.31"
"10","005","00","002","0202","0000","925","263","662","54","979","1566","0","62.52","16.79"
"10","005","00","002","0202","0185","589","184","405","41","630","951","0","66.25","19.35"
"10","005","00","002","0202","0186","336","79","257","13","349","615","0","56.75","12.85"
"10","005","00","002","0203","0000","482","139","343","62","544","878","0","61.96","15.83"
"10","005","00","002","0203","0187","482","139","343","62","544","878","0","61.96","15.83"
"10","005","00","002","0204","0000","860","277","583","58","918","1543","0","59.49","17.95"
"10","005","00","002","0204","0188","447","147","300","27","474","767","0","61.8","19.17"
"10","005","00","002","0204","0189","413","130","283","31","444","776","0","57.22","16.75"
"10","005","00","002","0205","0000","602","187","415","57","659","1231","0","53.53","15.19"
"10","005","00","002","0205","0190","602","187","415","57","659","1231","0","53.53","15.19"
"10","005","00","002","0206","0000","1094","333","761","64","1158","1995","0","58.05","16.69"
"10","005","00","002","0206","0191","648","202","446","36","684","1145","0","59.74","17.64"
"10","005","00","002","0206","0192","446","131","315","28","474","850","0","55.76","15.41"
"10","005","00","002","0207","0000","527","182","345","54","581","1052","0","55.23","17.3"
"10","005","00","002","0207","0193","527","182","345","54","581","1052","0","55.23","17.3"
"10","005","00","002","0208","0000","1218","392","826","99","1317","2250","0","58.53","17.42"
"10","005","00","002","0208","0194","595","177","418","44","639","1114","0","57.36","15.89"
"10","005","00","002","0208","0195","623","215","408","55","678","1136","0","59.68","18.93"
"10","005","00","002","0209","0000","2156","658","1498","136","2292","3922","0","58.44","16.78"
"10","005","00","002","0209","0196","638","180","458","39","677","1194","0","56.7","15.08"
"10","005","00","002","0209","0197","856","259","597","47","903","1579","0","57.19","16.4"
"10","005","00","002","0209","0198","662","219","443","50","712","1149","0","61.97","19.06"
"10","005","00","002","0210","0000","1142","354","788","75","1217","2158","0","56.39","16.4"
"10","005","00","002","0210","0199","585","193","392","57","642","1057","0","60.74","18.26"
"10","005","00","002","0210","0200","557","161","396","18","575","1101","0","52.23","14.62"
"10","005","00","002","0211","0000","419","117","302","36","455","912","0","49.89","12.83"
"10","005","00","002","0211","0201","419","117","302","36","455","912","0","49.89","12.83"
"10","005","00","002","0212","0000","338","100","238","29","367","652","0","56.29","15.34"
"10","005","00","002","0212","0202","338","100","238","29","367","652","0","56.29","15.34"
"10","005","00","002","0213","0000","715","207","508","69","784","1348","0","58.16","15.36"
"10","005","00","002","0213","0203","715","207","508","69","784","1348","0","58.16","15.36"
"10","005","00","002","0214","0000","681","220","461","31","712","1395","0","51.04","15.77"
"10","005","00","002","0214","0204","351","122","229","18","369","733","0","50.34","16.64"
"10","005","00","002","0214","0205","330","98","232","13","343","662","0","51.81","14.8"
"10","005","00","002","0215","0000","983","320","663","80","1063","1803","0","58.96","17.75"
"10","005","00","002","0215","0206","481","144","337","35","516","893","0","57.78","16.13"
"10","005","00","002","0215","0207","502","176","326","45","547","910","0","60.11","19.34"
"10","005","00","002","0216","0000","643","191","452","57","700","1270","0","55.12","15.04"
"10","005","00","002","0216","0208","643","191","452","57","700","1270","0","55.12","15.04"
"10","005","00","002","0217","0000","266","74","192","28","294","545","0","53.94","13.58"
"10","005","00","002","0217","0209","266","74","192","28","294","545","0","53.94","13.58"
"10","005","00","002","0218","0000","453","116","337","49","502","792","0","63.38","14.65"
"10","005","00","002","0218","0210","453","116","337","49","502","792","0","63.38","14.65"
"10","005","00","002","0219","0000","1310","363","947","83","1393","2316","0","60.15","15.67"
"10","005","00","002","0219","0218","620","160","460","25","645","1082","0","59.61","14.79"
"10","005","00","002","0219","0219","690","203","487","58","748","1234","0","60.62","16.45"
"10","005","00","002","0220","0000","764","226","538","67","831","1609","0","51.65","14.05"
"10","005","00","002","0220","0212","342","94","248","20","362","827","0","43.77","11.37"
"10","005","00","002","0220","0213","422","132","290","47","469","782","0","59.97","16.88"
"10","005","00","002","0221","0000","832","236","596","66","898","1634","0","54.96","14.44"
"10","005","00","002","0221","0214","404","118","286","30","434","788","0","55.08","14.97"
"10","005","00","002","0221","0215","428","118","310","36","464","846","0","54.85","13.95"
"10","005","00","002","0222","0000","964","254","710","92","1056","1771","0","59.63","14.34"
"10","005","00","002","0222","0216","465","129","336","40","505","828","0","60.99","15.58"
"10","005","00","002","0222","0217","499","125","374","52","551","943","0","58.43","13.26"
"10","005","00","002","0223","0000","396","132","264","22","418","726","0","57.58","18.18"
"10","005","00","002","0223","0211","396","132","264","22","418","726","0","57.58","18.18"
"10","005","00","002","0224","0000","744","211","533","43","787","1434","0","54.88","14.71"
"10","005","00","002","0224","0220","744","211","533","43","787","1434","0","54.88","14.71"
"10","005","00","002","0225","0000","1051","317","734","84","1135","1869","0","60.73","16.96"
"10","005","00","002","0225","0221","532","156","376","39","571","987","0","57.85","15.81"
"10","005","00","002","0225","0222","519","161","358","45","564","882","0","63.95","18.25"
"10","005","00","003","0000","0000","14734","4556","10178","1346","16080","29709","34122","54.13","15.34"
"10","005","00","003","0301","0000","597","206","391","67","664","1142","0","58.14","18.04"
"10","005","00","003","0301","0149","597","206","391","67","664","1142","0","58.14","18.04"
"10","005","00","003","0302","0000","1078","359","719","105","1183","1952","0","60.6","18.39"
"10","005","00","003","0302","0150","526","192","334","53","579","884","0","65.5","21.72"
"10","005","00","003","0302","0151","552","167","385","52","604","1068","0","56.55","15.64"
"10","005","00","003","0303","0000","1064","347","717","87","1151","1868","0","61.62","18.58"
"10","005","00","003","0303","0152","552","182","370","38","590","1009","0","58.47","18.04"
"10","005","00","003","0303","0153","512","165","347","49","561","859","0","65.31","19.21"
"10","005","00","003","0304","0000","852","258","594","62","914","1551","0","58.93","16.63"
"10","005","00","003","0304","0157","475","145","330","37","512","761","0","67.28","19.05"
"10","005","00","003","0304","0158","377","113","264","25","402","790","0","50.89","14.3"
"10","005","00","003","0305","0000","352","115","237","56","408","686","0","59.48","16.76"
"10","005","00","003","0305","0156","352","115","237","56","408","686","0","59.48","16.76"
"10","005","00","003","0306","0000","1326","377","949","149","1475","2709","0","54.45","13.92"
"10","005","00","003","0306","0159","483","136","347","51","534","966","0","55.28","14.08"
"10","005","00","003","0306","0160","443","135","308","61","504","972","0","51.85","13.89"
"10","005","00","003","0306","0161","400","106","294","37","437","771","0","56.68","13.75"
"10","005","00","003","0307","0000","336","114","222","14","350","684","0","51.17","16.67"
"10","005","00","003","0307","0168","336","114","222","14","350","684","0","51.17","16.67"
"10","005","00","003","0308","0000","407","124","283","35","442","943","0","46.87","13.15"
"10","005","00","003","0308","0169","407","124","283","35","442","943","0","46.87","13.15"
"10","005","00","003","0309","0000","437","123","314","43","480","790","0","60.76","15.57"
"10","005","00","003","0309","0170","437","123","314","43","480","790","0","60.76","15.57"
"10","005","00","003","0310","0000","279","76","203","11","290","673","0","43.09","11.29"
"10","005","00","003","0310","0171","279","76","203","11","290","673","0","43.09","11.29"
"10","005","00","003","0311","0000","600","174","426","52","652","1232","0","52.92","14.12"
"10","005","00","003","0311","0172","600","174","426","52","652","1232","0","52.92","14.12"
"10","005","00","003","0312","0000","689","166","523","68","757","1286","0","58.86","12.91"
"10","005","00","003","0312","0173","689","166","523","68","757","1286","0","58.86","12.91"
"10","005","00","003","0313","0000","706","218","488","65","771","1418","0","54.37","15.37"
"10","005","00","003","0313","0174","356","106","250","29","385","649","0","59.32","16.33"
"10","005","00","003","0313","0175","350","112","238","36","386","769","0","50.2","14.56"
"10","005","00","003","0314","0000","864","261","603","77","941","1836","0","51.25","14.22"
"10","005","00","003","0314","0162","333","99","234","24","357","758","0","47.1","13.06"
"10","005","00","003","0314","0163","531","162","369","53","584","1078","0","54.17","15.03"
"10","005","00","003","0315","0000","169","32","137","31","200","459","0","43.57","6.97"
"10","005","00","003","0315","0164","169","32","137","31","200","459","0","43.57","6.97"
"10","005","00","003","0316","0000","406","111","295","43","449","894","0","50.22","12.42"
"10","005","00","003","0316","0165","406","111","295","43","449","894","0","50.22","12.42"
"10","005","00","003","0317","0000","151","50","101","8","159","402","0","39.55","12.44"
"10","005","00","003","0317","0166","151","50","101","8","159","402","0","39.55","12.44"
"10","005","00","003","0318","0000","397","112","285","36","433","802","0","53.99","13.97"
"10","005","00","003","0318","0167","397","112","285","36","433","802","0","53.99","13.97"
"10","005","00","003","0319","0000","1082","355","727","125","1207","2286","0","52.8","15.53"
"10","005","00","003","0319","0176","565","192","373","66","631","1148","0","54.97","16.72"
"10","005","00","003","0319","0177","517","163","354","59","576","1138","0","50.62","14.32"
"10","005","00","003","0320","0000","523","164","359","43","566","1121","0","50.49","14.63"
"10","005","00","003","0320","0178","523","164","359","43","566","1121","0","50.49","14.63"
"10","005","00","003","0321","0000","406","139","267","21","427","769","0","55.53","18.08"
"10","005","00","003","0321","0179","406","139","267","21","427","769","0","55.53","18.08"
"10","005","00","003","0322","0000","684","249","435","53","737","1415","0","52.08","17.6"
"10","005","00","003","0322","0180","285","102","183","16","301","616","0","48.86","16.56"
"10","005","00","003","0322","0181","399","147","252","37","436","799","0","54.57","18.4"
"10","005","00","003","0323","0000","346","112","234","33","379","743","0","51.01","15.07"
"10","005","00","003","0323","0182","346","112","234","33","379","743","0","51.01","15.07"
"10","005","00","003","0324","0000","983","314","669","62","1045","2048","0","51.03","15.33"
"10","005","00","003","0324","0154","569","193","376","39","608","1040","0","58.46","18.56"
"10","005","00","003","0324","0155","414","121","293","23","437","1008","0","43.35","12.0"
"10","005","00","004","0000","0000","36544","11697","24847","1967","38511","68528","86056","56.2","17.07"
"10","005","00","004","0401","0000","1097","373","724","47","1144","1912","0","59.83","19.51"
"10","005","00","004","0401","0270","633","244","389","21","654","1086","0","60.22","22.47"
"10","005","00","004","0401","0271","464","129","335","26","490","826","0","59.32","15.62"
"10","005","00","004","0402","0000","1787","633","1154","117","1904","3302","0","57.66","19.17"
"10","005","00","004","0402","0272","527","223","304","30","557","1051","0","53.0","21.22"
"10","005","00","004","0402","0273","695","214","481","36","731","1235","0","59.19","17.33"
"10","005","00","004","0402","0274","565","196","369","51","616","1016","0","60.63","19.29"
"10","005","00","004","0403","0000","1375","485","890","59","1434","2773","0","51.71","17.49"
"10","005","00","004","0403","0275","754","268","486","43","797","1472","0","54.14","18.21"
"10","005","00","004","0403","0276","621","217","404","16","637","1301","0","48.96","16.68"
"10","005","00","004","0404","0000","2286","768","1518","108","2394","4519","0","52.98","16.99"
"10","005","00","004","0404","0277","748","258","490","34","782","1544","0","50.65","16.71"
"10","005","00","004","0404","0278","800","262","538","31","831","1512","0","54.96","17.33"
"10","005","00","004","0404","0279","738","248","490","43","781","1463","0","53.38","16.95"
"10","005","00","004","0405","0000","2945","930","2015","102","3047","5258","0","57.95","17.69"
"10","005","00","004","0405","0280","539","179","360","29","568","1073","0","52.94","16.68"
"10","005","00","004","0405","0281","802","270","532","32","834","1453","0","57.4","18.58"
"10","005","00","004","0405","0282","738","231","507","18","756","1245","0","60.72","18.55"
"10","005","00","004","0405","0283","866","250","616","23","889","1487","0","59.78","16.81"
"10","005","00","004","0406","0000","1869","623","1246","94","1963","3445","0","56.98","18.08"
"10","005","00","004","0406","0284","571","186","385","37","608","1018","0","59.72","18.27"
"10","005","00","004","0406","0285","633","218","415","22","655","1105","0","59.28","19.73"
"10","005","00","004","0406","0286","665","219","446","35","700","1322","0","52.95","16.57"
"10","005","00","004","0407","0000","1953","590","1363","80","2033","3343","0","60.81","17.65"
"10","005","00","004","0407","0287","645","184","461","16","661","1140","0","57.98","16.14"
"10","005","00","004","0407","0288","625","185","440","30","655","1067","0","61.39","17.34"
"10","005","00","004","0407","0289","683","221","462","34","717","1136","0","63.12","19.45"
"10","005","00","004","0408","0000","1620","524","1096","104","1724","3237","0","53.26","16.19"
"10","005","00","004","0408","0290","617","194","423","36","653","1253","0","52.11","15.48"
"10","005","00","004","0408","0291","477","151","326","37","514","963","0","53.37","15.68"
"10","005","00","004","0408","0292","526","179","347","31","557","1021","0","54.55","17.53"
"10","005","00","004","0409","0000","1164","324","840","79","1243","2111","0","58.88","15.35"
"10","005","00","004","0409","0297","517","156","361","46","563","989","0","56.93","15.77"
"10","005","00","004","0409","0298","647","168","479","33","680","1122","0","60.61","14.97"
"10","005","00","004","0410","0000","2316","707","1609","105","2421","4607","0","52.55","15.35"
"10","005","00","004","0410","0299","511","176","335","30","541","1111","0","48.69","15.84"
"10","005","00","004","0410","0300","581","172","409","34","615","1036","0","59.36","16.6"
"10","005","00","004","0410","0301","541","148","393","19","560","1112","0","50.36","13.31"
"10","005","00","004","0410","0302","683","211","472","22","705","1348","0","52.3","15.65"
"10","005","00","004","0411","0000","612","210","402","39","651","1059","0","61.47","19.83"
"10","005","00","004","0411","0306","612","210","402","39","651","1059","0","61.47","19.83"
"10","005","00","004","0412","0000","1584","525","1059","93","1677","2834","0","59.17","18.53"
"10","005","00","004","0412","0307","488","156","332","30","518","869","0","59.61","17.95"
"10","005","00","004","0412","0308","414","125","289","32","446","800","0","55.75","15.63"
"10","005","00","004","0412","0309","682","244","438","31","713","1165","0","61.2","20.94"
"10","005","00","004","0413","0000","794","247","547","51","845","1468","0","57.56","16.83"
"10","005","00","004","0413","0310","429","136","293","33","462","791","0","58.41","17.19"
"10","005","00","004","0413","0311","365","111","254","18","383","677","0","56.57","16.4"
"10","005","00","004","0414","0000","1107","334","773","67","1174","1988","0","59.05","16.8"
"10","005","00","004","0414","0312","476","159","317","41","517","797","0","64.87","19.95"
"10","005","00","004","0414","0313","631","175","456","26","657","1191","0","55.16","14.69"
"10","005","00","004","0415","0000","527","183","344","16","543","1027","0","52.87","17.82"
"10","005","00","004","0415","0314","527","183","344","16","543","1027","0","52.87","17.82"
"10","005","00","004","0416","0000","2055","652","1403","121","2176","3935","0","55.3","16.57"
"10","005","00","004","0416","0315","744","230","514","46","790","1341","0","58.91","17.15"
"10","005","00","004","0416","0316","655","215","440","48","703","1378","0","51.02","15.6"
"10","005","00","004","0416","0317","656","207","449","27","683","1216","0","56.17","17.02"
"10","005","00","004","0417","0000","1097","325","772","69","1166","2108","0","55.31","15.42"
"10","005","00","004","0417","0318","807","227","580","29","836","1570","0","53.25","14.46"
"10","005","00","004","0417","0319","290","98","192","40","330","538","0","61.34","18.22"
"10","005","00","004","0418","0000","518","142","376","31","549","1166","0","47.08","12.18"
"10","005","00","004","0418","0320","518","142","376","31","549","1166","0","47.08","12.18"
"10","005","00","004","0419","0000","2078","666","1412","100","2178","4119","0","52.88","16.17"
"10","005","00","004","0419","0321","761","276","485","22","783","1488","0","52.62","18.55"
"10","005","00","004","0419","0322","708","211","497","24","732","1449","0","50.52","14.56"
"10","005","00","004","0419","0323","609","179","430","54","663","1182","0","56.09","15.14"
"10","005","00","004","0420","0000","1132","356","776","103","1235","2158","0","57.23","16.5"
"10","005","00","004","0420","0324","596","196","400","72","668","1175","0","56.85","16.68"
"10","005","00","004","0420","0325","536","160","376","31","567","983","0","57.68","16.28"
"10","005","00","004","0421","0000","1969","626","1343","124","2093","3715","0","56.34","16.85"
"10","005","00","004","0421","0326","289","70","219","20","309","492","0","62.8","14.23"
"10","005","00","004","0421","0327","589","181","408","33","622","1074","0","57.91","16.85"
"10","005","00","004","0421","0328","432","149","283","38","470","852","0","55.16","17.49"
"10","005","00","004","0421","0329","659","226","433","33","692","1297","0","53.35","17.42"
"10","005","00","004","0422","0000","505","168","337","54","559","1028","0","54.38","16.34"
"10","005","00","004","0422","0330","505","168","337","54","559","1028","0","54.38","16.34"
"10","005","00","004","0423","0000","1733","546","1187","98","1831","3111","0","58.86","17.55"
"10","005","00","004","0423","0303","627","214","413","32","659","1114","0","59.16","19.21"
"10","005","00","004","0423","0304","632","205","427","42","674","1119","0","60.23","18.32"
"10","005","00","004","0423","0305","474","127","347","24","498","878","0","56.72","14.46"
"10","005","00","004","0424","0000","1189","348","841","45","1234","2109","0","58.51","16.5"
"10","005","00","004","0424","0295","711","213","498","33","744","1293","0","57.54","16.47"
"10","005","00","004","0424","0296","478","135","343","12","490","816","0","60.05","16.54"
"10","005","00","004","0425","0000","1232","412","820","61","1293","2196","0","58.88","18.76"
"10","005","00","004","0425","0293","661","220","441","36","697","1154","0","60.4","19.06"
"10","005","00","004","0425","0294","571","192","379","25","596","1042","0","57.2","18.43"
"10","005","00","005","0000","0000","45200","13417","31783","2218","47418","83617","103007","56.71","16.05"
"10","005","00","005","0501","0000","1130","292","838","105","1235","2207","0","55.96","13.23"
"10","005","00","005","0501","0331","444","117","327","56","500","915","0","54.64","12.79"
"10","005","00","005","0501","0332","686","175","511","49","735","1292","0","56.89","13.54"
"10","005","00","005","0502","0000","937","248","689","46","983","1763","0","55.76","14.07"
"10","005","00","005","0502","0333","519","133","386","34","553","928","0","59.59","14.33"
"10","005","00","005","0502","0334","418","115","303","12","430","835","0","51.5","13.77"
"10","005","00","005","0503","0000","1494","449","1045","91","1585","2988","0","53.05","15.03"
"10","005","00","005","0503","0335","556","153","403","33","589","1070","0","55.05","14.3"
"10","005","00","005","0503","0336","435","117","318","22","457","879","0","51.99","13.31"
"10","005","00","005","0503","0337","503","179","324","36","539","1039","0","51.88","17.23"
"10","005","00","005","0504","0000","1902","512","1390","123","2025","3716","0","54.49","13.78"
"10","005","00","005","0504","0338","623","170","453","36","659","1129","0","58.37","15.06"
"10","005","00","005","0504","0339","535","159","376","37","572","1041","0","54.95","15.27"
"10","005","00","005","0504","0340","744","183","561","50","794","1546","0","51.36","11.84"
"10","005","00","005","0505","0000","2277","695","1582","101","2378","4361","0","54.53","15.94"
"10","005","00","005","0505","0341","559","165","394","29","588","935","0","62.89","17.65"
"10","005","00","005","0505","0342","588","174","414","29","617","1180","0","52.29","14.75"
"10","005","00","005","0505","0343","741","212","529","27","768","1499","0","51.23","14.14"
"10","005","00","005","0505","0344","389","144","245","16","405","747","0","54.22","19.28"
"10","005","00","005","0506","0000","1358","375","983","76","1434","2599","0","55.18","14.43"
"10","005","00","005","0506","0345","729","204","525","31","760","1406","0","54.05","14.51"
"10","005","00","005","0506","0346","629","171","458","45","674","1193","0","56.5","14.33"
"10","005","00","005","0507","0000","516","160","356","41","557","948","0","58.76","16.88"
"10","005","00","005","0507","0347","516","160","356","41","557","948","0","58.76","16.88"
"10","005","00","005","0508","0000","1789","545","1244","56","1845","3297","0","55.96","16.53"
"10","005","00","005","0508","0348","457","118","339","12","469","869","0","53.97","13.58"
"10","005","00","005","0508","0349","638","197","441","27","665","1142","0","58.23","17.25"
"10","005","00","005","0508","0350","694","230","464","17","711","1286","0","55.29","17.88"
"10","005","00","005","0509","0000","1787","529","1258","86","1873","3105","0","60.32","17.04"
"10","005","00","005","0509","0351","508","152","356","31","539","903","0","59.69","16.83"
"10","005","00","005","0509","0352","696","199","497","39","735","1186","0","61.97","16.78"
"10","005","00","005","0509","0353","583","178","405","16","599","1016","0","58.96","17.52"
"10","005","00","005","0510","0000","884","285","599","42","926","1536","0","60.29","18.55"
"10","005","00","005","0510","0357","498","154","344","20","518","890","0","58.2","17.3"
"10","005","00","005","0510","0358","386","131","255","22","408","646","0","63.16","20.28"
"10","005","00","005","0511","0000","445","128","317","19","464","947","0","49.0","13.52"
"10","005","00","005","0511","0356","445","128","317","19","464","947","0","49.0","13.52"
"10","005","00","005","0512","0000","635","173","462","35","670","1030","0","65.05","16.8"
"10","005","00","005","0512","0363","635","173","462","35","670","1030","0","65.05","16.8"
"10","005","00","005","0513","0000","1027","285","742","42","1069","1968","0","54.32","14.48"
"10","005","00","005","0513","0384","563","153","410","20","583","1121","0","52.01","13.65"
"10","005","00","005","0513","0385","464","132","332","22","486","847","0","57.38","15.58"
"10","005","00","005","0514","0000","1728","477","1251","94","1822","3454","0","52.75","13.81"
"10","005","00","005","0514","0388","798","216","582","35","833","1655","0","50.33","13.05"
"10","005","00","005","0514","0389","930","261","669","59","989","1799","0","54.97","14.51"
"10","005","00","005","0515","0000","2231","697","1534","95","2326","3884","0","59.89","17.95"
"10","005","00","005","0515","0367","767","247","520","30","797","1326","0","60.11","18.63"
"10","005","00","005","0515","0368","768","225","543","34","802","1270","0","63.15","17.72"
"10","005","00","005","0515","0369","696","225","471","31","727","1288","0","56.44","17.47"
"10","005","00","005","0516","0000","2102","660","1442","72","2174","3830","0","56.76","17.23"
"10","005","00","005","0516","0364","746","241","505","34","780","1338","0","58.3","18.01"
"10","005","00","005","0516","0365","758","234","524","26","784","1450","0","54.07","16.14"
"10","005","00","005","0516","0366","598","185","413","12","610","1042","0","58.54","17.75"
"10","005","00","005","0517","0000","1646","508","1138","60","1706","3125","0","54.59","16.26"
"10","005","00","005","0517","0376","864","263","601","29","893","1551","0","57.58","16.96"
"10","005","00","005","0517","0377","782","245","537","31","813","1574","0","51.65","15.57"
"10","005","00","005","0518","0000","2024","616","1408","81","2105","3984","0","52.84","15.46"
"10","005","00","005","0518","0390","633","190","443","29","662","1141","0","58.02","16.65"
"10","005","00","005","0518","0391","746","238","508","35","781","1431","0","54.58","16.63"
"10","005","00","005","0518","0392","645","188","457","17","662","1412","0","46.88","13.31"
"10","005","00","005","0519","0000","761","244","517","50","811","1344","0","60.34","18.15"
"10","005","00","005","0519","0395","761","244","517","50","811","1344","0","60.34","18.15"
"10","005","00","005","0520","0000","926","256","670","53","979","1990","0","49.2","12.86"
"10","005","00","005","0520","0359","541","155","386","41","582","975","0","59.69","15.9"
"10","005","00","005","0520","0360","385","101","284","12","397","1015","0","39.11","9.95"
"10","005","00","005","0521","0000","1462","413","1049","87","1549","2542","0","60.94","16.25"
"10","005","00","005","0521","0361","811","227","584","50","861","1399","0","61.54","16.23"
"10","005","00","005","0521","0362","651","186","465","37","688","1143","0","60.19","16.27"
"10","005","00","005","0522","0000","780","234","546","63","843","1363","0","61.85","17.17"
"10","005","00","005","0522","0396","780","234","546","63","843","1363","0","61.85","17.17"
"10","005","00","005","0523","0000","1410","399","1011","83","1493","2595","0","57.53","15.38"
"10","005","00","005","0523","0398","662","195","467","52","714","1182","0","60.41","16.5"
"10","005","00","005","0523","0399","748","204","544","31","779","1413","0","55.13","14.44"
"10","005","00","005","0524","0000","544","144","400","29","573","898","0","63.81","16.04"
"10","005","00","005","0524","0397","544","144","400","29","573","898","0","63.81","16.04"
"10","005","00","005","0525","0000","1235","376","859","77","1312","2171","0","60.43","17.32"
"10","005","00","005","0525","0400","583","181","402","33","616","991","0","62.16","18.26"
"10","005","00","005","0525","0401","652","195","457","44","696","1180","0","58.98","16.53"
"10","005","00","005","0526","0000","1126","369","757","45","1171","2048","0","57.18","18.02"
"10","005","00","005","0526","0386","580","198","382","19","599","993","0","60.32","19.94"
"10","005","00","005","0526","0387","546","171","375","26","572","1055","0","54.22","16.21"
"10","005","00","005","0527","0000","1251","362","889","58","1309","2319","0","56.45","15.61"
"10","005","00","005","0527","0393","544","149","395","23","567","1074","0","52.79","13.87"
"10","005","00","005","0527","0394","707","213","494","35","742","1245","0","59.6","17.11"
"10","005","00","005","0528","0000","2005","628","1377","108","2113","3507","0","60.25","17.91"
"10","005","00","005","0528","0378","696","219","477","34","730","1262","0","57.84","17.35"
"10","005","00","005","0528","0379","649","210","439","39","688","1171","0","58.75","17.93"
"10","005","00","005","0528","0380","660","199","461","35","695","1074","0","64.71","18.53"
"10","005","00","005","0529","0000","1999","592","1407","82","2081","3586","0","58.03","16.51"
"10","005","00","005","0529","0381","667","195","472","22","689","1141","0","60.39","17.09"
"10","005","00","005","0529","0382","701","191","510","33","734","1259","0","58.3","15.17"
"10","005","00","005","0529","0383","631","206","425","27","658","1186","0","55.48","17.37"
"10","005","00","005","0530","0000","1076","323","753","48","1124","2022","0","55.59","15.97"
"10","005","00","005","0530","0354","534","164","370","25","559","985","0","56.75","16.65"
"10","005","00","005","0530","0355","542","159","383","23","565","1037","0","54.48","15.33"
"10","005","00","005","0531","0000","1455","417","1038","45","1500","2523","0","59.45","16.53"
"10","005","00","005","0531","0370","717","219","498","27","744","1243","0","59.86","17.62"
"10","005","00","005","0531","0371","738","198","540","18","756","1280","0","59.06","15.47"
"10","005","00","005","0532","0000","1784","564","1220","78","1862","3377","0","55.14","16.7"
"10","005","00","005","0532","0372","870","275","595","45","915","1618","0","56.55","17.0"
"10","005","00","005","0532","0373","914","289","625","33","947","1759","0","53.84","16.43"
"10","005","00","005","0533","0000","1474","462","1012","47","1521","2590","0","58.73","17.84"
"10","005","00","005","0533","0374","726","224","502","27","753","1264","0","59.57","17.72"
"10","005","00","005","0533","0375","748","238","510","20","768","1326","0","57.92","17.95"
"10","005","00","006","0000","0000","15781","5002","10779","1327","17108","30948","36332","55.28","16.16"
"10","005","00","006","0601","0000","840","294","546","64","904","1473","0","61.37","19.96"
"10","005","00","006","0601","0223","320","110","210","23","343","590","0","58.14","18.64"
"10","005","00","006","0601","0224","520","184","336","41","561","883","0","63.53","20.84"
"10","005","00","006","0602","0000","460","151","309","35","495","793","0","62.42","19.04"
"10","005","00","006","0602","0225","460","151","309","35","495","793","0","62.42","19.04"
"10","005","00","006","0603","0000","747","385","362","55","802","1324","0","60.57","29.08"
"10","005","00","006","0603","0226","414","287","127","27","441","732","0","60.25","39.21"
"10","005","00","006","0603","0227","333","98","235","28","361","592","0","60.98","16.55"
"10","005","00","006","0604","0000","2273","727","1546","144","2417","4218","0","57.3","17.24"
"10","005","00","006","0604","0228","621","202","419","44","665","1113","0","59.75","18.15"
"10","005","00","006","0604","0229","633","202","431","44","677","1195","0","56.65","16.9"
"10","005","00","006","0604","0230","585","191","394","39","624","997","0","62.59","19.16"
"10","005","00","006","0604","0231","434","132","302","17","451","913","0","49.4","14.46"
"10","005","00","006","0605","0000","1191","337","854","93","1284","2304","0","55.73","14.63"
"10","005","00","006","0605","0246","593","148","445","34","627","1107","0","56.64","13.37"
"10","005","00","006","0605","0247","598","189","409","59","657","1197","0","54.89","15.79"
"10","005","00","006","0606","0000","794","211","583","57","851","1216","0","69.98","17.35"
"10","005","00","006","0606","0236","794","211","583","57","851","1216","0","69.98","17.35"
"10","005","00","006","0607","0000","498","156","342","35","533","977","0","54.55","15.97"
"10","005","00","006","0607","0237","498","156","342","35","533","977","0","54.55","15.97"
"10","005","00","006","0608","0000","1342","400","942","130","1472","2704","0","54.44","14.79"
"10","005","00","006","0608","0238","442","145","297","35","477","943","0","50.58","15.38"
"10","005","00","006","0608","0239","461","131","330","61","522","910","0","57.36","14.4"
"10","005","00","006","0608","0240","439","124","315","34","473","851","0","55.58","14.57"
"10","005","00","006","0609","0000","787","288","499","60","847","1375","0","61.6","20.95"
"10","005","00","006","0609","0241","437","169","268","22","459","725","0","63.31","23.31"
"10","005","00","006","0609","0242","350","119","231","38","388","650","0","59.69","18.31"
"10","005","00","006","0610","0000","321","101","220","46","367","706","0","51.98","14.31"
"10","005","00","006","0610","0243","321","101","220","46","367","706","0","51.98","14.31"
"10","005","00","006","0611","0000","730","239","491","60","790","1489","0","53.06","16.05"
"10","005","00","006","0611","0232","309","93","216","29","338","641","0","52.73","14.51"
"10","005","00","006","0611","0233","421","146","275","31","452","848","0","53.3","17.22"
"10","005","00","006","0612","0000","744","224","520","71","815","1549","0","52.61","14.46"
"10","005","00","006","0612","0244","399","120","279","37","436","748","0","58.29","16.04"
"10","005","00","006","0612","0245","345","104","241","34","379","801","0","47.32","12.98"
"10","005","00","006","0613","0000","627","212","415","73","700","1264","0","55.38","16.77"
"10","005","00","006","0613","0234","627","212","415","73","700","1264","0","55.38","16.77"
"10","005","00","006","0614","0000","459","142","317","46","505","965","0","52.33","14.72"
"10","005","00","006","0614","0235","459","142","317","46","505","965","0","52.33","14.72"
"10","005","00","006","0615","0000","483","122","361","45","528","1036","0","50.97","11.78"
"10","005","00","006","0615","0248","483","122","361","45","528","1036","0","50.97","11.78"
"10","005","00","006","0616","0000","397","116","281","28","425","913","0","46.55","12.71"
"10","005","00","006","0616","0249","397","116","281","28","425","913","0","46.55","12.71"
"10","005","00","006","0617","0000","400","114","286","40","440","719","0","61.2","15.86"
"10","005","00","006","0617","0250","400","114","286","40","440","719","0","61.2","15.86"
"10","005","00","006","0618","0000","520","137","383","79","599","1037","0","57.76","13.21"
"10","005","00","006","0618","0251","520","137","383","79","599","1037","0","57.76","13.21"
"10","005","00","006","0619","0000","294","107","187","14","308","601","0","51.25","17.8"
"10","005","00","006","0619","0252","294","107","187","14","308","601","0","51.25","17.8"
"10","005","00","006","0620","0000","546","170","376","35","581","1269","0","45.78","13.4"
"10","005","00","006","0620","0253","546","170","376","35","581","1269","0","45.78","13.4"
"10","005","00","006","0621","0000","338","98","240","29","367","735","0","49.93","13.33"
"10","005","00","006","0621","0254","338","98","240","29","367","735","0","49.93","13.33"
"10","005","00","006","0622","0000","468","145","323","36","504","1047","0","48.14","13.85"
"10","005","00","006","0622","0255","131","39","92","14","145","422","0","34.36","9.24"
"10","005","00","006","0622","0256","337","106","231","22","359","625","0","57.44","16.96"
"10","005","00","006","0623","0000","522","126","396","52","574","1234","0","46.52","10.21"
"10","005","00","006","0623","0257","522","126","396","52","574","1234","0","46.52","10.21"
"10","005","00","007","0000","0000","8083","2341","5742","604","8687","14772","16818","58.81","15.85"
"10","005","00","007","0701","0000","434","121","313","25","459","745","0","61.61","16.24"
"10","005","00","007","0701","0445","434","121","313","25","459","745","0","61.61","16.24"
"10","005","00","007","0702","0000","767","221","546","39","806","1528","0","52.75","14.46"
"10","005","00","007","0702","0446","404","101","303","27","431","783","0","55.04","12.9"
"10","005","00","007","0702","0447","363","120","243","12","375","745","0","50.34","16.11"
"10","005","00","007","0703","0000","1190","315","875","111","1301","2079","0","62.58","15.15"
"10","005","00","007","0703","0451","497","131","366","39","536","865","0","61.97","15.14"
"10","005","00","007","0703","0452","471","118","353","51","522","828","0","63.04","14.25"
"10","005","00","007","0703","0453","222","66","156","21","243","386","0","62.95","17.1"
"10","005","00","007","0704","0000","509","143","366","19","528","999","0","52.85","14.31"
"10","005","00","007","0704","0448","509","143","366","19","528","999","0","52.85","14.31"
"10","005","00","007","0705","0000","431","114","317","35","466","757","0","61.56","15.06"
"10","005","00","007","0705","0449","385","110","275","33","418","671","0","62.3","16.39"
"10","005","00","007","0705","0459","46","4","42","2","48","86","0","55.81","4.65"
"10","005","00","007","0706","0000","506","133","373","16","522","940","0","55.53","14.15"
"10","005","00","007","0706","0460","506","133","373","16","522","940","0","55.53","14.15"
"10","005","00","007","0707","0000","1072","325","747","94","1166","1978","0","58.95","16.43"
"10","005","00","007","0707","0442","548","156","392","40","588","961","0","61.19","16.23"
"10","005","00","007","0707","0443","524","169","355","54","578","1017","0","56.83","16.62"
"10","005","00","007","0708","0000","644","204","440","59","703","1095","0","64.2","18.63"
"10","005","00","007","0708","0444","644","204","440","59","703","1095","0","64.2","18.63"
"10","005","00","007","0709","0000","1269","405","864","101","1370","2209","0","62.02","18.33"
"10","005","00","007","0709","0454","405","132","273","39","444","688","0","64.53","19.19"
"10","005","00","007","0709","0455","456","156","300","36","492","792","0","62.12","19.7"
"10","005","00","007","0709","0456","408","117","291","26","434","729","0","59.53","16.05"
"10","005","00","007","0710","0000","422","116","306","61","483","734","0","65.8","15.8"
"10","005","00","007","0710","0450","422","116","306","61","483","734","0","65.8","15.8"
"10","005","00","007","0711","0000","839","244","595","44","883","1708","0","51.7","14.29"
"10","005","00","007","0711","0457","498","161","337","30","528","1093","0","48.31","14.73"
"10","005","00","007","0711","0458","341","83","258","14","355","615","0","57.72","13.5"
"10","005","00","008","0000","0000","6227","1898","4329","534","6761","12653","14521","53.43","15.0"
"10","005","00","008","0801","0000","826","373","453","69","895","1625","0","55.08","22.95"
"10","005","00","008","0801","0420","370","231","139","38","408","744","0","54.84","31.05"
"10","005","00","008","0801","0421","456","142","314","31","487","881","0","55.28","16.12"
"10","005","00","008","0802","0000","307","92","215","33","340","596","0","57.05","15.44"
"10","005","00","008","0802","0422","307","92","215","33","340","596","0","57.05","15.44"
"10","005","00","008","0803","0000","924","252","672","46","970","1790","0","54.19","14.08"
"10","005","00","008","0803","0424","434","112","322","22","456","867","0","52.6","12.92"
"10","005","00","008","0803","0425","490","140","350","24","514","923","0","55.69","15.17"
"10","005","00","008","0804","0000","652","179","473","84","736","1395","0","52.76","12.83"
"10","005","00","008","0804","0426","652","179","473","84","736","1395","0","52.76","12.83"
"10","005","00","008","0805","0000","196","62","134","19","215","561","0","38.32","11.05"
"10","005","00","008","0805","0427","196","62","134","19","215","561","0","38.32","11.05"
"10","005","00","008","0806","0000","602","191","411","52","654","1260","0","51.9","15.16"
"10","005","00","008","0806","0423","602","191","411","52","654","1260","0","51.9","15.16"
"10","005","00","008","0807","0000","354","92","262","19","373","638","0","58.46","14.42"
"10","005","00","008","0807","0428","354","92","262","19","373","638","0","58.46","14.42"
"10","005","00","008","0808","0000","719","219","500","56","775","1495","0","51.84","14.65"
"10","005","00","008","0808","0431","330","111","219","29","359","652","0","55.06","17.02"
"10","005","00","008","0808","0432","389","108","281","27","416","843","0","49.35","12.81"
"10","005","00","008","0809","0000","365","120","245","34","399","754","0","52.92","15.92"
"10","005","00","008","0809","0429","365","120","245","34","399","754","0","52.92","15.92"
"10","005","00","008","0810","0000","233","57","176","15","248","501","0","49.5","11.38"
"10","005","00","008","0810","0430","233","57","176","15","248","501","0","49.5","11.38"
"10","005","00","008","0811","0000","501","132","369","76","577","1020","0","56.57","12.94"
"10","005","00","008","0811","0433","501","132","369","76","577","1020","0","56.57","12.94"
"10","005","00","008","0812","0000","548","129","419","31","579","1018","0","56.88","12.67"
"10","005","00","008","0812","0434","548","129","419","31","579","1018","0","56.88","12.67"
"10","005","00","009","0000","0000","15558","4595","10963","1176","16734","28318","33327","59.09","16.23"
"10","005","00","009","0901","0000","984","298","686","68","1052","1581","0","66.54","18.85"
"10","005","00","009","0901","0068","484","149","335","40","524","789","0","66.41","18.88"
"10","005","00","009","0901","0069","500","149","351","28","528","792","0","66.67","18.81"
"10","005","00","009","0902","0000","1394","395","999","113","1507","2372","0","63.53","16.65"
"10","005","00","009","0902","0070","658","180","478","61","719","1117","0","64.37","16.11"
"10","005","00","009","0902","0071","736","215","521","52","788","1255","0","62.79","17.13"
"10","005","00","009","0903","0000","1961","585","1376","105","2066","3413","0","60.53","17.14"
"10","005","00","009","0903","0072","641","185","456","43","684","1141","0","59.95","16.21"
"10","005","00","009","0903","0073","653","212","441","34","687","1172","0","58.62","18.09"
"10","005","00","009","0903","0074","667","188","479","28","695","1100","0","63.18","17.09"
"10","005","00","009","0904","0000","510","154","356","44","554","964","0","57.47","15.98"
"10","005","00","009","0904","0079","510","154","356","44","554","964","0","57.47","15.98"
"10","005","00","009","0905","0000","1126","331","795","95","1221","2313","0","52.79","14.31"
"10","005","00","009","0905","0075","609","172","437","42","651","1232","0","52.84","13.96"
"10","005","00","009","0905","0076","517","159","358","53","570","1081","0","52.73","14.71"
"10","005","00","009","0906","0000","1326","387","939","81","1407","2331","0","60.36","16.6"
"10","005","00","009","0906","0077","737","209","528","39","776","1250","0","62.08","16.72"
"10","005","00","009","0906","0078","589","178","411","42","631","1081","0","58.37","16.47"
"10","005","00","009","0907","0000","809","247","562","57","866","1507","0","57.47","16.39"
"10","005","00","009","0907","0084","404","111","293","26","430","719","0","59.81","15.44"
"10","005","00","009","0907","0085","405","136","269","31","436","788","0","55.33","17.26"
"10","005","00","009","0908","0000","569","164","405","61","630","1038","0","60.69","15.8"
"10","005","00","009","0908","0080","569","164","405","61","630","1038","0","60.69","15.8"
"10","005","00","009","0909","0000","1062","318","744","89","1151","2031","0","56.67","15.66"
"10","005","00","009","0909","0082","449","126","323","49","498","865","0","57.57","14.57"
"10","005","00","009","0909","0083","613","192","421","40","653","1166","0","56.0","16.47"
"10","005","00","009","0910","0000","174","53","121","29","203","303","0","67.0","17.49"
"10","005","00","009","0910","0086","174","53","121","29","203","303","0","67.0","17.49"
"10","005","00","009","0911","0000","209","66","143","17","226","360","0","62.78","18.33"
"10","005","00","009","0911","0081","209","66","143","17","226","360","0","62.78","18.33"
"10","005","00","009","0912","0000","1246","373","873","85","1331","2255","0","59.02","16.54"
"10","005","00","009","0912","0087","756","230","526","40","796","1322","0","60.21","17.4"
"10","005","00","009","0912","0088","490","143","347","45","535","933","0","57.34","15.33"
"10","005","00","009","0913","0000","725","211","514","66","791","1455","0","54.36","14.5"
"10","005","00","009","0913","0089","725","211","514","66","791","1455","0","54.36","14.5"
"10","005","00","009","0914","0000","921","288","633","77","998","1615","0","61.8","17.83"
"10","005","00","009","0914","0090","921","288","633","77","998","1615","0","61.8","17.83"
"10","005","00","009","0915","0000","747","201","546","59","806","1451","0","55.55","13.85"
"10","005","00","009","0915","0091","747","201","546","59","806","1451","0","55.55","13.85"
"10","005","00","009","0916","0000","685","200","485","52","737","1317","0","55.96","15.19"
"10","005","00","009","0916","0093","685","200","485","52","737","1317","0","55.96","15.19"
"10","005","00","009","0917","0000","824","249","575","58","882","1462","0","60.33","17.03"
"10","005","00","009","0917","0092","824","249","575","58","882","1462","0","60.33","17.03"
"10","005","00","009","0918","0000","124","39","85","7","131","221","0","59.28","17.65"
"10","005","00","009","0918","0094","124","39","85","7","131","221","0","59.28","17.65"
"10","005","00","009","0919","0000","162","36","126","13","175","329","0","53.19","10.94"
"10","005","00","009","0919","0095","162","36","126","13","175","329","0","53.19","10.94"
"10","005","00","010","0000","0000","8146","2346","5800","502","8648","15424","17922","56.07","15.21"
"10","005","00","010","1001","0000","566","140","426","31","597","1029","0","58.02","13.61"
"10","005","00","010","1001","0114","566","140","426","31","597","1029","0","58.02","13.61"
"10","005","00","010","1002","0000","2539","724","1815","138","2677","4463","0","59.98","16.22"
"10","005","00","010","1002","0108","518","139","379","30","548","887","0","61.78","15.67"
"10","005","00","010","1002","0109","601","163","438","31","632","1052","0","60.08","15.49"
"10","005","00","010","1002","0110","786","250","536","39","825","1347","0","61.25","18.56"
"10","005","00","010","1002","0111","634","172","462","38","672","1177","0","57.09","14.61"
"10","005","00","010","1003","0000","949","286","663","43","992","1655","0","59.94","17.28"
"10","005","00","010","1003","0115","504","147","357","20","524","905","0","57.9","16.24"
"10","005","00","010","1003","0116","445","139","306","23","468","750","0","62.4","18.53"
"10","005","00","010","1004","0000","645","193","452","38","683","1268","0","53.86","15.22"
"10","005","00","010","1004","0112","645","193","452","38","683","1268","0","53.86","15.22"
"10","005","00","010","1005","0000","551","189","362","32","583","1185","0","49.2","15.95"
"10","005","00","010","1005","0113","551","189","362","32","583","1185","0","49.2","15.95"
"10","005","00","010","1006","0000","521","120","401","35","556","1080","0","51.48","11.11"
"10","005","00","010","1006","0117","521","120","401","35","556","1080","0","51.48","11.11"
"10","005","00","010","1007","0000","1593","484","1109","111","1704","3186","0","53.48","15.19"
"10","005","00","010","1007","0118","554","156","398","48","602","1108","0","54.33","14.08"
"10","005","00","010","1007","0119","428","145","283","28","456","862","0","52.9","16.82"
"10","005","00","010","1007","0120","611","183","428","35","646","1216","0","53.13","15.05"
"10","005","00","010","1008","0000","277","69","208","27","304","588","0","51.7","11.73"
"10","005","00","010","1008","0121","277","69","208","27","304","588","0","51.7","11.73"
"10","005","00","010","1009","0000","210","59","151","25","235","429","0","54.78","13.75"
"10","005","00","010","1009","0122","210","59","151","25","235","429","0","54.78","13.75"
"10","005","00","010","1010","0000","295","82","213","22","317","541","0","58.6","15.16"
"10","005","00","010","1010","0123","295","82","213","22","317","541","0","58.6","15.16"
"10","005","00","011","0000","0000","4069","1189","2880","270","4339","8784","10130","49.4","13.54"
"10","005","00","011","1101","0000","589","179","410","55","644","1155","0","55.76","15.5"
"10","005","00","011","1101","0411","589","179","410","55","644","1155","0","55.76","15.5"
"10","005","00","011","1102","0000","350","111","239","22","372","650","0","57.23","17.08"
"10","005","00","011","1102","0412","350","111","239","22","372","650","0","57.23","17.08"
"10","005","00","011","1103","0000","652","178","474","47","699","1353","0","51.66","13.16"
"10","005","00","011","1103","0413","652","178","474","47","699","1353","0","51.66","13.16"
"10","005","00","011","1104","0000","330","99","231","25","355","813","0","43.67","12.18"
"10","005","00","011","1104","0414","330","99","231","25","355","813","0","43.67","12.18"
"10","005","00","011","1105","0000","326","82","244","33","359","837","0","42.89","9.8"
"10","005","00","011","1105","0415","326","82","244","33","359","837","0","42.89","9.8"
"10","005","00","011","1106","0000","543","157","386","29","572","1093","0","52.33","14.36"
"10","005","00","011","1106","0416","543","157","386","29","572","1093","0","52.33","14.36"
"10","005","00","011","1107","0000","546","170","376","27","573","1048","0","54.68","16.22"
"10","005","00","011","1107","0417","546","170","376","27","573","1048","0","54.68","16.22"
"10","005","00","011","1108","0000","423","126","297","22","445","872","0","51.03","14.45"
"10","005","00","011","1108","0418","423","126","297","22","445","872","0","51.03","14.45"
"10","005","00","011","1109","0000","310","87","223","10","320","963","0","33.23","9.03"
"10","005","00","011","1109","0419","310","87","223","10","320","963","0","33.23","9.03"
"10","005","00","012","0000","0000","5778","1691","4087","346","6124","9390","10711","65.22","18.01"
"10","005","00","012","1201","0000","1604","433","1171","118","1722","2503","0","68.8","17.3"
"10","005","00","012","1201","0096","841","222","619","52","893","1335","0","66.89","16.63"
"10","005","00","012","1201","0097","763","211","552","66","829","1168","0","70.98","18.07"
"10","005","00","012","1202","0000","1084","364","720","43","1127","1851","0","60.89","19.67"
"10","005","00","012","1202","0103","483","160","323","21","504","844","0","59.72","18.96"
"10","005","00","012","1202","0104","601","204","397","22","623","1007","0","61.87","20.26"
"10","005","00","012","1203","0000","435","105","330","29","464","725","0","64.0","14.48"
"10","005","00","012","1203","0100","435","105","330","29","464","725","0","64.0","14.48"
"10","005","00","012","1204","0000","1104","344","760","74","1178","1710","0","68.89","20.12"
"10","005","00","012","1204","0098","486","136","350","34","520","792","0","65.66","17.17"
"10","005","00","012","1204","0099","618","208","410","40","658","918","0","71.68","22.66"
"10","005","00","012","1205","0000","536","145","391","19","555","899","0","61.74","16.13"
"10","005","00","012","1205","0101","536","145","391","19","555","899","0","61.74","16.13"
"10","005","00","012","1206","0000","175","51","124","7","182","369","0","49.32","13.82"
"10","005","00","012","1206","0102","175","51","124","7","182","369","0","49.32","13.82"
"10","005","00","012","1207","0000","621","193","428","37","658","1005","0","65.47","19.2"
"10","005","00","012","1207","0105","478","149","329","24","502","794","0","63.22","18.77"
"10","005","00","012","1207","0106","143","44","99","13","156","211","0","73.93","20.85"
"10","005","00","012","1208","0000","219","56","163","19","238","328","0","72.56","17.07"
"10","005","00","012","1208","0107","219","56","163","19","238","328","0","72.56","17.07"
"10","005","00","013","0000","0000","7749","2166","5583","402","8151","13889","16277","58.69","15.6"
"10","005","00","013","1301","0000","2319","635","1684","113","2432","4132","0","58.86","15.37"
"10","005","00","013","1301","0124","488","126","362","35","523","853","0","61.31","14.77"
"10","005","00","013","1301","0125","591","158","433","20","611","983","0","62.16","16.07"
"10","005","00","013","1301","0126","610","170","440","37","647","1080","0","59.91","15.74"
"10","005","00","013","1301","0127","630","181","449","21","651","1216","0","53.54","14.88"
"10","005","00","013","1302","0000","965","268","697","49","1014","1825","0","55.56","14.68"
"10","005","00","013","1302","0132","494","146","348","30","524","991","0","52.88","14.73"
"10","005","00","013","1302","0133","471","122","349","19","490","834","0","58.75","14.63"
"10","005","00","013","1303","0000","761","234","527","65","826","1371","0","60.25","17.07"
"10","005","00","013","1303","0134","339","105","234","28","367","622","0","59.0","16.88"
"10","005","00","013","1303","0135","422","129","293","37","459","749","0","61.28","17.22"
"10","005","00","013","1304","0000","1847","489","1358","73","1920","3395","0","56.55","14.4"
"10","005","00","013","1304","0128","566","136","430","38","604","1017","0","59.39","13.37"
"10","005","00","013","1304","0129","617","171","446","15","632","1180","0","53.56","14.49"
"10","005","00","013","1304","0130","664","182","482","20","684","1198","0","57.1","15.19"
"10","005","00","013","1305","0000","949","274","675","46","995","1451","0","68.57","18.88"
"10","005","00","013","1305","0136","437","128","309","23","460","692","0","66.47","18.5"
"10","005","00","013","1305","0137","512","146","366","23","535","759","0","70.49","19.24"
"10","005","00","013","1306","0000","232","56","176","10","242","417","0","58.03","13.43"
"10","005","00","013","1306","0131","232","56","176","10","242","417","0","58.03","13.43"
"10","005","00","013","1307","0000","676","210","466","46","722","1298","0","55.62","16.18"
"10","005","00","013","1307","0138","311","95","216","25","336","629","0","53.42","15.1"
"10","005","00","013","1307","0139","365","115","250","21","386","669","0","57.7","17.19"
"10","005","00","014","0000","0000","3275","987","2288","253","3528","6382","7072","55.28","15.47"
"10","005","00","014","1401","0000","305","102","203","24","329","601","0","54.74","16.97"
"10","005","00","014","1401","0140","305","102","203","24","329","601","0","54.74","16.97"
"10","005","00","014","1402","0000","318","90","228","23","341","566","0","60.25","15.9"
"10","005","00","014","1402","0141","318","90","228","23","341","566","0","60.25","15.9"
"10","005","00","014","1403","0000","451","125","326","39","490","843","0","58.13","14.83"
"10","005","00","014","1403","0142","451","125","326","39","490","843","0","58.13","14.83"
"10","005","00","014","1404","0000","317","102","215","25","342","648","0","52.78","15.74"
"10","005","00","014","1404","0143","317","102","215","25","342","648","0","52.78","15.74"
"10","005","00","014","1405","0000","274","74","200","20","294","515","0","57.09","14.37"
"10","005","00","014","1405","0146","274","74","200","20","294","515","0","57.09","14.37"
"10","005","00","014","1406","0000","235","82","153","13","248","461","0","53.8","17.79"
"10","005","00","014","1406","0145","235","82","153","13","248","461","0","53.8","17.79"
"10","005","00","014","1407","0000","440","142","298","33","473","936","0","50.53","15.17"
"10","005","00","014","1407","0144","440","142","298","33","473","936","0","50.53","15.17"
"10","005","00","014","1408","0000","566","149","417","49","615","1141","0","53.9","13.06"
"10","005","00","014","1408","0147","566","149","417","49","615","1141","0","53.9","13.06"
"10","005","00","014","1409","0000","369","121","248","27","396","671","0","59.02","18.03"
"10","005","00","014","1409","0148","369","121","248","27","396","671","0","59.02","18.03"
"10","005","00","015","0000","0000","5920","1696","4224","499","6419","11027","12728","58.21","15.38"
"10","005","00","015","1501","0000","1217","324","893","77","1294","2060","0","62.82","15.73"
"10","005","00","015","1501","0258","717","207","510","49","766","1171","0","65.41","17.68"
"10","005","00","015","1501","0259","500","117","383","28","528","889","0","59.39","13.16"
"10","005","00","015","1502","0000","219","54","165","18","237","479","0","49.48","11.27"
"10","005","00","015","1502","0260","219","54","165","18","237","479","0","49.48","11.27"
"10","005","00","015","1503","0000","554","132","422","49","603","1024","0","58.89","12.89"
"10","005","00","015","1503","0261","554","132","422","49","603","1024","0","58.89","12.89"
"10","005","00","015","1504","0000","1676","514","1162","148","1824","3442","0","52.99","14.93"
"10","005","00","015","1504","0262","595","200","395","62","657","1214","0","54.12","16.47"
"10","005","00","015","1504","0263","531","151","380","29","560","1071","0","52.29","14.1"
"10","005","00","015","1504","0264","550","163","387","57","607","1157","0","52.46","14.09"
"10","005","00","015","1505","0000","271","76","195","30","301","512","0","58.79","14.84"
"10","005","00","015","1505","0265","271","76","195","30","301","512","0","58.79","14.84"
"10","005","00","015","1506","0000","294","84","210","16","310","491","0","63.14","17.11"
"10","005","00","015","1506","0266","294","84","210","16","310","491","0","63.14","17.11"
"10","005","00","015","1507","0000","713","211","502","53","766","1272","0","60.22","16.59"
"10","005","00","015","1507","0267","713","211","502","53","766","1272","0","60.22","16.59"
"10","005","00","015","1508","0000","419","115","304","32","451","785","0","57.45","14.65"
"10","005","00","015","1508","0268","419","115","304","32","451","785","0","57.45","14.65"
"10","005","00","015","1509","0000","557","186","371","76","633","962","0","65.8","19.33"
"10","005","00","015","1509","0269","557","186","371","76","633","962","0","65.8","19.33"
"10","005","00","016","0000","0000","3108","855","2253","280","3388","5852","6662","57.89","14.61"
"10","005","00","016","1601","0000","1211","343","868","78","1289","2201","0","58.56","15.58"
"10","005","00","016","1601","0402","569","152","417","27","596","996","0","59.84","15.26"
"10","005","00","016","1601","0403","642","191","451","51","693","1205","0","57.51","15.85"
"10","005","00","016","1602","0000","346","92","254","41","387","635","0","60.94","14.49"
"10","005","00","016","1602","0404","346","92","254","41","387","635","0","60.94","14.49"
"10","005","00","016","1603","0000","454","126","328","43","497","862","0","57.66","14.62"
"10","005","00","016","1603","0405","454","126","328","43","497","862","0","57.66","14.62"
"10","005","00","016","1604","0000","106","26","80","12","118","238","0","49.58","10.92"
"10","005","00","016","1604","0406","106","26","80","12","118","238","0","49.58","10.92"
"10","005","00","016","1605","0000","266","76","190","28","294","541","0","54.34","14.05"
"10","005","00","016","1605","0407","266","76","190","28","294","541","0","54.34","14.05"
"10","005","00","016","1606","0000","275","79","196","25","300","578","0","51.9","13.67"
"10","005","00","016","1606","0408","275","79","196","25","300","578","0","51.9","13.67"
"10","005","00","016","1607","0000","245","60","185","34","279","405","0","68.89","14.81"
"10","005","00","016","1607","0409","245","60","185","34","279","405","0","68.89","14.81"
"10","005","00","016","1608","0000","205","53","152","19","224","392","0","57.14","13.52"
"10","005","00","016","1608","0410","205","53","152","19","224","392","0","57.14","13.52"
"10","005","00","017","0000","0000","1878","497","1381","161","2039","3968","4370","51.39","12.53"
"10","005","00","017","1701","0000","123","23","100","7","130","328","0","39.63","7.01"
"10","005","00","017","1701","0435","123","23","100","7","130","328","0","39.63","7.01"
"10","005","00","017","1702","0000","223","56","167","28","251","565","0","44.42","9.91"
"10","005","00","017","1702","0436","223","56","167","28","251","565","0","44.42","9.91"
"10","005","00","017","1703","0000","470","139","331","52","522","911","0","57.3","15.26"
"10","005","00","017","1703","0437","470","139","331","52","522","911","0","57.3","15.26"
"10","005","00","017","1704","0000","249","77","172","19","268","568","0","47.18","13.56"
"10","005","00","017","1704","0438","249","77","172","19","268","568","0","47.18","13.56"
"10","005","00","017","1705","0000","312","77","235","30","342","580","0","58.97","13.28"
"10","005","00","017","1705","0439","312","77","235","30","342","580","0","58.97","13.28"
"10","005","00","017","1706","0000","163","41","122","7","170","333","0","51.05","12.31"
"10","005","00","017","1706","0440","163","41","122","7","170","333","0","51.05","12.31"
"10","005","00","017","1707","0000","338","84","254","18","356","683","0","52.12","12.3"
"10","005","00","017","1707","0441","338","84","254","18","356","683","0","52.12","12.3"
"10","005","00","018","0000","0000","3267","777","2490","199","3466","5180","6076","66.91","15.0"
"10","005","00","018","1801","0000","149","41","108","6","155","325","0","47.69","12.62"
"10","005","00","018","1801","0461","149","41","108","6","155","325","0","47.69","12.62"
"10","005","00","018","1802","0000","730","177","553","48","778","1150","0","67.65","15.39"
"10","005","00","018","1802","0462","272","67","205","16","288","484","0","59.5","13.84"
"10","005","00","018","1802","0463","458","110","348","32","490","666","0","73.57","16.52"
"10","005","00","018","1803","0000","516","126","390","49","565","907","0","62.29","13.89"
"10","005","00","018","1803","0464","350","84","266","40","390","574","0","67.94","14.63"
"10","005","00","018","1803","0465","166","42","124","9","175","333","0","52.55","12.61"
"10","005","00","018","1804","0000","331","71","260","11","342","495","0","69.09","14.34"
"10","005","00","018","1804","0466","331","71","260","11","342","495","0","69.09","14.34"
"10","005","00","018","1805","0000","366","117","249","27","393","544","0","72.24","21.51"
"10","005","00","018","1805","0467","366","117","249","27","393","544","0","72.24","21.51"
"10","005","00","018","1806","0000","276","60","216","20","296","500","0","59.2","12.0"
"10","005","00","018","1806","0468","276","60","216","20","296","500","0","59.2","12.0"
"10","005","00","018","1807","0000","448","103","345","32","480","670","0","71.64","15.37"
"10","005","00","018","1807","0469","448","103","345","32","480","670","0","71.64","15.37"
"10","005","00","018","1808","0000","451","82","369","6","457","589","0","77.59","13.92"
"10","005","00","018","1808","0470","451","82","369","6","457","589","0","77.59","13.92"
"10","007","00","000","0000","0000","575613","177421","398192","38235","613848","1066994","1278437","57.53","16.63"
"10","007","00","001","0000","0000","109784","35239","74545","5749","115533","190995","232709","60.49","18.45"
"10","007","00","001","0101","0000","796","249","547","35","831","1295","0","64.17","19.23"
"10","007","00","001","0101","0117","408","136","272","19","427","662","0","64.5","20.54"
"10","007","00","001","0101","0118","388","113","275","16","404","633","0","63.82","17.85"
"10","007","00","001","0102","0000","2987","895","2092","116","3103","5001","0","62.05","17.9"
"10","007","00","001","0102","0125","739","231","508","35","774","1263","0","61.28","18.29"
"10","007","00","001","0102","0126","763","218","545","35","798","1268","0","62.93","17.19"
"10","007","00","001","0102","0127","744","223","521","30","774","1258","0","61.53","17.73"
"10","007","00","001","0102","0128","741","223","518","16","757","1212","0","62.46","18.4"
"10","007","00","001","0103","0000","961","339","622","44","1005","1656","0","60.69","20.47"
"10","007","00","001","0103","0112","466","171","295","18","484","781","0","61.97","21.9"
"10","007","00","001","0103","0113","495","168","327","26","521","875","0","59.54","19.2"
"10","007","00","001","0104","0000","462","141","321","24","486","816","0","59.56","17.28"
"10","007","00","001","0104","0114","462","141","321","24","486","816","0","59.56","17.28"
"10","007","00","001","0105","0000","857","276","581","56","913","1414","0","64.57","19.52"
"10","007","00","001","0105","0115","411","136","275","28","439","687","0","63.9","19.8"
"10","007","00","001","0105","0116","446","140","306","28","474","727","0","65.2","19.26"
"10","007","00","001","0106","0000","1030","332","698","58","1088","1759","0","61.85","18.87"
"10","007","00","001","0106","0119","558","187","371","33","591","906","0","65.23","20.64"
"10","007","00","001","0106","0120","472","145","327","25","497","853","0","58.26","17.0"
"10","007","00","001","0107","0000","2405","742","1663","109","2514","3986","0","63.07","18.62"
"10","007","00","001","0107","0121","615","190","425","31","646","1027","0","62.9","18.5"
"10","007","00","001","0107","0122","606","186","420","32","638","993","0","64.25","18.73"
"10","007","00","001","0107","0123","487","148","339","34","521","848","0","61.44","17.45"
"10","007","00","001","0107","0124","697","218","479","12","709","1118","0","63.42","19.5"
"10","007","00","001","0108","0000","2925","935","1990","89","3014","5156","0","58.46","18.13"
"10","007","00","001","0108","0106","691","216","475","6","697","1156","0","60.29","18.69"
"10","007","00","001","0108","0107","714","213","501","39","753","1235","0","60.97","17.25"
"10","007","00","001","0108","0108","746","248","498","37","783","1376","0","56.9","18.02"
"10","007","00","001","0108","0109","774","258","516","7","781","1389","0","56.23","18.57"
"10","007","00","001","0109","0000","1065","315","750","55","1120","1705","0","65.69","18.48"
"10","007","00","001","0109","0110","531","163","368","29","560","846","0","66.19","19.27"
"10","007","00","001","0109","0111","534","152","382","26","560","859","0","65.19","17.69"
"10","007","00","001","0110","0000","1036","315","721","56","1092","1883","0","57.99","16.73"
"10","007","00","001","0110","0104","512","153","359","21","533","975","0","54.67","15.69"
"10","007","00","001","0110","0105","524","162","362","35","559","908","0","61.56","17.84"
"10","007","00","001","0111","0000","480","160","320","21","501","773","0","64.81","20.7"
"10","007","00","001","0111","0103","480","160","320","21","501","773","0","64.81","20.7"
"10","007","00","001","0112","0000","829","293","536","56","885","1420","0","62.32","20.63"
"10","007","00","001","0112","0101","418","136","282","29","447","692","0","64.6","19.65"
"10","007","00","001","0112","0102","411","157","254","27","438","728","0","60.16","21.57"
"10","007","00","001","0113","0000","540","191","349","36","576","893","0","64.5","21.39"
"10","007","00","001","0113","0099","540","191","349","36","576","893","0","64.5","21.39"
"10","007","00","001","0114","0000","446","162","284","23","469","691","0","67.87","23.44"
"10","007","00","001","0114","0098","446","162","284","23","469","691","0","67.87","23.44"
"10","007","00","001","0115","0000","423","129","294","36","459","733","0","62.62","17.6"
"10","007","00","001","0115","0100","423","129","294","36","459","733","0","62.62","17.6"
"10","007","00","001","0116","0000","506","179","327","56","562","910","0","61.76","19.67"
"10","007","00","001","0116","0054","506","179","327","56","562","910","0","61.76","19.67"
"10","007","00","001","0117","0000","465","162","303","34","499","771","0","64.72","21.01"
"10","007","00","001","0117","0051","465","162","303","34","499","771","0","64.72","21.01"
"10","007","00","001","0118","0000","500","180","320","33","533","868","0","61.41","20.74"
"10","007","00","001","0118","0052","500","180","320","33","533","868","0","61.41","20.74"
"10","007","00","001","0119","0000","640","218","422","48","688","1135","0","60.62","19.21"
"10","007","00","001","0119","0053","640","218","422","48","688","1135","0","60.62","19.21"
"10","007","00","001","0120","0000","2052","671","1381","105","2157","3360","0","64.2","19.97"
"10","007","00","001","0120","0056","633","227","406","41","674","1077","0","62.58","21.08"
"10","007","00","001","0120","0057","784","256","528","43","827","1258","0","65.74","20.35"
"10","007","00","001","0120","0058","635","188","447","21","656","1025","0","64.0","18.34"
"10","007","00","001","0121","0000","2130","657","1473","95","2225","3648","0","60.99","18.01"
"10","007","00","001","0121","0059","715","228","487","33","748","1177","0","63.55","19.37"
"10","007","00","001","0121","0060","699","216","483","25","724","1262","0","57.37","17.12"
"10","007","00","001","0121","0061","716","213","503","37","753","1209","0","62.28","17.62"
"10","007","00","001","0122","0000","656","215","441","48","704","1203","0","58.52","17.87"
"10","007","00","001","0122","0065","656","215","441","48","704","1203","0","58.52","17.87"
"10","007","00","001","0123","0000","1829","571","1258","98","1927","3145","0","61.27","18.16"
"10","007","00","001","0123","0062","627","221","406","34","661","1041","0","63.5","21.23"
"10","007","00","001","0123","0063","647","184","463","26","673","1075","0","62.6","17.12"
"10","007","00","001","0123","0064","555","166","389","38","593","1029","0","57.63","16.13"
"10","007","00","001","0124","0000","2262","684","1578","95","2357","4157","0","56.7","16.45"
"10","007","00","001","0124","0066","566","158","408","26","592","1014","0","58.38","15.58"
"10","007","00","001","0124","0067","622","198","424","25","647","1069","0","60.52","18.52"
"10","007","00","001","0124","0068","504","157","347","20","524","969","0","54.08","16.2"
"10","007","00","001","0124","0069","570","171","399","24","594","1105","0","53.76","15.48"
"10","007","00","001","0125","0000","606","212","394","24","630","1004","0","62.75","21.12"
"10","007","00","001","0125","0055","606","212","394","24","630","1004","0","62.75","21.12"
"10","007","00","001","0126","0000","1959","678","1281","133","2092","3496","0","59.84","19.39"
"10","007","00","001","0126","0090","661","234","427","37","698","1201","0","58.12","19.48"
"10","007","00","001","0126","0091","624","232","392","40","664","1057","0","62.82","21.95"
"10","007","00","001","0126","0092","674","212","462","56","730","1238","0","58.97","17.12"
"10","007","00","001","0127","0000","1183","338","845","102","1285","2130","0","60.33","15.87"
"10","007","00","001","0127","0088","631","176","455","55","686","1153","0","59.5","15.26"
"10","007","00","001","0127","0089","552","162","390","47","599","977","0","61.31","16.58"
"10","007","00","001","0128","0000","1028","297","731","67","1095","1799","0","60.87","16.51"
"10","007","00","001","0128","0086","442","136","306","29","471","799","0","58.95","17.02"
"10","007","00","001","0128","0087","586","161","425","38","624","1000","0","62.4","16.1"
"10","007","00","001","0129","0000","1828","573","1255","71","1899","3091","0","61.44","18.54"
"10","007","00","001","0129","0083","524","148","376","25","549","890","0","61.69","16.63"
"10","007","00","001","0129","0084","690","222","468","27","717","1104","0","64.95","20.11"
"10","007","00","001","0129","0085","614","203","411","19","633","1097","0","57.7","18.51"
"10","007","00","001","0130","0000","1967","619","1348","110","2077","3297","0","63.0","18.77"
"10","007","00","001","0130","0093","707","206","501","40","747","1210","0","61.74","17.02"
"10","007","00","001","0130","0094","608","186","422","28","636","1026","0","61.99","18.13"
"10","007","00","001","0130","0095","652","227","425","42","694","1061","0","65.41","21.39"
"10","007","00","001","0131","0000","2508","815","1693","136","2644","4213","0","62.76","19.34"
"10","007","00","001","0131","0070","597","187","410","35","632","981","0","64.42","19.06"
"10","007","00","001","0131","0071","638","217","421","54","692","1095","0","63.2","19.82"
"10","007","00","001","0131","0072","657","192","465","22","679","1087","0","62.47","17.66"
"10","007","00","001","0131","0073","616","219","397","25","641","1050","0","61.05","20.86"
"10","007","00","001","0132","0000","1377","445","932","87","1464","2545","0","57.52","17.49"
"10","007","00","001","0132","0001","464","121","343","26","490","871","0","56.26","13.89"
"10","007","00","001","0132","0002","337","109","228","29","366","751","0","48.74","14.51"
"10","007","00","001","0132","0003","576","215","361","32","608","923","0","65.87","23.29"
"10","007","00","001","0133","0000","1423","516","907","77","1500","2477","0","60.56","20.83"
"10","007","00","001","0133","0096","683","240","443","42","725","1213","0","59.77","19.79"
"10","007","00","001","0133","0097","740","276","464","35","775","1264","0","61.31","21.84"
"10","007","00","001","0134","0000","898","344","554","68","966","1558","0","62.0","22.08"
"10","007","00","001","0134","0004","445","167","278","40","485","779","0","62.26","21.44"
"10","007","00","001","0134","0005","453","177","276","28","481","779","0","61.75","22.72"
"10","007","00","001","0135","0000","561","205","356","26","587","1027","0","57.16","19.96"
"10","007","00","001","0135","0010","561","205","356","26","587","1027","0","57.16","19.96"
"10","007","00","001","0136","0000","663","211","452","49","712","1249","0","57.01","16.89"
"10","007","00","001","0136","0011","663","211","452","49","712","1249","0","57.01","16.89"
"10","007","00","001","0137","0000","1084","332","752","78","1162","1814","0","64.06","18.3"
"10","007","00","001","0137","0008","473","143","330","29","502","767","0","65.45","18.64"
"10","007","00","001","0137","0009","611","189","422","49","660","1047","0","63.04","18.05"
"10","007","00","001","0138","0000","838","291","547","41","879","1469","0","59.84","19.81"
"10","007","00","001","0138","0006","411","139","272","20","431","720","0","59.86","19.31"
"10","007","00","001","0138","0007","427","152","275","21","448","749","0","59.81","20.29"
"10","007","00","001","0139","0000","4359","1495","2864","188","4547","7563","0","60.12","19.77"
"10","007","00","001","0139","0035","561","189","372","32","593","1045","0","56.75","18.09"
"10","007","00","001","0139","0036","633","226","407","14","647","1097","0","58.98","20.6"
"10","007","00","001","0139","0037","660","228","432","33","693","1190","0","58.24","19.16"
"10","007","00","001","0139","0038","666","241","425","26","692","1106","0","62.57","21.79"
"10","007","00","001","0139","0039","643","193","450","20","663","1097","0","60.44","17.59"
"10","007","00","001","0139","0040","603","203","400","38","641","1048","0","61.16","19.37"
"10","007","00","001","0139","0041","593","215","378","25","618","980","0","63.06","21.94"
"10","007","00","001","0140","0000","897","305","592","40","937","1516","0","61.81","20.12"
"10","007","00","001","0140","0042","433","145","288","14","447","707","0","63.22","20.51"
"10","007","00","001","0140","0043","464","160","304","26","490","809","0","60.57","19.78"
"10","007","00","001","0141","0000","2787","966","1821","127","2914","4896","0","59.52","19.73"
"10","007","00","001","0141","0025","652","213","439","41","693","1207","0","57.42","17.65"
"10","007","00","001","0141","0026","690","217","473","32","722","1161","0","62.19","18.69"
"10","007","00","001","0141","0027","640","249","391","25","665","1166","0","57.03","21.36"
"10","007","00","001","0141","0028","805","287","518","29","834","1362","0","61.23","21.07"
"10","007","00","001","0142","0000","4030","1477","2553","184","4214","7131","0","59.09","20.71"
"10","007","00","001","0142","0029","729","274","455","40","769","1236","0","62.22","22.17"
"10","007","00","001","0142","0030","600","200","400","43","643","1065","0","60.38","18.78"
"10","007","00","001","0142","0031","693","274","419","30","723","1199","0","60.3","22.85"
"10","007","00","001","0142","0032","717","267","450","26","743","1233","0","60.26","21.65"
"10","007","00","001","0142","0033","598","230","368","23","621","1245","0","49.88","18.47"
"10","007","00","001","0142","0034","693","232","461","22","715","1153","0","62.01","20.12"
"10","007","00","001","0143","0000","1613","563","1050","100","1713","2928","0","58.5","19.23"
"10","007","00","001","0143","0045","476","160","316","41","517","901","0","57.38","17.76"
"10","007","00","001","0143","0046","520","182","338","30","550","951","0","57.83","19.14"
"10","007","00","001","0143","0047","617","221","396","29","646","1076","0","60.04","20.54"
"10","007","00","001","0144","0000","1680","550","1130","88","1768","2932","0","60.3","18.76"
"10","007","00","001","0144","0048","568","170","398","20","588","1022","0","57.53","16.63"
"10","007","00","001","0144","0049","513","181","332","34","547","894","0","61.19","20.25"
"10","007","00","001","0144","0050","599","199","400","34","633","1016","0","62.3","19.59"
"10","007","00","001","0145","0000","829","257","572","40","869","1409","0","61.67","18.24"
"10","007","00","001","0145","0014","462","157","305","19","481","766","0","62.79","20.5"
"10","007","00","001","0145","0015","367","100","267","21","388","643","0","60.34","15.55"
"10","007","00","001","0146","0000","1195","378","817","60","1255","2552","0","49.18","14.81"
"10","007","00","001","0146","0016","704","209","495","39","743","1251","0","59.39","16.71"
"10","007","00","001","0146","0017","491","169","322","21","512","1301","0","39.35","12.99"
"10","007","00","001","0147","0000","5052","1620","3432","169","5221","8589","0","60.79","18.86"
"10","007","00","001","0147","0018","736","246","490","25","761","1280","0","59.45","19.22"
"10","007","00","001","0147","0019","699","213","486","30","729","1179","0","61.83","18.07"
"10","007","00","001","0147","0020","677","215","462","13","690","1168","0","59.08","18.41"
"10","007","00","001","0147","0021","686","177","509","32","718","1218","0","58.95","14.53"
"10","007","00","001","0147","0022","861","286","575","28","889","1351","0","65.8","21.17"
"10","007","00","001","0147","0023","691","251","440","25","716","1204","0","59.47","20.85"
"10","007","00","001","0147","0024","702","232","470","16","718","1189","0","60.39","19.51"
"10","007","00","001","0148","0000","1341","423","918","65","1406","2305","0","61.0","18.35"
"10","007","00","001","0148","0012","656","217","439","24","680","1136","0","59.86","19.1"
"10","007","00","001","0148","0013","685","206","479","41","726","1169","0","62.1","17.62"
"10","007","00","001","0149","0000","595","217","378","37","632","1008","0","62.7","21.53"
"10","007","00","001","0149","0044","595","217","378","37","632","1008","0","62.7","21.53"
"10","007","00","001","0150","0000","1803","533","1270","105","1908","3262","0","58.49","16.34"
"10","007","00","001","0150","0177","561","165","396","52","613","1002","0","61.18","16.47"
"10","007","00","001","0150","0178","627","177","450","22","649","1148","0","56.53","15.42"
"10","007","00","001","0150","0179","615","191","424","31","646","1112","0","58.09","17.18"
"10","007","00","001","0151","0000","966","277","689","78","1044","1685","0","61.96","16.44"
"10","007","00","001","0151","0153","469","122","347","38","507","800","0","63.38","15.25"
"10","007","00","001","0151","0154","497","155","342","40","537","885","0","60.68","17.51"
"10","007","00","001","0152","0000","1069","315","754","46","1115","1903","0","58.59","16.55"
"10","007","00","001","0152","0174","523","158","365","24","547","930","0","58.82","16.99"
"10","007","00","001","0152","0175","546","157","389","22","568","973","0","58.38","16.14"
"10","007","00","001","0153","0000","1846","582","1264","65","1911","3282","0","58.23","17.73"
"10","007","00","001","0153","0155","610","184","426","8","618","1000","0","61.8","18.4"
"10","007","00","001","0153","0156","622","203","419","28","650","1159","0","56.08","17.52"
"10","007","00","001","0153","0157","614","195","419","29","643","1123","0","57.26","17.36"
"10","007","00","001","0154","0000","1681","535","1146","128","1809","2908","0","62.21","18.4"
"10","007","00","001","0154","0158","560","191","369","43","603","907","0","66.48","21.06"
"10","007","00","001","0154","0159","522","153","369","41","563","989","0","56.93","15.47"
"10","007","00","001","0154","0160","599","191","408","44","643","1012","0","63.54","18.87"
"10","007","00","001","0155","0000","3729","1217","2512","255","3984","6789","0","58.68","17.93"
"10","007","00","001","0155","0168","582","175","407","37","619","1120","0","55.27","15.63"
"10","007","00","001","0155","0169","665","193","472","29","694","1269","0","54.69","15.21"
"10","007","00","001","0155","0170","669","192","477","37","706","1159","0","60.91","16.57"
"10","007","00","001","0155","0171","658","295","363","69","727","1184","0","61.4","24.92"
"10","007","00","001","0155","0172","596","191","405","38","634","1089","0","58.22","17.54"
"10","007","00","001","0155","0173","559","171","388","45","604","968","0","62.4","17.67"
"10","007","00","001","0156","0000","1373","402","971","81","1454","2485","0","58.51","16.18"
"10","007","00","001","0156","0151","726","239","487","51","777","1372","0","56.63","17.42"
"10","007","00","001","0156","0152","647","163","484","30","677","1113","0","60.83","14.65"
"10","007","00","001","0157","0000","590","207","383","26","616","1184","0","52.03","17.48"
"10","007","00","001","0157","0176","590","207","383","26","616","1184","0","52.03","17.48"
"10","007","00","001","0158","0000","1451","456","995","114","1565","2445","0","64.01","18.65"
"10","007","00","001","0158","0165","470","129","341","36","506","770","0","65.71","16.75"
"10","007","00","001","0158","0166","528","194","334","29","557","889","0","62.65","21.82"
"10","007","00","001","0158","0167","453","133","320","49","502","786","0","63.87","16.92"
"10","007","00","001","0159","0000","740","227","513","50","790","1249","0","63.25","18.17"
"10","007","00","001","0159","0133","740","227","513","50","790","1249","0","63.25","18.17"
"10","007","00","001","0160","0000","541","164","377","33","574","924","0","62.12","17.75"
"10","007","00","001","0160","0129","541","164","377","33","574","924","0","62.12","17.75"
"10","007","00","001","0161","0000","1783","555","1228","105","1888","2873","0","65.72","19.32"
"10","007","00","001","0161","0130","575","181","394","23","598","939","0","63.68","19.28"
"10","007","00","001","0161","0131","588","193","395","53","641","953","0","67.26","20.25"
"10","007","00","001","0161","0132","620","181","439","29","649","981","0","66.16","18.45"
"10","007","00","001","0162","0000","4705","1438","3267","219","4924","8267","0","59.56","17.39"
"10","007","00","001","0162","0137","701","217","484","26","727","1156","0","62.89","18.77"
"10","007","00","001","0162","0138","720","231","489","23","743","1291","0","57.55","17.89"
"10","007","00","001","0162","0139","642","193","449","26","668","1139","0","58.65","16.94"
"10","007","00","001","0162","0140","669","212","457","28","697","1125","0","61.96","18.84"
"10","007","00","001","0162","0141","681","196","485","37","718","1258","0","57.07","15.58"
"10","007","00","001","0162","0142","637","192","445","30","667","1123","0","59.39","17.1"
"10","007","00","001","0162","0143","655","197","458","49","704","1175","0","59.91","16.77"
"10","007","00","001","0163","0000","1355","427","928","93","1448","2378","0","60.89","17.96"
"10","007","00","001","0163","0134","466","139","327","43","509","817","0","62.3","17.01"
"10","007","00","001","0163","0135","502","163","339","30","532","872","0","61.01","18.69"
"10","007","00","001","0163","0136","387","125","262","20","407","689","0","59.07","18.14"
"10","007","00","001","0164","0000","2364","748","1616","109","2473","4160","0","59.45","17.98"
"10","007","00","001","0164","0147","575","170","405","20","595","1003","0","59.32","16.95"
"10","007","00","001","0164","0148","507","157","350","19","526","915","0","57.49","17.16"
"10","007","00","001","0164","0149","631","211","420","37","668","1158","0","57.69","18.22"
"10","007","00","001","0164","0150","651","210","441","33","684","1084","0","63.1","19.37"
"10","007","00","001","0165","0000","1587","498","1089","91","1678","2631","0","63.78","18.93"
"10","007","00","001","0165","0144","539","170","369","32","571","862","0","66.24","19.72"
"10","007","00","001","0165","0145","506","170","336","22","528","872","0","60.55","19.5"
"10","007","00","001","0165","0146","542","158","384","37","579","897","0","64.55","17.61"
"10","007","00","001","0166","0000","633","191","442","33","666","1161","0","57.36","16.45"
"10","007","00","001","0166","0184","633","191","442","33","666","1161","0","57.36","16.45"
"10","007","00","001","0167","0000","698","220","478","61","759","1276","0","59.48","17.24"
"10","007","00","001","0167","0183","698","220","478","61","759","1276","0","59.48","17.24"
"10","007","00","001","0168","0000","418","124","294","32","450","823","0","54.68","15.07"
"10","007","00","001","0168","0182","418","124","294","32","450","823","0","54.68","15.07"
"10","007","00","001","0169","0000","586","180","406","39","625","907","0","68.91","19.85"
"10","007","00","001","0169","0180","586","180","406","39","625","907","0","68.91","19.85"
"10","007","00","001","0170","0000","627","183","444","54","681","1112","0","61.24","16.46"
"10","007","00","001","0170","0181","627","183","444","54","681","1112","0","61.24","16.46"
"10","007","00","001","0171","0000","2511","764","1747","114","2625","4367","0","60.11","17.49"
"10","007","00","001","0171","0161","551","150","401","20","571","1033","0","55.28","14.52"
"10","007","00","001","0171","0162","650","210","440","35","685","1116","0","61.38","18.82"
"10","007","00","001","0171","0163","690","205","485","22","712","1154","0","61.7","17.76"
"10","007","00","001","0171","0164","620","199","421","37","657","1064","0","61.75","18.7"
"10","007","00","001","0172","0000","3069","827","2242","141","3210","5370","0","59.78","15.4"
"10","007","00","001","0172","0074","736","43","693","35","771","1252","0","61.58","3.43"
"10","007","00","001","0172","0075","604","190","414","28","632","1113","0","56.78","17.07"
"10","007","00","001","0172","0076","618","213","405","21","639","1009","0","63.33","21.11"
"10","007","00","001","0172","0077","543","186","357","36","579","999","0","57.96","18.62"
"10","007","00","001","0172","0078","568","195","373","21","589","997","0","59.08","19.56"
"10","007","00","001","0173","0000","3076","1031","2045","84","3160","5178","0","61.03","19.91"
"10","007","00","001","0173","0079","721","261","460","25","746","1145","0","65.15","22.79"
"10","007","00","001","0173","0080","716","232","484","19","735","1227","0","59.9","18.91"
"10","007","00","001","0173","0081","731","252","479","19","750","1208","0","62.09","20.86"
"10","007","00","001","0173","0082","908","286","622","21","929","1598","0","58.14","17.9"
"10","007","00","002","0000","0000","38386","11517","26869","2697","41083","70505","86762","58.27","16.34"
"10","007","00","002","0201","0000","670","212","458","44","714","1140","0","62.63","18.6"
"10","007","00","002","0201","0243","670","212","458","44","714","1140","0","62.63","18.6"
"10","007","00","002","0202","0000","286","96","190","20","306","511","0","59.88","18.79"
"10","007","00","002","0202","0244","286","96","190","20","306","511","0","59.88","18.79"
"10","007","00","002","0203","0000","413","241","172","16","429","857","0","50.06","28.12"
"10","007","00","002","0203","0245","413","241","172","16","429","857","0","50.06","28.12"
"10","007","00","002","0204","0000","561","169","392","50","611","946","0","64.59","17.86"
"10","007","00","002","0204","0246","561","169","392","50","611","946","0","64.59","17.86"
"10","007","00","002","0205","0000","4237","1242","2995","270","4507","7584","0","59.43","16.38"
"10","007","00","002","0205","0302","670","214","456","65","735","1299","0","56.58","16.47"
"10","007","00","002","0205","0303","780","224","556","28","808","1298","0","62.25","17.26"
"10","007","00","002","0205","0304","804","227","577","39","843","1458","0","57.82","15.57"
"10","007","00","002","0205","0305","637","200","437","47","684","1138","0","60.11","17.57"
"10","007","00","002","0205","0306","645","193","452","49","694","1170","0","59.32","16.5"
"10","007","00","002","0205","0307","701","184","517","42","743","1221","0","60.85","15.07"
"10","007","00","002","0206","0000","2758","773","1985","161","2919","5161","0","56.56","14.98"
"10","007","00","002","0206","0298","694","191","503","40","734","1227","0","59.82","15.57"
"10","007","00","002","0206","0299","670","156","514","50","720","1187","0","60.66","13.14"
"10","007","00","002","0206","0300","683","187","496","26","709","1296","0","54.71","14.43"
"10","007","00","002","0206","0301","711","239","472","45","756","1451","0","52.1","16.47"
"10","007","00","002","0207","0000","2661","847","1814","156","2817","4946","0","56.96","17.12"
"10","007","00","002","0207","0247","531","177","354","33","564","945","0","59.68","18.73"
"10","007","00","002","0207","0248","622","185","437","36","658","1097","0","59.98","16.86"
"10","007","00","002","0207","0249","714","250","464","24","738","1479","0","49.9","16.9"
"10","007","00","002","0207","0250","794","235","559","63","857","1425","0","60.14","16.49"
"10","007","00","002","0208","0000","2353","822","1531","163","2516","4335","0","58.04","18.96"
"10","007","00","002","0208","0253","598","189","409","49","647","1047","0","61.8","18.05"
"10","007","00","002","0208","0254","582","282","300","23","605","1097","0","55.15","25.71"
"10","007","00","002","0208","0255","539","152","387","54","593","1030","0","57.57","14.76"
"10","007","00","002","0208","0256","634","199","435","37","671","1161","0","57.8","17.14"
"10","007","00","002","0209","0000","306","97","209","35","341","540","0","63.15","17.96"
"10","007","00","002","0209","0257","306","97","209","35","341","540","0","63.15","17.96"
"10","007","00","002","0210","0000","500","171","329","60","560","880","0","63.64","19.43"
"10","007","00","002","0210","0251","500","171","329","60","560","880","0","63.64","19.43"
"10","007","00","002","0211","0000","618","195","423","52","670","1183","0","56.64","16.48"
"10","007","00","002","0211","0252","618","195","423","52","670","1183","0","56.64","16.48"
"10","007","00","002","0212","0000","610","197","413","57","667","1127","0","59.18","17.48"
"10","007","00","002","0212","0262","610","197","413","57","667","1127","0","59.18","17.48"
"10","007","00","002","0213","0000","719","211","508","38","757","1178","0","64.26","17.91"
"10","007","00","002","0213","0263","719","211","508","38","757","1178","0","64.26","17.91"
"10","007","00","002","0214","0000","158","51","107","11","169","284","0","59.51","17.96"
"10","007","00","002","0214","0264","158","51","107","11","169","284","0","59.51","17.96"
"10","007","00","002","0215","0000","399","104","295","36","435","659","0","66.01","15.78"
"10","007","00","002","0215","0266","399","104","295","36","435","659","0","66.01","15.78"
"10","007","00","002","0216","0000","324","112","212","23","347","584","0","59.42","19.18"
"10","007","00","002","0216","0265","324","112","212","23","347","584","0","59.42","19.18"
"10","007","00","002","0217","0000","516","177","339","21","537","915","0","58.69","19.34"
"10","007","00","002","0217","0267","516","177","339","21","537","915","0","58.69","19.34"
"10","007","00","002","0218","0000","1310","415","895","101","1411","2208","0","63.9","18.8"
"10","007","00","002","0218","0268","634","206","428","45","679","1079","0","62.93","19.09"
"10","007","00","002","0218","0269","676","209","467","56","732","1129","0","64.84","18.51"
"10","007","00","002","0219","0000","2003","638","1365","162","2165","3820","0","56.68","16.7"
"10","007","00","002","0219","0286","759","249","510","60","819","1505","0","54.42","16.54"
"10","007","00","002","0219","0287","560","186","374","44","604","1092","0","55.31","17.03"
"10","007","00","002","0219","0288","684","203","481","58","742","1223","0","60.67","16.6"
"10","007","00","002","0220","0000","1335","364","971","73","1408","2575","0","54.68","14.14"
"10","007","00","002","0220","0289","757","193","564","32","789","1572","0","50.19","12.28"
"10","007","00","002","0220","0290","578","171","407","41","619","1003","0","61.71","17.05"
"10","007","00","002","0221","0000","2276","566","1710","115","2391","4070","0","58.75","13.91"
"10","007","00","002","0221","0295","841","227","614","48","889","1397","0","63.64","16.25"
"10","007","00","002","0221","0296","671","152","519","33","704","1229","0","57.28","12.37"
"10","007","00","002","0221","0297","764","187","577","34","798","1444","0","55.26","12.95"
"10","007","00","002","0222","0000","2274","619","1655","134","2408","4152","0","58.0","14.91"
"10","007","00","002","0222","0291","530","136","394","29","559","933","0","59.91","14.58"
"10","007","00","002","0222","0292","615","168","447","48","663","1093","0","60.66","15.37"
"10","007","00","002","0222","0293","495","143","352","20","515","907","0","56.78","15.77"
"10","007","00","002","0222","0294","634","172","462","37","671","1219","0","55.05","14.11"
"10","007","00","002","0223","0000","1744","471","1273","88","1832","3167","0","57.85","14.87"
"10","007","00","002","0223","0278","524","142","382","21","545","984","0","55.39","14.43"
"10","007","00","002","0223","0279","615","148","467","27","642","1018","0","63.06","14.54"
"10","007","00","002","0223","0280","605","181","424","40","645","1165","0","55.36","15.54"
"10","007","00","002","0224","0000","1081","309","772","91","1172","2181","0","53.74","14.17"
"10","007","00","002","0224","0281","564","157","407","46","610","1161","0","52.54","13.52"
"10","007","00","002","0224","0282","517","152","365","45","562","1020","0","55.1","14.9"
"10","007","00","002","0225","0000","1696","457","1239","144","1840","3066","0","60.01","14.91"
"10","007","00","002","0225","0283","562","148","414","54","616","1068","0","57.68","13.86"
"10","007","00","002","0225","0284","595","139","456","28","623","1024","0","60.84","13.57"
"10","007","00","002","0225","0285","539","170","369","62","601","974","0","61.7","17.45"
"10","007","00","002","0226","0000","1779","567","1212","175","1954","3557","0","54.93","15.94"
"10","007","00","002","0226","0272","544","190","354","87","631","1137","0","55.5","16.71"
"10","007","00","002","0226","0273","620","199","421","41","661","1195","0","55.31","16.65"
"10","007","00","002","0226","0274","615","178","437","47","662","1225","0","54.04","14.53"
"10","007","00","002","0227","0000","1012","253","759","73","1085","1979","0","54.83","12.78"
"10","007","00","002","0227","0270","663","160","503","44","707","1273","0","55.54","12.57"
"10","007","00","002","0227","0271","349","93","256","29","378","706","0","53.54","13.17"
"10","007","00","002","0228","0000","1330","377","953","145","1475","2438","0","60.5","15.46"
"10","007","00","002","0228","0275","585","164","421","45","630","957","0","65.83","17.14"
"10","007","00","002","0228","0276","354","101","253","53","407","758","0","53.69","13.32"
"10","007","00","002","0228","0277","391","112","279","47","438","723","0","60.58","15.49"
"10","007","00","002","0229","0000","2457","764","1693","183","2640","4462","0","59.17","17.12"
"10","007","00","002","0229","0258","603","192","411","45","648","1135","0","57.09","16.92"
"10","007","00","002","0229","0259","611","160","451","58","669","1155","0","57.92","13.85"
"10","007","00","002","0229","0260","662","217","445","36","698","1127","0","61.93","19.25"
"10","007","00","002","0229","0261","581","195","386","44","625","1045","0","59.81","18.66"
"10","007","00","003","0000","0000","40702","12951","27751","2235","42937","75286","90786","57.03","17.2"
"10","007","00","003","0301","0000","3121","1016","2105","130","3251","6061","0","53.64","16.76"
"10","007","00","003","0301","0373","702","232","470","36","738","1341","0","55.03","17.3"
"10","007","00","003","0301","0374","724","232","492","47","771","1480","0","52.09","15.68"
"10","007","00","003","0301","0375","822","262","560","38","860","1529","0","56.25","17.14"
"10","007","00","003","0301","0376","873","290","583","9","882","1711","0","51.55","16.95"
"10","007","00","003","0302","0000","2453","829","1624","140","2593","4313","0","60.12","19.22"
"10","007","00","003","0302","0377","589","217","372","27","616","1057","0","58.28","20.53"
"10","007","00","003","0302","0378","581","219","362","37","618","1032","0","59.88","21.22"
"10","007","00","003","0302","0379","585","162","423","38","623","1015","0","61.38","15.96"
"10","007","00","003","0302","0380","698","231","467","38","736","1209","0","60.88","19.11"
"10","007","00","003","0303","0000","237","101","136","14","251","430","0","58.37","23.49"
"10","007","00","003","0303","0381","237","101","136","14","251","430","0","58.37","23.49"
"10","007","00","003","0304","0000","1023","308","715","44","1067","1822","0","58.56","16.9"
"10","007","00","003","0304","0382","468","153","315","16","484","856","0","56.54","17.87"
"10","007","00","003","0304","0383","555","155","400","28","583","966","0","60.35","16.05"
"10","007","00","003","0305","0000","1721","556","1165","91","1812","3242","0","55.89","17.15"
"10","007","00","003","0305","0384","557","185","372","25","582","1059","0","54.96","17.47"
"10","007","00","003","0305","0385","612","215","397","27","639","1117","0","57.21","19.25"
"10","007","00","003","0305","0386","552","156","396","39","591","1066","0","55.44","14.63"
"10","007","00","003","0306","0000","1425","492","933","65","1490","2780","0","53.6","17.7"
"10","007","00","003","0306","0387","658","235","423","25","683","1252","0","54.55","18.77"
"10","007","00","003","0306","0388","767","257","510","40","807","1528","0","52.81","16.82"
"10","007","00","003","0307","0000","929","299","630","50","979","1680","0","58.27","17.8"
"10","007","00","003","0307","0389","470","158","312","25","495","826","0","59.93","19.13"
"10","007","00","003","0307","0390","459","141","318","25","484","854","0","56.67","16.51"
"10","007","00","003","0308","0000","500","161","339","20","520","860","0","60.47","18.72"
"10","007","00","003","0308","0429","500","161","339","20","520","860","0","60.47","18.72"
"10","007","00","003","0309","0000","1173","343","830","54","1227","2152","0","57.02","15.94"
"10","007","00","003","0309","0391","709","223","486","39","748","1387","0","53.93","16.08"
"10","007","00","003","0309","0392","464","120","344","15","479","765","0","62.61","15.69"
"10","007","00","003","0310","0000","1497","442","1055","88","1585","2834","0","55.93","15.6"
"10","007","00","003","0310","0393","709","207","502","45","754","1438","0","52.43","14.39"
"10","007","00","003","0310","0394","788","235","553","43","831","1396","0","59.53","16.83"
"10","007","00","003","0311","0000","860","239","621","42","902","1467","0","61.49","16.29"
"10","007","00","003","0311","0395","371","96","275","16","387","658","0","58.81","14.59"
"10","007","00","003","0311","0396","489","143","346","26","515","809","0","63.66","17.68"
"10","007","00","003","0312","0000","943","287","656","37","980","1820","0","53.85","15.77"
"10","007","00","003","0312","0397","489","155","334","5","494","932","0","53.0","16.63"
"10","007","00","003","0312","0398","454","132","322","32","486","888","0","54.73","14.86"
"10","007","00","003","0313","0000","1251","555","696","63","1314","2221","0","59.16","24.99"
"10","007","00","003","0313","0399","671","386","285","28","699","1144","0","61.1","33.74"
"10","007","00","003","0313","0400","580","169","411","35","615","1077","0","57.1","15.69"
"10","007","00","003","0314","0000","659","207","452","52","711","1349","0","52.71","15.34"
"10","007","00","003","0314","0401","659","207","452","52","711","1349","0","52.71","15.34"
"10","007","00","003","0315","0000","2776","836","1940","134","2910","5134","0","56.68","16.28"
"10","007","00","003","0315","0402","691","191","500","34","725","1155","0","62.77","16.54"
"10","007","00","003","0315","0403","661","189","472","37","698","1253","0","55.71","15.08"
"10","007","00","003","0315","0404","654","186","468","36","690","1252","0","55.11","14.86"
"10","007","00","003","0315","0405","770","270","500","27","797","1474","0","54.07","18.32"
"10","007","00","003","0316","0000","1103","328","775","65","1168","1910","0","61.15","17.17"
"10","007","00","003","0316","0408","590","163","427","31","621","999","0","62.16","16.32"
"10","007","00","003","0316","0409","513","165","348","34","547","911","0","60.04","18.11"
"10","007","00","003","0317","0000","1444","417","1027","75","1519","2632","0","57.71","15.84"
"10","007","00","003","0317","0412","730","204","526","38","768","1308","0","58.72","15.6"
"10","007","00","003","0317","0413","714","213","501","37","751","1324","0","56.72","16.09"
"10","007","00","003","0318","0000","1094","338","756","65","1159","1972","0","58.77","17.14"
"10","007","00","003","0318","0410","566","186","380","29","595","1005","0","59.2","18.51"
"10","007","00","003","0318","0411","528","152","376","36","564","967","0","58.32","15.72"
"10","007","00","003","0319","0000","1838","584","1254","138","1976","3437","0","57.49","16.99"
"10","007","00","003","0319","0414","615","205","410","43","658","1102","0","59.71","18.6"
"10","007","00","003","0319","0415","568","179","389","45","613","1124","0","54.54","15.93"
"10","007","00","003","0319","0416","655","200","455","50","705","1211","0","58.22","16.52"
"10","007","00","003","0320","0000","554","154","400","39","593","884","0","67.08","17.42"
"10","007","00","003","0320","0417","554","154","400","39","593","884","0","67.08","17.42"
"10","007","00","003","0321","0000","1289","407","882","98","1387","2419","0","57.34","16.83"
"10","007","00","003","0321","0418","591","184","407","61","652","1119","0","58.27","16.44"
"10","007","00","003","0321","0419","698","223","475","37","735","1300","0","56.54","17.15"
"10","007","00","003","0322","0000","1277","399","878","68","1345","2317","0","58.05","17.22"
"10","007","00","003","0322","0420","580","183","397","26","606","1104","0","54.89","16.58"
"10","007","00","003","0322","0421","697","216","481","42","739","1213","0","60.92","17.81"
"10","007","00","003","0323","0000","555","186","369","37","592","1127","0","52.53","16.5"
"10","007","00","003","0323","0422","555","186","369","37","592","1127","0","52.53","16.5"
"10","007","00","003","0324","0000","1608","488","1120","107","1715","2864","0","59.88","17.04"
"10","007","00","003","0324","0423","487","158","329","39","526","919","0","57.24","17.19"
"10","007","00","003","0324","0424","562","170","392","34","596","987","0","60.39","17.22"
"10","007","00","003","0324","0425","559","160","399","34","593","958","0","61.9","16.7"
"10","007","00","003","0325","0000","2341","741","1600","76","2417","4228","0","57.17","17.53"
"10","007","00","003","0325","0426","761","220","541","33","794","1362","0","58.3","16.15"
"10","007","00","003","0325","0427","788","263","525","23","811","1461","0","55.51","18.0"
"10","007","00","003","0325","0428","792","258","534","20","812","1405","0","57.79","18.36"
"10","007","00","003","0326","0000","934","285","649","66","1000","1746","0","57.27","16.32"
"10","007","00","003","0326","0430","472","128","344","22","494","875","0","56.46","14.63"
"10","007","00","003","0326","0431","462","157","305","44","506","871","0","58.09","18.03"
"10","007","00","003","0327","0000","519","151","368","33","552","883","0","62.51","17.1"
"10","007","00","003","0327","0432","519","151","368","33","552","883","0","62.51","17.1"
"10","007","00","003","0328","0000","633","226","407","56","689","1224","0","56.29","18.46"
"10","007","00","003","0328","0433","633","226","407","56","689","1224","0","56.29","18.46"
"10","007","00","003","0329","0000","1075","348","727","71","1146","2031","0","56.43","17.13"
"10","007","00","003","0329","0434","562","178","384","40","602","1075","0","56.0","16.56"
"10","007","00","003","0329","0435","513","170","343","31","544","956","0","56.9","17.78"
"10","007","00","003","0330","0000","1637","544","1093","97","1734","3071","0","56.46","17.71"
"10","007","00","003","0330","0436","544","184","360","36","580","1037","0","55.93","17.74"
"10","007","00","003","0330","0437","553","181","372","22","575","1011","0","56.87","17.9"
"10","007","00","003","0330","0438","540","179","361","39","579","1023","0","56.6","17.5"
"10","007","00","003","0331","0000","850","249","601","61","911","1632","0","55.82","15.26"
"10","007","00","003","0331","0439","373","105","268","22","395","719","0","54.94","14.6"
"10","007","00","003","0331","0440","477","144","333","39","516","913","0","56.52","15.77"
"10","007","00","003","0332","0000","1383","435","948","59","1442","2744","0","52.55","15.85"
"10","007","00","003","0332","0406","688","223","465","29","717","1396","0","51.36","15.97"
"10","007","00","003","0332","0407","695","212","483","30","725","1348","0","53.78","15.73"
"10","007","00","004","0000","0000","7868","2323","5545","507","8375","14065","16872","59.54","16.52"
"10","007","00","004","0401","0000","1273","393","880","45","1318","2237","0","58.92","17.57"
"10","007","00","004","0401","0469","598","183","415","19","617","1071","0","57.61","17.09"
"10","007","00","004","0401","0470","675","210","465","26","701","1166","0","60.12","18.01"
"10","007","00","004","0402","0000","693","197","496","63","756","1269","0","59.57","15.52"
"10","007","00","004","0402","0471","693","197","496","63","756","1269","0","59.57","15.52"
"10","007","00","004","0403","0000","1274","354","920","100","1374","2266","0","60.64","15.62"
"10","007","00","004","0403","0472","613","168","445","38","651","1138","0","57.21","14.76"
"10","007","00","004","0403","0473","661","186","475","62","723","1128","0","64.1","16.49"
"10","007","00","004","0404","0000","713","199","514","56","769","1275","0","60.31","15.61"
"10","007","00","004","0404","0474","713","199","514","56","769","1275","0","60.31","15.61"
"10","007","00","004","0405","0000","670","213","457","38","708","1187","0","59.65","17.94"
"10","007","00","004","0405","0475","670","213","457","38","708","1187","0","59.65","17.94"
"10","007","00","004","0406","0000","1066","322","744","99","1165","1929","0","60.39","16.69"
"10","007","00","004","0406","0476","550","144","406","52","602","991","0","60.75","14.53"
"10","007","00","004","0406","0477","516","178","338","47","563","938","0","60.02","18.98"
"10","007","00","004","0407","0000","1354","406","948","91","1445","2561","0","56.42","15.85"
"10","007","00","004","0407","0478","640","195","445","47","687","1276","0","53.84","15.28"
"10","007","00","004","0407","0479","714","211","503","44","758","1285","0","58.99","16.42"
"10","007","00","004","0408","0000","825","239","586","15","840","1341","0","62.64","17.82"
"10","007","00","004","0408","0480","825","239","586","15","840","1341","0","62.64","17.82"
"10","007","00","005","0000","0000","16099","4958","11141","1159","17258","30407","37062","56.76","16.31"
"10","007","00","005","0501","0000","833","257","576","70","903","1700","0","53.12","15.12"
"10","007","00","005","0501","0456","430","145","285","46","476","854","0","55.74","16.98"
"10","007","00","005","0501","0457","403","112","291","24","427","846","0","50.47","13.24"
"10","007","00","005","0502","0000","529","178","351","81","610","1143","0","53.37","15.57"
"10","007","00","005","0502","0458","529","178","351","81","610","1143","0","53.37","15.57"
"10","007","00","005","0503","0000","719","240","479","55","774","1317","0","58.77","18.22"
"10","007","00","005","0503","0463","719","240","479","55","774","1317","0","58.77","18.22"
"10","007","00","005","0504","0000","988","312","676","84","1072","1912","0","56.07","16.32"
"10","007","00","005","0504","0447","465","148","317","47","512","904","0","56.64","16.37"
"10","007","00","005","0504","0448","523","164","359","37","560","1008","0","55.56","16.27"
"10","007","00","005","0505","0000","1108","346","762","83","1191","1993","0","59.76","17.36"
"10","007","00","005","0505","0453","591","184","407","57","648","1085","0","59.72","16.96"
"10","007","00","005","0505","0454","517","162","355","26","543","908","0","59.8","17.84"
"10","007","00","005","0506","0000","721","201","520","41","762","1264","0","60.28","15.9"
"10","007","00","005","0506","0455","721","201","520","41","762","1264","0","60.28","15.9"
"10","007","00","005","0507","0000","986","309","677","66","1052","1839","0","57.21","16.8"
"10","007","00","005","0507","0443","529","155","374","33","562","966","0","58.18","16.05"
"10","007","00","005","0507","0444","457","154","303","33","490","873","0","56.13","17.64"
"10","007","00","005","0508","0000","904","248","656","78","982","1687","0","58.21","14.7"
"10","007","00","005","0508","0445","453","125","328","38","491","812","0","60.47","15.39"
"10","007","00","005","0508","0446","451","123","328","40","491","875","0","56.11","14.06"
"10","007","00","005","0509","0000","1353","419","934","110","1463","2640","0","55.42","15.87"
"10","007","00","005","0509","0449","637","200","437","44","681","1154","0","59.01","17.33"
"10","007","00","005","0509","0450","716","219","497","66","782","1486","0","52.62","14.74"
"10","007","00","005","0510","0000","2739","879","1860","149","2888","5139","0","56.2","17.1"
"10","007","00","005","0510","0459","732","240","492","28","760","1357","0","56.01","17.69"
"10","007","00","005","0510","0460","710","221","489","47","757","1349","0","56.12","16.38"
"10","007","00","005","0510","0461","637","191","446","42","679","1154","0","58.84","16.55"
"10","007","00","005","0510","0462","660","227","433","32","692","1279","0","54.1","17.75"
"10","007","00","005","0511","0000","1114","298","816","54","1168","2182","0","53.53","13.66"
"10","007","00","005","0511","0451","574","159","415","36","610","1095","0","55.71","14.52"
"10","007","00","005","0511","0452","540","139","401","18","558","1087","0","51.33","12.79"
"10","007","00","005","0512","0000","1237","363","874","86","1323","2348","0","56.35","15.46"
"10","007","00","005","0512","0441","551","178","373","53","604","1182","0","51.1","15.06"
"10","007","00","005","0512","0442","686","185","501","33","719","1166","0","61.66","15.87"
"10","007","00","005","0513","0000","1703","545","1158","98","1801","3020","0","59.64","18.05"
"10","007","00","005","0513","0464","564","151","413","43","607","990","0","61.31","15.25"
"10","007","00","005","0513","0465","478","182","296","30","508","852","0","59.62","21.36"
"10","007","00","005","0513","0466","661","212","449","25","686","1178","0","58.23","18.0"
"10","007","00","005","0514","0000","1165","363","802","104","1269","2223","0","57.09","16.33"
"10","007","00","005","0514","0467","555","151","404","64","619","1088","0","56.89","13.88"
"10","007","00","005","0514","0468","610","212","398","40","650","1135","0","57.27","18.68"
"10","007","00","006","0000","0000","20083","6368","13715","1533","21616","39745","47166","54.39","16.02"
"10","007","00","006","0601","0000","729","193","536","62","791","1492","0","53.02","12.94"
"10","007","00","006","0601","0319","729","193","536","62","791","1492","0","53.02","12.94"
"10","007","00","006","0602","0000","633","181","452","42","675","1458","0","46.3","12.41"
"10","007","00","006","0602","0318","633","181","452","42","675","1458","0","46.3","12.41"
"10","007","00","006","0603","0000","623","199","424","39","662","1251","0","52.92","15.91"
"10","007","00","006","0603","0313","623","199","424","39","662","1251","0","52.92","15.91"
"10","007","00","006","0604","0000","712","203","509","52","764","1464","0","52.19","13.87"
"10","007","00","006","0604","0312","712","203","509","52","764","1464","0","52.19","13.87"
"10","007","00","006","0605","0000","565","188","377","73","638","1166","0","54.72","16.12"
"10","007","00","006","0605","0311","565","188","377","73","638","1166","0","54.72","16.12"
"10","007","00","006","0606","0000","606","182","424","57","663","1256","0","52.79","14.49"
"10","007","00","006","0606","0310","606","182","424","57","663","1256","0","52.79","14.49"
"10","007","00","006","0607","0000","676","254","422","50","726","1363","0","53.26","18.64"
"10","007","00","006","0607","0308","676","254","422","50","726","1363","0","53.26","18.64"
"10","007","00","006","0608","0000","447","153","294","23","470","821","0","57.25","18.64"
"10","007","00","006","0608","0309","447","153","294","23","470","821","0","57.25","18.64"
"10","007","00","006","0609","0000","1190","367","823","69","1259","2425","0","51.92","15.13"
"10","007","00","006","0609","0314","731","227","504","48","779","1465","0","53.17","15.49"
"10","007","00","006","0609","0315","459","140","319","21","480","960","0","50.0","14.58"
"10","007","00","006","0610","0000","1380","471","909","94","1474","2688","0","54.84","17.52"
"10","007","00","006","0610","0316","662","238","424","56","718","1323","0","54.27","17.99"
"10","007","00","006","0610","0317","718","233","485","38","756","1365","0","55.38","17.07"
"10","007","00","006","0611","0000","1235","388","847","76","1311","2477","0","52.93","15.66"
"10","007","00","006","0611","0324","534","202","332","38","572","1085","0","52.72","18.62"
"10","007","00","006","0611","0325","701","186","515","38","739","1392","0","53.09","13.36"
"10","007","00","006","0612","0000","652","178","474","45","697","1216","0","57.32","14.64"
"10","007","00","006","0612","0331","652","178","474","45","697","1216","0","57.32","14.64"
"10","007","00","006","0613","0000","542","142","400","33","575","1063","0","54.09","13.36"
"10","007","00","006","0613","0332","542","142","400","33","575","1063","0","54.09","13.36"
"10","007","00","006","0614","0000","1148","330","818","129","1277","2229","0","57.29","14.8"
"10","007","00","006","0614","0339","601","169","432","69","670","1079","0","62.09","15.66"
"10","007","00","006","0614","0340","547","161","386","60","607","1150","0","52.78","14.0"
"10","007","00","006","0615","0000","1009","296","713","66","1075","1921","0","55.96","15.41"
"10","007","00","006","0615","0337","520","137","383","34","554","926","0","59.83","14.79"
"10","007","00","006","0615","0338","489","159","330","32","521","995","0","52.36","15.98"
"10","007","00","006","0616","0000","1215","324","891","88","1303","2305","0","56.53","14.06"
"10","007","00","006","0616","0335","531","137","394","28","559","994","0","56.24","13.78"
"10","007","00","006","0616","0336","684","187","497","60","744","1311","0","56.75","14.26"
"10","007","00","006","0617","0000","551","165","386","53","604","1287","0","46.93","12.82"
"10","007","00","006","0617","0334","551","165","386","53","604","1287","0","46.93","12.82"
"10","007","00","006","0618","0000","662","195","467","42","704","1306","0","53.91","14.93"
"10","007","00","006","0618","0333","662","195","467","42","704","1306","0","53.91","14.93"
"10","007","00","006","0619","0000","2075","869","1206","129","2204","3672","0","60.02","23.67"
"10","007","00","006","0619","0326","715","216","499","59","774","1316","0","58.81","16.41"
"10","007","00","006","0619","0327","716","193","523","39","755","1255","0","60.16","15.38"
"10","007","00","006","0619","0328","644","460","184","31","675","1101","0","61.31","41.78"
"10","007","00","006","0620","0000","1265","446","819","128","1393","2560","0","54.41","17.42"
"10","007","00","006","0620","0329","596","157","439","62","658","1167","0","56.38","13.45"
"10","007","00","006","0620","0330","669","289","380","66","735","1393","0","52.76","20.75"
"10","007","00","006","0621","0000","1153","324","829","107","1260","2383","0","52.87","13.6"
"10","007","00","006","0621","0322","474","134","340","46","520","1043","0","49.86","12.85"
"10","007","00","006","0621","0323","679","190","489","61","740","1340","0","55.22","14.18"
"10","007","00","006","0622","0000","1015","320","695","76","1091","1942","0","56.18","16.48"
"10","007","00","006","0622","0320","435","134","301","22","457","888","0","51.46","15.09"
"10","007","00","006","0622","0321","580","186","394","54","634","1054","0","60.15","17.65"
"10","007","00","007","0000","0000","18039","5578","12461","1225","19264","32394","39300","59.47","17.22"
"10","007","00","007","0701","0000","947","288","659","119","1066","1686","0","63.23","17.08"
"10","007","00","007","0701","0341","587","171","416","82","669","1066","0","62.76","16.04"
"10","007","00","007","0701","0342","360","117","243","37","397","620","0","64.03","18.87"
"10","007","00","007","0702","0000","1136","379","757","47","1183","2072","0","57.09","18.29"
"10","007","00","007","0702","0343","433","145","288","14","447","876","0","51.03","16.55"
"10","007","00","007","0702","0344","703","234","469","33","736","1196","0","61.54","19.57"
"10","007","00","007","0703","0000","1460","453","1007","86","1546","2642","0","58.52","17.15"
"10","007","00","007","0703","0345","755","246","509","35","790","1369","0","57.71","17.97"
"10","007","00","007","0703","0346","705","207","498","51","756","1273","0","59.39","16.26"
"10","007","00","007","0704","0000","1071","346","725","49","1120","1888","0","59.32","18.33"
"10","007","00","007","0704","0348","547","176","371","29","576","967","0","59.57","18.2"
"10","007","00","007","0704","0349","524","170","354","20","544","921","0","59.07","18.46"
"10","007","00","007","0705","0000","766","127","639","40","806","1433","0","56.25","8.86"
"10","007","00","007","0705","0347","766","127","639","40","806","1433","0","56.25","8.86"
"10","007","00","007","0706","0000","2202","709","1493","143","2345","3910","0","59.97","18.13"
"10","007","00","007","0706","0350","410","130","280","24","434","689","0","62.99","18.87"
"10","007","00","007","0706","0351","382","116","266","39","421","688","0","61.19","16.86"
"10","007","00","007","0706","0352","733","243","490","48","781","1252","0","62.38","19.41"
"10","007","00","007","0706","0353","677","220","457","32","709","1281","0","55.35","17.17"
"10","007","00","007","0707","0000","1717","521","1196","80","1797","3211","0","55.96","16.23"
"10","007","00","007","0707","0354","404","112","292","23","427","754","0","56.63","14.85"
"10","007","00","007","0707","0355","550","187","363","37","587","1024","0","57.32","18.26"
"10","007","00","007","0707","0356","763","222","541","20","783","1433","0","54.64","15.49"
"10","007","00","007","0708","0000","1337","392","945","92","1429","2261","0","63.2","17.34"
"10","007","00","007","0708","0357","833","254","579","50","883","1366","0","64.64","18.59"
"10","007","00","007","0708","0358","504","138","366","42","546","895","0","61.01","15.42"
"10","007","00","007","0709","0000","692","225","467","54","746","1386","0","53.82","16.23"
"10","007","00","007","0709","0359","692","225","467","54","746","1386","0","53.82","16.23"
"10","007","00","007","0710","0000","2598","792","1806","213","2811","4454","0","63.11","17.78"
"10","007","00","007","0710","0360","484","146","338","60","544","896","0","60.71","16.29"
"10","007","00","007","0710","0361","499","156","343","36","535","804","0","66.54","19.4"
"10","007","00","007","0710","0362","491","137","354","29","520","827","0","62.88","16.57"
"10","007","00","007","0710","0363","551","178","373","43","594","996","0","59.64","17.87"
"10","007","00","007","0710","0364","573","175","398","45","618","931","0","66.38","18.8"
"10","007","00","007","0711","0000","1093","323","770","82","1175","1944","0","60.44","16.62"
"10","007","00","007","0711","0365","387","127","260","20","407","715","0","56.92","17.76"
"10","007","00","007","0711","0366","706","196","510","62","768","1229","0","62.49","15.95"
"10","007","00","007","0712","0000","916","471","445","57","973","1701","0","57.2","27.69"
"10","007","00","007","0712","0367","432","111","321","32","464","890","0","52.13","12.47"
"10","007","00","007","0712","0368","484","360","124","25","509","811","0","62.76","44.39"
"10","007","00","007","0713","0000","965","260","705","64","1029","1717","0","59.93","15.14"
"10","007","00","007","0713","0369","455","124","331","32","487","786","0","61.96","15.78"
"10","007","00","007","0713","0370","510","136","374","32","542","931","0","58.22","14.61"
"10","007","00","007","0714","0000","1139","292","847","99","1238","2089","0","59.26","13.98"
"10","007","00","007","0714","0371","722","170","552","51","773","1265","0","61.11","13.44"
"10","007","00","007","0714","0372","417","122","295","48","465","824","0","56.43","14.81"
"10","007","00","008","0000","0000","21786","6224","15562","1329","23115","38924","45922","59.38","15.99"
"10","007","00","008","0801","0000","1827","558","1269","89","1916","3257","0","58.83","17.13"
"10","007","00","008","0801","0185","499","139","360","48","547","901","0","60.71","15.43"
"10","007","00","008","0801","0186","620","199","421","30","650","1042","0","62.38","19.1"
"10","007","00","008","0801","0187","708","220","488","11","719","1314","0","54.72","16.74"
"10","007","00","008","0802","0000","1020","275","745","69","1089","1827","0","59.61","15.05"
"10","007","00","008","0802","0188","460","119","341","39","499","808","0","61.76","14.73"
"10","007","00","008","0802","0189","560","156","404","30","590","1019","0","57.9","15.31"
"10","007","00","008","0803","0000","1306","348","958","143","1449","2384","0","60.78","14.6"
"10","007","00","008","0803","0190","658","192","466","52","710","1144","0","62.06","16.78"
"10","007","00","008","0803","0191","648","156","492","91","739","1240","0","59.6","12.58"
"10","007","00","008","0804","0000","666","187","479","37","703","1095","0","64.2","17.08"
"10","007","00","008","0804","0193","666","187","479","37","703","1095","0","64.2","17.08"
"10","007","00","008","0805","0000","827","192","635","54","881","1425","0","61.82","13.47"
"10","007","00","008","0805","0192","827","192","635","54","881","1425","0","61.82","13.47"
"10","007","00","008","0806","0000","1103","303","800","59","1162","1892","0","61.42","16.01"
"10","007","00","008","0806","0194","508","139","369","36","544","910","0","59.78","15.27"
"10","007","00","008","0806","0195","595","164","431","23","618","982","0","62.93","16.7"
"10","007","00","008","0807","0000","474","145","329","31","505","764","0","66.1","18.98"
"10","007","00","008","0807","0198","474","145","329","31","505","764","0","66.1","18.98"
"10","007","00","008","0808","0000","971","337","634","38","1009","1770","0","57.01","19.04"
"10","007","00","008","0808","0196","612","201","411","14","626","1070","0","58.5","18.79"
"10","007","00","008","0808","0197","359","136","223","24","383","700","0","54.71","19.43"
"10","007","00","008","0809","0000","2783","758","2025","141","2924","4967","0","58.87","15.26"
"10","007","00","008","0809","0207","598","168","430","37","635","1169","0","54.32","14.37"
"10","007","00","008","0809","0208","722","211","511","46","768","1274","0","60.28","16.56"
"10","007","00","008","0809","0209","771","202","569","21","792","1280","0","61.88","15.78"
"10","007","00","008","0809","0210","692","177","515","37","729","1244","0","58.6","14.23"
"10","007","00","008","0810","0000","1713","500","1213","98","1811","3038","0","59.61","16.46"
"10","007","00","008","0810","0199","575","164","411","32","607","953","0","63.69","17.21"
"10","007","00","008","0810","0200","536","160","376","21","557","974","0","57.19","16.43"
"10","007","00","008","0810","0201","602","176","426","45","647","1111","0","58.24","15.84"
"10","007","00","008","0811","0000","2533","691","1842","153","2686","4576","0","58.7","15.1"
"10","007","00","008","0811","0202","614","154","460","59","673","1101","0","61.13","13.99"
"10","007","00","008","0811","0203","594","68","526","27","621","1110","0","55.95","6.13"
"10","007","00","008","0811","0204","700","233","467","39","739","1262","0","58.56","18.46"
"10","007","00","008","0811","0205","625","236","389","28","653","1103","0","59.2","21.4"
"10","007","00","008","0812","0000","655","198","457","51","706","1347","0","52.41","14.7"
"10","007","00","008","0812","0206","655","198","457","51","706","1347","0","52.41","14.7"
"10","007","00","008","0813","0000","1850","563","1287","120","1970","3312","0","59.48","17.0"
"10","007","00","008","0813","0211","629","193","436","52","681","1159","0","58.76","16.65"
"10","007","00","008","0813","0212","628","211","417","30","658","1042","0","63.15","20.25"
"10","007","00","008","0813","0213","593","159","434","38","631","1111","0","56.8","14.31"
"10","007","00","008","0814","0000","530","160","370","38","568","893","0","63.61","17.92"
"10","007","00","008","0814","0214","530","160","370","38","568","893","0","63.61","17.92"
"10","007","00","008","0815","0000","526","155","371","45","571","953","0","59.92","16.26"
"10","007","00","008","0815","0215","526","155","371","45","571","953","0","59.92","16.26"
"10","007","00","008","0816","0000","1072","339","733","64","1136","1912","0","59.41","17.73"
"10","007","00","008","0816","0216","506","167","339","27","533","987","0","54.0","16.92"
"10","007","00","008","0816","0217","566","172","394","37","603","925","0","65.19","18.59"
"10","007","00","008","0817","0000","1043","288","755","50","1093","1906","0","57.35","15.11"
"10","007","00","008","0817","0218","523","139","384","25","548","951","0","57.62","14.62"
"10","007","00","008","0817","0219","520","149","371","25","545","955","0","57.07","15.6"
"10","007","00","008","0818","0000","887","227","660","49","936","1606","0","58.28","14.13"
"10","007","00","008","0818","0220","487","120","367","29","516","895","0","57.65","13.41"
"10","007","00","008","0818","0221","400","107","293","20","420","711","0","59.07","15.05"
"10","007","00","009","0000","0000","10487","3045","7442","885","11372","20408","23594","55.72","14.92"
"10","007","00","009","0901","0000","914","265","649","79","993","1752","0","56.68","15.13"
"10","007","00","009","0901","0222","499","146","353","37","536","958","0","55.95","15.24"
"10","007","00","009","0901","0223","415","119","296","42","457","794","0","57.56","14.99"
"10","007","00","009","0902","0000","666","214","452","81","747","1415","0","52.79","15.12"
"10","007","00","009","0902","0224","666","214","452","81","747","1415","0","52.79","15.12"
"10","007","00","009","0903","0000","983","268","715","60","1043","1758","0","59.33","15.24"
"10","007","00","009","0903","0225","538","150","388","31","569","927","0","61.38","16.18"
"10","007","00","009","0903","0226","445","118","327","29","474","831","0","57.04","14.2"
"10","007","00","009","0904","0000","1221","395","826","116","1337","2465","0","54.24","16.02"
"10","007","00","009","0904","0228","603","219","384","51","654","1227","0","53.3","17.85"
"10","007","00","009","0904","0229","618","176","442","65","683","1238","0","55.17","14.22"
"10","007","00","009","0905","0000","1241","356","885","129","1370","2351","0","58.27","15.14"
"10","007","00","009","0905","0230","723","215","508","62","785","1362","0","57.64","15.79"
"10","007","00","009","0905","0231","518","141","377","67","585","989","0","59.15","14.26"
"10","007","00","009","0906","0000","991","286","705","82","1073","1661","0","64.6","17.22"
"10","007","00","009","0906","0232","621","176","445","50","671","1054","0","63.66","16.7"
"10","007","00","009","0906","0233","370","110","260","32","402","607","0","66.23","18.12"
"10","007","00","009","0907","0000","500","146","354","36","536","882","0","60.77","16.55"
"10","007","00","009","0907","0234","500","146","354","36","536","882","0","60.77","16.55"
"10","007","00","009","0908","0000","521","141","380","37","558","1143","0","48.82","12.34"
"10","007","00","009","0908","0235","521","141","380","37","558","1143","0","48.82","12.34"
"10","007","00","009","0909","0000","308","89","219","12","320","661","0","48.41","13.46"
"10","007","00","009","0909","0236","308","89","219","12","320","661","0","48.41","13.46"
"10","007","00","009","0910","0000","829","235","594","35","864","1685","0","51.28","13.95"
"10","007","00","009","0910","0237","411","109","302","7","418","838","0","49.88","13.01"
"10","007","00","009","0910","0238","418","126","292","28","446","847","0","52.66","14.88"
"10","007","00","009","0911","0000","542","133","409","50","592","987","0","59.98","13.48"
"10","007","00","009","0911","0239","542","133","409","50","592","987","0","59.98","13.48"
"10","007","00","009","0912","0000","580","167","413","62","642","1217","0","52.75","13.72"
"10","007","00","009","0912","0240","580","167","413","62","642","1217","0","52.75","13.72"
"10","007","00","009","0913","0000","398","111","287","52","450","865","0","52.02","12.83"
"10","007","00","009","0913","0241","398","111","287","52","450","865","0","52.02","12.83"
"10","007","00","009","0914","0000","480","150","330","35","515","996","0","51.71","15.06"
"10","007","00","009","0914","0242","480","150","330","35","515","996","0","51.71","15.06"
"10","007","00","009","0915","0000","313","89","224","19","332","570","0","58.25","15.61"
"10","007","00","009","0915","0227","313","89","224","19","332","570","0","58.25","15.61"
"10","007","00","010","0000","0000","55376","17321","38055","2876","58252","102028","124755","57.09","16.98"
"10","007","00","010","1001","0000","587","194","393","32","619","1063","0","58.23","18.25"
"10","007","00","010","1001","0504","587","194","393","32","619","1063","0","58.23","18.25"
"10","007","00","010","1002","0000","1535","675","860","88","1623","2788","0","58.21","24.21"
"10","007","00","010","1002","0505","499","389","110","20","519","925","0","56.11","42.05"
"10","007","00","010","1002","0506","518","148","370","41","559","947","0","59.03","15.63"
"10","007","00","010","1002","0507","518","138","380","27","545","916","0","59.5","15.07"
"10","007","00","010","1003","0000","1726","551","1175","76","1802","3174","0","56.77","17.36"
"10","007","00","010","1003","0528","464","154","310","14","478","867","0","55.13","17.76"
"10","007","00","010","1003","0529","649","197","452","29","678","1201","0","56.45","16.4"
"10","007","00","010","1003","0530","613","200","413","33","646","1106","0","58.41","18.08"
"10","007","00","010","1004","0000","1469","476","993","72","1541","2588","0","59.54","18.39"
"10","007","00","010","1004","0531","484","155","329","25","509","845","0","60.24","18.34"
"10","007","00","010","1004","0532","507","173","334","20","527","894","0","58.95","19.35"
"10","007","00","010","1004","0533","478","148","330","27","505","849","0","59.48","17.43"
"10","007","00","010","1005","0000","440","162","278","34","474","747","0","63.45","21.69"
"10","007","00","010","1005","0534","440","162","278","34","474","747","0","63.45","21.69"
"10","007","00","010","1006","0000","1495","465","1030","76","1571","2824","0","55.63","16.47"
"10","007","00","010","1006","0535","522","181","341","26","548","884","0","61.99","20.48"
"10","007","00","010","1006","0536","450","138","312","27","477","900","0","53.0","15.33"
"10","007","00","010","1006","0537","523","146","377","23","546","1040","0","52.5","14.04"
"10","007","00","010","1007","0000","441","159","282","15","456","831","0","54.87","19.13"
"10","007","00","010","1007","0538","441","159","282","15","456","831","0","54.87","19.13"
"10","007","00","010","1008","0000","358","125","233","30","388","591","0","65.65","21.15"
"10","007","00","010","1008","0539","358","125","233","30","388","591","0","65.65","21.15"
"10","007","00","010","1009","0000","1002","325","677","41","1043","1849","0","56.41","17.58"
"10","007","00","010","1009","0508","454","146","308","24","478","862","0","55.45","16.94"
"10","007","00","010","1009","0509","548","179","369","17","565","987","0","57.24","18.14"
"10","007","00","010","1010","0000","3111","976","2135","143","3254","5677","0","57.32","17.19"
"10","007","00","010","1010","0510","564","177","387","34","598","1085","0","55.12","16.31"
"10","007","00","010","1010","0511","614","188","426","23","637","1110","0","57.39","16.94"
"10","007","00","010","1010","0512","556","170","386","23","579","1095","0","52.88","15.53"
"10","007","00","010","1010","0513","754","251","503","31","785","1278","0","61.42","19.64"
"10","007","00","010","1010","0514","623","190","433","32","655","1109","0","59.06","17.13"
"10","007","00","010","1011","0000","1245","382","863","92","1337","2487","0","53.76","15.36"
"10","007","00","010","1011","0561","569","162","407","63","632","1131","0","55.88","14.32"
"10","007","00","010","1011","0562","676","220","456","29","705","1356","0","51.99","16.22"
"10","007","00","010","1012","0000","2360","784","1576","125","2485","4191","0","59.29","18.71"
"10","007","00","010","1012","0563","727","243","484","44","771","1370","0","56.28","17.74"
"10","007","00","010","1012","0564","604","197","407","34","638","1090","0","58.53","18.07"
"10","007","00","010","1012","0565","512","174","338","21","533","821","0","64.92","21.19"
"10","007","00","010","1012","0566","517","170","347","26","543","910","0","59.67","18.68"
"10","007","00","010","1013","0000","2796","877","1919","97","2893","4993","0","57.94","17.56"
"10","007","00","010","1013","0567","663","194","469","24","687","1203","0","57.11","16.13"
"10","007","00","010","1013","0568","757","269","488","26","783","1378","0","56.82","19.52"
"10","007","00","010","1013","0569","743","220","523","27","770","1352","0","56.95","16.27"
"10","007","00","010","1013","0570","633","194","439","20","653","1060","0","61.6","18.3"
"10","007","00","010","1014","0000","2368","664","1704","143","2511","4559","0","55.08","14.56"
"10","007","00","010","1014","0571","669","188","481","44","713","1317","0","54.14","14.27"
"10","007","00","010","1014","0572","583","172","411","28","611","1120","0","54.55","15.36"
"10","007","00","010","1014","0573","515","133","382","39","554","1025","0","54.05","12.98"
"10","007","00","010","1014","0574","601","171","430","32","633","1097","0","57.7","15.59"
"10","007","00","010","1015","0000","944","261","683","64","1008","1696","0","59.43","15.39"
"10","007","00","010","1015","0575","498","136","362","38","536","859","0","62.4","15.83"
"10","007","00","010","1015","0576","446","125","321","26","472","837","0","56.39","14.93"
"10","007","00","010","1016","0000","1212","384","828","86","1298","2163","0","60.01","17.75"
"10","007","00","010","1016","0577","649","210","439","35","684","1090","0","62.75","19.27"
"10","007","00","010","1016","0578","563","174","389","51","614","1073","0","57.22","16.22"
"10","007","00","010","1017","0000","1406","460","946","52","1458","2625","0","55.54","17.52"
"10","007","00","010","1017","0540","693","228","465","28","721","1330","0","54.21","17.14"
"10","007","00","010","1017","0541","713","232","481","24","737","1295","0","56.91","17.92"
"10","007","00","010","1018","0000","3354","1064","2290","135","3489","6205","0","56.23","17.15"
"10","007","00","010","1018","0545","661","217","444","27","688","1176","0","58.5","18.45"
"10","007","00","010","1018","0546","434","132","302","7","441","867","0","50.87","15.22"
"10","007","00","010","1018","0547","594","217","377","27","621","1121","0","55.4","19.36"
"10","007","00","010","1018","0548","606","191","415","23","629","1190","0","52.86","16.05"
"10","007","00","010","1018","0549","539","153","386","26","565","945","0","59.79","16.19"
"10","007","00","010","1018","0550","520","154","366","25","545","906","0","60.15","17.0"
"10","007","00","010","1019","0000","1690","469","1221","80","1770","2876","0","61.54","16.31"
"10","007","00","010","1019","0551","563","189","374","34","597","978","0","61.04","19.33"
"10","007","00","010","1019","0552","575","133","442","30","605","949","0","63.75","14.01"
"10","007","00","010","1019","0553","552","147","405","16","568","949","0","59.85","15.49"
"10","007","00","010","1020","0000","1041","339","702","66","1107","1931","0","57.33","17.56"
"10","007","00","010","1020","0515","554","162","392","42","596","1055","0","56.49","15.36"
"10","007","00","010","1020","0516","487","177","310","24","511","876","0","58.33","20.21"
"10","007","00","010","1021","0000","1189","369","820","56","1245","2301","0","54.11","16.04"
"10","007","00","010","1021","0517","528","168","360","28","556","1115","0","49.87","15.07"
"10","007","00","010","1021","0518","661","201","460","28","689","1186","0","58.09","16.95"
"10","007","00","010","1022","0000","1757","368","1389","83","1840","3195","0","57.59","11.52"
"10","007","00","010","1022","0519","560","154","406","42","602","995","0","60.5","15.48"
"10","007","00","010","1022","0520","536","0","536","15","551","999","0","55.16","0.0"
"10","007","00","010","1022","0521","661","214","447","26","687","1201","0","57.2","17.82"
"10","007","00","010","1023","0000","1292","390","902","42","1334","2428","0","54.94","16.06"
"10","007","00","010","1023","0522","725","212","513","20","745","1342","0","55.51","15.8"
"10","007","00","010","1023","0523","567","178","389","22","589","1086","0","54.24","16.39"
"10","007","00","010","1024","0000","2070","637","1433","84","2154","3624","0","59.44","17.58"
"10","007","00","010","1024","0524","434","128","306","23","457","854","0","53.51","14.99"
"10","007","00","010","1024","0525","585","167","418","22","607","1064","0","57.05","15.7"
"10","007","00","010","1024","0526","513","167","346","14","527","879","0","59.95","19.0"
"10","007","00","010","1024","0527","538","175","363","25","563","827","0","68.08","21.16"
"10","007","00","010","1025","0000","1231","323","908","51","1282","2440","0","52.54","13.24"
"10","007","00","010","1025","0481","553","129","424","20","573","1087","0","52.71","11.87"
"10","007","00","010","1025","0482","678","194","484","31","709","1353","0","52.4","14.34"
"10","007","00","010","1026","0000","1268","387","881","69","1337","2641","0","50.62","14.65"
"10","007","00","010","1026","0483","659","211","448","40","699","1313","0","53.24","16.07"
"10","007","00","010","1026","0484","609","176","433","29","638","1328","0","48.04","13.25"
"10","007","00","010","1027","0000","1485","468","1017","96","1581","2786","0","56.75","16.8"
"10","007","00","010","1027","0485","574","181","393","26","600","1055","0","56.87","17.16"
"10","007","00","010","1027","0486","494","154","340","36","530","959","0","55.27","16.06"
"10","007","00","010","1027","0487","417","133","284","34","451","772","0","58.42","17.23"
"10","007","00","010","1028","0000","847","251","596","40","887","1685","0","52.64","14.9"
"10","007","00","010","1028","0488","482","143","339","29","511","831","0","61.49","17.21"
"10","007","00","010","1028","0489","365","108","257","11","376","854","0","44.03","12.65"
"10","007","00","010","1029","0000","509","134","375","55","564","1190","0","47.39","11.26"
"10","007","00","010","1029","0490","509","134","375","55","564","1190","0","47.39","11.26"
"10","007","00","010","1030","0000","374","98","276","23","397","726","0","54.68","13.5"
"10","007","00","010","1030","0491","374","98","276","23","397","726","0","54.68","13.5"
"10","007","00","010","1031","0000","1022","358","664","64","1086","1984","0","54.74","18.04"
"10","007","00","010","1031","0492","602","202","400","31","633","1124","0","56.32","17.97"
"10","007","00","010","1031","0493","420","156","264","33","453","860","0","52.67","18.14"
"10","007","00","010","1032","0000","1246","382","864","77","1323","2197","0","60.22","17.39"
"10","007","00","010","1032","0494","653","202","451","31","684","1122","0","60.96","18.0"
"10","007","00","010","1032","0495","593","180","413","46","639","1075","0","59.44","16.74"
"10","007","00","010","1033","0000","987","252","735","88","1075","1960","0","54.85","12.86"
"10","007","00","010","1033","0496","497","128","369","53","550","993","0","55.39","12.89"
"10","007","00","010","1033","0497","490","124","366","35","525","967","0","54.29","12.82"
"10","007","00","010","1034","0000","978","294","684","66","1044","1812","0","57.62","16.23"
"10","007","00","010","1034","0498","553","164","389","33","586","1008","0","58.13","16.27"
"10","007","00","010","1034","0499","425","130","295","33","458","804","0","56.97","16.17"
"10","007","00","010","1035","0000","935","316","619","35","970","1752","0","55.37","18.04"
"10","007","00","010","1035","0500","462","158","304","23","485","867","0","55.94","18.22"
"10","007","00","010","1035","0501","473","158","315","12","485","885","0","54.8","17.85"
"10","007","00","010","1036","0000","1208","354","854","42","1250","2352","0","53.15","15.05"
"10","007","00","010","1036","0502","536","150","386","14","550","1097","0","50.14","13.67"
"10","007","00","010","1036","0503","672","204","468","28","700","1255","0","55.78","16.25"
"10","007","00","010","1037","0000","1599","527","1072","80","1679","2818","0","59.58","18.7"
"10","007","00","010","1037","0554","549","170","379","25","574","1006","0","57.06","16.9"
"10","007","00","010","1037","0555","492","182","310","36","528","889","0","59.39","20.47"
"10","007","00","010","1037","0556","558","175","383","19","577","923","0","62.51","18.96"
"10","007","00","010","1038","0000","1335","442","893","62","1397","2284","0","61.16","19.35"
"10","007","00","010","1038","0557","709","244","465","39","748","1209","0","61.87","20.18"
"10","007","00","010","1038","0558","626","198","428","23","649","1075","0","60.37","18.42"
"10","007","00","010","1039","0000","1444","509","935","78","1522","2381","0","63.92","21.38"
"10","007","00","010","1039","0559","790","275","515","39","829","1342","0","61.77","20.49"
"10","007","00","010","1039","0560","654","234","420","39","693","1039","0","66.7","22.52"
"10","007","00","010","1040","0000","818","280","538","50","868","1388","0","62.54","20.17"
"10","007","00","010","1040","0544","818","280","538","50","868","1388","0","62.54","20.17"
"10","007","00","010","1041","0000","1202","390","812","88","1290","2226","0","57.95","17.52"
"10","007","00","010","1041","0542","652","221","431","64","716","1283","0","55.81","17.23"
"10","007","00","010","1041","0543","550","169","381","24","574","943","0","60.87","17.92"
"10","007","00","011","0000","0000","24718","7695","17023","1567","26285","45147","55412","58.22","17.04"
"10","007","00","011","1101","0000","637","209","428","41","678","1221","0","55.53","17.12"
"10","007","00","011","1101","0640","637","209","428","41","678","1221","0","55.53","17.12"
"10","007","00","011","1102","0000","385","124","261","24","409","638","0","64.11","19.44"
"10","007","00","011","1102","0641","385","124","261","24","409","638","0","64.11","19.44"
"10","007","00","011","1103","0000","1006","294","712","64","1070","1785","0","59.94","16.47"
"10","007","00","011","1103","0642","448","134","314","37","485","817","0","59.36","16.4"
"10","007","00","011","1103","0643","558","160","398","27","585","968","0","60.43","16.53"
"10","007","00","011","1104","0000","285","97","188","10","295","448","0","65.85","21.65"
"10","007","00","011","1104","0644","285","97","188","10","295","448","0","65.85","21.65"
"10","007","00","011","1105","0000","1831","828","1003","102","1933","3275","0","59.02","25.28"
"10","007","00","011","1105","0654","588","170","418","25","613","1072","0","57.18","15.86"
"10","007","00","011","1105","0655","627","459","168","41","668","1113","0","60.02","41.24"
"10","007","00","011","1105","0656","616","199","417","36","652","1090","0","59.82","18.26"
"10","007","00","011","1106","0000","1242","322","920","71","1313","2145","0","61.21","15.01"
"10","007","00","011","1106","0657","688","186","502","32","720","1193","0","60.35","15.59"
"10","007","00","011","1106","0658","554","136","418","39","593","952","0","62.29","14.29"
"10","007","00","011","1107","0000","1905","589","1316","110","2015","3387","0","59.49","17.39"
"10","007","00","011","1107","0659","636","184","452","41","677","1172","0","57.76","15.7"
"10","007","00","011","1107","0660","560","194","366","32","592","1027","0","57.64","18.89"
"10","007","00","011","1107","0661","709","211","498","37","746","1188","0","62.79","17.76"
"10","007","00","011","1108","0000","709","221","488","49","758","1403","0","54.03","15.75"
"10","007","00","011","1108","0662","709","221","488","49","758","1403","0","54.03","15.75"
"10","007","00","011","1109","0000","1530","479","1051","104","1634","3033","0","53.87","15.79"
"10","007","00","011","1109","0663","638","190","448","60","698","1397","0","49.96","13.6"
"10","007","00","011","1109","0664","892","289","603","44","936","1636","0","57.21","17.67"
"10","007","00","011","1110","0000","1383","392","991","108","1491","2512","0","59.36","15.61"
"10","007","00","011","1110","0665","721","215","506","55","776","1298","0","59.78","16.56"
"10","007","00","011","1110","0666","662","177","485","53","715","1214","0","58.9","14.58"
"10","007","00","011","1111","0000","1312","410","902","69","1381","2265","0","60.97","18.1"
"10","007","00","011","1111","0667","736","233","503","40","776","1297","0","59.83","17.96"
"10","007","00","011","1111","0668","576","177","399","29","605","968","0","62.5","18.29"
"10","007","00","011","1112","0000","476","152","324","30","506","839","0","60.31","18.12"
"10","007","00","011","1112","0669","476","152","324","30","506","839","0","60.31","18.12"
"10","007","00","011","1113","0000","969","298","671","60","1029","1805","0","57.01","16.51"
"10","007","00","011","1113","0670","509","163","346","43","552","907","0","60.86","17.97"
"10","007","00","011","1113","0671","460","135","325","17","477","898","0","53.12","15.03"
"10","007","00","011","1114","0000","1296","370","926","91","1387","2345","0","59.15","15.78"
"10","007","00","011","1114","0649","633","188","445","42","675","1146","0","58.9","16.4"
"10","007","00","011","1114","0650","663","182","481","49","712","1199","0","59.38","15.18"
"10","007","00","011","1115","0000","470","175","295","28","498","851","0","58.52","20.56"
"10","007","00","011","1115","0653","470","175","295","28","498","851","0","58.52","20.56"
"10","007","00","011","1116","0000","790","280","510","73","863","1365","0","63.22","20.51"
"10","007","00","011","1116","0681","790","280","510","73","863","1365","0","63.22","20.51"
"10","007","00","011","1117","0000","1027","312","715","71","1098","1859","0","59.06","16.78"
"10","007","00","011","1117","0651","478","158","320","44","522","895","0","58.32","17.65"
"10","007","00","011","1117","0652","549","154","395","27","576","964","0","59.75","15.98"
"10","007","00","011","1118","0000","2535","732","1803","101","2636","4689","0","56.22","15.61"
"10","007","00","011","1118","0645","597","157","440","18","615","1123","0","54.76","13.98"
"10","007","00","011","1118","0646","621","183","438","39","660","1166","0","56.6","15.69"
"10","007","00","011","1118","0647","613","176","437","26","639","1151","0","55.52","15.29"
"10","007","00","011","1118","0648","704","216","488","18","722","1249","0","57.81","17.29"
"10","007","00","011","1119","0000","421","121","300","28","449","650","0","69.08","18.62"
"10","007","00","011","1119","0672","421","121","300","28","449","650","0","69.08","18.62"
"10","007","00","011","1120","0000","678","179","499","59","737","1279","0","57.62","14.0"
"10","007","00","011","1120","0673","678","179","499","59","737","1279","0","57.62","14.0"
"10","007","00","011","1121","0000","436","125","311","34","470","730","0","64.38","17.12"
"10","007","00","011","1121","0674","436","125","311","34","470","730","0","64.38","17.12"
"10","007","00","011","1122","0000","776","209","567","42","818","1407","0","58.14","14.85"
"10","007","00","011","1122","0675","776","209","567","42","818","1407","0","58.14","14.85"
"10","007","00","011","1123","0000","589","177","412","58","647","1273","0","50.82","13.9"
"10","007","00","011","1123","0676","589","177","412","58","647","1273","0","50.82","13.9"
"10","007","00","011","1124","0000","1066","307","759","81","1147","2201","0","52.11","13.95"
"10","007","00","011","1124","0679","483","132","351","44","527","1052","0","50.1","12.55"
"10","007","00","011","1124","0680","583","175","408","37","620","1149","0","53.96","15.23"
"10","007","00","011","1125","0000","964","293","671","59","1023","1742","0","58.73","16.82"
"10","007","00","011","1125","0677","517","151","366","25","542","988","0","54.86","15.28"
"10","007","00","011","1125","0678","447","142","305","34","481","754","0","63.79","18.83"
"10","007","00","012","0000","0000","19023","5778","13245","1405","20428","35391","41599","57.72","16.33"
"10","007","00","012","1201","0000","425","128","297","55","480","854","0","56.21","14.99"
"10","007","00","012","1201","0742","425","128","297","55","480","854","0","56.21","14.99"
"10","007","00","012","1202","0000","495","143","352","42","537","1138","0","47.19","12.57"
"10","007","00","012","1202","0743","453","132","321","39","492","963","0","51.09","13.71"
"10","007","00","012","1202","0744","42","11","31","3","45","175","0","25.71","6.29"
"10","007","00","012","1203","0000","360","101","259","34","394","739","0","53.32","13.67"
"10","007","00","012","1203","0745","360","101","259","34","394","739","0","53.32","13.67"
"10","007","00","012","1204","0000","837","419","418","56","893","1567","0","56.99","26.74"
"10","007","00","012","1204","0746","421","119","302","25","446","826","0","54.0","14.41"
"10","007","00","012","1204","0747","416","300","116","31","447","741","0","60.32","40.49"
"10","007","00","012","1205","0000","709","213","496","58","767","1507","0","50.9","14.13"
"10","007","00","012","1205","0748","233","67","166","9","242","506","0","47.83","13.24"
"10","007","00","012","1205","0749","476","146","330","49","525","1001","0","52.45","14.59"
"10","007","00","012","1206","0000","680","188","492","65","745","1281","0","58.16","14.68"
"10","007","00","012","1206","0750","680","188","492","65","745","1281","0","58.16","14.68"
"10","007","00","012","1207","0000","992","278","714","65","1057","1757","0","60.16","15.82"
"10","007","00","012","1207","0753","492","146","346","30","522","844","0","61.85","17.3"
"10","007","00","012","1207","0754","500","132","368","35","535","913","0","58.6","14.46"
"10","007","00","012","1208","0000","371","84","287","35","406","613","0","66.23","13.7"
"10","007","00","012","1208","0755","371","84","287","35","406","613","0","66.23","13.7"
"10","007","00","012","1209","0000","1984","557","1427","119","2103","3351","0","62.76","16.62"
"10","007","00","012","1209","0756","768","218","550","45","813","1382","0","58.83","15.77"
"10","007","00","012","1209","0757","636","177","459","37","673","1034","0","65.09","17.12"
"10","007","00","012","1209","0758","580","162","418","37","617","935","0","65.99","17.33"
"10","007","00","012","1210","0000","1245","390","855","73","1318","2401","0","54.89","16.24"
"10","007","00","012","1210","0759","613","216","397","40","653","1301","0","50.19","16.6"
"10","007","00","012","1210","0760","632","174","458","33","665","1100","0","60.45","15.82"
"10","007","00","012","1211","0000","617","204","413","35","652","1071","0","60.88","19.05"
"10","007","00","012","1211","0761","617","204","413","35","652","1071","0","60.88","19.05"
"10","007","00","012","1212","0000","694","200","494","39","733","1163","0","63.03","17.2"
"10","007","00","012","1212","0762","694","200","494","39","733","1163","0","63.03","17.2"
"10","007","00","012","1213","0000","1161","336","825","86","1247","1964","0","63.49","17.11"
"10","007","00","012","1213","0763","496","139","357","39","535","809","0","66.13","17.18"
"10","007","00","012","1213","0764","665","197","468","47","712","1155","0","61.65","17.06"
"10","007","00","012","1214","0000","1291","423","868","84","1375","2362","0","58.21","17.91"
"10","007","00","012","1214","0751","550","162","388","43","593","1035","0","57.29","15.65"
"10","007","00","012","1214","0752","741","261","480","41","782","1327","0","58.93","19.67"
"10","007","00","012","1215","0000","837","252","585","78","915","1606","0","56.97","15.69"
"10","007","00","012","1215","0766","462","140","322","27","489","870","0","56.21","16.09"
"10","007","00","012","1215","0767","375","112","263","51","426","736","0","57.88","15.22"
"10","007","00","012","1216","0000","656","191","465","42","698","1335","0","52.28","14.31"
"10","007","00","012","1216","0768","656","191","465","42","698","1335","0","52.28","14.31"
"10","007","00","012","1217","0000","916","275","641","82","998","1774","0","56.26","15.5"
"10","007","00","012","1217","0769","470","131","339","33","503","876","0","57.42","14.95"
"10","007","00","012","1217","0770","446","144","302","49","495","898","0","55.12","16.04"
"10","007","00","012","1218","0000","2272","677","1595","135","2407","4224","0","56.98","16.03"
"10","007","00","012","1218","0771","740","230","510","21","761","1298","0","58.63","17.72"
"10","007","00","012","1218","0772","742","214","528","66","808","1451","0","55.69","14.75"
"10","007","00","012","1218","0773","790","233","557","48","838","1475","0","56.81","15.8"
"10","007","00","012","1219","0000","679","209","470","57","736","1270","0","57.95","16.46"
"10","007","00","012","1219","0765","679","209","470","57","736","1270","0","57.95","16.46"
"10","007","00","012","1220","0000","788","205","583","57","845","1576","0","53.62","13.01"
"10","007","00","012","1220","0774","367","108","259","35","402","766","0","52.48","14.1"
"10","007","00","012","1220","0775","421","97","324","22","443","810","0","54.69","11.98"
"10","007","00","012","1221","0000","518","166","352","49","567","953","0","59.5","17.42"
"10","007","00","012","1221","0776","518","166","352","49","567","953","0","59.5","17.42"
"10","007","00","012","1222","0000","496","139","357","59","555","885","0","62.71","15.71"
"10","007","00","012","1222","0777","496","139","357","59","555","885","0","62.71","15.71"
"10","007","00","013","0000","0000","17490","5500","11990","1089","18579","31492","36907","59.0","17.46"
"10","007","00","013","1301","0000","1857","559","1298","127","1984","3152","0","62.94","17.73"
"10","007","00","013","1301","0579","845","253","592","60","905","1426","0","63.46","17.74"
"10","007","00","013","1301","0580","1012","306","706","67","1079","1726","0","62.51","17.73"
"10","007","00","013","1302","0000","890","280","610","64","954","1542","0","61.87","18.16"
"10","007","00","013","1302","0581","457","139","318","47","504","797","0","63.24","17.44"
"10","007","00","013","1302","0582","433","141","292","17","450","745","0","60.4","18.93"
"10","007","00","013","1303","0000","784","239","545","51","835","1426","0","58.56","16.76"
"10","007","00","013","1303","0585","784","239","545","51","835","1426","0","58.56","16.76"
"10","007","00","013","1304","0000","648","168","480","47","695","1125","0","61.78","14.93"
"10","007","00","013","1304","0583","648","168","480","47","695","1125","0","61.78","14.93"
"10","007","00","013","1305","0000","605","435","170","34","639","1161","0","55.04","37.47"
"10","007","00","013","1305","0591","605","435","170","34","639","1161","0","55.04","37.47"
"10","007","00","013","1306","0000","1547","508","1039","74","1621","2813","0","57.63","18.06"
"10","007","00","013","1306","0594","772","253","519","49","821","1412","0","58.14","17.92"
"10","007","00","013","1306","0595","775","255","520","25","800","1401","0","57.1","18.2"
"10","007","00","013","1307","0000","1720","513","1207","85","1805","3028","0","59.61","16.94"
"10","007","00","013","1307","0597","566","175","391","31","597","996","0","59.94","17.57"
"10","007","00","013","1307","0598","586","181","405","26","612","1047","0","58.45","17.29"
"10","007","00","013","1307","0599","568","157","411","28","596","985","0","60.51","15.94"
"10","007","00","013","1308","0000","1335","401","934","83","1418","2494","0","56.86","16.08"
"10","007","00","013","1308","0604","672","215","457","37","709","1189","0","59.63","18.08"
"10","007","00","013","1308","0605","663","186","477","46","709","1305","0","54.33","14.25"
"10","007","00","013","1309","0000","796","236","560","69","865","1486","0","58.21","15.88"
"10","007","00","013","1309","0584","796","236","560","69","865","1486","0","58.21","15.88"
"10","007","00","013","1310","0000","831","249","582","50","881","1478","0","59.61","16.85"
"10","007","00","013","1310","0588","831","249","582","50","881","1478","0","59.61","16.85"
"10","007","00","013","1311","0000","807","231","576","38","845","1395","0","60.57","16.56"
"10","007","00","013","1311","0596","807","231","576","38","845","1395","0","60.57","16.56"
"10","007","00","013","1312","0000","1082","317","765","61","1143","2001","0","57.12","15.84"
"10","007","00","013","1312","0586","498","127","371","26","524","824","0","63.59","15.41"
"10","007","00","013","1312","0587","584","190","394","35","619","1177","0","52.59","16.14"
"10","007","00","013","1313","0000","885","275","610","59","944","1591","0","59.33","17.28"
"10","007","00","013","1313","0589","407","126","281","19","426","779","0","54.69","16.17"
"10","007","00","013","1313","0590","478","149","329","40","518","812","0","63.79","18.35"
"10","007","00","013","1314","0000","1319","378","941","72","1391","2497","0","55.71","15.14"
"10","007","00","013","1314","0592","638","175","463","26","664","1238","0","53.63","14.14"
"10","007","00","013","1314","0593","681","203","478","46","727","1259","0","57.74","16.12"
"10","007","00","013","1315","0000","1292","368","924","75","1367","2254","0","60.65","16.33"
"10","007","00","013","1315","0600","614","185","429","45","659","1054","0","62.52","17.55"
"10","007","00","013","1315","0601","678","183","495","30","708","1200","0","59.0","15.25"
"10","007","00","013","1316","0000","1092","343","749","100","1192","2049","0","58.17","16.74"
"10","007","00","013","1316","0602","560","168","392","58","618","1003","0","61.62","16.75"
"10","007","00","013","1316","0603","532","175","357","42","574","1046","0","54.88","16.73"
"10","007","00","014","0000","0000","15750","4272","11478","1191","16941","28026","32517","60.45","15.24"
"10","007","00","014","1401","0000","1024","257","767","63","1087","1712","0","63.49","15.01"
"10","007","00","014","1401","0682","556","137","419","37","593","958","0","61.9","14.3"
"10","007","00","014","1401","0683","468","120","348","26","494","754","0","65.52","15.92"
"10","007","00","014","1402","0000","952","276","676","54","1006","1563","0","64.36","17.66"
"10","007","00","014","1402","0684","477","146","331","24","501","757","0","66.18","19.29"
"10","007","00","014","1402","0685","475","130","345","30","505","806","0","62.66","16.13"
"10","007","00","014","1403","0000","731","192","539","39","770","1280","0","60.16","15.0"
"10","007","00","014","1403","0686","731","192","539","39","770","1280","0","60.16","15.0"
"10","007","00","014","1404","0000","523","131","392","30","553","928","0","59.59","14.12"
"10","007","00","014","1404","0687","523","131","392","30","553","928","0","59.59","14.12"
"10","007","00","014","1405","0000","1032","293","739","88","1120","1710","0","65.5","17.13"
"10","007","00","014","1405","0688","549","166","383","44","593","895","0","66.26","18.55"
"10","007","00","014","1405","0689","483","127","356","44","527","815","0","64.66","15.58"
"10","007","00","014","1406","0000","532","156","376","28","560","957","0","58.52","16.3"
"10","007","00","014","1406","0690","532","156","376","28","560","957","0","58.52","16.3"
"10","007","00","014","1407","0000","711","171","540","82","793","1338","0","59.27","12.78"
"10","007","00","014","1407","0691","711","171","540","82","793","1338","0","59.27","12.78"
"10","007","00","014","1408","0000","594","165","429","46","640","1106","0","57.87","14.92"
"10","007","00","014","1408","0692","594","165","429","46","640","1106","0","57.87","14.92"
"10","007","00","014","1409","0000","445","130","315","30","475","690","0","68.84","18.84"
"10","007","00","014","1409","0693","445","130","315","30","475","690","0","68.84","18.84"
"10","007","00","014","1410","0000","672","182","490","34","706","1230","0","57.4","14.8"
"10","007","00","014","1410","0694","672","182","490","34","706","1230","0","57.4","14.8"
"10","007","00","014","1411","0000","1015","300","715","50","1065","1744","0","61.07","17.2"
"10","007","00","014","1411","0695","478","149","329","24","502","847","0","59.27","17.59"
"10","007","00","014","1411","0696","537","151","386","26","563","897","0","62.76","16.83"
"10","007","00","014","1412","0000","1157","315","842","90","1247","2062","0","60.48","15.28"
"10","007","00","014","1412","0697","486","149","337","46","532","882","0","60.32","16.89"
"10","007","00","014","1412","0698","671","166","505","44","715","1180","0","60.59","14.07"
"10","007","00","014","1413","0000","634","209","425","71","705","1215","0","58.02","17.2"
"10","007","00","014","1413","0699","634","209","425","71","705","1215","0","58.02","17.2"
"10","007","00","014","1414","0000","263","53","210","18","281","422","0","66.59","12.56"
"10","007","00","014","1414","0700","263","53","210","18","281","422","0","66.59","12.56"
"10","007","00","014","1415","0000","574","146","428","45","619","1106","0","55.97","13.2"
"10","007","00","014","1415","0701","574","146","428","45","619","1106","0","55.97","13.2"
"10","007","00","014","1416","0000","521","123","398","48","569","874","0","65.1","14.07"
"10","007","00","014","1416","0702","521","123","398","48","569","874","0","65.1","14.07"
"10","007","00","014","1417","0000","776","236","540","99","875","1445","0","60.55","16.33"
"10","007","00","014","1417","0703","776","236","540","99","875","1445","0","60.55","16.33"
"10","007","00","014","1418","0000","490","100","390","46","536","875","0","61.26","11.43"
"10","007","00","014","1418","0704","490","100","390","46","536","875","0","61.26","11.43"
"10","007","00","014","1419","0000","791","201","590","69","860","1522","0","56.5","13.21"
"10","007","00","014","1419","0705","411","109","302","37","448","837","0","53.52","13.02"
"10","007","00","014","1419","0706","380","92","288","32","412","685","0","60.15","13.43"
"10","007","00","014","1420","0000","895","258","637","74","969","1531","0","63.29","16.85"
"10","007","00","014","1420","0707","439","137","302","31","470","733","0","64.12","18.69"
"10","007","00","014","1420","0708","456","121","335","43","499","798","0","62.53","15.16"
"10","007","00","014","1421","0000","745","200","545","46","791","1381","0","57.28","14.48"
"10","007","00","014","1421","0709","745","200","545","46","791","1381","0","57.28","14.48"
"10","007","00","014","1422","0000","673","178","495","41","714","1335","0","53.48","13.33"
"10","007","00","014","1422","0710","673","178","495","41","714","1335","0","53.48","13.33"
"10","007","00","015","0000","0000","17109","5282","11827","1294","18403","29642","34739","62.08","17.82"
"10","007","00","015","1501","0000","2058","580","1478","143","2201","3604","0","61.07","16.09"
"10","007","00","015","1501","0711","654","187","467","59","713","1139","0","62.6","16.42"
"10","007","00","015","1501","0712","668","168","500","48","716","1217","0","58.83","13.8"
"10","007","00","015","1501","0713","736","225","511","36","772","1248","0","61.86","18.03"
"10","007","00","015","1502","0000","738","326","412","63","801","1248","0","64.18","26.12"
"10","007","00","015","1502","0714","738","326","412","63","801","1248","0","64.18","26.12"
"10","007","00","015","1503","0000","921","306","615","56","977","1541","0","63.4","19.86"
"10","007","00","015","1503","0715","531","165","366","36","567","916","0","61.9","18.01"
"10","007","00","015","1503","0716","390","141","249","20","410","625","0","65.6","22.56"
"10","007","00","015","1504","0000","669","204","465","63","732","1271","0","57.59","16.05"
"10","007","00","015","1504","0717","669","204","465","63","732","1271","0","57.59","16.05"
"10","007","00","015","1505","0000","1024","287","737","98","1122","1740","0","64.48","16.49"
"10","007","00","015","1505","0718","361","91","270","31","392","608","0","64.47","14.97"
"10","007","00","015","1505","0719","663","196","467","67","730","1132","0","64.49","17.31"
"10","007","00","015","1506","0000","1142","331","811","89","1231","1953","0","63.03","16.95"
"10","007","00","015","1506","0720","598","173","425","46","644","1027","0","62.71","16.85"
"10","007","00","015","1506","0721","544","158","386","43","587","926","0","63.39","17.06"
"10","007","00","015","1507","0000","832","244","588","83","915","1438","0","63.63","16.97"
"10","007","00","015","1507","0722","430","140","290","52","482","778","0","61.95","17.99"
"10","007","00","015","1507","0723","402","104","298","31","433","660","0","65.61","15.76"
"10","007","00","015","1508","0000","1187","375","812","63","1250","2019","0","61.91","18.57"
"10","007","00","015","1508","0726","628","183","445","31","659","985","0","66.9","18.58"
"10","007","00","015","1508","0727","559","192","367","32","591","1034","0","57.16","18.57"
"10","007","00","015","1509","0000","1353","418","935","62","1415","2321","0","60.97","18.01"
"10","007","00","015","1509","0724","780","226","554","42","822","1330","0","61.8","16.99"
"10","007","00","015","1509","0725","573","192","381","20","593","991","0","59.84","19.37"
"10","007","00","015","1510","0000","355","107","248","43","398","612","0","65.03","17.48"
"10","007","00","015","1510","0728","355","107","248","43","398","612","0","65.03","17.48"
"10","007","00","015","1511","0000","735","209","526","60","795","1236","0","64.32","16.91"
"10","007","00","015","1511","0729","735","209","526","60","795","1236","0","64.32","16.91"
"10","007","00","015","1512","0000","918","269","649","70","988","1513","0","65.3","17.78"
"10","007","00","015","1512","0730","454","132","322","40","494","775","0","63.74","17.03"
"10","007","00","015","1512","0731","464","137","327","30","494","738","0","66.94","18.56"
"10","007","00","015","1513","0000","603","219","384","37","640","1036","0","61.78","21.14"
"10","007","00","015","1513","0732","603","219","384","37","640","1036","0","61.78","21.14"
"10","007","00","015","1514","0000","508","167","341","54","562","975","0","57.64","17.13"
"10","007","00","015","1514","0733","508","167","341","54","562","975","0","57.64","17.13"
"10","007","00","015","1515","0000","785","215","570","51","836","1348","0","62.02","15.95"
"10","007","00","015","1515","0736","403","107","296","24","427","689","0","61.97","15.53"
"10","007","00","015","1515","0737","382","108","274","27","409","659","0","62.06","16.39"
"10","007","00","015","1516","0000","1045","317","728","88","1133","1824","0","62.12","17.38"
"10","007","00","015","1516","0734","498","146","352","43","541","885","0","61.13","16.5"
"10","007","00","015","1516","0735","547","171","376","45","592","939","0","63.05","18.21"
"10","007","00","015","1517","0000","835","261","574","57","892","1352","0","65.98","19.3"
"10","007","00","015","1517","0739","835","261","574","57","892","1352","0","65.98","19.3"
"10","007","00","015","1518","0000","466","147","319","32","498","910","0","54.73","16.15"
"10","007","00","015","1518","0738","466","147","319","32","498","910","0","54.73","16.15"
"10","007","00","015","1519","0000","412","135","277","36","448","759","0","59.03","17.79"
"10","007","00","015","1519","0740","412","135","277","36","448","759","0","59.03","17.79"
"10","007","00","015","1520","0000","523","165","358","46","569","942","0","60.4","17.52"
"10","007","00","015","1520","0741","523","165","358","46","569","942","0","60.4","17.52"
"10","007","00","016","0000","0000","17432","5651","11781","1192","18624","31239","37055","59.62","18.09"
"10","007","00","016","1601","0000","512","176","336","34","546","792","0","68.94","22.22"
"10","007","00","016","1601","0616","512","176","336","34","546","792","0","68.94","22.22"
"10","007","00","016","1602","0000","901","292","609","56","957","1516","0","63.13","19.26"
"10","007","00","016","1602","0617","418","164","254","29","447","695","0","64.32","23.6"
"10","007","00","016","1602","0618","483","128","355","27","510","821","0","62.12","15.59"
"10","007","00","016","1603","0000","1087","359","728","72","1159","1904","0","60.87","18.86"
"10","007","00","016","1603","0619","627","196","431","43","670","1064","0","62.97","18.42"
"10","007","00","016","1603","0620","460","163","297","29","489","840","0","58.21","19.4"
"10","007","00","016","1604","0000","1249","419","830","71","1320","2127","0","62.06","19.7"
"10","007","00","016","1604","0621","640","205","435","26","666","1079","0","61.72","19.0"
"10","007","00","016","1604","0622","609","214","395","45","654","1048","0","62.4","20.42"
"10","007","00","016","1605","0000","1043","331","712","61","1104","1758","0","62.8","18.83"
"10","007","00","016","1605","0623","581","167","414","34","615","960","0","64.06","17.4"
"10","007","00","016","1605","0624","462","164","298","27","489","798","0","61.28","20.55"
"10","007","00","016","1606","0000","837","258","579","78","915","1458","0","62.76","17.7"
"10","007","00","016","1606","0625","479","145","334","50","529","796","0","66.46","18.22"
"10","007","00","016","1606","0626","358","113","245","28","386","662","0","58.31","17.07"
"10","007","00","016","1607","0000","575","173","402","33","608","1040","0","58.46","16.63"
"10","007","00","016","1607","0627","575","173","402","33","608","1040","0","58.46","16.63"
"10","007","00","016","1608","0000","551","158","393","36","587","1025","0","57.27","15.41"
"10","007","00","016","1608","0628","551","158","393","36","587","1025","0","57.27","15.41"
"10","007","00","016","1609","0000","1540","444","1096","89","1629","2593","0","62.82","17.12"
"10","007","00","016","1609","0629","836","236","600","40","876","1357","0","64.55","17.39"
"10","007","00","016","1609","0630","704","208","496","49","753","1236","0","60.92","16.83"
"10","007","00","016","1610","0000","804","286","518","51","855","1393","0","61.38","20.53"
"10","007","00","016","1610","0611","392","132","260","28","420","659","0","63.73","20.03"
"10","007","00","016","1610","0612","412","154","258","23","435","734","0","59.26","20.98"
"10","007","00","016","1611","0000","606","173","433","58","664","1255","0","52.91","13.78"
"10","007","00","016","1611","0606","606","173","433","58","664","1255","0","52.91","13.78"
"10","007","00","016","1612","0000","922","526","396","81","1003","1648","0","60.86","31.92"
"10","007","00","016","1612","0609","408","119","289","42","450","724","0","62.15","16.44"
"10","007","00","016","1612","0610","514","407","107","39","553","924","0","59.85","44.05"
"10","007","00","016","1613","0000","1061","294","767","69","1130","1915","0","59.01","15.35"
"10","007","00","016","1613","0607","506","136","370","45","551","889","0","61.98","15.3"
"10","007","00","016","1613","0608","555","158","397","24","579","1026","0","56.43","15.4"
"10","007","00","016","1614","0000","886","246","640","47","933","1606","0","58.09","15.32"
"10","007","00","016","1614","0613","361","109","252","10","371","758","0","48.94","14.38"
"10","007","00","016","1614","0614","525","137","388","37","562","848","0","66.27","16.16"
"10","007","00","016","1615","0000","684","206","478","66","750","1404","0","53.42","14.67"
"10","007","00","016","1615","0615","684","206","478","66","750","1404","0","53.42","14.67"
"10","007","00","016","1616","0000","482","148","334","42","524","871","0","60.16","16.99"
"10","007","00","016","1616","0631","482","148","334","42","524","871","0","60.16","16.99"
"10","007","00","016","1617","0000","323","97","226","33","356","706","0","50.42","13.74"
"10","007","00","016","1617","0632","323","97","226","33","356","706","0","50.42","13.74"
"10","007","00","016","1618","0000","467","137","330","33","500","770","0","64.94","17.79"
"10","007","00","016","1618","0633","467","137","330","33","500","770","0","64.94","17.79"
"10","007","00","016","1619","0000","423","181","242","18","441","669","0","65.92","27.06"
"10","007","00","016","1619","0634","423","181","242","18","441","669","0","65.92","27.06"
"10","007","00","016","1620","0000","479","176","303","20","499","862","0","57.89","20.42"
"10","007","00","016","1620","0635","479","176","303","20","499","862","0","57.89","20.42"
"10","007","00","016","1621","0000","453","120","333","22","475","847","0","56.08","14.17"
"10","007","00","016","1621","0636","453","120","333","22","475","847","0","56.08","14.17"
"10","007","00","016","1622","0000","385","116","269","43","428","668","0","64.07","17.37"
"10","007","00","016","1622","0637","385","116","269","43","428","668","0","64.07","17.37"
"10","007","00","016","1623","0000","542","140","402","27","569","1073","0","53.03","13.05"
"10","007","00","016","1623","0638","542","140","402","27","569","1073","0","53.03","13.05"
"10","007","00","016","1624","0000","620","195","425","52","672","1339","0","50.19","14.56"
"10","007","00","016","1624","0639","620","195","425","52","672","1339","0","50.19","14.56"
"10","007","00","017","0000","0000","19757","5908","13849","1224","20981","36306","42917","57.79","16.27"
"10","007","00","017","1701","0000","1472","467","1005","88","1560","2765","0","56.42","16.89"
"10","007","00","017","1701","0778","436","144","292","31","467","791","0","59.04","18.2"
"10","007","00","017","1701","0779","525","170","355","33","558","984","0","56.71","17.28"
"10","007","00","017","1701","0780","511","153","358","24","535","990","0","54.04","15.45"
"10","007","00","017","1702","0000","752","224","528","61","813","1478","0","55.01","15.16"
"10","007","00","017","1702","0785","398","124","274","29","427","753","0","56.71","16.47"
"10","007","00","017","1702","0786","354","100","254","32","386","725","0","53.24","13.79"
"10","007","00","017","1703","0000","631","198","433","43","674","1165","0","57.85","17.0"
"10","007","00","017","1703","0805","631","198","433","43","674","1165","0","57.85","17.0"
"10","007","00","017","1704","0000","2552","790","1762","154","2706","4546","0","59.52","17.38"
"10","007","00","017","1704","0781","600","180","420","32","632","1016","0","62.2","17.72"
"10","007","00","017","1704","0782","620","188","432","39","659","1091","0","60.4","17.23"
"10","007","00","017","1704","0783","689","226","463","54","743","1236","0","60.11","18.28"
"10","007","00","017","1704","0784","643","196","447","29","672","1203","0","55.86","16.29"
"10","007","00","017","1705","0000","535","141","394","25","560","933","0","60.02","15.11"
"10","007","00","017","1705","0790","535","141","394","25","560","933","0","60.02","15.11"
"10","007","00","017","1706","0000","596","177","419","21","617","1092","0","56.5","16.21"
"10","007","00","017","1706","0812","596","177","419","21","617","1092","0","56.5","16.21"
"10","007","00","017","1707","0000","1502","421","1081","73","1575","2698","0","58.38","15.6"
"10","007","00","017","1707","0798","386","104","282","18","404","688","0","58.72","15.12"
"10","007","00","017","1707","0799","462","114","348","28","490","870","0","56.32","13.1"
"10","007","00","017","1707","0800","654","203","451","27","681","1140","0","59.74","17.81"
"10","007","00","017","1708","0000","1109","339","770","79","1188","2066","0","57.5","16.41"
"10","007","00","017","1708","0791","559","178","381","46","605","990","0","61.11","17.98"
"10","007","00","017","1708","0792","550","161","389","33","583","1076","0","54.18","14.96"
"10","007","00","017","1709","0000","441","138","303","18","459","724","0","63.4","19.06"
"10","007","00","017","1709","0807","441","138","303","18","459","724","0","63.4","19.06"
"10","007","00","017","1710","0000","532","148","384","23","555","937","0","59.23","15.8"
"10","007","00","017","1710","0803","532","148","384","23","555","937","0","59.23","15.8"
"10","007","00","017","1711","0000","872","279","593","68","940","1645","0","57.14","16.96"
"10","007","00","017","1711","0796","418","142","276","35","453","750","0","60.4","18.93"
"10","007","00","017","1711","0797","454","137","317","33","487","895","0","54.41","15.31"
"10","007","00","017","1712","0000","559","172","387","40","599","992","0","60.38","17.34"
"10","007","00","017","1712","0811","559","172","387","40","599","992","0","60.38","17.34"
"10","007","00","017","1713","0000","744","214","530","46","790","1266","0","62.4","16.9"
"10","007","00","017","1713","0802","744","214","530","46","790","1266","0","62.4","16.9"
"10","007","00","017","1714","0000","796","234","562","34","830","1414","0","58.7","16.55"
"10","007","00","017","1714","0793","440","135","305","14","454","742","0","61.19","18.19"
"10","007","00","017","1714","0794","356","99","257","20","376","672","0","55.95","14.73"
"10","007","00","017","1715","0000","559","140","419","32","591","1015","0","58.23","13.79"
"10","007","00","017","1715","0808","559","140","419","32","591","1015","0","58.23","13.79"
"10","007","00","017","1716","0000","543","160","383","38","581","985","0","58.98","16.24"
"10","007","00","017","1716","0801","543","160","383","38","581","985","0","58.98","16.24"
"10","007","00","017","1717","0000","594","150","444","34","628","1235","0","50.85","12.15"
"10","007","00","017","1717","0795","594","150","444","34","628","1235","0","50.85","12.15"
"10","007","00","017","1718","0000","474","144","330","36","510","828","0","61.59","17.39"
"10","007","00","017","1718","0813","474","144","330","36","510","828","0","61.59","17.39"
"10","007","00","017","1719","0000","913","291","622","58","971","1611","0","60.27","18.06"
"10","007","00","017","1719","0788","356","125","231","28","384","562","0","68.33","22.24"
"10","007","00","017","1719","0789","557","166","391","30","587","1049","0","55.96","15.82"
"10","007","00","017","1720","0000","549","169","380","41","590","986","0","59.84","17.14"
"10","007","00","017","1720","0806","549","169","380","41","590","986","0","59.84","17.14"
"10","007","00","017","1721","0000","722","245","477","64","786","1506","0","52.19","16.27"
"10","007","00","017","1721","0814","378","134","244","46","424","787","0","53.88","17.03"
"10","007","00","017","1721","0815","344","111","233","18","362","719","0","50.35","15.44"
"10","007","00","017","1722","0000","572","176","396","52","624","1023","0","61.0","17.2"
"10","007","00","017","1722","0787","572","176","396","52","624","1023","0","61.0","17.2"
"10","007","00","017","1723","0000","658","182","476","32","690","1219","0","56.6","14.93"
"10","007","00","017","1723","0804","658","182","476","32","690","1219","0","56.6","14.93"
"10","007","00","017","1724","0000","1080","309","771","64","1144","2177","0","52.55","14.19"
"10","007","00","017","1724","0809","540","154","386","32","572","1116","0","51.25","13.8"
"10","007","00","017","1724","0810","540","155","385","32","572","1061","0","53.91","14.61"
"10","007","00","018","0000","0000","7447","2152","5295","672","8119","13339","15193","60.87","16.13"
"10","007","00","018","1801","0000","419","119","300","54","473","871","0","54.31","13.66"
"10","007","00","018","1801","0818","419","119","300","54","473","871","0","54.31","13.66"
"10","007","00","018","1802","0000","515","136","379","50","565","953","0","59.29","14.27"
"10","007","00","018","1802","0819","515","136","379","50","565","953","0","59.29","14.27"
"10","007","00","018","1803","0000","303","82","221","38","341","624","0","54.65","13.14"
"10","007","00","018","1803","0820","303","82","221","38","341","624","0","54.65","13.14"
"10","007","00","018","1804","0000","391","140","251","39","430","645","0","66.67","21.71"
"10","007","00","018","1804","0821","391","140","251","39","430","645","0","66.67","21.71"
"10","007","00","018","1805","0000","576","193","383","48","624","943","0","66.17","20.47"
"10","007","00","018","1805","0823","576","193","383","48","624","943","0","66.17","20.47"
"10","007","00","018","1806","0000","661","160","501","37","698","986","0","70.79","16.23"
"10","007","00","018","1806","0822","661","160","501","37","698","986","0","70.79","16.23"
"10","007","00","018","1807","0000","527","160","367","33","560","831","0","67.39","19.25"
"10","007","00","018","1807","0825","527","160","367","33","560","831","0","67.39","19.25"
"10","007","00","018","1808","0000","276","80","196","9","285","455","0","62.64","17.58"
"10","007","00","018","1808","0824","276","80","196","9","285","455","0","62.64","17.58"
"10","007","00","018","1809","0000","541","143","398","31","572","1013","0","56.47","14.12"
"10","007","00","018","1809","0827","541","143","398","31","572","1013","0","56.47","14.12"
"10","007","00","018","1810","0000","481","140","341","36","517","831","0","62.21","16.85"
"10","007","00","018","1810","0826","481","140","341","36","517","831","0","62.21","16.85"
"10","007","00","018","1811","0000","443","115","328","62","505","796","0","63.44","14.45"
"10","007","00","018","1811","0828","443","115","328","62","505","796","0","63.44","14.45"
"10","007","00","018","1812","0000","404","119","285","46","450","781","0","57.62","15.24"
"10","007","00","018","1812","0829","404","119","285","46","450","781","0","57.62","15.24"
"10","007","00","018","1813","0000","337","107","230","20","357","692","0","51.59","15.46"
"10","007","00","018","1813","0830","337","107","230","20","357","692","0","51.59","15.46"
"10","007","00","018","1814","0000","350","104","246","23","373","635","0","58.74","16.38"
"10","007","00","018","1814","0831","350","104","246","23","373","635","0","58.74","16.38"
"10","007","00","018","1815","0000","299","88","211","29","328","566","0","57.95","15.55"
"10","007","00","018","1815","0832","299","88","211","29","328","566","0","57.95","15.55"
"10","007","00","018","1816","0000","548","164","384","60","608","1028","0","59.14","15.95"
"10","007","00","018","1816","0816","548","164","384","60","608","1028","0","59.14","15.95"
"10","007","00","018","1817","0000","376","102","274","57","433","689","0","62.84","14.8"
"10","007","00","018","1817","0817","376","102","274","57","433","689","0","62.84","14.8"
"10","007","00","019","0000","0000","15061","4843","10218","1070","16131","27593","33335","58.46","17.55"
"10","007","00","019","1901","0000","1020","299","721","60","1080","1790","0","60.34","16.7"
"10","007","00","019","1901","0844","477","126","351","34","511","833","0","61.34","15.13"
"10","007","00","019","1901","0845","543","173","370","26","569","957","0","59.46","18.08"
"10","007","00","019","1902","0000","396","115","281","27","423","783","0","54.02","14.69"
"10","007","00","019","1902","0846","396","115","281","27","423","783","0","54.02","14.69"
"10","007","00","019","1903","0000","282","93","189","37","319","573","0","55.67","16.23"
"10","007","00","019","1903","0847","282","93","189","37","319","573","0","55.67","16.23"
"10","007","00","019","1904","0000","370","131","239","18","388","672","0","57.74","19.49"
"10","007","00","019","1904","0848","370","131","239","18","388","672","0","57.74","19.49"
"10","007","00","019","1905","0000","722","242","480","61","783","1442","0","54.3","16.78"
"10","007","00","019","1905","0849","349","133","216","33","382","695","0","54.96","19.14"
"10","007","00","019","1905","0850","373","109","264","28","401","747","0","53.68","14.59"
"10","007","00","019","1906","0000","762","218","544","52","814","1305","0","62.38","16.7"
"10","007","00","019","1906","0851","396","116","280","17","413","643","0","64.23","18.04"
"10","007","00","019","1906","0852","366","102","264","35","401","662","0","60.57","15.41"
"10","007","00","019","1907","0000","1262","386","876","100","1362","2206","0","61.74","17.5"
"10","007","00","019","1907","0853","639","190","449","50","689","1085","0","63.5","17.51"
"10","007","00","019","1907","0854","623","196","427","50","673","1121","0","60.04","17.48"
"10","007","00","019","1908","0000","1635","495","1140","81","1716","3017","0","56.88","16.41"
"10","007","00","019","1908","0855","478","139","339","32","510","830","0","61.45","16.75"
"10","007","00","019","1908","0856","521","146","375","23","544","975","0","55.79","14.97"
"10","007","00","019","1908","0857","636","210","426","26","662","1212","0","54.62","17.33"
"10","007","00","019","1909","0000","731","223","508","49","780","1302","0","59.91","17.13"
"10","007","00","019","1909","0858","731","223","508","49","780","1302","0","59.91","17.13"
"10","007","00","019","1910","0000","2533","755","1778","176","2709","4597","0","58.93","16.42"
"10","007","00","019","1910","0838","631","187","444","42","673","1124","0","59.88","16.64"
"10","007","00","019","1910","0839","633","206","427","41","674","1096","0","61.5","18.8"
"10","007","00","019","1910","0840","679","195","484","36","715","1213","0","58.94","16.08"
"10","007","00","019","1910","0841","590","167","423","57","647","1164","0","55.58","14.35"
"10","007","00","019","1911","0000","857","541","316","48","905","1608","0","56.28","33.64"
"10","007","00","019","1911","0842","389","117","272","24","413","730","0","56.58","16.03"
"10","007","00","019","1911","0843","468","424","44","24","492","878","0","56.04","48.29"
"10","007","00","019","1912","0000","1470","442","1028","131","1601","2649","0","60.44","16.69"
"10","007","00","019","1912","0833","470","134","336","52","522","925","0","56.43","14.49"
"10","007","00","019","1912","0834","483","156","327","46","529","869","0","60.87","17.95"
"10","007","00","019","1912","0835","517","152","365","33","550","855","0","64.33","17.78"
"10","007","00","019","1913","0000","1099","325","774","81","1180","1893","0","62.33","17.17"
"10","007","00","019","1913","0836","641","198","443","33","674","1065","0","63.29","18.59"
"10","007","00","019","1913","0837","458","127","331","48","506","828","0","61.11","15.34"
"10","007","00","019","1914","0000","962","286","676","85","1047","1994","0","52.51","14.34"
"10","007","00","019","1914","0859","503","151","352","36","539","1077","0","50.05","14.02"
"10","007","00","019","1914","0860","459","135","324","49","508","917","0","55.4","14.72"
"10","007","00","019","1915","0000","960","292","668","64","1024","1762","0","58.12","16.57"
"10","007","00","019","1915","0861","440","135","305","26","466","825","0","56.48","16.36"
"10","007","00","019","1915","0862","520","157","363","38","558","937","0","59.55","16.76"
"10","007","00","020","0000","0000","21009","6416","14593","1678","22687","42976","50709","52.79","14.93"
"10","007","00","020","2001","0000","1162","377","785","77","1239","2148","0","57.68","17.55"
"10","007","00","020","2001","0945","487","154","333","32","519","892","0","58.18","17.26"
"10","007","00","020","2001","0946","675","223","452","45","720","1256","0","57.32","17.75"
"10","007","00","020","2002","0000","1750","506","1244","109","1859","3201","0","58.08","15.81"
"10","007","00","020","2002","0947","532","146","386","41","573","1043","0","54.94","14.0"
"10","007","00","020","2002","0948","618","196","422","32","650","1076","0","60.41","18.22"
"10","007","00","020","2002","0949","600","164","436","36","636","1082","0","58.78","15.16"
"10","007","00","020","2003","0000","723","324","399","52","775","1427","0","54.31","22.7"
"10","007","00","020","2003","0950","723","324","399","52","775","1427","0","54.31","22.7"
"10","007","00","020","2004","0000","1480","473","1007","134","1614","3040","0","53.09","15.56"
"10","007","00","020","2004","0951","479","152","327","48","527","1030","0","51.17","14.76"
"10","007","00","020","2004","0952","496","160","336","46","542","1033","0","52.47","15.49"
"10","007","00","020","2004","0953","505","161","344","40","545","977","0","55.78","16.48"
"10","007","00","020","2005","0000","772","199","573","92","864","1658","0","52.11","12.0"
"10","007","00","020","2005","0954","335","91","244","17","352","683","0","51.54","13.32"
"10","007","00","020","2005","0955","437","108","329","75","512","975","0","52.51","11.08"
"10","007","00","020","2006","0000","532","423","109","64","596","1336","0","44.61","31.66"
"10","007","00","020","2006","0956","532","423","109","64","596","1336","0","44.61","31.66"
"10","007","00","020","2007","0000","429","113","316","51","480","1019","0","47.11","11.09"
"10","007","00","020","2007","0957","429","113","316","51","480","1019","0","47.11","11.09"
"10","007","00","020","2008","0000","405","132","273","40","445","1003","0","44.37","13.16"
"10","007","00","020","2008","0958","405","132","273","40","445","1003","0","44.37","13.16"
"10","007","00","020","2009","0000","605","155","450","44","649","1151","0","56.39","13.47"
"10","007","00","020","2009","0959","605","155","450","44","649","1151","0","56.39","13.47"
"10","007","00","020","2010","0000","819","251","568","90","909","1598","0","56.88","15.71"
"10","007","00","020","2010","0960","819","251","568","90","909","1598","0","56.88","15.71"
"10","007","00","020","2011","0000","1722","514","1208","94","1816","3259","0","55.72","15.77"
"10","007","00","020","2011","0961","753","211","542","46","799","1488","0","53.7","14.18"
"10","007","00","020","2011","0962","969","303","666","48","1017","1771","0","57.43","17.11"
"10","007","00","020","2012","0000","1275","360","915","85","1360","2540","0","53.54","14.17"
"10","007","00","020","2012","0942","295","84","211","22","317","731","0","43.37","11.49"
"10","007","00","020","2012","0943","551","146","405","39","590","1025","0","57.56","14.24"
"10","007","00","020","2012","0944","429","130","299","24","453","784","0","57.78","16.58"
"10","007","00","020","2013","0000","543","185","358","41","584","1360","0","42.94","13.6"
"10","007","00","020","2013","0963","543","185","358","41","584","1360","0","42.94","13.6"
"10","007","00","020","2014","0000","693","166","527","61","754","1613","0","46.75","10.29"
"10","007","00","020","2014","0964","693","166","527","61","754","1613","0","46.75","10.29"
"10","007","00","020","2015","0000","581","178","403","58","639","1228","0","52.04","14.5"
"10","007","00","020","2015","0965","581","178","403","58","639","1228","0","52.04","14.5"
"10","007","00","020","2016","0000","418","111","307","23","441","771","0","57.2","14.4"
"10","007","00","020","2016","0966","418","111","307","23","441","771","0","57.2","14.4"
"10","007","00","020","2017","0000","775","208","567","32","807","1519","0","53.13","13.69"
"10","007","00","020","2017","0967","473","134","339","32","505","858","0","58.86","15.62"
"10","007","00","020","2017","0968","302","74","228","0","302","661","0","45.69","11.2"
"10","007","00","020","2018","0000","550","164","386","83","633","1268","0","49.92","12.93"
"10","007","00","020","2018","0969","550","164","386","83","633","1268","0","49.92","12.93"
"10","007","00","020","2019","0000","516","128","388","24","540","1081","0","49.95","11.84"
"10","007","00","020","2019","0970","516","128","388","24","540","1081","0","49.95","11.84"
"10","007","00","020","2020","0000","1733","476","1257","140","1873","3659","0","51.19","13.01"
"10","007","00","020","2020","0971","566","162","404","32","598","1213","0","49.3","13.36"
"10","007","00","020","2020","0972","703","197","506","38","741","1328","0","55.8","14.83"
"10","007","00","020","2020","0973","464","117","347","70","534","1118","0","47.76","10.47"
"10","007","00","020","2021","0000","446","118","328","33","479","972","0","49.28","12.14"
"10","007","00","020","2021","0975","446","118","328","33","479","972","0","49.28","12.14"
"10","007","00","020","2022","0000","492","140","352","42","534","1157","0","46.15","12.1"
"10","007","00","020","2022","0974","492","140","352","42","534","1157","0","46.15","12.1"
"10","007","00","020","2023","0000","452","136","316","37","489","902","0","54.21","15.08"
"10","007","00","020","2023","0976","452","136","316","37","489","902","0","54.21","15.08"
"10","007","00","020","2024","0000","757","175","582","49","806","1273","0","63.32","13.75"
"10","007","00","020","2024","0977","757","175","582","49","806","1273","0","63.32","13.75"
"10","007","00","020","2025","0000","543","158","385","30","573","1087","0","52.71","14.54"
"10","007","00","020","2025","0978","543","158","385","30","573","1087","0","52.71","14.54"
"10","007","00","020","2026","0000","524","144","380","67","591","987","0","59.88","14.59"
"10","007","00","020","2026","0979","524","144","380","67","591","987","0","59.88","14.59"
"10","007","00","020","2027","0000","312","102","210","26","338","719","0","47.01","14.19"
"10","007","00","020","2027","0980","312","102","210","26","338","719","0","47.01","14.19"
"10","007","00","021","0000","0000","12864","3867","8997","893","13757","23179","27346","59.35","16.68"
"10","007","00","021","2101","0000","632","202","430","40","672","1284","0","52.34","15.73"
"10","007","00","021","2101","0863","632","202","430","40","672","1284","0","52.34","15.73"
"10","007","00","021","2102","0000","571","154","417","36","607","874","0","69.45","17.62"
"10","007","00","021","2102","0873","571","154","417","36","607","874","0","69.45","17.62"
"10","007","00","021","2103","0000","1477","450","1027","101","1578","2562","0","61.59","17.56"
"10","007","00","021","2103","0871","789","260","529","52","841","1376","0","61.12","18.9"
"10","007","00","021","2103","0872","688","190","498","49","737","1186","0","62.14","16.02"
"10","007","00","021","2104","0000","630","186","444","56","686","1079","0","63.58","17.24"
"10","007","00","021","2104","0882","630","186","444","56","686","1079","0","63.58","17.24"
"10","007","00","021","2105","0000","383","124","259","28","411","760","0","54.08","16.32"
"10","007","00","021","2105","0886","383","124","259","28","411","760","0","54.08","16.32"
"10","007","00","021","2106","0000","638","206","432","63","701","1084","0","64.67","19.0"
"10","007","00","021","2106","0887","638","206","432","63","701","1084","0","64.67","19.0"
"10","007","00","021","2107","0000","604","186","418","46","650","1198","0","54.26","15.53"
"10","007","00","021","2107","0884","604","186","418","46","650","1198","0","54.26","15.53"
"10","007","00","021","2108","0000","306","98","208","48","354","621","0","57.0","15.78"
"10","007","00","021","2108","0885","306","98","208","48","354","621","0","57.0","15.78"
"10","007","00","021","2109","0000","731","230","501","49","780","1336","0","58.38","17.22"
"10","007","00","021","2109","0883","731","230","501","49","780","1336","0","58.38","17.22"
"10","007","00","021","2110","0000","699","222","477","33","732","1337","0","54.75","16.6"
"10","007","00","021","2110","0870","699","222","477","33","732","1337","0","54.75","16.6"
"10","007","00","021","2111","0000","880","280","600","46","926","1555","0","59.55","18.01"
"10","007","00","021","2111","0868","354","107","247","15","369","680","0","54.26","15.74"
"10","007","00","021","2111","0869","526","173","353","31","557","875","0","63.66","19.77"
"10","007","00","021","2112","0000","676","177","499","49","725","1187","0","61.08","14.91"
"10","007","00","021","2112","0864","676","177","499","49","725","1187","0","61.08","14.91"
"10","007","00","021","2113","0000","983","264","719","67","1050","1729","0","60.73","15.27"
"10","007","00","021","2113","0865","589","167","422","34","623","1033","0","60.31","16.17"
"10","007","00","021","2113","0866","394","97","297","33","427","696","0","61.35","13.94"
"10","007","00","021","2114","0000","574","199","375","20","594","938","0","63.33","21.22"
"10","007","00","021","2114","0878","574","199","375","20","594","938","0","63.33","21.22"
"10","007","00","021","2115","0000","514","154","360","49","563","880","0","63.98","17.5"
"10","007","00","021","2115","0879","514","154","360","49","563","880","0","63.98","17.5"
"10","007","00","021","2116","0000","715","240","475","49","764","1396","0","54.73","17.19"
"10","007","00","021","2116","0880","406","125","281","28","434","804","0","53.98","15.55"
"10","007","00","021","2116","0881","309","115","194","21","330","592","0","55.74","19.43"
"10","007","00","021","2117","0000","892","228","664","48","940","1606","0","58.53","14.2"
"10","007","00","021","2117","0874","340","101","239","27","367","647","0","56.72","15.61"
"10","007","00","021","2117","0875","552","127","425","21","573","959","0","59.75","13.24"
"10","007","00","021","2118","0000","134","32","102","10","144","263","0","54.75","12.17"
"10","007","00","021","2118","0876","134","32","102","10","144","263","0","54.75","12.17"
"10","007","00","021","2119","0000","310","87","223","26","336","618","0","54.37","14.08"
"10","007","00","021","2119","0877","310","87","223","26","336","618","0","54.37","14.08"
"10","007","00","021","2120","0000","515","148","367","29","544","872","0","62.39","16.97"
"10","007","00","021","2120","0867","515","148","367","29","544","872","0","62.39","16.97"
"10","007","00","022","0000","0000","12736","3871","8865","1221","13957","25677","30536","54.36","15.08"
"10","007","00","022","2201","0000","1180","363","817","103","1283","2468","0","51.99","14.71"
"10","007","00","022","2201","0888","530","181","349","56","586","1178","0","49.75","15.37"
"10","007","00","022","2201","0889","650","182","468","47","697","1290","0","54.03","14.11"
"10","007","00","022","2202","0000","889","259","630","73","962","1756","0","54.78","14.75"
"10","007","00","022","2202","0890","500","147","353","44","544","973","0","55.91","15.11"
"10","007","00","022","2202","0891","389","112","277","29","418","783","0","53.38","14.3"
"10","007","00","022","2203","0000","826","272","554","115","941","1632","0","57.66","16.67"
"10","007","00","022","2203","0892","367","116","251","46","413","733","0","56.34","15.83"
"10","007","00","022","2203","0893","459","156","303","69","528","899","0","58.73","17.35"
"10","007","00","022","2204","0000","1153","320","833","108","1261","2321","0","54.33","13.79"
"10","007","00","022","2204","0894","493","138","355","54","547","965","0","56.68","14.3"
"10","007","00","022","2204","0895","660","182","478","54","714","1356","0","52.65","13.42"
"10","007","00","022","2205","0000","636","206","430","54","690","1265","0","54.55","16.28"
"10","007","00","022","2205","0896","636","206","430","54","690","1265","0","54.55","16.28"
"10","007","00","022","2206","0000","839","271","568","84","923","1582","0","58.34","17.13"
"10","007","00","022","2206","0897","494","153","341","47","541","877","0","61.69","17.45"
"10","007","00","022","2206","0898","345","118","227","37","382","705","0","54.18","16.74"
"10","007","00","022","2207","0000","1814","495","1319","116","1930","3285","0","58.75","15.07"
"10","007","00","022","2207","0899","613","170","443","32","645","1062","0","60.73","16.01"
"10","007","00","022","2207","0900","714","206","508","28","742","1300","0","57.08","15.85"
"10","007","00","022","2207","0901","487","119","368","56","543","923","0","58.83","12.89"
"10","007","00","022","2208","0000","1039","228","811","77","1116","2188","0","51.01","10.42"
"10","007","00","022","2208","0902","432","57","375","30","462","1085","0","42.58","5.25"
"10","007","00","022","2208","0903","607","171","436","47","654","1103","0","59.29","15.5"
"10","007","00","022","2209","0000","350","98","252","31","381","735","0","51.84","13.33"
"10","007","00","022","2209","0904","350","98","252","31","381","735","0","51.84","13.33"
"10","007","00","022","2210","0000","275","98","177","41","316","574","0","55.05","17.07"
"10","007","00","022","2210","0905","275","98","177","41","316","574","0","55.05","17.07"
"10","007","00","022","2211","0000","714","168","546","82","796","1504","0","52.93","11.17"
"10","007","00","022","2211","0906","341","70","271","45","386","767","0","50.33","9.13"
"10","007","00","022","2211","0907","373","98","275","37","410","737","0","55.63","13.3"
"10","007","00","022","2212","0000","467","162","305","48","515","1058","0","48.68","15.31"
"10","007","00","022","2212","0908","467","162","305","48","515","1058","0","48.68","15.31"
"10","007","00","022","2213","0000","357","103","254","68","425","826","0","51.45","12.47"
"10","007","00","022","2213","0909","357","103","254","68","425","826","0","51.45","12.47"
"10","007","00","022","2214","0000","468","140","328","76","544","1082","0","50.28","12.94"
"10","007","00","022","2214","0910","468","140","328","76","544","1082","0","50.28","12.94"
"10","007","00","022","2215","0000","752","370","382","69","821","1448","0","56.7","25.55"
"10","007","00","022","2215","0911","397","285","112","49","446","737","0","60.52","38.67"
"10","007","00","022","2215","0912","355","85","270","20","375","711","0","52.74","11.95"
"10","007","00","022","2216","0000","537","194","343","53","590","1043","0","56.57","18.6"
"10","007","00","022","2216","0913","537","194","343","53","590","1043","0","56.57","18.6"
"10","007","00","022","2217","0000","440","124","316","23","463","910","0","50.88","13.63"
"10","007","00","022","2217","0914","440","124","316","23","463","910","0","50.88","13.63"
"10","007","00","023","0000","0000","12951","3674","9277","1350","14301","29291","33549","48.82","12.54"
"10","007","00","023","2301","0000","300","93","207","36","336","940","0","35.74","9.89"
"10","007","00","023","2301","0998","300","93","207","36","336","940","0","35.74","9.89"
"10","007","00","023","2302","0000","135","32","103","27","162","403","0","40.2","7.94"
"10","007","00","023","2302","0999","135","32","103","27","162","403","0","40.2","7.94"
"10","007","00","023","2303","0000","339","103","236","36","375","756","0","49.6","13.62"
"10","007","00","023","2303","1000","339","103","236","36","375","756","0","49.6","13.62"
"10","007","00","023","2304","0000","153","43","110","25","178","548","0","32.48","7.85"
"10","007","00","023","2304","1001","153","43","110","25","178","548","0","32.48","7.85"
"10","007","00","023","2305","0000","481","121","360","41","522","997","0","52.36","12.14"
"10","007","00","023","2305","1002","481","121","360","41","522","997","0","52.36","12.14"
"10","007","00","023","2306","0000","936","301","635","98","1034","2159","0","47.89","13.94"
"10","007","00","023","2306","1003","530","178","352","61","591","1300","0","45.46","13.69"
"10","007","00","023","2306","1004","406","123","283","37","443","859","0","51.57","14.32"
"10","007","00","023","2307","0000","624","195","429","41","665","1370","0","48.54","14.23"
"10","007","00","023","2307","1005","341","90","251","19","360","734","0","49.05","12.26"
"10","007","00","023","2307","1006","283","105","178","22","305","636","0","47.96","16.51"
"10","007","00","023","2308","0000","168","51","117","13","181","470","0","38.51","10.85"
"10","007","00","023","2308","1022","168","51","117","13","181","470","0","38.51","10.85"
"10","007","00","023","2309","0000","253","84","169","42","295","668","0","44.16","12.57"
"10","007","00","023","2309","1008","253","84","169","42","295","668","0","44.16","12.57"
"10","007","00","023","2310","0000","348","119","229","30","378","744","0","50.81","15.99"
"10","007","00","023","2310","1009","348","119","229","30","378","744","0","50.81","15.99"
"10","007","00","023","2311","0000","422","128","294","78","500","1026","0","48.73","12.48"
"10","007","00","023","2311","1010","422","128","294","78","500","1026","0","48.73","12.48"
"10","007","00","023","2312","0000","213","57","156","12","225","586","0","38.4","9.73"
"10","007","00","023","2312","1011","213","57","156","12","225","586","0","38.4","9.73"
"10","007","00","023","2313","0000","292","86","206","22","314","593","0","52.95","14.5"
"10","007","00","023","2313","1012","292","86","206","22","314","593","0","52.95","14.5"
"10","007","00","023","2314","0000","313","94","219","60","373","808","0","46.16","11.63"
"10","007","00","023","2314","1007","313","94","219","60","373","808","0","46.16","11.63"
"10","007","00","023","2315","0000","901","262","639","134","1035","2131","0","48.57","12.29"
"10","007","00","023","2315","1013","495","121","374","79","574","1071","0","53.59","11.3"
"10","007","00","023","2315","1014","406","141","265","55","461","1060","0","43.49","13.3"
"10","007","00","023","2316","0000","338","78","260","21","359","708","0","50.71","11.02"
"10","007","00","023","2316","1015","338","78","260","21","359","708","0","50.71","11.02"
"10","007","00","023","2317","0000","312","87","225","49","361","735","0","49.12","11.84"
"10","007","00","023","2317","1016","312","87","225","49","361","735","0","49.12","11.84"
"10","007","00","023","2318","0000","304","95","209","48","352","674","0","52.23","14.09"
"10","007","00","023","2318","1019","304","95","209","48","352","674","0","52.23","14.09"
"10","007","00","023","2319","0000","583","164","419","71","654","1300","0","50.31","12.62"
"10","007","00","023","2319","1017","290","80","210","45","335","571","0","58.67","14.01"
"10","007","00","023","2319","1018","293","84","209","26","319","729","0","43.76","11.52"
"10","007","00","023","2320","0000","826","211","615","77","903","1652","0","54.66","12.77"
"10","007","00","023","2320","1020","398","107","291","36","434","846","0","51.3","12.65"
"10","007","00","023","2320","1021","428","104","324","41","469","806","0","58.19","12.9"
"10","007","00","023","2321","0000","710","167","543","54","764","1441","0","53.02","11.59"
"10","007","00","023","2321","1023","570","126","444","42","612","1124","0","54.45","11.21"
"10","007","00","023","2321","1024","140","41","99","12","152","317","0","47.95","12.93"
"10","007","00","023","2322","0000","438","118","320","42","480","1086","0","44.2","10.87"
"10","007","00","023","2322","1028","438","118","320","42","480","1086","0","44.2","10.87"
"10","007","00","023","2323","0000","878","227","651","85","963","2125","0","45.32","10.68"
"10","007","00","023","2323","1025","440","106","334","59","499","1158","0","43.09","9.15"
"10","007","00","023","2323","1026","438","121","317","26","464","967","0","47.98","12.51"
"10","007","00","023","2324","0000","368","105","263","35","403","762","0","52.89","13.78"
"10","007","00","023","2324","1027","368","105","263","35","403","762","0","52.89","13.78"
"10","007","00","023","2325","0000","585","164","421","49","634","1400","0","45.29","11.71"
"10","007","00","023","2325","1029","341","96","245","27","368","747","0","49.26","12.85"
"10","007","00","023","2325","1030","244","68","176","22","266","653","0","40.74","10.41"
"10","007","00","023","2326","0000","1731","489","1242","124","1855","3209","0","57.81","15.24"
"10","007","00","023","2326","1031","478","117","361","36","514","872","0","58.94","13.42"
"10","007","00","023","2326","1032","700","210","490","45","745","1235","0","60.32","17.0"
"10","007","00","023","2326","1033","553","162","391","43","596","1102","0","54.08","14.7"
"10","007","00","024","0000","0000","5230","1381","3849","515","5745","14713","16781","39.05","9.39"
"10","007","00","024","2401","0000","364","104","260","65","429","1104","0","38.86","9.42"
"10","007","00","024","2401","0982","364","104","260","65","429","1104","0","38.86","9.42"
"10","007","00","024","2402","0000","395","99","296","39","434","1092","0","39.74","9.07"
"10","007","00","024","2402","0986","171","30","141","12","183","518","0","35.33","5.79"
"10","007","00","024","2402","0987","224","69","155","27","251","574","0","43.73","12.02"
"10","007","00","024","2403","0000","562","162","400","45","607","1312","0","46.27","12.35"
"10","007","00","024","2403","0984","562","162","400","45","607","1312","0","46.27","12.35"
"10","007","00","024","2404","0000","324","83","241","43","367","853","0","43.02","9.73"
"10","007","00","024","2404","0985","324","83","241","43","367","853","0","43.02","9.73"
"10","007","00","024","2405","0000","480","131","349","57","537","964","0","55.71","13.59"
"10","007","00","024","2405","0983","480","131","349","57","537","964","0","55.71","13.59"
"10","007","00","024","2406","0000","397","90","307","19","416","1103","0","37.72","8.16"
"10","007","00","024","2406","0993","397","90","307","19","416","1103","0","37.72","8.16"
"10","007","00","024","2407","0000","429","97","332","24","453","1288","0","35.17","7.53"
"10","007","00","024","2407","0981","429","97","332","24","453","1288","0","35.17","7.53"
"10","007","00","024","2408","0000","233","55","178","37","270","702","0","38.46","7.83"
"10","007","00","024","2408","0988","233","55","178","37","270","702","0","38.46","7.83"
"10","007","00","024","2409","0000","205","58","147","24","229","686","0","33.38","8.45"
"10","007","00","024","2409","0996","205","58","147","24","229","686","0","33.38","8.45"
"10","007","00","024","2410","0000","303","71","232","32","335","1069","0","31.34","6.64"
"10","007","00","024","2410","0989","108","32","76","12","120","376","0","31.91","8.51"
"10","007","00","024","2410","0990","195","39","156","20","215","693","0","31.02","5.63"
"10","007","00","024","2411","0000","271","68","203","25","296","899","0","32.93","7.56"
"10","007","00","024","2411","0997","271","68","203","25","296","899","0","32.93","7.56"
"10","007","00","024","2412","0000","392","117","275","24","416","1192","0","34.9","9.82"
"10","007","00","024","2412","0994","392","117","275","24","416","1192","0","34.9","9.82"
"10","007","00","024","2413","0000","332","97","235","29","361","917","0","39.37","10.58"
"10","007","00","024","2413","0995","332","97","235","29","361","917","0","39.37","10.58"
"10","007","00","024","2414","0000","349","102","247","37","386","877","0","44.01","11.63"
"10","007","00","024","2414","0991","349","102","247","37","386","877","0","44.01","11.63"
"10","007","00","024","2415","0000","194","47","147","15","209","655","0","31.91","7.18"
"10","007","00","024","2415","0992","194","47","147","15","209","655","0","31.91","7.18"
"10","007","00","025","0000","0000","6371","1832","4539","581","6952","12821","15117","54.22","14.29"
"10","007","00","025","2501","0000","609","162","447","63","672","1168","0","57.53","13.87"
"10","007","00","025","2501","1034","609","162","447","63","672","1168","0","57.53","13.87"
"10","007","00","025","2502","0000","1103","302","801","66","1169","1925","0","60.73","15.69"
"10","007","00","025","2502","1035","542","152","390","27","569","965","0","58.96","15.75"
"10","007","00","025","2502","1036","561","150","411","39","600","960","0","62.5","15.63"
"10","007","00","025","2503","0000","424","120","304","57","481","743","0","64.74","16.15"
"10","007","00","025","2503","1037","424","120","304","57","481","743","0","64.74","16.15"
"10","007","00","025","2504","0000","309","97","212","30","339","751","0","45.14","12.92"
"10","007","00","025","2504","1038","309","97","212","30","339","751","0","45.14","12.92"
"10","007","00","025","2505","0000","667","196","471","56","723","1525","0","47.41","12.85"
"10","007","00","025","2505","1039","335","94","241","40","375","792","0","47.35","11.87"
"10","007","00","025","2505","1040","332","102","230","16","348","733","0","47.48","13.92"
"10","007","00","025","2506","0000","327","93","234","29","356","657","0","54.19","14.16"
"10","007","00","025","2506","1041","327","93","234","29","356","657","0","54.19","14.16"
"10","007","00","025","2507","0000","516","130","386","34","550","1063","0","51.74","12.23"
"10","007","00","025","2507","1042","516","130","386","34","550","1063","0","51.74","12.23"
"10","007","00","025","2508","0000","591","169","422","47","638","1114","0","57.27","15.17"
"10","007","00","025","2508","1043","591","169","422","47","638","1114","0","57.27","15.17"
"10","007","00","025","2509","0000","308","93","215","33","341","506","0","67.39","18.38"
"10","007","00","025","2509","1044","308","93","215","33","341","506","0","67.39","18.38"
"10","007","00","025","2510","0000","390","122","268","35","425","823","0","51.64","14.82"
"10","007","00","025","2510","1045","390","122","268","35","425","823","0","51.64","14.82"
"10","007","00","025","2511","0000","312","105","207","26","338","654","0","51.68","16.06"
"10","007","00","025","2511","1046","312","105","207","26","338","654","0","51.68","16.06"
"10","007","00","025","2512","0000","235","67","168","25","260","577","0","45.06","11.61"
"10","007","00","025","2512","1047","235","67","168","25","260","577","0","45.06","11.61"
"10","007","00","025","2513","0000","359","111","248","49","408","772","0","52.85","14.38"
"10","007","00","025","2513","1048","359","111","248","49","408","772","0","52.85","14.38"
"10","007","00","025","2514","0000","221","65","156","31","252","543","0","46.41","11.97"
"10","007","00","025","2514","1049","221","65","156","31","252","543","0","46.41","11.97"
"10","007","00","026","0000","0000","12055","3775","8280","1098","13153","25405","29797","51.77","14.86"
"10","007","00","026","2601","0000","902","265","637","59","961","1839","0","52.26","14.41"
"10","007","00","026","2601","0915","396","115","281","35","431","778","0","55.4","14.78"
"10","007","00","026","2601","0916","506","150","356","24","530","1061","0","49.95","14.14"
"10","007","00","026","2602","0000","585","175","410","65","650","1409","0","46.13","12.42"
"10","007","00","026","2602","0925","585","175","410","65","650","1409","0","46.13","12.42"
"10","007","00","026","2603","0000","476","151","325","55","531","1157","0","45.89","13.05"
"10","007","00","026","2603","0930","476","151","325","55","531","1157","0","45.89","13.05"
"10","007","00","026","2604","0000","767","250","517","60","827","1490","0","55.5","16.78"
"10","007","00","026","2604","0941","767","250","517","60","827","1490","0","55.5","16.78"
"10","007","00","026","2605","0000","305","80","225","31","336","701","0","47.93","11.41"
"10","007","00","026","2605","0917","305","80","225","31","336","701","0","47.93","11.41"
"10","007","00","026","2606","0000","743","221","522","62","805","1506","0","53.45","14.67"
"10","007","00","026","2606","0926","399","111","288","19","418","792","0","52.78","14.02"
"10","007","00","026","2606","0927","344","110","234","43","387","714","0","54.2","15.41"
"10","007","00","026","2607","0000","383","121","262","61","444","843","0","52.67","14.35"
"10","007","00","026","2607","0936","383","121","262","61","444","843","0","52.67","14.35"
"10","007","00","026","2608","0000","497","151","346","38","535","879","0","60.86","17.18"
"10","007","00","026","2608","0918","497","151","346","38","535","879","0","60.86","17.18"
"10","007","00","026","2609","0000","879","245","634","104","983","2071","0","47.46","11.83"
"10","007","00","026","2609","0928","483","121","362","57","540","1109","0","48.69","10.91"
"10","007","00","026","2609","0929","396","124","272","47","443","962","0","46.05","12.89"
"10","007","00","026","2610","0000","259","83","176","9","268","711","0","37.69","11.67"
"10","007","00","026","2610","0937","259","83","176","9","268","711","0","37.69","11.67"
"10","007","00","026","2611","0000","862","412","450","72","934","1532","0","60.97","26.89"
"10","007","00","026","2611","0919","392","280","112","37","429","654","0","65.6","42.81"
"10","007","00","026","2611","0920","470","132","338","35","505","878","0","57.52","15.03"
"10","007","00","026","2612","0000","883","288","595","83","966","1839","0","52.53","15.66"
"10","007","00","026","2612","0931","446","140","306","44","490","952","0","51.47","14.71"
"10","007","00","026","2612","0932","437","148","289","39","476","887","0","53.66","16.69"
"10","007","00","026","2613","0000","406","139","267","63","469","851","0","55.11","16.33"
"10","007","00","026","2613","0938","406","139","267","63","469","851","0","55.11","16.33"
"10","007","00","026","2614","0000","998","293","705","71","1069","1813","0","58.96","16.16"
"10","007","00","026","2614","0921","543","141","402","42","585","942","0","62.1","14.97"
"10","007","00","026","2614","0922","455","152","303","29","484","871","0","55.57","17.45"
"10","007","00","026","2615","0000","767","228","539","103","870","1876","0","46.38","12.15"
"10","007","00","026","2615","0933","333","109","224","47","380","866","0","43.88","12.59"
"10","007","00","026","2615","0934","434","119","315","56","490","1010","0","48.51","11.78"
"10","007","00","026","2616","0000","557","130","427","50","607","1247","0","48.68","10.43"
"10","007","00","026","2616","0940","557","130","427","50","607","1247","0","48.68","10.43"
"10","007","00","026","2617","0000","979","297","682","62","1041","1905","0","54.65","15.59"
"10","007","00","026","2617","0923","515","154","361","19","534","1047","0","51.0","14.71"
"10","007","00","026","2617","0924","464","143","321","43","507","858","0","59.09","16.67"
"10","007","00","026","2618","0000","404","130","274","21","425","853","0","49.82","15.24"
"10","007","00","026","2618","0935","404","130","274","21","425","853","0","49.82","15.24"
"10","007","00","026","2619","0000","403","116","287","29","432","883","0","48.92","13.14"
"10","007","00","026","2619","0939","403","116","287","29","432","883","0","48.92","13.14"
"10","008","00","000","0000","0000","233470","68393","165077","14440","247910","427089","497876","58.05","16.01"
"10","008","00","001","0000","0000","48721","14491","34230","2383","51104","84328","99538","60.6","17.18"
"10","008","00","001","0101","0000","536","193","343","18","554","927","0","59.76","20.82"
"10","008","00","001","0101","0001","536","193","343","18","554","927","0","59.76","20.82"
"10","008","00","001","0102","0000","906","280","626","53","959","1440","0","66.6","19.44"
"10","008","00","001","0102","0002","430","131","299","24","454","667","0","68.07","19.64"
"10","008","00","001","0102","0003","476","149","327","29","505","773","0","65.33","19.28"
"10","008","00","001","0103","0000","488","155","333","26","514","818","0","62.84","18.95"
"10","008","00","001","0103","0004","488","155","333","26","514","818","0","62.84","18.95"
"10","008","00","001","0104","0000","342","117","225","15","357","525","0","68.0","22.29"
"10","008","00","001","0104","0005","342","117","225","15","357","525","0","68.0","22.29"
"10","008","00","001","0105","0000","364","103","261","23","387","575","0","67.3","17.91"
"10","008","00","001","0105","0006","364","103","261","23","387","575","0","67.3","17.91"
"10","008","00","001","0106","0000","245","80","165","9","254","368","0","69.02","21.74"
"10","008","00","001","0106","0007","245","80","165","9","254","368","0","69.02","21.74"
"10","008","00","001","0107","0000","589","155","434","43","632","956","0","66.11","16.21"
"10","008","00","001","0107","0008","589","155","434","43","632","956","0","66.11","16.21"
"10","008","00","001","0108","0000","1621","481","1140","76","1697","2632","0","64.48","18.28"
"10","008","00","001","0108","0058","841","240","601","48","889","1387","0","64.1","17.3"
"10","008","00","001","0108","0059","780","241","539","28","808","1245","0","64.9","19.36"
"10","008","00","001","0109","0000","4150","1268","2882","184","4334","7018","0","61.76","18.07"
"10","008","00","001","0109","0060","684","201","483","20","704","1199","0","58.72","16.76"
"10","008","00","001","0109","0061","764","218","546","38","802","1288","0","62.27","16.93"
"10","008","00","001","0109","0062","588","173","415","32","620","1040","0","59.62","16.63"
"10","008","00","001","0109","0063","631","192","439","35","666","1070","0","62.24","17.94"
"10","008","00","001","0109","0064","790","252","538","36","826","1299","0","63.59","19.4"
"10","008","00","001","0109","0065","693","232","461","23","716","1122","0","63.81","20.68"
"10","008","00","001","0110","0000","2456","748","1708","119","2575","4543","0","56.68","16.46"
"10","008","00","001","0110","0032","757","239","518","34","791","1356","0","58.33","17.63"
"10","008","00","001","0110","0033","720","243","477","39","759","1373","0","55.28","17.7"
"10","008","00","001","0110","0034","775","221","554","40","815","1452","0","56.13","15.22"
"10","008","00","001","0110","0035","204","45","159","6","210","362","0","58.01","12.43"
"10","008","00","001","0111","0000","213","63","150","23","236","389","0","60.67","16.2"
"10","008","00","001","0111","0036","213","63","150","23","236","389","0","60.67","16.2"
"10","008","00","001","0112","0000","3486","1062","2424","188","3674","5992","0","61.32","17.72"
"10","008","00","001","0112","0022","525","147","378","28","553","960","0","57.6","15.31"
"10","008","00","001","0112","0023","523","146","377","36","559","906","0","61.7","16.11"
"10","008","00","001","0112","0024","569","188","381","28","597","957","0","62.38","19.64"
"10","008","00","001","0112","0025","611","174","437","41","652","997","0","65.4","17.45"
"10","008","00","001","0112","0026","595","182","413","34","629","1008","0","62.4","18.06"
"10","008","00","001","0112","0027","663","225","438","21","684","1164","0","58.76","19.33"
"10","008","00","001","0113","0000","1104","330","774","86","1190","2045","0","58.19","16.14"
"10","008","00","001","0113","0028","327","87","240","21","348","587","0","59.28","14.82"
"10","008","00","001","0113","0029","384","115","269","31","415","734","0","56.54","15.67"
"10","008","00","001","0113","0030","393","128","265","34","427","724","0","58.98","17.68"
"10","008","00","001","0114","0000","570","147","423","31","601","1003","0","59.92","14.66"
"10","008","00","001","0114","0031","570","147","423","31","601","1003","0","59.92","14.66"
"10","008","00","001","0115","0000","3122","943","2179","120","3242","5426","0","59.75","17.38"
"10","008","00","001","0115","0009","657","199","458","19","676","1245","0","54.3","15.98"
"10","008","00","001","0115","0010","837","261","576","25","862","1484","0","58.09","17.59"
"10","008","00","001","0115","0011","749","213","536","35","784","1191","0","65.83","17.88"
"10","008","00","001","0115","0012","879","270","609","41","920","1506","0","61.09","17.93"
"10","008","00","001","0116","0000","1710","563","1147","95","1805","2790","0","64.7","20.18"
"10","008","00","001","0116","0013","649","222","427","30","679","1070","0","63.46","20.75"
"10","008","00","001","0116","0014","408","123","285","19","427","670","0","63.73","18.36"
"10","008","00","001","0116","0015","653","218","435","46","699","1050","0","66.57","20.76"
"10","008","00","001","0117","0000","1125","358","767","68","1193","2106","0","56.65","17.0"
"10","008","00","001","0117","0016","599","188","411","36","635","1122","0","56.6","16.76"
"10","008","00","001","0117","0017","526","170","356","32","558","984","0","56.71","17.28"
"10","008","00","001","0118","0000","2613","826","1787","135","2748","4411","0","62.3","18.73"
"10","008","00","001","0118","0018","680","213","467","28","708","1062","0","66.67","20.06"
"10","008","00","001","0118","0019","606","170","436","38","644","1053","0","61.16","16.14"
"10","008","00","001","0118","0020","665","220","445","37","702","1104","0","63.59","19.93"
"10","008","00","001","0118","0021","662","223","439","32","694","1192","0","58.22","18.71"
"10","008","00","001","0119","0000","987","288","699","67","1054","1930","0","54.61","14.92"
"10","008","00","001","0119","0083","489","143","346","43","532","950","0","56.0","15.05"
"10","008","00","001","0119","0084","498","145","353","24","522","980","0","53.27","14.8"
"10","008","00","001","0120","0000","369","112","257","31","400","790","0","50.63","14.18"
"10","008","00","001","0120","0081","369","112","257","31","400","790","0","50.63","14.18"
"10","008","00","001","0121","0000","287","79","208","13","300","647","0","46.37","12.21"
"10","008","00","001","0121","0082","287","79","208","13","300","647","0","46.37","12.21"
"10","008","00","001","0122","0000","514","171","343","78","592","1122","0","52.76","15.24"
"10","008","00","001","0122","0080","514","171","343","78","592","1122","0","52.76","15.24"
"10","008","00","001","0123","0000","2875","771","2104","130","3005","5362","0","56.04","14.38"
"10","008","00","001","0123","0066","805","240","565","33","838","1414","0","59.26","16.97"
"10","008","00","001","0123","0067","628","180","448","38","666","1121","0","59.41","16.06"
"10","008","00","001","0123","0068","710","159","551","18","728","1434","0","50.77","11.09"
"10","008","00","001","0123","0069","732","192","540","41","773","1393","0","55.49","13.78"
"10","008","00","001","0124","0000","2634","741","1893","84","2718","4907","0","55.39","15.1"
"10","008","00","001","0124","0070","598","156","442","17","615","1059","0","58.07","14.73"
"10","008","00","001","0124","0071","688","193","495","21","709","1218","0","58.21","15.85"
"10","008","00","001","0124","0072","694","224","470","23","717","1293","0","55.45","17.32"
"10","008","00","001","0124","0073","654","168","486","23","677","1337","0","50.64","12.57"
"10","008","00","001","0125","0000","1643","483","1160","81","1724","2859","0","60.3","16.89"
"10","008","00","001","0125","0074","531","160","371","34","565","876","0","64.5","18.26"
"10","008","00","001","0125","0075","544","150","394","20","564","971","0","58.08","15.45"
"10","008","00","001","0125","0076","568","173","395","27","595","1012","0","58.79","17.09"
"10","008","00","001","0126","0000","1705","532","1173","82","1787","2999","0","59.59","17.74"
"10","008","00","001","0126","0077","519","147","372","30","549","973","0","56.42","15.11"
"10","008","00","001","0126","0078","600","185","415","26","626","1002","0","62.48","18.46"
"10","008","00","001","0126","0079","586","200","386","26","612","1024","0","59.77","19.53"
"10","008","00","001","0127","0000","3720","1125","2595","156","3876","5880","0","65.92","19.13"
"10","008","00","001","0127","0039","553","187","366","40","593","921","0","64.39","20.3"
"10","008","00","001","0127","0040","604","181","423","19","623","892","0","69.84","20.29"
"10","008","00","001","0127","0041","666","195","471","27","693","1050","0","66.0","18.57"
"10","008","00","001","0127","0042","656","190","466","20","676","1078","0","62.71","17.63"
"10","008","00","001","0127","0043","649","179","470","19","668","1078","0","61.97","16.6"
"10","008","00","001","0127","0044","592","193","399","31","623","861","0","72.36","22.42"
"10","008","00","001","0128","0000","1463","470","993","76","1539","2365","0","65.07","19.87"
"10","008","00","001","0128","0037","788","253","535","42","830","1276","0","65.05","19.83"
"10","008","00","001","0128","0038","675","217","458","34","709","1089","0","65.11","19.93"
"10","008","00","001","0129","0000","3946","1121","2825","150","4096","6589","0","62.16","17.01"
"10","008","00","001","0129","0045","694","189","505","42","736","1221","0","60.28","15.48"
"10","008","00","001","0129","0046","635","186","449","21","656","1105","0","59.37","16.83"
"10","008","00","001","0129","0047","739","206","533","18","757","1230","0","61.54","16.75"
"10","008","00","001","0129","0048","657","179","478","18","675","1092","0","61.81","16.39"
"10","008","00","001","0129","0049","802","237","565","19","821","1286","0","63.84","18.43"
"10","008","00","001","0129","0050","419","124","295","32","451","655","0","68.85","18.93"
"10","008","00","001","0130","0000","867","254","613","43","910","1439","0","63.24","17.65"
"10","008","00","001","0130","0051","450","125","325","25","475","719","0","66.06","17.39"
"10","008","00","001","0130","0052","417","129","288","18","435","720","0","60.42","17.92"
"10","008","00","001","0131","0000","487","114","373","22","509","848","0","60.02","13.44"
"10","008","00","001","0131","0057","487","114","373","22","509","848","0","60.02","13.44"
"10","008","00","001","0132","0000","632","127","505","24","656","1108","0","59.21","11.46"
"10","008","00","001","0132","0054","268","54","214","13","281","492","0","57.11","10.98"
"10","008","00","001","0132","0055","364","73","291","11","375","616","0","60.88","11.85"
"10","008","00","001","0133","0000","619","149","470","21","640","1010","0","63.37","14.75"
"10","008","00","001","0133","0056","619","149","470","21","640","1010","0","63.37","14.75"
"10","008","00","001","0134","0000","333","82","251","13","346","509","0","67.98","16.11"
"10","008","00","001","0134","0053","333","82","251","13","346","509","0","67.98","16.11"
"10","008","00","002","0000","0000","37358","10904","26454","2295","39653","68763","80408","57.67","15.86"
"10","008","00","002","0201","0000","1506","424","1082","103","1609","2676","0","60.13","15.84"
"10","008","00","002","0201","0085","468","141","327","34","502","828","0","60.63","17.03"
"10","008","00","002","0201","0086","458","138","320","36","494","786","0","62.85","17.56"
"10","008","00","002","0201","0087","580","145","435","33","613","1062","0","57.72","13.65"
"10","008","00","002","0202","0000","526","131","395","26","552","838","0","65.87","15.63"
"10","008","00","002","0202","0105","526","131","395","26","552","838","0","65.87","15.63"
"10","008","00","002","0203","0000","1616","473","1143","95","1711","3107","0","55.07","15.22"
"10","008","00","002","0203","0102","491","136","355","11","502","901","0","55.72","15.09"
"10","008","00","002","0203","0103","475","125","350","54","529","997","0","53.06","12.54"
"10","008","00","002","0203","0104","650","212","438","30","680","1209","0","56.24","17.54"
"10","008","00","002","0204","0000","1313","406","907","94","1407","2489","0","56.53","16.31"
"10","008","00","002","0204","0106","579","174","405","36","615","1226","0","50.16","14.19"
"10","008","00","002","0204","0107","734","232","502","58","792","1263","0","62.71","18.37"
"10","008","00","002","0205","0000","1161","311","850","78","1239","2233","0","55.49","13.93"
"10","008","00","002","0205","0121","594","158","436","41","635","1133","0","56.05","13.95"
"10","008","00","002","0205","0122","567","153","414","37","604","1100","0","54.91","13.91"
"10","008","00","002","0206","0000","631","198","433","33","664","1023","0","64.91","19.35"
"10","008","00","002","0206","0126","631","198","433","33","664","1023","0","64.91","19.35"
"10","008","00","002","0207","0000","1849","584","1265","137","1986","3705","0","53.6","15.76"
"10","008","00","002","0207","0123","627","182","445","52","679","1155","0","58.79","15.76"
"10","008","00","002","0207","0124","581","202","379","41","622","1254","0","49.6","16.11"
"10","008","00","002","0207","0125","641","200","441","44","685","1296","0","52.85","15.43"
"10","008","00","002","0208","0000","3239","876","2363","147","3386","5777","0","58.61","15.16"
"10","008","00","002","0208","0127","471","102","369","20","491","964","0","50.93","10.58"
"10","008","00","002","0208","0128","553","173","380","28","581","986","0","58.92","17.55"
"10","008","00","002","0208","0129","603","163","440","15","618","1016","0","60.83","16.04"
"10","008","00","002","0208","0130","505","134","371","31","536","898","0","59.69","14.92"
"10","008","00","002","0208","0131","558","159","399","38","596","980","0","60.82","16.22"
"10","008","00","002","0208","0132","549","145","404","15","564","933","0","60.45","15.54"
"10","008","00","002","0209","0000","610","195","415","41","651","929","0","70.08","20.99"
"10","008","00","002","0209","0133","610","195","415","41","651","929","0","70.08","20.99"
"10","008","00","002","0210","0000","3931","1153","2778","225","4156","7458","0","55.73","15.46"
"10","008","00","002","0210","0090","700","197","503","25","725","1282","0","56.55","15.37"
"10","008","00","002","0210","0091","465","131","334","42","507","859","0","59.02","15.25"
"10","008","00","002","0210","0092","685","204","481","63","748","1288","0","58.07","15.84"
"10","008","00","002","0210","0093","740","234","506","23","763","1330","0","57.37","17.59"
"10","008","00","002","0210","0094","725","216","509","43","768","1416","0","54.24","15.25"
"10","008","00","002","0210","0095","616","171","445","29","645","1283","0","50.27","13.33"
"10","008","00","002","0211","0000","2041","541","1500","142","2183","3815","0","57.22","14.18"
"10","008","00","002","0211","0096","636","117","519","62","698","1151","0","60.64","10.17"
"10","008","00","002","0211","0097","608","179","429","25","633","1193","0","53.06","15.0"
"10","008","00","002","0211","0098","797","245","552","55","852","1471","0","57.92","16.66"
"10","008","00","002","0212","0000","460","122","338","73","533","1044","0","51.05","11.69"
"10","008","00","002","0212","0099","460","122","338","73","533","1044","0","51.05","11.69"
"10","008","00","002","0213","0000","612","171","441","54","666","1122","0","59.36","15.24"
"10","008","00","002","0213","0100","612","171","441","54","666","1122","0","59.36","15.24"
"10","008","00","002","0214","0000","688","176","512","39","727","1129","0","64.39","15.59"
"10","008","00","002","0214","0101","688","176","512","39","727","1129","0","64.39","15.59"
"10","008","00","002","0215","0000","530","146","384","60","590","1032","0","57.17","14.15"
"10","008","00","002","0215","0134","530","146","384","60","590","1032","0","57.17","14.15"
"10","008","00","002","0216","0000","156","37","119","9","165","315","0","52.38","11.75"
"10","008","00","002","0216","0135","156","37","119","9","165","315","0","52.38","11.75"
"10","008","00","002","0217","0000","680","189","491","64","744","1363","0","54.59","13.87"
"10","008","00","002","0217","0136","680","189","491","64","744","1363","0","54.59","13.87"
"10","008","00","002","0218","0000","823","231","592","45","868","1430","0","60.7","16.15"
"10","008","00","002","0218","0137","412","130","282","29","441","725","0","60.83","17.93"
"10","008","00","002","0218","0138","411","101","310","16","427","705","0","60.57","14.33"
"10","008","00","002","0219","0000","969","270","699","55","1024","1683","0","60.84","16.04"
"10","008","00","002","0219","0139","465","140","325","25","490","751","0","65.25","18.64"
"10","008","00","002","0219","0140","504","130","374","30","534","932","0","57.3","13.95"
"10","008","00","002","0220","0000","737","218","519","48","785","1332","0","58.93","16.37"
"10","008","00","002","0220","0141","538","168","370","33","571","956","0","59.73","17.57"
"10","008","00","002","0220","0142","199","50","149","15","214","376","0","56.91","13.3"
"10","008","00","002","0221","0000","376","111","265","32","408","682","0","59.82","16.28"
"10","008","00","002","0221","0143","376","111","265","32","408","682","0","59.82","16.28"
"10","008","00","002","0222","0000","603","83","520","42","645","990","0","65.15","8.38"
"10","008","00","002","0222","0144","603","83","520","42","645","990","0","65.15","8.38"
"10","008","00","002","0223","0000","593","142","451","58","651","1170","0","55.64","12.14"
"10","008","00","002","0223","0147","593","142","451","58","651","1170","0","55.64","12.14"
"10","008","00","002","0224","0000","344","103","241","17","361","604","0","59.77","17.05"
"10","008","00","002","0224","0148","344","103","241","17","361","604","0","59.77","17.05"
"10","008","00","002","0225","0000","520","147","373","31","551","999","0","55.16","14.71"
"10","008","00","002","0225","0149","520","147","373","31","551","999","0","55.16","14.71"
"10","008","00","002","0226","0000","1480","623","857","79","1559","2791","0","55.86","22.32"
"10","008","00","002","0226","0150","467","338","129","19","486","923","0","52.65","36.62"
"10","008","00","002","0226","0151","504","139","365","33","537","887","0","60.54","15.67"
"10","008","00","002","0226","0152","509","146","363","27","536","981","0","54.64","14.88"
"10","008","00","002","0227","0000","901","422","479","63","964","1630","0","59.14","25.89"
"10","008","00","002","0227","0116","387","265","122","40","427","725","0","58.9","36.55"
"10","008","00","002","0227","0117","514","157","357","23","537","905","0","59.34","17.35"
"10","008","00","002","0228","0000","1299","358","941","103","1402","2588","0","54.17","13.83"
"10","008","00","002","0228","0118","594","176","418","42","636","1179","0","53.94","14.93"
"10","008","00","002","0228","0119","470","109","361","28","498","944","0","52.75","11.55"
"10","008","00","002","0228","0120","235","73","162","33","268","465","0","57.63","15.7"
"10","008","00","002","0229","0000","802","225","577","18","820","1622","0","50.55","13.87"
"10","008","00","002","0229","0145","672","172","500","0","672","1324","0","50.76","12.99"
"10","008","00","002","0229","0146","130","53","77","18","148","298","0","49.66","17.79"
"10","008","00","002","0230","0000","1927","583","1344","84","2011","3227","0","62.32","18.07"
"10","008","00","002","0230","0108","620","195","425","17","637","1045","0","60.96","18.66"
"10","008","00","002","0230","0109","653","188","465","28","681","1120","0","60.8","16.79"
"10","008","00","002","0230","0110","654","200","454","39","693","1062","0","65.25","18.83"
"10","008","00","002","0231","0000","1454","406","1048","79","1533","2616","0","58.6","15.52"
"10","008","00","002","0231","0088","699","206","493","48","747","1201","0","62.2","17.15"
"10","008","00","002","0231","0089","755","200","555","31","786","1415","0","55.55","14.13"
"10","008","00","002","0232","0000","1747","513","1234","76","1823","3179","0","57.35","16.14"
"10","008","00","002","0232","0111","567","168","399","32","599","1022","0","58.61","16.44"
"10","008","00","002","0232","0112","579","167","412","18","597","1051","0","56.8","15.89"
"10","008","00","002","0232","0113","601","178","423","26","627","1106","0","56.69","16.09"
"10","008","00","002","0233","0000","1234","336","898","45","1279","2165","0","59.08","15.52"
"10","008","00","002","0233","0114","620","172","448","18","638","1098","0","58.11","15.66"
"10","008","00","002","0233","0115","614","164","450","27","641","1067","0","60.07","15.37"
"10","008","00","003","0000","0000","45902","14396","31506","2285","48187","82922","97223","58.11","17.36"
"10","008","00","003","0301","0000","1201","386","815","51","1252","2125","0","58.92","18.16"
"10","008","00","003","0301","0153","599","200","399","25","624","998","0","62.53","20.04"
"10","008","00","003","0301","0154","602","186","416","26","628","1127","0","55.72","16.5"
"10","008","00","003","0302","0000","1144","356","788","67","1211","2077","0","58.31","17.14"
"10","008","00","003","0302","0158","514","141","373","26","540","936","0","57.69","15.06"
"10","008","00","003","0302","0159","630","215","415","41","671","1141","0","58.81","18.84"
"10","008","00","003","0303","0000","688","211","477","12","700","1121","0","62.44","18.82"
"10","008","00","003","0303","0161","688","211","477","12","700","1121","0","62.44","18.82"
"10","008","00","003","0304","0000","3618","1102","2516","185","3803","6455","0","58.92","17.07"
"10","008","00","003","0304","0164","658","186","472","38","696","1267","0","54.93","14.68"
"10","008","00","003","0304","0165","667","202","465","55","722","1214","0","59.47","16.64"
"10","008","00","003","0304","0166","705","210","495","47","752","1259","0","59.73","16.68"
"10","008","00","003","0304","0167","855","292","563","15","870","1442","0","60.33","20.25"
"10","008","00","003","0304","0168","733","212","521","30","763","1273","0","59.94","16.65"
"10","008","00","003","0305","0000","4277","1338","2939","168","4445","7422","0","59.89","18.03"
"10","008","00","003","0305","0169","629","191","438","29","658","1145","0","57.47","16.68"
"10","008","00","003","0305","0170","692","202","490","21","713","1279","0","55.75","15.79"
"10","008","00","003","0305","0171","636","183","453","20","656","1158","0","56.65","15.8"
"10","008","00","003","0305","0172","836","247","589","37","873","1335","0","65.39","18.5"
"10","008","00","003","0305","0173","738","251","487","25","763","1178","0","64.77","21.31"
"10","008","00","003","0305","0174","746","264","482","36","782","1327","0","58.93","19.89"
"10","008","00","003","0306","0000","3528","1142","2386","156","3684","6403","0","57.54","17.84"
"10","008","00","003","0306","0208","780","250","530","51","831","1466","0","56.68","17.05"
"10","008","00","003","0306","0209","658","206","452","22","680","1180","0","57.63","17.46"
"10","008","00","003","0306","0210","600","189","411","15","615","1006","0","61.13","18.79"
"10","008","00","003","0306","0211","480","170","310","29","509","1000","0","50.9","17.0"
"10","008","00","003","0306","0212","669","221","448","22","691","1128","0","61.26","19.59"
"10","008","00","003","0306","0213","341","106","235","17","358","623","0","57.46","17.01"
"10","008","00","003","0307","0000","3026","968","2058","143","3169","6046","0","52.41","16.01"
"10","008","00","003","0307","0190","655","208","447","23","678","1395","0","48.6","14.91"
"10","008","00","003","0307","0191","662","199","463","21","683","1101","0","62.03","18.07"
"10","008","00","003","0307","0192","687","227","460","23","710","1297","0","54.74","17.5"
"10","008","00","003","0307","0193","391","135","256","24","415","877","0","47.32","15.39"
"10","008","00","003","0307","0194","631","199","432","52","683","1376","0","49.64","14.46"
"10","008","00","003","0308","0000","2354","722","1632","145","2499","4066","0","61.46","17.76"
"10","008","00","003","0308","0195","612","186","426","41","653","1008","0","64.78","18.45"
"10","008","00","003","0308","0196","635","185","450","32","667","1080","0","61.76","17.13"
"10","008","00","003","0308","0197","522","175","347","43","565","1017","0","55.56","17.21"
"10","008","00","003","0308","0198","585","176","409","29","614","961","0","63.89","18.31"
"10","008","00","003","0309","0000","2318","690","1628","90","2408","4392","0","54.83","15.71"
"10","008","00","003","0309","0181","524","178","346","20","544","1048","0","51.91","16.98"
"10","008","00","003","0309","0182","550","163","387","29","579","1009","0","57.38","16.15"
"10","008","00","003","0309","0183","593","160","433","22","615","1138","0","54.04","14.06"
"10","008","00","003","0309","0184","651","189","462","19","670","1197","0","55.97","15.79"
"10","008","00","003","0310","0000","1369","392","977","70","1439","2423","0","59.39","16.18"
"10","008","00","003","0310","0185","768","221","547","38","806","1364","0","59.09","16.2"
"10","008","00","003","0310","0186","601","171","430","32","633","1059","0","59.77","16.15"
"10","008","00","003","0311","0000","1609","490","1119","121","1730","2944","0","58.76","16.64"
"10","008","00","003","0311","0187","617","206","411","44","661","1108","0","59.66","18.59"
"10","008","00","003","0311","0188","475","144","331","29","504","879","0","57.34","16.38"
"10","008","00","003","0311","0189","517","140","377","48","565","957","0","59.04","14.63"
"10","008","00","003","0312","0000","1788","487","1301","63","1851","3143","0","58.89","15.49"
"10","008","00","003","0312","0178","603","124","479","23","626","1121","0","55.84","11.06"
"10","008","00","003","0312","0179","594","177","417","26","620","1043","0","59.44","16.97"
"10","008","00","003","0312","0180","591","186","405","14","605","979","0","61.8","19.0"
"10","008","00","003","0313","0000","1978","594","1384","113","2091","3524","0","59.34","16.86"
"10","008","00","003","0313","0199","663","227","436","47","710","1160","0","61.21","19.57"
"10","008","00","003","0313","0200","634","181","453","29","663","1121","0","59.14","16.15"
"10","008","00","003","0313","0201","681","186","495","37","718","1243","0","57.76","14.96"
"10","008","00","003","0314","0000","1627","558","1069","98","1725","2919","0","59.1","19.12"
"10","008","00","003","0314","0205","550","187","363","34","584","923","0","63.27","20.26"
"10","008","00","003","0314","0206","494","159","335","40","534","970","0","55.05","16.39"
"10","008","00","003","0314","0207","583","212","371","24","607","1026","0","59.16","20.66"
"10","008","00","003","0315","0000","768","201","567","31","799","1518","0","52.64","13.24"
"10","008","00","003","0315","0204","768","201","567","31","799","1518","0","52.64","13.24"
"10","008","00","003","0316","0000","1353","418","935","69","1422","2255","0","63.06","18.54"
"10","008","00","003","0316","0202","538","163","375","21","559","932","0","59.98","17.49"
"10","008","00","003","0316","0203","815","255","560","48","863","1323","0","65.23","19.27"
"10","008","00","003","0317","0000","987","315","672","83","1070","1953","0","54.79","16.13"
"10","008","00","003","0317","0214","378","132","246","42","420","707","0","59.41","18.67"
"10","008","00","003","0317","0215","366","111","255","26","392","719","0","54.52","15.44"
"10","008","00","003","0317","0216","243","72","171","15","258","527","0","48.96","13.66"
"10","008","00","003","0318","0000","1178","383","795","67","1245","2052","0","60.67","18.66"
"10","008","00","003","0318","0217","663","216","447","48","711","1183","0","60.1","18.26"
"10","008","00","003","0318","0218","515","167","348","19","534","869","0","61.45","19.22"
"10","008","00","003","0319","0000","2190","723","1467","118","2308","4114","0","56.1","17.57"
"10","008","00","003","0319","0219","551","201","350","23","574","1132","0","50.71","17.76"
"10","008","00","003","0319","0220","527","165","362","38","565","949","0","59.54","17.39"
"10","008","00","003","0319","0221","559","178","381","26","585","965","0","60.62","18.45"
"10","008","00","003","0319","0222","553","179","374","31","584","1068","0","54.68","16.76"
"10","008","00","003","0320","0000","837","218","619","54","891","1659","0","53.71","13.14"
"10","008","00","003","0320","0224","330","78","252","24","354","642","0","55.14","12.15"
"10","008","00","003","0320","0225","507","140","367","30","537","1017","0","52.8","13.77"
"10","008","00","003","0321","0000","585","178","407","41","626","1024","0","61.13","17.38"
"10","008","00","003","0321","0223","585","178","407","41","626","1024","0","61.13","17.38"
"10","008","00","003","0322","0000","1252","350","902","74","1326","2276","0","58.26","15.38"
"10","008","00","003","0322","0227","624","178","446","39","663","1170","0","56.67","15.21"
"10","008","00","003","0322","0228","628","172","456","35","663","1106","0","59.95","15.55"
"10","008","00","003","0323","0000","608","168","440","24","632","1092","0","57.88","15.38"
"10","008","00","003","0323","0226","608","168","440","24","632","1092","0","57.88","15.38"
"10","008","00","003","0324","0000","420","135","285","25","445","705","0","63.12","19.15"
"10","008","00","003","0324","0160","420","135","285","25","445","705","0","63.12","19.15"
"10","008","00","003","0325","0000","1315","405","910","59","1374","2278","0","60.32","17.78"
"10","008","00","003","0325","0162","564","175","389","19","583","877","0","66.48","19.95"
"10","008","00","003","0325","0163","751","230","521","40","791","1401","0","56.46","16.42"
"10","008","00","003","0326","0000","2051","926","1125","91","2142","3796","0","56.43","24.39"
"10","008","00","003","0326","0155","729","220","509","25","754","1401","0","53.82","15.7"
"10","008","00","003","0326","0156","595","184","411","28","623","1110","0","56.13","16.58"
"10","008","00","003","0326","0157","727","522","205","38","765","1285","0","59.53","40.62"
"10","008","00","003","0327","0000","1833","540","1293","67","1900","3140","0","60.51","17.2"
"10","008","00","003","0327","0175","584","183","401","19","603","1000","0","60.3","18.3"
"10","008","00","003","0327","0176","700","202","498","24","724","1257","0","57.6","16.07"
"10","008","00","003","0327","0177","549","155","394","24","573","883","0","64.89","17.55"
"10","008","00","004","0000","0000","24280","7543","16737","1780","26060","47034","54689","55.41","16.04"
"10","008","00","004","0401","0000","1146","510","636","89","1235","2020","0","61.14","25.25"
"10","008","00","004","0401","0229","659","170","489","44","703","1170","0","60.09","14.53"
"10","008","00","004","0401","0230","487","340","147","45","532","850","0","62.59","40.0"
"10","008","00","004","0402","0000","317","95","222","25","342","621","0","55.07","15.3"
"10","008","00","004","0402","0231","317","95","222","25","342","621","0","55.07","15.3"
"10","008","00","004","0403","0000","2318","675","1643","173","2491","4505","0","55.29","14.98"
"10","008","00","004","0403","0232","476","154","322","33","509","905","0","56.24","17.02"
"10","008","00","004","0403","0233","515","148","367","41","556","1099","0","50.59","13.47"
"10","008","00","004","0403","0234","599","151","448","49","648","1214","0","53.38","12.44"
"10","008","00","004","0403","0235","728","222","506","50","778","1287","0","60.45","17.25"
"10","008","00","004","0404","0000","1910","541","1369","139","2049","3587","0","57.12","15.08"
"10","008","00","004","0404","0236","623","173","450","51","674","1191","0","56.59","14.53"
"10","008","00","004","0404","0237","584","152","432","56","640","1118","0","57.25","13.6"
"10","008","00","004","0404","0238","703","216","487","32","735","1278","0","57.51","16.9"
"10","008","00","004","0405","0000","952","300","652","56","1008","1715","0","58.78","17.49"
"10","008","00","004","0405","0270","447","151","296","37","484","793","0","61.03","19.04"
"10","008","00","004","0405","0271","505","149","356","19","524","922","0","56.83","16.16"
"10","008","00","004","0406","0000","651","198","453","40","691","1193","0","57.92","16.6"
"10","008","00","004","0406","0244","296","93","203","25","321","511","0","62.82","18.2"
"10","008","00","004","0406","0245","355","105","250","15","370","682","0","54.25","15.4"
"10","008","00","004","0407","0000","1912","568","1344","119","2031","3710","0","54.74","15.31"
"10","008","00","004","0407","0241","695","210","485","43","738","1308","0","56.42","16.06"
"10","008","00","004","0407","0242","680","194","486","37","717","1358","0","52.8","14.29"
"10","008","00","004","0407","0243","537","164","373","39","576","1044","0","55.17","15.71"
"10","008","00","004","0408","0000","467","140","327","24","491","989","0","49.65","14.16"
"10","008","00","004","0408","0246","467","140","327","24","491","989","0","49.65","14.16"
"10","008","00","004","0409","0000","719","181","538","40","759","1378","0","55.08","13.13"
"10","008","00","004","0409","0247","719","181","538","40","759","1378","0","55.08","13.13"
"10","008","00","004","0410","0000","408","92","316","32","440","875","0","50.29","10.51"
"10","008","00","004","0410","0272","176","46","130","19","195","366","0","53.28","12.57"
"10","008","00","004","0410","0273","232","46","186","13","245","509","0","48.13","9.04"
"10","008","00","004","0411","0000","1495","442","1053","97","1592","2882","0","55.24","15.34"
"10","008","00","004","0411","0260","712","209","503","54","766","1320","0","58.03","15.83"
"10","008","00","004","0411","0261","494","153","341","25","519","967","0","53.67","15.82"
"10","008","00","004","0411","0262","289","80","209","18","307","595","0","51.6","13.45"
"10","008","00","004","0412","0000","784","244","540","71","855","1729","0","49.45","14.11"
"10","008","00","004","0412","0258","408","118","290","25","433","908","0","47.69","13.0"
"10","008","00","004","0412","0259","376","126","250","46","422","821","0","51.4","15.35"
"10","008","00","004","0413","0000","418","129","289","59","477","859","0","55.53","15.02"
"10","008","00","004","0413","0263","418","129","289","59","477","859","0","55.53","15.02"
"10","008","00","004","0414","0000","2671","814","1857","168","2839","4873","0","58.26","16.7"
"10","008","00","004","0414","0251","761","227","534","49","810","1437","0","56.37","15.8"
"10","008","00","004","0414","0252","736","228","508","40","776","1286","0","60.34","17.73"
"10","008","00","004","0414","0253","621","184","437","35","656","1080","0","60.74","17.04"
"10","008","00","004","0414","0254","553","175","378","44","597","1070","0","55.79","16.36"
"10","008","00","004","0415","0000","927","283","644","89","1016","1845","0","55.07","15.34"
"10","008","00","004","0415","0264","592","178","414","54","646","1196","0","54.01","14.88"
"10","008","00","004","0415","0265","335","105","230","35","370","649","0","57.01","16.18"
"10","008","00","004","0416","0000","709","223","486","50","759","1341","0","56.6","16.63"
"10","008","00","004","0416","0266","709","223","486","50","759","1341","0","56.6","16.63"
"10","008","00","004","0417","0000","567","155","412","61","628","1222","0","51.39","12.68"
"10","008","00","004","0417","0267","567","155","412","61","628","1222","0","51.39","12.68"
"10","008","00","004","0418","0000","330","98","232","19","349","602","0","57.97","16.28"
"10","008","00","004","0418","0268","330","98","232","19","349","602","0","57.97","16.28"
"10","008","00","004","0419","0000","196","40","156","14","210","430","0","48.84","9.3"
"10","008","00","004","0419","0250","196","40","156","14","210","430","0","48.84","9.3"
"10","008","00","004","0420","0000","323","100","223","23","346","617","0","56.08","16.21"
"10","008","00","004","0420","0269","323","100","223","23","346","617","0","56.08","16.21"
"10","008","00","004","0421","0000","338","98","240","24","362","599","0","60.43","16.36"
"10","008","00","004","0421","0274","104","25","79","6","110","193","0","56.99","12.95"
"10","008","00","004","0421","0275","234","73","161","18","252","406","0","62.07","17.98"
"10","008","00","004","0422","0000","329","89","240","40","369","802","0","46.01","11.1"
"10","008","00","004","0422","0276","225","63","162","27","252","495","0","50.91","12.73"
"10","008","00","004","0422","0277","104","26","78","13","117","307","0","38.11","8.47"
"10","008","00","004","0423","0000","276","78","198","37","313","577","0","54.25","13.52"
"10","008","00","004","0423","0279","276","78","198","37","313","577","0","54.25","13.52"
"10","008","00","004","0424","0000","213","52","161","24","237","440","0","53.86","11.82"
"10","008","00","004","0424","0278","213","52","161","24","237","440","0","53.86","11.82"
"10","008","00","004","0425","0000","299","93","206","48","347","889","0","39.03","10.46"
"10","008","00","004","0425","0280","163","56","107","36","199","486","0","40.95","11.52"
"10","008","00","004","0425","0281","136","37","99","12","148","403","0","36.72","9.18"
"10","008","00","004","0426","0000","378","120","258","29","407","696","0","58.48","17.24"
"10","008","00","004","0426","0248","117","39","78","2","119","217","0","54.84","17.97"
"10","008","00","004","0426","0249","261","81","180","27","288","479","0","60.13","16.91"
"10","008","00","004","0427","0000","1978","573","1405","102","2080","3642","0","57.11","15.73"
"10","008","00","004","0427","0255","715","213","502","29","744","1295","0","57.45","16.45"
"10","008","00","004","0427","0256","565","160","405","34","599","1047","0","57.21","15.28"
"10","008","00","004","0427","0257","698","200","498","39","737","1300","0","56.69","15.38"
"10","008","00","004","0428","0000","1249","612","637","88","1337","2396","0","55.8","25.54"
"10","008","00","004","0428","0239","632","202","430","43","675","1153","0","58.54","17.52"
"10","008","00","004","0428","0240","617","410","207","45","662","1243","0","53.26","32.98"
"10","008","00","005","0000","0000","5204","1562","3642","378","5582","9611","10871","58.08","16.25"
"10","008","00","005","0501","0000","627","173","454","28","655","1070","0","61.21","16.17"
"10","008","00","005","0501","0282","627","173","454","28","655","1070","0","61.21","16.17"
"10","008","00","005","0502","0000","531","146","385","30","561","918","0","61.11","15.9"
"10","008","00","005","0502","0283","531","146","385","30","561","918","0","61.11","15.9"
"10","008","00","005","0503","0000","328","102","226","26","354","581","0","60.93","17.56"
"10","008","00","005","0503","0284","328","102","226","26","354","581","0","60.93","17.56"
"10","008","00","005","0504","0000","675","193","482","39","714","1194","0","59.8","16.16"
"10","008","00","005","0504","0285","675","193","482","39","714","1194","0","59.8","16.16"
"10","008","00","005","0505","0000","204","66","138","18","222","488","0","45.49","13.52"
"10","008","00","005","0505","0286","204","66","138","18","222","488","0","45.49","13.52"
"10","008","00","005","0506","0000","290","88","202","24","314","504","0","62.3","17.46"
"10","008","00","005","0506","0287","290","88","202","24","314","504","0","62.3","17.46"
"10","008","00","005","0507","0000","483","142","341","82","565","910","0","62.09","15.6"
"10","008","00","005","0507","0288","483","142","341","82","565","910","0","62.09","15.6"
"10","008","00","005","0508","0000","831","259","572","55","886","1482","0","59.78","17.48"
"10","008","00","005","0508","0289","450","128","322","34","484","773","0","62.61","16.56"
"10","008","00","005","0508","0290","381","131","250","21","402","709","0","56.7","18.48"
"10","008","00","005","0509","0000","532","174","358","21","553","960","0","57.6","18.13"
"10","008","00","005","0509","0291","532","174","358","21","553","960","0","57.6","18.13"
"10","008","00","005","0510","0000","257","76","181","13","270","582","0","46.39","13.06"
"10","008","00","005","0510","0294","257","76","181","13","270","582","0","46.39","13.06"
"10","008","00","005","0511","0000","446","143","303","42","488","922","0","52.93","15.51"
"10","008","00","005","0511","0292","249","77","172","27","276","503","0","54.87","15.31"
"10","008","00","005","0511","0293","197","66","131","15","212","419","0","50.6","15.75"
"10","008","00","006","0000","0000","18565","5405","13160","1467","20032","33408","38376","59.96","16.18"
"10","008","00","006","0601","0000","679","204","475","50","729","1050","0","69.43","19.43"
"10","008","00","006","0601","0295","679","204","475","50","729","1050","0","69.43","19.43"
"10","008","00","006","0602","0000","1980","568","1412","135","2115","3405","0","62.11","16.68"
"10","008","00","006","0602","0296","508","143","365","48","556","920","0","60.43","15.54"
"10","008","00","006","0602","0297","448","131","317","30","478","727","0","65.75","18.02"
"10","008","00","006","0602","0298","532","152","380","22","554","861","0","64.34","17.65"
"10","008","00","006","0602","0299","492","142","350","35","527","897","0","58.75","15.83"
"10","008","00","006","0603","0000","1265","401","864","85","1350","2239","0","60.29","17.91"
"10","008","00","006","0603","0300","615","215","400","34","649","1055","0","61.52","20.38"
"10","008","00","006","0603","0301","650","186","464","51","701","1184","0","59.21","15.71"
"10","008","00","006","0604","0000","857","236","621","79","936","1564","0","59.85","15.09"
"10","008","00","006","0604","0302","409","119","290","37","446","783","0","56.96","15.2"
"10","008","00","006","0604","0303","448","117","331","42","490","781","0","62.74","14.98"
"10","008","00","006","0605","0000","523","155","368","47","570","1015","0","56.16","15.27"
"10","008","00","006","0605","0305","523","155","368","47","570","1015","0","56.16","15.27"
"10","008","00","006","0606","0000","519","145","374","40","559","977","0","57.22","14.84"
"10","008","00","006","0606","0304","519","145","374","40","559","977","0","57.22","14.84"
"10","008","00","006","0607","0000","2299","700","1599","134","2433","4234","0","57.46","16.53"
"10","008","00","006","0607","0306","538","162","376","25","563","914","0","61.6","17.72"
"10","008","00","006","0607","0307","480","180","300","16","496","1028","0","48.25","17.51"
"10","008","00","006","0607","0308","583","153","430","34","617","1018","0","60.61","15.03"
"10","008","00","006","0607","0309","698","205","493","59","757","1274","0","59.42","16.09"
"10","008","00","006","0608","0000","975","278","697","73","1048","1650","0","63.52","16.85"
"10","008","00","006","0608","0310","424","125","299","32","456","755","0","60.4","16.56"
"10","008","00","006","0608","0311","551","153","398","41","592","895","0","66.15","17.09"
"10","008","00","006","0609","0000","502","149","353","50","552","951","0","58.04","15.67"
"10","008","00","006","0609","0313","502","149","353","50","552","951","0","58.04","15.67"
"10","008","00","006","0610","0000","683","185","498","43","726","1261","0","57.57","14.67"
"10","008","00","006","0610","0314","683","185","498","43","726","1261","0","57.57","14.67"
"10","008","00","006","0611","0000","1016","293","723","103","1119","1829","0","61.18","16.02"
"10","008","00","006","0611","0316","532","160","372","52","584","962","0","60.71","16.63"
"10","008","00","006","0611","0317","484","133","351","51","535","867","0","61.71","15.34"
"10","008","00","006","0612","0000","504","161","343","65","569","930","0","61.18","17.31"
"10","008","00","006","0612","0318","504","161","343","65","569","930","0","61.18","17.31"
"10","008","00","006","0613","0000","409","128","281","34","443","768","0","57.68","16.67"
"10","008","00","006","0613","0315","409","128","281","34","443","768","0","57.68","16.67"
"10","008","00","006","0614","0000","506","180","326","52","558","931","0","59.94","19.33"
"10","008","00","006","0614","0321","506","180","326","52","558","931","0","59.94","19.33"
"10","008","00","006","0615","0000","601","155","446","68","669","1171","0","57.13","13.24"
"10","008","00","006","0615","0319","343","94","249","45","388","641","0","60.53","14.66"
"10","008","00","006","0615","0320","258","61","197","23","281","530","0","53.02","11.51"
"10","008","00","006","0616","0000","885","258","627","80","965","1570","0","61.46","16.43"
"10","008","00","006","0616","0322","620","180","440","50","670","1127","0","59.45","15.97"
"10","008","00","006","0616","0323","265","78","187","30","295","443","0","66.59","17.61"
"10","008","00","006","0617","0000","853","252","601","76","929","1491","0","62.31","16.9"
"10","008","00","006","0617","0324","493","133","360","41","534","870","0","61.38","15.29"
"10","008","00","006","0617","0325","360","119","241","35","395","621","0","63.61","19.16"
"10","008","00","006","0618","0000","609","189","420","32","641","1179","0","54.37","16.03"
"10","008","00","006","0618","0326","609","189","420","32","641","1179","0","54.37","16.03"
"10","008","00","006","0619","0000","559","133","426","37","596","876","0","68.04","15.18"
"10","008","00","006","0619","0328","559","133","426","37","596","876","0","68.04","15.18"
"10","008","00","006","0620","0000","511","147","364","44","555","881","0","63.0","16.69"
"10","008","00","006","0620","0327","511","147","364","44","555","881","0","63.0","16.69"
"10","008","00","006","0621","0000","431","112","319","46","477","783","0","60.92","14.3"
"10","008","00","006","0621","0329","431","112","319","46","477","783","0","60.92","14.3"
"10","008","00","006","0622","0000","894","242","652","72","966","1761","0","54.86","13.74"
"10","008","00","006","0622","0330","393","91","302","30","423","778","0","54.37","11.7"
"10","008","00","006","0622","0331","501","151","350","42","543","983","0","55.24","15.36"
"10","008","00","006","0623","0000","505","134","371","22","527","892","0","59.08","15.02"
"10","008","00","006","0623","0312","505","134","371","22","527","892","0","59.08","15.02"
"10","008","00","007","0000","0000","8054","2276","5778","566","8620","15941","17698","54.07","14.28"
"10","008","00","007","0701","0000","941","245","696","85","1026","1874","0","54.75","13.07"
"10","008","00","007","0701","0332","432","100","332","52","484","934","0","51.82","10.71"
"10","008","00","007","0701","0333","509","145","364","33","542","940","0","57.66","15.43"
"10","008","00","007","0702","0000","672","209","463","39","711","1430","0","49.72","14.62"
"10","008","00","007","0702","0348","353","114","239","20","373","713","0","52.31","15.99"
"10","008","00","007","0702","0349","319","95","224","19","338","717","0","47.14","13.25"
"10","008","00","007","0703","0000","622","218","404","55","677","1303","0","51.96","16.73"
"10","008","00","007","0703","0334","432","138","294","25","457","852","0","53.64","16.2"
"10","008","00","007","0703","0335","190","80","110","30","220","451","0","48.78","17.74"
"10","008","00","007","0704","0000","1153","299","854","55","1208","1952","0","61.89","15.32"
"10","008","00","007","0704","0336","477","127","350","19","496","810","0","61.23","15.68"
"10","008","00","007","0704","0337","676","172","504","36","712","1142","0","62.35","15.06"
"10","008","00","007","0705","0000","536","163","373","39","575","1045","0","55.02","15.6"
"10","008","00","007","0705","0342","279","85","194","17","296","578","0","51.21","14.71"
"10","008","00","007","0705","0343","257","78","179","22","279","467","0","59.74","16.7"
"10","008","00","007","0706","0000","762","193","569","54","816","1507","0","54.15","12.81"
"10","008","00","007","0706","0345","364","100","264","19","383","740","0","51.76","13.51"
"10","008","00","007","0706","0346","398","93","305","35","433","767","0","56.45","12.13"
"10","008","00","007","0707","0000","501","123","378","30","531","909","0","58.42","13.53"
"10","008","00","007","0707","0347","501","123","378","30","531","909","0","58.42","13.53"
"10","008","00","007","0708","0000","318","69","249","28","346","622","0","55.63","11.09"
"10","008","00","007","0708","0344","318","69","249","28","346","622","0","55.63","11.09"
"10","008","00","007","0709","0000","683","216","467","53","736","1392","0","52.87","15.52"
"10","008","00","007","0709","0340","429","146","283","31","460","811","0","56.72","18.0"
"10","008","00","007","0709","0341","254","70","184","22","276","581","0","47.5","12.05"
"10","008","00","007","0710","0000","838","226","612","58","896","1650","0","54.3","13.7"
"10","008","00","007","0710","0338","359","106","253","19","378","766","0","49.35","13.84"
"10","008","00","007","0710","0339","479","120","359","39","518","884","0","58.6","13.57"
"10","008","00","007","0711","0000","384","119","265","24","408","794","0","51.39","14.99"
"10","008","00","007","0711","0350","384","119","265","24","408","794","0","51.39","14.99"
"10","008","00","007","0712","0000","346","108","238","15","361","726","0","49.72","14.88"
"10","008","00","007","0712","0351","346","108","238","15","361","726","0","49.72","14.88"
"10","008","00","007","0713","0000","298","88","210","31","329","737","0","44.64","11.94"
"10","008","00","007","0713","0352","298","88","210","31","329","737","0","44.64","11.94"
"10","008","00","008","0000","0000","7074","1943","5131","556","7630","13181","14734","57.89","14.74"
"10","008","00","008","0801","0000","468","128","340","37","505","822","0","61.44","15.57"
"10","008","00","008","0801","0353","468","128","340","37","505","822","0","61.44","15.57"
"10","008","00","008","0802","0000","234","65","169","16","250","474","0","52.74","13.71"
"10","008","00","008","0802","0354","143","40","103","12","155","253","0","61.26","15.81"
"10","008","00","008","0802","0355","91","25","66","4","95","221","0","42.99","11.31"
"10","008","00","008","0803","0000","381","116","265","21","402","780","0","51.54","14.87"
"10","008","00","008","0803","0356","162","52","110","4","166","353","0","47.03","14.73"
"10","008","00","008","0803","0357","219","64","155","17","236","427","0","55.27","14.99"
"10","008","00","008","0804","0000","375","103","272","28","403","661","0","60.97","15.58"
"10","008","00","008","0804","0360","375","103","272","28","403","661","0","60.97","15.58"
"10","008","00","008","0805","0000","360","83","277","33","393","713","0","55.12","11.64"
"10","008","00","008","0805","0358","217","48","169","15","232","406","0","57.14","11.82"
"10","008","00","008","0805","0359","143","35","108","18","161","307","0","52.44","11.4"
"10","008","00","008","0806","0000","963","286","677","65","1028","1727","0","59.53","16.56"
"10","008","00","008","0806","0362","528","163","365","44","572","973","0","58.79","16.75"
"10","008","00","008","0806","0363","435","123","312","21","456","754","0","60.48","16.31"
"10","008","00","008","0807","0000","180","47","133","12","192","290","0","66.21","16.21"
"10","008","00","008","0807","0361","180","47","133","12","192","290","0","66.21","16.21"
"10","008","00","008","0808","0000","340","86","254","28","368","662","0","55.59","12.99"
"10","008","00","008","0808","0364","340","86","254","28","368","662","0","55.59","12.99"
"10","008","00","008","0809","0000","226","53","173","10","236","490","0","48.16","10.82"
"10","008","00","008","0809","0365","226","53","173","10","236","490","0","48.16","10.82"
"10","008","00","008","0810","0000","705","209","496","47","752","1325","0","56.75","15.77"
"10","008","00","008","0810","0366","163","56","107","13","176","335","0","52.54","16.72"
"10","008","00","008","0810","0367","542","153","389","34","576","990","0","58.18","15.45"
"10","008","00","008","0811","0000","636","169","467","41","677","1075","0","62.98","15.72"
"10","008","00","008","0811","0368","278","68","210","18","296","461","0","64.21","14.75"
"10","008","00","008","0811","0369","358","101","257","23","381","614","0","62.05","16.45"
"10","008","00","008","0812","0000","466","117","349","44","510","895","0","56.98","13.07"
"10","008","00","008","0812","0370","466","117","349","44","510","895","0","56.98","13.07"
"10","008","00","008","0813","0000","351","121","230","51","402","682","0","58.94","17.74"
"10","008","00","008","0813","0372","351","121","230","51","402","682","0","58.94","17.74"
"10","008","00","008","0814","0000","364","92","272","31","395","643","0","61.43","14.31"
"10","008","00","008","0814","0374","364","92","272","31","395","643","0","61.43","14.31"
"10","008","00","008","0815","0000","250","65","185","15","265","528","0","50.19","12.31"
"10","008","00","008","0815","0376","250","65","185","15","265","528","0","50.19","12.31"
"10","008","00","008","0816","0000","238","61","177","27","265","465","0","56.99","13.12"
"10","008","00","008","0816","0371","238","61","177","27","265","465","0","56.99","13.12"
"10","008","00","008","0817","0000","265","68","197","19","284","459","0","61.87","14.81"
"10","008","00","008","0817","0375","265","68","197","19","284","459","0","61.87","14.81"
"10","008","00","008","0818","0000","272","74","198","31","303","490","0","61.84","15.1"
"10","008","00","008","0818","0373","272","74","198","31","303","490","0","61.84","15.1"
"10","008","00","009","0000","0000","7065","2123","4942","546","7611","13958","15823","54.53","15.21"
"10","008","00","009","0901","0000","823","257","566","71","894","1580","0","56.58","16.27"
"10","008","00","009","0901","0379","358","129","229","29","387","720","0","53.75","17.92"
"10","008","00","009","0901","0380","465","128","337","42","507","860","0","58.95","14.88"
"10","008","00","009","0902","0000","1093","346","747","87","1180","2020","0","58.42","17.13"
"10","008","00","009","0902","0377","496","155","341","35","531","922","0","57.59","16.81"
"10","008","00","009","0902","0378","597","191","406","52","649","1098","0","59.11","17.4"
"10","008","00","009","0903","0000","448","147","301","48","496","1017","0","48.77","14.45"
"10","008","00","009","0903","0394","246","80","166","26","272","578","0","47.06","13.84"
"10","008","00","009","0903","0395","202","67","135","22","224","439","0","51.03","15.26"
"10","008","00","009","0904","0000","700","215","485","57","757","1386","0","54.62","15.51"
"10","008","00","009","0904","0387","407","124","283","26","433","841","0","51.49","14.74"
"10","008","00","009","0904","0388","156","49","107","14","170","270","0","62.96","18.15"
"10","008","00","009","0904","0389","137","42","95","17","154","275","0","56.0","15.27"
"10","008","00","009","0905","0000","517","148","369","36","553","1088","0","50.83","13.6"
"10","008","00","009","0905","0381","239","58","181","24","263","514","0","51.17","11.28"
"10","008","00","009","0905","0382","278","90","188","12","290","574","0","50.52","15.68"
"10","008","00","009","0906","0000","637","195","442","47","684","1249","0","54.76","15.61"
"10","008","00","009","0906","0383","637","195","442","47","684","1249","0","54.76","15.61"
"10","008","00","009","0907","0000","542","173","369","34","576","992","0","58.06","17.44"
"10","008","00","009","0907","0384","188","55","133","6","194","293","0","66.21","18.77"
"10","008","00","009","0907","0385","258","75","183","21","279","513","0","54.39","14.62"
"10","008","00","009","0907","0386","96","43","53","7","103","186","0","55.38","23.12"
"10","008","00","009","0908","0000","309","87","222","16","325","674","0","48.22","12.91"
"10","008","00","009","0908","0390","124","27","97","7","131","282","0","46.45","9.57"
"10","008","00","009","0908","0391","185","60","125","9","194","392","0","49.49","15.31"
"10","008","00","009","0909","0000","364","89","275","39","403","732","0","55.05","12.16"
"10","008","00","009","0909","0392","273","72","201","33","306","556","0","55.04","12.95"
"10","008","00","009","0909","0393","91","17","74","6","97","176","0","55.11","9.66"
"10","008","00","009","0910","0000","465","130","335","24","489","844","0","57.94","15.4"
"10","008","00","009","0910","0396","465","130","335","24","489","844","0","57.94","15.4"
"10","008","00","009","0911","0000","468","148","320","29","497","942","0","52.76","15.71"
"10","008","00","009","0911","0398","177","58","119","13","190","405","0","46.91","14.32"
"10","008","00","009","0911","0399","291","90","201","16","307","537","0","57.17","16.76"
"10","008","00","009","0912","0000","262","59","203","25","287","566","0","50.71","10.42"
"10","008","00","009","0912","0400","170","43","127","13","183","335","0","54.63","12.84"
"10","008","00","009","0912","0401","92","16","76","12","104","231","0","45.02","6.93"
"10","008","00","009","0913","0000","437","129","308","33","470","868","0","54.15","14.86"
"10","008","00","009","0913","0397","437","129","308","33","470","868","0","54.15","14.86"
"10","008","00","010","0000","0000","8778","2268","6510","625","9403","16597","18699","56.65","13.67"
"10","008","00","010","1001","0000","949","214","735","70","1019","1700","0","59.94","12.59"
"10","008","00","010","1001","0402","553","125","428","50","603","964","0","62.55","12.97"
"10","008","00","010","1001","0403","396","89","307","20","416","736","0","56.52","12.09"
"10","008","00","010","1002","0000","960","237","723","69","1029","1765","0","58.3","13.43"
"10","008","00","010","1002","0404","425","100","325","52","477","801","0","59.55","12.48"
"10","008","00","010","1002","0405","535","137","398","17","552","964","0","57.26","14.21"
"10","008","00","010","1003","0000","355","100","255","32","387","686","0","56.41","14.58"
"10","008","00","010","1003","0406","355","100","255","32","387","686","0","56.41","14.58"
"10","008","00","010","1004","0000","939","222","717","52","991","1880","0","52.71","11.81"
"10","008","00","010","1004","0411","545","127","418","32","577","1012","0","57.02","12.55"
"10","008","00","010","1004","0412","394","95","299","20","414","868","0","47.7","10.94"
"10","008","00","010","1005","0000","696","173","523","45","741","1391","0","53.27","12.44"
"10","008","00","010","1005","0407","342","91","251","20","362","661","0","54.77","13.77"
"10","008","00","010","1005","0408","354","82","272","25","379","730","0","51.92","11.23"
"10","008","00","010","1006","0000","402","119","283","18","420","706","0","59.49","16.86"
"10","008","00","010","1006","0410","402","119","283","18","420","706","0","59.49","16.86"
"10","008","00","010","1007","0000","1032","267","765","60","1092","1855","0","58.87","14.39"
"10","008","00","010","1007","0413","535","135","400","21","556","918","0","60.57","14.71"
"10","008","00","010","1007","0414","497","132","365","39","536","937","0","57.2","14.09"
"10","008","00","010","1008","0000","415","125","290","35","450","815","0","55.21","15.34"
"10","008","00","010","1008","0415","415","125","290","35","450","815","0","55.21","15.34"
"10","008","00","010","1009","0000","648","167","481","37","685","1134","0","60.41","14.73"
"10","008","00","010","1009","0416","648","167","481","37","685","1134","0","60.41","14.73"
"10","008","00","010","1010","0000","821","235","586","64","885","1543","0","57.36","15.23"
"10","008","00","010","1010","0418","606","174","432","42","648","1095","0","59.18","15.89"
"10","008","00","010","1010","0419","215","61","154","22","237","448","0","52.9","13.62"
"10","008","00","010","1011","0000","797","185","612","74","871","1634","0","53.3","11.32"
"10","008","00","010","1011","0420","518","112","406","53","571","1064","0","53.67","10.53"
"10","008","00","010","1011","0421","279","73","206","21","300","570","0","52.63","12.81"
"10","008","00","010","1012","0000","373","117","256","24","397","714","0","55.6","16.39"
"10","008","00","010","1012","0417","373","117","256","24","397","714","0","55.6","16.39"
"10","008","00","010","1013","0000","391","107","284","45","436","774","0","56.33","13.82"
"10","008","00","010","1013","0409","391","107","284","45","436","774","0","56.33","13.82"
"10","008","00","011","0000","0000","8110","2326","5784","569","8679","15458","17582","56.15","15.05"
"10","008","00","011","1101","0000","397","110","287","25","422","757","0","55.75","14.53"
"10","008","00","011","1101","0422","397","110","287","25","422","757","0","55.75","14.53"
"10","008","00","011","1102","0000","286","82","204","8","294","480","0","61.25","17.08"
"10","008","00","011","1102","0427","286","82","204","8","294","480","0","61.25","17.08"
"10","008","00","011","1103","0000","818","245","573","74","892","1553","0","57.44","15.78"
"10","008","00","011","1103","0423","279","84","195","34","313","554","0","56.5","15.16"
"10","008","00","011","1103","0424","539","161","378","40","579","999","0","57.96","16.12"
"10","008","00","011","1104","0000","321","85","236","16","337","616","0","54.71","13.8"
"10","008","00","011","1104","0425","321","85","236","16","337","616","0","54.71","13.8"
"10","008","00","011","1105","0000","503","146","357","22","525","875","0","60.0","16.69"
"10","008","00","011","1105","0426","503","146","357","22","525","875","0","60.0","16.69"
"10","008","00","011","1106","0000","562","146","416","25","587","1004","0","58.47","14.54"
"10","008","00","011","1106","0430","562","146","416","25","587","1004","0","58.47","14.54"
"10","008","00","011","1107","0000","587","168","419","54","641","998","0","64.23","16.83"
"10","008","00","011","1107","0433","587","168","419","54","641","998","0","64.23","16.83"
"10","008","00","011","1108","0000","748","205","543","61","809","1389","0","58.24","14.76"
"10","008","00","011","1108","0434","400","115","285","42","442","800","0","55.25","14.38"
"10","008","00","011","1108","0435","348","90","258","19","367","589","0","62.31","15.28"
"10","008","00","011","1109","0000","602","158","444","35","637","1217","0","52.34","12.98"
"10","008","00","011","1109","0437","602","158","444","35","637","1217","0","52.34","12.98"
"10","008","00","011","1110","0000","231","83","148","17","248","450","0","55.11","18.44"
"10","008","00","011","1110","0428","231","83","148","17","248","450","0","55.11","18.44"
"10","008","00","011","1111","0000","318","112","206","37","355","643","0","55.21","17.42"
"10","008","00","011","1111","0429","318","112","206","37","355","643","0","55.21","17.42"
"10","008","00","011","1112","0000","80","26","54","1","81","205","0","39.51","12.68"
"10","008","00","011","1112","0438","80","26","54","1","81","205","0","39.51","12.68"
"10","008","00","011","1113","0000","185","50","135","24","209","330","0","63.33","15.15"
"10","008","00","011","1113","0439","185","50","135","24","209","330","0","63.33","15.15"
"10","008","00","011","1114","0000","547","149","398","32","579","1100","0","52.64","13.55"
"10","008","00","011","1114","0440","547","149","398","32","579","1100","0","52.64","13.55"
"10","008","00","011","1115","0000","417","118","299","47","464","887","0","52.31","13.3"
"10","008","00","011","1115","0436","417","118","299","47","464","887","0","52.31","13.3"
"10","008","00","011","1116","0000","137","57","80","2","139","318","0","43.71","17.92"
"10","008","00","011","1116","0442","137","57","80","2","139","318","0","43.71","17.92"
"10","008","00","011","1117","0000","398","101","297","48","446","818","0","54.52","12.35"
"10","008","00","011","1117","0443","398","101","297","48","446","818","0","54.52","12.35"
"10","008","00","011","1118","0000","97","22","75","8","105","275","0","38.18","8.0"
"10","008","00","011","1118","0441","97","22","75","8","105","275","0","38.18","8.0"
"10","008","00","011","1119","0000","876","263","613","33","909","1543","0","58.91","17.04"
"10","008","00","011","1119","0431","418","98","320","22","440","741","0","59.38","13.23"
"10","008","00","011","1119","0432","458","165","293","11","469","802","0","58.48","20.57"
"10","008","00","012","0000","0000","7594","1461","6133","602","8196","13299","16281","61.63","10.99"
"10","008","00","012","1201","0000","700","104","596","68","768","1203","0","63.84","8.65"
"10","008","00","012","1201","0459","578","77","501","61","639","929","0","68.78","8.29"
"10","008","00","012","1201","0460","122","27","95","7","129","274","0","47.08","9.85"
"10","008","00","012","1202","0000","599","96","503","35","634","900","0","70.44","10.67"
"10","008","00","012","1202","0461","599","96","503","35","634","900","0","70.44","10.67"
"10","008","00","012","1203","0000","351","67","284","26","377","560","0","67.32","11.96"
"10","008","00","012","1203","0463","351","67","284","26","377","560","0","67.32","11.96"
"10","008","00","012","1204","0000","772","169","603","85","857","1530","0","56.01","11.05"
"10","008","00","012","1204","0444","609","138","471","70","679","1201","0","56.54","11.49"
"10","008","00","012","1204","0445","163","31","132","15","178","329","0","54.1","9.42"
"10","008","00","012","1205","0000","244","75","169","27","271","516","0","52.52","14.53"
"10","008","00","012","1205","0446","244","75","169","27","271","516","0","52.52","14.53"
"10","008","00","012","1206","0000","350","86","264","21","371","745","0","49.8","11.54"
"10","008","00","012","1206","0447","185","44","141","17","202","424","0","47.64","10.38"
"10","008","00","012","1206","0448","165","42","123","4","169","321","0","52.65","13.08"
"10","008","00","012","1207","0000","721","110","611","26","747","1376","0","54.29","7.99"
"10","008","00","012","1207","0451","721","110","611","26","747","1376","0","54.29","7.99"
"10","008","00","012","1208","0000","884","162","722","61","945","1509","0","62.62","10.74"
"10","008","00","012","1208","0452","528","96","432","22","550","979","0","56.18","9.81"
"10","008","00","012","1208","0453","356","66","290","39","395","530","0","74.53","12.45"
"10","008","00","012","1209","0000","706","174","532","57","763","1425","0","53.54","12.21"
"10","008","00","012","1209","0454","467","119","348","39","506","961","0","52.65","12.38"
"10","008","00","012","1209","0455","239","55","184","18","257","464","0","55.39","11.85"
"10","008","00","012","1210","0000","352","100","252","42","394","666","0","59.16","15.02"
"10","008","00","012","1210","0456","271","77","194","34","305","517","0","58.99","14.89"
"10","008","00","012","1210","0457","81","23","58","8","89","149","0","59.73","15.44"
"10","008","00","012","1211","0000","696","103","593","67","763","1020","0","74.8","10.1"
"10","008","00","012","1211","0458","696","103","593","67","763","1020","0","74.8","10.1"
"10","008","00","012","1212","0000","419","73","346","32","451","617","0","73.1","11.83"
"10","008","00","012","1212","0462","419","73","346","32","451","617","0","73.1","11.83"
"10","008","00","012","1213","0000","406","58","348","33","439","584","0","75.17","9.93"
"10","008","00","012","1213","0450","406","58","348","33","439","584","0","75.17","9.93"
"10","008","00","012","1214","0000","394","84","310","22","416","648","0","64.2","12.96"
"10","008","00","012","1214","0449","394","84","310","22","416","648","0","64.2","12.96"
"10","008","00","013","0000","0000","6765","1695","5070","388","7153","12589","15954","56.82","13.46"
"10","008","00","013","1301","0000","367","82","285","13","380","763","0","49.8","10.75"
"10","008","00","013","1301","0484","367","82","285","13","380","763","0","49.8","10.75"
"10","008","00","013","1302","0000","549","66","483","29","578","889","0","65.02","7.42"
"10","008","00","013","1302","0485","549","66","483","29","578","889","0","65.02","7.42"
"10","008","00","013","1303","0000","659","148","511","53","712","1119","0","63.63","13.23"
"10","008","00","013","1303","0486","405","79","326","33","438","672","0","65.18","11.76"
"10","008","00","013","1303","0487","254","69","185","20","274","447","0","61.3","15.44"
"10","008","00","013","1304","0000","298","62","236","7","305","409","0","74.57","15.16"
"10","008","00","013","1304","0488","298","62","236","7","305","409","0","74.57","15.16"
"10","008","00","013","1305","0000","366","54","312","16","382","509","0","75.05","10.61"
"10","008","00","013","1305","0477","366","54","312","16","382","509","0","75.05","10.61"
"10","008","00","013","1306","0000","449","63","386","33","482","769","0","62.68","8.19"
"10","008","00","013","1306","0474","222","28","194","27","249","384","0","64.84","7.29"
"10","008","00","013","1306","0475","58","4","54","4","62","121","0","51.24","3.31"
"10","008","00","013","1306","0476","169","31","138","2","171","264","0","64.77","11.74"
"10","008","00","013","1307","0000","206","47","159","10","216","597","0","36.18","7.87"
"10","008","00","013","1307","0473","206","47","159","10","216","597","0","36.18","7.87"
"10","008","00","013","1308","0000","525","145","380","36","561","1151","0","48.74","12.6"
"10","008","00","013","1308","0480","273","80","193","20","293","613","0","47.8","13.05"
"10","008","00","013","1308","0481","178","52","126","12","190","404","0","47.03","12.87"
"10","008","00","013","1308","0482","74","13","61","4","78","134","0","58.21","9.7"
"10","008","00","013","1309","0000","889","235","654","44","933","1665","0","56.04","14.11"
"10","008","00","013","1309","0466","439","115","324","14","453","900","0","50.33","12.78"
"10","008","00","013","1309","0467","277","75","202","20","297","460","0","64.57","16.3"
"10","008","00","013","1309","0468","173","45","128","10","183","305","0","60.0","14.75"
"10","008","00","013","1310","0000","671","438","233","30","701","1269","0","55.24","34.52"
"10","008","00","013","1310","0464","531","395","136","20","551","973","0","56.63","40.6"
"10","008","00","013","1310","0465","140","43","97","10","150","296","0","50.68","14.53"
"10","008","00","013","1311","0000","502","96","406","9","511","952","0","53.68","10.08"
"10","008","00","013","1311","0470","502","96","406","9","511","952","0","53.68","10.08"
"10","008","00","013","1312","0000","298","64","234","7","305","679","0","44.92","9.43"
"10","008","00","013","1312","0471","298","64","234","7","305","679","0","44.92","9.43"
"10","008","00","013","1313","0000","375","69","306","32","407","630","0","64.6","10.95"
"10","008","00","013","1313","0483","375","69","306","32","407","630","0","64.6","10.95"
"10","008","00","013","1314","0000","18","1","17","2","20","58","0","34.48","1.72"
"10","008","00","013","1314","0469","18","1","17","2","20","58","0","34.48","1.72"
"10","008","00","013","1315","0000","270","48","222","21","291","507","0","57.4","9.47"
"10","008","00","013","1315","0478","187","25","162","20","207","338","0","61.24","7.4"
"10","008","00","013","1315","0479","83","23","60","1","84","169","0","49.7","13.61"
"10","008","00","013","1316","0000","323","77","246","46","369","623","0","59.23","12.36"
"10","008","00","013","1316","0472","323","77","246","46","369","623","0","59.23","12.36"
"10","009","00","000","0000","0000","278561","88127","190434","23887","302448","584480","687195","51.75","15.08"
"10","009","00","001","0000","0000","49034","15497","33537","2528","51562","89761","108487","57.44","17.26"
"10","009","00","001","0101","0000","825","260","565","52","877","1415","0","61.98","18.37"
"10","009","00","001","0101","0431","825","260","565","52","877","1415","0","61.98","18.37"
"10","009","00","001","0102","0000","638","196","442","37","675","1101","0","61.31","17.8"
"10","009","00","001","0102","0432","638","196","442","37","675","1101","0","61.31","17.8"
"10","009","00","001","0103","0000","344","127","217","15","359","644","0","55.75","19.72"
"10","009","00","001","0103","0411","344","127","217","15","359","644","0","55.75","19.72"
"10","009","00","001","0104","0000","324","104","220","21","345","617","0","55.92","16.86"
"10","009","00","001","0104","0412","324","104","220","21","345","617","0","55.92","16.86"
"10","009","00","001","0105","0000","494","174","320","28","522","764","0","68.32","22.77"
"10","009","00","001","0105","0413","494","174","320","28","522","764","0","68.32","22.77"
"10","009","00","001","0106","0000","465","153","312","25","490","784","0","62.5","19.52"
"10","009","00","001","0106","0414","465","153","312","25","490","784","0","62.5","19.52"
"10","009","00","001","0107","0000","397","138","259","47","444","760","0","58.42","18.16"
"10","009","00","001","0107","0415","397","138","259","47","444","760","0","58.42","18.16"
"10","009","00","001","0108","0000","2602","767","1835","106","2708","4634","0","58.44","16.55"
"10","009","00","001","0108","0422","856","261","595","17","873","1529","0","57.1","17.07"
"10","009","00","001","0108","0423","746","209","537","43","789","1335","0","59.1","15.66"
"10","009","00","001","0108","0424","1000","297","703","46","1046","1770","0","59.1","16.78"
"10","009","00","001","0109","0000","1674","523","1151","66","1740","3236","0","53.77","16.16"
"10","009","00","001","0109","0433","877","276","601","45","922","1648","0","55.95","16.75"
"10","009","00","001","0109","0434","797","247","550","21","818","1588","0","51.51","15.55"
"10","009","00","001","0110","0000","1635","499","1136","71","1706","2765","0","61.7","18.05"
"10","009","00","001","0110","0427","696","211","485","31","727","1193","0","60.94","17.69"
"10","009","00","001","0110","0428","939","288","651","40","979","1572","0","62.28","18.32"
"10","009","00","001","0111","0000","1016","352","664","49","1065","1747","0","60.96","20.15"
"10","009","00","001","0111","0449","1016","352","664","49","1065","1747","0","60.96","20.15"
"10","009","00","001","0112","0000","1904","618","1286","78","1982","3513","0","56.42","17.59"
"10","009","00","001","0112","0444","596","207","389","22","618","1097","0","56.34","18.87"
"10","009","00","001","0112","0445","701","211","490","29","730","1262","0","57.84","16.72"
"10","009","00","001","0112","0446","607","200","407","27","634","1154","0","54.94","17.33"
"10","009","00","001","0113","0000","2318","715","1603","91","2409","4188","0","57.52","17.07"
"10","009","00","001","0113","0439","847","264","583","33","880","1421","0","61.93","18.58"
"10","009","00","001","0113","0440","694","202","492","32","726","1261","0","57.57","16.02"
"10","009","00","001","0113","0441","777","249","528","26","803","1506","0","53.32","16.53"
"10","009","00","001","0114","0000","1138","363","775","68","1206","2329","0","51.78","15.59"
"10","009","00","001","0114","0437","564","155","409","31","595","1187","0","50.13","13.06"
"10","009","00","001","0114","0438","574","208","366","37","611","1142","0","53.5","18.21"
"10","009","00","001","0115","0000","413","129","284","20","433","669","0","64.72","19.28"
"10","009","00","001","0115","0453","413","129","284","20","433","669","0","64.72","19.28"
"10","009","00","001","0116","0000","1165","399","766","56","1221","2202","0","55.45","18.12"
"10","009","00","001","0116","0454","399","141","258","31","430","752","0","57.18","18.75"
"10","009","00","001","0116","0455","766","258","508","25","791","1450","0","54.55","17.79"
"10","009","00","001","0117","0000","288","91","197","34","322","555","0","58.02","16.4"
"10","009","00","001","0117","0456","288","91","197","34","322","555","0","58.02","16.4"
"10","009","00","001","0118","0000","1326","407","919","63","1389","2414","0","57.54","16.86"
"10","009","00","001","0118","0451","601","165","436","32","633","1112","0","56.92","14.84"
"10","009","00","001","0118","0452","725","242","483","31","756","1302","0","58.06","18.59"
"10","009","00","001","0119","0000","770","282","488","39","809","1418","0","57.05","19.89"
"10","009","00","001","0119","0450","770","282","488","39","809","1418","0","57.05","19.89"
"10","009","00","001","0120","0000","1266","405","861","61","1327","2397","0","55.36","16.9"
"10","009","00","001","0120","0457","730","240","490","39","769","1470","0","52.31","16.33"
"10","009","00","001","0120","0458","536","165","371","22","558","927","0","60.19","17.8"
"10","009","00","001","0121","0000","731","131","600","77","808","1748","0","46.22","7.49"
"10","009","00","001","0121","0466","731","131","600","77","808","1748","0","46.22","7.49"
"10","009","00","001","0122","0000","2998","999","1999","94","3092","5306","0","58.27","18.83"
"10","009","00","001","0122","0462","815","265","550","25","840","1412","0","59.49","18.77"
"10","009","00","001","0122","0463","809","257","552","28","837","1354","0","61.82","18.98"
"10","009","00","001","0122","0464","702","253","449","20","722","1267","0","56.99","19.97"
"10","009","00","001","0122","0465","672","224","448","21","693","1273","0","54.44","17.6"
"10","009","00","001","0123","0000","2793","871","1922","181","2974","5374","0","55.34","16.21"
"10","009","00","001","0123","0459","1062","360","702","45","1107","1893","0","58.48","19.02"
"10","009","00","001","0123","0460","894","264","630","80","974","1708","0","57.03","15.46"
"10","009","00","001","0123","0461","837","247","590","56","893","1773","0","50.37","13.93"
"10","009","00","001","0124","0000","1008","325","683","84","1092","1813","0","60.23","17.93"
"10","009","00","001","0124","0472","406","121","285","28","434","702","0","61.82","17.24"
"10","009","00","001","0124","0473","602","204","398","56","658","1111","0","59.23","18.36"
"10","009","00","001","0125","0000","520","131","389","34","554","1123","0","49.33","11.67"
"10","009","00","001","0125","0474","520","131","389","34","554","1123","0","49.33","11.67"
"10","009","00","001","0126","0000","2388","711","1677","154","2542","4406","0","57.69","16.14"
"10","009","00","001","0126","0467","669","200","469","64","733","1238","0","59.21","16.16"
"10","009","00","001","0126","0468","852","239","613","39","891","1648","0","54.07","14.5"
"10","009","00","001","0126","0469","867","272","595","51","918","1520","0","60.39","17.89"
"10","009","00","001","0127","0000","562","144","418","21","583","1087","0","53.63","13.25"
"10","009","00","001","0127","0470","562","144","418","21","583","1087","0","53.63","13.25"
"10","009","00","001","0128","0000","1016","313","703","68","1084","1904","0","56.93","16.44"
"10","009","00","001","0128","0471","1016","313","703","68","1084","1904","0","56.93","16.44"
"10","009","00","001","0129","0000","1606","511","1095","125","1731","3095","0","55.93","16.51"
"10","009","00","001","0129","0477","535","171","364","53","588","1023","0","57.48","16.72"
"10","009","00","001","0129","0478","1071","340","731","72","1143","2072","0","55.16","16.41"
"10","009","00","001","0130","0000","1508","473","1035","68","1576","2932","0","53.75","16.13"
"10","009","00","001","0130","0475","588","164","424","32","620","1146","0","54.1","14.31"
"10","009","00","001","0130","0476","920","309","611","36","956","1786","0","53.53","17.3"
"10","009","00","001","0131","0000","577","195","382","34","611","1128","0","54.17","17.29"
"10","009","00","001","0131","0479","577","195","382","34","611","1128","0","54.17","17.29"
"10","009","00","001","0132","0000","1464","469","995","48","1512","2345","0","64.48","20.0"
"10","009","00","001","0132","0418","781","242","539","28","809","1255","0","64.46","19.28"
"10","009","00","001","0132","0419","683","227","456","20","703","1090","0","64.5","20.83"
"10","009","00","001","0133","0000","2049","647","1402","102","2151","3710","0","57.98","17.44"
"10","009","00","001","0133","0416","1092","345","747","49","1141","1881","0","60.66","18.34"
"10","009","00","001","0133","0417","957","302","655","53","1010","1829","0","55.22","16.51"
"10","009","00","001","0134","0000","1617","558","1059","43","1660","2814","0","58.99","19.83"
"10","009","00","001","0134","0435","806","284","522","21","827","1392","0","59.41","20.4"
"10","009","00","001","0134","0436","811","274","537","22","833","1422","0","58.58","19.27"
"10","009","00","001","0135","0000","1289","409","880","56","1345","2286","0","58.84","17.89"
"10","009","00","001","0135","0447","477","149","328","32","509","847","0","60.09","17.59"
"10","009","00","001","0135","0448","812","260","552","24","836","1439","0","58.1","18.07"
"10","009","00","001","0136","0000","1251","407","844","58","1309","2204","0","59.39","18.47"
"10","009","00","001","0136","0429","555","181","374","18","573","1009","0","56.79","17.94"
"10","009","00","001","0136","0430","696","226","470","40","736","1195","0","61.59","18.91"
"10","009","00","001","0137","0000","1823","587","1236","104","1927","3479","0","55.39","16.87"
"10","009","00","001","0137","0425","716","238","478","36","752","1308","0","57.49","18.2"
"10","009","00","001","0137","0426","1107","349","758","68","1175","2171","0","54.12","16.08"
"10","009","00","001","0138","0000","1518","499","1019","83","1601","2576","0","62.15","19.37"
"10","009","00","001","0138","0442","702","257","445","28","730","1214","0","60.13","21.17"
"10","009","00","001","0138","0443","816","242","574","55","871","1362","0","63.95","17.77"
"10","009","00","001","0139","0000","1314","415","899","67","1381","2279","0","60.6","18.21"
"10","009","00","001","0139","0420","643","213","430","29","672","1103","0","60.92","19.31"
"10","009","00","001","0139","0421","671","202","469","38","709","1176","0","60.29","17.18"
"10","009","00","002","0000","0000","20296","6583","13713","1405","21701","38138","44608","56.9","17.26"
"10","009","00","002","0201","0000","660","202","458","42","702","1166","0","60.21","17.32"
"10","009","00","002","0201","0498","660","202","458","42","702","1166","0","60.21","17.32"
"10","009","00","002","0202","0000","1245","406","839","61","1306","2110","0","61.9","19.24"
"10","009","00","002","0202","0499","665","211","454","34","699","1135","0","61.59","18.59"
"10","009","00","002","0202","0500","580","195","385","27","607","975","0","62.26","20.0"
"10","009","00","002","0203","0000","1160","359","801","85","1245","2228","0","55.88","16.11"
"10","009","00","002","0203","0503","705","220","485","41","746","1321","0","56.47","16.65"
"10","009","00","002","0203","0504","455","139","316","44","499","907","0","55.02","15.33"
"10","009","00","002","0204","0000","867","234","633","55","922","1473","0","62.59","15.89"
"10","009","00","002","0204","0505","867","234","633","55","922","1473","0","62.59","15.89"
"10","009","00","002","0205","0000","747","241","506","55","802","1277","0","62.8","18.87"
"10","009","00","002","0205","0506","747","241","506","55","802","1277","0","62.8","18.87"
"10","009","00","002","0206","0000","1442","577","865","84","1526","2673","0","57.09","21.59"
"10","009","00","002","0206","0514","599","194","405","39","638","1042","0","61.23","18.62"
"10","009","00","002","0206","0515","843","383","460","45","888","1631","0","54.45","23.48"
"10","009","00","002","0207","0000","688","214","474","67","755","1333","0","56.64","16.05"
"10","009","00","002","0207","0507","688","214","474","67","755","1333","0","56.64","16.05"
"10","009","00","002","0208","0000","391","123","268","33","424","777","0","54.57","15.83"
"10","009","00","002","0208","0508","391","123","268","33","424","777","0","54.57","15.83"
"10","009","00","002","0209","0000","451","123","328","43","494","899","0","54.95","13.68"
"10","009","00","002","0209","0510","451","123","328","43","494","899","0","54.95","13.68"
"10","009","00","002","0210","0000","284","89","195","37","321","688","0","46.66","12.94"
"10","009","00","002","0210","0511","284","89","195","37","321","688","0","46.66","12.94"
"10","009","00","002","0211","0000","549","168","381","27","576","1147","0","50.22","14.65"
"10","009","00","002","0211","0512","549","168","381","27","576","1147","0","50.22","14.65"
"10","009","00","002","0212","0000","879","296","583","69","948","1709","0","55.47","17.32"
"10","009","00","002","0212","0513","879","296","583","69","948","1709","0","55.47","17.32"
"10","009","00","002","0213","0000","505","173","332","24","529","981","0","53.92","17.64"
"10","009","00","002","0213","0525","505","173","332","24","529","981","0","53.92","17.64"
"10","009","00","002","0214","0000","1376","463","913","100","1476","2715","0","54.36","17.05"
"10","009","00","002","0214","0526","509","176","333","29","538","1129","0","47.65","15.59"
"10","009","00","002","0214","0527","867","287","580","71","938","1586","0","59.14","18.1"
"10","009","00","002","0215","0000","1174","378","796","79","1253","2227","0","56.26","16.97"
"10","009","00","002","0215","0528","721","247","474","52","773","1243","0","62.19","19.87"
"10","009","00","002","0215","0529","453","131","322","27","480","984","0","48.78","13.31"
"10","009","00","002","0216","0000","1828","589","1239","122","1950","3266","0","59.71","18.03"
"10","009","00","002","0216","0516","964","311","653","65","1029","1702","0","60.46","18.27"
"10","009","00","002","0216","0517","864","278","586","57","921","1564","0","58.89","17.77"
"10","009","00","002","0217","0000","399","120","279","17","416","897","0","46.38","13.38"
"10","009","00","002","0217","0520","399","120","279","17","416","897","0","46.38","13.38"
"10","009","00","002","0218","0000","414","140","274","24","438","803","0","54.55","17.43"
"10","009","00","002","0218","0521","414","140","274","24","438","803","0","54.55","17.43"
"10","009","00","002","0219","0000","462","135","327","43","505","866","0","58.31","15.59"
"10","009","00","002","0219","0522","462","135","327","43","505","866","0","58.31","15.59"
"10","009","00","002","0220","0000","788","241","547","95","883","1523","0","57.98","15.82"
"10","009","00","002","0220","0523","450","146","304","53","503","852","0","59.04","17.14"
"10","009","00","002","0220","0524","338","95","243","42","380","671","0","56.63","14.16"
"10","009","00","002","0221","0000","784","251","533","68","852","1507","0","56.54","16.66"
"10","009","00","002","0221","0530","784","251","533","68","852","1507","0","56.54","16.66"
"10","009","00","002","0222","0000","454","153","301","28","482","877","0","54.96","17.45"
"10","009","00","002","0222","0509","454","153","301","28","482","877","0","54.96","17.45"
"10","009","00","002","0223","0000","1586","551","1035","81","1667","2810","0","59.32","19.61"
"10","009","00","002","0223","0501","830","291","539","39","869","1459","0","59.56","19.95"
"10","009","00","002","0223","0502","756","260","496","42","798","1351","0","59.07","19.25"
"10","009","00","002","0224","0000","1163","357","806","66","1229","2186","0","56.22","16.33"
"10","009","00","002","0224","0518","402","112","290","25","427","910","0","46.92","12.31"
"10","009","00","002","0224","0519","761","245","516","41","802","1276","0","62.85","19.2"
"10","009","00","003","0000","0000","29351","9596","19755","1753","31104","58167","70892","53.47","16.5"
"10","009","00","003","0301","0000","516","193","323","55","571","941","0","60.68","20.51"
"10","009","00","003","0301","0117","516","193","323","55","571","941","0","60.68","20.51"
"10","009","00","003","0302","0000","819","266","553","57","876","1675","0","52.3","15.88"
"10","009","00","003","0302","0111","412","136","276","26","438","785","0","55.8","17.32"
"10","009","00","003","0302","0112","407","130","277","31","438","890","0","49.21","14.61"
"10","009","00","003","0303","0000","1411","471","940","74","1485","2605","0","57.01","18.08"
"10","009","00","003","0303","0109","703","232","471","41","744","1347","0","55.23","17.22"
"10","009","00","003","0303","0110","708","239","469","33","741","1258","0","58.9","19.0"
"10","009","00","003","0304","0000","1627","524","1103","82","1709","2844","0","60.09","18.42"
"10","009","00","003","0304","0113","795","270","525","44","839","1413","0","59.38","19.11"
"10","009","00","003","0304","0114","832","254","578","38","870","1431","0","60.8","17.75"
"10","009","00","003","0305","0000","1225","377","848","85","1310","2549","0","51.39","14.79"
"10","009","00","003","0305","0115","610","190","420","51","661","1224","0","54.0","15.52"
"10","009","00","003","0305","0116","615","187","428","34","649","1325","0","48.98","14.11"
"10","009","00","003","0306","0000","1685","550","1135","52","1737","3254","0","53.38","16.9"
"10","009","00","003","0306","0118","850","270","580","24","874","1613","0","54.18","16.74"
"10","009","00","003","0306","0119","835","280","555","28","863","1641","0","52.59","17.06"
"10","009","00","003","0307","0000","862","257","605","25","887","1438","0","61.68","17.87"
"10","009","00","003","0307","0123","862","257","605","25","887","1438","0","61.68","17.87"
"10","009","00","003","0308","0000","2495","854","1641","87","2582","4295","0","60.12","19.88"
"10","009","00","003","0308","0124","760","237","523","25","785","1361","0","57.68","17.41"
"10","009","00","003","0308","0125","828","328","500","36","864","1444","0","59.83","22.71"
"10","009","00","003","0308","0126","907","289","618","26","933","1490","0","62.62","19.4"
"10","009","00","003","0309","0000","1253","508","745","65","1318","2274","0","57.96","22.34"
"10","009","00","003","0309","0127","790","345","445","37","827","1307","0","63.27","26.4"
"10","009","00","003","0309","0128","463","163","300","28","491","967","0","50.78","16.86"
"10","009","00","003","0310","0000","1988","636","1352","56","2044","3745","0","54.58","16.98"
"10","009","00","003","0310","0129","974","298","676","24","998","1865","0","53.51","15.98"
"10","009","00","003","0310","0130","1014","338","676","32","1046","1880","0","55.64","17.98"
"10","009","00","003","0311","0000","1039","324","715","54","1093","2000","0","54.65","16.2"
"10","009","00","003","0311","0131","539","166","373","35","574","1099","0","52.23","15.1"
"10","009","00","003","0311","0132","500","158","342","19","519","901","0","57.6","17.54"
"10","009","00","003","0312","0000","565","195","370","33","598","1120","0","53.39","17.41"
"10","009","00","003","0312","0133","565","195","370","33","598","1120","0","53.39","17.41"
"10","009","00","003","0313","0000","575","164","411","62","637","1272","0","50.08","12.89"
"10","009","00","003","0313","0154","575","164","411","62","637","1272","0","50.08","12.89"
"10","009","00","003","0314","0000","381","121","260","21","402","851","0","47.24","14.22"
"10","009","00","003","0314","0153","381","121","260","21","402","851","0","47.24","14.22"
"10","009","00","003","0315","0000","654","222","432","66","720","1549","0","46.48","14.33"
"10","009","00","003","0315","0152","654","222","432","66","720","1549","0","46.48","14.33"
"10","009","00","003","0316","0000","656","205","451","53","709","1509","0","46.98","13.59"
"10","009","00","003","0316","0150","656","205","451","53","709","1509","0","46.98","13.59"
"10","009","00","003","0317","0000","321","128","193","47","368","855","0","43.04","14.97"
"10","009","00","003","0317","0151","321","128","193","47","368","855","0","43.04","14.97"
"10","009","00","003","0318","0000","1305","444","861","81","1386","2668","0","51.95","16.64"
"10","009","00","003","0318","0135","699","240","459","57","756","1420","0","53.24","16.9"
"10","009","00","003","0318","0136","606","204","402","24","630","1248","0","50.48","16.35"
"10","009","00","003","0319","0000","418","118","300","21","439","799","0","54.94","14.77"
"10","009","00","003","0319","0137","418","118","300","21","439","799","0","54.94","14.77"
"10","009","00","003","0320","0000","810","278","532","84","894","1760","0","50.8","15.8"
"10","009","00","003","0320","0138","398","125","273","50","448","836","0","53.59","14.95"
"10","009","00","003","0320","0139","412","153","259","34","446","924","0","48.27","16.56"
"10","009","00","003","0321","0000","690","209","481","29","719","1648","0","43.63","12.68"
"10","009","00","003","0321","0140","690","209","481","29","719","1648","0","43.63","12.68"
"10","009","00","003","0322","0000","1421","473","948","131","1552","3162","0","49.08","14.96"
"10","009","00","003","0322","0141","688","244","444","85","773","1616","0","47.83","15.1"
"10","009","00","003","0322","0142","733","229","504","46","779","1546","0","50.39","14.81"
"10","009","00","003","0323","0000","1152","340","812","64","1216","2361","0","51.5","14.4"
"10","009","00","003","0323","0143","630","171","459","33","663","1283","0","51.68","13.33"
"10","009","00","003","0323","0144","522","169","353","31","553","1078","0","51.3","15.68"
"10","009","00","003","0324","0000","1193","371","822","78","1271","2597","0","48.94","14.29"
"10","009","00","003","0324","0145","585","183","402","45","630","1313","0","47.98","13.94"
"10","009","00","003","0324","0146","608","188","420","33","641","1284","0","49.92","14.64"
"10","009","00","003","0325","0000","655","205","450","73","728","1356","0","53.69","15.12"
"10","009","00","003","0325","0147","655","205","450","73","728","1356","0","53.69","15.12"
"10","009","00","003","0326","0000","762","231","531","53","815","1504","0","54.19","15.36"
"10","009","00","003","0326","0148","762","231","531","53","815","1504","0","54.19","15.36"
"10","009","00","003","0327","0000","252","84","168","8","260","545","0","47.71","15.41"
"10","009","00","003","0327","0134","252","84","168","8","260","545","0","47.71","15.41"
"10","009","00","003","0328","0000","2059","667","1392","130","2189","3767","0","58.11","17.71"
"10","009","00","003","0328","0120","663","224","439","44","707","1200","0","58.92","18.67"
"10","009","00","003","0328","0121","697","225","472","63","760","1294","0","58.73","17.39"
"10","009","00","003","0328","0122","699","218","481","23","722","1273","0","56.72","17.12"
"10","009","00","003","0329","0000","562","181","381","27","589","1224","0","48.12","14.79"
"10","009","00","003","0329","0149","562","181","381","27","589","1224","0","48.12","14.79"
"10","009","00","004","0000","0000","18512","6128","12384","1819","20331","38142","46135","53.3","16.07"
"10","009","00","004","0401","0000","763","274","489","61","824","1590","0","51.82","17.23"
"10","009","00","004","0401","0340","763","274","489","61","824","1590","0","51.82","17.23"
"10","009","00","004","0402","0000","901","301","600","52","953","1741","0","54.74","17.29"
"10","009","00","004","0402","0341","901","301","600","52","953","1741","0","54.74","17.29"
"10","009","00","004","0403","0000","1270","433","837","88","1358","2120","0","64.06","20.42"
"10","009","00","004","0403","0342","659","220","439","44","703","1080","0","65.09","20.37"
"10","009","00","004","0403","0343","611","213","398","44","655","1040","0","62.98","20.48"
"10","009","00","004","0404","0000","1579","470","1109","72","1651","2971","0","55.57","15.82"
"10","009","00","004","0404","0344","725","214","511","36","761","1346","0","56.54","15.9"
"10","009","00","004","0404","0345","854","256","598","36","890","1625","0","54.77","15.75"
"10","009","00","004","0405","0000","219","67","152","9","228","354","0","64.41","18.93"
"10","009","00","004","0405","0346","219","67","152","9","228","354","0","64.41","18.93"
"10","009","00","004","0406","0000","296","101","195","25","321","580","0","55.34","17.41"
"10","009","00","004","0406","0347","296","101","195","25","321","580","0","55.34","17.41"
"10","009","00","004","0407","0000","356","120","236","19","375","591","0","63.45","20.3"
"10","009","00","004","0407","0348","356","120","236","19","375","591","0","63.45","20.3"
"10","009","00","004","0408","0000","570","204","366","51","621","1050","0","59.14","19.43"
"10","009","00","004","0408","0349","570","204","366","51","621","1050","0","59.14","19.43"
"10","009","00","004","0409","0000","1442","479","963","128","1570","2749","0","57.11","17.42"
"10","009","00","004","0409","0350","649","214","435","60","709","1147","0","61.81","18.66"
"10","009","00","004","0409","0351","793","265","528","68","861","1602","0","53.75","16.54"
"10","009","00","004","0410","0000","2182","688","1494","137","2319","4335","0","53.49","15.87"
"10","009","00","004","0410","0352","735","238","497","41","776","1452","0","53.44","16.39"
"10","009","00","004","0410","0353","808","255","553","68","876","1578","0","55.51","16.16"
"10","009","00","004","0410","0354","639","195","444","28","667","1305","0","51.11","14.94"
"10","009","00","004","0411","0000","553","182","371","51","604","1327","0","45.52","13.72"
"10","009","00","004","0411","0355","553","182","371","51","604","1327","0","45.52","13.72"
"10","009","00","004","0412","0000","741","248","493","56","797","1516","0","52.57","16.36"
"10","009","00","004","0412","0356","741","248","493","56","797","1516","0","52.57","16.36"
"10","009","00","004","0413","0000","473","176","297","67","540","983","0","54.93","17.9"
"10","009","00","004","0413","0369","473","176","297","67","540","983","0","54.93","17.9"
"10","009","00","004","0414","0000","491","165","326","55","546","1014","0","53.85","16.27"
"10","009","00","004","0414","0370","491","165","326","55","546","1014","0","53.85","16.27"
"10","009","00","004","0415","0000","797","264","533","121","918","1805","0","50.86","14.63"
"10","009","00","004","0415","0371","399","143","256","77","476","939","0","50.69","15.23"
"10","009","00","004","0415","0372","398","121","277","44","442","866","0","51.04","13.97"
"10","009","00","004","0416","0000","637","197","440","85","722","1486","0","48.59","13.26"
"10","009","00","004","0416","0373","637","197","440","85","722","1486","0","48.59","13.26"
"10","009","00","004","0417","0000","631","223","408","43","674","1616","0","41.71","13.8"
"10","009","00","004","0417","0357","327","122","205","26","353","828","0","42.63","14.73"
"10","009","00","004","0417","0358","304","101","203","17","321","788","0","40.74","12.82"
"10","009","00","004","0418","0000","389","131","258","58","447","863","0","51.8","15.18"
"10","009","00","004","0418","0359","389","131","258","58","447","863","0","51.8","15.18"
"10","009","00","004","0419","0000","437","156","281","87","524","984","0","53.25","15.85"
"10","009","00","004","0419","0360","437","156","281","87","524","984","0","53.25","15.85"
"10","009","00","004","0420","0000","418","130","288","53","471","870","0","54.14","14.94"
"10","009","00","004","0420","0362","418","130","288","53","471","870","0","54.14","14.94"
"10","009","00","004","0421","0000","678","212","466","223","901","1514","0","59.51","14.0"
"10","009","00","004","0421","0361","678","212","466","223","901","1514","0","59.51","14.0"
"10","009","00","004","0422","0000","464","172","292","53","517","971","0","53.24","17.71"
"10","009","00","004","0422","0363","464","172","292","53","517","971","0","53.24","17.71"
"10","009","00","004","0423","0000","406","104","302","39","445","823","0","54.07","12.64"
"10","009","00","004","0423","0366","406","104","302","39","445","823","0","54.07","12.64"
"10","009","00","004","0424","0000","325","125","200","28","353","726","0","48.62","17.22"
"10","009","00","004","0424","0365","325","125","200","28","353","726","0","48.62","17.22"
"10","009","00","004","0425","0000","551","191","360","51","602","1304","0","46.17","14.65"
"10","009","00","004","0425","0364","551","191","360","51","602","1304","0","46.17","14.65"
"10","009","00","004","0426","0000","343","97","246","21","364","886","0","41.08","10.95"
"10","009","00","004","0426","0367","343","97","246","21","364","886","0","41.08","10.95"
"10","009","00","004","0427","0000","600","218","382","86","686","1373","0","49.96","15.88"
"10","009","00","004","0427","0368","600","218","382","86","686","1373","0","49.96","15.88"
"10","009","00","005","0000","0000","11715","3824","7891","1166","12881","24412","28827","52.77","15.66"
"10","009","00","005","0501","0000","465","143","322","50","515","809","0","63.66","17.68"
"10","009","00","005","0501","0080","465","143","322","50","515","809","0","63.66","17.68"
"10","009","00","005","0502","0000","539","161","378","41","580","896","0","64.73","17.97"
"10","009","00","005","0502","0081","539","161","378","41","580","896","0","64.73","17.97"
"10","009","00","005","0503","0000","819","274","545","58","877","1389","0","63.14","19.73"
"10","009","00","005","0503","0082","374","124","250","31","405","687","0","58.95","18.05"
"10","009","00","005","0503","0083","445","150","295","27","472","702","0","67.24","21.37"
"10","009","00","005","0504","0000","610","181","429","25","635","1032","0","61.53","17.54"
"10","009","00","005","0504","0084","610","181","429","25","635","1032","0","61.53","17.54"
"10","009","00","005","0505","0000","520","173","347","75","595","1124","0","52.94","15.39"
"10","009","00","005","0505","0085","326","116","210","44","370","697","0","53.08","16.64"
"10","009","00","005","0505","0086","194","57","137","31","225","427","0","52.69","13.35"
"10","009","00","005","0506","0000","692","268","424","40","732","1430","0","51.19","18.74"
"10","009","00","005","0506","0089","281","109","172","16","297","634","0","46.85","17.19"
"10","009","00","005","0506","0090","411","159","252","24","435","796","0","54.65","19.97"
"10","009","00","005","0507","0000","550","177","373","69","619","1321","0","46.86","13.4"
"10","009","00","005","0507","0091","289","100","189","42","331","745","0","44.43","13.42"
"10","009","00","005","0507","0092","261","77","184","27","288","576","0","50.0","13.37"
"10","009","00","005","0508","0000","523","168","355","67","590","1277","0","46.2","13.16"
"10","009","00","005","0508","0093","296","79","217","58","354","743","0","47.64","10.63"
"10","009","00","005","0508","0094","227","89","138","9","236","534","0","44.19","16.67"
"10","009","00","005","0509","0000","416","116","300","48","464","843","0","55.04","13.76"
"10","009","00","005","0509","0099","416","116","300","48","464","843","0","55.04","13.76"
"10","009","00","005","0510","0000","1506","453","1053","68","1574","2734","0","57.57","16.57"
"10","009","00","005","0510","0087","792","244","548","49","841","1451","0","57.96","16.82"
"10","009","00","005","0510","0088","714","209","505","19","733","1283","0","57.13","16.29"
"10","009","00","005","0511","0000","862","256","606","105","967","1864","0","51.88","13.73"
"10","009","00","005","0511","0100","426","121","305","63","489","916","0","53.38","13.21"
"10","009","00","005","0511","0101","436","135","301","42","478","948","0","50.42","14.24"
"10","009","00","005","0512","0000","867","269","598","95","962","1774","0","54.23","15.16"
"10","009","00","005","0512","0102","457","141","316","31","488","914","0","53.39","15.43"
"10","009","00","005","0512","0103","410","128","282","64","474","860","0","55.12","14.88"
"10","009","00","005","0513","0000","346","115","231","38","384","896","0","42.86","12.83"
"10","009","00","005","0513","0106","346","115","231","38","384","896","0","42.86","12.83"
"10","009","00","005","0514","0000","797","268","529","100","897","1804","0","49.72","14.86"
"10","009","00","005","0514","0104","425","145","280","47","472","929","0","50.81","15.61"
"10","009","00","005","0514","0105","372","123","249","53","425","875","0","48.57","14.06"
"10","009","00","005","0515","0000","942","407","535","146","1088","2276","0","47.8","17.88"
"10","009","00","005","0515","0095","473","247","226","75","548","1199","0","45.7","20.6"
"10","009","00","005","0515","0096","469","160","309","71","540","1077","0","50.14","14.86"
"10","009","00","005","0516","0000","661","210","451","63","724","1503","0","48.17","13.97"
"10","009","00","005","0516","0097","330","103","227","25","355","819","0","43.35","12.58"
"10","009","00","005","0516","0098","331","107","224","38","369","684","0","53.95","15.64"
"10","009","00","005","0517","0000","600","185","415","78","678","1440","0","47.08","12.85"
"10","009","00","005","0517","0107","295","89","206","50","345","757","0","45.57","11.76"
"10","009","00","005","0517","0108","305","96","209","28","333","683","0","48.76","14.06"
"10","009","00","006","0000","0000","16890","5486","11404","1664","18554","33958","39975","54.64","16.16"
"10","009","00","006","0601","0000","372","106","266","56","428","724","0","59.12","14.64"
"10","009","00","006","0601","0256","372","106","266","56","428","724","0","59.12","14.64"
"10","009","00","006","0602","0000","381","149","232","48","429","688","0","62.35","21.66"
"10","009","00","006","0602","0257","381","149","232","48","429","688","0","62.35","21.66"
"10","009","00","006","0603","0000","227","61","166","38","265","452","0","58.63","13.5"
"10","009","00","006","0603","0258","227","61","166","38","265","452","0","58.63","13.5"
"10","009","00","006","0604","0000","451","146","305","57","508","866","0","58.66","16.86"
"10","009","00","006","0604","0259","451","146","305","57","508","866","0","58.66","16.86"
"10","009","00","006","0605","0000","161","58","103","17","178","336","0","52.98","17.26"
"10","009","00","006","0605","0260","161","58","103","17","178","336","0","52.98","17.26"
"10","009","00","006","0606","0000","195","44","151","21","216","395","0","54.68","11.14"
"10","009","00","006","0606","0261","195","44","151","21","216","395","0","54.68","11.14"
"10","009","00","006","0607","0000","212","54","158","26","238","376","0","63.3","14.36"
"10","009","00","006","0607","0262","212","54","158","26","238","376","0","63.3","14.36"
"10","009","00","006","0608","0000","508","168","340","38","546","950","0","57.47","17.68"
"10","009","00","006","0608","0263","508","168","340","38","546","950","0","57.47","17.68"
"10","009","00","006","0609","0000","286","101","185","40","326","512","0","63.67","19.73"
"10","009","00","006","0609","0264","286","101","185","40","326","512","0","63.67","19.73"
"10","009","00","006","0610","0000","169","55","114","29","198","324","0","61.11","16.98"
"10","009","00","006","0610","0265","169","55","114","29","198","324","0","61.11","16.98"
"10","009","00","006","0611","0000","262","84","178","39","301","546","0","55.13","15.38"
"10","009","00","006","0611","0266","262","84","178","39","301","546","0","55.13","15.38"
"10","009","00","006","0612","0000","623","185","438","73","696","1184","0","58.78","15.63"
"10","009","00","006","0612","0267","244","79","165","20","264","433","0","60.97","18.24"
"10","009","00","006","0612","0268","379","106","273","53","432","751","0","57.52","14.11"
"10","009","00","006","0613","0000","249","58","191","24","273","442","0","61.76","13.12"
"10","009","00","006","0613","0269","249","58","191","24","273","442","0","61.76","13.12"
"10","009","00","006","0614","0000","2587","836","1751","228","2815","4912","0","57.31","17.02"
"10","009","00","006","0614","0270","605","195","410","63","668","1151","0","58.04","16.94"
"10","009","00","006","0614","0271","671","208","463","46","717","1224","0","58.58","16.99"
"10","009","00","006","0614","0272","626","200","426","45","671","1211","0","55.41","16.52"
"10","009","00","006","0614","0273","685","233","452","74","759","1326","0","57.24","17.57"
"10","009","00","006","0615","0000","1031","314","717","73","1104","1721","0","64.15","18.25"
"10","009","00","006","0615","0274","446","135","311","35","481","744","0","64.65","18.15"
"10","009","00","006","0615","0275","585","179","406","38","623","977","0","63.77","18.32"
"10","009","00","006","0616","0000","3314","1110","2204","247","3561","6230","0","57.16","17.82"
"10","009","00","006","0616","0278","742","244","498","47","789","1364","0","57.84","17.89"
"10","009","00","006","0616","0279","593","199","394","62","655","1123","0","58.33","17.72"
"10","009","00","006","0616","0280","789","268","521","40","829","1451","0","57.13","18.47"
"10","009","00","006","0616","0281","648","228","420","51","699","1162","0","60.15","19.62"
"10","009","00","006","0616","0282","542","171","371","47","589","1130","0","52.12","15.13"
"10","009","00","006","0617","0000","564","165","399","31","595","1149","0","51.78","14.36"
"10","009","00","006","0617","0283","564","165","399","31","595","1149","0","51.78","14.36"
"10","009","00","006","0618","0000","333","91","242","20","353","809","0","43.63","11.25"
"10","009","00","006","0618","0287","333","91","242","20","353","809","0","43.63","11.25"
"10","009","00","006","0619","0000","582","182","400","86","668","1397","0","47.82","13.03"
"10","009","00","006","0619","0288","582","182","400","86","668","1397","0","47.82","13.03"
"10","009","00","006","0620","0000","455","129","326","74","529","1145","0","46.2","11.27"
"10","009","00","006","0620","0289","455","129","326","74","529","1145","0","46.2","11.27"
"10","009","00","006","0621","0000","493","258","235","39","532","966","0","55.07","26.71"
"10","009","00","006","0621","0284","213","56","157","27","240","533","0","45.03","10.51"
"10","009","00","006","0621","0285","280","202","78","12","292","433","0","67.44","46.65"
"10","009","00","006","0622","0000","256","82","174","58","314","828","0","37.92","9.9"
"10","009","00","006","0622","0290","256","82","174","58","314","828","0","37.92","9.9"
"10","009","00","006","0623","0000","214","61","153","11","225","557","0","40.39","10.95"
"10","009","00","006","0623","0291","214","61","153","11","225","557","0","40.39","10.95"
"10","009","00","006","0624","0000","708","239","469","80","788","1637","0","48.14","14.6"
"10","009","00","006","0624","0292","466","163","303","43","509","1060","0","48.02","15.38"
"10","009","00","006","0624","0293","242","76","166","37","279","577","0","48.35","13.17"
"10","009","00","006","0625","0000","1419","481","938","132","1551","2981","0","52.03","16.14"
"10","009","00","006","0625","0294","341","144","197","70","411","931","0","44.15","15.47"
"10","009","00","006","0625","0295","517","153","364","32","549","1018","0","53.93","15.03"
"10","009","00","006","0625","0296","561","184","377","30","591","1032","0","57.27","17.83"
"10","009","00","006","0626","0000","482","174","308","57","539","960","0","56.15","18.13"
"10","009","00","006","0626","0276","482","174","308","57","539","960","0","56.15","18.13"
"10","009","00","006","0627","0000","183","56","127","10","193","494","0","39.07","11.34"
"10","009","00","006","0627","0277","183","56","127","10","193","494","0","39.07","11.34"
"10","009","00","006","0628","0000","173","39","134","12","185","377","0","49.07","10.34"
"10","009","00","006","0628","0286","173","39","134","12","185","377","0","49.07","10.34"
"10","009","00","007","0000","0000","13424","4164","9260","1136","14560","27477","31464","52.99","15.15"
"10","009","00","007","0701","0000","594","198","396","58","652","1255","0","51.95","15.78"
"10","009","00","007","0701","0539","594","198","396","58","652","1255","0","51.95","15.78"
"10","009","00","007","0702","0000","617","211","406","36","653","1078","0","60.58","19.57"
"10","009","00","007","0702","0540","617","211","406","36","653","1078","0","60.58","19.57"
"10","009","00","007","0703","0000","611","165","446","73","684","1169","0","58.51","14.11"
"10","009","00","007","0703","0538","611","165","446","73","684","1169","0","58.51","14.11"
"10","009","00","007","0704","0000","678","179","499","78","756","1426","0","53.02","12.55"
"10","009","00","007","0704","0536","571","155","416","75","646","1122","0","57.58","13.81"
"10","009","00","007","0704","0537","107","24","83","3","110","304","0","36.18","7.89"
"10","009","00","007","0705","0000","1515","450","1065","95","1610","3074","0","52.37","14.64"
"10","009","00","007","0705","0534","674","187","487","41","715","1302","0","54.92","14.36"
"10","009","00","007","0705","0535","841","263","578","54","895","1772","0","50.51","14.84"
"10","009","00","007","0706","0000","738","277","461","67","805","1517","0","53.07","18.26"
"10","009","00","007","0706","0533","738","277","461","67","805","1517","0","53.07","18.26"
"10","009","00","007","0707","0000","1044","337","707","107","1151","2120","0","54.29","15.9"
"10","009","00","007","0707","0531","570","176","394","55","625","1126","0","55.51","15.63"
"10","009","00","007","0707","0532","474","161","313","52","526","994","0","52.92","16.2"
"10","009","00","007","0708","0000","278","78","200","16","294","734","0","40.05","10.63"
"10","009","00","007","0708","0554","278","78","200","16","294","734","0","40.05","10.63"
"10","009","00","007","0709","0000","109","30","79","11","120","285","0","42.11","10.53"
"10","009","00","007","0709","0553","109","30","79","11","120","285","0","42.11","10.53"
"10","009","00","007","0710","0000","1077","338","739","81","1158","2138","0","54.16","15.81"
"10","009","00","007","0710","0547","467","152","315","39","506","998","0","50.7","15.23"
"10","009","00","007","0710","0548","610","186","424","42","652","1140","0","57.19","16.32"
"10","009","00","007","0711","0000","566","182","384","70","636","1150","0","55.3","15.83"
"10","009","00","007","0711","0555","566","182","384","70","636","1150","0","55.3","15.83"
"10","009","00","007","0712","0000","586","180","406","33","619","1233","0","50.2","14.6"
"10","009","00","007","0712","0552","586","180","406","33","619","1233","0","50.2","14.6"
"10","009","00","007","0713","0000","226","58","168","18","244","453","0","53.86","12.8"
"10","009","00","007","0713","0556","226","58","168","18","244","453","0","53.86","12.8"
"10","009","00","007","0714","0000","255","53","202","23","278","571","0","48.69","9.28"
"10","009","00","007","0714","0557","255","53","202","23","278","571","0","48.69","9.28"
"10","009","00","007","0715","0000","1025","327","698","70","1095","2058","0","53.21","15.89"
"10","009","00","007","0715","0549","549","186","363","43","592","1102","0","53.72","16.88"
"10","009","00","007","0715","0550","476","141","335","27","503","956","0","52.62","14.75"
"10","009","00","007","0716","0000","345","114","231","32","377","695","0","54.24","16.4"
"10","009","00","007","0716","0551","345","114","231","32","377","695","0","54.24","16.4"
"10","009","00","007","0717","0000","1042","340","702","89","1131","2243","0","50.42","15.16"
"10","009","00","007","0717","0541","436","134","302","26","462","943","0","48.99","14.21"
"10","009","00","007","0717","0542","606","206","400","63","669","1300","0","51.46","15.85"
"10","009","00","007","0718","0000","1032","295","737","86","1118","2108","0","53.04","13.99"
"10","009","00","007","0718","0543","457","121","336","41","498","964","0","51.66","12.55"
"10","009","00","007","0718","0544","575","174","401","45","620","1144","0","54.2","15.21"
"10","009","00","007","0719","0000","734","239","495","58","792","1482","0","53.44","16.13"
"10","009","00","007","0719","0545","734","239","495","58","792","1482","0","53.44","16.13"
"10","009","00","007","0720","0000","352","113","239","35","387","688","0","56.25","16.42"
"10","009","00","007","0720","0546","352","113","239","35","387","688","0","56.25","16.42"
"10","009","00","008","0000","0000","7848","2538","5310","671","8519","16509","19083","51.6","15.37"
"10","009","00","008","0801","0000","362","125","237","38","400","750","0","53.33","16.67"
"10","009","00","008","0801","0480","362","125","237","38","400","750","0","53.33","16.67"
"10","009","00","008","0802","0000","1070","378","692","71","1141","2095","0","54.46","18.04"
"10","009","00","008","0802","0484","738","270","468","45","783","1495","0","52.37","18.06"
"10","009","00","008","0802","0485","332","108","224","26","358","600","0","59.67","18.0"
"10","009","00","008","0803","0000","542","177","365","51","593","1004","0","59.06","17.63"
"10","009","00","008","0803","0486","542","177","365","51","593","1004","0","59.06","17.63"
"10","009","00","008","0804","0000","366","134","232","23","389","948","0","41.03","14.14"
"10","009","00","008","0804","0487","366","134","232","23","389","948","0","41.03","14.14"
"10","009","00","008","0805","0000","848","250","598","79","927","1895","0","48.92","13.19"
"10","009","00","008","0805","0489","632","196","436","56","688","1430","0","48.11","13.71"
"10","009","00","008","0805","0490","216","54","162","23","239","465","0","51.4","11.61"
"10","009","00","008","0806","0000","829","257","572","66","895","1781","0","50.25","14.43"
"10","009","00","008","0806","0491","600","168","432","46","646","1307","0","49.43","12.85"
"10","009","00","008","0806","0492","229","89","140","20","249","474","0","52.53","18.78"
"10","009","00","008","0807","0000","784","226","558","47","831","1539","0","54.0","14.68"
"10","009","00","008","0807","0488","784","226","558","47","831","1539","0","54.0","14.68"
"10","009","00","008","0808","0000","651","233","418","79","730","1220","0","59.84","19.1"
"10","009","00","008","0808","0493","651","233","418","79","730","1220","0","59.84","19.1"
"10","009","00","008","0809","0000","343","123","220","26","369","719","0","51.32","17.11"
"10","009","00","008","0809","0481","343","123","220","26","369","719","0","51.32","17.11"
"10","009","00","008","0810","0000","293","70","223","25","318","603","0","52.74","11.61"
"10","009","00","008","0810","0482","293","70","223","25","318","603","0","52.74","11.61"
"10","009","00","008","0811","0000","481","161","320","47","528","1106","0","47.74","14.56"
"10","009","00","008","0811","0483","481","161","320","47","528","1106","0","47.74","14.56"
"10","009","00","008","0812","0000","350","102","248","21","371","733","0","50.61","13.92"
"10","009","00","008","0812","0494","350","102","248","21","371","733","0","50.61","13.92"
"10","009","00","008","0813","0000","352","99","253","25","377","681","0","55.36","14.54"
"10","009","00","008","0813","0495","352","99","253","25","377","681","0","55.36","14.54"
"10","009","00","008","0814","0000","278","99","179","22","300","712","0","42.13","13.9"
"10","009","00","008","0814","0496","278","99","179","22","300","712","0","42.13","13.9"
"10","009","00","008","0815","0000","299","104","195","51","350","723","0","48.41","14.38"
"10","009","00","008","0815","0497","299","104","195","51","350","723","0","48.41","14.38"
"10","009","00","009","0000","0000","12279","4027","8252","1291","13570","24570","28727","55.23","16.39"
"10","009","00","009","0901","0000","2119","668","1451","200","2319","4079","0","56.85","16.38"
"10","009","00","009","0901","0374","782","243","539","67","849","1507","0","56.34","16.12"
"10","009","00","009","0901","0375","675","216","459","35","710","1300","0","54.62","16.62"
"10","009","00","009","0901","0376","662","209","453","98","760","1272","0","59.75","16.43"
"10","009","00","009","0902","0000","403","161","242","58","461","861","0","53.54","18.7"
"10","009","00","009","0902","0377","403","161","242","58","461","861","0","53.54","18.7"
"10","009","00","009","0903","0000","686","256","430","64","750","1565","0","47.92","16.36"
"10","009","00","009","0903","0378","686","256","430","64","750","1565","0","47.92","16.36"
"10","009","00","009","0904","0000","543","189","354","53","596","1213","0","49.13","15.58"
"10","009","00","009","0904","0379","278","94","184","19","297","577","0","51.47","16.29"
"10","009","00","009","0904","0380","265","95","170","34","299","636","0","47.01","14.94"
"10","009","00","009","0905","0000","508","199","309","73","581","1110","0","52.34","17.93"
"10","009","00","009","0905","0381","508","199","309","73","581","1110","0","52.34","17.93"
"10","009","00","009","0906","0000","1020","379","641","115","1135","1958","0","57.97","19.36"
"10","009","00","009","0906","0382","529","184","345","56","585","973","0","60.12","18.91"
"10","009","00","009","0906","0383","491","195","296","59","550","985","0","55.84","19.8"
"10","009","00","009","0907","0000","1565","482","1083","169","1734","2991","0","57.97","16.12"
"10","009","00","009","0907","0384","921","283","638","94","1015","1707","0","59.46","16.58"
"10","009","00","009","0907","0385","644","199","445","75","719","1284","0","56.0","15.5"
"10","009","00","009","0908","0000","678","217","461","58","736","1293","0","56.92","16.78"
"10","009","00","009","0908","0386","678","217","461","58","736","1293","0","56.92","16.78"
"10","009","00","009","0909","0000","563","183","380","31","594","1165","0","50.99","15.71"
"10","009","00","009","0909","0389","563","183","380","31","594","1165","0","50.99","15.71"
"10","009","00","009","0910","0000","1002","304","698","129","1131","1940","0","58.3","15.67"
"10","009","00","009","0910","0387","466","133","333","44","510","900","0","56.67","14.78"
"10","009","00","009","0910","0388","536","171","365","85","621","1040","0","59.71","16.44"
"10","009","00","009","0911","0000","933","304","629","106","1039","1756","0","59.17","17.31"
"10","009","00","009","0911","0390","438","158","280","58","496","871","0","56.95","18.14"
"10","009","00","009","0911","0391","495","146","349","48","543","885","0","61.36","16.5"
"10","009","00","009","0912","0000","691","204","487","69","760","1489","0","51.04","13.7"
"10","009","00","009","0912","0392","691","204","487","69","760","1489","0","51.04","13.7"
"10","009","00","009","0913","0000","614","183","431","64","678","1347","0","50.33","13.59"
"10","009","00","009","0913","0393","614","183","431","64","678","1347","0","50.33","13.59"
"10","009","00","009","0914","0000","954","298","656","102","1056","1803","0","58.57","16.53"
"10","009","00","009","0914","0394","602","191","411","64","666","1150","0","57.91","16.61"
"10","009","00","009","0914","0395","352","107","245","38","390","653","0","59.72","16.39"
"10","009","00","010","0000","0000","7925","2539","5386","877","8802","15551","18089","56.6","16.33"
"10","009","00","010","1001","0000","605","174","431","52","657","1036","0","63.42","16.8"
"10","009","00","010","1001","0396","605","174","431","52","657","1036","0","63.42","16.8"
"10","009","00","010","1002","0000","1819","532","1287","178","1997","3652","0","54.68","14.57"
"10","009","00","010","1002","0397","774","249","525","64","838","1490","0","56.24","16.71"
"10","009","00","010","1002","0398","733","210","523","69","802","1491","0","53.79","14.08"
"10","009","00","010","1002","0399","312","73","239","45","357","671","0","53.2","10.88"
"10","009","00","010","1003","0000","1152","369","783","157","1309","2187","0","59.85","16.87"
"10","009","00","010","1003","0400","759","236","523","106","865","1436","0","60.24","16.43"
"10","009","00","010","1003","0401","393","133","260","51","444","751","0","59.12","17.71"
"10","009","00","010","1004","0000","274","96","178","22","296","535","0","55.33","17.94"
"10","009","00","010","1004","0402","274","96","178","22","296","535","0","55.33","17.94"
"10","009","00","010","1005","0000","334","150","184","51","385","811","0","47.47","18.5"
"10","009","00","010","1005","0403","334","150","184","51","385","811","0","47.47","18.5"
"10","009","00","010","1006","0000","1306","416","890","167","1473","2625","0","56.11","15.85"
"10","009","00","010","1006","0404","684","240","444","86","770","1339","0","57.51","17.92"
"10","009","00","010","1006","0405","622","176","446","81","703","1286","0","54.67","13.69"
"10","009","00","010","1007","0000","327","115","212","32","359","646","0","55.57","17.8"
"10","009","00","010","1007","0406","327","115","212","32","359","646","0","55.57","17.8"
"10","009","00","010","1008","0000","590","168","422","55","645","1158","0","55.7","14.51"
"10","009","00","010","1008","0407","590","168","422","55","645","1158","0","55.7","14.51"
"10","009","00","010","1009","0000","564","195","369","56","620","1090","0","56.88","17.89"
"10","009","00","010","1009","0408","564","195","369","56","620","1090","0","56.88","17.89"
"10","009","00","010","1010","0000","954","324","630","107","1061","1811","0","58.59","17.89"
"10","009","00","010","1010","0409","514","167","347","69","583","950","0","61.37","17.58"
"10","009","00","010","1010","0410","440","157","283","38","478","861","0","55.52","18.23"
"10","009","00","011","0000","0000","10013","3275","6738","1146","11159","23367","26906","47.76","14.02"
"10","009","00","011","1101","0000","688","213","475","36","724","1463","0","49.49","14.56"
"10","009","00","011","1101","0317","688","213","475","36","724","1463","0","49.49","14.56"
"10","009","00","011","1102","0000","725","250","475","68","793","1738","0","45.63","14.38"
"10","009","00","011","1102","0318","725","250","475","68","793","1738","0","45.63","14.38"
"10","009","00","011","1103","0000","690","231","459","111","801","1643","0","48.75","14.06"
"10","009","00","011","1103","0319","252","81","171","44","296","625","0","47.36","12.96"
"10","009","00","011","1103","0320","438","150","288","67","505","1018","0","49.61","14.73"
"10","009","00","011","1104","0000","523","165","358","55","578","1496","0","38.64","11.03"
"10","009","00","011","1104","0321","164","47","117","6","170","448","0","37.95","10.49"
"10","009","00","011","1104","0322","359","118","241","49","408","1048","0","38.93","11.26"
"10","009","00","011","1105","0000","571","194","377","63","634","1161","0","54.61","16.71"
"10","009","00","011","1105","0323","571","194","377","63","634","1161","0","54.61","16.71"
"10","009","00","011","1106","0000","920","292","628","97","1017","1840","0","55.27","15.87"
"10","009","00","011","1106","0324","472","157","315","43","515","991","0","51.97","15.84"
"10","009","00","011","1106","0325","448","135","313","54","502","849","0","59.13","15.9"
"10","009","00","011","1107","0000","403","128","275","47","450","890","0","50.56","14.38"
"10","009","00","011","1107","0326","403","128","275","47","450","890","0","50.56","14.38"
"10","009","00","011","1108","0000","414","120","294","21","435","891","0","48.82","13.47"
"10","009","00","011","1108","0328","414","120","294","21","435","891","0","48.82","13.47"
"10","009","00","011","1109","0000","311","85","226","22","333","757","0","43.99","11.23"
"10","009","00","011","1109","0329","311","85","226","22","333","757","0","43.99","11.23"
"10","009","00","011","1110","0000","618","216","402","115","733","1497","0","48.96","14.43"
"10","009","00","011","1110","0330","618","216","402","115","733","1497","0","48.96","14.43"
"10","009","00","011","1111","0000","845","290","555","115","960","1857","0","51.7","15.62"
"10","009","00","011","1111","0331","495","180","315","61","556","1171","0","47.48","15.37"
"10","009","00","011","1111","0332","350","110","240","54","404","686","0","58.89","16.03"
"10","009","00","011","1112","0000","316","116","200","71","387","864","0","44.79","13.43"
"10","009","00","011","1112","0333","316","116","200","71","387","864","0","44.79","13.43"
"10","009","00","011","1113","0000","801","270","531","54","855","1769","0","48.33","15.26"
"10","009","00","011","1113","0334","540","171","369","25","565","1073","0","52.66","15.94"
"10","009","00","011","1113","0335","261","99","162","29","290","696","0","41.67","14.22"
"10","009","00","011","1114","0000","414","127","287","61","475","1271","0","37.37","9.99"
"10","009","00","011","1114","0336","414","127","287","61","475","1271","0","37.37","9.99"
"10","009","00","011","1115","0000","363","121","242","44","407","912","0","44.63","13.27"
"10","009","00","011","1115","0337","363","121","242","44","407","912","0","44.63","13.27"
"10","009","00","011","1116","0000","351","115","236","35","386","861","0","44.83","13.36"
"10","009","00","011","1116","0338","351","115","236","35","386","861","0","44.83","13.36"
"10","009","00","011","1117","0000","403","118","285","55","458","1030","0","44.47","11.46"
"10","009","00","011","1117","0339","403","118","285","55","458","1030","0","44.47","11.46"
"10","009","00","011","1118","0000","657","224","433","76","733","1427","0","51.37","15.7"
"10","009","00","011","1118","0327","657","224","433","76","733","1427","0","51.37","15.7"
"10","009","00","012","0000","0000","9218","2880","6338","927","10145","21050","24427","48.19","13.68"
"10","009","00","012","1201","0000","599","190","409","57","656","1176","0","55.78","16.16"
"10","009","00","012","1201","0297","599","190","409","57","656","1176","0","55.78","16.16"
"10","009","00","012","1202","0000","678","222","456","46","724","1439","0","50.31","15.43"
"10","009","00","012","1202","0298","678","222","456","46","724","1439","0","50.31","15.43"
"10","009","00","012","1203","0000","1224","364","860","90","1314","2286","0","57.48","15.92"
"10","009","00","012","1203","0299","567","163","404","46","613","1027","0","59.69","15.87"
"10","009","00","012","1203","0300","657","201","456","44","701","1259","0","55.68","15.97"
"10","009","00","012","1204","0000","922","273","649","49","971","2056","0","47.23","13.28"
"10","009","00","012","1204","0301","498","146","352","15","513","1058","0","48.49","13.8"
"10","009","00","012","1204","0302","424","127","297","34","458","998","0","45.89","12.73"
"10","009","00","012","1205","0000","935","328","607","80","1015","2023","0","50.17","16.21"
"10","009","00","012","1205","0303","432","157","275","30","462","968","0","47.73","16.22"
"10","009","00","012","1205","0304","503","171","332","50","553","1055","0","52.42","16.21"
"10","009","00","012","1206","0000","551","186","365","77","628","1315","0","47.76","14.14"
"10","009","00","012","1206","0305","551","186","365","77","628","1315","0","47.76","14.14"
"10","009","00","012","1207","0000","805","236","569","120","925","2024","0","45.7","11.66"
"10","009","00","012","1207","0306","300","90","210","34","334","1027","0","32.52","8.76"
"10","009","00","012","1207","0307","505","146","359","86","591","997","0","59.28","14.64"
"10","009","00","012","1208","0000","387","101","286","37","424","807","0","52.54","12.52"
"10","009","00","012","1208","0308","387","101","286","37","424","807","0","52.54","12.52"
"10","009","00","012","1209","0000","593","192","401","72","665","1502","0","44.27","12.78"
"10","009","00","012","1209","0309","257","85","172","30","287","698","0","41.12","12.18"
"10","009","00","012","1209","0310","336","107","229","42","378","804","0","47.01","13.31"
"10","009","00","012","1210","0000","725","218","507","63","788","1753","0","44.95","12.44"
"10","009","00","012","1210","0311","389","118","271","32","421","867","0","48.56","13.61"
"10","009","00","012","1210","0312","336","100","236","31","367","886","0","41.42","11.29"
"10","009","00","012","1211","0000","521","159","362","93","614","1476","0","41.6","10.77"
"10","009","00","012","1211","0313","521","159","362","93","614","1476","0","41.6","10.77"
"10","009","00","012","1212","0000","370","103","267","29","399","1159","0","34.43","8.89"
"10","009","00","012","1212","0314","370","103","267","29","399","1159","0","34.43","8.89"
"10","009","00","012","1213","0000","627","165","462","73","700","1220","0","57.38","13.52"
"10","009","00","012","1213","0315","627","165","462","73","700","1220","0","57.38","13.52"
"10","009","00","012","1214","0000","281","143","138","41","322","814","0","39.56","17.57"
"10","009","00","012","1214","0316","281","143","138","41","322","814","0","39.56","17.57"
"10","009","00","013","0000","0000","16658","4927","11731","1443","18101","37119","46004","48.76","13.27"
"10","009","00","013","1301","0000","1765","509","1256","161","1926","4029","0","47.8","12.63"
"10","009","00","013","1301","0005","556","180","376","55","611","1340","0","45.6","13.43"
"10","009","00","013","1301","0006","496","139","357","56","552","1138","0","48.51","12.21"
"10","009","00","013","1301","0007","713","190","523","50","763","1551","0","49.19","12.25"
"10","009","00","013","1302","0000","3157","926","2231","201","3358","6988","0","48.05","13.25"
"10","009","00","013","1302","0001","604","165","439","50","654","1497","0","43.69","11.02"
"10","009","00","013","1302","0002","826","243","583","47","873","1738","0","50.23","13.98"
"10","009","00","013","1302","0003","907","274","633","50","957","1921","0","49.82","14.26"
"10","009","00","013","1302","0004","820","244","576","54","874","1832","0","47.71","13.32"
"10","009","00","013","1303","0000","762","218","544","72","834","1909","0","43.69","11.42"
"10","009","00","013","1303","0008","289","82","207","23","312","715","0","43.64","11.47"
"10","009","00","013","1303","0009","473","136","337","49","522","1194","0","43.72","11.39"
"10","009","00","013","1304","0000","1006","302","704","84","1090","2581","0","42.23","11.7"
"10","009","00","013","1304","0010","447","134","313","41","488","1023","0","47.7","13.1"
"10","009","00","013","1304","0011","559","168","391","43","602","1558","0","38.64","10.78"
"10","009","00","013","1305","0000","1162","309","853","103","1265","2559","0","49.43","12.08"
"10","009","00","013","1305","0019","565","147","418","55","620","1230","0","50.41","11.95"
"10","009","00","013","1305","0020","597","162","435","48","645","1329","0","48.53","12.19"
"10","009","00","013","1306","0000","1226","358","868","127","1353","2959","0","45.72","12.1"
"10","009","00","013","1306","0014","599","161","438","61","660","1363","0","48.42","11.81"
"10","009","00","013","1306","0015","627","197","430","66","693","1596","0","43.42","12.34"
"10","009","00","013","1307","0000","848","262","586","52","900","2170","0","41.47","12.07"
"10","009","00","013","1307","0012","454","146","308","24","478","1187","0","40.27","12.3"
"10","009","00","013","1307","0013","394","116","278","28","422","983","0","42.93","11.8"
"10","009","00","013","1308","0000","801","255","546","76","877","2002","0","43.81","12.74"
"10","009","00","013","1308","0017","390","139","251","42","432","964","0","44.81","14.42"
"10","009","00","013","1308","0018","411","116","295","34","445","1038","0","42.87","11.18"
"10","009","00","013","1309","0000","1864","573","1291","244","2108","3841","0","54.88","14.92"
"10","009","00","013","1309","0021","535","152","383","72","607","1129","0","53.76","13.46"
"10","009","00","013","1309","0022","619","205","414","78","697","1241","0","56.16","16.52"
"10","009","00","013","1309","0023","710","216","494","94","804","1471","0","54.66","14.68"
"10","009","00","013","1310","0000","570","181","389","69","639","1107","0","57.72","16.35"
"10","009","00","013","1310","0024","570","181","389","69","639","1107","0","57.72","16.35"
"10","009","00","013","1311","0000","1642","471","1171","116","1758","3391","0","51.84","13.89"
"10","009","00","013","1311","0025","830","243","587","69","899","1636","0","54.95","14.85"
"10","009","00","013","1311","0026","812","228","584","47","859","1755","0","48.95","12.99"
"10","009","00","013","1312","0000","1064","324","740","67","1131","2114","0","53.5","15.33"
"10","009","00","013","1312","0027","586","169","417","31","617","1158","0","53.28","14.59"
"10","009","00","013","1312","0028","478","155","323","36","514","956","0","53.77","16.21"
"10","009","00","013","1313","0000","791","239","552","71","862","1469","0","58.68","16.27"
"10","009","00","013","1313","0016","791","239","552","71","862","1469","0","58.68","16.27"
"10","009","00","014","0000","0000","5961","1761","4200","625","6586","13239","14845","49.75","13.3"
"10","009","00","014","1401","0000","829","237","592","45","874","1533","0","57.01","15.46"
"10","009","00","014","1401","0055","829","237","592","45","874","1533","0","57.01","15.46"
"10","009","00","014","1402","0000","650","194","456","69","719","1203","0","59.77","16.13"
"10","009","00","014","1402","0056","650","194","456","69","719","1203","0","59.77","16.13"
"10","009","00","014","1403","0000","720","231","489","69","789","1624","0","48.58","14.22"
"10","009","00","014","1403","0053","367","118","249","28","395","896","0","44.08","13.17"
"10","009","00","014","1403","0054","353","113","240","41","394","728","0","54.12","15.52"
"10","009","00","014","1404","0000","305","87","218","25","330","540","0","61.11","16.11"
"10","009","00","014","1404","0052","305","87","218","25","330","540","0","61.11","16.11"
"10","009","00","014","1405","0000","484","153","331","56","540","1207","0","44.74","12.68"
"10","009","00","014","1405","0051","484","153","331","56","540","1207","0","44.74","12.68"
"10","009","00","014","1406","0000","303","96","207","22","325","546","0","59.52","17.58"
"10","009","00","014","1406","0058","303","96","207","22","325","546","0","59.52","17.58"
"10","009","00","014","1407","0000","343","98","245","50","393","817","0","48.1","12.0"
"10","009","00","014","1407","0057","343","98","245","50","393","817","0","48.1","12.0"
"10","009","00","014","1408","0000","321","100","221","50","371","856","0","43.34","11.68"
"10","009","00","014","1408","0060","321","100","221","50","371","856","0","43.34","11.68"
"10","009","00","014","1409","0000","377","113","264","61","438","853","0","51.35","13.25"
"10","009","00","014","1409","0059","377","113","264","61","438","853","0","51.35","13.25"
"10","009","00","014","1410","0000","863","262","601","95","958","1945","0","49.25","13.47"
"10","009","00","014","1410","0061","394","132","262","51","445","923","0","48.21","14.3"
"10","009","00","014","1410","0062","469","130","339","44","513","1022","0","50.2","12.72"
"10","009","00","014","1411","0000","391","94","297","43","434","1087","0","39.93","8.65"
"10","009","00","014","1411","0065","391","94","297","43","434","1087","0","39.93","8.65"
"10","009","00","014","1412","0000","375","96","279","40","415","1028","0","40.37","9.34"
"10","009","00","014","1412","0063","217","46","171","24","241","634","0","38.01","7.26"
"10","009","00","014","1412","0064","158","50","108","16","174","394","0","44.16","12.69"
"10","009","00","015","0000","0000","5431","1790","3641","430","5861","11381","12992","51.5","15.73"
"10","009","00","015","1501","0000","1030","339","691","73","1103","1916","0","57.57","17.69"
"10","009","00","015","1501","0066","469","139","330","50","519","923","0","56.23","15.06"
"10","009","00","015","1501","0067","561","200","361","23","584","993","0","58.81","20.14"
"10","009","00","015","1502","0000","721","228","493","31","752","1450","0","51.86","15.72"
"10","009","00","015","1502","0068","376","127","249","19","395","748","0","52.81","16.98"
"10","009","00","015","1502","0069","345","101","244","12","357","702","0","50.85","14.39"
"10","009","00","015","1503","0000","750","253","497","37","787","1508","0","52.19","16.78"
"10","009","00","015","1503","0070","362","112","250","18","380","752","0","50.53","14.89"
"10","009","00","015","1503","0071","388","141","247","19","407","756","0","53.84","18.65"
"10","009","00","015","1504","0000","551","212","339","61","612","1207","0","50.7","17.56"
"10","009","00","015","1504","0074","211","68","143","25","236","470","0","50.21","14.47"
"10","009","00","015","1504","0075","340","144","196","36","376","737","0","51.02","19.54"
"10","009","00","015","1505","0000","676","211","465","47","723","1524","0","47.44","13.85"
"10","009","00","015","1505","0072","242","75","167","15","257","490","0","52.45","15.31"
"10","009","00","015","1505","0073","434","136","298","32","466","1034","0","45.07","13.15"
"10","009","00","015","1506","0000","403","119","284","33","436","878","0","49.66","13.55"
"10","009","00","015","1506","0076","403","119","284","33","436","878","0","49.66","13.55"
"10","009","00","015","1507","0000","351","104","247","39","390","778","0","50.13","13.37"
"10","009","00","015","1507","0077","351","104","247","39","390","778","0","50.13","13.37"
"10","009","00","015","1508","0000","591","207","384","40","631","1224","0","51.55","16.91"
"10","009","00","015","1508","0078","591","207","384","40","631","1224","0","51.55","16.91"
"10","009","00","015","1509","0000","358","117","241","69","427","896","0","47.66","13.06"
"10","009","00","015","1509","0079","358","117","241","69","427","896","0","47.66","13.06"
"10","009","00","016","0000","0000","8761","2524","6237","912","9673","21125","23824","45.79","11.95"
"10","009","00","016","1601","0000","616","187","429","64","680","1238","0","54.93","15.11"
"10","009","00","016","1601","0029","616","187","429","64","680","1238","0","54.93","15.11"
"10","009","00","016","1602","0000","523","137","386","59","582","1098","0","53.01","12.48"
"10","009","00","016","1602","0031","523","137","386","59","582","1098","0","53.01","12.48"
"10","009","00","016","1603","0000","490","268","222","30","520","1091","0","47.66","24.56"
"10","009","00","016","1603","0030","490","268","222","30","520","1091","0","47.66","24.56"
"10","009","00","016","1604","0000","859","231","628","89","948","2073","0","45.73","11.14"
"10","009","00","016","1604","0032","424","120","304","30","454","1048","0","43.32","11.45"
"10","009","00","016","1604","0033","435","111","324","59","494","1025","0","48.2","10.83"
"10","009","00","016","1605","0000","582","150","432","60","642","1460","0","43.97","10.27"
"10","009","00","016","1605","0035","582","150","432","60","642","1460","0","43.97","10.27"
"10","009","00","016","1606","0000","575","145","430","99","674","1890","0","35.66","7.67"
"10","009","00","016","1606","0036","367","108","259","69","436","1180","0","36.95","9.15"
"10","009","00","016","1606","0037","208","37","171","30","238","710","0","33.52","5.21"
"10","009","00","016","1607","0000","235","68","167","17","252","620","0","40.65","10.97"
"10","009","00","016","1607","0038","235","68","167","17","252","620","0","40.65","10.97"
"10","009","00","016","1608","0000","231","71","160","46","277","687","0","40.32","10.33"
"10","009","00","016","1608","0040","231","71","160","46","277","687","0","40.32","10.33"
"10","009","00","016","1609","0000","185","62","123","28","213","449","0","47.44","13.81"
"10","009","00","016","1609","0039","185","62","123","28","213","449","0","47.44","13.81"
"10","009","00","016","1610","0000","398","110","288","33","431","850","0","50.71","12.94"
"10","009","00","016","1610","0034","398","110","288","33","431","850","0","50.71","12.94"
"10","009","00","016","1611","0000","674","207","467","69","743","1514","0","49.08","13.67"
"10","009","00","016","1611","0043","473","142","331","51","524","1042","0","50.29","13.63"
"10","009","00","016","1611","0044","201","65","136","18","219","472","0","46.4","13.77"
"10","009","00","016","1612","0000","566","133","433","31","597","1409","0","42.37","9.44"
"10","009","00","016","1612","0045","566","133","433","31","597","1409","0","42.37","9.44"
"10","009","00","016","1613","0000","1310","339","971","167","1477","3067","0","48.16","11.05"
"10","009","00","016","1613","0046","496","145","351","66","562","1061","0","52.97","13.67"
"10","009","00","016","1613","0047","394","98","296","29","423","993","0","42.6","9.87"
"10","009","00","016","1613","0048","420","96","324","72","492","1013","0","48.57","9.48"
"10","009","00","016","1614","0000","809","228","581","57","866","1849","0","46.84","12.33"
"10","009","00","016","1614","0049","567","155","412","35","602","1233","0","48.82","12.57"
"10","009","00","016","1614","0050","242","73","169","22","264","616","0","42.86","11.85"
"10","009","00","016","1615","0000","708","188","520","63","771","1830","0","42.13","10.27"
"10","009","00","016","1615","0041","509","138","371","52","561","1247","0","44.99","11.07"
"10","009","00","016","1615","0042","199","50","149","11","210","583","0","36.02","8.58"
"10","009","00","017","0000","0000","8894","2717","6177","945","9839","22830","25784","43.1","11.9"
"10","009","00","017","1701","0000","1512","465","1047","102","1614","3349","0","48.19","13.88"
"10","009","00","017","1701","0180","433","124","309","32","465","915","0","50.82","13.55"
"10","009","00","017","1701","0181","584","173","411","24","608","1284","0","47.35","13.47"
"10","009","00","017","1701","0182","495","168","327","46","541","1150","0","47.04","14.61"
"10","009","00","017","1702","0000","640","194","446","85","725","1534","0","47.26","12.65"
"10","009","00","017","1702","0183","290","89","201","42","332","744","0","44.62","11.96"
"10","009","00","017","1702","0184","350","105","245","43","393","790","0","49.75","13.29"
"10","009","00","017","1703","0000","487","134","353","73","560","1356","0","41.3","9.88"
"10","009","00","017","1703","0185","487","134","353","73","560","1356","0","41.3","9.88"
"10","009","00","017","1704","0000","302","90","212","56","358","739","0","48.44","12.18"
"10","009","00","017","1704","0186","302","90","212","56","358","739","0","48.44","12.18"
"10","009","00","017","1705","0000","350","100","250","36","386","965","0","40.0","10.36"
"10","009","00","017","1705","0187","350","100","250","36","386","965","0","40.0","10.36"
"10","009","00","017","1706","0000","408","125","283","56","464","1080","0","42.96","11.57"
"10","009","00","017","1706","0188","408","125","283","56","464","1080","0","42.96","11.57"
"10","009","00","017","1707","0000","337","101","236","43","380","948","0","40.08","10.65"
"10","009","00","017","1707","0189","337","101","236","43","380","948","0","40.08","10.65"
"10","009","00","017","1708","0000","212","69","143","30","242","762","0","31.76","9.06"
"10","009","00","017","1708","0190","212","69","143","30","242","762","0","31.76","9.06"
"10","009","00","017","1709","0000","246","72","174","26","272","582","0","46.74","12.37"
"10","009","00","017","1709","0191","246","72","174","26","272","582","0","46.74","12.37"
"10","009","00","017","1710","0000","310","85","225","16","326","865","0","37.69","9.83"
"10","009","00","017","1710","0192","310","85","225","16","326","865","0","37.69","9.83"
"10","009","00","017","1711","0000","77","23","54","5","82","362","0","22.65","6.35"
"10","009","00","017","1711","0193","77","23","54","5","82","362","0","22.65","6.35"
"10","009","00","017","1712","0000","413","130","283","31","444","1162","0","38.21","11.19"
"10","009","00","017","1712","0194","413","130","283","31","444","1162","0","38.21","11.19"
"10","009","00","017","1713","0000","626","183","443","37","663","1527","0","43.42","11.98"
"10","009","00","017","1713","0195","626","183","443","37","663","1527","0","43.42","11.98"
"10","009","00","017","1714","0000","422","137","285","65","487","1006","0","48.41","13.62"
"10","009","00","017","1714","0196","422","137","285","65","487","1006","0","48.41","13.62"
"10","009","00","017","1715","0000","337","105","232","24","361","855","0","42.22","12.28"
"10","009","00","017","1715","0197","337","105","232","24","361","855","0","42.22","12.28"
"10","009","00","017","1716","0000","485","149","336","72","557","1181","0","47.16","12.62"
"10","009","00","017","1716","0198","485","149","336","72","557","1181","0","47.16","12.62"
"10","009","00","017","1717","0000","325","107","218","33","358","864","0","41.44","12.38"
"10","009","00","017","1717","0199","325","107","218","33","358","864","0","41.44","12.38"
"10","009","00","017","1718","0000","551","180","371","67","618","1545","0","40.0","11.65"
"10","009","00","017","1718","0200","237","78","159","30","267","667","0","40.03","11.69"
"10","009","00","017","1718","0201","314","102","212","37","351","878","0","39.98","11.62"
"10","009","00","017","1719","0000","183","53","130","8","191","610","0","31.31","8.69"
"10","009","00","017","1719","0202","183","53","130","8","191","610","0","31.31","8.69"
"10","009","00","017","1720","0000","344","101","243","53","397","837","0","47.43","12.07"
"10","009","00","017","1720","0203","344","101","243","53","397","837","0","47.43","12.07"
"10","009","00","017","1721","0000","327","114","213","27","354","701","0","50.5","16.26"
"10","009","00","017","1721","0204","327","114","213","27","354","701","0","50.5","16.26"
"10","009","00","018","0000","0000","7443","2192","5251","829","8272","20983","23317","39.42","10.45"
"10","009","00","018","1801","0000","757","202","555","92","849","1758","0","48.29","11.49"
"10","009","00","018","1801","0155","432","127","305","51","483","1082","0","44.64","11.74"
"10","009","00","018","1801","0156","325","75","250","41","366","676","0","54.14","11.09"
"10","009","00","018","1802","0000","229","61","168","18","247","650","0","38.0","9.38"
"10","009","00","018","1802","0160","229","61","168","18","247","650","0","38.0","9.38"
"10","009","00","018","1803","0000","402","124","278","21","423","969","0","43.65","12.8"
"10","009","00","018","1803","0161","402","124","278","21","423","969","0","43.65","12.8"
"10","009","00","018","1804","0000","324","113","211","51","375","925","0","40.54","12.22"
"10","009","00","018","1804","0162","324","113","211","51","375","925","0","40.54","12.22"
"10","009","00","018","1805","0000","1060","296","764","81","1141","2291","0","49.8","12.92"
"10","009","00","018","1805","0157","405","114","291","26","431","862","0","50.0","13.23"
"10","009","00","018","1805","0158","156","45","111","22","178","477","0","37.32","9.43"
"10","009","00","018","1805","0159","499","137","362","33","532","952","0","55.88","14.39"
"10","009","00","018","1806","0000","441","122","319","37","478","1219","0","39.21","10.01"
"10","009","00","018","1806","0165","441","122","319","37","478","1219","0","39.21","10.01"
"10","009","00","018","1807","0000","199","81","118","45","244","759","0","32.15","10.67"
"10","009","00","018","1807","0164","199","81","118","45","244","759","0","32.15","10.67"
"10","009","00","018","1808","0000","373","103","270","30","403","914","0","44.09","11.27"
"10","009","00","018","1808","0163","373","103","270","30","403","914","0","44.09","11.27"
"10","009","00","018","1809","0000","275","96","179","22","297","876","0","33.9","10.96"
"10","009","00","018","1809","0169","275","96","179","22","297","876","0","33.9","10.96"
"10","009","00","018","1810","0000","121","38","83","18","139","360","0","38.61","10.56"
"10","009","00","018","1810","0170","121","38","83","18","139","360","0","38.61","10.56"
"10","009","00","018","1811","0000","219","64","155","13","232","773","0","30.01","8.28"
"10","009","00","018","1811","0167","219","64","155","13","232","773","0","30.01","8.28"
"10","009","00","018","1812","0000","287","87","200","37","324","937","0","34.58","9.28"
"10","009","00","018","1812","0166","287","87","200","37","324","937","0","34.58","9.28"
"10","009","00","018","1813","0000","473","153","320","76","549","1718","0","31.96","8.91"
"10","009","00","018","1813","0171","222","74","148","41","263","885","0","29.72","8.36"
"10","009","00","018","1813","0172","251","79","172","35","286","833","0","34.33","9.48"
"10","009","00","018","1814","0000","285","90","195","35","320","785","0","40.76","11.46"
"10","009","00","018","1814","0173","285","90","195","35","320","785","0","40.76","11.46"
"10","009","00","018","1815","0000","309","71","238","26","335","705","0","47.52","10.07"
"10","009","00","018","1815","0174","309","71","238","26","335","705","0","47.52","10.07"
"10","009","00","018","1816","0000","272","93","179","29","301","927","0","32.47","10.03"
"10","009","00","018","1816","0175","272","93","179","29","301","927","0","32.47","10.03"
"10","009","00","018","1817","0000","365","94","271","51","416","1071","0","38.84","8.78"
"10","009","00","018","1817","0177","365","94","271","51","416","1071","0","38.84","8.78"
"10","009","00","018","1818","0000","273","74","199","18","291","1022","0","28.47","7.24"
"10","009","00","018","1818","0178","273","74","199","18","291","1022","0","28.47","7.24"
"10","009","00","018","1819","0000","277","73","204","27","304","711","0","42.76","10.27"
"10","009","00","018","1819","0179","277","73","204","27","304","711","0","42.76","10.27"
"10","009","00","018","1820","0000","190","55","135","35","225","555","0","40.54","9.91"
"10","009","00","018","1820","0168","190","55","135","35","225","555","0","40.54","9.91"
"10","009","00","018","1821","0000","312","102","210","67","379","1058","0","35.82","9.64"
"10","009","00","018","1821","0176","312","102","210","67","379","1058","0","35.82","9.64"
"10","009","00","019","0000","0000","10185","2990","7195","1280","11465","24193","27383","47.39","12.36"
"10","009","00","019","1901","0000","577","167","410","89","666","1225","0","54.37","13.63"
"10","009","00","019","1901","0206","577","167","410","89","666","1225","0","54.37","13.63"
"10","009","00","019","1902","0000","532","168","364","60","592","1134","0","52.2","14.81"
"10","009","00","019","1902","0205","532","168","364","60","592","1134","0","52.2","14.81"
"10","009","00","019","1903","0000","239","58","181","38","277","647","0","42.81","8.96"
"10","009","00","019","1903","0207","239","58","181","38","277","647","0","42.81","8.96"
"10","009","00","019","1904","0000","363","133","230","67","430","900","0","47.78","14.78"
"10","009","00","019","1904","0209","363","133","230","67","430","900","0","47.78","14.78"
"10","009","00","019","1905","0000","323","97","226","26","349","709","0","49.22","13.68"
"10","009","00","019","1905","0208","323","97","226","26","349","709","0","49.22","13.68"
"10","009","00","019","1906","0000","431","132","299","65","496","1011","0","49.06","13.06"
"10","009","00","019","1906","0210","431","132","299","65","496","1011","0","49.06","13.06"
"10","009","00","019","1907","0000","529","146","383","39","568","1437","0","39.53","10.16"
"10","009","00","019","1907","0211","529","146","383","39","568","1437","0","39.53","10.16"
"10","009","00","019","1908","0000","715","210","505","40","755","2041","0","36.99","10.29"
"10","009","00","019","1908","0212","263","88","175","13","276","848","0","32.55","10.38"
"10","009","00","019","1908","0213","452","122","330","27","479","1193","0","40.15","10.23"
"10","009","00","019","1909","0000","570","169","401","86","656","1574","0","41.68","10.74"
"10","009","00","019","1909","0214","245","78","167","43","288","759","0","37.94","10.28"
"10","009","00","019","1909","0215","325","91","234","43","368","815","0","45.15","11.17"
"10","009","00","019","1910","0000","638","200","438","82","720","1460","0","49.32","13.7"
"10","009","00","019","1910","0216","638","200","438","82","720","1460","0","49.32","13.7"
"10","009","00","019","1911","0000","173","68","105","7","180","556","0","32.37","12.23"
"10","009","00","019","1911","0217","173","68","105","7","180","556","0","32.37","12.23"
"10","009","00","019","1912","0000","645","182","463","56","701","1532","0","45.76","11.88"
"10","009","00","019","1912","0218","645","182","463","56","701","1532","0","45.76","11.88"
"10","009","00","019","1913","0000","369","96","273","14","383","847","0","45.22","11.33"
"10","009","00","019","1913","0219","369","96","273","14","383","847","0","45.22","11.33"
"10","009","00","019","1914","0000","833","243","590","183","1016","1882","0","53.99","12.91"
"10","009","00","019","1914","0220","160","52","108","22","182","374","0","48.66","13.9"
"10","009","00","019","1914","0221","673","191","482","161","834","1508","0","55.31","12.67"
"10","009","00","019","1915","0000","463","119","344","67","530","951","0","55.73","12.51"
"10","009","00","019","1915","0222","463","119","344","67","530","951","0","55.73","12.51"
"10","009","00","019","1916","0000","372","120","252","34","406","1006","0","40.36","11.93"
"10","009","00","019","1916","0228","372","120","252","34","406","1006","0","40.36","11.93"
"10","009","00","019","1917","0000","426","110","316","51","477","952","0","50.11","11.55"
"10","009","00","019","1917","0226","426","110","316","51","477","952","0","50.11","11.55"
"10","009","00","019","1918","0000","342","104","238","46","388","720","0","53.89","14.44"
"10","009","00","019","1918","0227","342","104","238","46","388","720","0","53.89","14.44"
"10","009","00","019","1919","0000","933","278","655","107","1040","1789","0","58.13","15.54"
"10","009","00","019","1919","0223","456","134","322","68","524","910","0","57.58","14.73"
"10","009","00","019","1919","0224","477","144","333","39","516","879","0","58.7","16.38"
"10","009","00","019","1920","0000","481","146","335","109","590","1213","0","48.64","12.04"
"10","009","00","019","1920","0225","481","146","335","109","590","1213","0","48.64","12.04"
"10","009","00","019","1921","0000","231","44","187","14","245","607","0","40.36","7.25"
"10","009","00","019","1921","0229","231","44","187","14","245","607","0","40.36","7.25"
"10","009","00","020","0000","0000","8723","2689","6034","1040","9763","22508","25426","43.38","11.95"
"10","009","00","020","2001","0000","992","334","658","75","1067","2242","0","47.59","14.9"
"10","009","00","020","2001","0230","570","190","380","59","629","1355","0","46.42","14.02"
"10","009","00","020","2001","0231","422","144","278","16","438","887","0","49.38","16.23"
"10","009","00","020","2002","0000","977","302","675","58","1035","1997","0","51.83","15.12"
"10","009","00","020","2002","0232","625","188","437","40","665","1234","0","53.89","15.24"
"10","009","00","020","2002","0233","352","114","238","18","370","763","0","48.49","14.94"
"10","009","00","020","2003","0000","422","141","281","74","496","1022","0","48.53","13.8"
"10","009","00","020","2003","0253","422","141","281","74","496","1022","0","48.53","13.8"
"10","009","00","020","2004","0000","455","124","331","41","496","1191","0","41.65","10.41"
"10","009","00","020","2004","0254","455","124","331","41","496","1191","0","41.65","10.41"
"10","009","00","020","2005","0000","414","142","272","81","495","1006","0","49.2","14.12"
"10","009","00","020","2005","0240","414","142","272","81","495","1006","0","49.2","14.12"
"10","009","00","020","2006","0000","249","68","181","14","263","651","0","40.4","10.45"
"10","009","00","020","2006","0241","249","68","181","14","263","651","0","40.4","10.45"
"10","009","00","020","2007","0000","230","66","164","19","249","607","0","41.02","10.87"
"10","009","00","020","2007","0242","230","66","164","19","249","607","0","41.02","10.87"
"10","009","00","020","2008","0000","363","125","238","67","430","1033","0","41.63","12.1"
"10","009","00","020","2008","0243","363","125","238","67","430","1033","0","41.63","12.1"
"10","009","00","020","2009","0000","191","51","140","15","206","631","0","32.65","8.08"
"10","009","00","020","2009","0244","191","51","140","15","206","631","0","32.65","8.08"
"10","009","00","020","2010","0000","394","95","299","15","409","961","0","42.56","9.89"
"10","009","00","020","2010","0245","394","95","299","15","409","961","0","42.56","9.89"
"10","009","00","020","2011","0000","257","104","153","48","305","721","0","42.3","14.42"
"10","009","00","020","2011","0234","257","104","153","48","305","721","0","42.3","14.42"
"10","009","00","020","2012","0000","231","69","162","8","239","647","0","36.94","10.66"
"10","009","00","020","2012","0235","231","69","162","8","239","647","0","36.94","10.66"
"10","009","00","020","2013","0000","388","109","279","16","404","1081","0","37.37","10.08"
"10","009","00","020","2013","0238","388","109","279","16","404","1081","0","37.37","10.08"
"10","009","00","020","2014","0000","376","120","256","64","440","989","0","44.49","12.13"
"10","009","00","020","2014","0236","376","120","256","64","440","989","0","44.49","12.13"
"10","009","00","020","2015","0000","288","86","202","33","321","837","0","38.35","10.27"
"10","009","00","020","2015","0237","288","86","202","33","321","837","0","38.35","10.27"
"10","009","00","020","2016","0000","351","108","243","72","423","951","0","44.48","11.36"
"10","009","00","020","2016","0246","351","108","243","72","423","951","0","44.48","11.36"
"10","009","00","020","2017","0000","324","98","226","40","364","838","0","43.44","11.69"
"10","009","00","020","2017","0247","324","98","226","40","364","838","0","43.44","11.69"
"10","009","00","020","2018","0000","399","112","287","100","499","1055","0","47.3","10.62"
"10","009","00","020","2018","0248","399","112","287","100","499","1055","0","47.3","10.62"
"10","009","00","020","2019","0000","147","37","110","30","177","512","0","34.57","7.23"
"10","009","00","020","2019","0249","147","37","110","30","177","512","0","34.57","7.23"
"10","009","00","020","2020","0000","229","81","148","16","245","671","0","36.51","12.07"
"10","009","00","020","2020","0250","229","81","148","16","245","671","0","36.51","12.07"
"10","009","00","020","2021","0000","187","64","123","37","224","693","0","32.32","9.24"
"10","009","00","020","2021","0251","187","64","123","37","224","693","0","32.32","9.24"
"10","009","00","020","2022","0000","198","62","136","41","239","689","0","34.69","9.0"
"10","009","00","020","2022","0252","198","62","136","41","239","689","0","34.69","9.0"
"10","009","00","020","2023","0000","279","93","186","39","318","704","0","45.17","13.21"
"10","009","00","020","2023","0239","279","93","186","39","318","704","0","45.17","13.21"
"10","009","00","020","2024","0000","382","98","284","37","419","779","0","53.79","12.58"
"10","009","00","020","2024","0255","382","98","284","37","419","779","0","53.79","12.58"
"10","010","00","000","0000","0000","204282","65100","139182","19875","224157","442775","507780","50.63","14.7"
"10","010","00","001","0000","0000","15602","5217","10385","1236","16838","31568","38048","53.34","16.53"
"10","010","00","001","0101","0000","1186","380","806","85","1271","2286","0","55.6","16.62"
"10","010","00","001","0101","0001","625","200","425","54","679","1210","0","56.12","16.53"
"10","010","00","001","0101","0002","561","180","381","31","592","1076","0","55.02","16.73"
"10","010","00","001","0102","0000","221","86","135","20","241","488","0","49.39","17.62"
"10","010","00","001","0102","0003","221","86","135","20","241","488","0","49.39","17.62"
"10","010","00","001","0103","0000","646","225","421","80","726","1475","0","49.22","15.25"
"10","010","00","001","0103","0004","646","225","421","80","726","1475","0","49.22","15.25"
"10","010","00","001","0104","0000","745","237","508","64","809","1673","0","48.36","14.17"
"10","010","00","001","0104","0005","336","117","219","30","366","790","0","46.33","14.81"
"10","010","00","001","0104","0006","409","120","289","34","443","883","0","50.17","13.59"
"10","010","00","001","0105","0000","501","142","359","57","558","1147","0","48.65","12.38"
"10","010","00","001","0105","0007","352","105","247","47","399","758","0","52.64","13.85"
"10","010","00","001","0105","0008","149","37","112","10","159","389","0","40.87","9.51"
"10","010","00","001","0106","0000","463","160","303","50","513","1101","0","46.59","14.53"
"10","010","00","001","0106","0009","463","160","303","50","513","1101","0","46.59","14.53"
"10","010","00","001","0107","0000","430","122","308","13","443","853","0","51.93","14.3"
"10","010","00","001","0107","0010","430","122","308","13","443","853","0","51.93","14.3"
"10","010","00","001","0108","0000","828","275","553","40","868","1692","0","51.3","16.25"
"10","010","00","001","0108","0014","405","114","291","29","434","913","0","47.54","12.49"
"10","010","00","001","0108","0015","423","161","262","11","434","779","0","55.71","20.67"
"10","010","00","001","0109","0000","602","228","374","107","709","1278","0","55.48","17.84"
"10","010","00","001","0109","0016","602","228","374","107","709","1278","0","55.48","17.84"
"10","010","00","001","0110","0000","1116","370","746","64","1180","2392","0","49.33","15.47"
"10","010","00","001","0110","0017","362","122","240","32","394","819","0","48.11","14.9"
"10","010","00","001","0110","0018","754","248","506","32","786","1573","0","49.97","15.77"
"10","010","00","001","0111","0000","372","116","256","38","410","726","0","56.47","15.98"
"10","010","00","001","0111","0019","229","71","158","33","262","481","0","54.47","14.76"
"10","010","00","001","0111","0020","143","45","98","5","148","245","0","60.41","18.37"
"10","010","00","001","0112","0000","290","153","137","21","311","575","0","54.09","26.61"
"10","010","00","001","0112","0021","164","107","57","14","178","317","0","56.15","33.75"
"10","010","00","001","0112","0022","126","46","80","7","133","258","0","51.55","17.83"
"10","010","00","001","0113","0000","1789","587","1202","111","1900","3333","0","57.01","17.61"
"10","010","00","001","0113","0023","284","85","199","49","333","611","0","54.5","13.91"
"10","010","00","001","0113","0024","850","260","590","41","891","1526","0","58.39","17.04"
"10","010","00","001","0113","0025","655","242","413","21","676","1196","0","56.52","20.23"
"10","010","00","001","0114","0000","2271","768","1503","195","2466","4467","0","55.2","17.19"
"10","010","00","001","0114","0026","756","265","491","93","849","1536","0","55.27","17.25"
"10","010","00","001","0114","0027","762","262","500","61","823","1481","0","55.57","17.69"
"10","010","00","001","0114","0028","753","241","512","41","794","1450","0","54.76","16.62"
"10","010","00","001","0115","0000","906","336","570","55","961","1829","0","52.54","18.37"
"10","010","00","001","0115","0029","394","135","259","25","419","840","0","49.88","16.07"
"10","010","00","001","0115","0030","512","201","311","30","542","989","0","54.8","20.32"
"10","010","00","001","0116","0000","1635","521","1114","114","1749","3040","0","57.53","17.14"
"10","010","00","001","0116","0031","833","237","596","65","898","1529","0","58.73","15.5"
"10","010","00","001","0116","0032","802","284","518","49","851","1511","0","56.32","18.8"
"10","010","00","001","0117","0000","302","109","193","35","337","697","0","48.35","15.64"
"10","010","00","001","0117","0033","302","109","193","35","337","697","0","48.35","15.64"
"10","010","00","001","0118","0000","1299","402","897","87","1386","2516","0","55.09","15.98"
"10","010","00","001","0118","0011","83","40","43","9","92","224","0","41.07","17.86"
"10","010","00","001","0118","0012","276","93","183","46","322","662","0","48.64","14.05"
"10","010","00","001","0118","0013","940","269","671","32","972","1630","0","59.63","16.5"
"10","010","00","002","0000","0000","16755","5426","11329","1428","18183","35191","42143","51.67","15.42"
"10","010","00","002","0201","0000","983","349","634","71","1054","1938","0","54.39","18.01"
"10","010","00","002","0201","0233","607","232","375","33","640","1183","0","54.1","19.61"
"10","010","00","002","0201","0234","376","117","259","38","414","755","0","54.83","15.5"
"10","010","00","002","0202","0000","1249","427","822","81","1330","2331","0","57.06","18.32"
"10","010","00","002","0202","0235","647","220","427","33","680","1253","0","54.27","17.56"
"10","010","00","002","0202","0236","602","207","395","48","650","1078","0","60.3","19.2"
"10","010","00","002","0203","0000","621","229","392","64","685","1117","0","61.32","20.5"
"10","010","00","002","0203","0237","621","229","392","64","685","1117","0","61.32","20.5"
"10","010","00","002","0204","0000","212","84","128","19","231","387","0","59.69","21.71"
"10","010","00","002","0204","0238","212","84","128","19","231","387","0","59.69","21.71"
"10","010","00","002","0205","0000","316","96","220","43","359","633","0","56.71","15.17"
"10","010","00","002","0205","0239","316","96","220","43","359","633","0","56.71","15.17"
"10","010","00","002","0206","0000","345","126","219","23","368","650","0","56.62","19.38"
"10","010","00","002","0206","0240","345","126","219","23","368","650","0","56.62","19.38"
"10","010","00","002","0207","0000","488","141","347","34","522","825","0","63.27","17.09"
"10","010","00","002","0207","0241","488","141","347","34","522","825","0","63.27","17.09"
"10","010","00","002","0208","0000","913","290","623","84","997","1750","0","56.97","16.57"
"10","010","00","002","0208","0242","407","145","262","39","446","810","0","55.06","17.9"
"10","010","00","002","0208","0243","506","145","361","45","551","940","0","58.62","15.43"
"10","010","00","002","0209","0000","1158","380","778","91","1249","2510","0","49.76","15.14"
"10","010","00","002","0209","0244","433","132","301","54","487","905","0","53.81","14.59"
"10","010","00","002","0209","0245","725","248","477","37","762","1605","0","47.48","15.45"
"10","010","00","002","0210","0000","2271","756","1515","135","2406","4193","0","57.38","18.03"
"10","010","00","002","0210","0246","811","288","523","38","849","1479","0","57.4","19.47"
"10","010","00","002","0210","0247","661","218","443","41","702","1218","0","57.64","17.9"
"10","010","00","002","0210","0248","799","250","549","56","855","1496","0","57.15","16.71"
"10","010","00","002","0211","0000","342","99","243","22","364","667","0","54.57","14.84"
"10","010","00","002","0211","0249","342","99","243","22","364","667","0","54.57","14.84"
"10","010","00","002","0212","0000","238","71","167","16","254","627","0","40.51","11.32"
"10","010","00","002","0212","0250","238","71","167","16","254","627","0","40.51","11.32"
"10","010","00","002","0213","0000","351","90","261","44","395","791","0","49.94","11.38"
"10","010","00","002","0213","0251","351","90","261","44","395","791","0","49.94","11.38"
"10","010","00","002","0214","0000","481","153","328","92","573","1034","0","55.42","14.8"
"10","010","00","002","0214","0252","481","153","328","92","573","1034","0","55.42","14.8"
"10","010","00","002","0215","0000","810","297","513","26","836","1710","0","48.89","17.37"
"10","010","00","002","0215","0253","810","297","513","26","836","1710","0","48.89","17.37"
"10","010","00","002","0216","0000","1380","413","967","81","1461","3218","0","45.4","12.83"
"10","010","00","002","0216","0254","754","226","528","39","793","1671","0","47.46","13.52"
"10","010","00","002","0216","0255","626","187","439","42","668","1547","0","43.18","12.09"
"10","010","00","002","0217","0000","1322","403","919","75","1397","2904","0","48.11","13.88"
"10","010","00","002","0217","0256","602","180","422","54","656","1602","0","40.95","11.24"
"10","010","00","002","0217","0257","720","223","497","21","741","1302","0","56.91","17.13"
"10","010","00","002","0218","0000","334","91","243","42","376","740","0","50.81","12.3"
"10","010","00","002","0218","0258","334","91","243","42","376","740","0","50.81","12.3"
"10","010","00","002","0219","0000","560","171","389","61","621","1054","0","58.92","16.22"
"10","010","00","002","0219","0259","560","171","389","61","621","1054","0","58.92","16.22"
"10","010","00","002","0220","0000","347","96","251","20","367","907","0","40.46","10.58"
"10","010","00","002","0220","0260","347","96","251","20","367","907","0","40.46","10.58"
"10","010","00","002","0221","0000","116","40","76","30","146","251","0","58.17","15.94"
"10","010","00","002","0221","0262","116","40","76","30","146","251","0","58.17","15.94"
"10","010","00","002","0222","0000","282","102","180","30","312","720","0","43.33","14.17"
"10","010","00","002","0222","0261","282","102","180","30","312","720","0","43.33","14.17"
"10","010","00","002","0223","0000","284","103","181","51","335","767","0","43.68","13.43"
"10","010","00","002","0223","0263","284","103","181","51","335","767","0","43.68","13.43"
"10","010","00","002","0224","0000","340","105","235","50","390","702","0","55.56","14.96"
"10","010","00","002","0224","0264","340","105","235","50","390","702","0","55.56","14.96"
"10","010","00","002","0225","0000","424","127","297","65","489","1038","0","47.11","12.24"
"10","010","00","002","0225","0265","424","127","297","65","489","1038","0","47.11","12.24"
"10","010","00","002","0226","0000","381","127","254","28","409","1228","0","33.31","10.34"
"10","010","00","002","0226","0266","381","127","254","28","409","1228","0","33.31","10.34"
"10","010","00","002","0227","0000","207","60","147","50","257","499","0","51.5","12.02"
"10","010","00","002","0227","0267","207","60","147","50","257","499","0","51.5","12.02"
"10","010","00","003","0000","0000","10443","3048","7395","1180","11623","23965","26846","48.5","12.72"
"10","010","00","003","0301","0000","277","81","196","22","299","614","0","48.7","13.19"
"10","010","00","003","0301","0325","277","81","196","22","299","614","0","48.7","13.19"
"10","010","00","003","0302","0000","146","37","109","23","169","372","0","45.43","9.95"
"10","010","00","003","0302","0326","146","37","109","23","169","372","0","45.43","9.95"
"10","010","00","003","0303","0000","1000","310","690","147","1147","2112","0","54.31","14.68"
"10","010","00","003","0303","0327","439","139","300","72","511","914","0","55.91","15.21"
"10","010","00","003","0303","0328","561","171","390","75","636","1198","0","53.09","14.27"
"10","010","00","003","0304","0000","463","120","343","60","523","1113","0","46.99","10.78"
"10","010","00","003","0304","0329","463","120","343","60","523","1113","0","46.99","10.78"
"10","010","00","003","0305","0000","786","232","554","70","856","1681","0","50.92","13.8"
"10","010","00","003","0305","0330","457","150","307","58","515","992","0","51.92","15.12"
"10","010","00","003","0305","0331","329","82","247","12","341","689","0","49.49","11.9"
"10","010","00","003","0306","0000","406","124","282","54","460","882","0","52.15","14.06"
"10","010","00","003","0306","0332","406","124","282","54","460","882","0","52.15","14.06"
"10","010","00","003","0307","0000","337","95","242","44","381","731","0","52.12","13.0"
"10","010","00","003","0307","0333","337","95","242","44","381","731","0","52.12","13.0"
"10","010","00","003","0308","0000","387","94","293","35","422","779","0","54.17","12.07"
"10","010","00","003","0308","0334","387","94","293","35","422","779","0","54.17","12.07"
"10","010","00","003","0309","0000","410","120","290","43","453","953","0","47.53","12.59"
"10","010","00","003","0309","0349","410","120","290","43","453","953","0","47.53","12.59"
"10","010","00","003","0310","0000","635","175","460","55","690","1292","0","53.41","13.54"
"10","010","00","003","0310","0350","635","175","460","55","690","1292","0","53.41","13.54"
"10","010","00","003","0311","0000","1119","299","820","90","1209","2371","0","50.99","12.61"
"10","010","00","003","0311","0351","556","142","414","51","607","1127","0","53.86","12.6"
"10","010","00","003","0311","0352","563","157","406","39","602","1244","0","48.39","12.62"
"10","010","00","003","0312","0000","481","149","332","23","504","1106","0","45.57","13.47"
"10","010","00","003","0312","0353","481","149","332","23","504","1106","0","45.57","13.47"
"10","010","00","003","0313","0000","492","138","354","45","537","1145","0","46.9","12.05"
"10","010","00","003","0313","0342","492","138","354","45","537","1145","0","46.9","12.05"
"10","010","00","003","0314","0000","816","260","556","76","892","1894","0","47.1","13.73"
"10","010","00","003","0314","0343","403","119","284","35","438","936","0","46.79","12.71"
"10","010","00","003","0314","0344","413","141","272","41","454","958","0","47.39","14.72"
"10","010","00","003","0315","0000","122","42","80","13","135","298","0","45.3","14.09"
"10","010","00","003","0315","0345","122","42","80","13","135","298","0","45.3","14.09"
"10","010","00","003","0316","0000","209","63","146","39","248","428","0","57.94","14.72"
"10","010","00","003","0316","0346","209","63","146","39","248","428","0","57.94","14.72"
"10","010","00","003","0317","0000","98","21","77","7","105","295","0","35.59","7.12"
"10","010","00","003","0317","0347","53","15","38","1","54","121","0","44.63","12.4"
"10","010","00","003","0317","0348","45","6","39","6","51","174","0","29.31","3.45"
"10","010","00","003","0318","0000","305","90","215","35","340","762","0","44.62","11.81"
"10","010","00","003","0318","0335","305","90","215","35","340","762","0","44.62","11.81"
"10","010","00","003","0319","0000","476","142","334","57","533","1184","0","45.02","11.99"
"10","010","00","003","0319","0336","476","142","334","57","533","1184","0","45.02","11.99"
"10","010","00","003","0320","0000","492","170","322","60","552","1351","0","40.86","12.58"
"10","010","00","003","0320","0338","492","170","322","60","552","1351","0","40.86","12.58"
"10","010","00","003","0321","0000","497","136","361","73","570","1423","0","40.06","9.56"
"10","010","00","003","0321","0337","497","136","361","73","570","1423","0","40.06","9.56"
"10","010","00","003","0322","0000","216","61","155","19","235","518","0","45.37","11.78"
"10","010","00","003","0322","0339","115","27","88","5","120","275","0","43.64","9.82"
"10","010","00","003","0322","0340","101","34","67","14","115","243","0","47.33","13.99"
"10","010","00","003","0323","0000","273","89","184","90","363","661","0","54.92","13.46"
"10","010","00","003","0323","0341","273","89","184","90","363","661","0","54.92","13.46"
"10","010","00","004","0000","0000","12785","4191","8594","1117","13902","26922","30954","51.64","15.57"
"10","010","00","004","0401","0000","240","80","160","28","268","483","0","55.49","16.56"
"10","010","00","004","0401","0169","240","80","160","28","268","483","0","55.49","16.56"
"10","010","00","004","0402","0000","951","312","639","67","1018","1823","0","55.84","17.11"
"10","010","00","004","0402","0170","951","312","639","67","1018","1823","0","55.84","17.11"
"10","010","00","004","0403","0000","515","152","363","20","535","955","0","56.02","15.92"
"10","010","00","004","0403","0171","515","152","363","20","535","955","0","56.02","15.92"
"10","010","00","004","0404","0000","3001","1069","1932","231","3232","5874","0","55.02","18.2"
"10","010","00","004","0404","0172","710","243","467","37","747","1436","0","52.02","16.92"
"10","010","00","004","0404","0173","695","260","435","70","765","1390","0","55.04","18.71"
"10","010","00","004","0404","0174","772","274","498","73","845","1512","0","55.89","18.12"
"10","010","00","004","0404","0175","824","292","532","51","875","1536","0","56.97","19.01"
"10","010","00","004","0405","0000","519","159","360","40","559","1165","0","47.98","13.65"
"10","010","00","004","0405","0176","519","159","360","40","559","1165","0","47.98","13.65"
"10","010","00","004","0406","0000","960","275","685","58","1018","1730","0","58.84","15.9"
"10","010","00","004","0406","0177","960","275","685","58","1018","1730","0","58.84","15.9"
"10","010","00","004","0407","0000","239","66","173","21","260","602","0","43.19","10.96"
"10","010","00","004","0407","0178","239","66","173","21","260","602","0","43.19","10.96"
"10","010","00","004","0408","0000","309","121","188","49","358","716","0","50.0","16.9"
"10","010","00","004","0408","0179","309","121","188","49","358","716","0","50.0","16.9"
"10","010","00","004","0409","0000","236","71","165","9","245","625","0","39.2","11.36"
"10","010","00","004","0409","0180","236","71","165","9","245","625","0","39.2","11.36"
"10","010","00","004","0410","0000","69","26","43","5","74","193","0","38.34","13.47"
"10","010","00","004","0410","0181","69","26","43","5","74","193","0","38.34","13.47"
"10","010","00","004","0411","0000","677","219","458","77","754","1642","0","45.92","13.34"
"10","010","00","004","0411","0182","677","219","458","77","754","1642","0","45.92","13.34"
"10","010","00","004","0412","0000","702","206","496","61","763","1465","0","52.08","14.06"
"10","010","00","004","0412","0183","702","206","496","61","763","1465","0","52.08","14.06"
"10","010","00","004","0413","0000","499","146","353","72","571","1289","0","44.3","11.33"
"10","010","00","004","0413","0184","365","110","255","46","411","928","0","44.29","11.85"
"10","010","00","004","0413","0185","134","36","98","26","160","361","0","44.32","9.97"
"10","010","00","004","0414","0000","372","108","264","19","391","814","0","48.03","13.27"
"10","010","00","004","0414","0186","372","108","264","19","391","814","0","48.03","13.27"
"10","010","00","004","0415","0000","703","237","466","49","752","1579","0","47.63","15.01"
"10","010","00","004","0415","0187","703","237","466","49","752","1579","0","47.63","15.01"
"10","010","00","004","0416","0000","948","389","559","100","1048","2041","0","51.35","19.06"
"10","010","00","004","0416","0188","948","389","559","100","1048","2041","0","51.35","19.06"
"10","010","00","004","0417","0000","412","119","293","62","474","931","0","50.91","12.78"
"10","010","00","004","0417","0189","412","119","293","62","474","931","0","50.91","12.78"
"10","010","00","004","0418","0000","304","109","195","43","347","675","0","51.41","16.15"
"10","010","00","004","0418","0190","304","109","195","43","347","675","0","51.41","16.15"
"10","010","00","004","0419","0000","301","76","225","24","325","655","0","49.62","11.6"
"10","010","00","004","0419","0191","301","76","225","24","325","655","0","49.62","11.6"
"10","010","00","004","0420","0000","374","113","261","36","410","833","0","49.22","13.57"
"10","010","00","004","0420","0192","374","113","261","36","410","833","0","49.22","13.57"
"10","010","00","004","0421","0000","454","138","316","46","500","832","0","60.1","16.59"
"10","010","00","004","0421","0193","454","138","316","46","500","832","0","60.1","16.59"
"10","010","00","005","0000","0000","30063","10079","19984","2724","32787","61209","71327","53.57","16.47"
"10","010","00","005","0501","0000","1174","396","778","84","1258","2297","0","54.77","17.24"
"10","010","00","005","0501","0093","679","237","442","54","733","1267","0","57.85","18.71"
"10","010","00","005","0501","0094","495","159","336","30","525","1030","0","50.97","15.44"
"10","010","00","005","0502","0000","860","274","586","89","949","1590","0","59.69","17.23"
"10","010","00","005","0502","0095","860","274","586","89","949","1590","0","59.69","17.23"
"10","010","00","005","0503","0000","1751","882","869","92","1843","3391","0","54.35","26.01"
"10","010","00","005","0503","0096","831","548","283","26","857","1673","0","51.23","32.76"
"10","010","00","005","0503","0097","920","334","586","66","986","1718","0","57.39","19.44"
"10","010","00","005","0504","0000","1096","380","716","99","1195","2140","0","55.84","17.76"
"10","010","00","005","0504","0098","567","191","376","47","614","1040","0","59.04","18.37"
"10","010","00","005","0504","0099","529","189","340","52","581","1100","0","52.82","17.18"
"10","010","00","005","0505","0000","721","238","483","76","797","1559","0","51.12","15.27"
"10","010","00","005","0505","0100","721","238","483","76","797","1559","0","51.12","15.27"
"10","010","00","005","0506","0000","867","294","573","79","946","1862","0","50.81","15.79"
"10","010","00","005","0506","0101","867","294","573","79","946","1862","0","50.81","15.79"
"10","010","00","005","0507","0000","736","264","472","73","809","1435","0","56.38","18.4"
"10","010","00","005","0507","0102","736","264","472","73","809","1435","0","56.38","18.4"
"10","010","00","005","0508","0000","784","277","507","168","952","1751","0","54.37","15.82"
"10","010","00","005","0508","0103","784","277","507","168","952","1751","0","54.37","15.82"
"10","010","00","005","0509","0000","472","142","330","60","532","933","0","57.02","15.22"
"10","010","00","005","0509","0104","472","142","330","60","532","933","0","57.02","15.22"
"10","010","00","005","0510","0000","473","161","312","44","517","827","0","62.52","19.47"
"10","010","00","005","0510","0105","473","161","312","44","517","827","0","62.52","19.47"
"10","010","00","005","0511","0000","348","120","228","55","403","843","0","47.81","14.23"
"10","010","00","005","0511","0106","348","120","228","55","403","843","0","47.81","14.23"
"10","010","00","005","0512","0000","1033","333","700","85","1118","2159","0","51.78","15.42"
"10","010","00","005","0512","0107","867","279","588","69","936","1774","0","52.76","15.73"
"10","010","00","005","0512","0108","166","54","112","16","182","385","0","47.27","14.03"
"10","010","00","005","0513","0000","726","250","476","33","759","1306","0","58.12","19.14"
"10","010","00","005","0513","0109","726","250","476","33","759","1306","0","58.12","19.14"
"10","010","00","005","0514","0000","279","83","196","41","320","535","0","59.81","15.51"
"10","010","00","005","0514","0110","279","83","196","41","320","535","0","59.81","15.51"
"10","010","00","005","0515","0000","545","187","358","72","617","1055","0","58.48","17.73"
"10","010","00","005","0515","0111","545","187","358","72","617","1055","0","58.48","17.73"
"10","010","00","005","0516","0000","878","235","643","82","960","1875","0","51.2","12.53"
"10","010","00","005","0516","0127","878","235","643","82","960","1875","0","51.2","12.53"
"10","010","00","005","0517","0000","1377","485","892","106","1483","2746","0","54.01","17.66"
"10","010","00","005","0517","0128","686","230","456","45","731","1305","0","56.02","17.62"
"10","010","00","005","0517","0129","691","255","436","61","752","1441","0","52.19","17.7"
"10","010","00","005","0518","0000","1005","334","671","101","1106","2004","0","55.19","16.67"
"10","010","00","005","0518","0132","1005","334","671","101","1106","2004","0","55.19","16.67"
"10","010","00","005","0519","0000","1299","426","873","96","1395","2430","0","57.41","17.53"
"10","010","00","005","0519","0133","731","246","485","67","798","1354","0","58.94","18.17"
"10","010","00","005","0519","0134","568","180","388","29","597","1076","0","55.48","16.73"
"10","010","00","005","0520","0000","1715","519","1196","204","1919","3606","0","53.22","14.39"
"10","010","00","005","0520","0135","787","234","553","128","915","1629","0","56.17","14.36"
"10","010","00","005","0520","0136","928","285","643","76","1004","1977","0","50.78","14.42"
"10","010","00","005","0521","0000","601","206","395","71","672","1295","0","51.89","15.91"
"10","010","00","005","0521","0137","601","206","395","71","672","1295","0","51.89","15.91"
"10","010","00","005","0522","0000","2456","758","1698","167","2623","5171","0","50.73","14.66"
"10","010","00","005","0522","0112","753","225","528","46","799","1476","0","54.13","15.24"
"10","010","00","005","0522","0113","746","212","534","49","795","1583","0","50.22","13.39"
"10","010","00","005","0522","0114","326","111","215","28","354","758","0","46.7","14.64"
"10","010","00","005","0522","0115","631","210","421","44","675","1354","0","49.85","15.51"
"10","010","00","005","0523","0000","1194","388","806","145","1339","2377","0","56.33","16.32"
"10","010","00","005","0523","0116","591","182","409","101","692","1202","0","57.57","15.14"
"10","010","00","005","0523","0117","603","206","397","44","647","1175","0","55.06","17.53"
"10","010","00","005","0524","0000","1076","311","765","120","1196","2371","0","50.44","13.12"
"10","010","00","005","0524","0122","439","121","318","57","496","1019","0","48.68","11.87"
"10","010","00","005","0524","0123","637","190","447","63","700","1352","0","51.78","14.05"
"10","010","00","005","0525","0000","1251","447","804","120","1371","2563","0","53.49","17.44"
"10","010","00","005","0525","0124","820","297","523","77","897","1620","0","55.37","18.33"
"10","010","00","005","0525","0125","431","150","281","43","474","943","0","50.27","15.91"
"10","010","00","005","0526","0000","737","215","522","60","797","1720","0","46.34","12.5"
"10","010","00","005","0526","0126","737","215","522","60","797","1720","0","46.34","12.5"
"10","010","00","005","0527","0000","1483","472","1011","132","1615","2973","0","54.32","15.88"
"10","010","00","005","0527","0130","720","228","492","63","783","1413","0","55.41","16.14"
"10","010","00","005","0527","0131","763","244","519","69","832","1560","0","53.33","15.64"
"10","010","00","005","0528","0000","3126","1002","2124","170","3296","6395","0","51.54","15.67"
"10","010","00","005","0528","0118","679","238","441","45","724","1423","0","50.88","16.73"
"10","010","00","005","0528","0119","813","240","573","37","850","1612","0","52.73","14.89"
"10","010","00","005","0528","0120","901","286","615","34","935","1695","0","55.16","16.87"
"10","010","00","005","0528","0121","733","238","495","54","787","1665","0","47.27","14.29"
"10","010","00","006","0000","0000","5894","2024","3870","726","6620","13105","14670","50.52","15.44"
"10","010","00","006","0601","0000","654","221","433","99","753","1318","0","57.13","16.77"
"10","010","00","006","0601","0194","654","221","433","99","753","1318","0","57.13","16.77"
"10","010","00","006","0602","0000","347","128","219","48","395","677","0","58.35","18.91"
"10","010","00","006","0602","0195","347","128","219","48","395","677","0","58.35","18.91"
"10","010","00","006","0603","0000","329","105","224","35","364","690","0","52.75","15.22"
"10","010","00","006","0603","0196","194","60","134","17","211","417","0","50.6","14.39"
"10","010","00","006","0603","0197","135","45","90","18","153","273","0","56.04","16.48"
"10","010","00","006","0604","0000","391","109","282","37","428","1003","0","42.67","10.87"
"10","010","00","006","0604","0210","391","109","282","37","428","1003","0","42.67","10.87"
"10","010","00","006","0605","0000","273","97","176","23","296","701","0","42.23","13.84"
"10","010","00","006","0605","0209","273","97","176","23","296","701","0","42.23","13.84"
"10","010","00","006","0606","0000","389","132","257","44","433","786","0","55.09","16.79"
"10","010","00","006","0606","0203","389","132","257","44","433","786","0","55.09","16.79"
"10","010","00","006","0607","0000","342","119","223","44","386","807","0","47.83","14.75"
"10","010","00","006","0607","0204","342","119","223","44","386","807","0","47.83","14.75"
"10","010","00","006","0608","0000","430","144","286","24","454","1168","0","38.87","12.33"
"10","010","00","006","0608","0205","430","144","286","24","454","1168","0","38.87","12.33"
"10","010","00","006","0609","0000","489","176","313","99","588","1052","0","55.89","16.73"
"10","010","00","006","0609","0206","489","176","313","99","588","1052","0","55.89","16.73"
"10","010","00","006","0610","0000","424","139","285","70","494","953","0","51.84","14.59"
"10","010","00","006","0610","0207","244","87","157","41","285","565","0","50.44","15.4"
"10","010","00","006","0610","0208","180","52","128","29","209","388","0","53.87","13.4"
"10","010","00","006","0611","0000","628","223","405","76","704","1294","0","54.4","17.23"
"10","010","00","006","0611","0198","464","154","310","66","530","908","0","58.37","16.96"
"10","010","00","006","0611","0199","164","69","95","10","174","386","0","45.08","17.88"
"10","010","00","006","0612","0000","519","192","327","57","576","1039","0","55.44","18.48"
"10","010","00","006","0612","0200","519","192","327","57","576","1039","0","55.44","18.48"
"10","010","00","006","0613","0000","283","102","181","48","331","708","0","46.75","14.41"
"10","010","00","006","0613","0201","283","102","181","48","331","708","0","46.75","14.41"
"10","010","00","006","0614","0000","396","137","259","22","418","909","0","45.98","15.07"
"10","010","00","006","0614","0202","396","137","259","22","418","909","0","45.98","15.07"
"10","010","00","007","0000","0000","12927","4330","8597","1648","14575","27342","31755","53.31","15.84"
"10","010","00","007","0701","0000","1224","404","820","97","1321","2203","0","59.96","18.34"
"10","010","00","007","0701","0138","547","176","371","35","582","1087","0","53.54","16.19"
"10","010","00","007","0701","0139","677","228","449","62","739","1116","0","66.22","20.43"
"10","010","00","007","0702","0000","734","256","478","118","852","1567","0","54.37","16.34"
"10","010","00","007","0702","0140","359","115","244","53","412","740","0","55.68","15.54"
"10","010","00","007","0702","0141","375","141","234","65","440","827","0","53.2","17.05"
"10","010","00","007","0703","0000","801","283","518","107","908","1472","0","61.68","19.23"
"10","010","00","007","0703","0142","377","122","255","55","432","704","0","61.36","17.33"
"10","010","00","007","0703","0143","424","161","263","52","476","768","0","61.98","20.96"
"10","010","00","007","0704","0000","793","282","511","109","902","1611","0","55.99","17.5"
"10","010","00","007","0704","0144","409","155","254","47","456","761","0","59.92","20.37"
"10","010","00","007","0704","0145","384","127","257","62","446","850","0","52.47","14.94"
"10","010","00","007","0705","0000","638","198","440","63","701","1327","0","52.83","14.92"
"10","010","00","007","0705","0146","638","198","440","63","701","1327","0","52.83","14.92"
"10","010","00","007","0706","0000","730","260","470","153","883","1572","0","56.17","16.54"
"10","010","00","007","0706","0147","358","124","234","61","419","756","0","55.42","16.4"
"10","010","00","007","0706","0148","372","136","236","92","464","816","0","56.86","16.67"
"10","010","00","007","0707","0000","728","250","478","84","812","1609","0","50.47","15.54"
"10","010","00","007","0707","0149","284","99","185","26","310","667","0","46.48","14.84"
"10","010","00","007","0707","0150","444","151","293","58","502","942","0","53.29","16.03"
"10","010","00","007","0708","0000","371","109","262","71","442","918","0","48.15","11.87"
"10","010","00","007","0708","0151","371","109","262","71","442","918","0","48.15","11.87"
"10","010","00","007","0709","0000","221","60","161","18","239","554","0","43.14","10.83"
"10","010","00","007","0709","0152","221","60","161","18","239","554","0","43.14","10.83"
"10","010","00","007","0710","0000","309","39","270","46","355","929","0","38.21","4.2"
"10","010","00","007","0710","0153","309","39","270","46","355","929","0","38.21","4.2"
"10","010","00","007","0711","0000","161","70","91","44","205","487","0","42.09","14.37"
"10","010","00","007","0711","0154","161","70","91","44","205","487","0","42.09","14.37"
"10","010","00","007","0712","0000","225","64","161","45","270","487","0","55.44","13.14"
"10","010","00","007","0712","0155","225","64","161","45","270","487","0","55.44","13.14"
"10","010","00","007","0713","0000","792","292","500","100","892","1681","0","53.06","17.37"
"10","010","00","007","0713","0156","376","143","233","47","423","836","0","50.6","17.11"
"10","010","00","007","0713","0157","416","149","267","53","469","845","0","55.5","17.63"
"10","010","00","007","0714","0000","793","311","482","94","887","1587","0","55.89","19.6"
"10","010","00","007","0714","0158","416","168","248","46","462","834","0","55.4","20.14"
"10","010","00","007","0714","0159","377","143","234","48","425","753","0","56.44","18.99"
"10","010","00","007","0715","0000","616","207","409","87","703","1328","0","52.94","15.59"
"10","010","00","007","0715","0160","616","207","409","87","703","1328","0","52.94","15.59"
"10","010","00","007","0716","0000","791","244","547","56","847","1400","0","60.5","17.43"
"10","010","00","007","0716","0163","791","244","547","56","847","1400","0","60.5","17.43"
"10","010","00","007","0717","0000","553","187","366","67","620","1043","0","59.44","17.93"
"10","010","00","007","0717","0162","553","187","366","67","620","1043","0","59.44","17.93"
"10","010","00","007","0718","0000","510","177","333","46","556","969","0","57.38","18.27"
"10","010","00","007","0718","0161","510","177","333","46","556","969","0","57.38","18.27"
"10","010","00","007","0719","0000","335","112","223","30","365","1017","0","35.89","11.01"
"10","010","00","007","0719","0164","335","112","223","30","365","1017","0","35.89","11.01"
"10","010","00","007","0720","0000","467","152","315","52","519","1132","0","45.85","13.43"
"10","010","00","007","0720","0165","467","152","315","52","519","1132","0","45.85","13.43"
"10","010","00","007","0721","0000","467","161","306","73","540","1037","0","52.07","15.53"
"10","010","00","007","0721","0166","467","161","306","73","540","1037","0","52.07","15.53"
"10","010","00","007","0722","0000","270","82","188","63","333","563","0","59.15","14.56"
"10","010","00","007","0722","0167","270","82","188","63","333","563","0","59.15","14.56"
"10","010","00","007","0723","0000","398","130","268","25","423","849","0","49.82","15.31"
"10","010","00","007","0723","0168","398","130","268","25","423","849","0","49.82","15.31"
"10","010","00","008","0000","0000","7850","2568","5282","873","8723","20821","23049","41.9","12.33"
"10","010","00","008","0801","0000","477","146","331","35","512","1165","0","43.95","12.53"
"10","010","00","008","0801","0268","477","146","331","35","512","1165","0","43.95","12.53"
"10","010","00","008","0802","0000","263","76","187","21","284","825","0","34.42","9.21"
"10","010","00","008","0802","0269","263","76","187","21","284","825","0","34.42","9.21"
"10","010","00","008","0803","0000","355","120","235","30","385","850","0","45.29","14.12"
"10","010","00","008","0803","0270","355","120","235","30","385","850","0","45.29","14.12"
"10","010","00","008","0804","0000","114","38","76","18","132","222","0","59.46","17.12"
"10","010","00","008","0804","0271","114","38","76","18","132","222","0","59.46","17.12"
"10","010","00","008","0805","0000","537","200","337","57","594","1216","0","48.85","16.45"
"10","010","00","008","0805","0272","537","200","337","57","594","1216","0","48.85","16.45"
"10","010","00","008","0806","0000","421","141","280","44","465","1200","0","38.75","11.75"
"10","010","00","008","0806","0273","421","141","280","44","465","1200","0","38.75","11.75"
"10","010","00","008","0807","0000","369","122","247","41","410","877","0","46.75","13.91"
"10","010","00","008","0807","0274","369","122","247","41","410","877","0","46.75","13.91"
"10","010","00","008","0808","0000","236","93","143","37","273","644","0","42.39","14.44"
"10","010","00","008","0808","0275","236","93","143","37","273","644","0","42.39","14.44"
"10","010","00","008","0809","0000","236","79","157","18","254","761","0","33.38","10.38"
"10","010","00","008","0809","0276","198","69","129","16","214","594","0","36.03","11.62"
"10","010","00","008","0809","0277","38","10","28","2","40","167","0","23.95","5.99"
"10","010","00","008","0810","0000","233","75","158","47","280","714","0","39.22","10.5"
"10","010","00","008","0810","0283","233","75","158","47","280","714","0","39.22","10.5"
"10","010","00","008","0811","0000","449","138","311","65","514","1051","0","48.91","13.13"
"10","010","00","008","0811","0284","449","138","311","65","514","1051","0","48.91","13.13"
"10","010","00","008","0812","0000","423","142","281","61","484","934","0","51.82","15.2"
"10","010","00","008","0812","0285","423","142","281","61","484","934","0","51.82","15.2"
"10","010","00","008","0813","0000","457","147","310","57","514","1044","0","49.23","14.08"
"10","010","00","008","0813","0286","457","147","310","57","514","1044","0","49.23","14.08"
"10","010","00","008","0814","0000","591","187","404","38","629","1476","0","42.62","12.67"
"10","010","00","008","0814","0287","591","187","404","38","629","1476","0","42.62","12.67"
"10","010","00","008","0815","0000","203","69","134","21","224","618","0","36.25","11.17"
"10","010","00","008","0815","0288","203","69","134","21","224","618","0","36.25","11.17"
"10","010","00","008","0816","0000","124","42","82","38","162","478","0","33.89","8.79"
"10","010","00","008","0816","0289","124","42","82","38","162","478","0","33.89","8.79"
"10","010","00","008","0817","0000","192","61","131","44","236","642","0","36.76","9.5"
"10","010","00","008","0817","0290","192","61","131","44","236","642","0","36.76","9.5"
"10","010","00","008","0818","0000","277","91","186","9","286","883","0","32.39","10.31"
"10","010","00","008","0818","0291","277","91","186","9","286","883","0","32.39","10.31"
"10","010","00","008","0819","0000","584","192","392","55","639","1391","0","45.94","13.8"
"10","010","00","008","0819","0278","70","28","42","2","72","204","0","35.29","13.73"
"10","010","00","008","0819","0279","86","38","48","3","89","234","0","38.03","16.24"
"10","010","00","008","0819","0280","141","35","106","4","145","361","0","40.17","9.7"
"10","010","00","008","0819","0281","287","91","196","46","333","592","0","56.25","15.37"
"10","010","00","008","0820","0000","277","86","191","35","312","619","0","50.4","13.89"
"10","010","00","008","0820","0282","277","86","191","35","312","619","0","50.4","13.89"
"10","010","00","008","0821","0000","229","59","170","11","240","739","0","32.48","7.98"
"10","010","00","008","0821","0292","229","59","170","11","240","739","0","32.48","7.98"
"10","010","00","008","0822","0000","192","72","120","26","218","554","0","39.35","13.0"
"10","010","00","008","0822","0293","192","72","120","26","218","554","0","39.35","13.0"
"10","010","00","008","0823","0000","194","59","135","25","219","649","0","33.74","9.09"
"10","010","00","008","0823","0294","194","59","135","25","219","649","0","33.74","9.09"
"10","010","00","008","0824","0000","223","75","148","21","244","689","0","35.41","10.89"
"10","010","00","008","0824","0295","223","75","148","21","244","689","0","35.41","10.89"
"10","010","00","008","0825","0000","194","58","136","19","213","580","0","36.72","10.0"
"10","010","00","008","0825","0296","159","46","113","17","176","455","0","38.68","10.11"
"10","010","00","008","0825","0297","35","12","23","2","37","125","0","29.6","9.6"
"10","010","00","009","0000","0000","7886","2179","5707","985","8871","21915","24658","40.48","9.94"
"10","010","00","009","0901","0000","812","212","600","68","880","1915","0","45.95","11.07"
"10","010","00","009","0901","0298","812","212","600","68","880","1915","0","45.95","11.07"
"10","010","00","009","0902","0000","328","107","221","50","378","938","0","40.3","11.41"
"10","010","00","009","0902","0299","328","107","221","50","378","938","0","40.3","11.41"
"10","010","00","009","0903","0000","371","112","259","30","401","1366","0","29.36","8.2"
"10","010","00","009","0903","0300","371","112","259","30","401","1366","0","29.36","8.2"
"10","010","00","009","0904","0000","632","146","486","5","637","1676","0","38.01","8.71"
"10","010","00","009","0904","0301","632","146","486","5","637","1676","0","38.01","8.71"
"10","010","00","009","0905","0000","399","119","280","75","474","1151","0","41.18","10.34"
"10","010","00","009","0905","0302","399","119","280","75","474","1151","0","41.18","10.34"
"10","010","00","009","0906","0000","263","74","189","58","321","716","0","44.83","10.34"
"10","010","00","009","0906","0303","263","74","189","58","321","716","0","44.83","10.34"
"10","010","00","009","0907","0000","114","19","95","17","131","387","0","33.85","4.91"
"10","010","00","009","0907","0304","114","19","95","17","131","387","0","33.85","4.91"
"10","010","00","009","0908","0000","232","58","174","16","248","864","0","28.7","6.71"
"10","010","00","009","0908","0305","232","58","174","16","248","864","0","28.7","6.71"
"10","010","00","009","0909","0000","277","86","191","20","297","910","0","32.64","9.45"
"10","010","00","009","0909","0306","277","86","191","20","297","910","0","32.64","9.45"
"10","010","00","009","0910","0000","250","64","186","15","265","760","0","34.87","8.42"
"10","010","00","009","0910","0307","250","64","186","15","265","760","0","34.87","8.42"
"10","010","00","009","0911","0000","141","31","110","26","167","378","0","44.18","8.2"
"10","010","00","009","0911","0308","73","14","59","14","87","166","0","52.41","8.43"
"10","010","00","009","0911","0309","68","17","51","12","80","212","0","37.74","8.02"
"10","010","00","009","0912","0000","292","80","212","39","331","993","0","33.33","8.06"
"10","010","00","009","0912","0310","292","80","212","39","331","993","0","33.33","8.06"
"10","010","00","009","0913","0000","482","140","342","74","556","1226","0","45.35","11.42"
"10","010","00","009","0913","0314","482","140","342","74","556","1226","0","45.35","11.42"
"10","010","00","009","0914","0000","305","101","204","62","367","843","0","43.53","11.98"
"10","010","00","009","0914","0315","305","101","204","62","367","843","0","43.53","11.98"
"10","010","00","009","0915","0000","259","81","178","30","289","693","0","41.7","11.69"
"10","010","00","009","0915","0316","259","81","178","30","289","693","0","41.7","11.69"
"10","010","00","009","0916","0000","367","95","272","45","412","839","0","49.11","11.32"
"10","010","00","009","0916","0317","367","95","272","45","412","839","0","49.11","11.32"
"10","010","00","009","0917","0000","249","72","177","26","275","684","0","40.2","10.53"
"10","010","00","009","0917","0318","149","38","111","14","163","363","0","44.9","10.47"
"10","010","00","009","0917","0319","100","34","66","12","112","321","0","34.89","10.59"
"10","010","00","009","0918","0000","505","132","373","91","596","1083","0","55.03","12.19"
"10","010","00","009","0918","0320","505","132","373","91","596","1083","0","55.03","12.19"
"10","010","00","009","0919","0000","366","118","248","50","416","901","0","46.17","13.1"
"10","010","00","009","0919","0321","366","118","248","50","416","901","0","46.17","13.1"
"10","010","00","009","0920","0000","366","91","275","40","406","1216","0","33.39","7.48"
"10","010","00","009","0920","0322","366","91","275","40","406","1216","0","33.39","7.48"
"10","010","00","009","0921","0000","345","100","245","59","404","789","0","51.2","12.67"
"10","010","00","009","0921","0323","202","60","142","47","249","418","0","59.57","14.35"
"10","010","00","009","0921","0324","143","40","103","12","155","371","0","41.78","10.78"
"10","010","00","009","0922","0000","106","26","80","13","119","306","0","38.89","8.5"
"10","010","00","009","0922","0311","106","26","80","13","119","306","0","38.89","8.5"
"10","010","00","009","0923","0000","425","115","310","76","501","1281","0","39.11","8.98"
"10","010","00","009","0923","0312","351","99","252","60","411","1046","0","39.29","9.46"
"10","010","00","009","0923","0313","74","16","58","16","90","235","0","38.3","6.81"
"10","010","00","010","0000","0000","7479","2458","5021","910","8389","16647","18297","50.39","14.77"
"10","010","00","010","1001","0000","317","98","219","44","361","705","0","51.21","13.9"
"10","010","00","010","1001","0354","206","65","141","25","231","482","0","47.93","13.49"
"10","010","00","010","1001","0355","111","33","78","19","130","223","0","58.3","14.8"
"10","010","00","010","1002","0000","723","256","467","101","824","1529","0","53.89","16.74"
"10","010","00","010","1002","0356","723","256","467","101","824","1529","0","53.89","16.74"
"10","010","00","010","1003","0000","589","194","395","70","659","1175","0","56.09","16.51"
"10","010","00","010","1003","0357","589","194","395","70","659","1175","0","56.09","16.51"
"10","010","00","010","1004","0000","494","150","344","53","547","886","0","61.74","16.93"
"10","010","00","010","1004","0358","494","150","344","53","547","886","0","61.74","16.93"
"10","010","00","010","1005","0000","303","99","204","32","335","743","0","45.09","13.32"
"10","010","00","010","1005","0359","303","99","204","32","335","743","0","45.09","13.32"
"10","010","00","010","1006","0000","590","203","387","90","680","1236","0","55.02","16.42"
"10","010","00","010","1006","0360","590","203","387","90","680","1236","0","55.02","16.42"
"10","010","00","010","1007","0000","173","58","115","21","194","377","0","51.46","15.38"
"10","010","00","010","1007","0361","173","58","115","21","194","377","0","51.46","15.38"
"10","010","00","010","1008","0000","184","59","125","29","213","440","0","48.41","13.41"
"10","010","00","010","1008","0362","129","44","85","25","154","338","0","45.56","13.02"
"10","010","00","010","1008","0363","55","15","40","4","59","102","0","57.84","14.71"
"10","010","00","010","1009","0000","313","112","201","22","335","763","0","43.91","14.68"
"10","010","00","010","1009","0364","313","112","201","22","335","763","0","43.91","14.68"
"10","010","00","010","1010","0000","216","69","147","31","247","429","0","57.58","16.08"
"10","010","00","010","1010","0365","216","69","147","31","247","429","0","57.58","16.08"
"10","010","00","010","1011","0000","191","55","136","21","212","427","0","49.65","12.88"
"10","010","00","010","1011","0366","191","55","136","21","212","427","0","49.65","12.88"
"10","010","00","010","1012","0000","285","96","189","46","331","607","0","54.53","15.82"
"10","010","00","010","1012","0367","285","96","189","46","331","607","0","54.53","15.82"
"10","010","00","010","1013","0000","638","206","432","45","683","1486","0","45.96","13.86"
"10","010","00","010","1013","0368","638","206","432","45","683","1486","0","45.96","13.86"
"10","010","00","010","1014","0000","418","129","289","62","480","835","0","57.49","15.45"
"10","010","00","010","1014","0369","418","129","289","62","480","835","0","57.49","15.45"
"10","010","00","010","1015","0000","294","106","188","60","354","816","0","43.38","12.99"
"10","010","00","010","1015","0370","294","106","188","60","354","816","0","43.38","12.99"
"10","010","00","010","1016","0000","323","124","199","61","384","833","0","46.1","14.89"
"10","010","00","010","1016","0371","323","124","199","61","384","833","0","46.1","14.89"
"10","010","00","010","1017","0000","200","50","150","14","214","433","0","49.42","11.55"
"10","010","00","010","1017","0372","200","50","150","14","214","433","0","49.42","11.55"
"10","010","00","010","1018","0000","239","87","152","6","245","558","0","43.91","15.59"
"10","010","00","010","1018","0373","239","87","152","6","245","558","0","43.91","15.59"
"10","010","00","010","1019","0000","322","104","218","43","365","742","0","49.19","14.02"
"10","010","00","010","1019","0374","271","94","177","42","313","602","0","51.99","15.61"
"10","010","00","010","1019","0375","51","10","41","1","52","140","0","37.14","7.14"
"10","010","00","010","1020","0000","158","58","100","21","179","393","0","45.55","14.76"
"10","010","00","010","1020","0376","158","58","100","21","179","393","0","45.55","14.76"
"10","010","00","010","1021","0000","267","77","190","24","291","585","0","49.74","13.16"
"10","010","00","010","1021","0377","267","77","190","24","291","585","0","49.74","13.16"
"10","010","00","010","1022","0000","242","68","174","14","256","649","0","39.45","10.48"
"10","010","00","010","1022","0378","175","48","127","7","182","526","0","34.6","9.13"
"10","010","00","010","1022","0379","67","20","47","7","74","123","0","60.16","16.26"
"10","010","00","011","0000","0000","5722","1996","3726","841","6563","13937","15422","47.09","14.32"
"10","010","00","011","1101","0000","210","84","126","31","241","522","0","46.17","16.09"
"10","010","00","011","1101","0034","210","84","126","31","241","522","0","46.17","16.09"
"10","010","00","011","1102","0000","263","112","151","41","304","563","0","54.0","19.89"
"10","010","00","011","1102","0035","263","112","151","41","304","563","0","54.0","19.89"
"10","010","00","011","1103","0000","572","191","381","73","645","1304","0","49.46","14.65"
"10","010","00","011","1103","0036","572","191","381","73","645","1304","0","49.46","14.65"
"10","010","00","011","1104","0000","607","198","409","53","660","1312","0","50.3","15.09"
"10","010","00","011","1104","0037","607","198","409","53","660","1312","0","50.3","15.09"
"10","010","00","011","1105","0000","246","76","170","10","256","738","0","34.69","10.3"
"10","010","00","011","1105","0038","139","44","95","7","146","320","0","45.63","13.75"
"10","010","00","011","1105","0039","107","32","75","3","110","418","0","26.32","7.66"
"10","010","00","011","1106","0000","386","128","258","59","445","1025","0","43.41","12.49"
"10","010","00","011","1106","0040","386","128","258","59","445","1025","0","43.41","12.49"
"10","010","00","011","1107","0000","166","65","101","20","186","451","0","41.24","14.41"
"10","010","00","011","1107","0041","166","65","101","20","186","451","0","41.24","14.41"
"10","010","00","011","1108","0000","351","95","256","94","445","830","0","53.61","11.45"
"10","010","00","011","1108","0042","351","95","256","94","445","830","0","53.61","11.45"
"10","010","00","011","1109","0000","421","145","276","69","490","1050","0","46.67","13.81"
"10","010","00","011","1109","0043","421","145","276","69","490","1050","0","46.67","13.81"
"10","010","00","011","1110","0000","326","108","218","72","398","972","0","40.95","11.11"
"10","010","00","011","1110","0044","326","108","218","72","398","972","0","40.95","11.11"
"10","010","00","011","1111","0000","392","140","252","54","446","962","0","46.36","14.55"
"10","010","00","011","1111","0045","392","140","252","54","446","962","0","46.36","14.55"
"10","010","00","011","1112","0000","410","151","259","73","483","940","0","51.38","16.06"
"10","010","00","011","1112","0046","293","124","169","53","346","678","0","51.03","18.29"
"10","010","00","011","1112","0047","117","27","90","20","137","262","0","52.29","10.31"
"10","010","00","011","1113","0000","441","153","288","58","499","1212","0","41.17","12.62"
"10","010","00","011","1113","0048","343","124","219","48","391","906","0","43.16","13.69"
"10","010","00","011","1113","0049","98","29","69","10","108","306","0","35.29","9.48"
"10","010","00","011","1114","0000","646","201","445","95","741","1435","0","51.64","14.01"
"10","010","00","011","1114","0050","472","149","323","72","544","1062","0","51.22","14.03"
"10","010","00","011","1114","0051","174","52","122","23","197","373","0","52.82","13.94"
"10","010","00","011","1115","0000","285","149","136","39","324","621","0","52.17","23.99"
"10","010","00","011","1115","0052","152","49","103","23","175","324","0","54.01","15.12"
"10","010","00","011","1115","0053","133","100","33","16","149","297","0","50.17","33.67"
"10","010","00","012","0000","0000","21321","6712","14609","1928","23249","43857","49406","53.01","15.3"
"10","010","00","012","1201","0000","1921","624","1297","155","2076","3971","0","52.28","15.71"
"10","010","00","012","1201","0054","486","154","332","29","515","1024","0","50.29","15.04"
"10","010","00","012","1201","0055","559","190","369","56","615","1015","0","60.59","18.72"
"10","010","00","012","1201","0056","876","280","596","70","946","1932","0","48.96","14.49"
"10","010","00","012","1202","0000","1341","417","924","108","1449","2475","0","58.55","16.85"
"10","010","00","012","1202","0057","648","214","434","35","683","1170","0","58.38","18.29"
"10","010","00","012","1202","0058","693","203","490","73","766","1305","0","58.7","15.56"
"10","010","00","012","1203","0000","834","300","534","110","944","1564","0","60.36","19.18"
"10","010","00","012","1203","0066","357","133","224","56","413","626","0","65.97","21.25"
"10","010","00","012","1203","0067","308","118","190","31","339","570","0","59.47","20.7"
"10","010","00","012","1203","0068","169","49","120","23","192","368","0","52.17","13.32"
"10","010","00","012","1204","0000","963","349","614","153","1116","2102","0","53.09","16.6"
"10","010","00","012","1204","0069","444","160","284","92","536","1037","0","51.69","15.43"
"10","010","00","012","1204","0070","519","189","330","61","580","1065","0","54.46","17.75"
"10","010","00","012","1205","0000","438","144","294","72","510","802","0","63.59","17.96"
"10","010","00","012","1205","0071","438","144","294","72","510","802","0","63.59","17.96"
"10","010","00","012","1206","0000","708","242","466","70","778","1566","0","49.68","15.45"
"10","010","00","012","1206","0059","567","190","377","52","619","1242","0","49.84","15.3"
"10","010","00","012","1206","0060","141","52","89","18","159","324","0","49.07","16.05"
"10","010","00","012","1207","0000","883","274","609","86","969","1838","0","52.72","14.91"
"10","010","00","012","1207","0061","300","89","211","25","325","622","0","52.25","14.31"
"10","010","00","012","1207","0062","583","185","398","61","644","1216","0","52.96","15.21"
"10","010","00","012","1208","0000","978","320","658","61","1039","1791","0","58.01","17.87"
"10","010","00","012","1208","0063","529","161","368","29","558","1020","0","54.71","15.78"
"10","010","00","012","1208","0064","449","159","290","32","481","771","0","62.39","20.62"
"10","010","00","012","1209","0000","255","66","189","22","277","441","0","62.81","14.97"
"10","010","00","012","1209","0065","255","66","189","22","277","441","0","62.81","14.97"
"10","010","00","012","1210","0000","341","109","232","32","373","641","0","58.19","17.0"
"10","010","00","012","1210","0074","341","109","232","32","373","641","0","58.19","17.0"
"10","010","00","012","1211","0000","224","68","156","16","240","408","0","58.82","16.67"
"10","010","00","012","1211","0075","224","68","156","16","240","408","0","58.82","16.67"
"10","010","00","012","1212","0000","662","223","439","68","730","1363","0","53.56","16.36"
"10","010","00","012","1212","0076","409","146","263","49","458","794","0","57.68","18.39"
"10","010","00","012","1212","0077","253","77","176","19","272","569","0","47.8","13.53"
"10","010","00","012","1213","0000","927","332","595","46","973","1948","0","49.95","17.04"
"10","010","00","012","1213","0072","927","332","595","46","973","1948","0","49.95","17.04"
"10","010","00","012","1214","0000","464","149","315","65","529","1028","0","51.46","14.49"
"10","010","00","012","1214","0073","464","149","315","65","529","1028","0","51.46","14.49"
"10","010","00","012","1215","0000","1039","349","690","75","1114","2035","0","54.74","17.15"
"10","010","00","012","1215","0080","1039","349","690","75","1114","2035","0","54.74","17.15"
"10","010","00","012","1216","0000","969","314","655","90","1059","1987","0","53.3","15.8"
"10","010","00","012","1216","0081","969","314","655","90","1059","1987","0","53.3","15.8"
"10","010","00","012","1217","0000","887","250","637","117","1004","1766","0","56.85","14.16"
"10","010","00","012","1217","0078","414","120","294","37","451","806","0","55.96","14.89"
"10","010","00","012","1217","0079","473","130","343","80","553","960","0","57.6","13.54"
"10","010","00","012","1218","0000","1904","541","1363","146","2050","4310","0","47.56","12.55"
"10","010","00","012","1218","0083","1032","280","752","81","1113","2208","0","50.41","12.68"
"10","010","00","012","1218","0084","872","261","611","65","937","2102","0","44.58","12.42"
"10","010","00","012","1219","0000","1447","437","1010","117","1564","2980","0","52.48","14.66"
"10","010","00","012","1219","0085","600","163","437","57","657","1309","0","50.19","12.45"
"10","010","00","012","1219","0086","847","274","573","60","907","1671","0","54.28","16.4"
"10","010","00","012","1220","0000","917","266","651","87","1004","1919","0","52.32","13.86"
"10","010","00","012","1220","0089","917","266","651","87","1004","1919","0","52.32","13.86"
"10","010","00","012","1221","0000","831","240","591","62","893","1772","0","50.4","13.54"
"10","010","00","012","1221","0088","831","240","591","62","893","1772","0","50.4","13.54"
"10","010","00","012","1222","0000","392","93","299","21","413","912","0","45.29","10.2"
"10","010","00","012","1222","0090","392","93","299","21","413","912","0","45.29","10.2"
"10","010","00","012","1223","0000","483","132","351","22","505","992","0","50.91","13.31"
"10","010","00","012","1223","0091","483","132","351","22","505","992","0","50.91","13.31"
"10","010","00","012","1224","0000","524","166","358","45","569","1270","0","44.8","13.07"
"10","010","00","012","1224","0092","524","166","358","45","569","1270","0","44.8","13.07"
"10","010","00","012","1225","0000","588","186","402","36","624","1154","0","54.07","16.12"
"10","010","00","012","1225","0082","588","186","402","36","624","1154","0","54.07","16.12"
"10","010","00","012","1226","0000","401","121","280","46","447","822","0","54.38","14.72"
"10","010","00","012","1226","0087","401","121","280","46","447","822","0","54.38","14.72"
"10","010","00","013","0000","0000","16865","5328","11537","1466","18331","39139","44605","46.84","13.61"
"10","010","00","013","1301","0000","737","245","492","91","828","1809","0","45.77","13.54"
"10","010","00","013","1301","0392","737","245","492","91","828","1809","0","45.77","13.54"
"10","010","00","013","1302","0000","436","144","292","23","459","953","0","48.16","15.11"
"10","010","00","013","1302","0393","436","144","292","23","459","953","0","48.16","15.11"
"10","010","00","013","1303","0000","337","92","245","19","356","828","0","43.0","11.11"
"10","010","00","013","1303","0401","337","92","245","19","356","828","0","43.0","11.11"
"10","010","00","013","1304","0000","390","126","264","32","422","879","0","48.01","14.33"
"10","010","00","013","1304","0400","390","126","264","32","422","879","0","48.01","14.33"
"10","010","00","013","1305","0000","599","178","421","68","667","1441","0","46.29","12.35"
"10","010","00","013","1305","0394","599","178","421","68","667","1441","0","46.29","12.35"
"10","010","00","013","1306","0000","1174","392","782","95","1269","2834","0","44.78","13.83"
"10","010","00","013","1306","0380","405","125","280","18","423","1046","0","40.44","11.95"
"10","010","00","013","1306","0381","769","267","502","77","846","1788","0","47.32","14.93"
"10","010","00","013","1307","0000","1463","500","963","99","1562","3311","0","47.18","15.1"
"10","010","00","013","1307","0382","745","252","493","42","787","1730","0","45.49","14.57"
"10","010","00","013","1307","0383","718","248","470","57","775","1581","0","49.02","15.69"
"10","010","00","013","1308","0000","3158","941","2217","191","3349","7060","0","47.44","13.33"
"10","010","00","013","1308","0384","625","193","432","54","679","1594","0","42.6","12.11"
"10","010","00","013","1308","0385","879","268","611","37","916","1801","0","50.86","14.88"
"10","010","00","013","1308","0386","863","231","632","62","925","1862","0","49.68","12.41"
"10","010","00","013","1308","0387","791","249","542","38","829","1803","0","45.98","13.81"
"10","010","00","013","1309","0000","2595","811","1784","217","2812","5642","0","49.84","14.37"
"10","010","00","013","1309","0388","725","211","514","46","771","1481","0","52.06","14.25"
"10","010","00","013","1309","0389","668","223","445","56","724","1366","0","53.0","16.33"
"10","010","00","013","1309","0390","635","191","444","80","715","1599","0","44.72","11.94"
"10","010","00","013","1309","0391","567","186","381","35","602","1196","0","50.33","15.55"
"10","010","00","013","1310","0000","792","230","562","75","867","1882","0","46.07","12.22"
"10","010","00","013","1310","0395","792","230","562","75","867","1882","0","46.07","12.22"
"10","010","00","013","1311","0000","532","164","368","17","549","1470","0","37.35","11.16"
"10","010","00","013","1311","0396","532","164","368","17","549","1470","0","37.35","11.16"
"10","010","00","013","1312","0000","840","246","594","91","931","2121","0","43.89","11.6"
"10","010","00","013","1312","0397","681","195","486","75","756","1699","0","44.5","11.48"
"10","010","00","013","1312","0398","159","51","108","16","175","422","0","41.47","12.09"
"10","010","00","013","1313","0000","443","152","291","69","512","1030","0","49.71","14.76"
"10","010","00","013","1313","0399","443","152","291","69","512","1030","0","49.71","14.76"
"10","010","00","013","1314","0000","580","180","400","71","651","1177","0","55.31","15.29"
"10","010","00","013","1314","0402","448","133","315","55","503","881","0","57.09","15.1"
"10","010","00","013","1314","0403","132","47","85","16","148","296","0","50.0","15.88"
"10","010","00","013","1315","0000","403","116","287","76","479","979","0","48.93","11.85"
"10","010","00","013","1315","0404","403","116","287","76","479","979","0","48.93","11.85"
"10","010","00","013","1316","0000","715","233","482","51","766","1938","0","39.53","12.02"
"10","010","00","013","1316","0405","514","164","350","44","558","1268","0","44.01","12.93"
"10","010","00","013","1316","0406","201","69","132","7","208","670","0","31.04","10.3"
"10","010","00","013","1317","0000","274","110","164","23","297","741","0","40.08","14.84"
"10","010","00","013","1317","0409","274","110","164","23","297","741","0","40.08","14.84"
"10","010","00","013","1318","0000","440","136","304","34","474","1000","0","47.4","13.6"
"10","010","00","013","1318","0410","223","70","153","9","232","518","0","44.79","13.51"
"10","010","00","013","1318","0411","217","66","151","25","242","482","0","50.21","13.69"
"10","010","00","013","1319","0000","316","124","192","39","355","648","0","54.78","19.14"
"10","010","00","013","1319","0408","316","124","192","39","355","648","0","54.78","19.14"
"10","010","00","013","1320","0000","364","119","245","67","431","754","0","57.16","15.78"
"10","010","00","013","1320","0407","364","119","245","67","431","754","0","57.16","15.78"
"10","010","00","013","1321","0000","139","50","89","8","147","348","0","42.24","14.37"
"10","010","00","013","1321","0412","139","50","89","8","147","348","0","42.24","14.37"
"10","010","00","013","1322","0000","138","39","99","10","148","294","0","50.34","13.27"
"10","010","00","013","1322","0413","138","39","99","10","148","294","0","50.34","13.27"
"10","010","00","014","0000","0000","14905","4432","10473","1194","16099","31228","35625","51.55","14.19"
"10","010","00","014","1401","0000","1274","417","857","66","1340","2522","0","53.13","16.53"
"10","010","00","014","1401","0414","645","221","424","40","685","1312","0","52.21","16.84"
"10","010","00","014","1401","0415","629","196","433","26","655","1210","0","54.13","16.2"
"10","010","00","014","1402","0000","1105","313","792","77","1182","2198","0","53.78","14.24"
"10","010","00","014","1402","0416","511","142","369","42","553","991","0","55.8","14.33"
"10","010","00","014","1402","0417","594","171","423","35","629","1207","0","52.11","14.17"
"10","010","00","014","1403","0000","321","128","193","15","336","752","0","44.68","17.02"
"10","010","00","014","1403","0418","321","128","193","15","336","752","0","44.68","17.02"
"10","010","00","014","1404","0000","419","140","279","66","485","833","0","58.22","16.81"
"10","010","00","014","1404","0419","419","140","279","66","485","833","0","58.22","16.81"
"10","010","00","014","1405","0000","619","174","445","75","694","1220","0","56.89","14.26"
"10","010","00","014","1405","0420","619","174","445","75","694","1220","0","56.89","14.26"
"10","010","00","014","1406","0000","337","111","226","17","354","616","0","57.47","18.02"
"10","010","00","014","1406","0421","337","111","226","17","354","616","0","57.47","18.02"
"10","010","00","014","1407","0000","478","125","353","50","528","1031","0","51.21","12.12"
"10","010","00","014","1407","0422","478","125","353","50","528","1031","0","51.21","12.12"
"10","010","00","014","1408","0000","2552","746","1806","151","2703","5283","0","51.16","14.12"
"10","010","00","014","1408","0423","608","160","448","61","669","1292","0","51.78","12.38"
"10","010","00","014","1408","0424","1037","315","722","65","1102","1995","0","55.24","15.79"
"10","010","00","014","1408","0425","907","271","636","25","932","1996","0","46.69","13.58"
"10","010","00","014","1409","0000","682","212","470","72","754","1449","0","52.04","14.63"
"10","010","00","014","1409","0426","682","212","470","72","754","1449","0","52.04","14.63"
"10","010","00","014","1410","0000","690","190","500","41","731","1420","0","51.48","13.38"
"10","010","00","014","1410","0427","690","190","500","41","731","1420","0","51.48","13.38"
"10","010","00","014","1411","0000","810","235","575","57","867","1590","0","54.53","14.78"
"10","010","00","014","1411","0428","810","235","575","57","867","1590","0","54.53","14.78"
"10","010","00","014","1412","0000","795","246","549","82","877","1785","0","49.13","13.78"
"10","010","00","014","1412","0429","365","102","263","32","397","771","0","51.49","13.23"
"10","010","00","014","1412","0430","430","144","286","50","480","1014","0","47.34","14.2"
"10","010","00","014","1413","0000","298","83","215","18","316","641","0","49.3","12.95"
"10","010","00","014","1413","0433","298","83","215","18","316","641","0","49.3","12.95"
"10","010","00","014","1414","0000","452","112","340","32","484","1014","0","47.73","11.05"
"10","010","00","014","1414","0431","112","34","78","8","120","327","0","36.7","10.4"
"10","010","00","014","1414","0432","340","78","262","24","364","687","0","52.98","11.35"
"10","010","00","014","1415","0000","432","120","312","22","454","857","0","52.98","14.0"
"10","010","00","014","1415","0434","251","71","180","8","259","474","0","54.64","14.98"
"10","010","00","014","1415","0435","181","49","132","14","195","383","0","50.91","12.79"
"10","010","00","014","1416","0000","340","90","250","37","377","619","0","60.9","14.54"
"10","010","00","014","1416","0436","340","90","250","37","377","619","0","60.9","14.54"
"10","010","00","014","1417","0000","809","255","554","96","905","1782","0","50.79","14.31"
"10","010","00","014","1417","0437","94","30","64","6","100","214","0","46.73","14.02"
"10","010","00","014","1417","0438","715","225","490","90","805","1568","0","51.34","14.35"
"10","010","00","014","1418","0000","273","73","200","29","302","658","0","45.9","11.09"
"10","010","00","014","1418","0439","273","73","200","29","302","658","0","45.9","11.09"
"10","010","00","014","1419","0000","226","73","153","28","254","434","0","58.53","16.82"
"10","010","00","014","1419","0440","226","73","153","28","254","434","0","58.53","16.82"
"10","010","00","014","1420","0000","877","271","606","100","977","1898","0","51.48","14.28"
"10","010","00","014","1420","0441","446","137","309","54","500","917","0","54.53","14.94"
"10","010","00","014","1420","0442","431","134","297","46","477","981","0","48.62","13.66"
"10","010","00","014","1421","0000","375","96","279","23","398","897","0","44.37","10.7"
"10","010","00","014","1421","0443","348","88","260","20","368","789","0","46.64","11.15"
"10","010","00","014","1421","0444","27","8","19","3","30","108","0","27.78","7.41"
"10","010","00","014","1422","0000","60","23","37","2","62","235","0","26.38","9.79"
"10","010","00","014","1422","0445","60","23","37","2","62","235","0","26.38","9.79"
"10","010","00","014","1423","0000","408","134","274","15","423","781","0","54.16","17.16"
"10","010","00","014","1423","0446","145","48","97","4","149","331","0","45.02","14.5"
"10","010","00","014","1423","0447","263","86","177","11","274","450","0","60.89","19.11"
"10","010","00","014","1424","0000","273","65","208","23","296","713","0","41.51","9.12"
"10","010","00","014","1424","0448","185","46","139","5","190","462","0","41.13","9.96"
"10","010","00","014","1424","0449","88","19","69","18","106","251","0","42.23","7.57"
"10","010","00","015","0000","0000","8500","2612","5888","875","9375","17083","19303","54.88","15.29"
"10","010","00","015","1501","0000","1156","390","766","121","1277","2286","0","55.86","17.06"
"10","010","00","015","1501","0211","506","170","336","29","535","1041","0","51.39","16.33"
"10","010","00","015","1501","0212","650","220","430","92","742","1245","0","59.6","17.67"
"10","010","00","015","1502","0000","507","176","331","63","570","917","0","62.16","19.19"
"10","010","00","015","1502","0213","507","176","331","63","570","917","0","62.16","19.19"
"10","010","00","015","1503","0000","296","116","180","48","344","545","0","63.12","21.28"
"10","010","00","015","1503","0217","296","116","180","48","344","545","0","63.12","21.28"
"10","010","00","015","1504","0000","2220","708","1512","159","2379","4404","0","54.02","16.08"
"10","010","00","015","1504","0214","596","190","406","43","639","1189","0","53.74","15.98"
"10","010","00","015","1504","0215","706","223","483","62","768","1388","0","55.33","16.07"
"10","010","00","015","1504","0216","918","295","623","54","972","1827","0","53.2","16.15"
"10","010","00","015","1505","0000","153","58","95","30","183","407","0","44.96","14.25"
"10","010","00","015","1505","0218","153","58","95","30","183","407","0","44.96","14.25"
"10","010","00","015","1506","0000","305","79","226","22","327","526","0","62.17","15.02"
"10","010","00","015","1506","0223","305","79","226","22","327","526","0","62.17","15.02"
"10","010","00","015","1507","0000","150","48","102","30","180","372","0","48.39","12.9"
"10","010","00","015","1507","0224","150","48","102","30","180","372","0","48.39","12.9"
"10","010","00","015","1508","0000","328","89","239","32","360","636","0","56.6","13.99"
"10","010","00","015","1508","0219","328","89","239","32","360","636","0","56.6","13.99"
"10","010","00","015","1509","0000","838","251","587","87","925","1674","0","55.26","14.99"
"10","010","00","015","1509","0221","838","251","587","87","925","1674","0","55.26","14.99"
"10","010","00","015","1510","0000","286","94","192","48","334","576","0","57.99","16.32"
"10","010","00","015","1510","0220","286","94","192","48","334","576","0","57.99","16.32"
"10","010","00","015","1511","0000","368","100","268","16","384","858","0","44.76","11.66"
"10","010","00","015","1511","0222","368","100","268","16","384","858","0","44.76","11.66"
"10","010","00","015","1512","0000","231","76","155","22","253","506","0","50.0","15.02"
"10","010","00","015","1512","0225","231","76","155","22","253","506","0","50.0","15.02"
"10","010","00","015","1513","0000","138","45","93","10","148","293","0","50.51","15.36"
"10","010","00","015","1513","0228","138","45","93","10","148","293","0","50.51","15.36"
"10","010","00","015","1514","0000","269","70","199","39","308","433","0","71.13","16.17"
"10","010","00","015","1514","0226","269","70","199","39","308","433","0","71.13","16.17"
"10","010","00","015","1515","0000","389","97","292","62","451","712","0","63.34","13.62"
"10","010","00","015","1515","0229","389","97","292","62","451","712","0","63.34","13.62"
"10","010","00","015","1516","0000","335","76","259","38","373","602","0","61.96","12.62"
"10","010","00","015","1516","0230","335","76","259","38","373","602","0","61.96","12.62"
"10","010","00","015","1517","0000","376","98","278","39","415","932","0","44.53","10.52"
"10","010","00","015","1517","0231","222","58","164","29","251","515","0","48.74","11.26"
"10","010","00","015","1517","0232","154","40","114","10","164","417","0","39.33","9.59"
"10","010","00","015","1518","0000","155","41","114","9","164","404","0","40.59","10.15"
"10","010","00","015","1518","0227","155","41","114","9","164","404","0","40.59","10.15"
"10","010","00","016","0000","0000","5214","1436","3778","453","5667","10156","11470","55.8","14.14"
"10","010","00","016","1601","0000","642","196","446","67","709","1174","0","60.39","16.7"
"10","010","00","016","1601","0450","642","196","446","67","709","1174","0","60.39","16.7"
"10","010","00","016","1602","0000","264","79","185","9","273","449","0","60.8","17.59"
"10","010","00","016","1602","0451","264","79","185","9","273","449","0","60.8","17.59"
"10","010","00","016","1603","0000","646","176","470","70","716","1304","0","54.91","13.5"
"10","010","00","016","1603","0452","416","108","308","36","452","753","0","60.03","14.34"
"10","010","00","016","1603","0453","230","68","162","34","264","551","0","47.91","12.34"
"10","010","00","016","1604","0000","929","296","633","77","1006","1791","0","56.17","16.53"
"10","010","00","016","1604","0454","929","296","633","77","1006","1791","0","56.17","16.53"
"10","010","00","016","1605","0000","484","147","337","54","538","849","0","63.37","17.31"
"10","010","00","016","1605","0455","484","147","337","54","538","849","0","63.37","17.31"
"10","010","00","016","1606","0000","463","140","323","37","500","866","0","57.74","16.17"
"10","010","00","016","1606","0456","463","140","323","37","500","866","0","57.74","16.17"
"10","010","00","016","1607","0000","639","168","471","57","696","1244","0","55.95","13.5"
"10","010","00","016","1607","0457","406","91","315","33","439","800","0","54.88","11.38"
"10","010","00","016","1607","0458","233","77","156","24","257","444","0","57.88","17.34"
"10","010","00","016","1608","0000","250","60","190","13","263","635","0","41.42","9.45"
"10","010","00","016","1608","0459","250","60","190","13","263","635","0","41.42","9.45"
"10","010","00","016","1609","0000","488","102","386","37","525","961","0","54.63","10.61"
"10","010","00","016","1609","0460","134","29","105","13","147","319","0","46.08","9.09"
"10","010","00","016","1609","0461","354","73","281","24","378","642","0","58.88","11.37"
"10","010","00","016","1610","0000","209","45","164","22","231","509","0","45.38","8.84"
"10","010","00","016","1610","0462","209","45","164","22","231","509","0","45.38","8.84"
"10","010","00","016","1611","0000","200","27","173","10","210","374","0","56.15","7.22"
"10","010","00","016","1611","0463","88","10","78","1","89","162","0","54.94","6.17"
"10","010","00","016","1611","0464","112","17","95","9","121","212","0","57.08","8.02"
"10","010","00","017","0000","0000","2031","634","1397","157","2188","3999","4592","54.71","15.85"
"10","010","00","017","1701","0000","733","249","484","78","811","1468","0","55.25","16.96"
"10","010","00","017","1701","0465","733","249","484","78","811","1468","0","55.25","16.96"
"10","010","00","017","1702","0000","285","87","198","15","300","624","0","48.08","13.94"
"10","010","00","017","1702","0466","121","37","84","5","126","320","0","39.38","11.56"
"10","010","00","017","1702","0467","164","50","114","10","174","304","0","57.24","16.45"
"10","010","00","017","1703","0000","239","68","171","13","252","418","0","60.29","16.27"
"10","010","00","017","1703","0468","92","23","69","1","93","184","0","50.54","12.5"
"10","010","00","017","1703","0469","147","45","102","12","159","234","0","67.95","19.23"
"10","010","00","017","1704","0000","455","145","310","23","478","920","0","51.96","15.76"
"10","010","00","017","1704","0470","239","70","169","13","252","495","0","50.91","14.14"
"10","010","00","017","1704","0471","111","37","74","4","115","199","0","57.79","18.59"
"10","010","00","017","1704","0472","105","38","67","6","111","226","0","49.12","16.81"
"10","010","00","017","1705","0000","319","85","234","28","347","569","0","60.98","14.94"
"10","010","00","017","1705","0473","319","85","234","28","347","569","0","60.98","14.94"
"10","010","00","018","0000","0000","2040","430","1610","134","2174","4691","5610","46.34","9.17"
"10","010","00","018","1801","0000","176","48","128","9","185","371","0","49.87","12.94"
"10","010","00","018","1801","0474","176","48","128","9","185","371","0","49.87","12.94"
"10","010","00","018","1802","0000","82","19","63","5","87","197","0","44.16","9.64"
"10","010","00","018","1802","0475","82","19","63","5","87","197","0","44.16","9.64"
"10","010","00","018","1803","0000","65","15","50","4","69","152","0","45.39","9.87"
"10","010","00","018","1803","0476","65","15","50","4","69","152","0","45.39","9.87"
"10","010","00","018","1804","0000","93","21","72","7","100","303","0","33.0","6.93"
"10","010","00","018","1804","0477","72","17","55","7","79","231","0","34.2","7.36"
"10","010","00","018","1804","0478","21","4","17","0","21","72","0","29.17","5.56"
"10","010","00","018","1805","0000","150","26","124","13","163","306","0","53.27","8.5"
"10","010","00","018","1805","0480","150","26","124","13","163","306","0","53.27","8.5"
"10","010","00","018","1806","0000","134","31","103","2","136","311","0","43.73","9.97"
"10","010","00","018","1806","0479","134","31","103","2","136","311","0","43.73","9.97"
"10","010","00","018","1807","0000","410","66","344","44","454","827","0","54.9","7.98"
"10","010","00","018","1807","0482","410","66","344","44","454","827","0","54.9","7.98"
"10","010","00","018","1808","0000","444","110","334","12","456","970","0","47.01","11.34"
"10","010","00","018","1808","0481","444","110","334","12","456","970","0","47.01","11.34"
"10","010","00","018","1809","0000","116","23","93","4","120","238","0","50.42","9.66"
"10","010","00","018","1809","0483","116","23","93","4","120","238","0","50.42","9.66"
"10","010","00","018","1810","0000","126","21","105","9","135","479","0","28.18","4.38"
"10","010","00","018","1810","0484","126","21","105","9","135","479","0","28.18","4.38"
"10","010","00","018","1811","0000","105","24","81","6","111","291","0","38.14","8.25"
"10","010","00","018","1811","0485","105","24","81","6","111","291","0","38.14","8.25"
"10","010","00","018","1812","0000","139","26","113","19","158","246","0","64.23","10.57"
"10","010","00","018","1812","0486","139","26","113","19","158","246","0","64.23","10.57"
"10","013","00","000","0000","0000","343017","113331","229686","28411","371428","711720","826779","52.19","15.92"
"10","013","00","001","0000","0000","85873","29361","56512","4547","90420","170148","199807","53.14","17.26"
"10","013","00","001","0101","0000","384","135","249","23","407","713","0","57.08","18.93"
"10","013","00","001","0101","0004","384","135","249","23","407","713","0","57.08","18.93"
"10","013","00","001","0102","0000","145","65","80","0","145","249","0","58.23","26.1"
"10","013","00","001","0102","0007","145","65","80","0","145","249","0","58.23","26.1"
"10","013","00","001","0103","0000","144","56","88","22","166","294","0","56.46","19.05"
"10","013","00","001","0103","0002","144","56","88","22","166","294","0","56.46","19.05"
"10","013","00","001","0104","0000","307","138","169","11","318","582","0","54.64","23.71"
"10","013","00","001","0104","0003","307","138","169","11","318","582","0","54.64","23.71"
"10","013","00","001","0105","0000","272","95","177","10","282","455","0","61.98","20.88"
"10","013","00","001","0105","0006","272","95","177","10","282","455","0","61.98","20.88"
"10","013","00","001","0106","0000","122","47","75","6","128","237","0","54.01","19.83"
"10","013","00","001","0106","0001","122","47","75","6","128","237","0","54.01","19.83"
"10","013","00","001","0107","0000","293","118","175","25","318","572","0","55.59","20.63"
"10","013","00","001","0107","0005","293","118","175","25","318","572","0","55.59","20.63"
"10","013","00","001","0108","0000","408","159","249","28","436","713","0","61.15","22.3"
"10","013","00","001","0108","0010","408","159","249","28","436","713","0","61.15","22.3"
"10","013","00","001","0109","0000","336","133","203","32","368","573","0","64.22","23.21"
"10","013","00","001","0109","0011","336","133","203","32","368","573","0","64.22","23.21"
"10","013","00","001","0110","0000","266","82","184","17","283","409","0","69.19","20.05"
"10","013","00","001","0110","0013","266","82","184","17","283","409","0","69.19","20.05"
"10","013","00","001","0111","0000","189","76","113","13","202","297","0","68.01","25.59"
"10","013","00","001","0111","0012","189","76","113","13","202","297","0","68.01","25.59"
"10","013","00","001","0112","0000","1217","423","794","65","1282","2688","0","47.69","15.74"
"10","013","00","001","0112","0008","599","192","407","22","621","1315","0","47.22","14.6"
"10","013","00","001","0112","0009","618","231","387","43","661","1373","0","48.14","16.82"
"10","013","00","001","0113","0000","234","109","125","15","249","459","0","54.25","23.75"
"10","013","00","001","0113","0017","234","109","125","15","249","459","0","54.25","23.75"
"10","013","00","001","0114","0000","408","158","250","23","431","672","0","64.14","23.51"
"10","013","00","001","0114","0018","408","158","250","23","431","672","0","64.14","23.51"
"10","013","00","001","0115","0000","242","90","152","9","251","421","0","59.62","21.38"
"10","013","00","001","0115","0015","242","90","152","9","251","421","0","59.62","21.38"
"10","013","00","001","0116","0000","310","113","197","12","322","569","0","56.59","19.86"
"10","013","00","001","0116","0016","310","113","197","12","322","569","0","56.59","19.86"
"10","013","00","001","0117","0000","146","47","99","14","160","286","0","55.94","16.43"
"10","013","00","001","0117","0014","146","47","99","14","160","286","0","55.94","16.43"
"10","013","00","001","0118","0000","382","156","226","43","425","668","0","63.62","23.35"
"10","013","00","001","0118","0019","382","156","226","43","425","668","0","63.62","23.35"
"10","013","00","001","0119","0000","225","89","136","10","235","411","0","57.18","21.65"
"10","013","00","001","0119","0020","225","89","136","10","235","411","0","57.18","21.65"
"10","013","00","001","0120","0000","827","280","547","51","878","1554","0","56.5","18.02"
"10","013","00","001","0120","0021","416","139","277","25","441","768","0","57.42","18.1"
"10","013","00","001","0120","0022","411","141","270","26","437","786","0","55.6","17.94"
"10","013","00","001","0121","0000","492","169","323","31","523","890","0","58.76","18.99"
"10","013","00","001","0121","0023","492","169","323","31","523","890","0","58.76","18.99"
"10","013","00","001","0122","0000","1034","368","666","54","1088","1911","0","56.93","19.26"
"10","013","00","001","0122","0039","490","169","321","35","525","939","0","55.91","18.0"
"10","013","00","001","0122","0040","544","199","345","19","563","972","0","57.92","20.47"
"10","013","00","001","0123","0000","1361","457","904","87","1448","2517","0","57.53","18.16"
"10","013","00","001","0123","0034","691","238","453","46","737","1258","0","58.59","18.92"
"10","013","00","001","0123","0035","670","219","451","41","711","1259","0","56.47","17.39"
"10","013","00","001","0124","0000","1937","683","1254","78","2015","3556","0","56.66","19.21"
"10","013","00","001","0124","0036","564","189","375","28","592","1076","0","55.02","17.57"
"10","013","00","001","0124","0037","643","222","421","26","669","1162","0","57.57","19.1"
"10","013","00","001","0124","0038","730","272","458","24","754","1318","0","57.21","20.64"
"10","013","00","001","0125","0000","2100","699","1401","90","2190","4039","0","54.22","17.31"
"10","013","00","001","0125","0031","706","254","452","40","746","1297","0","57.52","19.58"
"10","013","00","001","0125","0032","717","238","479","13","730","1361","0","53.64","17.49"
"10","013","00","001","0125","0033","677","207","470","37","714","1381","0","51.7","14.99"
"10","013","00","001","0126","0000","4926","1630","3296","184","5110","9307","0","54.9","17.51"
"10","013","00","001","0126","0024","721","209","512","40","761","1353","0","56.25","15.45"
"10","013","00","001","0126","0025","721","232","489","19","740","1386","0","53.39","16.74"
"10","013","00","001","0126","0026","714","243","471","23","737","1413","0","52.16","17.2"
"10","013","00","001","0126","0027","660","194","466","31","691","1272","0","54.32","15.25"
"10","013","00","001","0126","0028","674","247","427","26","700","1287","0","54.39","19.19"
"10","013","00","001","0126","0029","731","267","464","30","761","1311","0","58.05","20.37"
"10","013","00","001","0126","0030","705","238","467","15","720","1285","0","56.03","18.52"
"10","013","00","001","0127","0000","681","253","428","75","756","1540","0","49.09","16.43"
"10","013","00","001","0127","0047","681","253","428","75","756","1540","0","49.09","16.43"
"10","013","00","001","0128","0000","540","230","310","51","591","1061","0","55.7","21.68"
"10","013","00","001","0128","0046","540","230","310","51","591","1061","0","55.7","21.68"
"10","013","00","001","0129","0000","520","189","331","18","538","1141","0","47.15","16.56"
"10","013","00","001","0129","0048","520","189","331","18","538","1141","0","47.15","16.56"
"10","013","00","001","0130","0000","3689","1210","2479","147","3836","7243","0","52.96","16.71"
"10","013","00","001","0130","0041","867","281","586","31","898","1535","0","58.5","18.31"
"10","013","00","001","0130","0042","656","210","446","31","687","1419","0","48.41","14.8"
"10","013","00","001","0130","0043","667","197","470","18","685","1398","0","49.0","14.09"
"10","013","00","001","0130","0044","714","251","463","34","748","1405","0","53.24","17.86"
"10","013","00","001","0130","0045","785","271","514","33","818","1486","0","55.05","18.24"
"10","013","00","001","0131","0000","2787","941","1846","160","2947","5428","0","54.29","17.34"
"10","013","00","001","0131","0075","739","233","506","70","809","1485","0","54.48","15.69"
"10","013","00","001","0131","0076","728","241","487","39","767","1387","0","55.3","17.38"
"10","013","00","001","0131","0077","478","157","321","18","496","953","0","52.05","16.47"
"10","013","00","001","0131","0078","842","310","532","33","875","1603","0","54.59","19.34"
"10","013","00","001","0132","0000","271","97","174","24","295","535","0","55.14","18.13"
"10","013","00","001","0132","0079","271","97","174","24","295","535","0","55.14","18.13"
"10","013","00","001","0133","0000","1291","485","806","81","1372","2843","0","48.26","17.06"
"10","013","00","001","0133","0089","548","199","349","24","572","1215","0","47.08","16.38"
"10","013","00","001","0133","0090","743","286","457","57","800","1628","0","49.14","17.57"
"10","013","00","001","0134","0000","419","126","293","41","460","867","0","53.06","14.53"
"10","013","00","001","0134","0086","419","126","293","41","460","867","0","53.06","14.53"
"10","013","00","001","0135","0000","488","151","337","31","519","918","0","56.54","16.45"
"10","013","00","001","0135","0087","488","151","337","31","519","918","0","56.54","16.45"
"10","013","00","001","0136","0000","636","237","399","39","675","1209","0","55.83","19.6"
"10","013","00","001","0136","0091","636","237","399","39","675","1209","0","55.83","19.6"
"10","013","00","001","0137","0000","314","103","211","30","344","663","0","51.89","15.54"
"10","013","00","001","0137","0088","314","103","211","30","344","663","0","51.89","15.54"
"10","013","00","001","0138","0000","682","440","242","18","700","1110","0","63.06","39.64"
"10","013","00","001","0138","0092","682","440","242","18","700","1110","0","63.06","39.64"
"10","013","00","001","0139","0000","309","90","219","15","324","684","0","47.37","13.16"
"10","013","00","001","0139","0093","309","90","219","15","324","684","0","47.37","13.16"
"10","013","00","001","0140","0000","3445","1193","2252","194","3639","7190","0","50.61","16.59"
"10","013","00","001","0140","0094","579","196","383","28","607","1349","0","45.0","14.53"
"10","013","00","001","0140","0095","665","222","443","55","720","1457","0","49.42","15.24"
"10","013","00","001","0140","0096","712","246","466","36","748","1447","0","51.69","17.0"
"10","013","00","001","0140","0097","657","254","403","23","680","1354","0","50.22","18.76"
"10","013","00","001","0140","0098","832","275","557","52","884","1583","0","55.84","17.37"
"10","013","00","001","0141","0000","1214","401","813","62","1276","2503","0","50.98","16.02"
"10","013","00","001","0141","0072","632","221","411","29","661","1284","0","51.48","17.21"
"10","013","00","001","0141","0073","582","180","402","33","615","1219","0","50.45","14.77"
"10","013","00","001","0142","0000","791","259","532","82","873","1544","0","56.54","16.77"
"10","013","00","001","0142","0074","791","259","532","82","873","1544","0","56.54","16.77"
"10","013","00","001","0143","0000","1139","370","769","73","1212","2266","0","53.49","16.33"
"10","013","00","001","0143","0083","606","217","389","36","642","1227","0","52.32","17.69"
"10","013","00","001","0143","0084","533","153","380","37","570","1039","0","54.86","14.73"
"10","013","00","001","0144","0000","706","224","482","87","793","1485","0","53.4","15.08"
"10","013","00","001","0144","0085","706","224","482","87","793","1485","0","53.4","15.08"
"10","013","00","001","0145","0000","555","184","371","34","589","1119","0","52.64","16.44"
"10","013","00","001","0145","0080","555","184","371","34","589","1119","0","52.64","16.44"
"10","013","00","001","0146","0000","931","328","603","96","1027","1770","0","58.02","18.53"
"10","013","00","001","0146","0081","440","137","303","37","477","847","0","56.32","16.17"
"10","013","00","001","0146","0082","491","191","300","59","550","923","0","59.59","20.69"
"10","013","00","001","0147","0000","140","41","99","3","143","391","0","36.57","10.49"
"10","013","00","001","0147","0060","140","41","99","3","143","391","0","36.57","10.49"
"10","013","00","001","0148","0000","117","32","85","4","121","231","0","52.38","13.85"
"10","013","00","001","0148","0063","117","32","85","4","121","231","0","52.38","13.85"
"10","013","00","001","0149","0000","1011","379","632","83","1094","1998","0","54.75","18.97"
"10","013","00","001","0149","0064","503","181","322","43","546","945","0","57.78","19.15"
"10","013","00","001","0149","0065","508","198","310","40","548","1053","0","52.04","18.8"
"10","013","00","001","0150","0000","486","156","330","52","538","1043","0","51.58","14.96"
"10","013","00","001","0150","0066","486","156","330","52","538","1043","0","51.58","14.96"
"10","013","00","001","0151","0000","643","235","408","21","664","1205","0","55.1","19.5"
"10","013","00","001","0151","0071","643","235","408","21","664","1205","0","55.1","19.5"
"10","013","00","001","0153","0000","4252","1441","2811","194","4446","8175","0","54.39","17.63"
"10","013","00","001","0153","0052","657","211","446","33","690","1253","0","55.07","16.84"
"10","013","00","001","0153","0053","679","229","450","35","714","1315","0","54.3","17.41"
"10","013","00","001","0153","0054","695","255","440","33","728","1425","0","51.09","17.89"
"10","013","00","001","0153","0055","715","249","466","18","733","1423","0","51.51","17.5"
"10","013","00","001","0153","0056","757","237","520","38","795","1400","0","56.79","16.93"
"10","013","00","001","0153","0057","749","260","489","37","786","1359","0","57.84","19.13"
"10","013","00","001","0154","0000","1358","404","954","141","1499","2922","0","51.3","13.83"
"10","013","00","001","0154","0069","687","186","501","89","776","1468","0","52.86","12.67"
"10","013","00","001","0154","0070","671","218","453","52","723","1454","0","49.72","14.99"
"10","013","00","001","0155","0000","1999","696","1303","96","2095","3996","0","52.43","17.42"
"10","013","00","001","0155","0049","591","218","373","31","622","1247","0","49.88","17.48"
"10","013","00","001","0155","0050","705","261","444","29","734","1446","0","50.76","18.05"
"10","013","00","001","0155","0051","703","217","486","36","739","1303","0","56.72","16.65"
"10","013","00","001","0156","0000","915","324","591","93","1008","1937","0","52.04","16.73"
"10","013","00","001","0156","0067","501","174","327","54","555","1061","0","52.31","16.4"
"10","013","00","001","0156","0068","414","150","264","39","453","876","0","51.71","17.12"
"10","013","00","001","0157","0000","143","53","90","24","167","328","0","50.91","16.16"
"10","013","00","001","0157","0062","143","53","90","24","167","328","0","50.91","16.16"
"10","013","00","001","0158","0000","105","38","67","12","117","200","0","58.5","19.0"
"10","013","00","001","0158","0061","105","38","67","12","117","200","0","58.5","19.0"
"10","013","00","001","0159","0000","925","301","624","43","968","1722","0","56.21","17.48"
"10","013","00","001","0159","0122","438","147","291","22","460","853","0","53.93","17.23"
"10","013","00","001","0159","0123","487","154","333","21","508","869","0","58.46","17.72"
"10","013","00","001","0160","0000","2531","868","1663","153","2684","4870","0","55.11","17.82"
"10","013","00","001","0160","0124","633","196","437","37","670","1169","0","57.31","16.77"
"10","013","00","001","0160","0125","523","175","348","70","593","1058","0","56.05","16.54"
"10","013","00","001","0160","0126","646","217","429","23","669","1344","0","49.78","16.15"
"10","013","00","001","0160","0127","729","280","449","23","752","1299","0","57.89","21.56"
"10","013","00","001","0161","0000","406","138","268","21","427","744","0","57.39","18.55"
"10","013","00","001","0161","0143","406","138","268","21","427","744","0","57.39","18.55"
"10","013","00","001","0162","0000","347","119","228","24","371","678","0","54.72","17.55"
"10","013","00","001","0162","0144","347","119","228","24","371","678","0","54.72","17.55"
"10","013","00","001","0163","0000","385","126","259","15","400","681","0","58.74","18.5"
"10","013","00","001","0163","0145","385","126","259","15","400","681","0","58.74","18.5"
"10","013","00","001","0164","0000","2357","794","1563","70","2427","4705","0","51.58","16.88"
"10","013","00","001","0164","0140","788","281","507","42","830","1491","0","55.67","18.85"
"10","013","00","001","0164","0141","670","207","463","12","682","1411","0","48.33","14.67"
"10","013","00","001","0164","0142","899","306","593","16","915","1803","0","50.75","16.97"
"10","013","00","001","0165","0000","2438","770","1668","100","2538","5541","0","45.8","13.9"
"10","013","00","001","0165","0118","505","171","334","24","529","1683","0","31.43","10.16"
"10","013","00","001","0165","0119","740","232","508","17","757","1497","0","50.57","15.5"
"10","013","00","001","0165","0120","554","185","369","30","584","1129","0","51.73","16.39"
"10","013","00","001","0165","0121","639","182","457","29","668","1232","0","54.22","14.77"
"10","013","00","001","0166","0000","861","356","505","37","898","1920","0","46.77","18.54"
"10","013","00","001","0166","0113","386","110","276","15","401","821","0","48.84","13.4"
"10","013","00","001","0166","0114","475","246","229","22","497","1099","0","45.22","22.38"
"10","013","00","001","0167","0000","1139","392","747","68","1207","2327","0","51.87","16.85"
"10","013","00","001","0167","0128","575","202","373","38","613","1204","0","50.91","16.78"
"10","013","00","001","0167","0129","564","190","374","30","594","1123","0","52.89","16.92"
"10","013","00","001","0168","0000","1264","440","824","66","1330","2404","0","55.32","18.3"
"10","013","00","001","0168","0138","696","240","456","47","743","1289","0","57.64","18.62"
"10","013","00","001","0168","0139","568","200","368","19","587","1115","0","52.65","17.94"
"10","013","00","001","0169","0000","3112","969","2143","128","3240","6072","0","53.36","15.96"
"10","013","00","001","0169","0133","571","187","384","22","593","1215","0","48.81","15.39"
"10","013","00","001","0169","0134","691","190","501","36","727","1370","0","53.07","13.87"
"10","013","00","001","0169","0135","645","189","456","13","658","1240","0","53.06","15.24"
"10","013","00","001","0169","0136","646","225","421","26","672","1168","0","57.53","19.26"
"10","013","00","001","0169","0137","559","178","381","31","590","1079","0","54.68","16.5"
"10","013","00","001","0170","0000","1208","433","775","63","1271","2172","0","58.52","19.94"
"10","013","00","001","0170","0148","573","202","371","42","615","1018","0","60.41","19.84"
"10","013","00","001","0170","0149","635","231","404","21","656","1154","0","56.85","20.02"
"10","013","00","001","0171","0000","1013","340","673","73","1086","2082","0","52.16","16.33"
"10","013","00","001","0171","0116","563","192","371","33","596","1167","0","51.07","16.45"
"10","013","00","001","0171","0117","450","148","302","40","490","915","0","53.55","16.17"
"10","013","00","001","0173","0000","5925","1766","4159","195","6120","11833","0","51.72","14.92"
"10","013","00","001","0173","0099","862","249","613","24","886","1707","0","51.9","14.59"
"10","013","00","001","0173","0100","786","234","552","18","804","1637","0","49.11","14.29"
"10","013","00","001","0173","0101","701","205","496","34","735","1459","0","50.38","14.05"
"10","013","00","001","0173","0102","922","277","645","27","949","1759","0","53.95","15.75"
"10","013","00","001","0173","0103","970","294","676","32","1002","1950","0","51.38","15.08"
"10","013","00","001","0173","0104","902","259","643","33","935","1729","0","54.08","14.98"
"10","013","00","001","0173","0105","782","248","534","27","809","1592","0","50.82","15.58"
"10","013","00","001","0174","0000","838","629","209","36","874","1688","0","51.78","37.26"
"10","013","00","001","0174","0115","838","629","209","36","874","1688","0","51.78","37.26"
"10","013","00","001","0175","0000","5657","1717","3940","181","5838","11483","0","50.84","14.95"
"10","013","00","001","0175","0106","699","218","481","27","726","1437","0","50.52","15.17"
"10","013","00","001","0175","0107","594","166","428","19","613","1204","0","50.91","13.79"
"10","013","00","001","0175","0108","706","189","517","26","732","1340","0","54.63","14.1"
"10","013","00","001","0175","0109","683","218","465","34","717","1322","0","54.24","16.49"
"10","013","00","001","0175","0110","719","225","494","23","742","1462","0","50.75","15.39"
"10","013","00","001","0175","0111","1544","480","1064","40","1584","3241","0","48.87","14.81"
"10","013","00","001","0175","0112","712","221","491","12","724","1477","0","49.02","14.96"
"10","013","00","001","0176","0000","587","203","384","31","618","1318","0","46.89","15.4"
"10","013","00","001","0176","0130","587","203","384","31","618","1318","0","46.89","15.4"
"10","013","00","001","0177","0000","473","179","294","43","516","865","0","59.65","20.69"
"10","013","00","001","0177","0131","473","179","294","43","516","865","0","59.65","20.69"
"10","013","00","001","0178","0000","483","162","321","27","510","1100","0","46.36","14.73"
"10","013","00","001","0178","0132","483","162","321","27","510","1100","0","46.36","14.73"
"10","013","00","001","0179","0000","484","160","324","60","544","954","0","57.02","16.77"
"10","013","00","001","0179","0147","484","160","324","60","544","954","0","57.02","16.77"
"10","013","00","001","0180","0000","669","238","431","33","702","1535","0","45.73","15.5"
"10","013","00","001","0180","0146","669","238","431","33","702","1535","0","45.73","15.5"
"10","013","00","001","0181","0000","1487","376","1111","46","1533","2867","0","53.47","13.11"
"10","013","00","001","0181","0058","698","172","526","20","718","1328","0","54.07","12.95"
"10","013","00","001","0181","0059","789","204","585","26","815","1539","0","52.96","13.26"
"10","013","00","002","0000","0000","22657","7197","15460","1559","24216","46444","53924","52.14","15.5"
"10","013","00","002","0201","0000","275","96","179","30","305","504","0","60.52","19.05"
"10","013","00","002","0201","0150","275","96","179","30","305","504","0","60.52","19.05"
"10","013","00","002","0202","0000","337","117","220","42","379","603","0","62.85","19.4"
"10","013","00","002","0202","0154","337","117","220","42","379","603","0","62.85","19.4"
"10","013","00","002","0203","0000","677","201","476","47","724","1245","0","58.15","16.14"
"10","013","00","002","0203","0170","677","201","476","47","724","1245","0","58.15","16.14"
"10","013","00","002","0204","0000","513","177","336","36","549","972","0","56.48","18.21"
"10","013","00","002","0204","0169","513","177","336","36","549","972","0","56.48","18.21"
"10","013","00","002","0205","0000","2222","722","1500","87","2309","4759","0","48.52","15.17"
"10","013","00","002","0205","0151","775","271","504","43","818","1711","0","47.81","15.84"
"10","013","00","002","0205","0152","816","259","557","21","837","1634","0","51.22","15.85"
"10","013","00","002","0205","0153","631","192","439","23","654","1414","0","46.25","13.58"
"10","013","00","002","0206","0000","436","132","304","54","490","896","0","54.69","14.73"
"10","013","00","002","0206","0155","436","132","304","54","490","896","0","54.69","14.73"
"10","013","00","002","0207","0000","2685","863","1822","184","2869","5309","0","54.04","16.26"
"10","013","00","002","0207","0156","618","206","412","52","670","1285","0","52.14","16.03"
"10","013","00","002","0207","0157","830","258","572","39","869","1744","0","49.83","14.79"
"10","013","00","002","0207","0158","577","195","382","40","617","1071","0","57.61","18.21"
"10","013","00","002","0207","0159","660","204","456","53","713","1209","0","58.97","16.87"
"10","013","00","002","0208","0000","3304","1045","2259","205","3509","6490","0","54.07","16.1"
"10","013","00","002","0208","0160","584","205","379","34","618","1159","0","53.32","17.69"
"10","013","00","002","0208","0161","641","196","445","46","687","1296","0","53.01","15.12"
"10","013","00","002","0208","0162","745","224","521","38","783","1466","0","53.41","15.28"
"10","013","00","002","0208","0163","606","180","426","46","652","1130","0","57.7","15.93"
"10","013","00","002","0208","0164","728","240","488","41","769","1439","0","53.44","16.68"
"10","013","00","002","0209","0000","1143","323","820","78","1221","2122","0","57.54","15.22"
"10","013","00","002","0209","0165","479","134","345","46","525","897","0","58.53","14.94"
"10","013","00","002","0209","0166","664","189","475","32","696","1225","0","56.82","15.43"
"10","013","00","002","0210","0000","707","162","545","45","752","1415","0","53.14","11.45"
"10","013","00","002","0210","0171","707","162","545","45","752","1415","0","53.14","11.45"
"10","013","00","002","0211","0000","975","408","567","39","1014","2313","0","43.84","17.64"
"10","013","00","002","0211","0172","573","215","358","15","588","1255","0","46.85","17.13"
"10","013","00","002","0211","0173","402","193","209","24","426","1058","0","40.26","18.24"
"10","013","00","002","0212","0000","1124","350","774","93","1217","2270","0","53.61","15.42"
"10","013","00","002","0212","0174","576","190","386","36","612","1187","0","51.56","16.01"
"10","013","00","002","0212","0175","548","160","388","57","605","1083","0","55.86","14.77"
"10","013","00","002","0213","0000","3489","1086","2403","176","3665","7022","0","52.19","15.47"
"10","013","00","002","0213","0176","728","233","495","32","760","1590","0","47.8","14.65"
"10","013","00","002","0213","0177","797","232","565","49","846","1543","0","54.83","15.04"
"10","013","00","002","0213","0178","767","258","509","45","812","1631","0","49.79","15.82"
"10","013","00","002","0213","0179","606","173","433","24","630","1159","0","54.36","14.93"
"10","013","00","002","0213","0180","591","190","401","26","617","1099","0","56.14","17.29"
"10","013","00","002","0214","0000","547","170","377","45","592","1200","0","49.33","14.17"
"10","013","00","002","0214","0181","547","170","377","45","592","1200","0","49.33","14.17"
"10","013","00","002","0215","0000","646","171","475","58","704","1391","0","50.61","12.29"
"10","013","00","002","0215","0182","646","171","475","58","704","1391","0","50.61","12.29"
"10","013","00","002","0216","0000","458","144","314","46","504","881","0","57.21","16.35"
"10","013","00","002","0216","0183","458","144","314","46","504","881","0","57.21","16.35"
"10","013","00","002","0217","0000","190","51","139","20","210","454","0","46.26","11.23"
"10","013","00","002","0217","0184","190","51","139","20","210","454","0","46.26","11.23"
"10","013","00","002","0218","0000","716","258","458","86","802","1639","0","48.93","15.74"
"10","013","00","002","0218","0167","533","195","338","52","585","1158","0","50.52","16.84"
"10","013","00","002","0218","0168","183","63","120","34","217","481","0","45.11","13.1"
"10","013","00","002","0219","0000","817","240","577","73","890","1658","0","53.68","14.48"
"10","013","00","002","0219","0185","817","240","577","73","890","1658","0","53.68","14.48"
"10","013","00","002","0220","0000","767","285","482","56","823","1770","0","46.5","16.1"
"10","013","00","002","0220","0186","370","136","234","31","401","822","0","48.78","16.55"
"10","013","00","002","0220","0187","397","149","248","25","422","948","0","44.51","15.72"
"10","013","00","002","0221","0000","629","196","433","59","688","1531","0","44.94","12.8"
"10","013","00","002","0221","0188","465","145","320","32","497","1194","0","41.62","12.14"
"10","013","00","002","0221","0189","164","51","113","27","191","337","0","56.68","15.13"
"10","013","00","003","0000","0000","19140","6062","13078","1842","20982","39495","47654","53.13","15.35"
"10","013","00","003","0301","0000","1117","342","775","105","1222","2051","0","59.58","16.67"
"10","013","00","003","0301","0190","541","160","381","47","588","981","0","59.94","16.31"
"10","013","00","003","0301","0191","576","182","394","58","634","1070","0","59.25","17.01"
"10","013","00","003","0302","0000","310","90","220","36","346","527","0","65.65","17.08"
"10","013","00","003","0302","0192","310","90","220","36","346","527","0","65.65","17.08"
"10","013","00","003","0303","0000","221","72","149","19","240","395","0","60.76","18.23"
"10","013","00","003","0303","0193","221","72","149","19","240","395","0","60.76","18.23"
"10","013","00","003","0304","0000","312","99","213","26","338","659","0","51.29","15.02"
"10","013","00","003","0304","0194","312","99","213","26","338","659","0","51.29","15.02"
"10","013","00","003","0305","0000","250","79","171","25","275","513","0","53.61","15.4"
"10","013","00","003","0305","0195","250","79","171","25","275","513","0","53.61","15.4"
"10","013","00","003","0306","0000","364","119","245","27","391","695","0","56.26","17.12"
"10","013","00","003","0306","0203","364","119","245","27","391","695","0","56.26","17.12"
"10","013","00","003","0307","0000","846","239","607","104","950","1643","0","57.82","14.55"
"10","013","00","003","0307","0204","587","199","388","73","660","1076","0","61.34","18.49"
"10","013","00","003","0307","0205","259","40","219","31","290","567","0","51.15","7.05"
"10","013","00","003","0308","0000","394","129","265","33","427","806","0","52.98","16.0"
"10","013","00","003","0308","0206","394","129","265","33","427","806","0","52.98","16.0"
"10","013","00","003","0309","0000","627","200","427","57","684","1227","0","55.75","16.3"
"10","013","00","003","0309","0207","627","200","427","57","684","1227","0","55.75","16.3"
"10","013","00","003","0310","0000","278","79","199","47","325","599","0","54.26","13.19"
"10","013","00","003","0310","0208","278","79","199","47","325","599","0","54.26","13.19"
"10","013","00","003","0311","0000","533","160","373","40","573","1354","0","42.32","11.82"
"10","013","00","003","0311","0209","533","160","373","40","573","1354","0","42.32","11.82"
"10","013","00","003","0312","0000","879","285","594","147","1026","1841","0","55.73","15.48"
"10","013","00","003","0312","0210","345","101","244","46","391","734","0","53.27","13.76"
"10","013","00","003","0312","0211","534","184","350","101","635","1107","0","57.36","16.62"
"10","013","00","003","0313","0000","1271","427","844","155","1426","2812","0","50.71","15.18"
"10","013","00","003","0313","0212","533","180","353","72","605","1198","0","50.5","15.03"
"10","013","00","003","0313","0213","738","247","491","83","821","1614","0","50.87","15.3"
"10","013","00","003","0314","0000","848","266","582","95","943","1738","0","54.26","15.3"
"10","013","00","003","0314","0214","378","118","260","45","423","826","0","51.21","14.29"
"10","013","00","003","0314","0215","470","148","322","50","520","912","0","57.02","16.23"
"10","013","00","003","0315","0000","804","245","559","114","918","1636","0","56.11","14.98"
"10","013","00","003","0315","0216","198","62","136","30","228","432","0","52.78","14.35"
"10","013","00","003","0315","0217","606","183","423","84","690","1204","0","57.31","15.2"
"10","013","00","003","0316","0000","2580","761","1819","181","2761","5318","0","51.92","14.31"
"10","013","00","003","0316","0218","667","202","465","55","722","1304","0","55.37","15.49"
"10","013","00","003","0316","0219","664","196","468","61","725","1317","0","55.05","14.88"
"10","013","00","003","0316","0220","676","202","474","33","709","1387","0","51.12","14.56"
"10","013","00","003","0316","0221","573","161","412","32","605","1310","0","46.18","12.29"
"10","013","00","003","0317","0000","864","316","548","104","968","1994","0","48.55","15.85"
"10","013","00","003","0317","0222","544","203","341","51","595","1228","0","48.45","16.53"
"10","013","00","003","0317","0223","320","113","207","53","373","766","0","48.69","14.75"
"10","013","00","003","0318","0000","690","237","453","80","770","1578","0","48.8","15.02"
"10","013","00","003","0318","0224","420","157","263","61","481","823","0","58.44","19.08"
"10","013","00","003","0318","0225","270","80","190","19","289","755","0","38.28","10.6"
"10","013","00","003","0319","0000","4465","1429","3036","297","4762","8957","0","53.17","15.95"
"10","013","00","003","0319","0196","839","271","568","51","890","1732","0","51.39","15.65"
"10","013","00","003","0319","0197","907","276","631","45","952","1779","0","53.51","15.51"
"10","013","00","003","0319","0198","613","202","411","31","644","1270","0","50.71","15.91"
"10","013","00","003","0319","0199","645","199","446","52","697","1327","0","52.52","15.0"
"10","013","00","003","0319","0200","637","215","422","57","694","1242","0","55.88","17.31"
"10","013","00","003","0319","0201","824","266","558","61","885","1607","0","55.07","16.55"
"10","013","00","003","0320","0000","597","213","384","42","639","1305","0","48.97","16.32"
"10","013","00","003","0320","0202","597","213","384","42","639","1305","0","48.97","16.32"
"10","013","00","003","0321","0000","543","186","357","83","626","1094","0","57.22","17.0"
"10","013","00","003","0321","0226","543","186","357","83","626","1094","0","57.22","17.0"
"10","013","00","003","0322","0000","347","89","258","25","372","753","0","49.4","11.82"
"10","013","00","003","0322","0227","347","89","258","25","372","753","0","49.4","11.82"
"10","013","00","004","0000","0000","11255","3668","7587","822","12077","25661","30812","47.06","14.29"
"10","013","00","004","0401","0000","403","108","295","37","440","902","0","48.78","11.97"
"10","013","00","004","0401","0228","403","108","295","37","440","902","0","48.78","11.97"
"10","013","00","004","0402","0000","1110","392","718","74","1184","2249","0","52.65","17.43"
"10","013","00","004","0402","0229","518","180","338","36","554","969","0","57.17","18.58"
"10","013","00","004","0402","0230","592","212","380","38","630","1280","0","49.22","16.56"
"10","013","00","004","0403","0000","582","187","395","28","610","1133","0","53.84","16.5"
"10","013","00","004","0403","0231","582","187","395","28","610","1133","0","53.84","16.5"
"10","013","00","004","0404","0000","1846","572","1274","115","1961","4159","0","47.15","13.75"
"10","013","00","004","0404","0246","697","232","465","29","726","1505","0","48.24","15.42"
"10","013","00","004","0404","0247","474","145","329","46","520","1111","0","46.8","13.05"
"10","013","00","004","0404","0248","675","195","480","40","715","1543","0","46.34","12.64"
"10","013","00","004","0405","0000","1211","416","795","65","1276","3037","0","42.02","13.7"
"10","013","00","004","0405","0232","641","219","422","15","656","1552","0","42.27","14.11"
"10","013","00","004","0405","0233","570","197","373","50","620","1485","0","41.75","13.27"
"10","013","00","004","0406","0000","448","142","306","33","481","896","0","53.68","15.85"
"10","013","00","004","0406","0234","448","142","306","33","481","896","0","53.68","15.85"
"10","013","00","004","0407","0000","225","78","147","25","250","531","0","47.08","14.69"
"10","013","00","004","0407","0235","225","78","147","25","250","531","0","47.08","14.69"
"10","013","00","004","0408","0000","210","72","138","11","221","478","0","46.23","15.06"
"10","013","00","004","0408","0236","210","72","138","11","221","478","0","46.23","15.06"
"10","013","00","004","0409","0000","445","156","289","44","489","1020","0","47.94","15.29"
"10","013","00","004","0409","0237","445","156","289","44","489","1020","0","47.94","15.29"
"10","013","00","004","0410","0000","429","159","270","17","446","924","0","48.27","17.21"
"10","013","00","004","0410","0238","429","159","270","17","446","924","0","48.27","17.21"
"10","013","00","004","0411","0000","444","139","305","29","473","1079","0","43.84","12.88"
"10","013","00","004","0411","0239","444","139","305","29","473","1079","0","43.84","12.88"
"10","013","00","004","0412","0000","712","176","536","58","770","1588","0","48.49","11.08"
"10","013","00","004","0412","0240","302","88","214","16","318","775","0","41.03","11.35"
"10","013","00","004","0412","0241","410","88","322","42","452","813","0","55.6","10.82"
"10","013","00","004","0413","0000","923","290","633","95","1018","2214","0","45.98","13.1"
"10","013","00","004","0413","0242","473","143","330","50","523","1104","0","47.37","12.95"
"10","013","00","004","0413","0243","450","147","303","45","495","1110","0","44.59","13.24"
"10","013","00","004","0414","0000","491","172","319","68","559","1400","0","39.93","12.29"
"10","013","00","004","0414","0244","240","93","147","57","297","692","0","42.92","13.44"
"10","013","00","004","0414","0245","251","79","172","11","262","708","0","37.01","11.16"
"10","013","00","004","0415","0000","727","251","476","48","775","1672","0","46.35","15.01"
"10","013","00","004","0415","0249","317","114","203","14","331","828","0","39.98","13.77"
"10","013","00","004","0415","0250","410","137","273","34","444","844","0","52.61","16.23"
"10","013","00","004","0416","0000","574","207","367","37","611","1253","0","48.76","16.52"
"10","013","00","004","0416","0251","574","207","367","37","611","1253","0","48.76","16.52"
"10","013","00","004","0417","0000","475","151","324","38","513","1126","0","45.56","13.41"
"10","013","00","004","0417","0252","475","151","324","38","513","1126","0","45.56","13.41"
"10","013","00","005","0000","0000","21212","7211","14001","1988","23200","43478","50595","53.36","16.59"
"10","013","00","005","0501","0000","347","136","211","16","363","595","0","61.01","22.86"
"10","013","00","005","0501","0267","347","136","211","16","363","595","0","61.01","22.86"
"10","013","00","005","0502","0000","452","149","303","34","486","847","0","57.38","17.59"
"10","013","00","005","0502","0262","452","149","303","34","486","847","0","57.38","17.59"
"10","013","00","005","0503","0000","1661","532","1129","143","1804","3458","0","52.17","15.38"
"10","013","00","005","0503","0263","549","166","383","38","587","1149","0","51.09","14.45"
"10","013","00","005","0503","0264","560","182","378","47","607","1131","0","53.67","16.09"
"10","013","00","005","0503","0265","552","184","368","58","610","1178","0","51.78","15.62"
"10","013","00","005","0504","0000","397","131","266","28","425","711","0","59.77","18.42"
"10","013","00","005","0504","0266","397","131","266","28","425","711","0","59.77","18.42"
"10","013","00","005","0505","0000","751","503","248","56","807","1403","0","57.52","35.85"
"10","013","00","005","0505","0268","751","503","248","56","807","1403","0","57.52","35.85"
"10","013","00","005","0506","0000","1135","358","777","61","1196","2252","0","53.11","15.9"
"10","013","00","005","0506","0269","518","156","362","28","546","1094","0","49.91","14.26"
"10","013","00","005","0506","0270","617","202","415","33","650","1158","0","56.13","17.44"
"10","013","00","005","0507","0000","1077","356","721","102","1179","2025","0","58.22","17.58"
"10","013","00","005","0507","0271","537","184","353","60","597","963","0","61.99","19.11"
"10","013","00","005","0507","0272","540","172","368","42","582","1062","0","54.8","16.2"
"10","013","00","005","0508","0000","809","264","545","83","892","1684","0","52.97","15.68"
"10","013","00","005","0508","0273","809","264","545","83","892","1684","0","52.97","15.68"
"10","013","00","005","0509","0000","1234","393","841","114","1348","2250","0","59.91","17.47"
"10","013","00","005","0509","0290","566","185","381","62","628","1023","0","61.39","18.08"
"10","013","00","005","0509","0291","668","208","460","52","720","1227","0","58.68","16.95"
"10","013","00","005","0510","0000","501","173","328","36","537","976","0","55.02","17.73"
"10","013","00","005","0510","0275","501","173","328","36","537","976","0","55.02","17.73"
"10","013","00","005","0511","0000","846","271","575","97","943","1860","0","50.7","14.57"
"10","013","00","005","0511","0276","496","158","338","62","558","1013","0","55.08","15.6"
"10","013","00","005","0511","0277","350","113","237","35","385","847","0","45.45","13.34"
"10","013","00","005","0512","0000","787","257","530","125","912","1570","0","58.09","16.37"
"10","013","00","005","0512","0278","787","257","530","125","912","1570","0","58.09","16.37"
"10","013","00","005","0513","0000","624","184","440","73","697","1411","0","49.4","13.04"
"10","013","00","005","0513","0279","624","184","440","73","697","1411","0","49.4","13.04"
"10","013","00","005","0514","0000","405","107","298","41","446","804","0","55.47","13.31"
"10","013","00","005","0514","0282","405","107","298","41","446","804","0","55.47","13.31"
"10","013","00","005","0515","0000","632","216","416","68","700","1284","0","54.52","16.82"
"10","013","00","005","0515","0283","632","216","416","68","700","1284","0","54.52","16.82"
"10","013","00","005","0516","0000","655","206","449","51","706","1430","0","49.37","14.41"
"10","013","00","005","0516","0284","655","206","449","51","706","1430","0","49.37","14.41"
"10","013","00","005","0517","0000","541","186","355","59","600","960","0","62.5","19.38"
"10","013","00","005","0517","0285","541","186","355","59","600","960","0","62.5","19.38"
"10","013","00","005","0518","0000","1004","345","659","123","1127","1944","0","57.97","17.75"
"10","013","00","005","0518","0286","433","135","298","46","479","786","0","60.94","17.18"
"10","013","00","005","0518","0287","571","210","361","77","648","1158","0","55.96","18.13"
"10","013","00","005","0519","0000","714","234","480","62","776","1666","0","46.58","14.05"
"10","013","00","005","0519","0289","714","234","480","62","776","1666","0","46.58","14.05"
"10","013","00","005","0520","0000","659","205","454","72","731","1647","0","44.38","12.45"
"10","013","00","005","0520","0288","659","205","454","72","731","1647","0","44.38","12.45"
"10","013","00","005","0521","0000","800","293","507","26","826","1702","0","48.53","17.22"
"10","013","00","005","0521","0274","800","293","507","26","826","1702","0","48.53","17.22"
"10","013","00","005","0522","0000","928","321","607","103","1031","2096","0","49.19","15.31"
"10","013","00","005","0522","0254","507","178","329","60","567","1147","0","49.43","15.52"
"10","013","00","005","0522","0255","421","143","278","43","464","949","0","48.89","15.07"
"10","013","00","005","0523","0000","624","193","431","45","669","1527","0","43.81","12.64"
"10","013","00","005","0523","0253","624","193","431","45","669","1527","0","43.81","12.64"
"10","013","00","005","0524","0000","518","209","309","82","600","1046","0","57.36","19.98"
"10","013","00","005","0524","0280","518","209","309","82","600","1046","0","57.36","19.98"
"10","013","00","005","0525","0000","933","291","642","40","973","2012","0","48.36","14.46"
"10","013","00","005","0525","0256","449","158","291","30","479","990","0","48.38","15.96"
"10","013","00","005","0525","0257","484","133","351","10","494","1022","0","48.34","13.01"
"10","013","00","005","0526","0000","652","217","435","36","688","1385","0","49.68","15.67"
"10","013","00","005","0526","0281","652","217","435","36","688","1385","0","49.68","15.67"
"10","013","00","005","0527","0000","592","170","422","91","683","1159","0","58.93","14.67"
"10","013","00","005","0527","0259","592","170","422","91","683","1159","0","58.93","14.67"
"10","013","00","005","0528","0000","430","150","280","60","490","837","0","58.54","17.92"
"10","013","00","005","0528","0260","430","150","280","60","490","837","0","58.54","17.92"
"10","013","00","005","0529","0000","320","97","223","48","368","545","0","67.52","17.8"
"10","013","00","005","0529","0258","320","97","223","48","368","545","0","67.52","17.8"
"10","013","00","005","0530","0000","184","64","120","13","197","392","0","50.26","16.33"
"10","013","00","005","0530","0261","184","64","120","13","197","392","0","50.26","16.33"
"10","013","00","006","0000","0000","13189","4527","8662","1270","14459","26256","29714","55.07","17.24"
"10","013","00","006","0601","0000","1313","420","893","135","1448","2632","0","55.02","15.96"
"10","013","00","006","0601","0292","512","146","366","55","567","1018","0","55.7","14.34"
"10","013","00","006","0601","0293","801","274","527","80","881","1614","0","54.58","16.98"
"10","013","00","006","0602","0000","1854","805","1049","136","1990","3555","0","55.98","22.64"
"10","013","00","006","0602","0294","998","547","451","68","1066","1848","0","57.68","29.6"
"10","013","00","006","0602","0295","856","258","598","68","924","1707","0","54.13","15.11"
"10","013","00","006","0603","0000","1065","352","713","58","1123","1961","0","57.27","17.95"
"10","013","00","006","0603","0296","533","180","353","18","551","972","0","56.69","18.52"
"10","013","00","006","0603","0297","532","172","360","40","572","989","0","57.84","17.39"
"10","013","00","006","0604","0000","1249","453","796","91","1340","2548","0","52.59","17.78"
"10","013","00","006","0604","0298","409","131","278","36","445","735","0","60.54","17.82"
"10","013","00","006","0604","0299","840","322","518","55","895","1813","0","49.37","17.76"
"10","013","00","006","0605","0000","599","197","402","52","651","1073","0","60.67","18.36"
"10","013","00","006","0605","0300","599","197","402","52","651","1073","0","60.67","18.36"
"10","013","00","006","0606","0000","463","129","334","48","511","884","0","57.81","14.59"
"10","013","00","006","0606","0305","463","129","334","48","511","884","0","57.81","14.59"
"10","013","00","006","0607","0000","557","169","388","66","623","1090","0","57.16","15.5"
"10","013","00","006","0607","0306","557","169","388","66","623","1090","0","57.16","15.5"
"10","013","00","006","0608","0000","723","237","486","88","811","1492","0","54.36","15.88"
"10","013","00","006","0608","0304","723","237","486","88","811","1492","0","54.36","15.88"
"10","013","00","006","0609","0000","814","264","550","69","883","1654","0","53.39","15.96"
"10","013","00","006","0609","0301","814","264","550","69","883","1654","0","53.39","15.96"
"10","013","00","006","0610","0000","637","231","406","59","696","1205","0","57.76","19.17"
"10","013","00","006","0610","0302","637","231","406","59","696","1205","0","57.76","19.17"
"10","013","00","006","0611","0000","407","140","267","26","433","758","0","57.12","18.47"
"10","013","00","006","0611","0303","407","140","267","26","433","758","0","57.12","18.47"
"10","013","00","006","0612","0000","1121","340","781","112","1233","2401","0","51.35","14.16"
"10","013","00","006","0612","0311","611","199","412","88","699","1242","0","56.28","16.02"
"10","013","00","006","0612","0312","510","141","369","24","534","1159","0","46.07","12.17"
"10","013","00","006","0613","0000","863","283","580","140","1003","1770","0","56.67","15.99"
"10","013","00","006","0613","0308","410","132","278","55","465","845","0","55.03","15.62"
"10","013","00","006","0613","0309","453","151","302","85","538","925","0","58.16","16.32"
"10","013","00","006","0614","0000","611","204","407","79","690","1422","0","48.52","14.35"
"10","013","00","006","0614","0307","611","204","407","79","690","1422","0","48.52","14.35"
"10","013","00","006","0615","0000","549","192","357","73","622","1138","0","54.66","16.87"
"10","013","00","006","0615","0310","549","192","357","73","622","1138","0","54.66","16.87"
"10","013","00","006","0616","0000","364","111","253","38","402","673","0","59.73","16.49"
"10","013","00","006","0616","0313","364","111","253","38","402","673","0","59.73","16.49"
"10","013","00","007","0000","0000","5402","2021","3381","362","5764","9970","11068","57.81","20.27"
"10","013","00","007","0701","0000","1219","400","819","60","1279","2174","0","58.83","18.4"
"10","013","00","007","0701","0314","414","144","270","33","447","788","0","56.73","18.27"
"10","013","00","007","0701","0315","805","256","549","27","832","1386","0","60.03","18.47"
"10","013","00","007","0702","0000","551","184","367","37","588","957","0","61.44","19.23"
"10","013","00","007","0702","0316","551","184","367","37","588","957","0","61.44","19.23"
"10","013","00","007","0703","0000","861","412","449","92","953","1537","0","62.0","26.81"
"10","013","00","007","0703","0317","406","130","276","43","449","731","0","61.42","17.78"
"10","013","00","007","0703","0318","455","282","173","49","504","806","0","62.53","34.99"
"10","013","00","007","0704","0000","1319","475","844","93","1412","2547","0","55.44","18.65"
"10","013","00","007","0704","0319","579","208","371","19","598","1207","0","49.54","17.23"
"10","013","00","007","0704","0320","740","267","473","74","814","1340","0","60.75","19.93"
"10","013","00","007","0705","0000","668","270","398","53","721","1221","0","59.05","22.11"
"10","013","00","007","0705","0321","668","270","398","53","721","1221","0","59.05","22.11"
"10","013","00","007","0706","0000","437","164","273","17","454","851","0","53.35","19.27"
"10","013","00","007","0706","0322","437","164","273","17","454","851","0","53.35","19.27"
"10","013","00","007","0707","0000","347","116","231","10","357","683","0","52.27","16.98"
"10","013","00","007","0707","0323","347","116","231","10","357","683","0","52.27","16.98"
"10","013","00","008","0000","0000","9347","2950","6397","1075","10422","19132","22095","54.47","15.42"
"10","013","00","008","0801","0000","757","256","501","77","834","1491","0","55.94","17.17"
"10","013","00","008","0801","0324","757","256","501","77","834","1491","0","55.94","17.17"
"10","013","00","008","0802","0000","685","235","450","55","740","1375","0","53.82","17.09"
"10","013","00","008","0802","0325","685","235","450","55","740","1375","0","53.82","17.09"
"10","013","00","008","0803","0000","782","235","547","48","830","1678","0","49.46","14.0"
"10","013","00","008","0803","0326","782","235","547","48","830","1678","0","49.46","14.0"
"10","013","00","008","0804","0000","529","196","333","45","574","1276","0","44.98","15.36"
"10","013","00","008","0804","0328","529","196","333","45","574","1276","0","44.98","15.36"
"10","013","00","008","0805","0000","622","195","427","63","685","1166","0","58.75","16.72"
"10","013","00","008","0805","0327","622","195","427","63","685","1166","0","58.75","16.72"
"10","013","00","008","0806","0000","746","269","477","89","835","1600","0","52.19","16.81"
"10","013","00","008","0806","0334","746","269","477","89","835","1600","0","52.19","16.81"
"10","013","00","008","0807","0000","885","276","609","153","1038","1792","0","57.92","15.4"
"10","013","00","008","0807","0336","885","276","609","153","1038","1792","0","57.92","15.4"
"10","013","00","008","0808","0000","592","183","409","88","680","1248","0","54.49","14.66"
"10","013","00","008","0808","0335","592","183","409","88","680","1248","0","54.49","14.66"
"10","013","00","008","0809","0000","735","219","516","81","816","1482","0","55.06","14.78"
"10","013","00","008","0809","0337","735","219","516","81","816","1482","0","55.06","14.78"
"10","013","00","008","0810","0000","2136","602","1534","274","2410","4414","0","54.6","13.64"
"10","013","00","008","0810","0331","347","110","237","52","399","649","0","61.48","16.95"
"10","013","00","008","0810","0332","960","218","742","133","1093","1999","0","54.68","10.91"
"10","013","00","008","0810","0333","829","274","555","89","918","1766","0","51.98","15.52"
"10","013","00","008","0811","0000","878","284","594","102","980","1610","0","60.87","17.64"
"10","013","00","008","0811","0329","513","175","338","70","583","1033","0","56.44","16.94"
"10","013","00","008","0811","0330","365","109","256","32","397","577","0","68.8","18.89"
"10","013","00","009","0000","0000","10842","3616","7226","1218","12060","22128","26092","54.5","16.34"
"10","013","00","009","0901","0000","1562","532","1030","141","1703","3032","0","56.17","17.55"
"10","013","00","009","0901","0338","834","269","565","81","915","1552","0","58.96","17.33"
"10","013","00","009","0901","0339","728","263","465","60","788","1480","0","53.24","17.77"
"10","013","00","009","0902","0000","626","215","411","46","672","1127","0","59.63","19.08"
"10","013","00","009","0902","0342","626","215","411","46","672","1127","0","59.63","19.08"
"10","013","00","009","0903","0000","453","153","300","46","499","845","0","59.05","18.11"
"10","013","00","009","0903","0343","453","153","300","46","499","845","0","59.05","18.11"
"10","013","00","009","0904","0000","617","202","415","59","676","1282","0","52.73","15.76"
"10","013","00","009","0904","0344","617","202","415","59","676","1282","0","52.73","15.76"
"10","013","00","009","0905","0000","1041","347","694","121","1162","2012","0","57.75","17.25"
"10","013","00","009","0905","0345","504","167","337","62","566","981","0","57.7","17.02"
"10","013","00","009","0905","0346","537","180","357","59","596","1031","0","57.81","17.46"
"10","013","00","009","0906","0000","627","182","445","73","700","1423","0","49.19","12.79"
"10","013","00","009","0906","0347","627","182","445","73","700","1423","0","49.19","12.79"
"10","013","00","009","0907","0000","637","209","428","54","691","1534","0","45.05","13.62"
"10","013","00","009","0907","0340","637","209","428","54","691","1534","0","45.05","13.62"
"10","013","00","009","0908","0000","769","273","496","86","855","1578","0","54.18","17.3"
"10","013","00","009","0908","0341","769","273","496","86","855","1578","0","54.18","17.3"
"10","013","00","009","0909","0000","741","272","469","126","867","1566","0","55.36","17.37"
"10","013","00","009","0909","0348","145","53","92","21","166","363","0","45.73","14.6"
"10","013","00","009","0909","0349","596","219","377","105","701","1203","0","58.27","18.2"
"10","013","00","009","0910","0000","1198","389","809","137","1335","2411","0","55.37","16.13"
"10","013","00","009","0910","0350","559","166","393","79","638","1027","0","62.12","16.16"
"10","013","00","009","0910","0351","639","223","416","58","697","1384","0","50.36","16.11"
"10","013","00","009","0911","0000","996","302","694","99","1095","2034","0","53.83","14.85"
"10","013","00","009","0911","0352","701","237","464","86","787","1512","0","52.05","15.67"
"10","013","00","009","0911","0353","295","65","230","13","308","522","0","59.0","12.45"
"10","013","00","009","0912","0000","839","279","560","147","986","1829","0","53.91","15.25"
"10","013","00","009","0912","0354","389","121","268","68","457","822","0","55.6","14.72"
"10","013","00","009","0912","0355","450","158","292","79","529","1007","0","52.53","15.69"
"10","013","00","009","0913","0000","472","169","303","65","537","956","0","56.17","17.68"
"10","013","00","009","0913","0356","472","169","303","65","537","956","0","56.17","17.68"
"10","013","00","009","0914","0000","264","92","172","18","282","499","0","56.51","18.44"
"10","013","00","009","0914","0357","264","92","172","18","282","499","0","56.51","18.44"
"10","013","00","010","0000","0000","10714","3430","7284","908","11622","22402","25740","51.88","15.31"
"10","013","00","010","1001","0000","1444","478","966","121","1565","3148","0","49.71","15.18"
"10","013","00","010","1001","0370","701","218","483","34","735","1598","0","45.99","13.64"
"10","013","00","010","1001","0371","743","260","483","87","830","1550","0","53.55","16.77"
"10","013","00","010","1002","0000","1257","409","848","129","1386","2832","0","48.94","14.44"
"10","013","00","010","1002","0365","645","231","414","62","707","1367","0","51.72","16.9"
"10","013","00","010","1002","0366","612","178","434","67","679","1465","0","46.35","12.15"
"10","013","00","010","1003","0000","894","270","624","45","939","1850","0","50.76","14.59"
"10","013","00","010","1003","0358","470","139","331","26","496","951","0","52.16","14.62"
"10","013","00","010","1003","0359","424","131","293","19","443","899","0","49.28","14.57"
"10","013","00","010","1004","0000","1063","337","726","59","1122","2357","0","47.6","14.3"
"10","013","00","010","1004","0360","473","160","313","24","497","1116","0","44.53","14.34"
"10","013","00","010","1004","0361","590","177","413","35","625","1241","0","50.36","14.26"
"10","013","00","010","1005","0000","840","284","556","74","914","1732","0","52.77","16.4"
"10","013","00","010","1005","0362","368","119","249","35","403","770","0","52.34","15.45"
"10","013","00","010","1005","0363","472","165","307","39","511","962","0","53.12","17.15"
"10","013","00","010","1006","0000","574","177","397","57","631","1041","0","60.61","17.0"
"10","013","00","010","1006","0364","574","177","397","57","631","1041","0","60.61","17.0"
"10","013","00","010","1007","0000","796","275","521","45","841","1852","0","45.41","14.85"
"10","013","00","010","1007","0367","383","140","243","43","426","894","0","47.65","15.66"
"10","013","00","010","1007","0368","413","135","278","2","415","958","0","43.32","14.09"
"10","013","00","010","1008","0000","279","86","193","28","307","553","0","55.52","15.55"
"10","013","00","010","1008","0377","279","86","193","28","307","553","0","55.52","15.55"
"10","013","00","010","1009","0000","425","132","293","72","497","924","0","53.79","14.29"
"10","013","00","010","1009","0369","425","132","293","72","497","924","0","53.79","14.29"
"10","013","00","010","1010","0000","839","289","550","39","878","1619","0","54.23","17.85"
"10","013","00","010","1010","0376","839","289","550","39","878","1619","0","54.23","17.85"
"10","013","00","010","1011","0000","1780","574","1206","170","1950","3510","0","55.56","16.35"
"10","013","00","010","1011","0372","545","179","366","60","605","1127","0","53.68","15.88"
"10","013","00","010","1011","0373","603","184","419","67","670","1150","0","58.26","16.0"
"10","013","00","010","1011","0374","632","211","421","43","675","1233","0","54.74","17.11"
"10","013","00","010","1012","0000","523","119","404","69","592","984","0","60.16","12.09"
"10","013","00","010","1012","0375","523","119","404","69","592","984","0","60.16","12.09"
"10","013","00","011","0000","0000","9542","3246","6296","1121","10663","21697","24444","49.15","14.96"
"10","013","00","011","1101","0000","926","339","587","95","1021","2138","0","47.75","15.86"
"10","013","00","011","1101","0378","479","176","303","72","551","883","0","62.4","19.93"
"10","013","00","011","1101","0379","447","163","284","23","470","1255","0","37.45","12.99"
"10","013","00","011","1102","0000","612","201","411","33","645","1278","0","50.47","15.73"
"10","013","00","011","1102","0380","612","201","411","33","645","1278","0","50.47","15.73"
"10","013","00","011","1103","0000","313","84","229","22","335","738","0","45.39","11.38"
"10","013","00","011","1103","0381","313","84","229","22","335","738","0","45.39","11.38"
"10","013","00","011","1104","0000","249","91","158","16","265","585","0","45.3","15.56"
"10","013","00","011","1104","0382","249","91","158","16","265","585","0","45.3","15.56"
"10","013","00","011","1105","0000","486","186","300","110","596","1012","0","58.89","18.38"
"10","013","00","011","1105","0383","486","186","300","110","596","1012","0","58.89","18.38"
"10","013","00","011","1106","0000","495","179","316","78","573","1148","0","49.91","15.59"
"10","013","00","011","1106","0384","495","179","316","78","573","1148","0","49.91","15.59"
"10","013","00","011","1107","0000","266","92","174","34","300","591","0","50.76","15.57"
"10","013","00","011","1107","0385","266","92","174","34","300","591","0","50.76","15.57"
"10","013","00","011","1108","0000","315","117","198","47","362","786","0","46.06","14.89"
"10","013","00","011","1108","0386","315","117","198","47","362","786","0","46.06","14.89"
"10","013","00","011","1109","0000","262","78","184","18","280","649","0","43.14","12.02"
"10","013","00","011","1109","0387","262","78","184","18","280","649","0","43.14","12.02"
"10","013","00","011","1110","0000","449","135","314","66","515","1229","0","41.9","10.98"
"10","013","00","011","1110","0388","449","135","314","66","515","1229","0","41.9","10.98"
"10","013","00","011","1111","0000","579","173","406","53","632","1446","0","43.71","11.96"
"10","013","00","011","1111","0389","579","173","406","53","632","1446","0","43.71","11.96"
"10","013","00","011","1112","0000","774","305","469","61","835","1821","0","45.85","16.75"
"10","013","00","011","1112","0390","344","159","185","15","359","899","0","39.93","17.69"
"10","013","00","011","1112","0391","430","146","284","46","476","922","0","51.63","15.84"
"10","013","00","011","1113","0000","525","184","341","72","597","1259","0","47.42","14.61"
"10","013","00","011","1113","0392","525","184","341","72","597","1259","0","47.42","14.61"
"10","013","00","011","1114","0000","391","121","270","24","415","1056","0","39.3","11.46"
"10","013","00","011","1114","0393","391","121","270","24","415","1056","0","39.3","11.46"
"10","013","00","011","1115","0000","525","156","369","72","597","1116","0","53.49","13.98"
"10","013","00","011","1115","0394","525","156","369","72","597","1116","0","53.49","13.98"
"10","013","00","011","1116","0000","513","179","334","60","573","1020","0","56.18","17.55"
"10","013","00","011","1116","0395","513","179","334","60","573","1020","0","56.18","17.55"
"10","013","00","011","1117","0000","492","167","325","82","574","1055","0","54.41","15.83"
"10","013","00","011","1117","0396","492","167","325","82","574","1055","0","54.41","15.83"
"10","013","00","011","1118","0000","603","202","401","75","678","1231","0","55.08","16.41"
"10","013","00","011","1118","0397","396","136","260","45","441","738","0","59.76","18.43"
"10","013","00","011","1118","0398","207","66","141","30","237","493","0","48.07","13.39"
"10","013","00","011","1119","0000","767","257","510","103","870","1539","0","56.53","16.7"
"10","013","00","011","1119","0399","767","257","510","103","870","1539","0","56.53","16.7"
"10","013","00","012","0000","0000","8230","2813","5417","920","9150","17945","20585","50.99","15.68"
"10","013","00","012","1201","0000","566","205","361","40","606","1239","0","48.91","16.55"
"10","013","00","012","1201","0400","566","205","361","40","606","1239","0","48.91","16.55"
"10","013","00","012","1202","0000","386","155","231","55","441","759","0","58.1","20.42"
"10","013","00","012","1202","0401","386","155","231","55","441","759","0","58.1","20.42"
"10","013","00","012","1203","0000","883","313","570","138","1021","1701","0","60.02","18.4"
"10","013","00","012","1203","0402","471","158","313","86","557","932","0","59.76","16.95"
"10","013","00","012","1203","0403","412","155","257","52","464","769","0","60.34","20.16"
"10","013","00","012","1204","0000","425","154","271","81","506","920","0","55.0","16.74"
"10","013","00","012","1204","0404","425","154","271","81","506","920","0","55.0","16.74"
"10","013","00","012","1205","0000","292","116","176","35","327","560","0","58.39","20.71"
"10","013","00","012","1205","0405","292","116","176","35","327","560","0","58.39","20.71"
"10","013","00","012","1206","0000","484","148","336","31","515","1120","0","45.98","13.21"
"10","013","00","012","1206","0406","484","148","336","31","515","1120","0","45.98","13.21"
"10","013","00","012","1207","0000","484","143","341","25","509","1048","0","48.57","13.65"
"10","013","00","012","1207","0407","484","143","341","25","509","1048","0","48.57","13.65"
"10","013","00","012","1208","0000","592","188","404","50","642","1438","0","44.65","13.07"
"10","013","00","012","1208","0408","592","188","404","50","642","1438","0","44.65","13.07"
"10","013","00","012","1209","0000","967","322","645","99","1066","2027","0","52.59","15.89"
"10","013","00","012","1209","0411","443","116","327","31","474","1020","0","46.47","11.37"
"10","013","00","012","1209","0412","524","206","318","68","592","1007","0","58.79","20.46"
"10","013","00","012","1210","0000","712","241","471","128","840","1647","0","51.0","14.63"
"10","013","00","012","1210","0409","352","125","227","63","415","834","0","49.76","14.99"
"10","013","00","012","1210","0410","360","116","244","65","425","813","0","52.28","14.27"
"10","013","00","012","1211","0000","655","229","426","74","729","1648","0","44.24","13.9"
"10","013","00","012","1211","0413","655","229","426","74","729","1648","0","44.24","13.9"
"10","013","00","012","1212","0000","658","234","424","64","722","1437","0","50.24","16.28"
"10","013","00","012","1212","0414","658","234","424","64","722","1437","0","50.24","16.28"
"10","013","00","012","1213","0000","522","200","322","24","546","1228","0","44.46","16.29"
"10","013","00","012","1213","0415","522","200","322","24","546","1228","0","44.46","16.29"
"10","013","00","012","1214","0000","604","165","439","76","680","1173","0","57.97","14.07"
"10","013","00","012","1214","0416","322","76","246","40","362","597","0","60.64","12.73"
"10","013","00","012","1214","0417","282","89","193","36","318","576","0","55.21","15.45"
"10","013","00","013","0000","0000","21023","6775","14248","1649","22672","47558","54167","47.67","14.25"
"10","013","00","013","1301","0000","1764","524","1240","92","1856","3979","0","46.64","13.17"
"10","013","00","013","1301","0418","567","160","407","36","603","1305","0","46.21","12.26"
"10","013","00","013","1301","0419","575","166","409","37","612","1287","0","47.55","12.9"
"10","013","00","013","1301","0420","622","198","424","19","641","1387","0","46.21","14.28"
"10","013","00","013","1302","0000","1431","498","933","84","1515","3145","0","48.17","15.83"
"10","013","00","013","1302","0421","694","236","458","33","727","1540","0","47.21","15.32"
"10","013","00","013","1302","0422","737","262","475","51","788","1605","0","49.1","16.32"
"10","013","00","013","1303","0000","608","198","410","57","665","1326","0","50.15","14.93"
"10","013","00","013","1303","0423","608","198","410","57","665","1326","0","50.15","14.93"
"10","013","00","013","1304","0000","291","98","193","43","334","591","0","56.51","16.58"
"10","013","00","013","1304","0424","291","98","193","43","334","591","0","56.51","16.58"
"10","013","00","013","1305","0000","1009","323","686","54","1063","2202","0","48.27","14.67"
"10","013","00","013","1305","0425","499","174","325","40","539","1123","0","48.0","15.49"
"10","013","00","013","1305","0426","510","149","361","14","524","1079","0","48.56","13.81"
"10","013","00","013","1306","0000","1381","424","957","92","1473","2733","0","53.9","15.51"
"10","013","00","013","1306","0427","708","223","485","58","766","1485","0","51.58","15.02"
"10","013","00","013","1306","0428","673","201","472","34","707","1248","0","56.65","16.11"
"10","013","00","013","1307","0000","2045","714","1331","124","2169","4482","0","48.39","15.93"
"10","013","00","013","1307","0429","753","278","475","44","797","1569","0","50.8","17.72"
"10","013","00","013","1307","0430","648","213","435","71","719","1493","0","48.16","14.27"
"10","013","00","013","1307","0431","644","223","421","9","653","1420","0","45.99","15.7"
"10","013","00","013","1308","0000","1292","415","877","140","1432","2853","0","50.19","14.55"
"10","013","00","013","1308","0432","623","186","437","70","693","1334","0","51.95","13.94"
"10","013","00","013","1308","0433","669","229","440","70","739","1519","0","48.65","15.08"
"10","013","00","013","1309","0000","831","283","548","91","922","1672","0","55.14","16.93"
"10","013","00","013","1309","0434","383","135","248","38","421","784","0","53.7","17.22"
"10","013","00","013","1309","0435","448","148","300","53","501","888","0","56.42","16.67"
"10","013","00","013","1310","0000","728","253","475","48","776","1915","0","40.52","13.21"
"10","013","00","013","1310","0436","271","98","173","18","289","747","0","38.69","13.12"
"10","013","00","013","1310","0437","457","155","302","30","487","1168","0","41.7","13.27"
"10","013","00","013","1311","0000","869","299","570","76","945","1824","0","51.81","16.39"
"10","013","00","013","1311","0438","280","104","176","32","312","546","0","57.14","19.05"
"10","013","00","013","1311","0439","589","195","394","44","633","1278","0","49.53","15.26"
"10","013","00","013","1312","0000","1121","392","729","129","1250","2898","0","43.13","13.53"
"10","013","00","013","1312","0440","548","193","355","48","596","1348","0","44.21","14.32"
"10","013","00","013","1312","0441","573","199","374","81","654","1550","0","42.19","12.84"
"10","013","00","013","1313","0000","514","158","356","59","573","947","0","60.51","16.68"
"10","013","00","013","1313","0442","514","158","356","59","573","947","0","60.51","16.68"
"10","013","00","013","1314","0000","487","176","311","77","564","1097","0","51.41","16.04"
"10","013","00","013","1314","0443","487","176","311","77","564","1097","0","51.41","16.04"
"10","013","00","013","1315","0000","845","310","535","77","922","2381","0","38.72","13.02"
"10","013","00","013","1315","0444","420","169","251","58","478","1128","0","42.38","14.98"
"10","013","00","013","1315","0445","425","141","284","19","444","1253","0","35.43","11.25"
"10","013","00","013","1316","0000","577","174","403","27","604","1525","0","39.61","11.41"
"10","013","00","013","1316","0446","577","174","403","27","604","1525","0","39.61","11.41"
"10","013","00","013","1317","0000","1054","310","744","99","1153","2431","0","47.43","12.75"
"10","013","00","013","1317","0447","571","174","397","69","640","1215","0","52.67","14.32"
"10","013","00","013","1317","0448","483","136","347","30","513","1216","0","42.19","11.18"
"10","013","00","013","1318","0000","1062","302","760","67","1129","2379","0","47.46","12.69"
"10","013","00","013","1318","0449","580","164","416","36","616","1353","0","45.53","12.12"
"10","013","00","013","1318","0450","482","138","344","31","513","1026","0","50.0","13.45"
"10","013","00","013","1319","0000","371","119","252","30","401","862","0","46.52","13.81"
"10","013","00","013","1319","0451","371","119","252","30","401","862","0","46.52","13.81"
"10","013","00","013","1320","0000","745","252","493","50","795","1775","0","44.79","14.2"
"10","013","00","013","1320","0452","337","113","224","32","369","921","0","40.07","12.27"
"10","013","00","013","1320","0453","408","139","269","18","426","854","0","49.88","16.28"
"10","013","00","013","1321","0000","1023","288","735","59","1082","2434","0","44.45","11.83"
"10","013","00","013","1321","0454","502","147","355","43","545","1230","0","44.31","11.95"
"10","013","00","013","1321","0455","521","141","380","16","537","1204","0","44.6","11.71"
"10","013","00","013","1322","0000","564","163","401","32","596","1301","0","45.81","12.53"
"10","013","00","013","1322","0456","564","163","401","32","596","1301","0","45.81","12.53"
"10","013","00","013","1323","0000","411","102","309","42","453","806","0","56.2","12.66"
"10","013","00","013","1323","0457","411","102","309","42","453","806","0","56.2","12.66"
"10","013","00","014","0000","0000","8018","3162","4856","812","8830","15353","17181","57.51","20.6"
"10","013","00","014","1401","0000","762","214","548","80","842","1503","0","56.02","14.24"
"10","013","00","014","1401","0458","762","214","548","80","842","1503","0","56.02","14.24"
"10","013","00","014","1402","0000","512","176","336","40","552","899","0","61.4","19.58"
"10","013","00","014","1402","0459","512","176","336","40","552","899","0","61.4","19.58"
"10","013","00","014","1403","0000","411","143","268","42","453","716","0","63.27","19.97"
"10","013","00","014","1403","0460","411","143","268","42","453","716","0","63.27","19.97"
"10","013","00","014","1404","0000","345","133","212","38","383","581","0","65.92","22.89"
"10","013","00","014","1404","0461","345","133","212","38","383","581","0","65.92","22.89"
"10","013","00","014","1405","0000","646","520","126","93","739","1327","0","55.69","39.19"
"10","013","00","014","1405","0462","646","520","126","93","739","1327","0","55.69","39.19"
"10","013","00","014","1406","0000","553","182","371","69","622","997","0","62.39","18.25"
"10","013","00","014","1406","0463","553","182","371","69","622","997","0","62.39","18.25"
"10","013","00","014","1407","0000","322","120","202","30","352","649","0","54.24","18.49"
"10","013","00","014","1407","0464","322","120","202","30","352","649","0","54.24","18.49"
"10","013","00","014","1408","0000","328","110","218","19","347","476","0","72.9","23.11"
"10","013","00","014","1408","0465","328","110","218","19","347","476","0","72.9","23.11"
"10","013","00","014","1409","0000","1257","656","601","125","1382","2486","0","55.59","26.39"
"10","013","00","014","1409","0466","676","461","215","63","739","1259","0","58.7","36.62"
"10","013","00","014","1409","0467","581","195","386","62","643","1227","0","52.4","15.89"
"10","013","00","014","1410","0000","291","101","190","31","322","504","0","63.89","20.04"
"10","013","00","014","1410","0468","291","101","190","31","322","504","0","63.89","20.04"
"10","013","00","014","1411","0000","412","122","290","51","463","860","0","53.84","14.19"
"10","013","00","014","1411","0469","412","122","290","51","463","860","0","53.84","14.19"
"10","013","00","014","1412","0000","401","136","265","23","424","800","0","53.0","17.0"
"10","013","00","014","1412","0470","401","136","265","23","424","800","0","53.0","17.0"
"10","013","00","014","1413","0000","585","190","395","71","656","1134","0","57.85","16.75"
"10","013","00","014","1413","0471","585","190","395","71","656","1134","0","57.85","16.75"
"10","013","00","014","1414","0000","615","190","425","49","664","1229","0","54.03","15.46"
"10","013","00","014","1414","0472","615","190","425","49","664","1229","0","54.03","15.46"
"10","013","00","014","1415","0000","578","169","409","51","629","1192","0","52.77","14.18"
"10","013","00","014","1415","0473","578","169","409","51","629","1192","0","52.77","14.18"
"10","013","00","015","0000","0000","4113","1301","2812","445","4558","9033","10035","50.46","14.4"
"10","013","00","015","1501","0000","911","304","607","75","986","2026","0","48.67","15.0"
"10","013","00","015","1501","0474","769","263","506","42","811","1712","0","47.37","15.36"
"10","013","00","015","1501","0475","142","41","101","33","175","314","0","55.73","13.06"
"10","013","00","015","1502","0000","540","174","366","51","591","1086","0","54.42","16.02"
"10","013","00","015","1502","0476","379","129","250","28","407","752","0","54.12","17.15"
"10","013","00","015","1502","0477","161","45","116","23","184","334","0","55.09","13.47"
"10","013","00","015","1503","0000","484","135","349","58","542","957","0","56.64","14.11"
"10","013","00","015","1503","0478","484","135","349","58","542","957","0","56.64","14.11"
"10","013","00","015","1504","0000","392","133","259","59","451","764","0","59.03","17.41"
"10","013","00","015","1504","0479","392","133","259","59","451","764","0","59.03","17.41"
"10","013","00","015","1505","0000","783","251","532","77","860","1752","0","49.09","14.33"
"10","013","00","015","1505","0480","192","60","132","22","214","373","0","57.37","16.09"
"10","013","00","015","1505","0481","288","92","196","29","317","678","0","46.76","13.57"
"10","013","00","015","1505","0482","303","99","204","26","329","701","0","46.93","14.12"
"10","013","00","015","1506","0000","529","156","373","54","583","1125","0","51.82","13.87"
"10","013","00","015","1506","0484","280","85","195","32","312","541","0","57.67","15.71"
"10","013","00","015","1506","0485","249","71","178","22","271","584","0","46.4","12.16"
"10","013","00","015","1507","0000","474","148","326","71","545","1323","0","41.19","11.19"
"10","013","00","015","1507","0483","474","148","326","71","545","1323","0","41.19","11.19"
"10","013","00","016","0000","0000","9969","3196","6773","1214","11183","21394","24413","52.27","14.94"
"10","013","00","016","1601","0000","622","191","431","59","681","1213","0","56.14","15.75"
"10","013","00","016","1601","0486","622","191","431","59","681","1213","0","56.14","15.75"
"10","013","00","016","1602","0000","468","147","321","51","519","891","0","58.25","16.5"
"10","013","00","016","1602","0487","468","147","321","51","519","891","0","58.25","16.5"
"10","013","00","016","1603","0000","423","120","303","73","496","970","0","51.13","12.37"
"10","013","00","016","1603","0488","423","120","303","73","496","970","0","51.13","12.37"
"10","013","00","016","1604","0000","307","95","212","30","337","629","0","53.58","15.1"
"10","013","00","016","1604","0489","307","95","212","30","337","629","0","53.58","15.1"
"10","013","00","016","1605","0000","851","276","575","85","936","1614","0","57.99","17.1"
"10","013","00","016","1605","0490","439","165","274","47","486","840","0","57.86","19.64"
"10","013","00","016","1605","0491","412","111","301","38","450","774","0","58.14","14.34"
"10","013","00","016","1606","0000","1821","599","1222","189","2010","4157","0","48.35","14.41"
"10","013","00","016","1606","0492","654","284","370","61","715","1379","0","51.85","20.59"
"10","013","00","016","1606","0493","673","150","523","57","730","1502","0","48.6","9.99"
"10","013","00","016","1606","0494","494","165","329","71","565","1276","0","44.28","12.93"
"10","013","00","016","1607","0000","986","311","675","142","1128","1969","0","57.29","15.79"
"10","013","00","016","1607","0495","458","153","305","59","517","964","0","53.63","15.87"
"10","013","00","016","1607","0496","528","158","370","83","611","1005","0","60.8","15.72"
"10","013","00","016","1608","0000","713","205","508","64","777","1459","0","53.26","14.05"
"10","013","00","016","1608","0497","348","96","252","21","369","734","0","50.27","13.08"
"10","013","00","016","1608","0498","365","109","256","43","408","725","0","56.28","15.03"
"10","013","00","016","1609","0000","1010","330","680","128","1138","2113","0","53.86","15.62"
"10","013","00","016","1609","0499","474","165","309","53","527","1046","0","50.38","15.77"
"10","013","00","016","1609","0500","536","165","371","75","611","1067","0","57.26","15.46"
"10","013","00","016","1610","0000","225","68","157","52","277","718","0","38.58","9.47"
"10","013","00","016","1610","0501","225","68","157","52","277","718","0","38.58","9.47"
"10","013","00","016","1611","0000","369","114","255","49","418","903","0","46.29","12.62"
"10","013","00","016","1611","0502","369","114","255","49","418","903","0","46.29","12.62"
"10","013","00","016","1612","0000","357","128","229","34","391","959","0","40.77","13.35"
"10","013","00","016","1612","0506","357","128","229","34","391","959","0","40.77","13.35"
"10","013","00","016","1613","0000","208","71","137","28","236","427","0","55.27","16.63"
"10","013","00","016","1613","0507","208","71","137","28","236","427","0","55.27","16.63"
"10","013","00","016","1614","0000","1273","414","859","177","1450","2754","0","52.65","15.03"
"10","013","00","016","1614","0503","606","195","411","88","694","1387","0","50.04","14.06"
"10","013","00","016","1614","0504","667","219","448","89","756","1367","0","55.3","16.02"
"10","013","00","016","1615","0000","336","127","209","53","389","618","0","62.94","20.55"
"10","013","00","016","1615","0505","336","127","209","53","389","618","0","62.94","20.55"
"10","013","00","017","0000","0000","14586","4787","9799","1559","16145","30706","34961","52.58","15.59"
"10","013","00","017","1701","0000","900","319","581","80","980","1663","0","58.93","19.18"
"10","013","00","017","1701","0508","435","154","281","37","472","820","0","57.56","18.78"
"10","013","00","017","1701","0509","465","165","300","43","508","843","0","60.26","19.57"
"10","013","00","017","1702","0000","1289","415","874","96","1385","2532","0","54.7","16.39"
"10","013","00","017","1702","0510","600","195","405","43","643","1242","0","51.77","15.7"
"10","013","00","017","1702","0511","689","220","469","53","742","1290","0","57.52","17.05"
"10","013","00","017","1703","0000","1080","351","729","129","1209","2161","0","55.95","16.24"
"10","013","00","017","1703","0512","527","183","344","37","564","1073","0","52.56","17.05"
"10","013","00","017","1703","0513","553","168","385","92","645","1088","0","59.28","15.44"
"10","013","00","017","1704","0000","381","120","261","36","417","845","0","49.35","14.2"
"10","013","00","017","1704","0514","381","120","261","36","417","845","0","49.35","14.2"
"10","013","00","017","1705","0000","422","160","262","49","471","862","0","54.64","18.56"
"10","013","00","017","1705","0515","422","160","262","49","471","862","0","54.64","18.56"
"10","013","00","017","1706","0000","1038","322","716","158","1196","2292","0","52.18","14.05"
"10","013","00","017","1706","0516","513","167","346","75","588","1183","0","49.7","14.12"
"10","013","00","017","1706","0517","525","155","370","83","608","1109","0","54.82","13.98"
"10","013","00","017","1707","0000","1037","344","693","48","1085","2271","0","47.78","15.15"
"10","013","00","017","1707","0518","500","163","337","12","512","1119","0","45.76","14.57"
"10","013","00","017","1707","0519","537","181","356","36","573","1152","0","49.74","15.71"
"10","013","00","017","1708","0000","511","212","299","35","546","1240","0","44.03","17.1"
"10","013","00","017","1708","0522","511","212","299","35","546","1240","0","44.03","17.1"
"10","013","00","017","1709","0000","985","335","650","92","1077","2194","0","49.09","15.27"
"10","013","00","017","1709","0523","431","153","278","22","453","1120","0","40.45","13.66"
"10","013","00","017","1709","0524","554","182","372","70","624","1074","0","58.1","16.95"
"10","013","00","017","1710","0000","724","256","468","84","808","1598","0","50.56","16.02"
"10","013","00","017","1710","0525","362","134","228","35","397","849","0","46.76","15.78"
"10","013","00","017","1710","0526","362","122","240","49","411","749","0","54.87","16.29"
"10","013","00","017","1711","0000","639","210","429","81","720","1416","0","50.85","14.83"
"10","013","00","017","1711","0527","639","210","429","81","720","1416","0","50.85","14.83"
"10","013","00","017","1712","0000","1034","329","705","123","1157","2134","0","54.22","15.42"
"10","013","00","017","1712","0520","525","152","373","44","569","1030","0","55.24","14.76"
"10","013","00","017","1712","0521","509","177","332","79","588","1104","0","53.26","16.03"
"10","013","00","017","1713","0000","1365","411","954","158","1523","2800","0","54.39","14.68"
"10","013","00","017","1713","0528","429","130","299","53","482","895","0","53.85","14.53"
"10","013","00","017","1713","0529","456","142","314","63","519","933","0","55.63","15.22"
"10","013","00","017","1713","0530","480","139","341","42","522","972","0","53.7","14.3"
"10","013","00","017","1714","0000","2045","570","1475","222","2267","4377","0","51.79","13.02"
"10","013","00","017","1714","0531","599","192","407","63","662","1454","0","45.53","13.2"
"10","013","00","017","1714","0532","875","229","646","90","965","1653","0","58.38","13.85"
"10","013","00","017","1714","0533","571","149","422","69","640","1270","0","50.39","11.73"
"10","013","00","017","1715","0000","1136","433","703","168","1304","2321","0","56.18","18.66"
"10","013","00","017","1715","0534","587","268","319","94","681","1123","0","60.64","23.86"
"10","013","00","017","1715","0535","549","165","384","74","623","1198","0","52.0","13.77"
"10","013","00","018","0000","0000","5879","2014","3865","553","6432","12270","15524","52.42","16.41"
"10","013","00","018","1801","0000","1074","363","711","116","1190","2234","0","53.27","16.25"
"10","013","00","018","1801","0536","540","175","365","53","593","1190","0","49.83","14.71"
"10","013","00","018","1801","0537","534","188","346","63","597","1044","0","57.18","18.01"
"10","013","00","018","1802","0000","990","325","665","92","1082","2032","0","53.25","15.99"
"10","013","00","018","1802","0538","403","151","252","49","452","818","0","55.26","18.46"
"10","013","00","018","1802","0539","587","174","413","43","630","1214","0","51.89","14.33"
"10","013","00","018","1803","0000","658","232","426","51","709","1253","0","56.58","18.52"
"10","013","00","018","1803","0541","658","232","426","51","709","1253","0","56.58","18.52"
"10","013","00","018","1804","0000","608","191","417","26","634","1325","0","47.85","14.42"
"10","013","00","018","1804","0540","608","191","417","26","634","1325","0","47.85","14.42"
"10","013","00","018","1805","0000","486","186","300","43","529","1039","0","50.91","17.9"
"10","013","00","018","1805","0542","486","186","300","43","529","1039","0","50.91","17.9"
"10","013","00","018","1806","0000","690","235","455","68","758","1549","0","48.93","15.17"
"10","013","00","018","1806","0543","345","118","227","47","392","813","0","48.22","14.51"
"10","013","00","018","1806","0544","345","117","228","21","366","736","0","49.73","15.9"
"10","013","00","018","1807","0000","481","172","309","45","526","934","0","56.32","18.42"
"10","013","00","018","1807","0545","481","172","309","45","526","934","0","56.32","18.42"
"10","013","00","018","1808","0000","892","310","582","112","1004","1904","0","52.73","16.28"
"10","013","00","018","1808","0546","409","147","262","64","473","900","0","52.56","16.33"
"10","013","00","018","1808","0547","483","163","320","48","531","1004","0","52.89","16.24"
"10","013","00","019","0000","0000","7872","2763","5109","849","8721","15691","17842","55.58","17.61"
"10","013","00","019","1901","0000","770","231","539","88","858","1458","0","58.85","15.84"
"10","013","00","019","1901","0548","770","231","539","88","858","1458","0","58.85","15.84"
"10","013","00","019","1902","0000","875","278","597","77","952","1586","0","60.03","17.53"
"10","013","00","019","1902","0549","485","156","329","44","529","891","0","59.37","17.51"
"10","013","00","019","1902","0550","390","122","268","33","423","695","0","60.86","17.55"
"10","013","00","019","1903","0000","875","302","573","98","973","1634","0","59.55","18.48"
"10","013","00","019","1903","0555","443","158","285","56","499","841","0","59.33","18.79"
"10","013","00","019","1903","0556","432","144","288","42","474","793","0","59.77","18.16"
"10","013","00","019","1904","0000","422","157","265","38","460","725","0","63.45","21.66"
"10","013","00","019","1904","0554","422","157","265","38","460","725","0","63.45","21.66"
"10","013","00","019","1905","0000","1670","561","1109","151","1821","3189","0","57.1","17.59"
"10","013","00","019","1905","0551","548","180","368","57","605","1015","0","59.61","17.73"
"10","013","00","019","1905","0552","630","224","406","46","676","1171","0","57.73","19.13"
"10","013","00","019","1905","0553","492","157","335","48","540","1003","0","53.84","15.65"
"10","013","00","019","1906","0000","761","250","511","93","854","1816","0","47.03","13.77"
"10","013","00","019","1906","0559","338","123","215","44","382","783","0","48.79","15.71"
"10","013","00","019","1906","0560","423","127","296","49","472","1033","0","45.69","12.29"
"10","013","00","019","1907","0000","601","207","394","65","666","1283","0","51.91","16.13"
"10","013","00","019","1907","0558","601","207","394","65","666","1283","0","51.91","16.13"
"10","013","00","019","1908","0000","495","343","152","52","547","919","0","59.52","37.32"
"10","013","00","019","1908","0557","495","343","152","52","547","919","0","59.52","37.32"
"10","013","00","019","1909","0000","916","286","630","143","1059","1959","0","54.06","14.6"
"10","013","00","019","1909","0561","552","171","381","87","639","1186","0","53.88","14.42"
"10","013","00","019","1909","0562","364","115","249","56","420","773","0","54.33","14.88"
"10","013","00","019","1910","0000","487","148","339","44","531","1122","0","47.33","13.19"
"10","013","00","019","1910","0563","487","148","339","44","531","1122","0","47.33","13.19"
"10","013","00","020","0000","0000","4539","1618","2921","476","5015","9479","10650","52.91","17.07"
"10","013","00","020","2001","0000","800","270","530","97","897","1666","0","53.84","16.21"
"10","013","00","020","2001","0564","397","128","269","62","459","872","0","52.64","14.68"
"10","013","00","020","2001","0565","403","142","261","35","438","794","0","55.16","17.88"
"10","013","00","020","2002","0000","510","178","332","48","558","962","0","58.0","18.5"
"10","013","00","020","2002","0566","510","178","332","48","558","962","0","58.0","18.5"
"10","013","00","020","2003","0000","254","81","173","23","277","466","0","59.44","17.38"
"10","013","00","020","2003","0569","254","81","173","23","277","466","0","59.44","17.38"
"10","013","00","020","2004","0000","382","128","254","25","407","708","0","57.49","18.08"
"10","013","00","020","2004","0570","382","128","254","25","407","708","0","57.49","18.08"
"10","013","00","020","2005","0000","517","193","324","64","581","1033","0","56.24","18.68"
"10","013","00","020","2005","0567","517","193","324","64","581","1033","0","56.24","18.68"
"10","013","00","020","2006","0000","464","178","286","52","516","1007","0","51.24","17.68"
"10","013","00","020","2006","0568","464","178","286","52","516","1007","0","51.24","17.68"
"10","013","00","020","2007","0000","516","168","348","75","591","1044","0","56.61","16.09"
"10","013","00","020","2007","0571","516","168","348","75","591","1044","0","56.61","16.09"
"10","013","00","020","2008","0000","417","160","257","34","451","1071","0","42.11","14.94"
"10","013","00","020","2008","0572","417","160","257","34","451","1071","0","42.11","14.94"
"10","013","00","020","2009","0000","428","183","245","34","462","979","0","47.19","18.69"
"10","013","00","020","2009","0573","428","183","245","34","462","979","0","47.19","18.69"
"10","013","00","020","2010","0000","251","79","172","24","275","543","0","50.64","14.55"
"10","013","00","020","2010","0574","251","79","172","24","275","543","0","50.64","14.55"
"10","013","00","021","0000","0000","7438","2520","4918","988","8426","17063","19172","49.38","14.77"
"10","013","00","021","2101","0000","611","231","380","76","687","1472","0","46.67","15.69"
"10","013","00","021","2101","0575","611","231","380","76","687","1472","0","46.67","15.69"
"10","013","00","021","2102","0000","534","169","365","67","601","1360","0","44.19","12.43"
"10","013","00","021","2102","0576","534","169","365","67","601","1360","0","44.19","12.43"
"10","013","00","021","2103","0000","393","130","263","72","465","804","0","57.84","16.17"
"10","013","00","021","2103","0577","393","130","263","72","465","804","0","57.84","16.17"
"10","013","00","021","2104","0000","788","279","509","81","869","1780","0","48.82","15.67"
"10","013","00","021","2104","0578","420","156","264","64","484","925","0","52.32","16.86"
"10","013","00","021","2104","0579","368","123","245","17","385","855","0","45.03","14.39"
"10","013","00","021","2105","0000","865","327","538","112","977","1988","0","49.14","16.45"
"10","013","00","021","2105","0580","420","155","265","59","479","981","0","48.83","15.8"
"10","013","00","021","2105","0581","445","172","273","53","498","1007","0","49.45","17.08"
"10","013","00","021","2106","0000","866","312","554","132","998","2127","0","46.92","14.67"
"10","013","00","021","2106","0582","367","134","233","53","420","872","0","48.17","15.37"
"10","013","00","021","2106","0583","499","178","321","79","578","1255","0","46.06","14.18"
"10","013","00","021","2107","0000","441","146","295","106","547","995","0","54.97","14.67"
"10","013","00","021","2107","0584","441","146","295","106","547","995","0","54.97","14.67"
"10","013","00","021","2108","0000","268","83","185","25","293","734","0","39.92","11.31"
"10","013","00","021","2108","0585","268","83","185","25","293","734","0","39.92","11.31"
"10","013","00","021","2109","0000","474","160","314","35","509","1178","0","43.21","13.58"
"10","013","00","021","2109","0586","474","160","314","35","509","1178","0","43.21","13.58"
"10","013","00","021","2110","0000","466","191","275","59","525","1095","0","47.95","17.44"
"10","013","00","021","2110","0587","466","191","275","59","525","1095","0","47.95","17.44"
"10","013","00","021","2111","0000","542","144","398","101","643","1097","0","58.61","13.13"
"10","013","00","021","2111","0588","542","144","398","101","643","1097","0","58.61","13.13"
"10","013","00","021","2112","0000","1190","348","842","122","1312","2433","0","53.93","14.3"
"10","013","00","021","2112","0589","595","171","424","63","658","1273","0","51.69","13.43"
"10","013","00","021","2112","0590","595","177","418","59","654","1160","0","56.38","15.26"
"10","013","00","022","0000","0000","4428","1041","3387","327","4755","10706","12395","44.41","9.72"
"10","013","00","022","2201","0000","840","226","614","59","899","2083","0","43.16","10.85"
"10","013","00","022","2201","0591","443","130","313","23","466","1111","0","41.94","11.7"
"10","013","00","022","2201","0592","397","96","301","36","433","972","0","44.55","9.88"
"10","013","00","022","2202","0000","639","142","497","41","680","1278","0","53.21","11.11"
"10","013","00","022","2202","0593","639","142","497","41","680","1278","0","53.21","11.11"
"10","013","00","022","2203","0000","451","109","342","44","495","976","0","50.72","11.17"
"10","013","00","022","2203","0594","451","109","342","44","495","976","0","50.72","11.17"
"10","013","00","022","2204","0000","729","157","572","58","787","1658","0","47.47","9.47"
"10","013","00","022","2204","0595","729","157","572","58","787","1658","0","47.47","9.47"
"10","013","00","022","2205","0000","409","117","292","32","441","1146","0","38.48","10.21"
"10","013","00","022","2205","0596","409","117","292","32","441","1146","0","38.48","10.21"
"10","013","00","022","2206","0000","389","40","349","31","420","1079","0","38.92","3.71"
"10","013","00","022","2206","0597","389","40","349","31","420","1079","0","38.92","3.71"
"10","013","00","022","2207","0000","564","128","436","25","589","1613","0","36.52","7.94"
"10","013","00","022","2207","0598","564","128","436","25","589","1613","0","36.52","7.94"
"10","013","00","022","2208","0000","407","122","285","37","444","873","0","50.86","13.97"
"10","013","00","022","2208","0599","407","122","285","37","444","873","0","50.86","13.97"
"10","013","00","023","0000","0000","2864","1020","1844","269","3133","7595","8619","41.25","13.43"
"10","013","00","023","2301","0000","584","201","383","47","631","1347","0","46.84","14.92"
"10","013","00","023","2301","0602","205","85","120","20","225","491","0","45.82","17.31"
"10","013","00","023","2301","0603","379","116","263","27","406","856","0","47.43","13.55"
"10","013","00","023","2302","0000","224","81","143","8","232","554","0","41.88","14.62"
"10","013","00","023","2302","0604","224","81","143","8","232","554","0","41.88","14.62"
"10","013","00","023","2303","0000","210","78","132","31","241","647","0","37.25","12.06"
"10","013","00","023","2303","0601","210","78","132","31","241","647","0","37.25","12.06"
"10","013","00","023","2304","0000","271","109","162","38","309","737","0","41.93","14.79"
"10","013","00","023","2304","0600","271","109","162","38","309","737","0","41.93","14.79"
"10","013","00","023","2305","0000","141","48","93","2","143","388","0","36.86","12.37"
"10","013","00","023","2305","0605","141","48","93","2","143","388","0","36.86","12.37"
"10","013","00","023","2306","0000","340","136","204","44","384","922","0","41.65","14.75"
"10","013","00","023","2306","0606","340","136","204","44","384","922","0","41.65","14.75"
"10","013","00","023","2307","0000","377","138","239","21","398","1220","0","32.62","11.31"
"10","013","00","023","2307","0607","185","78","107","11","196","597","0","32.83","13.07"
"10","013","00","023","2307","0608","192","60","132","10","202","623","0","32.42","9.63"
"10","013","00","023","2308","0000","171","62","109","24","195","425","0","45.88","14.59"
"10","013","00","023","2308","0609","171","62","109","24","195","425","0","45.88","14.59"
"10","013","00","023","2309","0000","198","50","148","21","219","428","0","51.17","11.68"
"10","013","00","023","2309","0610","198","50","148","21","219","428","0","51.17","11.68"
"10","013","00","023","2310","0000","165","56","109","7","172","504","0","34.13","11.11"
"10","013","00","023","2310","0611","165","56","109","7","172","504","0","34.13","11.11"
"10","013","00","023","2311","0000","183","61","122","26","209","423","0","49.41","14.42"
"10","013","00","023","2311","0612","183","61","122","26","209","423","0","49.41","14.42"
"10","013","00","024","0000","0000","2884","971","1913","197","3081","7206","8068","42.76","13.47"
"10","013","00","024","2401","0000","689","270","419","40","729","1575","0","46.29","17.14"
"10","013","00","024","2401","0613","689","270","419","40","729","1575","0","46.29","17.14"
"10","013","00","024","2402","0000","187","65","122","10","197","420","0","46.9","15.48"
"10","013","00","024","2402","0614","187","65","122","10","197","420","0","46.9","15.48"
"10","013","00","024","2403","0000","479","130","349","25","504","1302","0","38.71","9.98"
"10","013","00","024","2403","0616","479","130","349","25","504","1302","0","38.71","9.98"
"10","013","00","024","2404","0000","556","197","359","48","604","1314","0","45.97","14.99"
"10","013","00","024","2404","0617","556","197","359","48","604","1314","0","45.97","14.99"
"10","013","00","024","2405","0000","324","83","241","26","350","602","0","58.14","13.79"
"10","013","00","024","2405","0615","324","83","241","26","350","602","0","58.14","13.79"
"10","013","00","024","2406","0000","373","130","243","19","392","1308","0","29.97","9.94"
"10","013","00","024","2406","0618","373","130","243","19","392","1308","0","29.97","9.94"
"10","013","00","024","2407","0000","125","53","72","14","139","367","0","37.87","14.44"
"10","013","00","024","2407","0619","125","53","72","14","139","367","0","37.87","14.44"
"10","013","00","024","2408","0000","151","43","108","15","166","318","0","52.2","13.52"
"10","013","00","024","2408","0620","151","43","108","15","166","318","0","52.2","13.52"
"10","013","00","025","0000","0000","2270","707","1563","220","2490","4856","5547","51.28","14.56"
"10","013","00","025","2501","0000","566","163","403","60","626","1032","0","60.66","15.79"
"10","013","00","025","2501","0621","332","101","231","34","366","604","0","60.6","16.72"
"10","013","00","025","2501","0622","234","62","172","26","260","428","0","60.75","14.49"
"10","013","00","025","2502","0000","992","300","692","69","1061","1900","0","55.84","15.79"
"10","013","00","025","2502","0623","524","166","358","49","573","928","0","61.75","17.89"
"10","013","00","025","2502","0624","468","134","334","20","488","972","0","50.21","13.79"
"10","013","00","025","2503","0000","412","136","276","68","480","1041","0","46.11","13.06"
"10","013","00","025","2503","0625","412","136","276","68","480","1041","0","46.11","13.06"
"10","013","00","025","2504","0000","300","108","192","23","323","883","0","36.58","12.23"
"10","013","00","025","2504","0626","300","108","192","23","323","883","0","36.58","12.23"
"10","013","00","026","0000","0000","3366","985","2381","249","3615","6373","7694","56.72","15.46"
"10","013","00","026","2601","0000","836","282","554","53","889","1448","0","61.4","19.48"
"10","013","00","026","2601","0630","836","282","554","53","889","1448","0","61.4","19.48"
"10","013","00","026","2602","0000","150","34","116","12","162","323","0","50.15","10.53"
"10","013","00","026","2602","0629","150","34","116","12","162","323","0","50.15","10.53"
"10","013","00","026","2603","0000","284","78","206","70","354","572","0","61.89","13.64"
"10","013","00","026","2603","0628","284","78","206","70","354","572","0","61.89","13.64"
"10","013","00","026","2604","0000","291","59","232","17","308","616","0","50.0","9.58"
"10","013","00","026","2604","0627","291","59","232","17","308","616","0","50.0","9.58"
"10","013","00","026","2605","0000","248","71","177","9","257","726","0","35.4","9.78"
"10","013","00","026","2605","0631","248","71","177","9","257","726","0","35.4","9.78"
"10","013","00","026","2606","0000","267","84","183","27","294","554","0","53.07","15.16"
"10","013","00","026","2606","0632","267","84","183","27","294","554","0","53.07","15.16"
"10","013","00","026","2607","0000","202","67","135","12","214","346","0","61.85","19.36"
"10","013","00","026","2607","0633","202","67","135","12","214","346","0","61.85","19.36"
"10","013","00","026","2608","0000","234","56","178","4","238","458","0","51.97","12.23"
"10","013","00","026","2608","0634","234","56","178","4","238","458","0","51.97","12.23"
"10","013","00","026","2609","0000","409","126","283","18","427","692","0","61.71","18.21"
"10","013","00","026","2609","0635","409","126","283","18","427","692","0","61.71","18.21"
"10","013","00","026","2610","0000","445","128","317","27","472","638","0","73.98","20.06"
"10","013","00","026","2610","0636","445","128","317","27","472","638","0","73.98","20.06"
"10","013","00","027","0000","0000","1701","433","1268","108","1809","2950","3376","61.32","14.68"
"10","013","00","027","2701","0000","682","175","507","33","715","1185","0","60.34","14.77"
"10","013","00","027","2701","0637","245","65","180","23","268","346","0","77.46","18.79"
"10","013","00","027","2701","0638","378","92","286","10","388","677","0","57.31","13.59"
"10","013","00","027","2701","0639","59","18","41","0","59","162","0","36.42","11.11"
"10","013","00","027","2702","0000","182","40","142","29","211","296","0","71.28","13.51"
"10","013","00","027","2702","0641","182","40","142","29","211","296","0","71.28","13.51"
"10","013","00","027","2703","0000","92","21","71","5","97","189","0","51.32","11.11"
"10","013","00","027","2703","0640","92","21","71","5","97","189","0","51.32","11.11"
"10","013","00","027","2704","0000","235","69","166","23","258","450","0","57.33","15.33"
"10","013","00","027","2704","0644","235","69","166","23","258","450","0","57.33","15.33"
"10","013","00","027","2705","0000","196","50","146","5","201","347","0","57.93","14.41"
"10","013","00","027","2705","0643","196","50","146","5","201","347","0","57.93","14.41"
"10","013","00","027","2706","0000","314","78","236","13","327","483","0","67.7","16.15"
"10","013","00","027","2706","0642","314","78","236","13","327","483","0","67.7","16.15"
"10","013","00","028","0000","0000","3385","880","2505","178","3563","5663","6833","62.92","15.54"
"10","013","00","028","2801","0000","243","78","165","3","246","455","0","54.07","17.14"
"10","013","00","028","2801","0645","243","78","165","3","246","455","0","54.07","17.14"
"10","013","00","028","2802","0000","513","143","370","32","545","821","0","66.38","17.42"
"10","013","00","028","2802","0646","513","143","370","32","545","821","0","66.38","17.42"
"10","013","00","028","2803","0000","542","144","398","25","567","1057","0","53.64","13.62"
"10","013","00","028","2803","0650","542","144","398","25","567","1057","0","53.64","13.62"
"10","013","00","028","2804","0000","503","133","370","21","524","900","0","58.22","14.78"
"10","013","00","028","2804","0651","503","133","370","21","524","900","0","58.22","14.78"
"10","013","00","028","2805","0000","232","50","182","7","239","429","0","55.71","11.66"
"10","013","00","028","2805","0652","232","50","182","7","239","429","0","55.71","11.66"
"10","013","00","028","2806","0000","1352","332","1020","90","1442","2001","0","72.06","16.59"
"10","013","00","028","2806","0647","419","121","298","46","465","635","0","73.23","19.06"
"10","013","00","028","2806","0648","500","99","401","23","523","695","0","75.25","14.24"
"10","013","00","028","2806","0649","433","112","321","21","454","671","0","67.66","16.69"
"10","013","00","029","0000","0000","2614","699","1915","195","2809","4344","5403","64.66","16.09"
"10","013","00","029","2901","0000","482","159","323","22","504","859","0","58.67","18.51"
"10","013","00","029","2901","0653","386","134","252","16","402","669","0","60.09","20.03"
"10","013","00","029","2901","0654","96","25","71","6","102","190","0","53.68","13.16"
"10","013","00","029","2902","0000","556","162","394","51","607","922","0","65.84","17.57"
"10","013","00","029","2902","0655","556","162","394","51","607","922","0","65.84","17.57"
"10","013","00","029","2903","0000","416","109","307","36","452","598","0","75.59","18.23"
"10","013","00","029","2903","0656","416","109","307","36","452","598","0","75.59","18.23"
"10","013","00","029","2904","0000","276","51","225","27","303","414","0","73.19","12.32"
"10","013","00","029","2904","0658","276","51","225","27","303","414","0","73.19","12.32"
"10","013","00","029","2905","0000","416","111","305","24","440","780","0","56.41","14.23"
"10","013","00","029","2905","0659","416","111","305","24","440","780","0","56.41","14.23"
"10","013","00","029","2906","0000","468","107","361","35","503","771","0","65.24","13.88"
"10","013","00","029","2906","0657","468","107","361","35","503","771","0","65.24","13.88"
"10","013","00","030","0000","0000","3461","822","2639","271","3732","6257","7445","59.65","13.14"
"10","013","00","030","3001","0000","534","107","427","80","614","917","0","66.96","11.67"
"10","013","00","030","3001","0660","534","107","427","80","614","917","0","66.96","11.67"
"10","013","00","030","3002","0000","322","83","239","10","332","577","0","57.54","14.38"
"10","013","00","030","3002","0661","203","60","143","8","211","361","0","58.45","16.62"
"10","013","00","030","3002","0662","119","23","96","2","121","216","0","56.02","10.65"
"10","013","00","030","3003","0000","483","90","393","35","518","725","0","71.45","12.41"
"10","013","00","030","3003","0663","311","59","252","25","336","445","0","75.51","13.26"
"10","013","00","030","3003","0664","172","31","141","10","182","280","0","65.0","11.07"
"10","013","00","030","3004","0000","599","117","482","49","648","1097","0","59.07","10.67"
"10","013","00","030","3004","0665","599","117","482","49","648","1097","0","59.07","10.67"
"10","013","00","030","3005","0000","533","101","432","31","564","840","0","67.14","12.02"
"10","013","00","030","3005","0666","533","101","432","31","564","840","0","67.14","12.02"
"10","013","00","030","3006","0000","441","134","307","21","462","889","0","51.97","15.07"
"10","013","00","030","3006","0667","441","134","307","21","462","889","0","51.97","15.07"
"10","013","00","030","3007","0000","549","190","359","45","594","1212","0","49.01","15.68"
"10","013","00","030","3007","0668","549","190","359","45","594","1212","0","49.01","15.68"
"10","013","00","031","0000","0000","1317","440","877","43","1360","3923","4903","34.67","11.22"
"10","013","00","031","3101","0000","284","99","185","4","288","909","0","31.68","10.89"
"10","013","00","031","3101","0669","284","99","185","4","288","909","0","31.68","10.89"
"10","013","00","031","3102","0000","235","96","139","12","247","663","0","37.25","14.48"
"10","013","00","031","3102","0670","235","96","139","12","247","663","0","37.25","14.48"
"10","013","00","031","3103","0000","82","20","62","3","85","304","0","27.96","6.58"
"10","013","00","031","3103","0671","82","20","62","3","85","304","0","27.96","6.58"
"10","013","00","031","3104","0000","387","110","277","14","401","928","0","43.21","11.85"
"10","013","00","031","3104","0672","387","110","277","14","401","928","0","43.21","11.85"
"10","013","00","031","3105","0000","185","62","123","8","193","641","0","30.11","9.67"
"10","013","00","031","3105","0673","185","62","123","8","193","641","0","30.11","9.67"
"10","013","00","031","3106","0000","144","53","91","2","146","478","0","30.54","11.09"
"10","013","00","031","3106","0674","144","53","91","2","146","478","0","30.54","11.09"
"10","013","00","032","0000","0000","2180","525","1655","93","2273","4230","5018","53.74","12.41"
"10","013","00","032","3201","0000","380","74","306","9","389","751","0","51.8","9.85"
"10","013","00","032","3201","0675","380","74","306","9","389","751","0","51.8","9.85"
"10","013","00","032","3202","0000","424","107","317","27","451","776","0","58.12","13.79"
"10","013","00","032","3202","0676","424","107","317","27","451","776","0","58.12","13.79"
"10","013","00","032","3203","0000","321","62","259","6","327","711","0","45.99","8.72"
"10","013","00","032","3203","0677","321","62","259","6","327","711","0","45.99","8.72"
"10","013","00","032","3204","0000","163","45","118","25","188","243","0","77.37","18.52"
"10","013","00","032","3204","0678","163","45","118","25","188","243","0","77.37","18.52"
"10","013","00","032","3205","0000","189","50","139","6","195","325","0","60.0","15.38"
"10","013","00","032","3205","0679","189","50","139","6","195","325","0","60.0","15.38"
"10","013","00","032","3206","0000","192","63","129","4","196","476","0","41.18","13.24"
"10","013","00","032","3206","0680","192","63","129","4","196","476","0","41.18","13.24"
"10","013","00","032","3207","0000","353","81","272","10","363","602","0","60.3","13.46"
"10","013","00","032","3207","0681","353","81","272","10","363","602","0","60.3","13.46"
"10","013","00","032","3208","0000","158","43","115","6","164","346","0","47.4","12.43"
"10","013","00","032","3208","0682","158","43","115","6","164","346","0","47.4","12.43"
"10","013","00","033","0000","0000","1707","570","1137","84","1791","4314","5003","41.52","13.21"
"10","013","00","033","3301","0000","756","250","506","50","806","1648","0","48.91","15.17"
"10","013","00","033","3301","0683","139","40","99","4","143","342","0","41.81","11.7"
"10","013","00","033","3301","0684","617","210","407","46","663","1306","0","50.77","16.08"
"10","013","00","033","3302","0000","167","59","108","5","172","693","0","24.82","8.51"
"10","013","00","033","3302","0685","167","59","108","5","172","693","0","24.82","8.51"
"10","013","00","033","3303","0000","166","45","121","10","176","437","0","40.27","10.3"
"10","013","00","033","3303","0686","166","45","121","10","176","437","0","40.27","10.3"
"10","013","00","033","3304","0000","191","57","134","5","196","392","0","50.0","14.54"
"10","013","00","033","3304","0687","191","57","134","5","196","392","0","50.0","14.54"
"10","013","00","033","3305","0000","298","119","179","9","307","593","0","51.77","20.07"
"10","013","00","033","3305","0688","298","119","179","9","307","593","0","51.77","20.07"
"10","013","00","033","3306","0000","129","40","89","5","134","551","0","24.32","7.26"
"10","013","00","033","3306","0689","129","40","89","5","134","551","0","24.32","7.26"
"10","002","00","000","0000","0000","199671","69188","130483","14890","214561","386089","455508","55.57","17.92"
"10","002","00","001","0000","0000","42401","14997","27404","2549","44950","79167","95747","56.78","18.94"
"10","002","00","001","0101","0000","1384","472","912","80","1464","2598","0","56.35","18.17"
"10","002","00","001","0101","0023","366","121","245","32","398","669","0","59.49","18.09"
"10","002","00","001","0101","0024","504","170","334","23","527","923","0","57.1","18.42"
"10","002","00","001","0101","0025","514","181","333","25","539","1006","0","53.58","17.99"
"10","002","00","001","0102","0000","819","278","541","41","860","1747","0","49.23","15.91"
"10","002","00","001","0102","0021","552","186","366","31","583","1282","0","45.48","14.51"
"10","002","00","001","0102","0022","267","92","175","10","277","465","0","59.57","19.78"
"10","002","00","001","0108","0000","1142","413","729","47","1189","2122","0","56.03","19.46"
"10","002","00","001","0108","0029","616","217","399","31","647","1143","0","56.61","18.99"
"10","002","00","001","0108","0030","526","196","330","16","542","979","0","55.36","20.02"
"10","002","00","001","0109","0000","627","209","418","55","682","1214","0","56.18","17.22"
"10","002","00","001","0109","0031","627","209","418","55","682","1214","0","56.18","17.22"
"10","002","00","001","0110","0000","1010","438","572","49","1059","1717","0","61.68","25.51"
"10","002","00","001","0110","0035","537","214","323","24","561","943","0","59.49","22.69"
"10","002","00","001","0110","0036","473","224","249","25","498","774","0","64.34","28.94"
"10","002","00","001","0111","0000","1080","366","714","56","1136","2036","0","55.8","17.98"
"10","002","00","001","0111","0033","526","183","343","25","551","946","0","58.25","19.34"
"10","002","00","001","0111","0034","554","183","371","31","585","1090","0","53.67","16.79"
"10","002","00","001","0112","0000","681","246","435","58","739","1283","0","57.6","19.17"
"10","002","00","001","0112","0032","681","246","435","58","739","1283","0","57.6","19.17"
"10","002","00","001","0113","0000","969","325","644","72","1041","1815","0","57.36","17.91"
"10","002","00","001","0113","0051","469","152","317","38","507","905","0","56.02","16.8"
"10","002","00","001","0113","0052","500","173","327","34","534","910","0","58.68","19.01"
"10","002","00","001","0114","0000","1217","444","773","57","1274","2214","0","57.54","20.05"
"10","002","00","001","0114","0046","602","220","382","26","628","1110","0","56.58","19.82"
"10","002","00","001","0114","0047","615","224","391","31","646","1104","0","58.51","20.29"
"10","002","00","001","0115","0000","1733","628","1105","103","1836","3262","0","56.28","19.25"
"10","002","00","001","0115","0040","570","193","377","48","618","1084","0","57.01","17.8"
"10","002","00","001","0115","0041","568","208","360","28","596","1095","0","54.43","19.0"
"10","002","00","001","0115","0042","595","227","368","27","622","1083","0","57.43","20.96"
"10","002","00","001","0116","0000","664","233","431","39","703","1434","0","49.02","16.25"
"10","002","00","001","0116","0053","664","233","431","39","703","1434","0","49.02","16.25"
"10","002","00","001","0117","0000","914","326","588","51","965","1803","0","53.52","18.08"
"10","002","00","001","0117","0059","453","165","288","21","474","909","0","52.15","18.15"
"10","002","00","001","0117","0060","461","161","300","30","491","894","0","54.92","18.01"
"10","002","00","001","0118","0000","940","310","630","85","1025","1560","0","65.71","19.87"
"10","002","00","001","0118","0027","431","141","290","35","466","727","0","64.1","19.39"
"10","002","00","001","0118","0028","509","169","340","50","559","833","0","67.11","20.29"
"10","002","00","001","0119","0000","545","211","334","33","578","966","0","59.83","21.84"
"10","002","00","001","0119","0055","545","211","334","33","578","966","0","59.83","21.84"
"10","002","00","001","0121","0000","890","345","545","63","953","1595","0","59.75","21.63"
"10","002","00","001","0121","0056","390","160","230","27","417","711","0","58.65","22.5"
"10","002","00","001","0121","0057","500","185","315","36","536","884","0","60.63","20.93"
"10","002","00","001","0122","0000","726","251","475","39","765","1326","0","57.69","18.93"
"10","002","00","001","0122","0058","726","251","475","39","765","1326","0","57.69","18.93"
"10","002","00","001","0123","0000","583","209","374","54","637","1152","0","55.3","18.14"
"10","002","00","001","0123","0054","583","209","374","54","637","1152","0","55.3","18.14"
"10","002","00","001","0124","0000","1398","437","961","102","1500","2584","0","58.05","16.91"
"10","002","00","001","0124","0064","731","249","482","77","808","1454","0","55.57","17.13"
"10","002","00","001","0124","0065","667","188","479","25","692","1130","0","61.24","16.64"
"10","002","00","001","0125","0000","1025","330","695","71","1096","2025","0","54.12","16.3"
"10","002","00","001","0125","0066","502","157","345","16","518","1087","0","47.65","14.44"
"10","002","00","001","0125","0067","523","173","350","55","578","938","0","61.62","18.44"
"10","002","00","001","0126","0000","1170","421","749","63","1233","2237","0","55.12","18.82"
"10","002","00","001","0126","0068","687","237","450","37","724","1285","0","56.34","18.44"
"10","002","00","001","0126","0069","483","184","299","26","509","952","0","53.47","19.33"
"10","002","00","001","0127","0000","1644","557","1087","141","1785","3123","0","57.16","17.84"
"10","002","00","001","0127","0070","524","180","344","48","572","948","0","60.34","18.99"
"10","002","00","001","0127","0071","569","202","367","42","611","1160","0","52.67","17.41"
"10","002","00","001","0127","0072","551","175","376","51","602","1015","0","59.31","17.24"
"10","002","00","001","0128","0000","678","267","411","59","737","1162","0","63.43","22.98"
"10","002","00","001","0128","0078","678","267","411","59","737","1162","0","63.43","22.98"
"10","002","00","001","0131","0000","475","170","305","40","515","959","0","53.7","17.73"
"10","002","00","001","0131","0075","475","170","305","40","515","959","0","53.7","17.73"
"10","002","00","001","0132","0000","980","308","672","66","1046","1699","0","61.57","18.13"
"10","002","00","001","0132","0076","485","165","320","35","520","814","0","63.88","20.27"
"10","002","00","001","0132","0077","495","143","352","31","526","885","0","59.44","16.16"
"10","002","00","001","0134","0000","782","287","495","48","830","1388","0","59.8","20.68"
"10","002","00","001","0134","0073","249","91","158","12","261","424","0","61.56","21.46"
"10","002","00","001","0134","0074","533","196","337","36","569","964","0","59.02","20.33"
"10","002","00","001","0135","0000","1534","538","996","95","1629","2933","0","55.54","18.34"
"10","002","00","001","0135","0007","478","177","301","32","510","912","0","55.92","19.41"
"10","002","00","001","0135","0008","712","253","459","40","752","1335","0","56.33","18.95"
"10","002","00","001","0135","0009","344","108","236","23","367","686","0","53.5","15.74"
"10","002","00","001","0136","0000","1171","381","790","64","1235","2252","0","54.84","16.92"
"10","002","00","001","0136","0001","517","165","352","17","534","982","0","54.38","16.8"
"10","002","00","001","0136","0002","654","216","438","47","701","1270","0","55.2","17.01"
"10","002","00","001","0137","0000","877","330","547","34","911","1605","0","56.76","20.56"
"10","002","00","001","0137","0003","458","180","278","14","472","849","0","55.59","21.2"
"10","002","00","001","0137","0004","419","150","269","20","439","756","0","58.07","19.84"
"10","002","00","001","0138","0000","2411","936","1475","80","2491","4269","0","58.35","21.93"
"10","002","00","001","0138","0010","800","307","493","26","826","1366","0","60.47","22.47"
"10","002","00","001","0138","0011","758","317","441","18","776","1363","0","56.93","23.26"
"10","002","00","001","0138","0012","853","312","541","36","889","1540","0","57.73","20.26"
"10","002","00","001","0139","0000","1587","586","1001","89","1676","3045","0","55.04","19.24"
"10","002","00","001","0139","0015","479","179","300","34","513","900","0","57.0","19.89"
"10","002","00","001","0139","0016","484","164","320","28","512","980","0","52.24","16.73"
"10","002","00","001","0139","0017","624","243","381","27","651","1165","0","55.88","20.86"
"10","002","00","001","0140","0000","1431","493","938","81","1512","2695","0","56.1","18.29"
"10","002","00","001","0140","0018","475","144","331","28","503","904","0","55.64","15.93"
"10","002","00","001","0140","0019","445","153","292","21","466","813","0","57.32","18.82"
"10","002","00","001","0140","0020","511","196","315","32","543","978","0","55.52","20.04"
"10","002","00","001","0141","0000","1616","578","1038","73","1689","3051","0","55.36","18.94"
"10","002","00","001","0141","0043","556","196","360","36","592","1108","0","53.43","17.69"
"10","002","00","001","0141","0044","481","178","303","12","493","848","0","58.14","20.99"
"10","002","00","001","0141","0045","579","204","375","25","604","1095","0","55.16","18.63"
"10","002","00","001","0142","0000","1738","594","1144","104","1842","3156","0","58.37","18.82"
"10","002","00","001","0142","0048","616","212","404","32","648","1134","0","57.14","18.69"
"10","002","00","001","0142","0049","633","209","424","28","661","1146","0","57.68","18.24"
"10","002","00","001","0142","0050","489","173","316","44","533","876","0","60.84","19.75"
"10","002","00","001","0143","0000","1386","488","898","55","1441","2550","0","56.51","19.14"
"10","002","00","001","0143","0013","741","264","477","13","754","1341","0","56.23","19.69"
"10","002","00","001","0143","0014","645","224","421","42","687","1209","0","56.82","18.53"
"10","002","00","001","0144","0000","980","309","671","80","1060","2000","0","53.0","15.45"
"10","002","00","001","0144","0005","525","162","363","38","563","1107","0","50.86","14.63"
"10","002","00","001","0144","0006","455","147","308","42","497","893","0","55.66","16.46"
"10","002","00","001","0145","0000","454","156","298","46","500","762","0","65.62","20.47"
"10","002","00","001","0145","0026","454","156","298","46","500","762","0","65.62","20.47"
"10","002","00","001","0146","0000","1457","492","965","84","1541","2915","0","52.86","16.88"
"10","002","00","001","0146","0061","608","212","396","31","639","1259","0","50.75","16.84"
"10","002","00","001","0146","0062","395","126","269","22","417","789","0","52.85","15.97"
"10","002","00","001","0146","0063","454","154","300","31","485","867","0","55.94","17.76"
"10","002","00","001","0147","0000","1683","635","1048","92","1775","2913","0","60.93","21.8"
"10","002","00","001","0147","0037","560","201","359","31","591","968","0","61.05","20.76"
"10","002","00","001","0147","0038","545","210","335","27","572","926","0","61.77","22.68"
"10","002","00","001","0147","0039","578","224","354","34","612","1019","0","60.06","21.98"
"10","002","00","002","0000","0000","31109","11312","19797","2002","33111","57686","72457","57.4","19.61"
"10","002","00","002","0204","0000","761","284","477","62","823","1475","0","55.8","19.25"
"10","002","00","002","0204","0081","761","284","477","62","823","1475","0","55.8","19.25"
"10","002","00","002","0205","0000","1814","681","1133","126","1940","3504","0","55.37","19.43"
"10","002","00","002","0205","0082","731","283","448","66","797","1466","0","54.37","19.3"
"10","002","00","002","0205","0083","578","215","363","28","606","1075","0","56.37","20.0"
"10","002","00","002","0205","0084","505","183","322","32","537","963","0","55.76","19.0"
"10","002","00","002","0206","0000","1349","505","844","102","1451","2677","0","54.2","18.86"
"10","002","00","002","0206","0085","741","270","471","74","815","1511","0","53.94","17.87"
"10","002","00","002","0206","0086","608","235","373","28","636","1166","0","54.55","20.15"
"10","002","00","002","0207","0000","1476","576","900","78","1554","3008","0","51.66","19.15"
"10","002","00","002","0207","0087","591","262","329","48","639","1273","0","50.2","20.58"
"10","002","00","002","0207","0088","885","314","571","30","915","1735","0","52.74","18.1"
"10","002","00","002","0208","0000","1282","466","816","70","1352","2324","0","58.18","20.05"
"10","002","00","002","0208","0089","811","281","530","37","848","1487","0","57.03","18.9"
"10","002","00","002","0208","0090","471","185","286","33","504","837","0","60.22","22.1"
"10","002","00","002","0209","0000","729","265","464","57","786","1312","0","59.91","20.2"
"10","002","00","002","0209","0091","729","265","464","57","786","1312","0","59.91","20.2"
"10","002","00","002","0210","0000","751","284","467","46","797","1502","0","53.06","18.91"
"10","002","00","002","0210","0092","751","284","467","46","797","1502","0","53.06","18.91"
"10","002","00","002","0211","0000","583","225","358","21","604","1138","0","53.08","19.77"
"10","002","00","002","0211","0093","583","225","358","21","604","1138","0","53.08","19.77"
"10","002","00","002","0216","0000","1879","646","1233","139","2018","3681","0","54.82","17.55"
"10","002","00","002","0216","0096","579","202","377","34","613","1089","0","56.29","18.55"
"10","002","00","002","0216","0097","668","207","461","42","710","1304","0","54.45","15.87"
"10","002","00","002","0216","0098","632","237","395","63","695","1288","0","53.96","18.4"
"10","002","00","002","0217","0000","1538","536","1002","112","1650","2850","0","57.89","18.81"
"10","002","00","002","0217","0102","762","266","496","69","831","1420","0","58.52","18.73"
"10","002","00","002","0217","0103","776","270","506","43","819","1430","0","57.27","18.88"
"10","002","00","002","0218","0000","1531","569","962","107","1638","2804","0","58.42","20.29"
"10","002","00","002","0218","0104","586","214","372","47","633","1075","0","58.88","19.91"
"10","002","00","002","0218","0105","490","182","308","40","530","879","0","60.3","20.71"
"10","002","00","002","0218","0106","455","173","282","20","475","850","0","55.88","20.35"
"10","002","00","002","0219","0000","1951","724","1227","97","2048","3623","0","56.53","19.98"
"10","002","00","002","0219","0111","770","292","478","35","805","1431","0","56.25","20.41"
"10","002","00","002","0219","0112","598","226","372","35","633","1109","0","57.08","20.38"
"10","002","00","002","0219","0113","583","206","377","27","610","1083","0","56.33","19.02"
"10","002","00","002","0220","0000","1478","525","953","77","1555","2692","0","57.76","19.5"
"10","002","00","002","0220","0114","772","261","511","41","813","1404","0","57.91","18.59"
"10","002","00","002","0220","0115","706","264","442","36","742","1288","0","57.61","20.5"
"10","002","00","002","0221","0000","501","182","319","45","546","1183","0","46.15","15.38"
"10","002","00","002","0221","0116","501","182","319","45","546","1183","0","46.15","15.38"
"10","002","00","002","0222","0000","1637","575","1062","100","1737","2865","0","60.63","20.07"
"10","002","00","002","0222","0117","628","208","420","31","659","1105","0","59.64","18.82"
"10","002","00","002","0222","0118","569","209","360","35","604","987","0","61.2","21.18"
"10","002","00","002","0222","0119","440","158","282","34","474","773","0","61.32","20.44"
"10","002","00","002","0223","0000","1541","579","962","140","1681","2926","0","57.45","19.79"
"10","002","00","002","0223","0123","511","204","307","58","569","977","0","58.24","20.88"
"10","002","00","002","0223","0124","482","180","302","49","531","972","0","54.63","18.52"
"10","002","00","002","0223","0125","548","195","353","33","581","977","0","59.47","19.96"
"10","002","00","002","0224","0000","1985","689","1296","110","2095","3551","0","59.0","19.4"
"10","002","00","002","0224","0126","776","267","509","50","826","1398","0","59.08","19.1"
"10","002","00","002","0224","0127","547","195","352","28","575","1022","0","56.26","19.08"
"10","002","00","002","0224","0128","662","227","435","32","694","1131","0","61.36","20.07"
"10","002","00","002","0225","0000","2079","751","1328","90","2169","3431","0","63.22","21.89"
"10","002","00","002","0225","0120","827","302","525","38","865","1366","0","63.32","22.11"
"10","002","00","002","0225","0121","564","208","356","21","585","907","0","64.5","22.93"
"10","002","00","002","0225","0122","688","241","447","31","719","1158","0","62.09","20.81"
"10","002","00","002","0226","0000","2529","940","1589","127","2656","4360","0","60.92","21.56"
"10","002","00","002","0226","0107","636","258","378","29","665","1111","0","59.86","23.22"
"10","002","00","002","0226","0108","674","230","444","40","714","1139","0","62.69","20.19"
"10","002","00","002","0226","0109","664","254","410","33","697","1130","0","61.68","22.48"
"10","002","00","002","0226","0110","555","198","357","25","580","980","0","59.18","20.2"
"10","002","00","002","0227","0000","1722","599","1123","129","1851","2990","0","61.91","20.03"
"10","002","00","002","0227","0099","595","220","375","46","641","1036","0","61.87","21.24"
"10","002","00","002","0227","0100","581","179","402","37","618","969","0","63.78","18.47"
"10","002","00","002","0227","0101","546","200","346","46","592","985","0","60.1","20.3"
"10","002","00","002","0228","0000","759","286","473","48","807","1407","0","57.36","20.33"
"10","002","00","002","0228","0079","379","153","226","29","408","689","0","59.22","22.21"
"10","002","00","002","0228","0080","380","133","247","19","399","718","0","55.57","18.52"
"10","002","00","002","0229","0000","711","241","470","82","793","1373","0","57.76","17.55"
"10","002","00","002","0229","0095","711","241","470","82","793","1373","0","57.76","17.55"
"10","002","00","002","0230","0000","523","184","339","37","560","1010","0","55.45","18.22"
"10","002","00","002","0230","0094","523","184","339","37","560","1010","0","55.45","18.22"
"10","002","00","003","0000","0000","17764","6130","11634","1642","19406","34512","39785","56.23","17.76"
"10","002","00","003","0301","0000","1798","644","1154","129","1927","3364","0","57.28","19.14"
"10","002","00","003","0301","0129","620","217","403","54","674","1194","0","56.45","18.17"
"10","002","00","003","0301","0130","580","189","391","30","610","1128","0","54.08","16.76"
"10","002","00","003","0301","0131","598","238","360","45","643","1042","0","61.71","22.84"
"10","002","00","003","0302","0000","552","217","335","35","587","997","0","58.88","21.77"
"10","002","00","003","0302","0132","552","217","335","35","587","997","0","58.88","21.77"
"10","002","00","003","0303","0000","1956","736","1220","177","2133","3693","0","57.76","19.93"
"10","002","00","003","0303","0133","681","268","413","56","737","1303","0","56.56","20.57"
"10","002","00","003","0303","0134","687","265","422","58","745","1260","0","59.13","21.03"
"10","002","00","003","0303","0135","588","203","385","63","651","1130","0","57.61","17.96"
"10","002","00","003","0304","0000","438","160","278","65","503","910","0","55.27","17.58"
"10","002","00","003","0304","0136","275","98","177","41","316","559","0","56.53","17.53"
"10","002","00","003","0304","0137","163","62","101","24","187","351","0","53.28","17.66"
"10","002","00","003","0305","0000","655","230","425","81","736","1323","0","55.63","17.38"
"10","002","00","003","0305","0138","439","161","278","56","495","889","0","55.68","18.11"
"10","002","00","003","0305","0139","216","69","147","25","241","434","0","55.53","15.9"
"10","002","00","003","0307","0000","1601","593","1008","143","1744","2945","0","59.22","20.14"
"10","002","00","003","0307","0140","481","174","307","29","510","835","0","61.08","20.84"
"10","002","00","003","0307","0141","518","194","324","41","559","975","0","57.33","19.9"
"10","002","00","003","0307","0142","602","225","377","73","675","1135","0","59.47","19.82"
"10","002","00","003","0308","0000","721","277","444","55","776","1257","0","61.73","22.04"
"10","002","00","003","0308","0143","480","198","282","34","514","788","0","65.23","25.13"
"10","002","00","003","0308","0144","241","79","162","21","262","469","0","55.86","16.84"
"10","002","00","003","0309","0000","1157","367","790","99","1256","2300","0","54.61","15.96"
"10","002","00","003","0309","0148","552","174","378","50","602","1146","0","52.53","15.18"
"10","002","00","003","0309","0149","605","193","412","49","654","1154","0","56.67","16.72"
"10","002","00","003","0310","0000","1259","407","852","84","1343","2398","0","56.01","16.97"
"10","002","00","003","0310","0150","441","158","283","18","459","908","0","50.55","17.4"
"10","002","00","003","0310","0151","342","97","245","21","363","656","0","55.34","14.79"
"10","002","00","003","0310","0152","476","152","324","45","521","834","0","62.47","18.23"
"10","002","00","003","0311","0000","577","196","381","37","614","1025","0","59.9","19.12"
"10","002","00","003","0311","0153","577","196","381","37","614","1025","0","59.9","19.12"
"10","002","00","003","0312","0000","252","89","163","12","264","455","0","58.02","19.56"
"10","002","00","003","0312","0154","252","89","163","12","264","455","0","58.02","19.56"
"10","002","00","003","0313","0000","284","112","172","29","313","535","0","58.5","20.93"
"10","002","00","003","0313","0155","284","112","172","29","313","535","0","58.5","20.93"
"10","002","00","003","0314","0000","324","105","219","20","344","536","0","64.18","19.59"
"10","002","00","003","0314","0156","324","105","219","20","344","536","0","64.18","19.59"
"10","002","00","003","0315","0000","256","82","174","19","275","451","0","60.98","18.18"
"10","002","00","003","0315","0157","256","82","174","19","275","451","0","60.98","18.18"
"10","002","00","003","0316","0000","294","101","193","38","332","593","0","55.99","17.03"
"10","002","00","003","0316","0158","294","101","193","38","332","593","0","55.99","17.03"
"10","002","00","003","0317","0000","235","73","162","21","256","441","0","58.05","16.55"
"10","002","00","003","0317","0159","235","73","162","21","256","441","0","58.05","16.55"
"10","002","00","003","0318","0000","507","169","338","44","551","954","0","57.76","17.71"
"10","002","00","003","0318","0160","507","169","338","44","551","954","0","57.76","17.71"
"10","002","00","003","0319","0000","469","153","316","49","518","952","0","54.41","16.07"
"10","002","00","003","0319","0161","469","153","316","49","518","952","0","54.41","16.07"
"10","002","00","003","0320","0000","519","162","357","72","591","1125","0","52.53","14.4"
"10","002","00","003","0320","0162","519","162","357","72","591","1125","0","52.53","14.4"
"10","002","00","003","0321","0000","659","203","456","94","753","1469","0","51.26","13.82"
"10","002","00","003","0321","0163","370","114","256","63","433","763","0","56.75","14.94"
"10","002","00","003","0321","0164","289","89","200","31","320","706","0","45.33","12.61"
"10","002","00","003","0322","0000","451","146","305","62","513","1068","0","48.03","13.67"
"10","002","00","003","0322","0165","451","146","305","62","513","1068","0","48.03","13.67"
"10","002","00","003","0323","0000","611","207","404","107","718","1240","0","57.9","16.69"
"10","002","00","003","0323","0166","339","119","220","49","388","666","0","58.26","17.87"
"10","002","00","003","0323","0167","272","88","184","58","330","574","0","57.49","15.33"
"10","002","00","003","0324","0000","142","54","88","9","151","351","0","43.02","15.38"
"10","002","00","003","0324","0168","142","54","88","9","151","351","0","43.02","15.38"
"10","002","00","003","0325","0000","355","117","238","50","405","717","0","56.49","16.32"
"10","002","00","003","0325","0169","355","117","238","50","405","717","0","56.49","16.32"
"10","002","00","003","0326","0000","227","78","149","23","250","596","0","41.95","13.09"
"10","002","00","003","0326","0170","143","37","106","13","156","373","0","41.82","9.92"
"10","002","00","003","0326","0171","84","41","43","10","94","223","0","42.15","18.39"
"10","002","00","003","0327","0000","1465","452","1013","88","1553","2817","0","55.13","16.05"
"10","002","00","003","0327","0145","405","126","279","33","438","811","0","54.01","15.54"
"10","002","00","003","0327","0146","451","128","323","22","473","867","0","54.56","14.76"
"10","002","00","003","0327","0147","609","198","411","33","642","1139","0","56.37","17.38"
"10","002","00","004","0000","0000","12674","4332","8342","1159","13833","25135","29173","55.03","17.23"
"10","002","00","004","0401","0000","93","28","65","12","105","292","0","35.96","9.59"
"10","002","00","004","0401","0172","93","28","65","12","105","292","0","35.96","9.59"
"10","002","00","004","0402","0000","334","111","223","38","372","688","0","54.07","16.13"
"10","002","00","004","0402","0173","334","111","223","38","372","688","0","54.07","16.13"
"10","002","00","004","0403","0000","401","130","271","48","449","879","0","51.08","14.79"
"10","002","00","004","0403","0175","401","130","271","48","449","879","0","51.08","14.79"
"10","002","00","004","0404","0000","180","59","121","24","204","335","0","60.9","17.61"
"10","002","00","004","0404","0176","180","59","121","24","204","335","0","60.9","17.61"
"10","002","00","004","0405","0000","668","216","452","68","736","1356","0","54.28","15.93"
"10","002","00","004","0405","0177","352","107","245","41","393","624","0","62.98","17.15"
"10","002","00","004","0405","0178","316","109","207","27","343","732","0","46.86","14.89"
"10","002","00","004","0406","0000","383","149","234","35","418","892","0","46.86","16.7"
"10","002","00","004","0406","0179","383","149","234","35","418","892","0","46.86","16.7"
"10","002","00","004","0407","0000","276","110","166","37","313","690","0","45.36","15.94"
"10","002","00","004","0407","0180","276","110","166","37","313","690","0","45.36","15.94"
"10","002","00","004","0408","0000","800","286","514","63","863","1578","0","54.69","18.12"
"10","002","00","004","0408","0181","423","141","282","29","452","842","0","53.68","16.75"
"10","002","00","004","0408","0182","377","145","232","34","411","736","0","55.84","19.7"
"10","002","00","004","0409","0000","638","220","418","49","687","1348","0","50.96","16.32"
"10","002","00","004","0409","0183","373","134","239","28","401","788","0","50.89","17.01"
"10","002","00","004","0409","0184","265","86","179","21","286","560","0","51.07","15.36"
"10","002","00","004","0410","0000","392","133","259","32","424","712","0","59.55","18.68"
"10","002","00","004","0410","0185","392","133","259","32","424","712","0","59.55","18.68"
"10","002","00","004","0411","0000","301","97","204","21","322","502","0","64.14","19.32"
"10","002","00","004","0411","0186","301","97","204","21","322","502","0","64.14","19.32"
"10","002","00","004","0412","0000","330","122","208","28","358","569","0","62.92","21.44"
"10","002","00","004","0412","0187","330","122","208","28","358","569","0","62.92","21.44"
"10","002","00","004","0413","0000","334","110","224","27","361","633","0","57.03","17.38"
"10","002","00","004","0413","0188","334","110","224","27","361","633","0","57.03","17.38"
"10","002","00","004","0414","0000","948","338","610","82","1030","2167","0","47.53","15.6"
"10","002","00","004","0414","0189","491","181","310","44","535","1132","0","47.26","15.99"
"10","002","00","004","0414","0190","457","157","300","38","495","1035","0","47.83","15.17"
"10","002","00","004","0415","0000","1083","394","689","82","1165","2019","0","57.7","19.51"
"10","002","00","004","0415","0191","461","156","305","43","504","847","0","59.5","18.42"
"10","002","00","004","0415","0192","622","238","384","39","661","1172","0","56.4","20.31"
"10","002","00","004","0416","0000","1069","384","685","50","1119","1971","0","56.77","19.48"
"10","002","00","004","0416","0193","444","171","273","27","471","896","0","52.57","19.08"
"10","002","00","004","0416","0194","625","213","412","23","648","1075","0","60.28","19.81"
"10","002","00","004","0417","0000","490","155","335","57","547","931","0","58.75","16.65"
"10","002","00","004","0417","0195","490","155","335","57","547","931","0","58.75","16.65"
"10","002","00","004","0418","0000","829","255","574","84","913","1730","0","52.77","14.74"
"10","002","00","004","0418","0196","517","158","359","45","562","1021","0","55.04","15.48"
"10","002","00","004","0418","0197","312","97","215","39","351","709","0","49.51","13.68"
"10","002","00","004","0419","0000","397","118","279","45","442","689","0","64.15","17.13"
"10","002","00","004","0419","0198","397","118","279","45","442","689","0","64.15","17.13"
"10","002","00","004","0420","0000","730","260","470","70","800","1374","0","58.22","18.92"
"10","002","00","004","0420","0199","354","122","232","31","385","615","0","62.6","19.84"
"10","002","00","004","0420","0200","376","138","238","39","415","759","0","54.68","18.18"
"10","002","00","004","0421","0000","512","175","337","54","566","917","0","61.72","19.08"
"10","002","00","004","0421","0201","512","175","337","54","566","917","0","61.72","19.08"
"10","002","00","004","0422","0000","542","179","363","59","601","1045","0","57.51","17.13"
"10","002","00","004","0422","0202","542","179","363","59","601","1045","0","57.51","17.13"
"10","002","00","004","0423","0000","590","202","388","52","642","1130","0","56.81","17.88"
"10","002","00","004","0423","0203","590","202","388","52","642","1130","0","56.81","17.88"
"10","002","00","004","0424","0000","354","101","253","42","396","688","0","57.56","14.68"
"10","002","00","004","0424","0174","354","101","253","42","396","688","0","57.56","14.68"
"10","002","00","005","0000","0000","15557","5360","10197","1238","16795","31084","35668","54.03","17.24"
"10","002","00","005","0501","0000","747","262","485","64","811","1627","0","49.85","16.1"
"10","002","00","005","0501","0204","503","176","327","40","543","1122","0","48.4","15.69"
"10","002","00","005","0501","0205","244","86","158","24","268","505","0","53.07","17.03"
"10","002","00","005","0502","0000","962","323","639","69","1031","1959","0","52.63","16.49"
"10","002","00","005","0502","0206","478","164","314","33","511","988","0","51.72","16.6"
"10","002","00","005","0502","0207","484","159","325","36","520","971","0","53.55","16.37"
"10","002","00","005","0503","0000","1808","620","1188","109","1917","4033","0","47.53","15.37"
"10","002","00","005","0503","0208","579","200","379","41","620","1246","0","49.76","16.05"
"10","002","00","005","0503","0209","742","257","485","39","781","1655","0","47.19","15.53"
"10","002","00","005","0503","0210","487","163","324","29","516","1132","0","45.58","14.4"
"10","002","00","005","0504","0000","1308","452","856","88","1396","2559","0","54.55","17.66"
"10","002","00","005","0504","0211","417","156","261","25","442","783","0","56.45","19.92"
"10","002","00","005","0504","0212","470","154","316","28","498","928","0","53.66","16.59"
"10","002","00","005","0504","0213","421","142","279","35","456","848","0","53.77","16.75"
"10","002","00","005","0505","0000","392","145","247","30","422","663","0","63.65","21.87"
"10","002","00","005","0505","0214","392","145","247","30","422","663","0","63.65","21.87"
"10","002","00","005","0506","0000","763","239","524","47","810","1441","0","56.21","16.59"
"10","002","00","005","0506","0215","322","99","223","18","340","608","0","55.92","16.28"
"10","002","00","005","0506","0216","441","140","301","29","470","833","0","56.42","16.81"
"10","002","00","005","0507","0000","579","221","358","20","599","1233","0","48.58","17.92"
"10","002","00","005","0507","0217","579","221","358","20","599","1233","0","48.58","17.92"
"10","002","00","005","0508","0000","726","264","462","54","780","1429","0","54.58","18.47"
"10","002","00","005","0508","0218","441","160","281","39","480","854","0","56.21","18.74"
"10","002","00","005","0508","0219","285","104","181","15","300","575","0","52.17","18.09"
"10","002","00","005","0509","0000","1126","400","726","93","1219","2140","0","56.96","18.69"
"10","002","00","005","0509","0220","432","147","285","37","469","835","0","56.17","17.6"
"10","002","00","005","0509","0221","694","253","441","56","750","1305","0","57.47","19.39"
"10","002","00","005","0510","0000","1194","421","773","140","1334","2402","0","55.54","17.53"
"10","002","00","005","0510","0222","412","140","272","49","461","830","0","55.54","16.87"
"10","002","00","005","0510","0223","380","144","236","47","427","649","0","65.79","22.19"
"10","002","00","005","0510","0224","402","137","265","44","446","923","0","48.32","14.84"
"10","002","00","005","0511","0000","504","153","351","40","544","1177","0","46.22","13.0"
"10","002","00","005","0511","0225","504","153","351","40","544","1177","0","46.22","13.0"
"10","002","00","005","0512","0000","421","139","282","40","461","840","0","54.88","16.55"
"10","002","00","005","0512","0226","421","139","282","40","461","840","0","54.88","16.55"
"10","002","00","005","0513","0000","569","187","382","27","596","1051","0","56.71","17.79"
"10","002","00","005","0513","0227","569","187","382","27","596","1051","0","56.71","17.79"
"10","002","00","005","0514","0000","637","233","404","45","682","1339","0","50.93","17.4"
"10","002","00","005","0514","0228","637","233","404","45","682","1339","0","50.93","17.4"
"10","002","00","005","0515","0000","1366","411","955","114","1480","2508","0","59.01","16.39"
"10","002","00","005","0515","0229","667","192","475","41","708","1194","0","59.3","16.08"
"10","002","00","005","0515","0230","699","219","480","73","772","1314","0","58.75","16.67"
"10","002","00","005","0516","0000","1752","649","1103","140","1892","3311","0","57.14","19.6"
"10","002","00","005","0516","0231","602","232","370","20","622","1125","0","55.29","20.62"
"10","002","00","005","0516","0232","665","231","434","56","721","1207","0","59.73","19.14"
"10","002","00","005","0516","0233","485","186","299","64","549","979","0","56.08","19.0"
"10","002","00","005","0517","0000","473","171","302","112","585","954","0","61.32","17.92"
"10","002","00","005","0517","0234","473","171","302","112","585","954","0","61.32","17.92"
"10","002","00","005","0518","0000","230","70","160","6","236","418","0","56.46","16.75"
"10","002","00","005","0518","0235","230","70","160","6","236","418","0","56.46","16.75"
"10","002","00","006","0000","0000","11237","3935","7302","1133","12370","21447","24315","57.68","18.35"
"10","002","00","006","0601","0000","1368","464","904","124","1492","2484","0","60.06","18.68"
"10","002","00","006","0601","0236","790","264","526","75","865","1435","0","60.28","18.4"
"10","002","00","006","0601","0237","578","200","378","49","627","1049","0","59.77","19.07"
"10","002","00","006","0602","0000","924","307","617","105","1029","1835","0","56.08","16.73"
"10","002","00","006","0602","0239","425","140","285","76","501","868","0","57.72","16.13"
"10","002","00","006","0602","0240","499","167","332","29","528","967","0","54.6","17.27"
"10","002","00","006","0603","0000","510","195","315","62","572","940","0","60.85","20.74"
"10","002","00","006","0603","0241","510","195","315","62","572","940","0","60.85","20.74"
"10","002","00","006","0604","0000","451","154","297","23","474","975","0","48.62","15.79"
"10","002","00","006","0604","0242","451","154","297","23","474","975","0","48.62","15.79"
"10","002","00","006","0605","0000","836","269","567","114","950","1605","0","59.19","16.76"
"10","002","00","006","0605","0243","426","148","278","63","489","797","0","61.36","18.57"
"10","002","00","006","0605","0244","410","121","289","51","461","808","0","57.05","14.98"
"10","002","00","006","0606","0000","755","298","457","104","859","1523","0","56.4","19.57"
"10","002","00","006","0606","0245","478","204","274","65","543","911","0","59.6","22.39"
"10","002","00","006","0606","0246","277","94","183","39","316","612","0","51.63","15.36"
"10","002","00","006","0607","0000","440","152","288","56","496","790","0","62.78","19.24"
"10","002","00","006","0607","0247","440","152","288","56","496","790","0","62.78","19.24"
"10","002","00","006","0608","0000","1248","433","815","137","1385","2338","0","59.24","18.52"
"10","002","00","006","0608","0248","461","159","302","63","524","878","0","59.68","18.11"
"10","002","00","006","0608","0249","432","153","279","43","475","723","0","65.7","21.16"
"10","002","00","006","0608","0250","355","121","234","31","386","737","0","52.37","16.42"
"10","002","00","006","0609","0000","808","299","509","66","874","1581","0","55.28","18.91"
"10","002","00","006","0609","0251","356","138","218","57","413","686","0","60.2","20.12"
"10","002","00","006","0609","0252","452","161","291","9","461","895","0","51.51","17.99"
"10","002","00","006","0610","0000","667","215","452","89","756","1237","0","61.12","17.38"
"10","002","00","006","0610","0253","667","215","452","89","756","1237","0","61.12","17.38"
"10","002","00","006","0611","0000","1172","405","767","91","1263","2241","0","56.36","18.07"
"10","002","00","006","0611","0254","606","218","388","45","651","1134","0","57.41","19.22"
"10","002","00","006","0611","0255","566","187","379","46","612","1107","0","55.28","16.89"
"10","002","00","006","0612","0000","580","203","377","43","623","1057","0","58.94","19.21"
"10","002","00","006","0612","0256","580","203","377","43","623","1057","0","58.94","19.21"
"10","002","00","006","0613","0000","864","312","552","76","940","1773","0","53.02","17.6"
"10","002","00","006","0613","0257","504","162","342","34","538","1051","0","51.19","15.41"
"10","002","00","006","0613","0258","360","150","210","42","402","722","0","55.68","20.78"
"10","002","00","006","0614","0000","614","229","385","43","657","1068","0","61.52","21.44"
"10","002","00","006","0614","0238","614","229","385","43","657","1068","0","61.52","21.44"
"10","002","00","007","0000","0000","13833","4651","9182","1333","15166","28131","32281","53.91","16.53"
"10","002","00","007","0701","0000","2793","980","1813","154","2947","5648","0","52.18","17.35"
"10","002","00","007","0701","0259","680","247","433","36","716","1393","0","51.4","17.73"
"10","002","00","007","0701","0260","440","176","264","24","464","895","0","51.84","19.66"
"10","002","00","007","0701","0261","615","189","426","52","667","1231","0","54.18","15.35"
"10","002","00","007","0701","0262","546","182","364","18","564","1098","0","51.37","16.58"
"10","002","00","007","0701","0263","512","186","326","24","536","1031","0","51.99","18.04"
"10","002","00","007","0702","0000","992","310","682","119","1111","2198","0","50.55","14.1"
"10","002","00","007","0702","0264","484","148","336","72","556","1030","0","53.98","14.37"
"10","002","00","007","0702","0265","508","162","346","47","555","1168","0","47.52","13.87"
"10","002","00","007","0703","0000","831","278","553","79","910","1587","0","57.34","17.52"
"10","002","00","007","0703","0266","419","136","283","43","462","809","0","57.11","16.81"
"10","002","00","007","0703","0267","412","142","270","36","448","778","0","57.58","18.25"
"10","002","00","007","0704","0000","782","200","582","64","846","1465","0","57.75","13.65"
"10","002","00","007","0704","0268","782","200","582","64","846","1465","0","57.75","13.65"
"10","002","00","007","0705","0000","970","337","633","90","1060","1839","0","57.64","18.33"
"10","002","00","007","0705","0269","529","199","330","52","581","979","0","59.35","20.33"
"10","002","00","007","0705","0270","441","138","303","38","479","860","0","55.7","16.05"
"10","002","00","007","0706","0000","536","175","361","63","599","1205","0","49.71","14.52"
"10","002","00","007","0706","0271","536","175","361","63","599","1205","0","49.71","14.52"
"10","002","00","007","0707","0000","761","256","505","95","856","1494","0","57.3","17.14"
"10","002","00","007","0707","0272","544","185","359","68","612","1082","0","56.56","17.1"
"10","002","00","007","0707","0273","217","71","146","27","244","412","0","59.22","17.23"
"10","002","00","007","0708","0000","271","78","193","25","296","635","0","46.61","12.28"
"10","002","00","007","0708","0274","174","58","116","18","192","403","0","47.64","14.39"
"10","002","00","007","0708","0275","97","20","77","7","104","232","0","44.83","8.62"
"10","002","00","007","0709","0000","930","353","577","82","1012","1838","0","55.06","19.21"
"10","002","00","007","0709","0276","474","178","296","38","512","944","0","54.24","18.86"
"10","002","00","007","0709","0277","456","175","281","44","500","894","0","55.93","19.57"
"10","002","00","007","0710","0000","702","215","487","59","761","1356","0","56.12","15.86"
"10","002","00","007","0710","0278","702","215","487","59","761","1356","0","56.12","15.86"
"10","002","00","007","0711","0000","1189","408","781","150","1339","2295","0","58.34","17.78"
"10","002","00","007","0711","0279","408","133","275","46","454","780","0","58.21","17.05"
"10","002","00","007","0711","0280","517","180","337","69","586","932","0","62.88","19.31"
"10","002","00","007","0711","0281","264","95","169","35","299","583","0","51.29","16.3"
"10","002","00","007","0712","0000","1188","376","812","152","1340","2435","0","55.03","15.44"
"10","002","00","007","0712","0282","449","133","316","55","504","900","0","56.0","14.78"
"10","002","00","007","0712","0283","367","119","248","38","405","747","0","54.22","15.93"
"10","002","00","007","0712","0284","372","124","248","59","431","788","0","54.7","15.74"
"10","002","00","007","0713","0000","418","153","265","46","464","884","0","52.49","17.31"
"10","002","00","007","0713","0285","418","153","265","46","464","884","0","52.49","17.31"
"10","002","00","007","0714","0000","411","132","279","27","438","857","0","51.11","15.4"
"10","002","00","007","0714","0286","411","132","279","27","438","857","0","51.11","15.4"
"10","002","00","007","0715","0000","489","193","296","26","515","1016","0","50.69","19.0"
"10","002","00","007","0715","0287","489","193","296","26","515","1016","0","50.69","19.0"
"10","002","00","007","0716","0000","570","207","363","102","672","1379","0","48.73","15.01"
"10","002","00","007","0716","0288","278","96","182","31","309","690","0","44.78","13.91"
"10","002","00","007","0716","0289","292","111","181","71","363","689","0","52.69","16.11"
"10","002","00","008","0000","0000","23094","8099","14995","1420","24514","45405","52843","53.99","17.84"
"10","002","00","008","0801","0000","607","208","399","42","649","1217","0","53.33","17.09"
"10","002","00","008","0801","0312","607","208","399","42","649","1217","0","53.33","17.09"
"10","002","00","008","0802","0000","902","361","541","61","963","1624","0","59.3","22.23"
"10","002","00","008","0802","0290","440","181","259","46","486","807","0","60.22","22.43"
"10","002","00","008","0802","0291","462","180","282","15","477","817","0","58.38","22.03"
"10","002","00","008","0803","0000","617","215","402","43","660","1156","0","57.09","18.6"
"10","002","00","008","0803","0292","617","215","402","43","660","1156","0","57.09","18.6"
"10","002","00","008","0804","0000","445","163","282","41","486","892","0","54.48","18.27"
"10","002","00","008","0804","0293","445","163","282","41","486","892","0","54.48","18.27"
"10","002","00","008","0805","0000","482","169","313","42","524","897","0","58.42","18.84"
"10","002","00","008","0805","0294","482","169","313","42","524","897","0","58.42","18.84"
"10","002","00","008","0806","0000","791","268","523","44","835","1392","0","59.99","19.25"
"10","002","00","008","0806","0295","791","268","523","44","835","1392","0","59.99","19.25"
"10","002","00","008","0807","0000","1433","561","872","71","1504","2906","0","51.75","19.3"
"10","002","00","008","0807","0296","803","349","454","34","837","1471","0","56.9","23.73"
"10","002","00","008","0807","0297","630","212","418","37","667","1435","0","46.48","14.77"
"10","002","00","008","0808","0000","1574","545","1029","76","1650","2975","0","55.46","18.32"
"10","002","00","008","0808","0298","746","260","486","35","781","1519","0","51.42","17.12"
"10","002","00","008","0808","0299","828","285","543","41","869","1456","0","59.68","19.57"
"10","002","00","008","0809","0000","378","118","260","25","403","694","0","58.07","17.0"
"10","002","00","008","0809","0301","378","118","260","25","403","694","0","58.07","17.0"
"10","002","00","008","0810","0000","398","144","254","36","434","711","0","61.04","20.25"
"10","002","00","008","0810","0300","398","144","254","36","434","711","0","61.04","20.25"
"10","002","00","008","0811","0000","904","277","627","59","963","1526","0","63.11","18.15"
"10","002","00","008","0811","0302","904","277","627","59","963","1526","0","63.11","18.15"
"10","002","00","008","0812","0000","457","167","290","35","492","884","0","55.66","18.89"
"10","002","00","008","0812","0303","457","167","290","35","492","884","0","55.66","18.89"
"10","002","00","008","0813","0000","686","268","418","49","735","1465","0","50.17","18.29"
"10","002","00","008","0813","0304","686","268","418","49","735","1465","0","50.17","18.29"
"10","002","00","008","0814","0000","251","81","170","27","278","488","0","56.97","16.6"
"10","002","00","008","0814","0305","251","81","170","27","278","488","0","56.97","16.6"
"10","002","00","008","0815","0000","2403","792","1611","148","2551","4993","0","51.09","15.86"
"10","002","00","008","0815","0306","611","197","414","43","654","1218","0","53.69","16.17"
"10","002","00","008","0815","0307","617","207","410","42","659","1291","0","51.05","16.03"
"10","002","00","008","0815","0308","637","215","422","28","665","1324","0","50.23","16.24"
"10","002","00","008","0815","0309","538","173","365","35","573","1160","0","49.4","14.91"
"10","002","00","008","0816","0000","1491","552","939","79","1570","3000","0","52.33","18.4"
"10","002","00","008","0816","0310","627","219","408","46","673","1246","0","54.01","17.58"
"10","002","00","008","0816","0311","864","333","531","33","897","1754","0","51.14","18.99"
"10","002","00","008","0817","0000","2218","760","1458","175","2393","4651","0","51.45","16.34"
"10","002","00","008","0817","0313","669","221","448","50","719","1495","0","48.09","14.78"
"10","002","00","008","0817","0314","474","172","302","37","511","937","0","54.54","18.36"
"10","002","00","008","0817","0315","543","195","348","36","579","1101","0","52.59","17.71"
"10","002","00","008","0817","0316","532","172","360","52","584","1118","0","52.24","15.38"
"10","002","00","008","0818","0000","2026","724","1302","80","2106","3732","0","56.43","19.4"
"10","002","00","008","0818","0317","727","257","470","22","749","1301","0","57.57","19.75"
"10","002","00","008","0818","0318","626","223","403","28","654","1225","0","53.39","18.2"
"10","002","00","008","0818","0319","673","244","429","30","703","1206","0","58.29","20.23"
"10","002","00","008","0819","0000","1168","387","781","70","1238","2429","0","50.97","15.93"
"10","002","00","008","0819","0320","602","196","406","36","638","1278","0","49.92","15.34"
"10","002","00","008","0819","0321","566","191","375","34","600","1151","0","52.13","16.59"
"10","002","00","008","0820","0000","498","141","357","40","538","1094","0","49.18","12.89"
"10","002","00","008","0820","0322","498","141","357","40","538","1094","0","49.18","12.89"
"10","002","00","008","0821","0000","1262","466","796","72","1334","2494","0","53.49","18.68"
"10","002","00","008","0821","0323","671","261","410","32","703","1247","0","56.38","20.93"
"10","002","00","008","0821","0324","591","205","386","40","631","1247","0","50.6","16.44"
"10","002","00","008","0822","0000","914","321","593","48","962","1677","0","57.36","19.14"
"10","002","00","008","0822","0325","517","181","336","21","538","979","0","54.95","18.49"
"10","002","00","008","0822","0326","397","140","257","27","424","698","0","60.74","20.06"
"10","002","00","008","0823","0000","869","303","566","39","908","1726","0","52.61","17.56"
"10","002","00","008","0823","0327","869","303","566","39","908","1726","0","52.61","17.56"
"10","002","00","008","0824","0000","320","108","212","18","338","782","0","43.22","13.81"
"10","002","00","008","0824","0328","320","108","212","18","338","782","0","43.22","13.81"
"10","002","00","009","0000","0000","17517","6188","11329","1217","18734","34892","39577","53.69","17.73"
"10","002","00","009","0901","0000","993","362","631","62","1055","2020","0","52.23","17.92"
"10","002","00","009","0901","0329","517","177","340","40","557","1076","0","51.77","16.45"
"10","002","00","009","0901","0330","476","185","291","22","498","944","0","52.75","19.6"
"10","002","00","009","0902","0000","957","329","628","54","1011","1773","0","57.02","18.56"
"10","002","00","009","0902","0331","459","157","302","19","478","836","0","57.18","18.78"
"10","002","00","009","0902","0332","498","172","326","35","533","937","0","56.88","18.36"
"10","002","00","009","0903","0000","1251","457","794","89","1340","2525","0","53.07","18.1"
"10","002","00","009","0903","0333","628","214","414","29","657","1255","0","52.35","17.05"
"10","002","00","009","0903","0334","623","243","380","60","683","1270","0","53.78","19.13"
"10","002","00","009","0904","0000","767","285","482","54","821","1603","0","51.22","17.78"
"10","002","00","009","0904","0335","382","139","243","22","404","801","0","50.44","17.35"
"10","002","00","009","0904","0336","385","146","239","32","417","802","0","52.0","18.2"
"10","002","00","009","0905","0000","614","218","396","36","650","1306","0","49.77","16.69"
"10","002","00","009","0905","0337","614","218","396","36","650","1306","0","49.77","16.69"
"10","002","00","009","0906","0000","1269","470","799","56","1325","2506","0","52.87","18.75"
"10","002","00","009","0906","0338","596","230","366","32","628","1190","0","52.77","19.33"
"10","002","00","009","0906","0339","673","240","433","24","697","1316","0","52.96","18.24"
"10","002","00","009","0907","0000","915","319","596","59","974","1779","0","54.75","17.93"
"10","002","00","009","0907","0340","506","184","322","29","535","965","0","55.44","19.07"
"10","002","00","009","0907","0341","409","135","274","30","439","814","0","53.93","16.58"
"10","002","00","009","0908","0000","1902","627","1275","96","1998","3637","0","54.94","17.24"
"10","002","00","009","0908","0342","630","209","421","27","657","1254","0","52.39","16.67"
"10","002","00","009","0908","0343","570","163","407","38","608","1060","0","57.36","15.38"
"10","002","00","009","0908","0344","702","255","447","31","733","1323","0","55.4","19.27"
"10","002","00","009","0909","0000","1898","639","1259","136","2034","3591","0","56.64","17.79"
"10","002","00","009","0909","0348","514","168","346","22","536","924","0","58.01","18.18"
"10","002","00","009","0909","0349","519","188","331","44","563","933","0","60.34","20.15"
"10","002","00","009","0909","0350","499","152","347","29","528","986","0","53.55","15.42"
"10","002","00","009","0909","0351","366","131","235","41","407","748","0","54.41","17.51"
"10","002","00","009","0910","0000","1660","600","1060","105","1765","3233","0","54.59","18.56"
"10","002","00","009","0910","0345","598","215","383","42","640","1120","0","57.14","19.2"
"10","002","00","009","0910","0346","461","169","292","22","483","893","0","54.09","18.92"
"10","002","00","009","0910","0347","601","216","385","41","642","1220","0","52.62","17.7"
"10","002","00","009","0911","0000","766","264","502","71","837","1550","0","54.0","17.03"
"10","002","00","009","0911","0352","766","264","502","71","837","1550","0","54.0","17.03"
"10","002","00","009","0912","0000","746","256","490","59","805","1435","0","56.1","17.84"
"10","002","00","009","0912","0353","342","110","232","22","364","629","0","57.87","17.49"
"10","002","00","009","0912","0354","404","146","258","37","441","806","0","54.71","18.11"
"10","002","00","009","0913","0000","985","350","635","83","1068","2022","0","52.82","17.31"
"10","002","00","009","0913","0355","457","186","271","44","501","956","0","52.41","19.46"
"10","002","00","009","0913","0356","528","164","364","39","567","1066","0","53.19","15.38"
"10","002","00","009","0914","0000","1477","535","942","97","1574","3079","0","51.12","17.38"
"10","002","00","009","0914","0357","694","256","438","56","750","1513","0","49.57","16.92"
"10","002","00","009","0914","0358","783","279","504","41","824","1566","0","52.62","17.82"
"10","002","00","009","0915","0000","1317","477","840","160","1477","2833","0","52.14","16.84"
"10","002","00","009","0915","0359","433","169","264","64","497","894","0","55.59","18.9"
"10","002","00","009","0915","0360","523","197","326","59","582","1235","0","47.13","15.95"
"10","002","00","009","0915","0361","361","111","250","37","398","704","0","56.53","15.77"
"10","002","00","010","0000","0000","9194","3118","6076","797","9991","19051","21391","52.44","16.37"
"10","002","00","010","1001","0000","102","32","70","15","117","215","0","54.42","14.88"
"10","002","00","010","1001","0362","102","32","70","15","117","215","0","54.42","14.88"
"10","002","00","010","1002","0000","204","73","131","36","240","523","0","45.89","13.96"
"10","002","00","010","1002","0363","204","73","131","36","240","523","0","45.89","13.96"
"10","002","00","010","1003","0000","345","134","211","43","388","745","0","52.08","17.99"
"10","002","00","010","1003","0364","345","134","211","43","388","745","0","52.08","17.99"
"10","002","00","010","1004","0000","296","96","200","28","324","583","0","55.57","16.47"
"10","002","00","010","1004","0368","296","96","200","28","324","583","0","55.57","16.47"
"10","002","00","010","1005","0000","209","50","159","26","235","436","0","53.9","11.47"
"10","002","00","010","1005","0369","209","50","159","26","235","436","0","53.9","11.47"
"10","002","00","010","1006","0000","597","198","399","47","644","1224","0","52.61","16.18"
"10","002","00","010","1006","0370","597","198","399","47","644","1224","0","52.61","16.18"
"10","002","00","010","1007","0000","523","167","356","31","554","1151","0","48.13","14.51"
"10","002","00","010","1007","0371","523","167","356","31","554","1151","0","48.13","14.51"
"10","002","00","010","1008","0000","449","139","310","33","482","870","0","55.4","15.98"
"10","002","00","010","1008","0372","449","139","310","33","482","870","0","55.4","15.98"
"10","002","00","010","1009","0000","500","153","347","34","534","1284","0","41.59","11.92"
"10","002","00","010","1009","0373","500","153","347","34","534","1284","0","41.59","11.92"
"10","002","00","010","1010","0000","2114","720","1394","136","2250","4286","0","52.5","16.8"
"10","002","00","010","1010","0375","722","240","482","55","777","1439","0","54.0","16.68"
"10","002","00","010","1010","0376","690","257","433","47","737","1445","0","51.0","17.79"
"10","002","00","010","1010","0377","702","223","479","34","736","1402","0","52.5","15.91"
"10","002","00","010","1011","0000","480","153","327","51","531","897","0","59.2","17.06"
"10","002","00","010","1011","0374","480","153","327","51","531","897","0","59.2","17.06"
"10","002","00","010","1012","0000","291","111","180","25","316","617","0","51.22","17.99"
"10","002","00","010","1012","0365","291","111","180","25","316","617","0","51.22","17.99"
"10","002","00","010","1013","0000","235","80","155","30","265","497","0","53.32","16.1"
"10","002","00","010","1013","0366","235","80","155","30","265","497","0","53.32","16.1"
"10","002","00","010","1014","0000","362","127","235","49","411","735","0","55.92","17.28"
"10","002","00","010","1014","0367","362","127","235","49","411","735","0","55.92","17.28"
"10","002","00","010","1015","0000","602","223","379","46","648","1230","0","52.68","18.13"
"10","002","00","010","1015","0378","602","223","379","46","648","1230","0","52.68","18.13"
"10","002","00","010","1016","0000","394","115","279","38","432","774","0","55.81","14.86"
"10","002","00","010","1016","0379","394","115","279","38","432","774","0","55.81","14.86"
"10","002","00","010","1017","0000","810","302","508","64","874","1563","0","55.92","19.32"
"10","002","00","010","1017","0380","438","158","280","42","480","827","0","58.04","19.11"
"10","002","00","010","1017","0381","372","144","228","22","394","736","0","53.53","19.57"
"10","002","00","010","1018","0000","681","245","436","65","746","1421","0","52.5","17.24"
"10","002","00","010","1018","0382","681","245","436","65","746","1421","0","52.5","17.24"
"10","002","00","011","0000","0000","2665","528","2137","217","2882","4935","6247","58.4","10.7"
"10","002","00","011","1101","0000","399","101","298","42","441","893","0","49.38","11.31"
"10","002","00","011","1101","0383","399","101","298","42","441","893","0","49.38","11.31"
"10","002","00","011","1102","0000","426","85","341","34","460","632","0","72.78","13.45"
"10","002","00","011","1102","0384","426","85","341","34","460","632","0","72.78","13.45"
"10","002","00","011","1103","0000","412","77","335","23","435","684","0","63.6","11.26"
"10","002","00","011","1103","0385","412","77","335","23","435","684","0","63.6","11.26"
"10","002","00","011","1104","0000","150","44","106","25","175","264","0","66.29","16.67"
"10","002","00","011","1104","0386","150","44","106","25","175","264","0","66.29","16.67"
"10","002","00","011","1105","0000","172","27","145","4","176","337","0","52.23","8.01"
"10","002","00","011","1105","0387","172","27","145","4","176","337","0","52.23","8.01"
"10","002","00","011","1106","0000","232","32","200","8","240","404","0","59.41","7.92"
"10","002","00","011","1106","0388","232","32","200","8","240","404","0","59.41","7.92"
"10","002","00","011","1107","0000","24","4","20","3","27","55","0","49.09","7.27"
"10","002","00","011","1107","0389","24","4","20","3","27","55","0","49.09","7.27"
"10","002","00","011","1108","0000","317","73","244","12","329","787","0","41.8","9.28"
"10","002","00","011","1108","0391","317","73","244","12","329","787","0","41.8","9.28"
"10","002","00","011","1109","0000","399","60","339","46","445","680","0","65.44","8.82"
"10","002","00","011","1109","0392","399","60","339","46","445","680","0","65.44","8.82"
"10","002","00","011","1110","0000","134","25","109","20","154","199","0","77.39","12.56"
"10","002","00","011","1110","0390","134","25","109","20","154","199","0","77.39","12.56"
"10","002","00","012","0000","0000","2626","538","2088","183","2809","4644","6024","60.49","11.58"
"10","002","00","012","1201","0000","602","138","464","24","626","1210","0","51.74","11.4"
"10","002","00","012","1201","0394","602","138","464","24","626","1210","0","51.74","11.4"
"10","002","00","012","1202","0000","583","108","475","61","644","962","0","66.94","11.23"
"10","002","00","012","1202","0395","583","108","475","61","644","962","0","66.94","11.23"
"10","002","00","012","1203","0000","241","66","175","6","247","444","0","55.63","14.86"
"10","002","00","012","1203","0393","241","66","175","6","247","444","0","55.63","14.86"
"10","002","00","012","1204","0000","188","36","152","5","193","411","0","46.96","8.76"
"10","002","00","012","1204","0396","188","36","152","5","193","411","0","46.96","8.76"
"10","002","00","012","1205","0000","293","66","227","16","309","447","0","69.13","14.77"
"10","002","00","012","1205","0397","293","66","227","16","309","447","0","69.13","14.77"
"10","002","00","012","1206","0000","337","61","276","36","373","475","0","78.53","12.84"
"10","002","00","012","1206","0398","337","61","276","36","373","475","0","78.53","12.84"
"10","002","00","012","1207","0000","382","63","319","35","417","695","0","60.0","9.06"
"10","002","00","012","1207","0399","382","63","319","35","417","695","0","60.0","9.06"
"10","015","00","000","0000","0000","136822","38850","97972","9514","146336","278059","328331","52.63","13.97"
"10","015","00","001","0000","0000","43668","13072","30596","2054","45722","84807","103798","53.91","15.41"
"10","015","00","001","0101","0000","727","231","496","18","745","1512","0","49.27","15.28"
"10","015","00","001","0101","0019","727","231","496","18","745","1512","0","49.27","15.28"
"10","015","00","001","0102","0000","1044","310","734","81","1125","1996","0","56.36","15.53"
"10","015","00","001","0102","0014","539","155","384","57","596","1071","0","55.65","14.47"
"10","015","00","001","0102","0015","505","155","350","24","529","925","0","57.19","16.76"
"10","015","00","001","0103","0000","235","62","173","13","248","442","0","56.11","14.03"
"10","015","00","001","0103","0023","235","62","173","13","248","442","0","56.11","14.03"
"10","015","00","001","0104","0000","286","85","201","24","310","566","0","54.77","15.02"
"10","015","00","001","0104","0029","286","85","201","24","310","566","0","54.77","15.02"
"10","015","00","001","0105","0000","306","100","206","17","323","565","0","57.17","17.7"
"10","015","00","001","0105","0031","306","100","206","17","323","565","0","57.17","17.7"
"10","015","00","001","0106","0000","1528","450","1078","108","1636","2983","0","54.84","15.09"
"10","015","00","001","0106","0033","442","141","301","39","481","911","0","52.8","15.48"
"10","015","00","001","0106","0034","505","129","376","34","539","1029","0","52.38","12.54"
"10","015","00","001","0106","0035","581","180","401","35","616","1043","0","59.06","17.26"
"10","015","00","001","0107","0000","764","239","525","37","801","1840","0","43.53","12.99"
"10","015","00","001","0107","0052","480","150","330","19","499","1339","0","37.27","11.2"
"10","015","00","001","0107","0053","284","89","195","18","302","501","0","60.28","17.76"
"10","015","00","001","0108","0000","1798","499","1299","94","1892","3241","0","58.38","15.4"
"10","015","00","001","0108","0049","608","177","431","36","644","1022","0","63.01","17.32"
"10","015","00","001","0108","0050","605","179","426","33","638","1135","0","56.21","15.77"
"10","015","00","001","0108","0051","585","143","442","25","610","1084","0","56.27","13.19"
"10","015","00","001","0109","0000","843","279","564","25","868","1522","0","57.03","18.33"
"10","015","00","001","0109","0001","843","279","564","25","868","1522","0","57.03","18.33"
"10","015","00","001","0110","0000","917","242","675","62","979","2029","0","48.25","11.93"
"10","015","00","001","0110","0005","220","68","152","19","239","470","0","50.85","14.47"
"10","015","00","001","0110","0006","405","105","300","27","432","838","0","51.55","12.53"
"10","015","00","001","0110","0007","292","69","223","16","308","721","0","42.72","9.57"
"10","015","00","001","0112","0000","252","76","176","9","261","469","0","55.65","16.2"
"10","015","00","001","0112","0030","252","76","176","9","261","469","0","55.65","16.2"
"10","015","00","001","0113","0000","292","89","203","17","309","538","0","57.43","16.54"
"10","015","00","001","0113","0028","292","89","203","17","309","538","0","57.43","16.54"
"10","015","00","001","0114","0000","1900","661","1239","94","1994","3514","0","56.74","18.81"
"10","015","00","001","0114","0038","704","213","491","46","750","1331","0","56.35","16.0"
"10","015","00","001","0114","0039","670","303","367","27","697","1228","0","56.76","24.67"
"10","015","00","001","0114","0040","526","145","381","21","547","955","0","57.28","15.18"
"10","015","00","001","0115","0000","485","145","340","19","504","904","0","55.75","16.04"
"10","015","00","001","0115","0054","485","145","340","19","504","904","0","55.75","16.04"
"10","015","00","001","0116","0000","2574","695","1879","116","2690","5074","0","53.02","13.7"
"10","015","00","001","0116","0069","654","179","475","45","699","1410","0","49.57","12.7"
"10","015","00","001","0116","0070","670","177","493","13","683","1303","0","52.42","13.58"
"10","015","00","001","0116","0071","647","195","452","25","672","1256","0","53.5","15.53"
"10","015","00","001","0116","0072","603","144","459","33","636","1105","0","57.56","13.03"
"10","015","00","001","0117","0000","1986","580","1406","90","2076","3583","0","57.94","16.19"
"10","015","00","001","0117","0016","669","191","478","44","713","1141","0","62.49","16.74"
"10","015","00","001","0117","0017","601","176","425","15","616","1163","0","52.97","15.13"
"10","015","00","001","0117","0018","716","213","503","31","747","1279","0","58.41","16.65"
"10","015","00","001","0118","0000","1710","536","1174","55","1765","3181","0","55.49","16.85"
"10","015","00","001","0118","0002","631","192","439","20","651","1114","0","58.44","17.24"
"10","015","00","001","0118","0003","359","119","240","17","376","670","0","56.12","17.76"
"10","015","00","001","0118","0004","720","225","495","18","738","1397","0","52.83","16.11"
"10","015","00","001","0119","0000","546","153","393","26","572","1114","0","51.35","13.73"
"10","015","00","001","0119","0024","546","153","393","26","572","1114","0","51.35","13.73"
"10","015","00","001","0120","0000","340","105","235","15","355","577","0","61.53","18.2"
"10","015","00","001","0120","0026","340","105","235","15","355","577","0","61.53","18.2"
"10","015","00","001","0121","0000","1001","319","682","34","1035","1835","0","56.4","17.38"
"10","015","00","001","0121","0036","475","151","324","19","494","856","0","57.71","17.64"
"10","015","00","001","0121","0037","526","168","358","15","541","979","0","55.26","17.16"
"10","015","00","001","0122","0000","546","152","394","28","574","1192","0","48.15","12.75"
"10","015","00","001","0122","0056","546","152","394","28","574","1192","0","48.15","12.75"
"10","015","00","001","0123","0000","1338","418","920","52","1390","2766","0","50.25","15.11"
"10","015","00","001","0123","0062","628","201","427","14","642","1311","0","48.97","15.33"
"10","015","00","001","0123","0063","710","217","493","38","748","1455","0","51.41","14.91"
"10","015","00","001","0124","0000","927","287","640","47","974","1715","0","56.79","16.73"
"10","015","00","001","0124","0067","395","124","271","20","415","715","0","58.04","17.34"
"10","015","00","001","0124","0068","532","163","369","27","559","1000","0","55.9","16.3"
"10","015","00","001","0125","0000","500","155","345","32","532","918","0","57.95","16.88"
"10","015","00","001","0125","0008","500","155","345","32","532","918","0","57.95","16.88"
"10","015","00","001","0126","0000","314","111","203","20","334","615","0","54.31","18.05"
"10","015","00","001","0126","0020","314","111","203","20","334","615","0","54.31","18.05"
"10","015","00","001","0127","0000","274","75","199","10","284","559","0","50.81","13.42"
"10","015","00","001","0127","0022","274","75","199","10","284","559","0","50.81","13.42"
"10","015","00","001","0128","0000","471","155","316","24","495","810","0","61.11","19.14"
"10","015","00","001","0128","0027","471","155","316","24","495","810","0","61.11","19.14"
"10","015","00","001","0129","0000","1372","346","1026","66","1438","2674","0","53.78","12.94"
"10","015","00","001","0129","0047","609","196","413","47","656","1184","0","55.41","16.55"
"10","015","00","001","0129","0048","763","150","613","19","782","1490","0","52.48","10.07"
"10","015","00","001","0130","0000","290","95","195","14","304","490","0","62.04","19.39"
"10","015","00","001","0130","0055","290","95","195","14","304","490","0","62.04","19.39"
"10","015","00","001","0131","0000","1032","301","731","64","1096","1975","0","55.49","15.24"
"10","015","00","001","0131","0060","517","152","365","27","544","993","0","54.78","15.31"
"10","015","00","001","0131","0061","515","149","366","37","552","982","0","56.21","15.17"
"10","015","00","001","0132","0000","593","195","398","19","612","1068","0","57.3","18.26"
"10","015","00","001","0132","0077","593","195","398","19","612","1068","0","57.3","18.26"
"10","015","00","001","0133","0000","1492","471","1021","65","1557","2942","0","52.92","16.01"
"10","015","00","001","0133","0009","781","260","521","29","810","1539","0","52.63","16.89"
"10","015","00","001","0133","0010","711","211","500","36","747","1403","0","53.24","15.04"
"10","015","00","001","0134","0000","344","114","230","14","358","606","0","59.08","18.81"
"10","015","00","001","0134","0021","344","114","230","14","358","606","0","59.08","18.81"
"10","015","00","001","0135","0000","228","61","167","12","240","416","0","57.69","14.66"
"10","015","00","001","0135","0025","228","61","167","12","240","416","0","57.69","14.66"
"10","015","00","001","0136","0000","382","107","275","24","406","816","0","49.75","13.11"
"10","015","00","001","0136","0032","382","107","275","24","406","816","0","49.75","13.11"
"10","015","00","001","0137","0000","2703","789","1914","115","2818","5217","0","54.02","15.12"
"10","015","00","001","0137","0043","741","213","528","34","775","1369","0","56.61","15.56"
"10","015","00","001","0137","0044","644","202","442","22","666","1435","0","46.41","14.08"
"10","015","00","001","0137","0045","616","173","443","23","639","1164","0","54.9","14.86"
"10","015","00","001","0137","0046","702","201","501","36","738","1249","0","59.09","16.09"
"10","015","00","001","0138","0000","1178","362","816","55","1233","2226","0","55.39","16.26"
"10","015","00","001","0138","0058","650","201","449","26","676","1267","0","53.35","15.86"
"10","015","00","001","0138","0059","528","161","367","29","557","959","0","58.08","16.79"
"10","015","00","001","0139","0000","412","126","286","25","437","869","0","50.29","14.5"
"10","015","00","001","0139","0057","412","126","286","25","437","869","0","50.29","14.5"
"10","015","00","001","0140","0000","646","181","465","36","682","1482","0","46.02","12.21"
"10","015","00","001","0140","0081","646","181","465","36","682","1482","0","46.02","12.21"
"10","015","00","001","0141","0000","2159","600","1559","98","2257","4183","0","53.96","14.34"
"10","015","00","001","0141","0073","535","168","367","22","557","1089","0","51.15","15.43"
"10","015","00","001","0141","0074","510","139","371","22","532","1043","0","51.01","13.33"
"10","015","00","001","0141","0075","591","147","444","31","622","1080","0","57.59","13.61"
"10","015","00","001","0141","0076","523","146","377","23","546","971","0","56.23","15.04"
"10","015","00","001","0142","0000","1233","376","857","53","1286","2498","0","51.48","15.05"
"10","015","00","001","0142","0041","616","191","425","27","643","1268","0","50.71","15.06"
"10","015","00","001","0142","0042","617","185","432","26","643","1230","0","52.28","15.04"
"10","015","00","001","0143","0000","1725","521","1204","70","1795","3727","0","48.16","13.98"
"10","015","00","001","0143","0064","509","124","385","27","536","1151","0","46.57","10.77"
"10","015","00","001","0143","0065","591","171","420","22","613","1237","0","49.56","13.82"
"10","015","00","001","0143","0066","625","226","399","21","646","1339","0","48.24","16.88"
"10","015","00","001","0144","0000","2091","681","1410","76","2167","4064","0","53.32","16.76"
"10","015","00","001","0144","0078","670","198","472","24","694","1379","0","50.33","14.36"
"10","015","00","001","0144","0079","686","241","445","31","717","1362","0","52.64","17.69"
"10","015","00","001","0144","0080","735","242","493","21","756","1323","0","57.14","18.29"
"10","015","00","001","0145","0000","1884","537","1347","81","1965","3494","0","56.24","15.37"
"10","015","00","001","0145","0011","544","149","395","22","566","1068","0","53.0","13.95"
"10","015","00","001","0145","0012","627","177","450","19","646","1167","0","55.36","15.17"
"10","015","00","001","0145","0013","713","211","502","40","753","1259","0","59.81","16.76"
"10","015","00","002","0000","0000","4874","1327","3547","466","5340","9676","10902","55.19","13.71"
"10","015","00","002","0201","0000","681","175","506","55","736","1192","0","61.74","14.68"
"10","015","00","002","0201","0195","681","175","506","55","736","1192","0","61.74","14.68"
"10","015","00","002","0202","0000","305","74","231","20","325","639","0","50.86","11.58"
"10","015","00","002","0202","0196","305","74","231","20","325","639","0","50.86","11.58"
"10","015","00","002","0203","0000","363","91","272","38","401","601","0","66.72","15.14"
"10","015","00","002","0203","0197","363","91","272","38","401","601","0","66.72","15.14"
"10","015","00","002","0204","0000","689","189","500","39","728","1137","0","64.03","16.62"
"10","015","00","002","0204","0198","689","189","500","39","728","1137","0","64.03","16.62"
"10","015","00","002","0205","0000","708","184","524","61","769","1352","0","56.88","13.61"
"10","015","00","002","0205","0199","373","106","267","45","418","742","0","56.33","14.29"
"10","015","00","002","0205","0200","335","78","257","16","351","610","0","57.54","12.79"
"10","015","00","002","0206","0000","220","64","156","39","259","513","0","50.49","12.48"
"10","015","00","002","0206","0201","156","52","104","36","192","295","0","65.08","17.63"
"10","015","00","002","0206","0202","64","12","52","3","67","218","0","30.73","5.5"
"10","015","00","002","0207","0000","554","168","386","46","600","1248","0","48.08","13.46"
"10","015","00","002","0207","0203","292","87","205","19","311","720","0","43.19","12.08"
"10","015","00","002","0207","0204","262","81","181","27","289","528","0","54.73","15.34"
"10","015","00","002","0208","0000","272","89","183","18","290","560","0","51.79","15.89"
"10","015","00","002","0208","0205","272","89","183","18","290","560","0","51.79","15.89"
"10","015","00","002","0209","0000","249","68","181","42","291","541","0","53.79","12.57"
"10","015","00","002","0209","0206","249","68","181","42","291","541","0","53.79","12.57"
"10","015","00","002","0210","0000","411","99","312","53","464","818","0","56.72","12.1"
"10","015","00","002","0210","0207","411","99","312","53","464","818","0","56.72","12.1"
"10","015","00","002","0211","0000","384","112","272","44","428","984","0","43.5","11.38"
"10","015","00","002","0211","0208","384","112","272","44","428","984","0","43.5","11.38"
"10","015","00","002","0212","0000","38","14","24","11","49","91","0","53.85","15.38"
"10","015","00","002","0212","0209","38","14","24","11","49","91","0","53.85","15.38"
"10","015","00","003","0000","0000","8784","2402","6382","997","9781","20650","24066","47.37","11.63"
"10","015","00","003","0301","0000","2602","722","1880","194","2796","5111","0","54.71","14.13"
"10","015","00","003","0301","0254","511","146","365","30","541","1008","0","53.67","14.48"
"10","015","00","003","0301","0255","521","129","392","37","558","939","0","59.42","13.74"
"10","015","00","003","0301","0256","597","168","429","61","658","1256","0","52.39","13.38"
"10","015","00","003","0301","0257","471","139","332","34","505","929","0","54.36","14.96"
"10","015","00","003","0301","0258","502","140","362","32","534","979","0","54.55","14.3"
"10","015","00","003","0302","0000","721","197","524","77","798","1619","0","49.29","12.17"
"10","015","00","003","0302","0260","380","97","283","38","418","847","0","49.35","11.45"
"10","015","00","003","0302","0261","341","100","241","39","380","772","0","49.22","12.95"
"10","015","00","003","0303","0000","532","122","410","64","596","1286","0","46.35","9.49"
"10","015","00","003","0303","0264","532","122","410","64","596","1286","0","46.35","9.49"
"10","015","00","003","0304","0000","495","144","351","43","538","1358","0","39.62","10.6"
"10","015","00","003","0304","0262","257","78","179","21","278","558","0","49.82","13.98"
"10","015","00","003","0304","0263","238","66","172","22","260","800","0","32.5","8.25"
"10","015","00","003","0305","0000","699","98","601","31","730","1244","0","58.68","7.88"
"10","015","00","003","0305","0259","699","98","601","31","730","1244","0","58.68","7.88"
"10","015","00","003","0306","0000","559","186","373","39","598","1246","0","47.99","14.93"
"10","015","00","003","0306","0265","559","186","373","39","598","1246","0","47.99","14.93"
"10","015","00","003","0307","0000","291","88","203","59","350","647","0","54.1","13.6"
"10","015","00","003","0307","0266","291","88","203","59","350","647","0","54.1","13.6"
"10","015","00","003","0308","0000","228","65","163","14","242","990","0","24.44","6.57"
"10","015","00","003","0308","0267","228","65","163","14","242","990","0","24.44","6.57"
"10","015","00","003","0309","0000","205","64","141","57","262","530","0","49.43","12.08"
"10","015","00","003","0309","0268","205","64","141","57","262","530","0","49.43","12.08"
"10","015","00","003","0310","0000","579","152","427","111","690","1536","0","44.92","9.9"
"10","015","00","003","0310","0269","334","90","244","36","370","979","0","37.79","9.19"
"10","015","00","003","0310","0270","245","62","183","75","320","557","0","57.45","11.13"
"10","015","00","003","0311","0000","466","137","329","92","558","1499","0","37.22","9.14"
"10","015","00","003","0311","0271","157","38","119","20","177","434","0","40.78","8.76"
"10","015","00","003","0311","0272","309","99","210","72","381","1065","0","35.77","9.3"
"10","015","00","003","0312","0000","380","99","281","90","470","866","0","54.27","11.43"
"10","015","00","003","0312","0273","380","99","281","90","470","866","0","54.27","11.43"
"10","015","00","003","0313","0000","283","77","206","52","335","769","0","43.56","10.01"
"10","015","00","003","0313","0274","283","77","206","52","335","769","0","43.56","10.01"
"10","015","00","003","0314","0000","341","123","218","31","372","869","0","42.81","14.15"
"10","015","00","003","0314","0275","341","123","218","31","372","869","0","42.81","14.15"
"10","015","00","003","0315","0000","403","128","275","43","446","1080","0","41.3","11.85"
"10","015","00","003","0315","0276","403","128","275","43","446","1080","0","41.3","11.85"
"10","015","00","004","0000","0000","8666","2473","6193","586","9252","17029","20112","54.33","14.52"
"10","015","00","004","0401","0000","644","189","455","36","680","1296","0","52.47","14.58"
"10","015","00","004","0401","0082","194","73","121","18","212","367","0","57.77","19.89"
"10","015","00","004","0401","0083","450","116","334","18","468","929","0","50.38","12.49"
"10","015","00","004","0402","0000","456","164","292","72","528","897","0","58.86","18.28"
"10","015","00","004","0402","0084","305","112","193","50","355","590","0","60.17","18.98"
"10","015","00","004","0402","0085","151","52","99","22","173","307","0","56.35","16.94"
"10","015","00","004","0403","0000","1234","352","882","94","1328","2428","0","54.7","14.5"
"10","015","00","004","0403","0086","147","36","111","13","160","260","0","61.54","13.85"
"10","015","00","004","0403","0087","660","221","439","59","719","1283","0","56.04","17.23"
"10","015","00","004","0403","0088","427","95","332","22","449","885","0","50.73","10.73"
"10","015","00","004","0404","0000","1978","547","1431","120","2098","3962","0","52.95","13.81"
"10","015","00","004","0404","0092","546","151","395","48","594","1163","0","51.07","12.98"
"10","015","00","004","0404","0093","810","220","590","37","847","1605","0","52.77","13.71"
"10","015","00","004","0404","0094","622","176","446","35","657","1194","0","55.03","14.74"
"10","015","00","004","0405","0000","522","151","371","30","552","979","0","56.38","15.42"
"10","015","00","004","0405","0095","522","151","371","30","552","979","0","56.38","15.42"
"10","015","00","004","0406","0000","1937","551","1386","87","2024","3719","0","54.42","14.82"
"10","015","00","004","0406","0096","790","205","585","40","830","1485","0","55.89","13.8"
"10","015","00","004","0406","0097","537","157","380","23","560","1070","0","52.34","14.67"
"10","015","00","004","0406","0098","610","189","421","24","634","1164","0","54.47","16.24"
"10","015","00","004","0407","0000","603","180","423","51","654","1249","0","52.36","14.41"
"10","015","00","004","0407","0099","425","119","306","43","468","880","0","53.18","13.52"
"10","015","00","004","0407","0100","178","61","117","8","186","369","0","50.41","16.53"
"10","015","00","004","0408","0000","1292","339","953","96","1388","2499","0","55.54","13.57"
"10","015","00","004","0408","0089","416","109","307","30","446","770","0","57.92","14.16"
"10","015","00","004","0408","0090","690","167","523","54","744","1363","0","54.59","12.25"
"10","015","00","004","0408","0091","186","63","123","12","198","366","0","54.1","17.21"
"10","015","00","005","0000","0000","36247","10232","26015","1847","38094","72116","83262","52.82","14.19"
"10","015","00","005","0501","0000","3741","1068","2673","149","3890","7071","0","55.01","15.1"
"10","015","00","005","0501","0147","580","180","400","30","610","1135","0","53.74","15.86"
"10","015","00","005","0501","0148","666","171","495","25","691","1223","0","56.5","13.98"
"10","015","00","005","0501","0149","674","161","513","23","697","1274","0","54.71","12.64"
"10","015","00","005","0501","0150","565","161","404","29","594","1124","0","52.85","14.32"
"10","015","00","005","0501","0151","626","199","427","25","651","1158","0","56.22","17.18"
"10","015","00","005","0501","0152","630","196","434","17","647","1157","0","55.92","16.94"
"10","015","00","005","0502","0000","2587","761","1826","82","2669","4926","0","54.18","15.45"
"10","015","00","005","0502","0153","674","196","478","21","695","1258","0","55.25","15.58"
"10","015","00","005","0502","0154","640","187","453","32","672","1257","0","53.46","14.88"
"10","015","00","005","0502","0155","631","183","448","21","652","1245","0","52.37","14.7"
"10","015","00","005","0502","0156","642","195","447","8","650","1166","0","55.75","16.72"
"10","015","00","005","0503","0000","1732","550","1182","102","1834","3739","0","49.05","14.71"
"10","015","00","005","0503","0119","553","179","374","26","579","1107","0","52.3","16.17"
"10","015","00","005","0503","0120","564","179","385","26","590","1179","0","50.04","15.18"
"10","015","00","005","0503","0121","615","192","423","50","665","1453","0","45.77","13.21"
"10","015","00","005","0504","0000","2141","622","1519","102","2243","4178","0","53.69","14.89"
"10","015","00","005","0504","0115","534","158","376","26","560","1059","0","52.88","14.92"
"10","015","00","005","0504","0116","519","150","369","29","548","983","0","55.75","15.26"
"10","015","00","005","0504","0117","541","150","391","23","564","1031","0","54.7","14.55"
"10","015","00","005","0504","0118","547","164","383","24","571","1105","0","51.67","14.84"
"10","015","00","005","0505","0000","3594","1051","2543","149","3743","6870","0","54.48","15.3"
"10","015","00","005","0505","0122","805","243","562","36","841","1432","0","58.73","16.97"
"10","015","00","005","0505","0123","705","209","496","22","727","1320","0","55.08","15.83"
"10","015","00","005","0505","0124","679","200","479","21","700","1356","0","51.62","14.75"
"10","015","00","005","0505","0125","654","173","481","23","677","1295","0","52.28","13.36"
"10","015","00","005","0505","0126","751","226","525","47","798","1467","0","54.4","15.41"
"10","015","00","005","0506","0000","2674","805","1869","95","2769","5242","0","52.82","15.36"
"10","015","00","005","0506","0127","767","226","541","25","792","1515","0","52.28","14.92"
"10","015","00","005","0506","0128","595","183","412","35","630","1063","0","59.27","17.22"
"10","015","00","005","0506","0129","561","172","389","13","574","1284","0","44.7","13.4"
"10","015","00","005","0506","0130","751","224","527","22","773","1380","0","56.01","16.23"
"10","015","00","005","0507","0000","1481","439","1042","115","1596","2959","0","53.94","14.84"
"10","015","00","005","0507","0131","684","197","487","50","734","1297","0","56.59","15.19"
"10","015","00","005","0507","0132","797","242","555","65","862","1662","0","51.87","14.56"
"10","015","00","005","0508","0000","694","181","513","60","754","1563","0","48.24","11.58"
"10","015","00","005","0508","0133","694","181","513","60","754","1563","0","48.24","11.58"
"10","015","00","005","0509","0000","586","145","441","36","622","1288","0","48.29","11.26"
"10","015","00","005","0509","0134","586","145","441","36","622","1288","0","48.29","11.26"
"10","015","00","005","0510","0000","1438","432","1006","74","1512","2845","0","53.15","15.18"
"10","015","00","005","0510","0135","487","149","338","27","514","907","0","56.67","16.43"
"10","015","00","005","0510","0136","447","126","321","26","473","917","0","51.58","13.74"
"10","015","00","005","0510","0137","504","157","347","21","525","1021","0","51.42","15.38"
"10","015","00","005","0511","0000","1680","483","1197","111","1791","3187","0","56.2","15.16"
"10","015","00","005","0511","0138","586","172","414","28","614","1033","0","59.44","16.65"
"10","015","00","005","0511","0139","511","156","355","41","552","966","0","57.14","16.15"
"10","015","00","005","0511","0140","583","155","428","42","625","1188","0","52.61","13.05"
"10","015","00","005","0512","0000","1978","527","1451","83","2061","4066","0","50.69","12.96"
"10","015","00","005","0512","0141","746","189","557","27","773","1480","0","52.23","12.77"
"10","015","00","005","0512","0142","646","164","482","29","675","1393","0","48.46","11.77"
"10","015","00","005","0512","0143","586","174","412","27","613","1193","0","51.38","14.59"
"10","015","00","005","0513","0000","1960","563","1397","147","2107","3961","0","53.19","14.21"
"10","015","00","005","0513","0144","673","180","493","29","702","1445","0","48.58","12.46"
"10","015","00","005","0513","0145","644","190","454","70","714","1301","0","54.88","14.6"
"10","015","00","005","0513","0146","643","193","450","48","691","1215","0","56.87","15.88"
"10","015","00","005","0514","0000","3088","852","2236","166","3254","6041","0","53.87","14.1"
"10","015","00","005","0514","0157","661","191","470","50","711","1358","0","52.36","14.06"
"10","015","00","005","0514","0158","602","137","465","26","628","1214","0","51.73","11.29"
"10","015","00","005","0514","0159","583","169","414","38","621","1151","0","53.95","14.68"
"10","015","00","005","0514","0160","612","166","446","28","640","1157","0","55.32","14.35"
"10","015","00","005","0514","0161","630","189","441","24","654","1161","0","56.33","16.28"
"10","015","00","005","0515","0000","2643","705","1938","145","2788","5491","0","50.77","12.84"
"10","015","00","005","0515","0162","704","207","497","33","737","1304","0","56.52","15.87"
"10","015","00","005","0515","0163","676","184","492","43","719","1367","0","52.6","13.46"
"10","015","00","005","0515","0164","638","169","469","28","666","1411","0","47.2","11.98"
"10","015","00","005","0515","0165","625","145","480","41","666","1409","0","47.27","10.29"
"10","015","00","005","0516","0000","1125","303","822","78","1203","2338","0","51.45","12.96"
"10","015","00","005","0516","0166","508","139","369","30","538","1125","0","47.82","12.36"
"10","015","00","005","0516","0167","617","164","453","48","665","1213","0","54.82","13.52"
"10","015","00","005","0517","0000","2093","499","1594","109","2202","4415","0","49.88","11.3"
"10","015","00","005","0517","0168","595","134","461","31","626","1141","0","54.86","11.74"
"10","015","00","005","0517","0169","518","134","384","20","538","1156","0","46.54","11.59"
"10","015","00","005","0517","0170","541","116","425","30","571","1092","0","52.29","10.62"
"10","015","00","005","0517","0171","439","115","324","28","467","1026","0","45.52","11.21"
"10","015","00","005","0518","0000","1012","246","766","44","1056","1936","0","54.55","12.71"
"10","015","00","005","0518","0172","416","99","317","13","429","804","0","53.36","12.31"
"10","015","00","005","0518","0173","596","147","449","31","627","1132","0","55.39","12.99"
"10","015","00","006","0000","0000","8066","2363","5703","734","8800","15847","18006","55.53","14.91"
"10","015","00","006","0601","0000","190","51","139","28","218","357","0","61.06","14.29"
"10","015","00","006","0601","0175","190","51","139","28","218","357","0","61.06","14.29"
"10","015","00","006","0602","0000","482","133","349","34","516","1052","0","49.05","12.64"
"10","015","00","006","0602","0174","482","133","349","34","516","1052","0","49.05","12.64"
"10","015","00","006","0603","0000","980","283","697","83","1063","1897","0","56.04","14.92"
"10","015","00","006","0603","0176","465","140","325","50","515","1022","0","50.39","13.7"
"10","015","00","006","0603","0177","515","143","372","33","548","875","0","62.63","16.34"
"10","015","00","006","0604","0000","721","201","520","48","769","1399","0","54.97","14.37"
"10","015","00","006","0604","0178","397","121","276","27","424","691","0","61.36","17.51"
"10","015","00","006","0604","0179","324","80","244","21","345","708","0","48.73","11.3"
"10","015","00","006","0605","0000","433","132","301","41","474","894","0","53.02","14.77"
"10","015","00","006","0605","0180","433","132","301","41","474","894","0","53.02","14.77"
"10","015","00","006","0606","0000","408","121","287","28","436","695","0","62.73","17.41"
"10","015","00","006","0606","0183","408","121","287","28","436","695","0","62.73","17.41"
"10","015","00","006","0607","0000","819","263","556","60","879","1627","0","54.03","16.16"
"10","015","00","006","0607","0181","387","137","250","23","410","746","0","54.96","18.36"
"10","015","00","006","0607","0182","432","126","306","37","469","881","0","53.23","14.3"
"10","015","00","006","0608","0000","451","120","331","70","521","816","0","63.85","14.71"
"10","015","00","006","0608","0184","451","120","331","70","521","816","0","63.85","14.71"
"10","015","00","006","0609","0000","353","100","253","42","395","773","0","51.1","12.94"
"10","015","00","006","0609","0185","353","100","253","42","395","773","0","51.1","12.94"
"10","015","00","006","0610","0000","779","225","554","68","847","1436","0","58.98","15.67"
"10","015","00","006","0610","0186","543","171","372","46","589","1029","0","57.24","16.62"
"10","015","00","006","0610","0187","236","54","182","22","258","407","0","63.39","13.27"
"10","015","00","006","0611","0000","1316","445","871","95","1411","2549","0","55.36","17.46"
"10","015","00","006","0611","0188","602","173","429","48","650","1139","0","57.07","15.19"
"10","015","00","006","0611","0189","540","215","325","33","573","996","0","57.53","21.59"
"10","015","00","006","0611","0190","174","57","117","14","188","414","0","45.41","13.77"
"10","015","00","006","0612","0000","146","39","107","11","157","270","0","58.15","14.44"
"10","015","00","006","0612","0191","146","39","107","11","157","270","0","58.15","14.44"
"10","015","00","006","0613","0000","436","98","338","53","489","836","0","58.49","11.72"
"10","015","00","006","0613","0192","436","98","338","53","489","836","0","58.49","11.72"
"10","015","00","006","0614","0000","271","73","198","45","316","739","0","42.76","9.88"
"10","015","00","006","0614","0194","271","73","198","45","316","739","0","42.76","9.88"
"10","015","00","006","0615","0000","281","79","202","28","309","507","0","60.95","15.58"
"10","015","00","006","0615","0193","281","79","202","28","309","507","0","60.95","15.58"
"10","015","00","007","0000","0000","5216","1345","3871","674","5890","11417","12847","51.59","11.78"
"10","015","00","007","0701","0000","468","119","349","32","500","859","0","58.21","13.85"
"10","015","00","007","0701","0211","468","119","349","32","500","859","0","58.21","13.85"
"10","015","00","007","0702","0000","657","178","479","74","731","1295","0","56.45","13.75"
"10","015","00","007","0702","0210","657","178","479","74","731","1295","0","56.45","13.75"
"10","015","00","007","0703","0000","465","120","345","106","571","958","0","59.6","12.53"
"10","015","00","007","0703","0212","465","120","345","106","571","958","0","59.6","12.53"
"10","015","00","007","0704","0000","511","108","403","88","599","1011","0","59.25","10.68"
"10","015","00","007","0704","0213","511","108","403","88","599","1011","0","59.25","10.68"
"10","015","00","007","0705","0000","538","142","396","64","602","1041","0","57.83","13.64"
"10","015","00","007","0705","0214","538","142","396","64","602","1041","0","57.83","13.64"
"10","015","00","007","0706","0000","247","62","185","22","269","471","0","57.11","13.16"
"10","015","00","007","0706","0221","247","62","185","22","269","471","0","57.11","13.16"
"10","015","00","007","0707","0000","358","102","256","42","400","756","0","52.91","13.49"
"10","015","00","007","0707","0222","320","96","224","35","355","640","0","55.47","15.0"
"10","015","00","007","0707","0223","38","6","32","7","45","116","0","38.79","5.17"
"10","015","00","007","0708","0000","157","42","115","5","162","496","0","32.66","8.47"
"10","015","00","007","0708","0224","157","42","115","5","162","496","0","32.66","8.47"
"10","015","00","007","0709","0000","133","43","90","13","146","324","0","45.06","13.27"
"10","015","00","007","0709","0225","133","43","90","13","146","324","0","45.06","13.27"
"10","015","00","007","0710","0000","157","36","121","24","181","454","0","39.87","7.93"
"10","015","00","007","0710","0226","157","36","121","24","181","454","0","39.87","7.93"
"10","015","00","007","0711","0000","413","108","305","83","496","1009","0","49.16","10.7"
"10","015","00","007","0711","0215","372","98","274","79","451","821","0","54.93","11.94"
"10","015","00","007","0711","0216","41","10","31","4","45","188","0","23.94","5.32"
"10","015","00","007","0712","0000","408","93","315","45","453","960","0","47.19","9.69"
"10","015","00","007","0712","0217","246","59","187","35","281","514","0","54.67","11.48"
"10","015","00","007","0712","0218","162","34","128","10","172","446","0","38.57","7.62"
"10","015","00","007","0713","0000","376","86","290","56","432","851","0","50.76","10.11"
"10","015","00","007","0713","0219","376","86","290","56","432","851","0","50.76","10.11"
"10","015","00","007","0714","0000","328","106","222","20","348","932","0","37.34","11.37"
"10","015","00","007","0714","0220","328","106","222","20","348","932","0","37.34","11.37"
"10","015","00","008","0000","0000","1727","520","1207","271","1998","4395","4811","45.46","11.83"
"10","015","00","008","0801","0000","726","212","514","67","793","1779","0","44.58","11.92"
"10","015","00","008","0801","0229","250","81","169","42","292","613","0","47.63","13.21"
"10","015","00","008","0801","0230","390","107","283","20","410","809","0","50.68","13.23"
"10","015","00","008","0801","0231","86","24","62","5","91","357","0","25.49","6.72"
"10","015","00","008","0802","0000","275","85","190","66","341","669","0","50.97","12.71"
"10","015","00","008","0802","0232","275","85","190","66","341","669","0","50.97","12.71"
"10","015","00","008","0803","0000","201","64","137","11","212","479","0","44.26","13.36"
"10","015","00","008","0803","0233","201","64","137","11","212","479","0","44.26","13.36"
"10","015","00","008","0804","0000","258","92","166","52","310","751","0","41.28","12.25"
"10","015","00","008","0804","0228","258","92","166","52","310","751","0","41.28","12.25"
"10","015","00","008","0805","0000","267","67","200","75","342","717","0","47.7","9.34"
"10","015","00","008","0805","0227","267","67","200","75","342","717","0","47.7","9.34"
"10","015","00","009","0000","0000","4586","1135","3451","509","5095","10279","11716","49.57","11.04"
"10","015","00","009","0901","0000","1010","244","766","76","1086","1904","0","57.04","12.82"
"10","015","00","009","0901","0241","447","112","335","27","474","813","0","58.3","13.78"
"10","015","00","009","0901","0242","563","132","431","49","612","1091","0","56.1","12.1"
"10","015","00","009","0902","0000","930","226","704","104","1034","1814","0","57.0","12.46"
"10","015","00","009","0902","0243","434","113","321","43","477","839","0","56.85","13.47"
"10","015","00","009","0902","0244","496","113","383","61","557","975","0","57.13","11.59"
"10","015","00","009","0903","0000","236","56","180","24","260","546","0","47.62","10.26"
"10","015","00","009","0903","0245","236","56","180","24","260","546","0","47.62","10.26"
"10","015","00","009","0904","0000","499","136","363","71","570","1002","0","56.89","13.57"
"10","015","00","009","0904","0246","499","136","363","71","570","1002","0","56.89","13.57"
"10","015","00","009","0905","0000","257","70","187","23","280","593","0","47.22","11.8"
"10","015","00","009","0905","0247","257","70","187","23","280","593","0","47.22","11.8"
"10","015","00","009","0906","0000","473","137","336","83","556","965","0","57.62","14.2"
"10","015","00","009","0906","0248","473","137","336","83","556","965","0","57.62","14.2"
"10","015","00","009","0907","0000","414","98","316","63","477","863","0","55.27","11.36"
"10","015","00","009","0907","0249","414","98","316","63","477","863","0","55.27","11.36"
"10","015","00","009","0908","0000","76","15","61","7","83","340","0","24.41","4.41"
"10","015","00","009","0908","0250","76","15","61","7","83","340","0","24.41","4.41"
"10","015","00","009","0909","0000","320","78","242","34","354","764","0","46.34","10.21"
"10","015","00","009","0909","0251","320","78","242","34","354","764","0","46.34","10.21"
"10","015","00","009","0910","0000","190","39","151","10","200","868","0","23.04","4.49"
"10","015","00","009","0910","0252","190","39","151","10","200","868","0","23.04","4.49"
"10","015","00","009","0911","0000","181","36","145","14","195","620","0","31.45","5.81"
"10","015","00","009","0911","0253","181","36","145","14","195","620","0","31.45","5.81"
"10","015","00","010","0000","0000","3727","1034","2693","424","4151","9065","10331","45.79","11.41"
"10","015","00","010","1001","0000","180","40","140","18","198","467","0","42.4","8.57"
"10","015","00","010","1001","0277","180","40","140","18","198","467","0","42.4","8.57"
"10","015","00","010","1002","0000","363","111","252","49","412","1032","0","39.92","10.76"
"10","015","00","010","1002","0278","363","111","252","49","412","1032","0","39.92","10.76"
"10","015","00","010","1003","0000","250","48","202","28","278","638","0","43.57","7.52"
"10","015","00","010","1003","0279","250","48","202","28","278","638","0","43.57","7.52"
"10","015","00","010","1004","0000","254","68","186","66","320","591","0","54.15","11.51"
"10","015","00","010","1004","0280","254","68","186","66","320","591","0","54.15","11.51"
"10","015","00","010","1005","0000","541","134","407","53","594","1087","0","54.65","12.33"
"10","015","00","010","1005","0281","541","134","407","53","594","1087","0","54.65","12.33"
"10","015","00","010","1006","0000","206","69","137","18","224","431","0","51.97","16.01"
"10","015","00","010","1006","0282","206","69","137","18","224","431","0","51.97","16.01"
"10","015","00","010","1007","0000","403","128","275","33","436","893","0","48.82","14.33"
"10","015","00","010","1007","0283","403","128","275","33","436","893","0","48.82","14.33"
"10","015","00","010","1008","0000","133","36","97","16","149","361","0","41.27","9.97"
"10","015","00","010","1008","0284","133","36","97","16","149","361","0","41.27","9.97"
"10","015","00","010","1009","0000","508","150","358","39","547","1362","0","40.16","11.01"
"10","015","00","010","1009","0285","508","150","358","39","547","1362","0","40.16","11.01"
"10","015","00","010","1010","0000","216","59","157","23","239","458","0","52.18","12.88"
"10","015","00","010","1010","0286","216","59","157","23","239","458","0","52.18","12.88"
"10","015","00","010","1011","0000","178","46","132","29","207","621","0","33.33","7.41"
"10","015","00","010","1011","0287","178","46","132","29","207","621","0","33.33","7.41"
"10","015","00","010","1012","0000","224","68","156","20","244","493","0","49.49","13.79"
"10","015","00","010","1012","0288","224","68","156","20","244","493","0","49.49","13.79"
"10","015","00","010","1013","0000","271","77","194","32","303","631","0","48.02","12.2"
"10","015","00","010","1013","0289","271","77","194","32","303","631","0","48.02","12.2"
"10","015","00","011","0000","0000","6020","1694","4326","415","6435","12562","15937","51.23","13.49"
"10","015","00","011","1101","0000","545","127","418","31","576","1373","0","41.95","9.25"
"10","015","00","011","1101","0103","545","127","418","31","576","1373","0","41.95","9.25"
"10","015","00","011","1102","0000","812","196","616","69","881","1806","0","48.78","10.85"
"10","015","00","011","1102","0104","726","177","549","65","791","1644","0","48.11","10.77"
"10","015","00","011","1102","0105","86","19","67","4","90","162","0","55.56","11.73"
"10","015","00","011","1103","0000","790","236","554","56","846","1766","0","47.9","13.36"
"10","015","00","011","1103","0106","177","50","127","17","194","384","0","50.52","13.02"
"10","015","00","011","1103","0107","613","186","427","39","652","1382","0","47.18","13.46"
"10","015","00","011","1104","0000","619","182","437","82","701","1139","0","61.55","15.98"
"10","015","00","011","1104","0111","619","182","437","82","701","1139","0","61.55","15.98"
"10","015","00","011","1105","0000","645","186","459","13","658","1213","0","54.25","15.33"
"10","015","00","011","1105","0112","645","186","459","13","658","1213","0","54.25","15.33"
"10","015","00","011","1106","0000","537","153","384","29","566","1084","0","52.21","14.11"
"10","015","00","011","1106","0113","386","113","273","21","407","754","0","53.98","14.99"
"10","015","00","011","1106","0114","151","40","111","8","159","330","0","48.18","12.12"
"10","015","00","011","1107","0000","807","272","535","50","857","1752","0","48.92","15.53"
"10","015","00","011","1107","0108","515","166","349","37","552","1125","0","49.07","14.76"
"10","015","00","011","1107","0109","292","106","186","13","305","627","0","48.64","16.91"
"10","015","00","011","1108","0000","563","154","409","38","601","987","0","60.89","15.6"
"10","015","00","011","1108","0110","563","154","409","38","601","987","0","60.89","15.6"
"10","015","00","011","1109","0000","702","188","514","47","749","1442","0","51.94","13.04"
"10","015","00","011","1109","0101","427","100","327","23","450","867","0","51.9","11.53"
"10","015","00","011","1109","0102","275","88","187","24","299","575","0","52.0","15.3"
"10","015","00","012","0000","0000","2654","668","1986","279","2933","5269","6439","55.67","12.68"
"10","015","00","012","1201","0000","531","152","379","67","598","1072","0","55.78","14.18"
"10","015","00","012","1201","0234","531","152","379","67","598","1072","0","55.78","14.18"
"10","015","00","012","1202","0000","254","75","179","6","260","560","0","46.43","13.39"
"10","015","00","012","1202","0235","254","75","179","6","260","560","0","46.43","13.39"
"10","015","00","012","1203","0000","445","119","326","28","473","773","0","61.19","15.39"
"10","015","00","012","1203","0236","445","119","326","28","473","773","0","61.19","15.39"
"10","015","00","012","1204","0000","256","68","188","15","271","661","0","41.0","10.29"
"10","015","00","012","1204","0237","256","68","188","15","271","661","0","41.0","10.29"
"10","015","00","012","1205","0000","526","88","438","62","588","1117","0","52.64","7.88"
"10","015","00","012","1205","0238","228","35","193","11","239","442","0","54.07","7.92"
"10","015","00","012","1205","0239","298","53","245","51","349","675","0","51.7","7.85"
"10","015","00","012","1206","0000","642","166","476","101","743","1086","0","68.42","15.29"
"10","015","00","012","1206","0240","642","166","476","101","743","1086","0","68.42","15.29"
"10","015","00","013","0000","0000","2587","585","2002","258","2845","4947","6104","57.51","11.83"
"10","015","00","013","1301","0000","280","66","214","23","303","533","0","56.85","12.38"
"10","015","00","013","1301","0290","280","66","214","23","303","533","0","56.85","12.38"
"10","015","00","013","1302","0000","556","161","395","54","610","1015","0","60.1","15.86"
"10","015","00","013","1302","0291","291","78","213","41","332","522","0","63.6","14.94"
"10","015","00","013","1302","0292","265","83","182","13","278","493","0","56.39","16.84"
"10","015","00","013","1303","0000","395","68","327","46","441","701","0","62.91","9.7"
"10","015","00","013","1303","0293","395","68","327","46","441","701","0","62.91","9.7"
"10","015","00","013","1304","0000","403","82","321","40","443","746","0","59.38","10.99"
"10","015","00","013","1304","0294","403","82","321","40","443","746","0","59.38","10.99"
"10","015","00","013","1305","0000","482","106","376","59","541","1021","0","52.99","10.38"
"10","015","00","013","1305","0295","341","68","273","49","390","616","0","63.31","11.04"
"10","015","00","013","1305","0296","141","38","103","10","151","405","0","37.28","9.38"
"10","015","00","013","1306","0000","471","102","369","36","507","931","0","54.46","10.96"
"10","015","00","013","1306","0297","166","41","125","13","179","329","0","54.41","12.46"
"10","015","00","013","1306","0298","216","42","174","14","230","428","0","53.74","9.81"
"10","015","00","013","1306","0299","89","19","70","9","98","174","0","56.32","10.92"
"10","014","00","000","0000","0000","87713","24813","62900","8135","95848","185996","219268","51.53","13.34"
"10","014","00","001","0000","0000","44873","12992","31881","3100","47973","87803","105587","54.64","14.8"
"10","014","00","001","0101","0000","662","145","517","112","774","1505","0","51.43","9.63"
"10","014","00","001","0101","0052","662","145","517","112","774","1505","0","51.43","9.63"
"10","014","00","001","0102","0000","349","104","245","55","404","836","0","48.33","12.44"
"10","014","00","001","0102","0053","349","104","245","55","404","836","0","48.33","12.44"
"10","014","00","001","0103","0000","1110","304","806","86","1196","2162","0","55.32","14.06"
"10","014","00","001","0103","0056","1110","304","806","86","1196","2162","0","55.32","14.06"
"10","014","00","001","0104","0000","1378","396","982","87","1465","2688","0","54.5","14.73"
"10","014","00","001","0104","0059","686","183","503","40","726","1359","0","53.42","13.47"
"10","014","00","001","0104","0060","692","213","479","47","739","1329","0","55.61","16.03"
"10","014","00","001","0105","0000","1550","486","1064","75","1625","2767","0","58.73","17.56"
"10","014","00","001","0105","0057","922","313","609","41","963","1627","0","59.19","19.24"
"10","014","00","001","0105","0058","628","173","455","34","662","1140","0","58.07","15.18"
"10","014","00","001","0106","0000","1328","375","953","129","1457","2644","0","55.11","14.18"
"10","014","00","001","0106","0054","692","194","498","44","736","1294","0","56.88","14.99"
"10","014","00","001","0106","0055","636","181","455","85","721","1350","0","53.41","13.41"
"10","014","00","001","0107","0000","3594","1000","2594","192","3786","6543","0","57.86","15.28"
"10","014","00","001","0107","0026","906","255","651","48","954","1638","0","58.24","15.57"
"10","014","00","001","0107","0027","827","229","598","45","872","1576","0","55.33","14.53"
"10","014","00","001","0107","0028","935","246","689","59","994","1595","0","62.32","15.42"
"10","014","00","001","0107","0029","926","270","656","40","966","1734","0","55.71","15.57"
"10","014","00","001","0108","0000","1756","465","1291","78","1834","3141","0","58.39","14.8"
"10","014","00","001","0108","0006","867","232","635","38","905","1651","0","54.82","14.05"
"10","014","00","001","0108","0007","889","233","656","40","929","1490","0","62.35","15.64"
"10","014","00","001","0109","0000","428","128","300","31","459","859","0","53.43","14.9"
"10","014","00","001","0109","0008","428","128","300","31","459","859","0","53.43","14.9"
"10","014","00","001","0110","0000","1511","352","1159","79","1590","2651","0","59.98","13.28"
"10","014","00","001","0110","0032","724","162","562","41","765","1313","0","58.26","12.34"
"10","014","00","001","0110","0033","787","190","597","38","825","1338","0","61.66","14.2"
"10","014","00","001","0111","0000","1698","521","1177","85","1783","3021","0","59.02","17.25"
"10","014","00","001","0111","0030","801","238","563","51","852","1476","0","57.72","16.12"
"10","014","00","001","0111","0031","897","283","614","34","931","1545","0","60.26","18.32"
"10","014","00","001","0112","0000","2213","688","1525","112","2325","4021","0","57.82","17.11"
"10","014","00","001","0112","0003","664","192","472","40","704","1259","0","55.92","15.25"
"10","014","00","001","0112","0004","741","232","509","38","779","1399","0","55.68","16.58"
"10","014","00","001","0112","0005","808","264","544","34","842","1363","0","61.78","19.37"
"10","014","00","001","0113","0000","839","256","583","57","896","1469","0","60.99","17.43"
"10","014","00","001","0113","0002","839","256","583","57","896","1469","0","60.99","17.43"
"10","014","00","001","0114","0000","338","89","249","38","376","651","0","57.76","13.67"
"10","014","00","001","0114","0010","338","89","249","38","376","651","0","57.76","13.67"
"10","014","00","001","0115","0000","751","337","414","63","814","1650","0","49.33","20.42"
"10","014","00","001","0115","0011","751","337","414","63","814","1650","0","49.33","20.42"
"10","014","00","001","0116","0000","351","116","235","32","383","632","0","60.6","18.35"
"10","014","00","001","0116","0013","351","116","235","32","383","632","0","60.6","18.35"
"10","014","00","001","0117","0000","640","173","467","80","720","1299","0","55.43","13.32"
"10","014","00","001","0117","0016","640","173","467","80","720","1299","0","55.43","13.32"
"10","014","00","001","0118","0000","507","170","337","37","544","890","0","61.12","19.1"
"10","014","00","001","0118","0009","507","170","337","37","544","890","0","61.12","19.1"
"10","014","00","001","0119","0000","423","131","292","28","451","724","0","62.29","18.09"
"10","014","00","001","0119","0012","423","131","292","28","451","724","0","62.29","18.09"
"10","014","00","001","0120","0000","453","134","319","32","485","811","0","59.8","16.52"
"10","014","00","001","0120","0017","453","134","319","32","485","811","0","59.8","16.52"
"10","014","00","001","0121","0000","425","122","303","37","462","771","0","59.92","15.82"
"10","014","00","001","0121","0014","425","122","303","37","462","771","0","59.92","15.82"
"10","014","00","001","0122","0000","386","128","258","24","410","798","0","51.38","16.04"
"10","014","00","001","0122","0015","386","128","258","24","410","798","0","51.38","16.04"
"10","014","00","001","0123","0000","417","119","298","17","434","874","0","49.66","13.62"
"10","014","00","001","0123","0001","417","119","298","17","434","874","0","49.66","13.62"
"10","014","00","001","0124","0000","459","140","319","32","491","764","0","64.27","18.32"
"10","014","00","001","0124","0018","459","140","319","32","491","764","0","64.27","18.32"
"10","014","00","001","0125","0000","288","83","205","14","302","601","0","50.25","13.81"
"10","014","00","001","0125","0023","288","83","205","14","302","601","0","50.25","13.81"
"10","014","00","001","0126","0000","391","144","247","19","410","784","0","52.3","18.37"
"10","014","00","001","0126","0019","391","144","247","19","410","784","0","52.3","18.37"
"10","014","00","001","0127","0000","204","71","133","9","213","417","0","51.08","17.03"
"10","014","00","001","0127","0024","204","71","133","9","213","417","0","51.08","17.03"
"10","014","00","001","0128","0000","207","64","143","11","218","427","0","51.05","14.99"
"10","014","00","001","0128","0020","207","64","143","11","218","427","0","51.05","14.99"
"10","014","00","001","0129","0000","769","207","562","81","850","1597","0","53.22","12.96"
"10","014","00","001","0129","0063","769","207","562","81","850","1597","0","53.22","12.96"
"10","014","00","001","0130","0000","1027","252","775","79","1106","2028","0","54.54","12.43"
"10","014","00","001","0130","0061","485","117","368","30","515","990","0","52.02","11.82"
"10","014","00","001","0130","0062","542","135","407","49","591","1038","0","56.94","13.01"
"10","014","00","001","0131","0000","1320","387","933","117","1437","2959","0","48.56","13.08"
"10","014","00","001","0131","0036","611","198","413","68","679","1407","0","48.26","14.07"
"10","014","00","001","0131","0037","709","189","520","49","758","1552","0","48.84","12.18"
"10","014","00","001","0132","0000","1396","412","984","72","1468","2577","0","56.97","15.99"
"10","014","00","001","0132","0034","698","192","506","32","730","1312","0","55.64","14.63"
"10","014","00","001","0132","0035","698","220","478","40","738","1265","0","58.34","17.39"
"10","014","00","001","0133","0000","729","194","535","82","811","1445","0","56.12","13.43"
"10","014","00","001","0133","0038","729","194","535","82","811","1445","0","56.12","13.43"
"10","014","00","001","0134","0000","1128","352","776","68","1196","2098","0","57.01","16.78"
"10","014","00","001","0134","0039","1128","352","776","68","1196","2098","0","57.01","16.78"
"10","014","00","001","0135","0000","711","186","525","80","791","1324","0","59.74","14.05"
"10","014","00","001","0135","0040","711","186","525","80","791","1324","0","59.74","14.05"
"10","014","00","001","0136","0000","1500","467","1033","37","1537","2793","0","55.03","16.72"
"10","014","00","001","0136","0021","646","210","436","27","673","1292","0","52.09","16.25"
"10","014","00","001","0136","0022","854","257","597","10","864","1501","0","57.56","17.12"
"10","014","00","001","0137","0000","529","142","387","37","566","1001","0","56.54","14.19"
"10","014","00","001","0137","0025","529","142","387","37","566","1001","0","56.54","14.19"
"10","014","00","001","0138","0000","4046","1122","2924","201","4247","8002","0","53.07","14.02"
"10","014","00","001","0138","0041","841","197","644","31","872","1598","0","54.57","12.33"
"10","014","00","001","0138","0042","774","207","567","33","807","1513","0","53.34","13.68"
"10","014","00","001","0138","0043","820","235","585","37","857","1679","0","51.04","14.0"
"10","014","00","001","0138","0044","697","218","479","49","746","1414","0","52.76","15.42"
"10","014","00","001","0138","0045","914","265","649","51","965","1798","0","53.67","14.74"
"10","014","00","001","0139","0000","2434","671","1763","188","2622","5087","0","51.54","13.19"
"10","014","00","001","0139","0046","762","229","533","57","819","1749","0","46.83","13.09"
"10","014","00","001","0139","0047","860","226","634","81","941","1709","0","55.06","13.22"
"10","014","00","001","0139","0048","812","216","596","50","862","1629","0","52.92","13.26"
"10","014","00","001","0140","0000","1061","272","789","104","1165","2375","0","49.05","11.45"
"10","014","00","001","0140","0049","533","149","384","63","596","1116","0","53.41","13.35"
"10","014","00","001","0140","0050","528","123","405","41","569","1259","0","45.19","9.77"
"10","014","00","001","0141","0000","530","161","369","48","578","1232","0","46.92","13.07"
"10","014","00","001","0141","0051","530","161","369","48","578","1232","0","46.92","13.07"
"10","014","00","001","0142","0000","653","222","431","89","742","1385","0","53.57","16.03"
"10","014","00","001","0142","0064","653","222","431","89","742","1385","0","53.57","16.03"
"10","014","00","001","0143","0000","413","143","270","18","431","939","0","45.9","15.23"
"10","014","00","001","0143","0065","413","143","270","18","431","939","0","45.9","15.23"
"10","014","00","001","0144","0000","510","146","364","55","565","1258","0","44.91","11.61"
"10","014","00","001","0144","0066","510","146","364","55","565","1258","0","44.91","11.61"
"10","014","00","001","0145","0000","648","221","427","8","656","1350","0","48.59","16.37"
"10","014","00","001","0145","0067","648","221","427","8","656","1350","0","48.59","16.37"
"10","014","00","001","0146","0000","813","194","619","85","898","1953","0","45.98","9.93"
"10","014","00","001","0146","0068","448","112","336","49","497","1058","0","46.98","10.59"
"10","014","00","001","0146","0069","365","82","283","36","401","895","0","44.8","9.16"
"10","014","00","002","0000","0000","5327","1217","4110","818","6145","12426","14105","49.45","9.79"
"10","014","00","002","0201","0000","201","41","160","29","230","637","0","36.11","6.44"
"10","014","00","002","0201","0085","85","12","73","2","87","373","0","23.32","3.22"
"10","014","00","002","0201","0086","116","29","87","27","143","264","0","54.17","10.98"
"10","014","00","002","0202","0000","341","81","260","73","414","969","0","42.72","8.36"
"10","014","00","002","0202","0083","178","38","140","41","219","488","0","44.88","7.79"
"10","014","00","002","0202","0084","163","43","120","32","195","481","0","40.54","8.94"
"10","014","00","002","0203","0000","535","128","407","136","671","1403","0","47.83","9.12"
"10","014","00","002","0203","0081","212","40","172","49","261","516","0","50.58","7.75"
"10","014","00","002","0203","0082","323","88","235","87","410","887","0","46.22","9.92"
"10","014","00","002","0204","0000","1258","256","1002","166","1424","2731","0","52.14","9.37"
"10","014","00","002","0204","0079","608","127","481","90","698","1365","0","51.14","9.3"
"10","014","00","002","0204","0080","650","129","521","76","726","1366","0","53.15","9.44"
"10","014","00","002","0205","0000","939","215","724","66","1005","1901","0","52.87","11.31"
"10","014","00","002","0205","0077","476","108","368","34","510","931","0","54.78","11.6"
"10","014","00","002","0205","0078","463","107","356","32","495","970","0","51.03","11.03"
"10","014","00","002","0206","0000","1009","252","757","109","1118","2197","0","50.89","11.47"
"10","014","00","002","0206","0074","136","27","109","24","160","339","0","47.2","7.96"
"10","014","00","002","0206","0075","452","119","333","24","476","995","0","47.84","11.96"
"10","014","00","002","0206","0076","421","106","315","61","482","863","0","55.85","12.28"
"10","014","00","002","0207","0000","272","61","211","73","345","747","0","46.18","8.17"
"10","014","00","002","0207","0073","272","61","211","73","345","747","0","46.18","8.17"
"10","014","00","002","0208","0000","772","183","589","166","938","1841","0","50.95","9.94"
"10","014","00","002","0208","0070","206","47","159","53","259","516","0","50.19","9.11"
"10","014","00","002","0208","0071","450","115","335","95","545","960","0","56.77","11.98"
"10","014","00","002","0208","0072","116","21","95","18","134","365","0","36.71","5.75"
"10","014","00","003","0000","0000","3474","1032","2442","270","3744","7509","8727","49.86","13.74"
"10","014","00","003","0301","0000","718","216","502","66","784","1691","0","46.36","12.77"
"10","014","00","003","0301","0093","423","123","300","48","471","912","0","51.64","13.49"
"10","014","00","003","0301","0094","295","93","202","18","313","779","0","40.18","11.94"
"10","014","00","003","0302","0000","589","170","419","37","626","1137","0","55.06","14.95"
"10","014","00","003","0302","0091","589","170","419","37","626","1137","0","55.06","14.95"
"10","014","00","003","0303","0000","368","108","260","24","392","887","0","44.19","12.18"
"10","014","00","003","0303","0090","368","108","260","24","392","887","0","44.19","12.18"
"10","014","00","003","0304","0000","466","137","329","35","501","828","0","60.51","16.55"
"10","014","00","003","0304","0089","466","137","329","35","501","828","0","60.51","16.55"
"10","014","00","003","0305","0000","830","252","578","51","881","1699","0","51.85","14.83"
"10","014","00","003","0305","0087","513","147","366","27","540","909","0","59.41","16.17"
"10","014","00","003","0305","0088","317","105","212","24","341","790","0","43.16","13.29"
"10","014","00","003","0306","0000","181","68","113","23","204","535","0","38.13","12.71"
"10","014","00","003","0306","0095","181","68","113","23","204","535","0","38.13","12.71"
"10","014","00","003","0307","0000","322","81","241","34","356","732","0","48.63","11.07"
"10","014","00","003","0307","0092","322","81","241","34","356","732","0","48.63","11.07"
"10","014","00","004","0000","0000","7064","2112","4952","803","7867","14976","17314","52.53","14.1"
"10","014","00","004","0401","0000","187","56","131","27","214","476","0","44.96","11.76"
"10","014","00","004","0401","0105","82","29","53","14","96","261","0","36.78","11.11"
"10","014","00","004","0401","0106","105","27","78","13","118","215","0","54.88","12.56"
"10","014","00","004","0402","0000","212","54","158","24","236","436","0","54.13","12.39"
"10","014","00","004","0402","0117","212","54","158","24","236","436","0","54.13","12.39"
"10","014","00","004","0403","0000","198","50","148","20","218","488","0","44.67","10.25"
"10","014","00","004","0403","0115","198","50","148","20","218","488","0","44.67","10.25"
"10","014","00","004","0404","0000","182","55","127","20","202","347","0","58.21","15.85"
"10","014","00","004","0404","0116","182","55","127","20","202","347","0","58.21","15.85"
"10","014","00","004","0405","0000","493","147","346","87","580","1163","0","49.87","12.64"
"10","014","00","004","0405","0103","300","97","203","51","351","727","0","48.28","13.34"
"10","014","00","004","0405","0104","193","50","143","36","229","436","0","52.52","11.47"
"10","014","00","004","0406","0000","567","166","401","48","615","1270","0","48.43","13.07"
"10","014","00","004","0406","0101","328","104","224","15","343","767","0","44.72","13.56"
"10","014","00","004","0406","0102","239","62","177","33","272","503","0","54.08","12.33"
"10","014","00","004","0407","0000","398","134","264","76","474","1066","0","44.47","12.57"
"10","014","00","004","0407","0098","75","30","45","22","97","219","0","44.29","13.7"
"10","014","00","004","0407","0099","186","65","121","36","222","460","0","48.26","14.13"
"10","014","00","004","0407","0100","137","39","98","18","155","387","0","40.05","10.08"
"10","014","00","004","0408","0000","1098","329","769","80","1178","2206","0","53.4","14.91"
"10","014","00","004","0408","0096","541","159","382","58","599","1041","0","57.54","15.27"
"10","014","00","004","0408","0097","557","170","387","22","579","1165","0","49.7","14.59"
"10","014","00","004","0409","0000","536","174","362","69","605","1110","0","54.5","15.68"
"10","014","00","004","0409","0110","536","174","362","69","605","1110","0","54.5","15.68"
"10","014","00","004","0410","0000","1531","440","1091","125","1656","3015","0","54.93","14.59"
"10","014","00","004","0410","0107","750","224","526","61","811","1442","0","56.24","15.53"
"10","014","00","004","0410","0108","250","70","180","13","263","527","0","49.91","13.28"
"10","014","00","004","0410","0109","531","146","385","51","582","1046","0","55.64","13.96"
"10","014","00","004","0411","0000","575","180","395","54","629","1105","0","56.92","16.29"
"10","014","00","004","0411","0111","575","180","395","54","629","1105","0","56.92","16.29"
"10","014","00","004","0412","0000","605","166","439","122","727","1167","0","62.3","14.22"
"10","014","00","004","0412","0112","605","166","439","122","727","1167","0","62.3","14.22"
"10","014","00","004","0413","0000","482","161","321","51","533","1127","0","47.29","14.29"
"10","014","00","004","0413","0113","422","136","286","48","470","968","0","48.55","14.05"
"10","014","00","004","0413","0114","60","25","35","3","63","159","0","39.62","15.72"
"10","014","00","005","0000","0000","2861","896","1965","259","3120","6936","7891","44.98","12.92"
"10","014","00","005","0501","0000","246","81","165","42","288","675","0","42.67","12.0"
"10","014","00","005","0501","0125","246","81","165","42","288","675","0","42.67","12.0"
"10","014","00","005","0502","0000","365","129","236","35","400","905","0","44.2","14.25"
"10","014","00","005","0502","0126","198","65","133","17","215","435","0","49.43","14.94"
"10","014","00","005","0502","0127","167","64","103","18","185","470","0","39.36","13.62"
"10","014","00","005","0503","0000","384","119","265","39","423","864","0","48.96","13.77"
"10","014","00","005","0503","0124","384","119","265","39","423","864","0","48.96","13.77"
"10","014","00","005","0504","0000","621","186","435","47","668","1446","0","46.2","12.86"
"10","014","00","005","0504","0121","475","155","320","38","513","1104","0","46.47","14.04"
"10","014","00","005","0504","0122","146","31","115","9","155","342","0","45.32","9.06"
"10","014","00","005","0505","0000","386","99","287","39","425","895","0","47.49","11.06"
"10","014","00","005","0505","0123","386","99","287","39","425","895","0","47.49","11.06"
"10","014","00","005","0506","0000","473","135","338","29","502","1096","0","45.8","12.32"
"10","014","00","005","0506","0118","188","52","136","8","196","522","0","37.55","9.96"
"10","014","00","005","0506","0119","285","83","202","21","306","574","0","53.31","14.46"
"10","014","00","005","0507","0000","386","147","239","28","414","1055","0","39.24","13.93"
"10","014","00","005","0507","0120","386","147","239","28","414","1055","0","39.24","13.93"
"10","014","00","006","0000","0000","2969","894","2075","336","3305","7162","8207","46.15","12.48"
"10","014","00","006","0601","0000","460","143","317","59","519","1137","0","45.65","12.58"
"10","014","00","006","0601","0130","184","57","127","27","211","434","0","48.62","13.13"
"10","014","00","006","0601","0131","276","86","190","32","308","703","0","43.81","12.23"
"10","014","00","006","0602","0000","262","72","190","24","286","654","0","43.73","11.01"
"10","014","00","006","0602","0132","262","72","190","24","286","654","0","43.73","11.01"
"10","014","00","006","0603","0000","108","33","75","21","129","324","0","39.81","10.19"
"10","014","00","006","0603","0133","108","33","75","21","129","324","0","39.81","10.19"
"10","014","00","006","0604","0000","319","95","224","40","359","794","0","45.21","11.96"
"10","014","00","006","0604","0134","319","95","224","40","359","794","0","45.21","11.96"
"10","014","00","006","0605","0000","928","293","635","64","992","1921","0","51.64","15.25"
"10","014","00","006","0605","0128","450","143","307","30","480","992","0","48.39","14.42"
"10","014","00","006","0605","0129","478","150","328","34","512","929","0","55.11","16.15"
"10","014","00","006","0606","0000","127","34","93","15","142","344","0","41.28","9.88"
"10","014","00","006","0606","0136","127","34","93","15","142","344","0","41.28","9.88"
"10","014","00","006","0607","0000","353","101","252","59","412","856","0","48.13","11.8"
"10","014","00","006","0607","0135","353","101","252","59","412","856","0","48.13","11.8"
"10","014","00","006","0608","0000","156","47","109","21","177","311","0","56.91","15.11"
"10","014","00","006","0608","0137","156","47","109","21","177","311","0","56.91","15.11"
"10","014","00","006","0609","0000","123","36","87","14","137","386","0","35.49","9.33"
"10","014","00","006","0609","0138","123","36","87","14","137","386","0","35.49","9.33"
"10","014","00","006","0610","0000","133","40","93","19","152","435","0","34.94","9.2"
"10","014","00","006","0610","0139","133","40","93","19","152","435","0","34.94","9.2"
"10","014","00","007","0000","0000","2919","831","2088","420","3339","7635","8518","43.73","10.88"
"10","014","00","007","0701","0000","465","113","352","66","531","1620","0","32.78","6.98"
"10","014","00","007","0701","0147","189","34","155","22","211","867","0","24.34","3.92"
"10","014","00","007","0701","0148","129","42","87","19","148","345","0","42.9","12.17"
"10","014","00","007","0701","0149","147","37","110","25","172","408","0","42.16","9.07"
"10","014","00","007","0702","0000","346","77","269","22","368","1197","0","30.74","6.43"
"10","014","00","007","0702","0146","346","77","269","22","368","1197","0","30.74","6.43"
"10","014","00","007","0703","0000","395","108","287","28","423","977","0","43.3","11.05"
"10","014","00","007","0703","0145","395","108","287","28","423","977","0","43.3","11.05"
"10","014","00","007","0704","0000","103","31","72","11","114","262","0","43.51","11.83"
"10","014","00","007","0704","0150","103","31","72","11","114","262","0","43.51","11.83"
"10","014","00","007","0705","0000","225","59","166","34","259","555","0","46.67","10.63"
"10","014","00","007","0705","0144","225","59","166","34","259","555","0","46.67","10.63"
"10","014","00","007","0706","0000","354","113","241","82","436","918","0","47.49","12.31"
"10","014","00","007","0706","0143","354","113","241","82","436","918","0","47.49","12.31"
"10","014","00","007","0707","0000","1031","330","701","177","1208","2106","0","57.36","15.67"
"10","014","00","007","0707","0140","101","36","65","23","124","290","0","42.76","12.41"
"10","014","00","007","0707","0141","309","108","201","41","350","620","0","56.45","17.42"
"10","014","00","007","0707","0142","621","186","435","113","734","1196","0","61.37","15.55"
"10","014","00","008","0000","0000","2310","593","1717","401","2711","6484","7196","41.81","9.15"
"10","014","00","008","0801","0000","243","55","188","38","281","630","0","44.6","8.73"
"10","014","00","008","0801","0160","11","4","7","2","13","25","0","52.0","16.0"
"10","014","00","008","0801","0161","232","51","181","36","268","605","0","44.3","8.43"
"10","014","00","008","0802","0000","368","87","281","82","450","1191","0","37.78","7.3"
"10","014","00","008","0802","0157","216","61","155","63","279","660","0","42.27","9.24"
"10","014","00","008","0802","0158","102","15","87","5","107","336","0","31.85","4.46"
"10","014","00","008","0802","0159","50","11","39","14","64","195","0","32.82","5.64"
"10","014","00","008","0803","0000","134","41","93","13","147","532","0","27.63","7.71"
"10","014","00","008","0803","0156","134","41","93","13","147","532","0","27.63","7.71"
"10","014","00","008","0804","0000","715","175","540","86","801","1993","0","40.19","8.78"
"10","014","00","008","0804","0154","434","109","325","26","460","1268","0","36.28","8.6"
"10","014","00","008","0804","0155","281","66","215","60","341","725","0","47.03","9.1"
"10","014","00","008","0805","0000","388","103","285","103","491","913","0","53.78","11.28"
"10","014","00","008","0805","0153","388","103","285","103","491","913","0","53.78","11.28"
"10","014","00","008","0806","0000","462","132","330","79","541","1225","0","44.16","10.78"
"10","014","00","008","0806","0151","258","83","175","51","309","536","0","57.65","15.49"
"10","014","00","008","0806","0152","204","49","155","28","232","689","0","33.67","7.11"
"10","014","00","009","0000","0000","4295","1147","3148","480","4775","9666","11186","49.4","11.87"
"10","014","00","009","0901","0000","613","159","454","65","678","1297","0","52.27","12.26"
"10","014","00","009","0901","0162","342","95","247","42","384","722","0","53.19","13.16"
"10","014","00","009","0901","0163","271","64","207","23","294","575","0","51.13","11.13"
"10","014","00","009","0902","0000","287","91","196","26","313","623","0","50.24","14.61"
"10","014","00","009","0902","0164","287","91","196","26","313","623","0","50.24","14.61"
"10","014","00","009","0903","0000","269","67","202","35","304","622","0","48.87","10.77"
"10","014","00","009","0903","0165","269","67","202","35","304","622","0","48.87","10.77"
"10","014","00","009","0904","0000","212","58","154","15","227","560","0","40.54","10.36"
"10","014","00","009","0904","0166","212","58","154","15","227","560","0","40.54","10.36"
"10","014","00","009","0905","0000","719","218","501","76","795","1410","0","56.38","15.46"
"10","014","00","009","0905","0169","377","129","248","38","415","673","0","61.66","19.17"
"10","014","00","009","0905","0170","342","89","253","38","380","737","0","51.56","12.08"
"10","014","00","009","0906","0000","801","207","594","125","926","1766","0","52.43","11.72"
"10","014","00","009","0906","0167","458","104","354","82","540","957","0","56.43","10.87"
"10","014","00","009","0906","0168","343","103","240","43","386","809","0","47.71","12.73"
"10","014","00","009","0907","0000","364","107","257","56","420","798","0","52.63","13.41"
"10","014","00","009","0907","0171","215","56","159","26","241","424","0","56.84","13.21"
"10","014","00","009","0907","0172","149","51","98","30","179","374","0","47.86","13.64"
"10","014","00","009","0908","0000","652","143","509","23","675","1698","0","39.75","8.42"
"10","014","00","009","0908","0173","313","80","233","15","328","829","0","39.57","9.65"
"10","014","00","009","0908","0174","339","63","276","8","347","869","0","39.93","7.25"
"10","014","00","009","0909","0000","378","97","281","59","437","892","0","48.99","10.87"
"10","014","00","009","0909","0175","68","16","52","5","73","223","0","32.74","7.17"
"10","014","00","009","0909","0176","310","81","229","54","364","669","0","54.41","12.11"
"10","014","00","010","0000","0000","2306","636","1670","399","2705","5266","6100","51.37","12.08"
"10","014","00","010","1001","0000","312","70","242","80","392","763","0","51.38","9.17"
"10","014","00","010","1001","0181","153","36","117","60","213","386","0","55.18","9.33"
"10","014","00","010","1001","0182","159","34","125","20","179","377","0","47.48","9.02"
"10","014","00","010","1002","0000","456","150","306","76","532","1134","0","46.91","13.23"
"10","014","00","010","1002","0180","456","150","306","76","532","1134","0","46.91","13.23"
"10","014","00","010","1003","0000","621","177","444","87","708","1327","0","53.35","13.34"
"10","014","00","010","1003","0179","621","177","444","87","708","1327","0","53.35","13.34"
"10","014","00","010","1004","0000","615","179","436","115","730","1474","0","49.53","12.14"
"10","014","00","010","1004","0178","615","179","436","115","730","1474","0","49.53","12.14"
"10","014","00","010","1005","0000","302","60","242","41","343","568","0","60.39","10.56"
"10","014","00","010","1005","0177","302","60","242","41","343","568","0","60.39","10.56"
"10","014","00","011","0000","0000","1506","467","1039","73","1579","3579","4097","44.12","13.05"
"10","014","00","011","1101","0000","461","151","310","20","481","1023","0","47.02","14.76"
"10","014","00","011","1101","0185","363","121","242","18","381","813","0","46.86","14.88"
"10","014","00","011","1101","0186","98","30","68","2","100","210","0","47.62","14.29"
"10","014","00","011","1102","0000","446","140","306","27","473","1082","0","43.72","12.94"
"10","014","00","011","1102","0184","446","140","306","27","473","1082","0","43.72","12.94"
"10","014","00","011","1103","0000","599","176","423","26","625","1474","0","42.4","11.94"
"10","014","00","011","1103","0183","599","176","423","26","625","1474","0","42.4","11.94"
"10","014","00","012","0000","0000","1599","373","1226","155","1754","3278","4207","53.51","11.38"
"10","014","00","012","1201","0000","355","67","288","38","393","728","0","53.98","9.2"
"10","014","00","012","1201","0190","355","67","288","38","393","728","0","53.98","9.2"
"10","014","00","012","1202","0000","131","41","90","16","147","259","0","56.76","15.83"
"10","014","00","012","1202","0191","131","41","90","16","147","259","0","56.76","15.83"
"10","014","00","012","1203","0000","127","31","96","13","140","254","0","55.12","12.2"
"10","014","00","012","1203","0192","127","31","96","13","140","254","0","55.12","12.2"
"10","014","00","012","1204","0000","434","124","310","47","481","971","0","49.54","12.77"
"10","014","00","012","1204","0189","434","124","310","47","481","971","0","49.54","12.77"
"10","014","00","012","1205","0000","315","56","259","15","330","569","0","58.0","9.84"
"10","014","00","012","1205","0188","315","56","259","15","330","569","0","58.0","9.84"
"10","014","00","012","1206","0000","237","54","183","26","263","497","0","52.92","10.87"
"10","014","00","012","1206","0187","237","54","183","26","263","497","0","52.92","10.87"
"10","014","00","013","0000","0000","1453","335","1118","146","1599","2930","3656","54.57","11.43"
"10","014","00","013","1301","0000","254","58","196","21","275","579","0","47.5","10.02"
"10","014","00","013","1301","0196","254","58","196","21","275","579","0","47.5","10.02"
"10","014","00","013","1302","0000","187","36","151","22","209","315","0","66.35","11.43"
"10","014","00","013","1302","0195","187","36","151","22","209","315","0","66.35","11.43"
"10","014","00","013","1303","0000","247","52","195","50","297","426","0","69.72","12.21"
"10","014","00","013","1303","0194","247","52","195","50","297","426","0","69.72","12.21"
"10","014","00","013","1304","0000","254","59","195","21","275","596","0","46.14","9.9"
"10","014","00","013","1304","0197","254","59","195","21","275","596","0","46.14","9.9"
"10","014","00","013","1305","0000","511","130","381","32","543","1014","0","53.55","12.82"
"10","014","00","013","1305","0193","511","130","381","32","543","1014","0","53.55","12.82"
"10","014","00","014","0000","0000","1630","454","1176","170","1800","3028","3748","59.45","14.99"
"10","014","00","014","1401","0000","353","109","244","40","393","520","0","75.58","20.96"
"10","014","00","014","1401","0200","353","109","244","40","393","520","0","75.58","20.96"
"10","014","00","014","1402","0000","364","104","260","32","396","601","0","65.89","17.3"
"10","014","00","014","1402","0199","364","104","260","32","396","601","0","65.89","17.3"
"10","014","00","014","1403","0000","554","149","405","45","599","1241","0","48.27","12.01"
"10","014","00","014","1403","0198","554","149","405","45","599","1241","0","48.27","12.01"
"10","014","00","014","1404","0000","167","44","123","22","189","336","0","56.25","13.1"
"10","014","00","014","1404","0201","167","44","123","22","189","336","0","56.25","13.1"
"10","014","00","014","1405","0000","192","48","144","31","223","330","0","67.58","14.55"
"10","014","00","014","1405","0202","192","48","144","31","223","330","0","67.58","14.55"
"10","014","00","015","0000","0000","1643","382","1261","188","1831","3137","3615","58.37","12.18"
"10","014","00","015","1501","0000","265","74","191","19","284","628","0","45.22","11.78"
"10","014","00","015","1501","0208","265","74","191","19","284","628","0","45.22","11.78"
"10","014","00","015","1502","0000","414","120","294","69","483","867","0","55.71","13.84"
"10","014","00","015","1502","0209","414","120","294","69","483","867","0","55.71","13.84"
"10","014","00","015","1503","0000","187","33","154","29","216","331","0","65.26","9.97"
"10","014","00","015","1503","0207","187","33","154","29","216","331","0","65.26","9.97"
"10","014","00","015","1504","0000","338","55","283","34","372","586","0","63.48","9.39"
"10","014","00","015","1504","0203","145","30","115","9","154","246","0","62.6","12.2"
"10","014","00","015","1504","0204","193","25","168","25","218","340","0","64.12","7.35"
"10","014","00","015","1505","0000","261","57","204","20","281","429","0","65.5","13.29"
"10","014","00","015","1505","0206","261","57","204","20","281","429","0","65.5","13.29"
"10","014","00","015","1506","0000","178","43","135","17","195","296","0","65.88","14.53"
"10","014","00","015","1506","0205","178","43","135","17","195","296","0","65.88","14.53"
"10","014","00","016","0000","0000","1484","452","1032","117","1601","4181","5114","38.29","10.81"
"10","014","00","016","1601","0000","388","122","266","20","408","1240","0","32.9","9.84"
"10","014","00","016","1601","0212","388","122","266","20","408","1240","0","32.9","9.84"
"10","014","00","016","1602","0000","250","101","149","29","279","760","0","36.71","13.29"
"10","014","00","016","1602","0213","250","101","149","29","279","760","0","36.71","13.29"
"10","014","00","016","1603","0000","488","146","342","41","529","1238","0","42.73","11.79"
"10","014","00","016","1603","0211","488","146","342","41","529","1238","0","42.73","11.79"
"10","014","00","016","1604","0000","358","83","275","27","385","943","0","40.83","8.8"
"10","014","00","016","1604","0210","358","83","275","27","385","943","0","40.83","8.8"
"10","016","00","000","0000","0000","37940","11489","26451","2808","40748","90405","104400","45.07","12.71"
"10","016","00","001","0000","0000","24590","7572","17018","1571","26161","53655","62523","48.76","14.11"
"10","016","00","001","0102","0000","215","68","147","10","225","481","0","46.78","14.14"
"10","016","00","001","0102","0001","215","68","147","10","225","481","0","46.78","14.14"
"10","016","00","001","0103","0000","273","70","203","18","291","558","0","52.15","12.54"
"10","016","00","001","0103","0002","273","70","203","18","291","558","0","52.15","12.54"
"10","016","00","001","0104","0000","225","60","165","38","263","533","0","49.34","11.26"
"10","016","00","001","0104","0003","225","60","165","38","263","533","0","49.34","11.26"
"10","016","00","001","0105","0000","435","137","298","32","467","922","0","50.65","14.86"
"10","016","00","001","0105","0004","435","137","298","32","467","922","0","50.65","14.86"
"10","016","00","001","0106","0000","519","191","328","30","549","1021","0","53.77","18.71"
"10","016","00","001","0106","0005","519","191","328","30","549","1021","0","53.77","18.71"
"10","016","00","001","0107","0000","378","131","247","29","407","793","0","51.32","16.52"
"10","016","00","001","0107","0006","378","131","247","29","407","793","0","51.32","16.52"
"10","016","00","001","0108","0000","950","296","654","66","1016","1955","0","51.97","15.14"
"10","016","00","001","0108","0007","471","149","322","40","511","954","0","53.56","15.62"
"10","016","00","001","0108","0008","479","147","332","26","505","1001","0","50.45","14.69"
"10","016","00","001","0109","0000","1959","563","1396","112","2071","4130","0","50.15","13.63"
"10","016","00","001","0109","0010","613","163","450","50","663","1402","0","47.29","11.63"
"10","016","00","001","0109","0011","688","207","481","25","713","1389","0","51.33","14.9"
"10","016","00","001","0109","0012","658","193","465","37","695","1339","0","51.9","14.41"
"10","016","00","001","0110","0000","503","165","338","32","535","1192","0","44.88","13.84"
"10","016","00","001","0110","0009","503","165","338","32","535","1192","0","44.88","13.84"
"10","016","00","001","0111","0000","2480","733","1747","145","2625","5281","0","49.71","13.88"
"10","016","00","001","0111","0013","561","152","409","37","598","1254","0","47.69","12.12"
"10","016","00","001","0111","0014","558","166","392","43","601","1194","0","50.34","13.9"
"10","016","00","001","0111","0015","632","180","452","40","672","1393","0","48.24","12.92"
"10","016","00","001","0111","0016","729","235","494","25","754","1440","0","52.36","16.32"
"10","016","00","001","0112","0000","1133","334","799","95","1228","2499","0","49.14","13.37"
"10","016","00","001","0112","0017","549","173","376","47","596","1215","0","49.05","14.24"
"10","016","00","001","0112","0018","584","161","423","48","632","1284","0","49.22","12.54"
"10","016","00","001","0113","0000","688","196","492","58","746","1512","0","49.34","12.96"
"10","016","00","001","0113","0019","688","196","492","58","746","1512","0","49.34","12.96"
"10","016","00","001","0114","0000","2790","1268","1522","124","2914","6044","0","48.21","20.98"
"10","016","00","001","0114","0020","521","156","365","46","567","1181","0","48.01","13.21"
"10","016","00","001","0114","0021","638","191","447","41","679","1348","0","50.37","14.17"
"10","016","00","001","0114","0022","697","233","464","22","719","1391","0","51.69","16.75"
"10","016","00","001","0114","0023","934","688","246","15","949","2124","0","44.68","32.39"
"10","016","00","001","0115","0000","1447","401","1046","79","1526","3082","0","49.51","13.01"
"10","016","00","001","0115","0024","704","202","502","43","747","1500","0","49.8","13.47"
"10","016","00","001","0115","0025","743","199","544","36","779","1582","0","49.24","12.58"
"10","016","00","001","0116","0000","1538","425","1113","70","1608","3192","0","50.38","13.31"
"10","016","00","001","0116","0026","771","211","560","27","798","1638","0","48.72","12.88"
"10","016","00","001","0116","0027","767","214","553","43","810","1554","0","52.12","13.77"
"10","016","00","001","0117","0000","796","233","563","40","836","1872","0","44.66","12.45"
"10","016","00","001","0117","0028","366","102","264","17","383","980","0","39.08","10.41"
"10","016","00","001","0117","0029","430","131","299","23","453","892","0","50.78","14.69"
"10","016","00","001","0118","0000","309","107","202","13","322","778","0","41.39","13.75"
"10","016","00","001","0118","0030","309","107","202","13","322","778","0","41.39","13.75"
"10","016","00","001","0119","0000","447","133","314","26","473","930","0","50.86","14.3"
"10","016","00","001","0119","0031","447","133","314","26","473","930","0","50.86","14.3"
"10","016","00","001","0120","0000","1409","372","1037","49","1458","2609","0","55.88","14.26"
"10","016","00","001","0120","0032","827","228","599","32","859","1481","0","58.0","15.4"
"10","016","00","001","0120","0033","582","144","438","17","599","1128","0","53.1","12.77"
"10","016","00","001","0121","0000","203","46","157","21","224","415","0","53.98","11.08"
"10","016","00","001","0121","0034","203","46","157","21","224","415","0","53.98","11.08"
"10","016","00","001","0122","0000","1013","268","745","60","1073","2070","0","51.84","12.95"
"10","016","00","001","0122","0035","517","142","375","41","558","1120","0","49.82","12.68"
"10","016","00","001","0122","0036","496","126","370","19","515","950","0","54.21","13.26"
"10","016","00","001","0123","0000","261","72","189","21","282","627","0","44.98","11.48"
"10","016","00","001","0123","0037","261","72","189","21","282","627","0","44.98","11.48"
"10","016","00","001","0124","0000","476","118","358","42","518","989","0","52.38","11.93"
"10","016","00","001","0124","0039","476","118","358","42","518","989","0","52.38","11.93"
"10","016","00","001","0125","0000","518","137","381","20","538","1055","0","51.0","12.99"
"10","016","00","001","0125","0038","518","137","381","20","538","1055","0","51.0","12.99"
"10","016","00","001","0126","0000","297","89","208","33","330","591","0","55.84","15.06"
"10","016","00","001","0126","0040","297","89","208","33","330","591","0","55.84","15.06"
"10","016","00","001","0127","0000","757","191","566","56","813","1700","0","47.82","11.24"
"10","016","00","001","0127","0043","362","86","276","38","400","797","0","50.19","10.79"
"10","016","00","001","0127","0044","395","105","290","18","413","903","0","45.74","11.63"
"10","016","00","001","0128","0000","1016","313","703","107","1123","2466","0","45.54","12.69"
"10","016","00","001","0128","0041","603","190","413","53","656","1387","0","47.3","13.7"
"10","016","00","001","0128","0042","413","123","290","54","467","1079","0","43.28","11.4"
"10","016","00","001","0129","0000","162","62","100","15","177","376","0","47.07","16.49"
"10","016","00","001","0129","0045","162","62","100","15","177","376","0","47.07","16.49"
"10","016","00","001","0130","0000","179","50","129","16","195","371","0","52.56","13.48"
"10","016","00","001","0130","0046","179","50","129","16","195","371","0","52.56","13.48"
"10","016","00","001","0131","0000","436","99","337","19","455","1173","0","38.79","8.44"
"10","016","00","001","0131","0047","436","99","337","19","455","1173","0","38.79","8.44"
"10","016","00","001","0132","0000","465","140","325","19","484","1389","0","34.85","10.08"
"10","016","00","001","0132","0048","465","140","325","19","484","1389","0","34.85","10.08"
"10","016","00","001","0133","0000","153","53","100","60","213","761","0","27.99","6.96"
"10","016","00","001","0133","0049","153","53","100","60","213","761","0","27.99","6.96"
"10","016","00","001","0134","0000","160","51","109","16","176","288","0","61.11","17.71"
"10","016","00","001","0134","0050","160","51","109","16","176","288","0","61.11","17.71"
"10","016","00","002","0000","0000","5113","1473","3640","407","5520","12741","14533","43.32","11.56"
"10","016","00","002","0201","0000","536","136","400","52","588","1120","0","52.5","12.14"
"10","016","00","002","0201","0051","536","136","400","52","588","1120","0","52.5","12.14"
"10","016","00","002","0202","0000","135","37","98","7","142","332","0","42.77","11.14"
"10","016","00","002","0202","0052","135","37","98","7","142","332","0","42.77","11.14"
"10","016","00","002","0203","0000","89","28","61","6","95","242","0","39.26","11.57"
"10","016","00","002","0203","0053","89","28","61","6","95","242","0","39.26","11.57"
"10","016","00","002","0204","0000","97","27","70","5","102","293","0","34.81","9.22"
"10","016","00","002","0204","0054","97","27","70","5","102","293","0","34.81","9.22"
"10","016","00","002","0205","0000","236","57","179","38","274","666","0","41.14","8.56"
"10","016","00","002","0205","0055","236","57","179","38","274","666","0","41.14","8.56"
"10","016","00","002","0206","0000","146","33","113","16","162","326","0","49.69","10.12"
"10","016","00","002","0206","0056","146","33","113","16","162","326","0","49.69","10.12"
"10","016","00","002","0207","0000","281","83","198","16","297","732","0","40.57","11.34"
"10","016","00","002","0207","0057","281","83","198","16","297","732","0","40.57","11.34"
"10","016","00","002","0208","0000","271","73","198","29","300","651","0","46.08","11.21"
"10","016","00","002","0208","0058","271","73","198","29","300","651","0","46.08","11.21"
"10","016","00","002","0209","0000","313","96","217","12","325","744","0","43.68","12.9"
"10","016","00","002","0209","0059","313","96","217","12","325","744","0","43.68","12.9"
"10","016","00","002","0210","0000","70","18","52","3","73","134","0","54.48","13.43"
"10","016","00","002","0210","0060","70","18","52","3","73","134","0","54.48","13.43"
"10","016","00","002","0211","0000","75","23","52","3","78","216","0","36.11","10.65"
"10","016","00","002","0211","0062","75","23","52","3","78","216","0","36.11","10.65"
"10","016","00","002","0212","0000","125","39","86","7","132","279","0","47.31","13.98"
"10","016","00","002","0212","0064","125","39","86","7","132","279","0","47.31","13.98"
"10","016","00","002","0213","0000","190","51","139","9","199","664","0","29.97","7.68"
"10","016","00","002","0213","0063","190","51","139","9","199","664","0","29.97","7.68"
"10","016","00","002","0214","0000","145","32","113","5","150","296","0","50.68","10.81"
"10","016","00","002","0214","0065","145","32","113","5","150","296","0","50.68","10.81"
"10","016","00","002","0215","0000","251","91","160","24","275","794","0","34.63","11.46"
"10","016","00","002","0215","0061","251","91","160","24","275","794","0","34.63","11.46"
"10","016","00","002","0216","0000","118","39","79","4","122","257","0","47.47","15.18"
"10","016","00","002","0216","0066","118","39","79","4","122","257","0","47.47","15.18"
"10","016","00","002","0217","0000","27","4","23","2","29","89","0","32.58","4.49"
"10","016","00","002","0217","0067","27","4","23","2","29","89","0","32.58","4.49"
"10","016","00","002","0218","0000","363","128","235","27","390","815","0","47.85","15.71"
"10","016","00","002","0218","0068","363","128","235","27","390","815","0","47.85","15.71"
"10","016","00","002","0219","0000","371","100","271","19","390","975","0","40.0","10.26"
"10","016","00","002","0219","0069","371","100","271","19","390","975","0","40.0","10.26"
"10","016","00","002","0220","0000","286","84","202","29","315","648","0","48.61","12.96"
"10","016","00","002","0220","0070","286","84","202","29","315","648","0","48.61","12.96"
"10","016","00","002","0221","0000","730","217","513","82","812","1739","0","46.69","12.48"
"10","016","00","002","0221","0071","346","104","242","28","374","893","0","41.88","11.65"
"10","016","00","002","0221","0072","384","113","271","54","438","846","0","51.77","13.36"
"10","016","00","002","0222","0000","258","77","181","12","270","729","0","37.04","10.56"
"10","016","00","002","0222","0073","258","77","181","12","270","729","0","37.04","10.56"
"10","016","00","003","0000","0000","3342","947","2395","309","3651","8625","9856","42.33","10.98"
"10","016","00","003","0301","0000","238","77","161","17","255","514","0","49.61","14.98"
"10","016","00","003","0301","0074","238","77","161","17","255","514","0","49.61","14.98"
"10","016","00","003","0302","0000","325","86","239","15","340","657","0","51.75","13.09"
"10","016","00","003","0302","0075","325","86","239","15","340","657","0","51.75","13.09"
"10","016","00","003","0303","0000","68","13","55","4","72","109","0","66.06","11.93"
"10","016","00","003","0303","0076","68","13","55","4","72","109","0","66.06","11.93"
"10","016","00","003","0304","0000","63","16","47","3","66","156","0","42.31","10.26"
"10","016","00","003","0304","0077","63","16","47","3","66","156","0","42.31","10.26"
"10","016","00","003","0305","0000","116","36","80","5","121","293","0","41.3","12.29"
"10","016","00","003","0305","0078","116","36","80","5","121","293","0","41.3","12.29"
"10","016","00","003","0306","0000","72","22","50","0","72","231","0","31.17","9.52"
"10","016","00","003","0306","0079","72","22","50","0","72","231","0","31.17","9.52"
"10","016","00","003","0307","0000","81","29","52","6","87","161","0","54.04","18.01"
"10","016","00","003","0307","0080","81","29","52","6","87","161","0","54.04","18.01"
"10","016","00","003","0308","0000","737","200","537","48","785","1705","0","46.04","11.73"
"10","016","00","003","0308","0081","737","200","537","48","785","1705","0","46.04","11.73"
"10","016","00","003","0309","0000","118","30","88","7","125","285","0","43.86","10.53"
"10","016","00","003","0309","0082","118","30","88","7","125","285","0","43.86","10.53"
"10","016","00","003","0310","0000","207","67","140","16","223","723","0","30.84","9.27"
"10","016","00","003","0310","0083","207","67","140","16","223","723","0","30.84","9.27"
"10","016","00","003","0311","0000","256","86","170","30","286","774","0","36.95","11.11"
"10","016","00","003","0311","0084","256","86","170","30","286","774","0","36.95","11.11"
"10","016","00","003","0312","0000","414","138","276","87","501","1429","0","35.06","9.66"
"10","016","00","003","0312","0085","414","138","276","87","501","1429","0","35.06","9.66"
"10","016","00","003","0313","0000","451","71","380","49","500","1084","0","46.13","6.55"
"10","016","00","003","0313","0086","451","71","380","49","500","1084","0","46.13","6.55"
"10","016","00","003","0314","0000","118","41","77","8","126","251","0","50.2","16.33"
"10","016","00","003","0314","0087","118","41","77","8","126","251","0","50.2","16.33"
"10","016","00","003","0315","0000","78","35","43","14","92","253","0","36.36","13.83"
"10","016","00","003","0315","0088","78","35","43","14","92","253","0","36.36","13.83"
"10","016","00","004","0000","0000","2282","684","1598","276","2558","7382","8396","34.65","9.27"
"10","016","00","004","0401","0000","45","11","34","1","46","283","0","16.25","3.89"
"10","016","00","004","0401","0089","45","11","34","1","46","283","0","16.25","3.89"
"10","016","00","004","0402","0000","110","48","62","14","124","424","0","29.25","11.32"
"10","016","00","004","0402","0090","110","48","62","14","124","424","0","29.25","11.32"
"10","016","00","004","0403","0000","99","22","77","10","109","282","0","38.65","7.8"
"10","016","00","004","0403","0092","99","22","77","10","109","282","0","38.65","7.8"
"10","016","00","004","0404","0000","236","88","148","49","285","826","0","34.5","10.65"
"10","016","00","004","0404","0091","236","88","148","49","285","826","0","34.5","10.65"
"10","016","00","004","0405","0000","218","73","145","43","261","661","0","39.49","11.04"
"10","016","00","004","0405","0093","218","73","145","43","261","661","0","39.49","11.04"
"10","016","00","004","0406","0000","26","9","17","3","29","141","0","20.57","6.38"
"10","016","00","004","0406","0094","26","9","17","3","29","141","0","20.57","6.38"
"10","016","00","004","0407","0000","187","45","142","10","197","635","0","31.02","7.09"
"10","016","00","004","0407","0095","187","45","142","10","197","635","0","31.02","7.09"
"10","016","00","004","0408","0000","70","15","55","3","73","216","0","33.8","6.94"
"10","016","00","004","0408","0096","70","15","55","3","73","216","0","33.8","6.94"
"10","016","00","004","0409","0000","120","39","81","20","140","572","0","24.48","6.82"
"10","016","00","004","0409","0097","120","39","81","20","140","572","0","24.48","6.82"
"10","016","00","004","0410","0000","469","115","354","49","518","1267","0","40.88","9.08"
"10","016","00","004","0410","0098","469","115","354","49","518","1267","0","40.88","9.08"
"10","016","00","004","0411","0000","702","219","483","74","776","2075","0","37.4","10.55"
"10","016","00","004","0411","0099","298","84","214","28","326","942","0","34.61","8.92"
"10","016","00","004","0411","0100","404","135","269","46","450","1133","0","39.72","11.92"
"10","016","00","005","0000","0000","1673","487","1186","167","1840","4628","5237","39.76","10.52"
"10","016","00","005","0501","0000","302","99","203","30","332","734","0","45.23","13.49"
"10","016","00","005","0501","0101","302","99","203","30","332","734","0","45.23","13.49"
"10","016","00","005","0502","0000","176","35","141","14","190","454","0","41.85","7.71"
"10","016","00","005","0502","0102","176","35","141","14","190","454","0","41.85","7.71"
"10","016","00","005","0503","0000","98","27","71","7","105","300","0","35.0","9.0"
"10","016","00","005","0503","0103","98","27","71","7","105","300","0","35.0","9.0"
"10","016","00","005","0504","0000","205","60","145","34","239","471","0","50.74","12.74"
"10","016","00","005","0504","0104","205","60","145","34","239","471","0","50.74","12.74"
"10","016","00","005","0505","0000","466","133","333","56","522","1414","0","36.92","9.41"
"10","016","00","005","0505","0105","202","64","138","18","220","672","0","32.74","9.52"
"10","016","00","005","0505","0106","264","69","195","38","302","742","0","40.7","9.3"
"10","016","00","005","0506","0000","195","58","137","1","196","476","0","41.18","12.18"
"10","016","00","005","0506","0108","195","58","137","1","196","476","0","41.18","12.18"
"10","016","00","005","0507","0000","53","24","29","3","56","208","0","26.92","11.54"
"10","016","00","005","0507","0109","53","24","29","3","56","208","0","26.92","11.54"
"10","016","00","005","0508","0000","94","26","68","15","109","264","0","41.29","9.85"
"10","016","00","005","0508","0107","94","26","68","15","109","264","0","41.29","9.85"
"10","016","00","005","0509","0000","84","25","59","7","91","307","0","29.64","8.14"
"10","016","00","005","0509","0110","84","25","59","7","91","307","0","29.64","8.14"
"10","016","00","006","0000","0000","940","326","614","78","1018","3374","3855","30.17","9.66"
"10","016","00","006","0601","0000","62","29","33","4","66","248","0","26.61","11.69"
"10","016","00","006","0601","0111","62","29","33","4","66","248","0","26.61","11.69"
"10","016","00","006","0602","0000","183","61","122","21","204","581","0","35.11","10.5"
"10","016","00","006","0602","0112","183","61","122","21","204","581","0","35.11","10.5"
"10","016","00","006","0603","0000","197","78","119","29","226","641","0","35.26","12.17"
"10","016","00","006","0603","0113","197","78","119","29","226","641","0","35.26","12.17"
"10","016","00","006","0604","0000","116","31","85","2","118","382","0","30.89","8.12"
"10","016","00","006","0604","0114","116","31","85","2","118","382","0","30.89","8.12"
"10","016","00","006","0605","0000","79","24","55","6","85","351","0","24.22","6.84"
"10","016","00","006","0605","0115","79","24","55","6","85","351","0","24.22","6.84"
"10","016","00","006","0606","0000","303","103","200","16","319","1171","0","27.24","8.8"
"10","016","00","006","0606","0116","303","103","200","16","319","1171","0","27.24","8.8"
"10","017","00","000","0000","0000","156637","54369","102268","8427","165064","320030","370269","51.58","16.99"
"10","017","00","001","0000","0000","20164","6983","13181","1324","21488","45545","51716","47.18","15.33"
"10","017","00","001","0101","0000","407","147","260","35","442","709","0","62.34","20.73"
"10","017","00","001","0101","0035","407","147","260","35","442","709","0","62.34","20.73"
"10","017","00","001","0102","0000","596","211","385","43","639","1219","0","52.42","17.31"
"10","017","00","001","0102","0033","596","211","385","43","639","1219","0","52.42","17.31"
"10","017","00","001","0103","0000","426","160","266","26","452","904","0","50.0","17.7"
"10","017","00","001","0103","0034","426","160","266","26","452","904","0","50.0","17.7"
"10","017","00","001","0104","0000","502","181","321","45","547","1037","0","52.75","17.45"
"10","017","00","001","0104","0032","502","181","321","45","547","1037","0","52.75","17.45"
"10","017","00","001","0105","0000","639","217","422","45","684","1210","0","56.53","17.93"
"10","017","00","001","0105","0031","639","217","422","45","684","1210","0","56.53","17.93"
"10","017","00","001","0106","0000","575","213","362","49","624","1175","0","53.11","18.13"
"10","017","00","001","0106","0030","575","213","362","49","624","1175","0","53.11","18.13"
"10","017","00","001","0107","0000","589","182","407","34","623","1267","0","49.17","14.36"
"10","017","00","001","0107","0029","589","182","407","34","623","1267","0","49.17","14.36"
"10","017","00","001","0108","0000","394","147","247","35","429","802","0","53.49","18.33"
"10","017","00","001","0108","0028","394","147","247","35","429","802","0","53.49","18.33"
"10","017","00","001","0109","0000","614","222","392","37","651","1594","0","40.84","13.93"
"10","017","00","001","0109","0027","614","222","392","37","651","1594","0","40.84","13.93"
"10","017","00","001","0110","0000","1080","349","731","58","1138","2316","0","49.14","15.07"
"10","017","00","001","0110","0025","430","135","295","35","465","859","0","54.13","15.72"
"10","017","00","001","0110","0026","650","214","436","23","673","1457","0","46.19","14.69"
"10","017","00","001","0111","0000","684","245","439","54","738","1341","0","55.03","18.27"
"10","017","00","001","0111","0024","684","245","439","54","738","1341","0","55.03","18.27"
"10","017","00","001","0112","0000","913","320","593","82","995","2000","0","49.75","16.0"
"10","017","00","001","0112","0022","535","191","344","38","573","1138","0","50.35","16.78"
"10","017","00","001","0112","0023","378","129","249","44","422","862","0","48.96","14.97"
"10","017","00","001","0113","0000","979","304","675","58","1037","1960","0","52.91","15.51"
"10","017","00","001","0113","0020","536","164","372","42","578","1090","0","53.03","15.05"
"10","017","00","001","0113","0021","443","140","303","16","459","870","0","52.76","16.09"
"10","017","00","001","0114","0000","608","217","391","30","638","1270","0","50.24","17.09"
"10","017","00","001","0114","0019","608","217","391","30","638","1270","0","50.24","17.09"
"10","017","00","001","0115","0000","525","137","388","29","554","1166","0","47.51","11.75"
"10","017","00","001","0115","0016","525","137","388","29","554","1166","0","47.51","11.75"
"10","017","00","001","0116","0000","797","466","331","82","879","1753","0","50.14","26.58"
"10","017","00","001","0116","0014","797","466","331","82","879","1753","0","50.14","26.58"
"10","017","00","001","0117","0000","391","116","275","53","444","984","0","45.12","11.79"
"10","017","00","001","0117","0015","391","116","275","53","444","984","0","45.12","11.79"
"10","017","00","001","0118","0000","519","168","351","59","578","1261","0","45.84","13.32"
"10","017","00","001","0118","0013","519","168","351","59","578","1261","0","45.84","13.32"
"10","017","00","001","0119","0000","583","195","388","49","632","1474","0","42.88","13.23"
"10","017","00","001","0119","0005","583","195","388","49","632","1474","0","42.88","13.23"
"10","017","00","001","0120","0000","504","192","312","50","554","1271","0","43.59","15.11"
"10","017","00","001","0120","0006","504","192","312","50","554","1271","0","43.59","15.11"
"10","017","00","001","0121","0000","244","85","159","14","258","466","0","55.36","18.24"
"10","017","00","001","0121","0001","244","85","159","14","258","466","0","55.36","18.24"
"10","017","00","001","0122","0000","2074","667","1407","83","2157","5256","0","41.04","12.69"
"10","017","00","001","0122","0002","516","175","341","24","540","1262","0","42.79","13.87"
"10","017","00","001","0122","0003","515","160","355","41","556","1171","0","47.48","13.66"
"10","017","00","001","0122","0004","1043","332","711","18","1061","2823","0","37.58","11.76"
"10","017","00","001","0123","0000","616","262","354","23","639","1694","0","37.72","15.47"
"10","017","00","001","0123","0018","616","262","354","23","639","1694","0","37.72","15.47"
"10","017","00","001","0124","0000","445","157","288","25","470","973","0","48.3","16.14"
"10","017","00","001","0124","0017","445","157","288","25","470","973","0","48.3","16.14"
"10","017","00","001","0125","0000","2391","772","1619","73","2464","5430","0","45.38","14.22"
"10","017","00","001","0125","0010","633","228","405","22","655","1352","0","48.45","16.86"
"10","017","00","001","0125","0011","642","184","458","15","657","1413","0","46.5","13.02"
"10","017","00","001","0125","0012","1116","360","756","36","1152","2665","0","43.23","13.51"
"10","017","00","001","0126","0000","2069","651","1418","153","2222","5013","0","44.32","12.99"
"10","017","00","001","0126","0007","1106","364","742","61","1167","2707","0","43.11","13.45"
"10","017","00","001","0126","0008","674","202","472","76","750","1545","0","48.54","13.07"
"10","017","00","001","0126","0009","289","85","204","16","305","761","0","40.08","11.17"
"10","017","00","002","0000","0000","23124","8017","15107","1356","24480","46256","53819","52.92","17.33"
"10","017","00","002","0201","0000","1915","662","1253","131","2046","3754","0","54.5","17.63"
"10","017","00","002","0201","0219","645","209","436","63","708","1258","0","56.28","16.61"
"10","017","00","002","0201","0220","647","214","433","42","689","1237","0","55.7","17.3"
"10","017","00","002","0201","0221","623","239","384","26","649","1259","0","51.55","18.98"
"10","017","00","002","0202","0000","1115","380","735","95","1210","2464","0","49.11","15.42"
"10","017","00","002","0202","0222","515","178","337","52","567","1120","0","50.63","15.89"
"10","017","00","002","0202","0223","600","202","398","43","643","1344","0","47.84","15.03"
"10","017","00","002","0203","0000","1918","613","1305","90","2008","3568","0","56.28","17.18"
"10","017","00","002","0203","0226","919","270","649","53","972","1735","0","56.02","15.56"
"10","017","00","002","0203","0227","999","343","656","37","1036","1833","0","56.52","18.71"
"10","017","00","002","0204","0000","1021","345","676","66","1087","1900","0","57.21","18.16"
"10","017","00","002","0204","0228","497","172","325","18","515","938","0","54.9","18.34"
"10","017","00","002","0204","0229","524","173","351","48","572","962","0","59.46","17.98"
"10","017","00","002","0205","0000","1172","352","820","71","1243","2190","0","56.76","16.07"
"10","017","00","002","0205","0230","648","209","439","27","675","1191","0","56.68","17.55"
"10","017","00","002","0205","0231","524","143","381","44","568","999","0","56.86","14.31"
"10","017","00","002","0206","0000","725","268","457","53","778","1525","0","51.02","17.57"
"10","017","00","002","0206","0232","126","45","81","12","138","282","0","48.94","15.96"
"10","017","00","002","0206","0233","599","223","376","41","640","1243","0","51.49","17.94"
"10","017","00","002","0207","0000","528","176","352","43","571","1092","0","52.29","16.12"
"10","017","00","002","0207","0234","528","176","352","43","571","1092","0","52.29","16.12"
"10","017","00","002","0208","0000","1090","371","719","48","1138","2260","0","50.35","16.42"
"10","017","00","002","0208","0238","444","146","298","19","463","975","0","47.49","14.97"
"10","017","00","002","0208","0239","646","225","421","29","675","1285","0","52.53","17.51"
"10","017","00","002","0209","0000","2152","750","1402","99","2251","4286","0","52.52","17.5"
"10","017","00","002","0209","0235","635","212","423","38","673","1246","0","54.01","17.01"
"10","017","00","002","0209","0236","838","326","512","29","867","1722","0","50.35","18.93"
"10","017","00","002","0209","0237","679","212","467","32","711","1318","0","53.95","16.08"
"10","017","00","002","0210","0000","1722","621","1101","132","1854","3463","0","53.54","17.93"
"10","017","00","002","0210","0244","882","307","575","68","950","1774","0","53.55","17.31"
"10","017","00","002","0210","0245","840","314","526","64","904","1689","0","53.52","18.59"
"10","017","00","002","0211","0000","931","344","587","62","993","2066","0","48.06","16.65"
"10","017","00","002","0211","0240","486","165","321","37","523","1077","0","48.56","15.32"
"10","017","00","002","0211","0241","445","179","266","25","470","989","0","47.52","18.1"
"10","017","00","002","0212","0000","216","83","133","12","228","428","0","53.27","19.39"
"10","017","00","002","0212","0253","216","83","133","12","228","428","0","53.27","19.39"
"10","017","00","002","0213","0000","168","50","118","29","197","326","0","60.43","15.34"
"10","017","00","002","0213","0254","168","50","118","29","197","326","0","60.43","15.34"
"10","017","00","002","0214","0000","234","77","157","16","250","351","0","71.23","21.94"
"10","017","00","002","0214","0255","234","77","157","16","250","351","0","71.23","21.94"
"10","017","00","002","0215","0000","864","298","566","30","894","1871","0","47.78","15.93"
"10","017","00","002","0215","0256","864","298","566","30","894","1871","0","47.78","15.93"
"10","017","00","002","0216","0000","199","56","143","9","208","448","0","46.43","12.5"
"10","017","00","002","0216","0257","199","56","143","9","208","448","0","46.43","12.5"
"10","017","00","002","0217","0000","1048","375","673","51","1099","1936","0","56.77","19.37"
"10","017","00","002","0217","0224","581","203","378","38","619","1011","0","61.23","20.08"
"10","017","00","002","0217","0225","467","172","295","13","480","925","0","51.89","18.59"
"10","017","00","002","0218","0000","2900","1082","1818","140","3040","6059","0","50.17","17.86"
"10","017","00","002","0218","0246","640","234","406","49","689","1355","0","50.85","17.27"
"10","017","00","002","0218","0247","727","288","439","40","767","1512","0","50.73","19.05"
"10","017","00","002","0218","0248","707","246","461","18","725","1486","0","48.79","16.55"
"10","017","00","002","0218","0249","826","314","512","33","859","1706","0","50.35","18.41"
"10","017","00","002","0219","0000","2001","704","1297","117","2118","3803","0","55.69","18.51"
"10","017","00","002","0219","0250","710","230","480","48","758","1384","0","54.77","16.62"
"10","017","00","002","0219","0251","588","219","369","39","627","1045","0","60.0","20.96"
"10","017","00","002","0219","0252","703","255","448","30","733","1374","0","53.35","18.56"
"10","017","00","002","0220","0000","1205","410","795","62","1267","2466","0","51.38","16.63"
"10","017","00","002","0220","0242","568","197","371","30","598","1193","0","50.13","16.51"
"10","017","00","002","0220","0243","637","213","424","32","669","1273","0","52.55","16.73"
"10","017","00","003","0000","0000","16817","5869","10948","679","17496","33225","38606","52.66","17.66"
"10","017","00","003","0301","0000","671","222","449","34","705","1431","0","49.27","15.51"
"10","017","00","003","0301","0191","671","222","449","34","705","1431","0","49.27","15.51"
"10","017","00","003","0302","0000","338","122","216","20","358","637","0","56.2","19.15"
"10","017","00","003","0302","0193","338","122","216","20","358","637","0","56.2","19.15"
"10","017","00","003","0303","0000","407","136","271","24","431","735","0","58.64","18.5"
"10","017","00","003","0303","0194","407","136","271","24","431","735","0","58.64","18.5"
"10","017","00","003","0304","0000","1758","607","1151","88","1846","3641","0","50.7","16.67"
"10","017","00","003","0304","0195","488","163","325","28","516","1078","0","47.87","15.12"
"10","017","00","003","0304","0196","616","216","400","35","651","1238","0","52.58","17.45"
"10","017","00","003","0304","0197","654","228","426","25","679","1325","0","51.25","17.21"
"10","017","00","003","0305","0000","1382","452","930","61","1443","2626","0","54.95","17.21"
"10","017","00","003","0305","0206","699","227","472","30","729","1267","0","57.54","17.92"
"10","017","00","003","0305","0207","683","225","458","31","714","1359","0","52.54","16.56"
"10","017","00","003","0306","0000","1523","501","1022","60","1583","2916","0","54.29","17.18"
"10","017","00","003","0306","0208","549","155","394","20","569","970","0","58.66","15.98"
"10","017","00","003","0306","0209","516","176","340","17","533","1002","0","53.19","17.56"
"10","017","00","003","0306","0210","458","170","288","23","481","944","0","50.95","18.01"
"10","017","00","003","0307","0000","1279","446","833","46","1325","2553","0","51.9","17.47"
"10","017","00","003","0307","0200","627","223","404","29","656","1110","0","59.1","20.09"
"10","017","00","003","0307","0201","652","223","429","17","669","1443","0","46.36","15.45"
"10","017","00","003","0308","0000","1283","401","882","53","1336","2654","0","50.34","15.11"
"10","017","00","003","0308","0198","752","291","461","25","777","1475","0","52.68","19.73"
"10","017","00","003","0308","0199","531","110","421","28","559","1179","0","47.41","9.33"
"10","017","00","003","0309","0000","208","64","144","16","224","415","0","53.98","15.42"
"10","017","00","003","0309","0202","208","64","144","16","224","415","0","53.98","15.42"
"10","017","00","003","0310","0000","2346","854","1492","101","2447","4551","0","53.77","18.77"
"10","017","00","003","0310","0203","662","255","407","20","682","1378","0","49.49","18.51"
"10","017","00","003","0310","0204","804","293","511","26","830","1570","0","52.87","18.66"
"10","017","00","003","0310","0205","880","306","574","55","935","1603","0","58.33","19.09"
"10","017","00","003","0311","0000","214","68","146","6","220","456","0","48.25","14.91"
"10","017","00","003","0311","0192","214","68","146","6","220","456","0","48.25","14.91"
"10","017","00","003","0312","0000","2602","953","1649","90","2692","4893","0","55.02","19.48"
"10","017","00","003","0312","0215","702","254","448","27","729","1328","0","54.89","19.13"
"10","017","00","003","0312","0216","600","216","384","16","616","1173","0","52.51","18.41"
"10","017","00","003","0312","0217","575","221","354","27","602","1019","0","59.08","21.69"
"10","017","00","003","0312","0218","725","262","463","20","745","1373","0","54.26","19.08"
"10","017","00","003","0313","0000","2806","1043","1763","80","2886","5717","0","50.48","18.24"
"10","017","00","003","0313","0211","820","373","447","23","843","1500","0","56.2","24.87"
"10","017","00","003","0313","0212","573","188","385","20","593","1442","0","41.12","13.04"
"10","017","00","003","0313","0213","616","216","400","15","631","1165","0","54.16","18.54"
"10","017","00","003","0313","0214","797","266","531","22","819","1610","0","50.87","16.52"
"10","017","00","004","0000","0000","18183","6390","11793","1326","19509","36738","43950","53.1","17.39"
"10","017","00","004","0401","0000","735","246","489","88","823","1782","0","46.18","13.8"
"10","017","00","004","0401","0072","735","246","489","88","823","1782","0","46.18","13.8"
"10","017","00","004","0402","0000","555","186","369","43","598","1055","0","56.68","17.63"
"10","017","00","004","0402","0073","555","186","369","43","598","1055","0","56.68","17.63"
"10","017","00","004","0403","0000","704","230","474","29","733","1558","0","47.05","14.76"
"10","017","00","004","0403","0074","704","230","474","29","733","1558","0","47.05","14.76"
"10","017","00","004","0404","0000","844","273","571","50","894","1736","0","51.5","15.73"
"10","017","00","004","0404","0075","844","273","571","50","894","1736","0","51.5","15.73"
"10","017","00","004","0405","0000","1286","383","903","69","1355","2352","0","57.61","16.28"
"10","017","00","004","0405","0076","696","208","488","37","733","1243","0","58.97","16.73"
"10","017","00","004","0405","0077","590","175","415","32","622","1109","0","56.09","15.78"
"10","017","00","004","0406","0000","926","288","638","36","962","1684","0","57.13","17.1"
"10","017","00","004","0406","0078","926","288","638","36","962","1684","0","57.13","17.1"
"10","017","00","004","0407","0000","472","185","287","36","508","919","0","55.28","20.13"
"10","017","00","004","0407","0079","472","185","287","36","508","919","0","55.28","20.13"
"10","017","00","004","0408","0000","487","198","289","17","504","991","0","50.86","19.98"
"10","017","00","004","0408","0080","487","198","289","17","504","991","0","50.86","19.98"
"10","017","00","004","0409","0000","447","153","294","25","472","876","0","53.88","17.47"
"10","017","00","004","0409","0081","447","153","294","25","472","876","0","53.88","17.47"
"10","017","00","004","0410","0000","823","267","556","51","874","1480","0","59.05","18.04"
"10","017","00","004","0410","0082","582","188","394","29","611","1046","0","58.41","17.97"
"10","017","00","004","0410","0083","241","79","162","22","263","434","0","60.6","18.2"
"10","017","00","004","0411","0000","399","141","258","47","446","764","0","58.38","18.46"
"10","017","00","004","0411","0084","399","141","258","47","446","764","0","58.38","18.46"
"10","017","00","004","0412","0000","481","181","300","20","501","968","0","51.76","18.7"
"10","017","00","004","0412","0085","481","181","300","20","501","968","0","51.76","18.7"
"10","017","00","004","0413","0000","1177","406","771","82","1259","2641","0","47.67","15.37"
"10","017","00","004","0413","0086","642","217","425","44","686","1326","0","51.73","16.37"
"10","017","00","004","0413","0087","535","189","346","38","573","1315","0","43.57","14.37"
"10","017","00","004","0414","0000","414","134","280","35","449","775","0","57.94","17.29"
"10","017","00","004","0414","0088","414","134","280","35","449","775","0","57.94","17.29"
"10","017","00","004","0415","0000","675","259","416","76","751","1326","0","56.64","19.53"
"10","017","00","004","0415","0089","326","120","206","48","374","652","0","57.36","18.4"
"10","017","00","004","0415","0090","349","139","210","28","377","674","0","55.93","20.62"
"10","017","00","004","0416","0000","383","144","239","27","410","789","0","51.96","18.25"
"10","017","00","004","0416","0091","383","144","239","27","410","789","0","51.96","18.25"
"10","017","00","004","0417","0000","835","280","555","68","903","1715","0","52.65","16.33"
"10","017","00","004","0417","0092","835","280","555","68","903","1715","0","52.65","16.33"
"10","017","00","004","0418","0000","418","176","242","41","459","849","0","54.06","20.73"
"10","017","00","004","0418","0093","418","176","242","41","459","849","0","54.06","20.73"
"10","017","00","004","0419","0000","353","146","207","18","371","875","0","42.4","16.69"
"10","017","00","004","0419","0094","353","146","207","18","371","875","0","42.4","16.69"
"10","017","00","004","0420","0000","402","159","243","34","436","851","0","51.23","18.68"
"10","017","00","004","0420","0095","402","159","243","34","436","851","0","51.23","18.68"
"10","017","00","004","0421","0000","395","150","245","32","427","735","0","58.1","20.41"
"10","017","00","004","0421","0096","395","150","245","32","427","735","0","58.1","20.41"
"10","017","00","004","0422","0000","479","163","316","58","537","1009","0","53.22","16.15"
"10","017","00","004","0422","0097","479","163","316","58","537","1009","0","53.22","16.15"
"10","017","00","004","0423","0000","479","163","316","53","532","1082","0","49.17","15.06"
"10","017","00","004","0423","0098","479","163","316","53","532","1082","0","49.17","15.06"
"10","017","00","004","0424","0000","1433","506","927","95","1528","2797","0","54.63","18.09"
"10","017","00","004","0424","0099","597","213","384","64","661","1278","0","51.72","16.67"
"10","017","00","004","0424","0100","836","293","543","31","867","1519","0","57.08","19.29"
"10","017","00","004","0425","0000","347","129","218","35","382","708","0","53.95","18.22"
"10","017","00","004","0425","0103","347","129","218","35","382","708","0","53.95","18.22"
"10","017","00","004","0426","0000","325","122","203","30","355","567","0","62.61","21.52"
"10","017","00","004","0426","0104","325","122","203","30","355","567","0","62.61","21.52"
"10","017","00","004","0427","0000","376","154","222","38","414","751","0","55.13","20.51"
"10","017","00","004","0427","0105","376","154","222","38","414","751","0","55.13","20.51"
"10","017","00","004","0428","0000","335","127","208","18","353","589","0","59.93","21.56"
"10","017","00","004","0428","0106","335","127","208","18","353","589","0","59.93","21.56"
"10","017","00","004","0429","0000","1198","441","757","75","1273","2514","0","50.64","17.54"
"10","017","00","004","0429","0101","567","225","342","34","601","1336","0","44.99","16.84"
"10","017","00","004","0429","0102","631","216","415","41","672","1178","0","57.05","18.34"
"10","017","00","005","0000","0000","20291","6929","13362","1097","21388","41856","47428","51.1","16.55"
"10","017","00","005","0501","0000","385","137","248","25","410","796","0","51.51","17.21"
"10","017","00","005","0501","0107","385","137","248","25","410","796","0","51.51","17.21"
"10","017","00","005","0502","0000","598","193","405","42","640","1036","0","61.78","18.63"
"10","017","00","005","0502","0108","598","193","405","42","640","1036","0","61.78","18.63"
"10","017","00","005","0503","0000","392","133","259","44","436","756","0","57.67","17.59"
"10","017","00","005","0503","0109","392","133","259","44","436","756","0","57.67","17.59"
"10","017","00","005","0504","0000","415","174","241","18","433","957","0","45.25","18.18"
"10","017","00","005","0504","0110","415","174","241","18","433","957","0","45.25","18.18"
"10","017","00","005","0505","0000","425","149","276","8","433","802","0","53.99","18.58"
"10","017","00","005","0505","0111","425","149","276","8","433","802","0","53.99","18.58"
"10","017","00","005","0506","0000","638","222","416","37","675","1263","0","53.44","17.58"
"10","017","00","005","0506","0112","638","222","416","37","675","1263","0","53.44","17.58"
"10","017","00","005","0507","0000","429","124","305","20","449","778","0","57.71","15.94"
"10","017","00","005","0507","0113","429","124","305","20","449","778","0","57.71","15.94"
"10","017","00","005","0508","0000","583","212","371","72","655","1180","0","55.51","17.97"
"10","017","00","005","0508","0114","583","212","371","72","655","1180","0","55.51","17.97"
"10","017","00","005","0509","0000","449","150","299","27","476","990","0","48.08","15.15"
"10","017","00","005","0509","0115","449","150","299","27","476","990","0","48.08","15.15"
"10","017","00","005","0510","0000","531","185","346","17","548","1332","0","41.14","13.89"
"10","017","00","005","0510","0116","531","185","346","17","548","1332","0","41.14","13.89"
"10","017","00","005","0511","0000","825","285","540","43","868","1770","0","49.04","16.1"
"10","017","00","005","0511","0117","386","146","240","23","409","848","0","48.23","17.22"
"10","017","00","005","0511","0118","439","139","300","20","459","922","0","49.78","15.08"
"10","017","00","005","0512","0000","684","238","446","33","717","1584","0","45.27","15.03"
"10","017","00","005","0512","0122","684","238","446","33","717","1584","0","45.27","15.03"
"10","017","00","005","0513","0000","453","130","323","29","482","1319","0","36.54","9.86"
"10","017","00","005","0513","0123","453","130","323","29","482","1319","0","36.54","9.86"
"10","017","00","005","0514","0000","261","81","180","23","284","574","0","49.48","14.11"
"10","017","00","005","0514","0120","261","81","180","23","284","574","0","49.48","14.11"
"10","017","00","005","0515","0000","421","148","273","34","455","877","0","51.88","16.88"
"10","017","00","005","0515","0121","421","148","273","34","455","877","0","51.88","16.88"
"10","017","00","005","0516","0000","391","174","217","35","426","715","0","59.58","24.34"
"10","017","00","005","0516","0141","391","174","217","35","426","715","0","59.58","24.34"
"10","017","00","005","0517","0000","472","173","299","43","515","849","0","60.66","20.38"
"10","017","00","005","0517","0140","472","173","299","43","515","849","0","60.66","20.38"
"10","017","00","005","0518","0000","427","152","275","21","448","932","0","48.07","16.31"
"10","017","00","005","0518","0139","427","152","275","21","448","932","0","48.07","16.31"
"10","017","00","005","0519","0000","797","249","548","63","860","1642","0","52.38","15.16"
"10","017","00","005","0519","0138","797","249","548","63","860","1642","0","52.38","15.16"
"10","017","00","005","0520","0000","2843","947","1896","91","2934","5387","0","54.46","17.58"
"10","017","00","005","0520","0126","1091","357","734","28","1119","2088","0","53.59","17.1"
"10","017","00","005","0520","0127","1030","354","676","16","1046","1946","0","53.75","18.19"
"10","017","00","005","0520","0128","722","236","486","47","769","1353","0","56.84","17.44"
"10","017","00","005","0521","0000","2829","924","1905","137","2966","5560","0","53.35","16.62"
"10","017","00","005","0521","0129","635","206","429","48","683","1317","0","51.86","15.64"
"10","017","00","005","0521","0130","474","162","312","22","496","870","0","57.01","18.62"
"10","017","00","005","0521","0131","702","221","481","21","723","1322","0","54.69","16.72"
"10","017","00","005","0521","0132","582","198","384","22","604","1295","0","46.64","15.29"
"10","017","00","005","0521","0133","436","137","299","24","460","756","0","60.85","18.12"
"10","017","00","005","0522","0000","1795","665","1130","94","1889","3815","0","49.52","17.43"
"10","017","00","005","0522","0124","920","321","599","65","985","1938","0","50.83","16.56"
"10","017","00","005","0522","0125","875","344","531","29","904","1877","0","48.16","18.33"
"10","017","00","005","0523","0000","259","77","182","13","272","459","0","59.26","16.78"
"10","017","00","005","0523","0119","259","77","182","13","272","459","0","59.26","16.78"
"10","017","00","005","0524","0000","2989","1007","1982","128","3117","6483","0","48.08","15.53"
"10","017","00","005","0524","0134","698","240","458","29","727","1602","0","45.38","14.98"
"10","017","00","005","0524","0135","711","231","480","38","749","1568","0","47.77","14.73"
"10","017","00","005","0524","0136","701","244","457","37","738","1404","0","52.56","17.38"
"10","017","00","005","0524","0137","879","292","587","24","903","1909","0","47.3","15.3"
"10","017","00","006","0000","0000","34938","12312","22626","1633","36571","70396","82263","51.95","17.49"
"10","017","00","006","0601","0000","560","177","383","30","590","1213","0","48.64","14.59"
"10","017","00","006","0601","0143","560","177","383","30","590","1213","0","48.64","14.59"
"10","017","00","006","0602","0000","450","135","315","17","467","1026","0","45.52","13.16"
"10","017","00","006","0602","0144","450","135","315","17","467","1026","0","45.52","13.16"
"10","017","00","006","0603","0000","615","194","421","50","665","1361","0","48.86","14.25"
"10","017","00","006","0603","0142","615","194","421","50","665","1361","0","48.86","14.25"
"10","017","00","006","0604","0000","554","169","385","73","627","1038","0","60.4","16.28"
"10","017","00","006","0604","0145","554","169","385","73","627","1038","0","60.4","16.28"
"10","017","00","006","0605","0000","464","187","277","51","515","897","0","57.41","20.85"
"10","017","00","006","0605","0146","464","187","277","51","515","897","0","57.41","20.85"
"10","017","00","006","0606","0000","906","303","603","76","982","2042","0","48.09","14.84"
"10","017","00","006","0606","0147","680","227","453","65","745","1401","0","53.18","16.2"
"10","017","00","006","0606","0148","226","76","150","11","237","641","0","36.97","11.86"
"10","017","00","006","0607","0000","944","318","626","61","1005","1944","0","51.7","16.36"
"10","017","00","006","0607","0149","697","234","463","45","742","1472","0","50.41","15.9"
"10","017","00","006","0607","0150","247","84","163","16","263","472","0","55.72","17.8"
"10","017","00","006","0608","0000","1535","548","987","90","1625","3250","0","50.0","16.86"
"10","017","00","006","0608","0153","880","312","568","46","926","1901","0","48.71","16.41"
"10","017","00","006","0608","0154","655","236","419","44","699","1349","0","51.82","17.49"
"10","017","00","006","0609","0000","476","161","315","25","501","841","0","59.57","19.14"
"10","017","00","006","0609","0151","476","161","315","25","501","841","0","59.57","19.14"
"10","017","00","006","0610","0000","277","108","169","26","303","571","0","53.06","18.91"
"10","017","00","006","0610","0152","277","108","169","26","303","571","0","53.06","18.91"
"10","017","00","006","0611","0000","1907","631","1276","92","1999","3922","0","50.97","16.09"
"10","017","00","006","0611","0179","1002","333","669","49","1051","1960","0","53.62","16.99"
"10","017","00","006","0611","0180","905","298","607","43","948","1962","0","48.32","15.19"
"10","017","00","006","0612","0000","812","304","508","32","844","1641","0","51.43","18.53"
"10","017","00","006","0612","0186","812","304","508","32","844","1641","0","51.43","18.53"
"10","017","00","006","0613","0000","2640","946","1694","107","2747","5289","0","51.94","17.89"
"10","017","00","006","0613","0187","626","203","423","35","661","1279","0","51.68","15.87"
"10","017","00","006","0613","0188","675","243","432","23","698","1360","0","51.32","17.87"
"10","017","00","006","0613","0189","738","277","461","26","764","1399","0","54.61","19.8"
"10","017","00","006","0613","0190","601","223","378","23","624","1251","0","49.88","17.83"
"10","017","00","006","0614","0000","1889","655","1234","100","1989","3946","0","50.41","16.6"
"10","017","00","006","0614","0181","1037","349","688","62","1099","2117","0","51.91","16.49"
"10","017","00","006","0614","0182","852","306","546","38","890","1829","0","48.66","16.73"
"10","017","00","006","0615","0000","1288","431","857","88","1376","2576","0","53.42","16.73"
"10","017","00","006","0615","0155","591","178","413","37","628","1225","0","51.27","14.53"
"10","017","00","006","0615","0156","697","253","444","51","748","1351","0","55.37","18.73"
"10","017","00","006","0616","0000","2563","895","1668","101","2664","4768","0","55.87","18.77"
"10","017","00","006","0616","0159","834","287","547","38","872","1613","0","54.06","17.79"
"10","017","00","006","0616","0160","908","302","606","36","944","1731","0","54.53","17.45"
"10","017","00","006","0616","0161","821","306","515","27","848","1424","0","59.55","21.49"
"10","017","00","006","0617","0000","1764","575","1189","100","1864","3485","0","53.49","16.5"
"10","017","00","006","0617","0162","880","279","601","49","929","1806","0","51.44","15.45"
"10","017","00","006","0617","0163","884","296","588","51","935","1679","0","55.69","17.63"
"10","017","00","006","0618","0000","1983","721","1262","78","2061","3942","0","52.28","18.29"
"10","017","00","006","0618","0164","981","360","621","42","1023","1902","0","53.79","18.93"
"10","017","00","006","0618","0165","1002","361","641","36","1038","2040","0","50.88","17.7"
"10","017","00","006","0619","0000","1261","437","824","72","1333","2556","0","52.15","17.1"
"10","017","00","006","0619","0166","672","240","432","38","710","1313","0","54.07","18.28"
"10","017","00","006","0619","0167","589","197","392","34","623","1243","0","50.12","15.85"
"10","017","00","006","0620","0000","1352","461","891","43","1395","2968","0","47.0","15.53"
"10","017","00","006","0620","0171","651","221","430","25","676","1557","0","43.42","14.19"
"10","017","00","006","0620","0172","701","240","461","18","719","1411","0","50.96","17.01"
"10","017","00","006","0621","0000","2279","759","1520","50","2329","4538","0","51.32","16.73"
"10","017","00","006","0621","0183","717","250","467","21","738","1529","0","48.27","16.35"
"10","017","00","006","0621","0184","933","304","629","20","953","1869","0","50.99","16.27"
"10","017","00","006","0621","0185","629","205","424","9","638","1140","0","55.96","17.98"
"10","017","00","006","0622","0000","1823","695","1128","69","1892","3319","0","57.01","20.94"
"10","017","00","006","0622","0168","872","327","545","31","903","1759","0","51.34","18.59"
"10","017","00","006","0622","0169","420","154","266","18","438","694","0","63.11","22.19"
"10","017","00","006","0622","0170","531","214","317","20","551","866","0","63.63","24.71"
"10","017","00","006","0623","0000","2119","706","1413","82","2201","4650","0","47.33","15.18"
"10","017","00","006","0623","0176","799","257","542","23","822","1673","0","49.13","15.36"
"10","017","00","006","0623","0177","530","167","363","30","560","1054","0","53.13","15.84"
"10","017","00","006","0623","0178","790","282","508","29","819","1923","0","42.59","14.66"
"10","017","00","006","0624","0000","2335","802","1533","66","2401","4499","0","53.37","17.83"
"10","017","00","006","0624","0173","867","302","565","23","890","1568","0","56.76","19.26"
"10","017","00","006","0624","0174","692","243","449","31","723","1400","0","51.64","17.36"
"10","017","00","006","0624","0175","776","257","519","12","788","1531","0","51.47","16.79"
"10","017","00","006","0625","0000","2142","994","1148","54","2196","4114","0","53.38","24.16"
"10","017","00","006","0625","0157","882","318","564","25","907","1601","0","56.65","19.86"
"10","017","00","006","0625","0158","1260","676","584","29","1289","2513","0","51.29","26.9"
"10","017","00","007","0000","0000","23120","7869","15251","1012","24132","46014","52487","52.44","17.1"
"10","017","00","007","0701","0000","583","217","366","33","616","1096","0","56.2","19.8"
"10","017","00","007","0701","0036","583","217","366","33","616","1096","0","56.2","19.8"
"10","017","00","007","0702","0000","693","258","435","37","730","1232","0","59.25","20.94"
"10","017","00","007","0702","0037","693","258","435","37","730","1232","0","59.25","20.94"
"10","017","00","007","0703","0000","638","244","394","20","658","1184","0","55.57","20.61"
"10","017","00","007","0703","0038","638","244","394","20","658","1184","0","55.57","20.61"
"10","017","00","007","0704","0000","1254","404","850","77","1331","2321","0","57.35","17.41"
"10","017","00","007","0704","0039","613","189","424","52","665","1133","0","58.69","16.68"
"10","017","00","007","0704","0040","641","215","426","25","666","1188","0","56.06","18.1"
"10","017","00","007","0705","0000","397","138","259","28","425","725","0","58.62","19.03"
"10","017","00","007","0705","0041","397","138","259","28","425","725","0","58.62","19.03"
"10","017","00","007","0706","0000","686","211","475","38","724","1524","0","47.51","13.85"
"10","017","00","007","0706","0042","686","211","475","38","724","1524","0","47.51","13.85"
"10","017","00","007","0707","0000","390","142","248","26","416","736","0","56.52","19.29"
"10","017","00","007","0707","0043","390","142","248","26","416","736","0","56.52","19.29"
"10","017","00","007","0708","0000","735","232","503","37","772","1562","0","49.42","14.85"
"10","017","00","007","0708","0044","302","103","199","21","323","611","0","52.86","16.86"
"10","017","00","007","0708","0045","433","129","304","16","449","951","0","47.21","13.56"
"10","017","00","007","0709","0000","816","264","552","34","850","1616","0","52.6","16.34"
"10","017","00","007","0709","0046","816","264","552","34","850","1616","0","52.6","16.34"
"10","017","00","007","0710","0000","787","276","511","35","822","1516","0","54.22","18.21"
"10","017","00","007","0710","0047","787","276","511","35","822","1516","0","54.22","18.21"
"10","017","00","007","0711","0000","1046","379","667","52","1098","2118","0","51.84","17.89"
"10","017","00","007","0711","0048","514","184","330","27","541","1049","0","51.57","17.54"
"10","017","00","007","0711","0049","532","195","337","25","557","1069","0","52.1","18.24"
"10","017","00","007","0712","0000","884","304","580","32","916","1763","0","51.96","17.24"
"10","017","00","007","0712","0054","501","169","332","22","523","999","0","52.35","16.92"
"10","017","00","007","0712","0055","383","135","248","10","393","764","0","51.44","17.67"
"10","017","00","007","0713","0000","1667","576","1091","68","1735","3570","0","48.6","16.13"
"10","017","00","007","0713","0056","706","240","466","44","750","1555","0","48.23","15.43"
"10","017","00","007","0713","0057","961","336","625","24","985","2015","0","48.88","16.67"
"10","017","00","007","0714","0000","1473","506","967","82","1555","2837","0","54.81","17.84"
"10","017","00","007","0714","0058","679","244","435","42","721","1268","0","56.86","19.24"
"10","017","00","007","0714","0059","794","262","532","40","834","1569","0","53.15","16.7"
"10","017","00","007","0715","0000","672","216","456","30","702","1295","0","54.21","16.68"
"10","017","00","007","0715","0071","672","216","456","30","702","1295","0","54.21","16.68"
"10","017","00","007","0716","0000","2312","862","1450","100","2412","4113","0","58.64","20.96"
"10","017","00","007","0716","0050","403","141","262","19","422","727","0","58.05","19.39"
"10","017","00","007","0716","0051","527","194","333","23","550","929","0","59.2","20.88"
"10","017","00","007","0716","0052","663","246","417","26","689","1118","0","61.63","22.0"
"10","017","00","007","0716","0053","719","281","438","32","751","1339","0","56.09","20.99"
"10","017","00","007","0717","0000","1556","489","1067","66","1622","3780","0","42.91","12.94"
"10","017","00","007","0717","0069","829","262","567","43","872","2016","0","43.25","13.0"
"10","017","00","007","0717","0070","727","227","500","23","750","1764","0","42.52","12.87"
"10","017","00","007","0718","0000","1709","534","1175","58","1767","3461","0","51.05","15.43"
"10","017","00","007","0718","0060","917","321","596","37","954","1985","0","48.06","16.17"
"10","017","00","007","0718","0061","792","213","579","21","813","1476","0","55.08","14.43"
"10","017","00","007","0719","0000","1146","346","800","61","1207","2494","0","48.4","13.87"
"10","017","00","007","0719","0067","650","193","457","35","685","1485","0","46.13","13.0"
"10","017","00","007","0719","0068","496","153","343","26","522","1009","0","51.73","15.16"
"10","017","00","007","0720","0000","3676","1271","2405","98","3774","7071","0","53.37","17.97"
"10","017","00","007","0720","0062","814","305","509","26","840","1493","0","56.26","20.43"
"10","017","00","007","0720","0063","744","271","473","14","758","1249","0","60.69","21.7"
"10","017","00","007","0720","0064","758","260","498","21","779","1559","0","49.97","16.68"
"10","017","00","007","0720","0065","556","201","355","13","569","1168","0","48.72","17.21"
"10","017","00","007","0720","0066","804","234","570","24","828","1602","0","51.69","14.61"
"10","018","00","000","0000","0000","190261","67231","123030","8894","199155","351775","444775","56.61","19.11"
"10","018","00","001","0000","0000","89843","32753","57090","3696","93539","163757","215079","57.12","20.0"
"10","018","00","001","0101","0000","397","147","250","24","421","714","0","58.96","20.59"
"10","018","00","001","0101","0101","397","147","250","24","421","714","0","58.96","20.59"
"10","018","00","001","0102","0000","759","248","511","40","799","1396","0","57.23","17.77"
"10","018","00","001","0102","0103","759","248","511","40","799","1396","0","57.23","17.77"
"10","018","00","001","0103","0000","482","162","320","37","519","875","0","59.31","18.51"
"10","018","00","001","0103","0102","482","162","320","37","519","875","0","59.31","18.51"
"10","018","00","001","0104","0000","264","91","173","9","273","507","0","53.85","17.95"
"10","018","00","001","0104","0100","264","91","173","9","273","507","0","53.85","17.95"
"10","018","00","001","0105","0000","328","118","210","25","353","566","0","62.37","20.85"
"10","018","00","001","0105","0004","328","118","210","25","353","566","0","62.37","20.85"
"10","018","00","001","0106","0000","158","60","98","15","173","305","0","56.72","19.67"
"10","018","00","001","0106","0006","158","60","98","15","173","305","0","56.72","19.67"
"10","018","00","001","0107","0000","361","128","233","14","375","640","0","58.59","20.0"
"10","018","00","001","0107","0005","361","128","233","14","375","640","0","58.59","20.0"
"10","018","00","001","0108","0000","287","85","202","15","302","475","0","63.58","17.89"
"10","018","00","001","0108","0113","287","85","202","15","302","475","0","63.58","17.89"
"10","018","00","001","0109","0000","416","141","275","39","455","752","0","60.51","18.75"
"10","018","00","001","0109","0112","416","141","275","39","455","752","0","60.51","18.75"
"10","018","00","001","0110","0000","376","117","259","32","408","710","0","57.46","16.48"
"10","018","00","001","0110","0111","376","117","259","32","408","710","0","57.46","16.48"
"10","018","00","001","0111","0000","501","191","310","10","511","1512","0","33.8","12.63"
"10","018","00","001","0111","0001","501","191","310","10","511","1512","0","33.8","12.63"
"10","018","00","001","0112","0000","326","108","218","20","346","563","0","61.46","19.18"
"10","018","00","001","0112","0007","326","108","218","20","346","563","0","61.46","19.18"
"10","018","00","001","0113","0000","1691","613","1078","71","1762","3123","0","56.42","19.63"
"10","018","00","001","0113","0027","838","330","508","35","873","1573","0","55.5","20.98"
"10","018","00","001","0113","0028","853","283","570","36","889","1550","0","57.35","18.26"
"10","018","00","001","0114","0000","1583","603","980","90","1673","2928","0","57.14","20.59"
"10","018","00","001","0114","0114","452","178","274","29","481","880","0","54.66","20.23"
"10","018","00","001","0114","0115","554","217","337","26","580","989","0","58.65","21.94"
"10","018","00","001","0114","0116","577","208","369","35","612","1059","0","57.79","19.64"
"10","018","00","001","0115","0000","783","312","471","65","848","1422","0","59.63","21.94"
"10","018","00","001","0115","0117","342","135","207","30","372","607","0","61.29","22.24"
"10","018","00","001","0115","0118","441","177","264","35","476","815","0","58.4","21.72"
"10","018","00","001","0116","0000","2739","1094","1645","114","2853","5524","0","51.65","19.8"
"10","018","00","001","0116","0104","635","239","396","29","664","1232","0","53.9","19.4"
"10","018","00","001","0116","0105","683","284","399","38","721","1323","0","54.5","21.47"
"10","018","00","001","0116","0106","705","271","434","18","723","1516","0","47.69","17.88"
"10","018","00","001","0116","0107","716","300","416","29","745","1453","0","51.27","20.65"
"10","018","00","001","0117","0000","979","365","614","30","1009","1682","0","59.99","21.7"
"10","018","00","001","0117","0002","574","222","352","12","586","953","0","61.49","23.29"
"10","018","00","001","0117","0003","405","143","262","18","423","729","0","58.02","19.62"
"10","018","00","001","0118","0000","2419","740","1679","95","2514","4456","0","56.42","16.61"
"10","018","00","001","0118","0010","844","291","553","30","874","1615","0","54.12","18.02"
"10","018","00","001","0118","0011","708","259","449","39","747","1287","0","58.04","20.12"
"10","018","00","001","0118","0012","867","190","677","26","893","1554","0","57.46","12.23"
"10","018","00","001","0119","0000","2339","860","1479","76","2415","4162","0","58.02","20.66"
"10","018","00","001","0119","0013","807","293","514","13","820","1388","0","59.08","21.11"
"10","018","00","001","0119","0014","816","290","526","24","840","1419","0","59.2","20.44"
"10","018","00","001","0119","0015","716","277","439","39","755","1355","0","55.72","20.44"
"10","018","00","001","0120","0000","2613","952","1661","151","2764","4714","0","58.63","20.2"
"10","018","00","001","0120","0019","594","234","360","26","620","1062","0","58.38","22.03"
"10","018","00","001","0120","0020","724","277","447","29","753","1315","0","57.26","21.06"
"10","018","00","001","0120","0021","536","175","361","59","595","1000","0","59.5","17.5"
"10","018","00","001","0120","0022","759","266","493","37","796","1337","0","59.54","19.9"
"10","018","00","001","0121","0000","3002","1187","1815","107","3109","5333","0","58.3","22.26"
"10","018","00","001","0121","0023","926","380","546","26","952","1747","0","54.49","21.75"
"10","018","00","001","0121","0024","940","392","548","20","960","1600","0","60.0","24.5"
"10","018","00","001","0121","0025","618","223","395","38","656","1158","0","56.65","19.26"
"10","018","00","001","0121","0026","518","192","326","23","541","828","0","65.34","23.19"
"10","018","00","001","0122","0000","1338","493","845","77","1415","2283","0","61.98","21.59"
"10","018","00","001","0122","0039","707","262","445","57","764","1271","0","60.11","20.61"
"10","018","00","001","0122","0040","631","231","400","20","651","1012","0","64.33","22.83"
"10","018","00","001","0123","0000","1346","504","842","99","1445","2604","0","55.49","19.35"
"10","018","00","001","0123","0041","540","188","352","48","588","1001","0","58.74","18.78"
"10","018","00","001","0123","0042","806","316","490","51","857","1603","0","53.46","19.71"
"10","018","00","001","0124","0000","2430","942","1488","108","2538","4297","0","59.06","21.92"
"10","018","00","001","0124","0050","672","278","394","34","706","1195","0","59.08","23.26"
"10","018","00","001","0124","0051","817","280","537","51","868","1569","0","55.32","17.85"
"10","018","00","001","0124","0052","941","384","557","23","964","1533","0","62.88","25.05"
"10","018","00","001","0125","0000","2325","726","1599","82","2407","3992","0","60.3","18.19"
"10","018","00","001","0125","0053","776","187","589","38","814","1336","0","60.93","14.0"
"10","018","00","001","0125","0054","778","243","535","27","805","1367","0","58.89","17.78"
"10","018","00","001","0125","0055","771","296","475","17","788","1289","0","61.13","22.96"
"10","018","00","001","0126","0000","3613","1309","2304","118","3731","6055","0","61.62","21.62"
"10","018","00","001","0126","0034","720","261","459","36","756","1262","0","59.9","20.68"
"10","018","00","001","0126","0035","676","226","450","15","691","1199","0","57.63","18.85"
"10","018","00","001","0126","0036","740","267","473","22","762","1226","0","62.15","21.78"
"10","018","00","001","0126","0037","859","321","538","28","887","1377","0","64.42","23.31"
"10","018","00","001","0126","0038","618","234","384","17","635","991","0","64.08","23.61"
"10","018","00","001","0127","0000","1788","623","1165","82","1870","3142","0","59.52","19.83"
"10","018","00","001","0127","0031","545","174","371","18","563","935","0","60.21","18.61"
"10","018","00","001","0127","0032","590","218","372","23","613","1074","0","57.08","20.3"
"10","018","00","001","0127","0033","653","231","422","41","694","1133","0","61.25","20.39"
"10","018","00","001","0128","0000","1779","609","1170","76","1855","3440","0","53.92","17.7"
"10","018","00","001","0128","0122","516","175","341","38","554","1062","0","52.17","16.48"
"10","018","00","001","0128","0123","589","208","381","21","610","1046","0","58.32","19.89"
"10","018","00","001","0128","0124","674","226","448","17","691","1332","0","51.88","16.97"
"10","018","00","001","0129","0000","1607","425","1182","87","1694","2999","0","56.49","14.17"
"10","018","00","001","0129","0108","482","61","421","35","517","880","0","58.75","6.93"
"10","018","00","001","0129","0109","552","171","381","26","578","1058","0","54.63","16.16"
"10","018","00","001","0129","0110","573","193","380","26","599","1061","0","56.46","18.19"
"10","018","00","001","0130","0000","2812","1052","1760","98","2910","5036","0","57.78","20.89"
"10","018","00","001","0130","0132","670","238","432","29","699","1315","0","53.16","18.1"
"10","018","00","001","0130","0133","788","301","487","27","815","1413","0","57.68","21.3"
"10","018","00","001","0130","0134","584","216","368","26","610","1064","0","57.33","20.3"
"10","018","00","001","0130","0135","770","297","473","16","786","1244","0","63.18","23.87"
"10","018","00","001","0131","0000","3021","1028","1993","118","3139","5678","0","55.28","18.1"
"10","018","00","001","0131","0125","742","253","489","40","782","1350","0","57.93","18.74"
"10","018","00","001","0131","0126","733","244","489","23","756","1438","0","52.57","16.97"
"10","018","00","001","0131","0127","711","216","495","31","742","1414","0","52.48","15.28"
"10","018","00","001","0131","0128","835","315","520","24","859","1476","0","58.2","21.34"
"10","018","00","001","0132","0000","709","265","444","15","724","1233","0","58.72","21.49"
"10","018","00","001","0132","0099","709","265","444","15","724","1233","0","58.72","21.49"
"10","018","00","001","0133","0000","1685","646","1039","79","1764","3003","0","58.74","21.51"
"10","018","00","001","0133","0063","640","236","404","37","677","1132","0","59.81","20.85"
"10","018","00","001","0133","0064","143","68","75","9","152","251","0","60.56","27.09"
"10","018","00","001","0133","0065","902","342","560","33","935","1620","0","57.72","21.11"
"10","018","00","001","0135","0000","493","139","354","27","520","915","0","56.83","15.19"
"10","018","00","001","0135","0059","493","139","354","27","520","915","0","56.83","15.19"
"10","018","00","001","0136","0000","1573","543","1030","74","1647","2751","0","59.87","19.74"
"10","018","00","001","0136","0056","518","173","345","22","540","960","0","56.25","18.02"
"10","018","00","001","0136","0057","530","195","335","9","539","843","0","63.94","23.13"
"10","018","00","001","0136","0058","525","175","350","43","568","948","0","59.92","18.46"
"10","018","00","001","0137","0000","2027","619","1408","69","2096","3556","0","58.94","17.41"
"10","018","00","001","0137","0060","1017","294","723","30","1047","1801","0","58.13","16.32"
"10","018","00","001","0137","0061","595","189","406","29","624","1079","0","57.83","17.52"
"10","018","00","001","0137","0062","415","136","279","10","425","676","0","62.87","20.12"
"10","018","00","001","0138","0000","1365","419","946","71","1436","2768","0","51.88","15.14"
"10","018","00","001","0138","0043","664","218","446","32","696","1236","0","56.31","17.64"
"10","018","00","001","0138","0044","701","201","500","39","740","1532","0","48.3","13.12"
"10","018","00","001","0139","0000","1812","621","1191","88","1900","3331","0","57.04","18.64"
"10","018","00","001","0139","0045","708","216","492","27","735","1306","0","56.28","16.54"
"10","018","00","001","0139","0046","584","203","381","45","629","1073","0","58.62","18.92"
"10","018","00","001","0139","0047","520","202","318","16","536","952","0","56.3","21.22"
"10","018","00","001","0140","0000","1017","317","700","64","1081","2076","0","52.07","15.27"
"10","018","00","001","0140","0048","599","192","407","46","645","1298","0","49.69","14.79"
"10","018","00","001","0140","0049","418","125","293","18","436","778","0","56.04","16.07"
"10","018","00","001","0141","0000","2449","1034","1415","83","2532","4669","0","54.23","22.15"
"10","018","00","001","0141","0077","657","228","429","18","675","1215","0","55.56","18.77"
"10","018","00","001","0141","0078","522","165","357","31","553","1067","0","51.83","15.46"
"10","018","00","001","0141","0079","645","330","315","15","660","1194","0","55.28","27.64"
"10","018","00","001","0141","0080","625","311","314","19","644","1193","0","53.98","26.07"
"10","018","00","001","0142","0000","4294","1860","2434","123","4417","7900","0","55.91","23.54"
"10","018","00","001","0142","0066","774","338","436","27","801","1479","0","54.16","22.85"
"10","018","00","001","0142","0067","733","316","417","23","756","1402","0","53.92","22.54"
"10","018","00","001","0142","0068","692","273","419","32","724","1280","0","56.56","21.33"
"10","018","00","001","0142","0069","719","338","381","13","732","1228","0","59.61","27.52"
"10","018","00","001","0142","0070","633","331","302","2","635","1157","0","54.88","28.61"
"10","018","00","001","0142","0071","743","264","479","26","769","1354","0","56.79","19.5"
"10","018","00","001","0143","0000","2917","1108","1809","122","3039","5242","0","57.97","21.14"
"10","018","00","001","0143","0081","752","291","461","53","805","1388","0","58.0","20.97"
"10","018","00","001","0143","0082","725","258","467","26","751","1267","0","59.27","20.36"
"10","018","00","001","0143","0083","721","259","462","22","743","1299","0","57.2","19.94"
"10","018","00","001","0143","0084","719","300","419","21","740","1288","0","57.45","23.29"
"10","018","00","001","0144","0000","2432","948","1484","86","2518","4240","0","59.39","22.36"
"10","018","00","001","0144","0096","834","308","526","33","867","1400","0","61.93","22.0"
"10","018","00","001","0144","0097","865","346","519","18","883","1473","0","59.95","23.49"
"10","018","00","001","0144","0098","733","294","439","35","768","1367","0","56.18","21.51"
"10","018","00","001","0145","0000","2595","914","1681","87","2682","5042","0","53.19","18.13"
"10","018","00","001","0145","0092","687","233","454","28","715","1323","0","54.04","17.61"
"10","018","00","001","0145","0093","630","181","449","20","650","1207","0","53.85","15.0"
"10","018","00","001","0145","0094","607","223","384","25","632","1264","0","50.0","17.64"
"10","018","00","001","0145","0095","671","277","394","14","685","1248","0","54.89","22.2"
"10","018","00","001","0146","0000","2455","843","1612","105","2560","4634","0","55.24","18.19"
"10","018","00","001","0146","0088","576","209","367","32","608","1135","0","53.57","18.41"
"10","018","00","001","0146","0089","584","187","397","25","609","1165","0","52.27","16.05"
"10","018","00","001","0146","0090","609","207","402","21","630","1124","0","56.05","18.42"
"10","018","00","001","0146","0091","686","240","446","27","713","1210","0","58.93","19.83"
"10","018","00","001","0147","0000","3842","1443","2399","115","3957","6262","0","63.19","23.04"
"10","018","00","001","0147","0072","856","352","504","26","882","1334","0","66.12","26.39"
"10","018","00","001","0147","0073","727","248","479","20","747","1234","0","60.53","20.1"
"10","018","00","001","0147","0074","867","309","558","25","892","1398","0","63.81","22.1"
"10","018","00","001","0147","0075","555","232","323","17","572","928","0","61.64","25.0"
"10","018","00","001","0147","0076","837","302","535","27","864","1368","0","63.16","22.08"
"10","018","00","001","0148","0000","1334","511","823","64","1398","2357","0","59.31","21.68"
"10","018","00","001","0148","0029","723","258","465","28","751","1317","0","57.02","19.59"
"10","018","00","001","0148","0030","611","253","358","36","647","1040","0","62.21","24.33"
"10","018","00","001","0149","0000","1767","608","1159","91","1858","3392","0","54.78","17.92"
"10","018","00","001","0149","0119","445","141","304","37","482","777","0","62.03","18.15"
"10","018","00","001","0149","0120","673","225","448","27","700","1399","0","50.04","16.08"
"10","018","00","001","0149","0121","649","242","407","27","676","1216","0","55.59","19.9"
"10","018","00","001","0150","0000","2626","918","1708","102","2728","4777","0","57.11","19.22"
"10","018","00","001","0150","0016","805","279","526","38","843","1490","0","56.58","18.72"
"10","018","00","001","0150","0017","887","310","577","31","918","1615","0","56.84","19.2"
"10","018","00","001","0150","0018","934","329","605","33","967","1672","0","57.83","19.68"
"10","018","00","001","0151","0000","995","385","610","25","1020","1782","0","57.24","21.6"
"10","018","00","001","0151","0008","413","151","262","8","421","741","0","56.82","20.38"
"10","018","00","001","0151","0009","582","234","348","17","599","1041","0","57.54","22.48"
"10","018","00","001","0152","0000","2073","755","1318","72","2145","3526","0","60.83","21.41"
"10","018","00","001","0152","0129","779","259","520","40","819","1326","0","61.76","19.53"
"10","018","00","001","0152","0130","580","238","342","16","596","927","0","64.29","25.67"
"10","018","00","001","0152","0131","714","258","456","16","730","1273","0","57.34","20.27"
"10","018","00","001","0153","0000","2338","806","1532","63","2401","4816","0","49.85","16.74"
"10","018","00","001","0153","0136","599","192","407","8","607","1160","0","52.33","16.55"
"10","018","00","001","0153","0137","670","236","434","12","682","1398","0","48.78","16.88"
"10","018","00","001","0153","0138","553","208","345","18","571","1384","0","41.26","15.03"
"10","018","00","001","0153","0139","516","170","346","25","541","874","0","61.9","19.45"
"10","018","00","001","0154","0000","2183","1018","1165","47","2230","3600","0","61.94","28.28"
"10","018","00","001","0154","0085","734","349","385","17","751","1228","0","61.16","28.42"
"10","018","00","001","0154","0086","680","311","369","11","691","1135","0","60.88","27.4"
"10","018","00","001","0154","0087","769","358","411","19","788","1237","0","63.7","28.94"
"10","018","00","002","0000","0000","65825","22925","42900","3223","69048","123122","151391","56.08","18.62"
"10","018","00","002","0201","0000","307","111","196","15","322","535","0","60.19","20.75"
"10","018","00","002","0201","0141","307","111","196","15","322","535","0","60.19","20.75"
"10","018","00","002","0202","0000","417","144","273","26","443","711","0","62.31","20.25"
"10","018","00","002","0202","0144","417","144","273","26","443","711","0","62.31","20.25"
"10","018","00","002","0203","0000","410","149","261","34","444","746","0","59.52","19.97"
"10","018","00","002","0203","0142","410","149","261","34","444","746","0","59.52","19.97"
"10","018","00","002","0204","0000","249","107","142","10","259","477","0","54.3","22.43"
"10","018","00","002","0204","0140","249","107","142","10","259","477","0","54.3","22.43"
"10","018","00","002","0205","0000","561","192","369","29","590","1143","0","51.62","16.8"
"10","018","00","002","0205","0145","561","192","369","29","590","1143","0","51.62","16.8"
"10","018","00","002","0206","0000","282","104","178","16","298","546","0","54.58","19.05"
"10","018","00","002","0206","0143","282","104","178","16","298","546","0","54.58","19.05"
"10","018","00","002","0207","0000","686","243","443","33","719","1370","0","52.48","17.74"
"10","018","00","002","0207","0146","686","243","443","33","719","1370","0","52.48","17.74"
"10","018","00","002","0208","0000","496","164","332","40","536","957","0","56.01","17.14"
"10","018","00","002","0208","0172","496","164","332","40","536","957","0","56.01","17.14"
"10","018","00","002","0209","0000","333","125","208","30","363","561","0","64.71","22.28"
"10","018","00","002","0209","0169","333","125","208","30","363","561","0","64.71","22.28"
"10","018","00","002","0210","0000","459","169","290","21","480","761","0","63.07","22.21"
"10","018","00","002","0210","0167","459","169","290","21","480","761","0","63.07","22.21"
"10","018","00","002","0211","0000","436","167","269","33","469","788","0","59.52","21.19"
"10","018","00","002","0211","0168","436","167","269","33","469","788","0","59.52","21.19"
"10","018","00","002","0212","0000","667","260","407","33","700","1398","0","50.07","18.6"
"10","018","00","002","0212","0171","667","260","407","33","700","1398","0","50.07","18.6"
"10","018","00","002","0213","0000","759","277","482","68","827","1558","0","53.08","17.78"
"10","018","00","002","0213","0170","759","277","482","68","827","1558","0","53.08","17.78"
"10","018","00","002","0214","0000","2487","878","1609","121","2608","4800","0","54.33","18.29"
"10","018","00","002","0214","0173","654","212","442","31","685","1195","0","57.32","17.74"
"10","018","00","002","0214","0174","586","235","351","28","614","1236","0","49.68","19.01"
"10","018","00","002","0214","0175","622","206","416","46","668","1255","0","53.23","16.41"
"10","018","00","002","0214","0176","625","225","400","16","641","1114","0","57.54","20.2"
"10","018","00","002","0215","0000","1537","575","962","60","1597","2949","0","54.15","19.5"
"10","018","00","002","0215","0188","740","274","466","26","766","1457","0","52.57","18.81"
"10","018","00","002","0215","0189","797","301","496","34","831","1492","0","55.7","20.17"
"10","018","00","002","0216","0000","1986","701","1285","100","2086","3906","0","53.41","17.95"
"10","018","00","002","0216","0185","598","205","393","20","618","1272","0","48.58","16.12"
"10","018","00","002","0216","0186","682","235","447","44","726","1306","0","55.59","17.99"
"10","018","00","002","0216","0187","706","261","445","36","742","1328","0","55.87","19.65"
"10","018","00","002","0217","0000","1161","393","768","115","1276","2131","0","59.88","18.44"
"10","018","00","002","0217","0190","658","229","429","44","702","1160","0","60.52","19.74"
"10","018","00","002","0217","0191","503","164","339","71","574","971","0","59.11","16.89"
"10","018","00","002","0218","0000","893","295","598","52","945","1651","0","57.24","17.87"
"10","018","00","002","0218","0228","498","171","327","23","521","946","0","55.07","18.08"
"10","018","00","002","0218","0229","395","124","271","29","424","705","0","60.14","17.59"
"10","018","00","002","0219","0000","2093","749","1344","102","2195","3852","0","56.98","19.44"
"10","018","00","002","0219","0221","647","247","400","30","677","1175","0","57.62","21.02"
"10","018","00","002","0219","0222","773","277","496","21","794","1371","0","57.91","20.2"
"10","018","00","002","0219","0223","673","225","448","51","724","1306","0","55.44","17.23"
"10","018","00","002","0220","0000","432","145","287","73","505","848","0","59.55","17.1"
"10","018","00","002","0220","0230","432","145","287","73","505","848","0","59.55","17.1"
"10","018","00","002","0221","0000","1489","540","949","59","1548","2712","0","57.08","19.91"
"10","018","00","002","0221","0199","774","275","499","31","805","1442","0","55.83","19.07"
"10","018","00","002","0221","0200","715","265","450","28","743","1270","0","58.5","20.87"
"10","018","00","002","0222","0000","3407","1367","2040","141","3548","5949","0","59.64","22.98"
"10","018","00","002","0222","0208","619","240","379","15","634","1106","0","57.32","21.7"
"10","018","00","002","0222","0209","609","323","286","21","630","1044","0","60.34","30.94"
"10","018","00","002","0222","0210","606","233","373","24","630","1061","0","59.38","21.96"
"10","018","00","002","0222","0211","844","315","529","52","896","1518","0","59.03","20.75"
"10","018","00","002","0222","0212","729","256","473","29","758","1220","0","62.13","20.98"
"10","018","00","002","0223","0000","2744","745","1999","99","2843","4623","0","61.5","16.12"
"10","018","00","002","0223","0217","596","162","434","17","613","1059","0","57.88","15.3"
"10","018","00","002","0223","0218","657","189","468","29","686","1130","0","60.71","16.73"
"10","018","00","002","0223","0219","750","222","528","31","781","1208","0","64.65","18.38"
"10","018","00","002","0223","0220","741","172","569","22","763","1226","0","62.23","14.03"
"10","018","00","002","0224","0000","2814","935","1879","114","2928","5718","0","51.21","16.35"
"10","018","00","002","0224","0231","672","233","439","21","693","1295","0","53.51","17.99"
"10","018","00","002","0224","0232","734","215","519","23","757","1467","0","51.6","14.66"
"10","018","00","002","0224","0233","738","256","482","38","776","1659","0","46.78","15.43"
"10","018","00","002","0224","0234","670","231","439","32","702","1297","0","54.12","17.81"
"10","018","00","002","0225","0000","312","104","208","35","347","594","0","58.42","17.51"
"10","018","00","002","0225","0244","312","104","208","35","347","594","0","58.42","17.51"
"10","018","00","002","0226","0000","1526","537","989","112","1638","2831","0","57.86","18.97"
"10","018","00","002","0226","0235","737","254","483","54","791","1374","0","57.57","18.49"
"10","018","00","002","0226","0236","789","283","506","58","847","1457","0","58.13","19.42"
"10","018","00","002","0227","0000","736","226","510","70","806","1609","0","50.09","14.05"
"10","018","00","002","0227","0243","736","226","510","70","806","1609","0","50.09","14.05"
"10","018","00","002","0228","0000","1893","613","1280","78","1971","3393","0","58.09","18.07"
"10","018","00","002","0228","0237","607","187","420","26","633","1072","0","59.05","17.44"
"10","018","00","002","0228","0238","690","231","459","35","725","1350","0","53.7","17.11"
"10","018","00","002","0228","0239","596","195","401","17","613","971","0","63.13","20.08"
"10","018","00","002","0229","0000","2006","635","1371","117","2123","3723","0","57.02","17.06"
"10","018","00","002","0229","0240","793","247","546","59","852","1450","0","58.76","17.03"
"10","018","00","002","0229","0241","486","150","336","27","513","895","0","57.32","16.76"
"10","018","00","002","0229","0242","727","238","489","31","758","1378","0","55.01","17.27"
"10","018","00","002","0230","0000","964","241","723","42","1006","1766","0","56.96","13.65"
"10","018","00","002","0230","0158","621","181","440","24","645","1128","0","57.18","16.05"
"10","018","00","002","0230","0159","343","60","283","18","361","638","0","56.58","9.4"
"10","018","00","002","0231","0000","1928","717","1211","69","1997","3589","0","55.64","19.98"
"10","018","00","002","0231","0147","718","246","472","36","754","1390","0","54.24","17.7"
"10","018","00","002","0231","0148","537","195","342","17","554","962","0","57.59","20.27"
"10","018","00","002","0231","0149","673","276","397","16","689","1237","0","55.7","22.31"
"10","018","00","002","0232","0000","2543","846","1697","124","2667","5156","0","51.73","16.41"
"10","018","00","002","0232","0151","368","116","252","13","381","758","0","50.26","15.3"
"10","018","00","002","0232","0152","665","226","439","20","685","1320","0","51.89","17.12"
"10","018","00","002","0232","0153","710","247","463","58","768","1519","0","50.56","16.26"
"10","018","00","002","0232","0154","130","47","83","3","133","347","0","38.33","13.54"
"10","018","00","002","0232","0155","670","210","460","30","700","1212","0","57.76","17.33"
"10","018","00","002","0233","0000","1495","546","949","84","1579","2912","0","54.22","18.75"
"10","018","00","002","0233","0156","767","274","493","27","794","1484","0","53.5","18.46"
"10","018","00","002","0233","0157","728","272","456","57","785","1428","0","54.97","19.05"
"10","018","00","002","0234","0000","2174","754","1420","99","2273","4121","0","55.16","18.3"
"10","018","00","002","0234","0163","737","232","505","29","766","1394","0","54.95","16.64"
"10","018","00","002","0234","0164","766","271","495","35","801","1568","0","51.08","17.28"
"10","018","00","002","0234","0165","671","251","420","35","706","1159","0","60.91","21.66"
"10","018","00","002","0235","0000","104","34","70","1","105","252","0","41.67","13.49"
"10","018","00","002","0235","0166","104","34","70","1","105","252","0","41.67","13.49"
"10","018","00","002","0236","0000","2635","843","1792","114","2749","4656","0","59.04","18.11"
"10","018","00","002","0236","0224","698","213","485","21","719","1340","0","53.66","15.9"
"10","018","00","002","0236","0225","646","242","404","38","684","1111","0","61.57","21.78"
"10","018","00","002","0236","0226","740","244","496","27","767","1197","0","64.08","20.38"
"10","018","00","002","0236","0227","551","144","407","28","579","1008","0","57.44","14.29"
"10","018","00","002","0237","0000","2810","987","1823","124","2934","5296","0","55.4","18.64"
"10","018","00","002","0237","0177","752","263","489","27","779","1396","0","55.8","18.84"
"10","018","00","002","0237","0178","797","270","527","42","839","1456","0","57.62","18.54"
"10","018","00","002","0237","0179","721","268","453","24","745","1374","0","54.22","19.51"
"10","018","00","002","0237","0180","540","186","354","31","571","1070","0","53.36","17.38"
"10","018","00","002","0238","0000","2446","764","1682","138","2584","4524","0","57.12","16.89"
"10","018","00","002","0238","0181","599","172","427","42","641","1142","0","56.13","15.06"
"10","018","00","002","0238","0182","568","202","366","18","586","1103","0","53.13","18.31"
"10","018","00","002","0238","0183","623","198","425","58","681","1190","0","57.23","16.64"
"10","018","00","002","0238","0184","656","192","464","20","676","1089","0","62.08","17.63"
"10","018","00","002","0239","0000","1972","724","1248","71","2043","4112","0","49.68","17.61"
"10","018","00","002","0239","0192","447","158","289","13","460","1401","0","32.83","11.28"
"10","018","00","002","0239","0193","747","288","459","28","775","1340","0","57.84","21.49"
"10","018","00","002","0239","0194","778","278","500","30","808","1371","0","58.94","20.28"
"10","018","00","002","0240","0000","2592","1011","1581","89","2681","4793","0","55.94","21.09"
"10","018","00","002","0240","0195","573","258","315","26","599","1267","0","47.28","20.36"
"10","018","00","002","0240","0196","658","247","411","22","680","1073","0","63.37","23.02"
"10","018","00","002","0240","0197","657","228","429","22","679","1159","0","58.58","19.67"
"10","018","00","002","0240","0198","704","278","426","19","723","1294","0","55.87","21.48"
"10","018","00","002","0241","0000","3167","1072","2095","101","3268","5721","0","57.12","18.74"
"10","018","00","002","0241","0213","839","315","524","15","854","1475","0","57.9","21.36"
"10","018","00","002","0241","0214","711","221","490","38","749","1373","0","54.55","16.1"
"10","018","00","002","0241","0215","811","262","549","25","836","1450","0","57.66","18.07"
"10","018","00","002","0241","0216","806","274","532","23","829","1423","0","58.26","19.26"
"10","018","00","002","0242","0000","3580","1418","2162","108","3688","6417","0","57.47","22.1"
"10","018","00","002","0242","0203","648","228","420","29","677","1163","0","58.21","19.6"
"10","018","00","002","0242","0204","723","290","433","14","737","1334","0","55.25","21.74"
"10","018","00","002","0242","0205","770","329","441","26","796","1415","0","56.25","23.25"
"10","018","00","002","0242","0206","780","326","454","16","796","1305","0","61.0","24.98"
"10","018","00","002","0242","0207","659","245","414","23","682","1200","0","56.83","20.42"
"10","018","00","002","0243","0000","1285","445","840","68","1353","2128","0","63.58","20.91"
"10","018","00","002","0243","0201","716","255","461","39","755","1179","0","64.04","21.63"
"10","018","00","002","0243","0202","569","190","379","29","598","949","0","63.01","20.02"
"10","018","00","002","0244","0000","734","279","455","62","796","1604","0","49.63","17.39"
"10","018","00","002","0244","0150","734","279","455","62","796","1604","0","49.63","17.39"
"10","018","00","002","0245","0000","1818","594","1224","93","1911","3235","0","59.07","18.36"
"10","018","00","002","0245","0160","669","182","487","46","715","1222","0","58.51","14.89"
"10","018","00","002","0245","0161","566","215","351","26","592","1076","0","55.02","19.98"
"10","018","00","002","0245","0162","583","197","386","21","604","937","0","64.46","21.02"
"10","018","00","003","0000","0000","34593","11553","23040","1975","36568","64896","78305","56.35","17.8"
"10","018","00","003","0301","0000","1394","425","969","117","1511","2513","0","60.13","16.91"
"10","018","00","003","0301","0271","596","187","409","60","656","1182","0","55.5","15.82"
"10","018","00","003","0301","0272","798","238","560","57","855","1331","0","64.24","17.88"
"10","018","00","003","0302","0000","2789","866","1923","166","2955","5255","0","56.23","16.48"
"10","018","00","003","0302","0266","561","177","384","47","608","1088","0","55.88","16.27"
"10","018","00","003","0302","0267","440","157","283","19","459","903","0","50.83","17.39"
"10","018","00","003","0302","0268","555","175","380","36","591","1012","0","58.4","17.29"
"10","018","00","003","0302","0269","542","146","396","41","583","1014","0","57.5","14.4"
"10","018","00","003","0302","0270","691","211","480","23","714","1238","0","57.67","17.04"
"10","018","00","003","0303","0000","1247","390","857","71","1318","2288","0","57.6","17.05"
"10","018","00","003","0303","0264","521","140","381","32","553","970","0","57.01","14.43"
"10","018","00","003","0303","0265","726","250","476","39","765","1318","0","58.04","18.97"
"10","018","00","003","0304","0000","1379","469","910","111","1490","2371","0","62.84","19.78"
"10","018","00","003","0304","0262","745","238","507","55","800","1348","0","59.35","17.66"
"10","018","00","003","0304","0263","634","231","403","56","690","1023","0","67.45","22.58"
"10","018","00","003","0305","0000","1211","503","708","104","1315","2095","0","62.77","24.01"
"10","018","00","003","0305","0260","643","313","330","50","693","1138","0","60.9","27.5"
"10","018","00","003","0305","0261","568","190","378","54","622","957","0","64.99","19.85"
"10","018","00","003","0306","0000","1759","632","1127","106","1865","3128","0","59.62","20.2"
"10","018","00","003","0306","0257","574","210","364","22","596","1067","0","55.86","19.68"
"10","018","00","003","0306","0258","498","173","325","31","529","863","0","61.3","20.05"
"10","018","00","003","0306","0259","687","249","438","53","740","1198","0","61.77","20.78"
"10","018","00","003","0307","0000","1588","535","1053","67","1655","2881","0","57.45","18.57"
"10","018","00","003","0307","0252","814","282","532","41","855","1473","0","58.04","19.14"
"10","018","00","003","0307","0253","774","253","521","26","800","1408","0","56.82","17.97"
"10","018","00","003","0308","0000","2261","751","1510","88","2349","4517","0","52.0","16.63"
"10","018","00","003","0308","0254","621","201","420","20","641","1318","0","48.63","15.25"
"10","018","00","003","0308","0255","713","233","480","41","754","1337","0","56.39","17.43"
"10","018","00","003","0308","0256","927","317","610","27","954","1862","0","51.24","17.02"
"10","018","00","003","0309","0000","2631","930","1701","104","2735","4959","0","55.15","18.75"
"10","018","00","003","0309","0245","736","240","496","48","784","1443","0","54.33","16.63"
"10","018","00","003","0309","0246","655","244","411","30","685","1241","0","55.2","19.66"
"10","018","00","003","0309","0247","646","224","422","15","661","1194","0","55.36","18.76"
"10","018","00","003","0309","0248","594","222","372","11","605","1081","0","55.97","20.54"
"10","018","00","003","0310","0000","2226","827","1399","95","2321","3917","0","59.25","21.11"
"10","018","00","003","0310","0273","619","253","366","14","633","976","0","64.86","25.92"
"10","018","00","003","0310","0274","437","146","291","18","455","834","0","54.56","17.51"
"10","018","00","003","0310","0275","497","155","342","33","530","919","0","57.67","16.87"
"10","018","00","003","0310","0276","673","273","400","30","703","1188","0","59.18","22.98"
"10","018","00","003","0311","0000","1891","640","1251","112","2003","3342","0","59.93","19.15"
"10","018","00","003","0311","0277","587","183","404","43","630","1086","0","58.01","16.85"
"10","018","00","003","0311","0278","677","246","431","37","714","1144","0","62.41","21.5"
"10","018","00","003","0311","0279","627","211","416","32","659","1112","0","59.26","18.97"
"10","018","00","003","0312","0000","2367","760","1607","111","2478","4231","0","58.57","17.96"
"10","018","00","003","0312","0280","810","274","536","45","855","1476","0","57.93","18.56"
"10","018","00","003","0312","0281","695","226","469","24","719","1291","0","55.69","17.51"
"10","018","00","003","0312","0282","862","260","602","42","904","1464","0","61.75","17.76"
"10","018","00","003","0313","0000","1495","453","1042","75","1570","2763","0","56.82","16.4"
"10","018","00","003","0313","0283","785","222","563","60","845","1427","0","59.22","15.56"
"10","018","00","003","0313","0284","710","231","479","15","725","1336","0","54.27","17.29"
"10","018","00","003","0314","0000","536","179","357","32","568","1131","0","50.22","15.83"
"10","018","00","003","0314","0285","536","179","357","32","568","1131","0","50.22","15.83"
"10","018","00","003","0315","0000","1150","360","790","119","1269","2076","0","61.13","17.34"
"10","018","00","003","0315","0286","599","190","409","50","649","1070","0","60.65","17.76"
"10","018","00","003","0315","0287","551","170","381","69","620","1006","0","61.63","16.9"
"10","018","00","003","0316","0000","1155","355","800","58","1213","2342","0","51.79","15.16"
"10","018","00","003","0316","0288","542","157","385","35","577","1223","0","47.18","12.84"
"10","018","00","003","0316","0289","613","198","415","23","636","1119","0","56.84","17.69"
"10","018","00","003","0317","0000","443","138","305","21","464","896","0","51.79","15.4"
"10","018","00","003","0317","0299","443","138","305","21","464","896","0","51.79","15.4"
"10","018","00","003","0318","0000","487","156","331","29","516","890","0","57.98","17.53"
"10","018","00","003","0318","0298","487","156","331","29","516","890","0","57.98","17.53"
"10","018","00","003","0319","0000","387","121","266","50","437","776","0","56.31","15.59"
"10","018","00","003","0319","0297","387","121","266","50","437","776","0","56.31","15.59"
"10","018","00","003","0320","0000","884","281","603","40","924","1784","0","51.79","15.75"
"10","018","00","003","0320","0295","378","111","267","24","402","719","0","55.91","15.44"
"10","018","00","003","0320","0296","506","170","336","16","522","1065","0","49.01","15.96"
"10","018","00","003","0321","0000","2017","670","1347","123","2140","4325","0","49.48","15.49"
"10","018","00","003","0321","0291","740","251","489","36","776","1627","0","47.7","15.43"
"10","018","00","003","0321","0292","608","209","399","41","649","1289","0","50.35","16.21"
"10","018","00","003","0321","0293","669","210","459","46","715","1409","0","50.75","14.9"
"10","018","00","003","0322","0000","666","228","438","37","703","1400","0","50.21","16.29"
"10","018","00","003","0322","0290","666","228","438","37","703","1400","0","50.21","16.29"
"10","018","00","003","0323","0000","391","129","262","30","421","814","0","51.72","15.85"
"10","018","00","003","0323","0294","391","129","262","30","421","814","0","51.72","15.85"
"10","018","00","003","0324","0000","2239","755","1484","109","2348","4202","0","55.88","17.97"
"10","018","00","003","0324","0249","453","146","307","22","475","807","0","58.86","18.09"
"10","018","00","003","0324","0250","910","314","596","50","960","1760","0","54.55","17.84"
"10","018","00","003","0324","0251","876","295","581","37","913","1635","0","55.84","18.04"
"10","020","00","000","0000","0000","115195","39449","75746","5781","120976","221553","268741","54.6","17.81"
"10","020","00","001","0000","0000","52093","18474","33619","2560","54653","100647","121279","54.3","18.36"
"10","020","00","001","0101","0000","2292","788","1504","122","2414","4386","0","55.04","17.97"
"10","020","00","001","0101","0079","638","214","424","49","687","1282","0","53.59","16.69"
"10","020","00","001","0101","0080","884","279","605","47","931","1571","0","59.26","17.76"
"10","020","00","001","0101","0081","770","295","475","26","796","1533","0","51.92","19.24"
"10","020","00","001","0102","0000","1508","536","972","52","1560","3393","0","45.98","15.8"
"10","020","00","001","0102","0077","763","272","491","19","782","1823","0","42.9","14.92"
"10","020","00","001","0102","0078","745","264","481","33","778","1570","0","49.55","16.82"
"10","020","00","001","0103","0000","1397","507","890","46","1443","2832","0","50.95","17.9"
"10","020","00","001","0103","0075","625","237","388","20","645","1404","0","45.94","16.88"
"10","020","00","001","0103","0076","772","270","502","26","798","1428","0","55.88","18.91"
"10","020","00","001","0104","0000","1630","525","1105","114","1744","3249","0","53.68","16.16"
"10","020","00","001","0104","0069","820","280","540","62","882","1682","0","52.44","16.65"
"10","020","00","001","0104","0070","810","245","565","52","862","1567","0","55.01","15.63"
"10","020","00","001","0105","0000","1237","438","799","39","1276","2188","0","58.32","20.02"
"10","020","00","001","0105","0071","668","238","430","18","686","1207","0","56.84","19.72"
"10","020","00","001","0105","0072","569","200","369","21","590","981","0","60.14","20.39"
"10","020","00","001","0134","0000","2261","710","1551","112","2373","4205","0","56.43","16.88"
"10","020","00","001","0134","0021","618","195","423","37","655","1199","0","54.63","16.26"
"10","020","00","001","0134","0022","672","184","488","20","692","1236","0","55.99","14.89"
"10","020","00","001","0134","0023","470","162","308","21","491","890","0","55.17","18.2"
"10","020","00","001","0134","0024","501","169","332","34","535","880","0","60.8","19.2"
"10","020","00","001","0135","0000","2313","1021","1292","116","2429","4172","0","58.22","24.47"
"10","020","00","001","0135","0018","875","299","576","40","915","1552","0","58.96","19.27"
"10","020","00","001","0135","0019","844","316","528","46","890","1558","0","57.12","20.28"
"10","020","00","001","0135","0020","594","406","188","30","624","1062","0","58.76","38.23"
"10","020","00","001","0136","0000","2065","696","1369","71","2136","3967","0","53.84","17.54"
"10","020","00","001","0136","0015","711","256","455","31","742","1453","0","51.07","17.62"
"10","020","00","001","0136","0016","572","178","394","14","586","1094","0","53.56","16.27"
"10","020","00","001","0136","0017","782","262","520","26","808","1420","0","56.9","18.45"
"10","020","00","001","0137","0000","1315","499","816","31","1346","2334","0","57.67","21.38"
"10","020","00","001","0137","0011","705","271","434","14","719","1221","0","58.89","22.19"
"10","020","00","001","0137","0012","610","228","382","17","627","1113","0","56.33","20.49"
"10","020","00","001","0138","0000","997","351","646","45","1042","1794","0","58.08","19.57"
"10","020","00","001","0138","0005","420","153","267","18","438","702","0","62.39","21.79"
"10","020","00","001","0138","0006","577","198","379","27","604","1092","0","55.31","18.13"
"10","020","00","001","0139","0000","2290","719","1571","82","2372","4239","0","55.96","16.96"
"10","020","00","001","0139","0027","759","276","483","29","788","1435","0","54.91","19.23"
"10","020","00","001","0139","0028","790","192","598","24","814","1349","0","60.34","14.23"
"10","020","00","001","0139","0029","741","251","490","29","770","1455","0","52.92","17.25"
"10","020","00","001","0141","0000","902","297","605","37","939","1816","0","51.71","16.35"
"10","020","00","001","0141","0008","902","297","605","37","939","1816","0","51.71","16.35"
"10","020","00","001","0142","0000","461","149","312","20","481","1023","0","47.02","14.57"
"10","020","00","001","0142","0007","461","149","312","20","481","1023","0","47.02","14.57"
"10","020","00","001","0143","0000","1639","587","1052","52","1691","2847","0","59.4","20.62"
"10","020","00","001","0143","0013","804","285","519","27","831","1452","0","57.23","19.63"
"10","020","00","001","0143","0014","835","302","533","25","860","1395","0","61.65","21.65"
"10","020","00","001","0144","0000","1226","442","784","46","1272","2301","0","55.28","19.21"
"10","020","00","001","0144","0001","567","201","366","24","591","1025","0","57.66","19.61"
"10","020","00","001","0144","0002","659","241","418","22","681","1276","0","53.37","18.89"
"10","020","00","001","0145","0000","1052","371","681","36","1088","1987","0","54.76","18.67"
"10","020","00","001","0145","0042","492","167","325","14","506","938","0","53.94","17.8"
"10","020","00","001","0145","0043","560","204","356","22","582","1049","0","55.48","19.45"
"10","020","00","001","0146","0000","656","228","428","55","711","1360","0","52.28","16.76"
"10","020","00","001","0146","0044","656","228","428","55","711","1360","0","52.28","16.76"
"10","020","00","001","0147","0000","312","169","143","76","388","1615","0","24.02","10.46"
"10","020","00","001","0147","0045","312","169","143","76","388","1615","0","24.02","10.46"
"10","020","00","001","0148","0000","650","244","406","31","681","1267","0","53.75","19.26"
"10","020","00","001","0148","0046","650","244","406","31","681","1267","0","53.75","19.26"
"10","020","00","001","0149","0000","1593","553","1040","115","1708","3410","0","50.09","16.22"
"10","020","00","001","0149","0047","711","230","481","53","764","1579","0","48.39","14.57"
"10","020","00","001","0149","0048","882","323","559","62","944","1831","0","51.56","17.64"
"10","020","00","001","0150","0000","1134","403","731","29","1163","2146","0","54.19","18.78"
"10","020","00","001","0150","0049","547","173","374","25","572","977","0","58.55","17.71"
"10","020","00","001","0150","0050","587","230","357","4","591","1169","0","50.56","19.67"
"10","020","00","001","0151","0000","1357","482","875","90","1447","2504","0","57.79","19.25"
"10","020","00","001","0151","0051","667","249","418","71","738","1238","0","59.61","20.11"
"10","020","00","001","0151","0052","690","233","457","19","709","1266","0","56.0","18.4"
"10","020","00","001","0152","0000","1317","417","900","65","1382","2717","0","50.86","15.35"
"10","020","00","001","0152","0053","639","180","459","40","679","1429","0","47.52","12.6"
"10","020","00","001","0152","0054","678","237","441","25","703","1288","0","54.58","18.4"
"10","020","00","001","0153","0000","1273","449","824","77","1350","2347","0","57.52","19.13"
"10","020","00","001","0153","0060","576","198","378","32","608","1170","0","51.97","16.92"
"10","020","00","001","0153","0061","697","251","446","45","742","1177","0","63.04","21.33"
"10","020","00","001","0154","0000","2076","721","1355","87","2163","3893","0","55.56","18.52"
"10","020","00","001","0154","0057","630","199","431","33","663","1133","0","58.52","17.56"
"10","020","00","001","0154","0058","662","229","433","34","696","1235","0","56.36","18.54"
"10","020","00","001","0154","0059","784","293","491","20","804","1525","0","52.72","19.21"
"10","020","00","001","0155","0000","1916","635","1281","163","2079","3667","0","56.69","17.32"
"10","020","00","001","0155","0062","640","215","425","46","686","1207","0","56.84","17.81"
"10","020","00","001","0155","0063","682","219","463","37","719","1272","0","56.53","17.22"
"10","020","00","001","0155","0064","594","201","393","80","674","1188","0","56.73","16.92"
"10","020","00","001","0156","0000","1149","375","774","108","1257","2101","0","59.83","17.85"
"10","020","00","001","0156","0040","571","200","371","44","615","1023","0","60.12","19.55"
"10","020","00","001","0156","0041","578","175","403","64","642","1078","0","59.55","16.23"
"10","020","00","001","0157","0000","868","291","577","65","933","1824","0","51.15","15.95"
"10","020","00","001","0157","0038","537","172","365","41","578","961","0","60.15","17.9"
"10","020","00","001","0157","0039","331","119","212","24","355","863","0","41.14","13.79"
"10","020","00","001","0158","0000","1022","376","646","52","1074","2058","0","52.19","18.27"
"10","020","00","001","0158","0036","461","171","290","27","488","967","0","50.47","17.68"
"10","020","00","001","0158","0037","561","205","356","25","586","1091","0","53.71","18.79"
"10","020","00","001","0159","0000","1041","379","662","65","1106","2021","0","54.73","18.75"
"10","020","00","001","0159","0032","491","175","316","40","531","941","0","56.43","18.6"
"10","020","00","001","0159","0033","550","204","346","25","575","1080","0","53.24","18.89"
"10","020","00","001","0160","0000","1020","373","647","46","1066","1867","0","57.1","19.98"
"10","020","00","001","0160","0030","509","182","327","24","533","915","0","58.25","19.89"
"10","020","00","001","0160","0031","511","191","320","22","533","952","0","55.99","20.06"
"10","020","00","001","0161","0000","1029","374","655","27","1056","1858","0","56.84","20.13"
"10","020","00","001","0161","0025","644","239","405","14","658","1189","0","55.34","20.1"
"10","020","00","001","0161","0026","385","135","250","13","398","669","0","59.49","20.18"
"10","020","00","001","0162","0000","1135","405","730","55","1190","2210","0","53.85","18.33"
"10","020","00","001","0162","0034","556","183","373","24","580","1157","0","50.13","15.82"
"10","020","00","001","0162","0035","579","222","357","31","610","1053","0","57.93","21.08"
"10","020","00","001","0163","0000","1317","508","809","72","1389","2343","0","59.28","21.68"
"10","020","00","001","0163","0067","725","279","446","41","766","1332","0","57.51","20.95"
"10","020","00","001","0163","0068","592","229","363","31","623","1011","0","61.62","22.65"
"10","020","00","001","0164","0000","1142","403","739","53","1195","2192","0","54.52","18.39"
"10","020","00","001","0164","0065","574","198","376","19","593","1172","0","50.6","16.89"
"10","020","00","001","0164","0066","568","205","363","34","602","1020","0","59.02","20.1"
"10","020","00","001","0165","0000","1166","397","769","54","1220","2149","0","56.77","18.47"
"10","020","00","001","0165","0003","469","156","313","28","497","974","0","51.03","16.02"
"10","020","00","001","0165","0004","697","241","456","26","723","1175","0","61.53","20.51"
"10","020","00","001","0166","0000","1987","792","1195","43","2030","3634","0","55.86","21.79"
"10","020","00","001","0166","0009","1040","404","636","30","1070","1936","0","55.27","20.87"
"10","020","00","001","0166","0010","947","388","559","13","960","1698","0","56.54","22.85"
"10","020","00","001","0167","0000","967","358","609","54","1021","1902","0","53.68","18.82"
"10","020","00","001","0167","0055","505","202","303","36","541","980","0","55.2","20.61"
"10","020","00","001","0167","0056","462","156","306","18","480","922","0","52.06","16.92"
"10","020","00","001","0168","0000","1381","506","875","57","1438","2829","0","50.83","17.89"
"10","020","00","001","0168","0073","710","261","449","39","749","1395","0","53.69","18.71"
"10","020","00","001","0168","0074","671","245","426","18","689","1434","0","48.05","17.09"
"10","020","00","002","0000","0000","63102","20975","42127","3221","66323","120906","147462","54.86","17.35"
"10","020","00","002","0201","0000","421","147","274","30","451","770","0","58.57","19.09"
"10","020","00","002","0201","0152","421","147","274","30","451","770","0","58.57","19.09"
"10","020","00","002","0202","0000","1073","376","697","52","1125","2071","0","54.32","18.16"
"10","020","00","002","0202","0157","497","172","325","30","527","997","0","52.86","17.25"
"10","020","00","002","0202","0158","576","204","372","22","598","1074","0","55.68","18.99"
"10","020","00","002","0203","0000","1234","424","810","72","1306","2257","0","57.86","18.79"
"10","020","00","002","0203","0148","624","220","404","49","673","1146","0","58.73","19.2"
"10","020","00","002","0203","0149","610","204","406","23","633","1111","0","56.98","18.36"
"10","020","00","002","0205","0000","896","319","577","81","977","1970","0","49.59","16.19"
"10","020","00","002","0205","0153","504","166","338","17","521","1135","0","45.9","14.63"
"10","020","00","002","0205","0154","392","153","239","64","456","835","0","54.61","18.32"
"10","020","00","002","0209","0000","2080","742","1338","95","2175","4311","0","50.45","17.21"
"10","020","00","002","0209","0159","641","233","408","20","661","1460","0","45.27","15.96"
"10","020","00","002","0209","0160","678","228","450","39","717","1352","0","53.03","16.86"
"10","020","00","002","0209","0161","761","281","480","36","797","1499","0","53.17","18.75"
"10","020","00","002","0210","0000","2210","757","1453","167","2377","4132","0","57.53","18.32"
"10","020","00","002","0210","0168","794","272","522","64","858","1467","0","58.49","18.54"
"10","020","00","002","0210","0169","695","242","453","51","746","1431","0","52.13","16.91"
"10","020","00","002","0210","0170","721","243","478","52","773","1234","0","62.64","19.69"
"10","020","00","002","0211","0000","1566","426","1140","53","1619","3214","0","50.37","13.25"
"10","020","00","002","0211","0165","794","244","550","29","823","1674","0","49.16","14.58"
"10","020","00","002","0211","0166","772","182","590","24","796","1540","0","51.69","11.82"
"10","020","00","002","0212","0000","1495","495","1000","98","1593","2868","0","55.54","17.26"
"10","020","00","002","0212","0175","820","287","533","75","895","1546","0","57.89","18.56"
"10","020","00","002","0212","0176","675","208","467","23","698","1322","0","52.8","15.73"
"10","020","00","002","0213","0000","824","266","558","73","897","1549","0","57.91","17.17"
"10","020","00","002","0213","0177","824","266","558","73","897","1549","0","57.91","17.17"
"10","020","00","002","0214","0000","572","180","392","17","589","1155","0","51.0","15.58"
"10","020","00","002","0214","0174","572","180","392","17","589","1155","0","51.0","15.58"
"10","020","00","002","0215","0000","1164","357","807","70","1234","2120","0","58.21","16.84"
"10","020","00","002","0215","0093","596","192","404","49","645","1053","0","61.25","18.23"
"10","020","00","002","0215","0094","568","165","403","21","589","1067","0","55.2","15.46"
"10","020","00","002","0216","0000","2035","898","1137","101","2136","4105","0","52.03","21.88"
"10","020","00","002","0216","0097","589","217","372","33","622","1196","0","52.01","18.14"
"10","020","00","002","0216","0098","615","394","221","21","636","1280","0","49.69","30.78"
"10","020","00","002","0216","0099","831","287","544","47","878","1629","0","53.9","17.62"
"10","020","00","002","0217","0000","1611","555","1056","96","1707","3195","0","53.43","17.37"
"10","020","00","002","0217","0110","670","217","453","49","719","1396","0","51.5","15.54"
"10","020","00","002","0217","0111","941","338","603","47","988","1799","0","54.92","18.79"
"10","020","00","002","0218","0000","1678","578","1100","59","1737","3440","0","50.49","16.8"
"10","020","00","002","0218","0095","736","253","483","23","759","1575","0","48.19","16.06"
"10","020","00","002","0218","0096","942","325","617","36","978","1865","0","52.44","17.43"
"10","020","00","002","0219","0000","1964","463","1501","71","2035","3351","0","60.73","13.82"
"10","020","00","002","0219","0105","614","209","405","18","632","1000","0","63.2","20.9"
"10","020","00","002","0219","0106","634","214","420","21","655","1095","0","59.82","19.54"
"10","020","00","002","0219","0107","716","40","676","32","748","1256","0","59.55","3.18"
"10","020","00","002","0220","0000","1055","370","685","62","1117","1827","0","61.14","20.25"
"10","020","00","002","0220","0108","521","172","349","40","561","962","0","58.32","17.88"
"10","020","00","002","0220","0109","534","198","336","22","556","865","0","64.28","22.89"
"10","020","00","002","0221","0000","3258","1049","2209","95","3353","6594","0","50.85","15.91"
"10","020","00","002","0221","0112","741","225","516","19","760","1505","0","50.5","14.95"
"10","020","00","002","0221","0113","852","275","577","48","900","1698","0","53.0","16.2"
"10","020","00","002","0221","0114","985","313","672","20","1005","1854","0","54.21","16.88"
"10","020","00","002","0221","0115","680","236","444","8","688","1537","0","44.76","15.35"
"10","020","00","002","0222","0000","1028","278","750","82","1110","2024","0","54.84","13.74"
"10","020","00","002","0222","0103","448","178","270","78","526","841","0","62.54","21.17"
"10","020","00","002","0222","0104","580","100","480","4","584","1183","0","49.37","8.45"
"10","020","00","002","0231","0000","1024","347","677","62","1086","1994","0","54.46","17.4"
"10","020","00","002","0231","0082","471","151","320","12","483","885","0","54.58","17.06"
"10","020","00","002","0231","0083","553","196","357","50","603","1109","0","54.37","17.67"
"10","020","00","002","0245","0000","936","271","665","41","977","1625","0","60.12","16.68"
"10","020","00","002","0245","0140","456","148","308","29","485","756","0","64.15","19.58"
"10","020","00","002","0245","0141","480","123","357","12","492","869","0","56.62","14.15"
"10","020","00","002","0246","0000","946","324","622","50","996","1904","0","52.31","17.02"
"10","020","00","002","0246","0138","352","144","208","26","378","736","0","51.36","19.57"
"10","020","00","002","0246","0139","594","180","414","24","618","1168","0","52.91","15.41"
"10","020","00","002","0247","0000","3057","1028","2029","170","3227","5706","0","56.55","18.02"
"10","020","00","002","0247","0134","818","278","540","55","873","1548","0","56.4","17.96"
"10","020","00","002","0247","0135","667","230","437","30","697","1295","0","53.82","17.76"
"10","020","00","002","0247","0136","752","249","503","45","797","1318","0","60.47","18.89"
"10","020","00","002","0247","0137","820","271","549","40","860","1545","0","55.66","17.54"
"10","020","00","002","0248","0000","2946","1004","1942","115","3061","5397","0","56.72","18.6"
"10","020","00","002","0248","0130","737","235","502","28","765","1185","0","64.56","19.83"
"10","020","00","002","0248","0131","751","247","504","35","786","1278","0","61.5","19.33"
"10","020","00","002","0248","0132","612","238","374","18","630","1394","0","45.19","17.07"
"10","020","00","002","0248","0133","846","284","562","34","880","1540","0","57.14","18.44"
"10","020","00","002","0249","0000","2295","754","1541","136","2431","4343","0","55.98","17.36"
"10","020","00","002","0249","0120","706","225","481","41","747","1362","0","54.85","16.52"
"10","020","00","002","0249","0121","712","249","463","28","740","1279","0","57.86","19.47"
"10","020","00","002","0249","0122","877","280","597","67","944","1702","0","55.46","16.45"
"10","020","00","002","0250","0000","2062","665","1397","144","2206","3715","0","59.38","17.9"
"10","020","00","002","0250","0117","536","194","342","59","595","944","0","63.03","20.55"
"10","020","00","002","0250","0118","880","256","624","52","932","1627","0","57.28","15.73"
"10","020","00","002","0250","0119","646","215","431","33","679","1144","0","59.35","18.79"
"10","020","00","002","0251","0000","997","327","670","69","1066","1811","0","58.86","18.06"
"10","020","00","002","0251","0142","550","187","363","37","587","983","0","59.72","19.02"
"10","020","00","002","0251","0143","447","140","307","32","479","828","0","57.85","16.91"
"10","020","00","002","0252","0000","942","243","699","34","976","1775","0","54.99","13.69"
"10","020","00","002","0252","0144","942","243","699","34","976","1775","0","54.99","13.69"
"10","020","00","002","0253","0000","2698","899","1799","110","2808","4992","0","56.25","18.01"
"10","020","00","002","0253","0126","738","235","503","27","765","1280","0","59.77","18.36"
"10","020","00","002","0253","0127","580","201","379","29","609","1220","0","49.92","16.48"
"10","020","00","002","0253","0128","671","214","457","21","692","1172","0","59.04","18.26"
"10","020","00","002","0253","0129","709","249","460","33","742","1320","0","56.21","18.86"
"10","020","00","002","0254","0000","742","192","550","16","758","1419","0","53.42","13.53"
"10","020","00","002","0254","0145","742","192","550","16","758","1419","0","53.42","13.53"
"10","020","00","002","0255","0000","781","292","489","42","823","1604","0","51.31","18.2"
"10","020","00","002","0255","0116","781","292","489","42","823","1604","0","51.31","18.2"
"10","020","00","002","0256","0000","1030","336","694","84","1114","1945","0","57.28","17.28"
"10","020","00","002","0256","0084","485","168","317","46","531","1020","0","52.06","16.47"
"10","020","00","002","0256","0085","545","168","377","38","583","925","0","63.03","18.16"
"10","020","00","002","0257","0000","740","291","449","30","770","1671","0","46.08","17.41"
"10","020","00","002","0257","0086","740","291","449","30","770","1671","0","46.08","17.41"
"10","020","00","002","0258","0000","1200","443","757","38","1238","2251","0","55.0","19.68"
"10","020","00","002","0258","0087","665","250","415","13","678","1215","0","55.8","20.58"
"10","020","00","002","0258","0088","535","193","342","25","560","1036","0","54.05","18.63"
"10","020","00","002","0259","0000","1133","389","744","55","1188","2256","0","52.66","17.24"
"10","020","00","002","0259","0089","552","193","359","28","580","1129","0","51.37","17.09"
"10","020","00","002","0259","0090","581","196","385","27","608","1127","0","53.95","17.39"
"10","020","00","002","0260","0000","687","201","486","21","708","1366","0","51.83","14.71"
"10","020","00","002","0260","0092","687","201","486","21","708","1366","0","51.83","14.71"
"10","020","00","002","0261","0000","757","269","488","39","796","1415","0","56.25","19.01"
"10","020","00","002","0261","0091","757","269","488","39","796","1415","0","56.25","19.01"
"10","020","00","002","0262","0000","832","273","559","28","860","1634","0","52.63","16.71"
"10","020","00","002","0262","0146","402","139","263","13","415","779","0","53.27","17.84"
"10","020","00","002","0262","0147","430","134","296","15","445","855","0","52.05","15.67"
"10","020","00","002","0263","0000","859","271","588","51","910","1584","0","57.45","17.11"
"10","020","00","002","0263","0150","462","133","329","34","496","767","0","64.67","17.34"
"10","020","00","002","0263","0151","397","138","259","17","414","817","0","50.67","16.89"
"10","020","00","002","0264","0000","983","322","661","62","1045","2126","0","49.15","15.15"
"10","020","00","002","0264","0155","545","177","368","32","577","1182","0","48.82","14.97"
"10","020","00","002","0264","0156","438","145","293","30","468","944","0","49.58","15.36"
"10","020","00","002","0265","0000","2143","763","1380","102","2245","4164","0","53.91","18.32"
"10","020","00","002","0265","0100","744","243","501","55","799","1393","0","57.36","17.44"
"10","020","00","002","0265","0101","610","214","396","35","645","1077","0","59.89","19.87"
"10","020","00","002","0265","0102","789","306","483","12","801","1694","0","47.28","18.06"
"10","020","00","002","0266","0000","1538","533","1005","96","1634","2718","0","60.12","19.61"
"10","020","00","002","0266","0123","762","269","493","40","802","1358","0","59.06","19.81"
"10","020","00","002","0266","0124","776","264","512","56","832","1360","0","61.18","19.41"
"10","020","00","002","0267","0000","859","249","610","52","911","1589","0","57.33","15.67"
"10","020","00","002","0267","0125","859","249","610","52","911","1589","0","57.33","15.67"
"10","020","00","002","0268","0000","1966","666","1300","44","2010","3598","0","55.86","18.51"
"10","020","00","002","0268","0171","666","226","440","12","678","1266","0","53.55","17.85"
"10","020","00","002","0268","0172","668","233","435","20","688","1211","0","56.81","19.24"
"10","020","00","002","0268","0173","632","207","425","12","644","1121","0","57.45","18.47"
"10","020","00","002","0269","0000","2179","738","1441","132","2311","4295","0","53.81","17.18"
"10","020","00","002","0269","0162","652","233","419","62","714","1262","0","56.58","18.46"
"10","020","00","002","0269","0163","675","229","446","26","701","1299","0","53.96","17.63"
"10","020","00","002","0269","0164","852","276","576","44","896","1734","0","51.67","15.92"
"10","020","00","002","0270","0000","606","205","401","24","630","1056","0","59.66","19.41"
"10","020","00","002","0270","0167","606","205","401","24","630","1056","0","59.66","19.41"
"09","020","00","000","0000","0000","41796","10826","30970","2118","43914","122695","138845","35.79","8.82"
"09","020","00","001","0000","0000","12588","3241","9347","645","13233","37815","43315","34.99","8.57"
"09","020","00","001","0101","0000","1754","431","1323","86","1840","4977","0","36.97","8.66"
"09","020","00","001","0101","0001","473","115","358","30","503","1396","0","36.03","8.24"
"09","020","00","001","0101","0002","671","170","501","24","695","1831","0","37.96","9.28"
"09","020","00","001","0101","0003","610","146","464","32","642","1750","0","36.69","8.34"
"09","020","00","001","0102","0000","3458","980","2478","147","3605","9882","0","36.48","9.92"
"09","020","00","001","0102","0007","515","163","352","42","557","1610","0","34.6","10.12"
"09","020","00","001","0102","0008","571","143","428","31","602","1687","0","35.68","8.48"
"09","020","00","001","0102","0009","564","225","339","17","581","1594","0","36.45","14.12"
"09","020","00","001","0102","0010","605","156","449","13","618","1726","0","35.81","9.04"
"09","020","00","001","0102","0011","614","153","461","17","631","1733","0","36.41","8.83"
"09","020","00","001","0102","0012","589","140","449","27","616","1532","0","40.21","9.14"
"09","020","00","001","0103","0000","1928","495","1433","103","2031","5465","0","37.16","9.06"
"09","020","00","001","0103","0004","662","167","495","55","717","1889","0","37.96","8.84"
"09","020","00","001","0103","0005","511","165","346","25","536","1675","0","32.0","9.85"
"09","020","00","001","0103","0006","755","163","592","23","778","1901","0","40.93","8.57"
"09","020","00","001","0104","0000","1307","345","962","67","1374","4112","0","33.41","8.39"
"09","020","00","001","0104","0013","679","168","511","42","721","2079","0","34.68","8.08"
"09","020","00","001","0104","0014","628","177","451","25","653","2033","0","32.12","8.71"
"09","020","00","001","0105","0000","996","230","766","69","1065","3788","0","28.12","6.07"
"09","020","00","001","0105","0018","670","163","507","50","720","2435","0","29.57","6.69"
"09","020","00","001","0105","0019","326","67","259","19","345","1353","0","25.5","4.95"
"09","020","00","001","0106","0000","702","148","554","33","735","2140","0","34.35","6.92"
"09","020","00","001","0106","0017","702","148","554","33","735","2140","0","34.35","6.92"
"09","020","00","001","0107","0000","916","220","696","55","971","2851","0","34.06","7.72"
"09","020","00","001","0107","0020","474","100","374","19","493","1574","0","31.32","6.35"
"09","020","00","001","0107","0021","442","120","322","36","478","1277","0","37.43","9.4"
"09","020","00","001","0108","0000","1527","392","1135","85","1612","4600","0","35.04","8.52"
"09","020","00","001","0108","0015","834","220","614","48","882","2517","0","35.04","8.74"
"09","020","00","001","0108","0016","693","172","521","37","730","2083","0","35.05","8.26"
"09","020","00","002","0000","0000","6225","1258","4967","347","6572","18560","20751","35.41","6.78"
"09","020","00","002","0201","0000","1729","341","1388","103","1832","5106","0","35.88","6.68"
"09","020","00","002","0201","0066","618","120","498","42","660","1909","0","34.57","6.29"
"09","020","00","002","0201","0067","593","125","468","32","625","1524","0","41.01","8.2"
"09","020","00","002","0201","0068","518","96","422","29","547","1673","0","32.7","5.74"
"09","020","00","002","0202","0000","669","122","547","32","701","1895","0","36.99","6.44"
"09","020","00","002","0202","0075","669","122","547","32","701","1895","0","36.99","6.44"
"09","020","00","002","0203","0000","430","84","346","32","462","1135","0","40.7","7.4"
"09","020","00","002","0203","0076","430","84","346","32","462","1135","0","40.7","7.4"
"09","020","00","002","0204","0000","863","187","676","38","901","2377","0","37.9","7.87"
"09","020","00","002","0204","0077","413","96","317","25","438","1252","0","34.98","7.67"
"09","020","00","002","0204","0078","450","91","359","13","463","1125","0","41.16","8.09"
"09","020","00","002","0205","0000","628","112","516","30","658","2003","0","32.85","5.59"
"09","020","00","002","0205","0069","628","112","516","30","658","2003","0","32.85","5.59"
"09","020","00","002","0206","0000","451","97","354","28","479","1540","0","31.1","6.3"
"09","020","00","002","0206","0072","451","97","354","28","479","1540","0","31.1","6.3"
"09","020","00","002","0207","0000","606","119","487","31","637","2166","0","29.41","5.49"
"09","020","00","002","0207","0073","358","73","285","20","378","1216","0","31.09","6.0"
"09","020","00","002","0207","0074","248","46","202","11","259","950","0","27.26","4.84"
"09","020","00","002","0208","0000","849","196","653","53","902","2338","0","38.58","8.38"
"09","020","00","002","0208","0070","467","106","361","26","493","1212","0","40.68","8.75"
"09","020","00","002","0208","0071","382","90","292","27","409","1126","0","36.32","7.99"
"09","020","00","003","0000","0000","9006","2250","6756","490","9496","25915","29658","36.64","8.68"
"09","020","00","003","0301","0000","1554","393","1161","80","1634","4137","0","39.5","9.5"
"09","020","00","003","0301","0049","512","144","368","28","540","1348","0","40.06","10.68"
"09","020","00","003","0301","0050","463","119","344","26","489","1386","0","35.28","8.59"
"09","020","00","003","0301","0051","579","130","449","26","605","1403","0","43.12","9.27"
"09","020","00","003","0302","0000","1159","298","861","71","1230","3264","0","37.68","9.13"
"09","020","00","003","0302","0052","648","155","493","26","674","1771","0","38.06","8.75"
"09","020","00","003","0302","0053","511","143","368","45","556","1493","0","37.24","9.58"
"09","020","00","003","0303","0000","839","214","625","55","894","2618","0","34.15","8.17"
"09","020","00","003","0303","0062","394","102","292","20","414","1236","0","33.5","8.25"
"09","020","00","003","0303","0063","445","112","333","35","480","1382","0","34.73","8.1"
"09","020","00","003","0304","0000","638","140","498","32","670","2006","0","33.4","6.98"
"09","020","00","003","0304","0056","638","140","498","32","670","2006","0","33.4","6.98"
"09","020","00","003","0305","0000","998","198","800","55","1053","3145","0","33.48","6.3"
"09","020","00","003","0305","0064","540","99","441","20","560","1631","0","34.33","6.07"
"09","020","00","003","0305","0065","458","99","359","35","493","1514","0","32.56","6.54"
"09","020","00","003","0306","0000","2758","777","1981","113","2871","7628","0","37.64","10.19"
"09","020","00","003","0306","0057","612","196","416","30","642","1780","0","36.07","11.01"
"09","020","00","003","0306","0058","618","176","442","17","635","1739","0","36.52","10.12"
"09","020","00","003","0306","0059","455","115","340","24","479","1384","0","34.61","8.31"
"09","020","00","003","0306","0060","502","139","363","26","528","1400","0","37.71","9.93"
"09","020","00","003","0306","0061","571","151","420","16","587","1325","0","44.3","11.4"
"09","020","00","003","0307","0000","481","99","382","54","535","1510","0","35.43","6.56"
"09","020","00","003","0307","0054","481","99","382","54","535","1510","0","35.43","6.56"
"09","020","00","003","0308","0000","579","131","448","30","609","1607","0","37.9","8.15"
"09","020","00","003","0308","0055","579","131","448","30","609","1607","0","37.9","8.15"
"09","020","00","004","0000","0000","9743","3170","6573","448","10191","28162","31588","36.19","11.26"
"09","020","00","004","0401","0000","948","211","737","79","1027","3272","0","31.39","6.45"
"09","020","00","004","0401","0022","484","99","385","57","541","1735","0","31.18","5.71"
"09","020","00","004","0401","0023","464","112","352","22","486","1537","0","31.62","7.29"
"09","020","00","004","0402","0000","1494","388","1106","86","1580","4507","0","35.06","8.61"
"09","020","00","004","0402","0024","560","178","382","35","595","1766","0","33.69","10.08"
"09","020","00","004","0402","0025","357","93","264","18","375","1015","0","36.95","9.16"
"09","020","00","004","0402","0026","577","117","460","33","610","1726","0","35.34","6.78"
"09","020","00","004","0403","0000","487","113","374","19","506","1537","0","32.92","7.35"
"09","020","00","004","0403","0038","487","113","374","19","506","1537","0","32.92","7.35"
"09","020","00","004","0404","0000","2691","1006","1685","97","2788","7318","0","38.1","13.75"
"09","020","00","004","0404","0027","517","121","396","21","538","1691","0","31.82","7.16"
"09","020","00","004","0404","0028","845","538","307","21","866","2044","0","42.37","26.32"
"09","020","00","004","0404","0029","736","191","545","28","764","1848","0","41.34","10.34"
"09","020","00","004","0404","0030","593","156","437","27","620","1735","0","35.73","8.99"
"09","020","00","004","0405","0000","1632","385","1247","88","1720","5157","0","33.35","7.47"
"09","020","00","004","0405","0031","596","162","434","31","627","1795","0","34.93","9.03"
"09","020","00","004","0405","0032","543","97","446","38","581","1834","0","31.68","5.29"
"09","020","00","004","0405","0033","493","126","367","19","512","1528","0","33.51","8.25"
"09","020","00","004","0406","0000","2491","1067","1424","79","2570","6371","0","40.34","16.75"
"09","020","00","004","0406","0034","544","120","424","24","568","1473","0","38.56","8.15"
"09","020","00","004","0406","0035","576","147","429","26","602","1679","0","35.85","8.76"
"09","020","00","004","0406","0036","919","674","245","14","933","1921","0","48.57","35.09"
"09","020","00","004","0406","0037","452","126","326","15","467","1298","0","35.98","9.71"
"09","020","00","005","0000","0000","4071","869","3202","186","4257","11676","12847","36.46","7.44"
"09","020","00","005","0501","0000","990","197","793","42","1032","2841","0","36.33","6.93"
"09","020","00","005","0501","0045","509","96","413","16","525","1412","0","37.18","6.8"
"09","020","00","005","0501","0046","481","101","380","26","507","1429","0","35.48","7.07"
"09","020","00","005","0502","0000","455","108","347","28","483","1425","0","33.89","7.58"
"09","020","00","005","0502","0044","455","108","347","28","483","1425","0","33.89","7.58"
"09","020","00","005","0503","0000","758","166","592","38","796","2395","0","33.24","6.93"
"09","020","00","005","0503","0042","422","103","319","18","440","1296","0","33.95","7.95"
"09","020","00","005","0503","0043","336","63","273","20","356","1099","0","32.39","5.73"
"09","020","00","005","0504","0000","1285","270","1015","54","1339","3380","0","39.62","7.99"
"09","020","00","005","0504","0039","702","149","553","20","722","1647","0","43.84","9.05"
"09","020","00","005","0504","0040","583","121","462","34","617","1733","0","35.6","6.98"
"09","020","00","005","0505","0000","583","128","455","24","607","1635","0","37.13","7.83"
"09","020","00","005","0505","0041","583","128","455","24","607","1635","0","37.13","7.83"
"09","020","00","006","0000","0000","163","38","125","2","165","567","686","29.1","6.7"
"09","020","00","006","0601","0000","76","22","54","2","78","275","0","28.36","8.0"
"09","020","00","006","0601","0047","76","22","54","2","78","275","0","28.36","8.0"
"09","020","00","006","0602","0000","87","16","71","0","87","292","0","29.79","5.48"
"09","020","00","006","0602","0048","87","16","71","0","87","292","0","29.79","5.48"
"09","007","00","000","0000","0000","5590","1480","4110","171","5761","11205","13062","51.41","13.21"
"09","007","00","001","0000","0000","3191","849","2342","98","3289","6461","7657","50.91","13.14"
"09","007","00","001","0101","0000","986","296","690","28","1014","1967","0","51.55","15.05"
"09","007","00","001","0101","0001","986","296","690","28","1014","1967","0","51.55","15.05"
"09","007","00","001","01x2","0000","846","224","622","38","884","1837","0","48.12","12.19"
"09","007","00","001","01x2","0002","846","224","622","38","884","1837","0","48.12","12.19"
"09","007","00","001","01x4","0000","570","163","407","18","588","1114","0","52.78","14.63"
"09","007","00","001","01x4","0003","570","163","407","18","588","1114","0","52.78","14.63"
"09","007","00","001","01x5","0000","789","166","623","14","803","1543","0","52.04","10.76"
"09","007","00","001","01x5","0004","789","166","623","14","803","1543","0","52.04","10.76"
"09","007","00","002","0000","0000","1077","266","811","33","1110","2125","2430","52.24","12.52"
"09","007","00","002","02x1","0000","788","189","599","26","814","1515","0","53.73","12.48"
"09","007","00","002","02x1","0005","788","189","599","26","814","1515","0","53.73","12.48"
"09","007","00","002","02x4","0000","289","77","212","7","296","610","0","48.52","12.62"
"09","007","00","002","02x4","0006","289","77","212","7","296","610","0","48.52","12.62"
"09","007","00","003","0000","0000","760","200","560","25","785","1481","1627","53.0","13.5"
"09","007","00","003","03x1","0000","331","96","235","11","342","698","0","49.0","13.75"
"09","007","00","003","03x1","0007","331","96","235","11","342","698","0","49.0","13.75"
"09","007","00","003","03x4","0000","429","104","325","14","443","783","0","56.58","13.28"
"09","007","00","003","03x4","0008","429","104","325","14","443","783","0","56.58","13.28"
"09","007","00","004","0000","0000","562","165","397","15","577","1138","1348","50.7","14.5"
"09","007","00","004","04x1","0000","562","165","397","15","577","1138","0","50.7","14.5"
"09","007","00","004","04x1","0009","562","165","397","15","577","1138","0","50.7","14.5"
