"prv_code","city_code","area_code","dept_code","li_code","tbox_no","valid_ticket","agree_ticket","disagree_ticket","invalid_ticket","vote_ticket","votable_population","population","vote_to_votable","agree_to_votable"
"00","000","00","000","0000","0000","8067206","3804689","4262517","78494","8145700","19825468","23470633","41.09","19.19"
"63","000","00","000","0000","0000","1004924","514232","490692","9609","1014533","2155416","2562738","47.07","23.86"
"63","000","00","010","0000","0000","79829","42583","37246","743","80572","162964","196890","49.44","26.13"
"63","000","00","010","0002","0000","2014","1077","937","19","2033","4467","0","45.51","24.11"
"63","000","00","010","0002","0001","536","285","251","1","537","1074","0","50.00","26.54"
"63","000","00","010","0002","0002","491","254","237","9","500","1138","0","43.94","22.32"
"63","000","00","010","0002","0003","426","228","198","5","431","1083","0","39.80","21.05"
"63","000","00","010","0002","0004","561","310","251","4","565","1172","0","48.21","26.45"
"63","000","00","010","0003","0000","3396","1681","1715","19","3415","6468","0","52.80","25.99"
"63","000","00","010","0003","0005","670","333","337","11","681","1294","0","52.63","25.73"
"63","000","00","010","0003","0006","728","410","318","4","732","1334","0","54.87","30.73"
"63","000","00","010","0003","0007","664","323","341","0","664","1290","0","51.47","25.04"
"63","000","00","010","0003","0008","655","304","351","2","657","1215","0","54.07","25.02"
"63","000","00","010","0003","0009","679","311","368","2","681","1335","0","51.01","23.30"
"63","000","00","010","0004","0000","2928","1580","1348","20","2948","5723","0","51.51","27.61"
"63","000","00","010","0004","0010","598","284","314","4","602","1071","0","56.21","26.52"
"63","000","00","010","0004","0011","570","349","221","2","572","1149","0","49.78","30.37"
"63","000","00","010","0004","0012","563","283","280","3","566","1092","0","51.83","25.92"
"63","000","00","010","0004","0013","587","335","252","6","593","1142","0","51.93","29.33"
"63","000","00","010","0004","0014","610","329","281","5","615","1269","0","48.46","25.93"
"63","000","00","010","0005","0000","1989","984","1005","16","2005","3881","0","51.66","25.35"
"63","000","00","010","0005","0015","678","364","314","6","684","1319","0","51.86","27.60"
"63","000","00","010","0005","0016","660","303","357","5","665","1305","0","50.96","23.22"
"63","000","00","010","0005","0017","651","317","334","5","656","1257","0","52.19","25.22"
"63","000","00","010","0006","0000","2173","1146","1027","16","2189","4281","0","51.13","26.77"
"63","000","00","010","0006","0018","509","273","236","5","514","1036","0","49.61","26.35"
"63","000","00","010","0006","0019","631","346","285","6","637","1203","0","52.95","28.76"
"63","000","00","010","0006","0020","487","227","260","3","490","969","0","50.57","23.43"
"63","000","00","010","0006","0021","546","300","246","2","548","1073","0","51.07","27.96"
"63","000","00","010","0007","0000","2048","1106","942","19","2067","4135","0","49.99","26.75"
"63","000","00","010","0007","0022","512","296","216","4","516","1031","0","50.05","28.71"
"63","000","00","010","0007","0023","527","288","239","6","533","1074","0","49.63","26.82"
"63","000","00","010","0007","0024","488","250","238","2","490","1013","0","48.37","24.68"
"63","000","00","010","0007","0025","521","272","249","7","528","1017","0","51.92","26.75"
"63","000","00","010","0008","0000","1886","1120","766","15","1901","3884","0","48.94","28.84"
"63","000","00","010","0008","0026","609","327","282","5","614","1239","0","49.56","26.39"
"63","000","00","010","0008","0027","624","390","234","5","629","1276","0","49.29","30.56"
"63","000","00","010","0008","0028","653","403","250","5","658","1369","0","48.06","29.44"
"63","000","00","010","0009","0000","1790","890","900","15","1805","3540","0","50.99","25.14"
"63","000","00","010","0009","0029","621","297","324","5","626","1176","0","53.23","25.26"
"63","000","00","010","0009","0030","589","301","288","5","594","1155","0","51.43","26.06"
"63","000","00","010","0009","0031","580","292","288","5","585","1209","0","48.39","24.15"
"63","000","00","010","0010","0000","1781","953","828","13","1794","3553","0","50.49","26.82"
"63","000","00","010","0010","0032","582","300","282","4","586","1167","0","50.21","25.71"
"63","000","00","010","0010","0033","657","358","299","7","664","1266","0","52.45","28.28"
"63","000","00","010","0010","0034","542","295","247","2","544","1120","0","48.57","26.34"
"63","000","00","010","0011","0000","3031","1689","1342","30","3061","6051","0","50.59","27.91"
"63","000","00","010","0011","0035","553","308","245","4","557","1044","0","53.35","29.50"
"63","000","00","010","0011","0036","508","262","246","3","511","1011","0","50.54","25.91"
"63","000","00","010","0011","0037","479","264","215","11","490","998","0","49.10","26.45"
"63","000","00","010","0011","0038","463","247","216","3","466","1000","0","46.60","24.70"
"63","000","00","010","0011","0039","513","332","181","4","517","989","0","52.28","33.57"
"63","000","00","010","0011","0040","515","276","239","5","520","1009","0","51.54","27.35"
"63","000","00","010","0012","0000","4266","2742","1524","38","4304","8377","0","51.38","32.73"
"63","000","00","010","0012","0041","630","497","133","5","635","1163","0","54.60","42.73"
"63","000","00","010","0012","0042","679","353","326","8","687","1294","0","53.09","27.28"
"63","000","00","010","0012","0043","611","344","267","1","612","1190","0","51.43","28.91"
"63","000","00","010","0012","0044","534","350","184","6","540","1164","0","46.39","30.07"
"63","000","00","010","0012","0045","617","475","142","6","623","1230","0","50.65","38.62"
"63","000","00","010","0012","0046","594","390","204","7","601","1192","0","50.42","32.72"
"63","000","00","010","0012","0047","601","333","268","5","606","1144","0","52.97","29.11"
"63","000","00","010","0013","0000","1172","537","635","8","1180","2184","0","54.03","24.59"
"63","000","00","010","0013","0048","585","296","289","5","590","1114","0","52.96","26.57"
"63","000","00","010","0013","0049","587","241","346","3","590","1070","0","55.14","22.52"
"63","000","00","010","0014","0000","1771","883","888","17","1788","3518","0","50.82","25.10"
"63","000","00","010","0014","0050","569","277","292","1","570","1140","0","50.00","24.30"
"63","000","00","010","0014","0051","608","315","293","5","613","1233","0","49.72","25.55"
"63","000","00","010","0014","0052","594","291","303","11","605","1145","0","52.84","25.41"
"63","000","00","010","0015","0000","2635","1435","1200","32","2667","5140","0","51.89","27.92"
"63","000","00","010","0015","0053","697","386","311","11","708","1332","0","53.15","28.98"
"63","000","00","010","0015","0054","640","392","248","8","648","1241","0","52.22","31.59"
"63","000","00","010","0015","0055","599","268","331","5","604","1169","0","51.67","22.93"
"63","000","00","010","0015","0056","699","389","310","8","707","1398","0","50.57","27.83"
"63","000","00","010","0016","0000","3779","1797","1982","34","3813","7351","0","51.87","24.45"
"63","000","00","010","0016","0057","561","282","279","10","571","1182","0","48.31","23.86"
"63","000","00","010","0016","0058","598","287","311","4","602","1153","0","52.21","24.89"
"63","000","00","010","0016","0059","637","322","315","3","640","1235","0","51.82","26.07"
"63","000","00","010","0016","0060","670","321","349","7","677","1246","0","54.33","25.76"
"63","000","00","010","0016","0061","641","276","365","7","648","1260","0","51.43","21.90"
"63","000","00","010","0016","0062","672","309","363","3","675","1275","0","52.94","24.24"
"63","000","00","010","0017","0000","2826","1642","1184","27","2853","5381","0","53.02","30.51"
"63","000","00","010","0017","0063","765","501","264","10","775","1412","0","54.89","35.48"
"63","000","00","010","0017","0064","651","340","311","2","653","1334","0","48.95","25.49"
"63","000","00","010","0017","0065","708","412","296","12","720","1327","0","54.26","31.05"
"63","000","00","010","0017","0066","702","389","313","3","705","1308","0","53.90","29.74"
"63","000","00","010","0018","0000","2741","1272","1469","21","2762","7162","0","38.56","17.76"
"63","000","00","010","0018","0085","586","291","295","2","588","1242","0","47.34","23.43"
"63","000","00","010","0018","0086","473","193","280","9","482","1045","0","46.12","18.47"
"63","000","00","010","0018","0087","531","221","310","0","531","1248","0","42.55","17.71"
"63","000","00","010","0018","0088","646","311","335","5","651","1381","0","47.14","22.52"
"63","000","00","010","0018","0089","505","256","249","5","510","2246","0","22.71","11.40"
"63","000","00","010","0019","0000","3322","1635","1687","27","3349","7230","0","46.32","22.61"
"63","000","00","010","0019","0070","673","339","334","6","679","1479","0","45.91","22.92"
"63","000","00","010","0019","0071","583","304","279","4","587","1242","0","47.26","24.48"
"63","000","00","010","0019","0072","594","286","308","6","600","1301","0","46.12","21.98"
"63","000","00","010","0019","0073","831","424","407","9","840","1709","0","49.15","24.81"
"63","000","00","010","0019","0074","641","282","359","2","643","1499","0","42.90","18.81"
"63","000","00","010","0020","0000","2273","1387","886","25","2298","4616","0","49.78","30.05"
"63","000","00","010","0020","0075","538","384","154","6","544","1135","0","47.93","33.83"
"63","000","00","010","0020","0076","556","326","230","9","565","1202","0","47.00","27.12"
"63","000","00","010","0020","0077","664","356","308","5","669","1190","0","56.22","29.92"
"63","000","00","010","0020","0078","515","321","194","5","520","1089","0","47.75","29.48"
"63","000","00","010","0021","0000","3978","2904","1074","45","4023","7730","0","52.04","37.57"
"63","000","00","010","0021","0079","653","447","206","9","662","1274","0","51.96","35.09"
"63","000","00","010","0021","0080","762","642","120","12","774","1336","0","57.93","48.05"
"63","000","00","010","0021","0081","575","371","204","6","581","1124","0","51.69","33.01"
"63","000","00","010","0021","0082","575","472","103","5","580","1152","0","50.35","40.97"
"63","000","00","010","0021","0083","702","434","268","6","708","1386","0","51.08","31.31"
"63","000","00","010","0021","0084","711","538","173","7","718","1458","0","49.25","36.90"
"63","000","00","010","0022","0000","3370","1810","1560","27","3397","6959","0","48.81","26.01"
"63","000","00","010","0022","0090","580","274","306","2","582","1290","0","45.12","21.24"
"63","000","00","010","0022","0091","578","308","270","6","584","1152","0","50.69","26.74"
"63","000","00","010","0022","0092","535","281","254","6","541","1080","0","50.09","26.02"
"63","000","00","010","0022","0093","556","323","233","3","559","1185","0","47.17","27.26"
"63","000","00","010","0022","0094","542","296","246","3","545","1091","0","49.95","27.13"
"63","000","00","010","0022","0095","579","328","251","7","586","1161","0","50.47","28.25"
"63","000","00","010","0024","0000","3078","1517","1561","37","3115","6657","0","46.79","22.79"
"63","000","00","010","0024","0096","583","306","277","12","595","1353","0","43.98","22.62"
"63","000","00","010","0024","0097","676","319","357","7","683","1344","0","50.82","23.74"
"63","000","00","010","0024","0098","607","319","288","9","616","1291","0","47.71","24.71"
"63","000","00","010","0024","0099","635","293","342","3","638","1327","0","48.08","22.08"
"63","000","00","010","0024","0100","577","280","297","6","583","1342","0","43.44","20.86"
"63","000","00","010","0025","0000","2629","1436","1193","31","2660","5286","0","50.32","27.17"
"63","000","00","010","0025","0101","709","390","319","6","715","1345","0","53.16","29.00"
"63","000","00","010","0025","0102","649","366","283","9","658","1348","0","48.81","27.15"
"63","000","00","010","0025","0103","721","402","319","6","727","1417","0","51.31","28.37"
"63","000","00","010","0025","0104","550","278","272","10","560","1176","0","47.62","23.64"
"63","000","00","010","0026","0000","3460","1654","1806","31","3491","7611","0","45.87","21.73"
"63","000","00","010","0026","0105","505","253","252","4","509","1110","0","45.86","22.79"
"63","000","00","010","0026","0106","609","253","356","5","614","1318","0","46.59","19.20"
"63","000","00","010","0026","0107","553","291","262","7","560","1278","0","43.82","22.77"
"63","000","00","010","0026","0108","628","328","300","6","634","1385","0","45.78","23.68"
"63","000","00","010","0026","0109","636","266","370","6","642","1282","0","50.08","20.75"
"63","000","00","010","0026","0110","529","263","266","3","532","1238","0","42.97","21.24"
"63","000","00","010","0027","0000","1570","778","792","19","1589","3317","0","47.90","23.45"
"63","000","00","010","0027","0111","532","269","263","8","540","1207","0","44.74","22.29"
"63","000","00","010","0027","0112","569","282","287","7","576","1209","0","47.64","23.33"
"63","000","00","010","0027","0113","469","227","242","4","473","901","0","52.50","25.19"
"63","000","00","010","0028","0000","1412","669","743","10","1422","2882","0","49.34","23.21"
"63","000","00","010","0028","0114","416","178","238","4","420","924","0","45.45","19.26"
"63","000","00","010","0028","0115","479","233","246","2","481","991","0","48.54","23.51"
"63","000","00","010","0028","0116","517","258","259","4","521","967","0","53.88","26.68"
"63","000","00","010","0029","0000","1480","739","741","10","1490","3234","0","46.07","22.85"
"63","000","00","010","0029","0117","532","267","265","7","539","1128","0","47.78","23.67"
"63","000","00","010","0029","0118","476","237","239","2","478","1081","0","44.22","21.92"
"63","000","00","010","0029","0119","472","235","237","1","473","1025","0","46.15","22.93"
"63","000","00","010","0030","0000","2883","1420","1463","32","2915","5590","0","52.15","25.40"
"63","000","00","010","0030","0120","740","361","379","7","747","1466","0","50.95","24.62"
"63","000","00","010","0030","0121","767","368","399","13","780","1487","0","52.45","24.75"
"63","000","00","010","0030","0122","613","280","333","5","618","1178","0","52.46","23.77"
"63","000","00","010","0030","0123","763","411","352","7","770","1459","0","52.78","28.17"
"63","000","00","010","0031","0000","1325","722","603","17","1342","2642","0","50.79","27.33"
"63","000","00","010","0031","0124","710","397","313","8","718","1420","0","50.56","27.96"
"63","000","00","010","0031","0125","615","325","290","9","624","1222","0","51.06","26.60"
"63","000","00","010","0032","0000","1804","974","830","20","1824","3714","0","49.11","26.23"
"63","000","00","010","0032","0126","645","377","268","8","653","1338","0","48.80","28.18"
"63","000","00","010","0032","0127","598","274","324","8","606","1284","0","47.20","21.34"
"63","000","00","010","0032","0128","561","323","238","4","565","1092","0","51.74","29.58"
"63","000","00","010","0033","0000","2507","1193","1314","23","2530","5206","0","48.60","22.92"
"63","000","00","010","0033","0129","617","259","358","8","625","1367","0","45.72","18.95"
"63","000","00","010","0033","0130","641","308","333","8","649","1199","0","54.13","25.69"
"63","000","00","010","0033","0131","627","311","316","4","631","1310","0","48.17","23.74"
"63","000","00","010","0033","0132","622","315","307","3","625","1330","0","46.99","23.68"
"63","000","00","010","0034","0000","1049","496","553","16","1065","2147","0","49.60","23.10"
"63","000","00","010","0034","0133","576","278","298","8","584","1185","0","49.28","23.46"
"63","000","00","010","0034","0134","473","218","255","8","481","962","0","50.00","22.66"
"63","000","00","010","0035","0000","1463","715","748","14","1477","3047","0","48.47","23.47"
"63","000","00","010","0035","0067","537","271","266","3","540","1065","0","50.70","25.45"
"63","000","00","010","0035","0068","452","222","230","5","457","933","0","48.98","23.79"
"63","000","00","010","0035","0069","474","222","252","6","480","1049","0","45.76","21.16"
"63","000","00","020","0000","0000","84150","45522","38628","843","84993","181747","210936","46.76","25.05"
"63","000","00","020","0001","0000","2102","1449","653","26","2128","4958","0","42.92","29.23"
"63","000","00","020","0001","0135","548","371","177","11","559","1035","0","54.01","35.85"
"63","000","00","020","0001","0136","538","378","160","6","544","2128","0","25.56","17.76"
"63","000","00","020","0001","0137","543","394","149","4","547","940","0","58.19","41.91"
"63","000","00","020","0001","0138","473","306","167","5","478","855","0","55.91","35.79"
"63","000","00","020","0002","0000","1965","1165","800","18","1983","3767","0","52.64","30.93"
"63","000","00","020","0002","0139","666","399","267","8","674","1261","0","53.45","31.64"
"63","000","00","020","0002","0140","663","402","261","6","669","1247","0","53.65","32.24"
"63","000","00","020","0002","0141","636","364","272","4","640","1259","0","50.83","28.91"
"63","000","00","020","0003","0000","1009","597","412","10","1019","2224","0","45.82","26.84"
"63","000","00","020","0003","0142","391","244","147","5","396","934","0","42.40","26.12"
"63","000","00","020","0003","0143","618","353","265","5","623","1290","0","48.29","27.36"
"63","000","00","020","0004","0000","1295","710","585","12","1307","2903","0","45.02","24.46"
"63","000","00","020","0004","0144","388","205","183","1","389","847","0","45.93","24.20"
"63","000","00","020","0004","0145","441","257","184","4","445","971","0","45.83","26.47"
"63","000","00","020","0004","0146","466","248","218","7","473","1085","0","43.59","22.86"
"63","000","00","020","0005","0000","1330","793","537","15","1345","2732","0","49.23","29.03"
"63","000","00","020","0005","0147","449","291","158","8","457","958","0","47.70","30.38"
"63","000","00","020","0005","0148","422","237","185","5","427","858","0","49.77","27.62"
"63","000","00","020","0005","0149","459","265","194","2","461","916","0","50.33","28.93"
"63","000","00","020","0006","0000","2176","1148","1028","27","2203","4753","0","46.35","24.15"
"63","000","00","020","0006","0150","457","282","175","2","459","1056","0","43.47","26.70"
"63","000","00","020","0006","0151","603","325","278","9","612","1267","0","48.30","25.65"
"63","000","00","020","0006","0152","532","235","297","13","545","1082","0","50.37","21.72"
"63","000","00","020","0006","0153","584","306","278","3","587","1348","0","43.55","22.70"
"63","000","00","020","0007","0000","1984","1068","916","18","2002","4357","0","45.95","24.51"
"63","000","00","020","0007","0154","451","258","193","3","454","1002","0","45.31","25.75"
"63","000","00","020","0007","0155","573","327","246","5","578","1226","0","47.15","26.67"
"63","000","00","020","0007","0156","478","240","238","2","480","1108","0","43.32","21.66"
"63","000","00","020","0007","0157","482","243","239","8","490","1021","0","47.99","23.80"
"63","000","00","020","0008","0000","3047","1664","1383","35","3082","6335","0","48.65","26.27"
"63","000","00","020","0008","0158","535","301","234","10","545","1156","0","47.15","26.04"
"63","000","00","020","0008","0159","501","271","230","4","505","1055","0","47.87","25.69"
"63","000","00","020","0008","0160","506","291","215","5","511","1047","0","48.81","27.79"
"63","000","00","020","0008","0161","594","322","272","4","598","1113","0","53.73","28.93"
"63","000","00","020","0008","0162","482","279","203","8","490","1045","0","46.89","26.70"
"63","000","00","020","0008","0163","429","200","229","4","433","919","0","47.12","21.76"
"63","000","00","020","0009","0000","3903","2093","1810","37","3940","8511","0","46.29","24.59"
"63","000","00","020","0009","0164","631","289","342","6","637","1345","0","47.36","21.49"
"63","000","00","020","0009","0165","596","305","291","7","603","1242","0","48.55","24.56"
"63","000","00","020","0009","0166","543","290","253","2","545","1058","0","51.51","27.41"
"63","000","00","020","0009","0167","473","275","198","7","480","993","0","48.34","27.69"
"63","000","00","020","0009","0168","534","320","214","8","542","1156","0","46.89","27.68"
"63","000","00","020","0009","0169","522","291","231","3","525","1333","0","39.38","21.83"
"63","000","00","020","0009","0170","604","323","281","4","608","1384","0","43.93","23.34"
"63","000","00","020","0010","0000","1417","718","699","16","1433","3102","0","46.20","23.15"
"63","000","00","020","0010","0171","543","274","269","9","552","1129","0","48.89","24.27"
"63","000","00","020","0010","0172","390","210","180","4","394","918","0","42.92","22.88"
"63","000","00","020","0010","0173","484","234","250","3","487","1055","0","46.16","22.18"
"63","000","00","020","0011","0000","2018","970","1048","23","2041","4266","0","47.84","22.74"
"63","000","00","020","0011","0174","476","232","244","9","485","1085","0","44.70","21.38"
"63","000","00","020","0011","0175","527","251","276","6","533","1087","0","49.03","23.09"
"63","000","00","020","0011","0176","495","239","256","6","501","1026","0","48.83","23.29"
"63","000","00","020","0011","0177","520","248","272","2","522","1068","0","48.88","23.22"
"63","000","00","020","0012","0000","1476","772","704","11","1487","3106","0","47.88","24.86"
"63","000","00","020","0012","0178","469","243","226","1","470","1046","0","44.93","23.23"
"63","000","00","020","0012","0179","450","231","219","5","455","997","0","45.64","23.17"
"63","000","00","020","0012","0180","557","298","259","5","562","1063","0","52.87","28.03"
"63","000","00","020","0013","0000","1948","860","1088","13","1961","4081","0","48.05","21.07"
"63","000","00","020","0013","0181","475","219","256","3","478","960","0","49.79","22.81"
"63","000","00","020","0013","0182","537","229","308","3","540","1055","0","51.18","21.71"
"63","000","00","020","0013","0183","430","195","235","4","434","938","0","46.27","20.79"
"63","000","00","020","0013","0184","506","217","289","3","509","1128","0","45.12","19.24"
"63","000","00","020","0014","0000","1414","548","866","8","1422","3370","0","42.20","16.26"
"63","000","00","020","0014","0185","452","182","270","2","454","1114","0","40.75","16.34"
"63","000","00","020","0014","0186","419","164","255","6","425","1013","0","41.95","16.19"
"63","000","00","020","0014","0187","543","202","341","0","543","1243","0","43.68","16.25"
"63","000","00","020","0015","0000","1556","758","798","20","1576","3629","0","43.43","20.89"
"63","000","00","020","0015","0188","547","267","280","4","551","1203","0","45.80","22.19"
"63","000","00","020","0015","0189","453","248","205","8","461","1156","0","39.88","21.45"
"63","000","00","020","0015","0190","556","243","313","8","564","1270","0","44.41","19.13"
"63","000","00","020","0016","0000","2326","1072","1254","24","2350","4754","0","49.43","22.55"
"63","000","00","020","0016","0191","548","219","329","8","556","1135","0","48.99","19.30"
"63","000","00","020","0016","0192","589","268","321","6","595","1166","0","51.03","22.98"
"63","000","00","020","0016","0193","603","321","282","7","610","1203","0","50.71","26.68"
"63","000","00","020","0016","0194","586","264","322","3","589","1250","0","47.12","21.12"
"63","000","00","020","0017","0000","2121","1163","958","24","2145","4535","0","47.30","25.64"
"63","000","00","020","0017","0195","489","260","229","5","494","980","0","50.41","26.53"
"63","000","00","020","0017","0196","584","304","280","8","592","1180","0","50.17","25.76"
"63","000","00","020","0017","0197","520","305","215","9","529","1177","0","44.94","25.91"
"63","000","00","020","0017","0198","528","294","234","2","530","1198","0","44.24","24.54"
"63","000","00","020","0018","0000","1914","933","981","33","1947","4223","0","46.10","22.09"
"63","000","00","020","0018","0199","415","213","202","6","421","971","0","43.36","21.94"
"63","000","00","020","0018","0200","554","283","271","13","567","1165","0","48.67","24.29"
"63","000","00","020","0018","0201","508","240","268","6","514","1060","0","48.49","22.64"
"63","000","00","020","0018","0202","437","197","240","8","445","1027","0","43.33","19.18"
"63","000","00","020","0019","0000","1722","1069","653","24","1746","3723","0","46.90","28.71"
"63","000","00","020","0019","0203","424","261","163","1","425","1003","0","42.37","26.02"
"63","000","00","020","0019","0204","605","390","215","10","615","1334","0","46.10","29.24"
"63","000","00","020","0019","0205","693","418","275","13","706","1386","0","50.94","30.16"
"63","000","00","020","0020","0000","2822","1517","1305","23","2845","6147","0","46.28","24.68"
"63","000","00","020","0020","0206","448","231","217","2","450","1019","0","44.16","22.67"
"63","000","00","020","0020","0207","523","272","251","6","529","1121","0","47.19","24.26"
"63","000","00","020","0020","0208","435","237","198","0","435","965","0","45.08","24.56"
"63","000","00","020","0020","0209","511","277","234","3","514","1040","0","49.42","26.63"
"63","000","00","020","0020","0210","481","262","219","8","489","963","0","50.78","27.21"
"63","000","00","020","0020","0211","424","238","186","4","428","1039","0","41.19","22.91"
"63","000","00","020","0021","0000","872","462","410","7","879","1924","0","45.69","24.01"
"63","000","00","020","0021","0212","446","232","214","4","450","969","0","46.44","23.94"
"63","000","00","020","0021","0213","426","230","196","3","429","955","0","44.92","24.08"
"63","000","00","020","0022","0000","2527","1358","1169","20","2547","5536","0","46.01","24.53"
"63","000","00","020","0022","0214","427","219","208","6","433","1114","0","38.87","19.66"
"63","000","00","020","0022","0215","519","309","210","3","522","1067","0","48.92","28.96"
"63","000","00","020","0022","0216","493","251","242","2","495","1114","0","44.43","22.53"
"63","000","00","020","0022","0217","568","298","270","6","574","1133","0","50.66","26.30"
"63","000","00","020","0022","0218","520","281","239","3","523","1108","0","47.20","25.36"
"63","000","00","020","0023","0000","1949","947","1002","15","1964","4245","0","46.27","22.31"
"63","000","00","020","0023","0219","466","235","231","6","472","1053","0","44.82","22.32"
"63","000","00","020","0023","0220","505","256","249","3","508","1041","0","48.80","24.59"
"63","000","00","020","0023","0221","459","221","238","2","461","1018","0","45.28","21.71"
"63","000","00","020","0023","0222","519","235","284","4","523","1133","0","46.16","20.74"
"63","000","00","020","0024","0000","1865","943","922","22","1887","3791","0","49.78","24.87"
"63","000","00","020","0024","0223","505","266","239","6","511","1004","0","50.90","26.49"
"63","000","00","020","0024","0224","407","192","215","3","410","836","0","49.04","22.97"
"63","000","00","020","0024","0225","436","214","222","7","443","874","0","50.69","24.49"
"63","000","00","020","0024","0226","517","271","246","6","523","1077","0","48.56","25.16"
"63","000","00","020","0025","0000","3059","1458","1601","27","3086","6724","0","45.90","21.68"
"63","000","00","020","0025","0227","490","238","252","5","495","1065","0","46.48","22.35"
"63","000","00","020","0025","0228","526","226","300","8","534","1152","0","46.35","19.62"
"63","000","00","020","0025","0229","474","245","229","3","477","1056","0","45.17","23.20"
"63","000","00","020","0025","0230","479","242","237","0","479","1047","0","45.75","23.11"
"63","000","00","020","0025","0231","532","239","293","6","538","1204","0","44.68","19.85"
"63","000","00","020","0025","0232","558","268","290","5","563","1200","0","46.92","22.33"
"63","000","00","020","0026","0000","2474","1164","1310","14","2488","5177","0","48.06","22.48"
"63","000","00","020","0026","0233","501","256","245","6","507","1073","0","47.25","23.86"
"63","000","00","020","0026","0234","573","243","330","3","576","1158","0","49.74","20.98"
"63","000","00","020","0026","0235","477","245","232","4","481","1006","0","47.81","24.35"
"63","000","00","020","0026","0236","418","184","234","0","418","937","0","44.61","19.64"
"63","000","00","020","0026","0237","505","236","269","1","506","1003","0","50.45","23.53"
"63","000","00","020","0027","0000","1520","770","750","8","1528","3445","0","44.35","22.35"
"63","000","00","020","0027","0238","452","234","218","2","454","1115","0","40.72","20.99"
"63","000","00","020","0027","0239","526","258","268","4","530","1151","0","46.05","22.42"
"63","000","00","020","0027","0240","542","278","264","2","544","1179","0","46.14","23.58"
"63","000","00","020","0028","0000","2039","1194","845","23","2062","4324","0","47.69","27.61"
"63","000","00","020","0028","0241","582","286","296","7","589","1168","0","50.43","24.49"
"63","000","00","020","0028","0242","515","303","212","5","520","1014","0","51.28","29.88"
"63","000","00","020","0028","0243","452","283","169","6","458","1042","0","43.95","27.16"
"63","000","00","020","0028","0244","490","322","168","5","495","1100","0","45.00","29.27"
"63","000","00","020","0029","0000","2535","1496","1039","29","2564","5572","0","46.02","26.85"
"63","000","00","020","0029","0245","458","267","191","4","462","1049","0","44.04","25.45"
"63","000","00","020","0029","0246","463","257","206","7","470","1036","0","45.37","24.81"
"63","000","00","020","0029","0247","531","318","213","2","533","1187","0","44.90","26.79"
"63","000","00","020","0029","0248","531","329","202","7","538","1064","0","50.56","30.92"
"63","000","00","020","0029","0249","552","325","227","9","561","1236","0","45.39","26.29"
"63","000","00","020","0030","0000","3542","1985","1557","33","3575","7503","0","47.65","26.46"
"63","000","00","020","0030","0250","535","284","251","5","540","1069","0","50.51","26.57"
"63","000","00","020","0030","0251","555","335","220","3","558","1083","0","51.52","30.93"
"63","000","00","020","0030","0252","534","307","227","3","537","1107","0","48.51","27.73"
"63","000","00","020","0030","0253","505","283","222","5","510","1093","0","46.66","25.89"
"63","000","00","020","0030","0254","494","263","231","7","501","1110","0","45.14","23.69"
"63","000","00","020","0030","0255","448","295","153","5","453","988","0","45.85","29.86"
"63","000","00","020","0030","0256","471","218","253","5","476","1053","0","45.20","20.70"
"63","000","00","020","0031","0000","2010","1131","879","23","2033","4453","0","45.65","25.40"
"63","000","00","020","0031","0257","516","297","219","9","525","1140","0","46.05","26.05"
"63","000","00","020","0031","0258","516","302","214","5","521","1157","0","45.03","26.10"
"63","000","00","020","0031","0259","497","269","228","2","499","1084","0","46.03","24.82"
"63","000","00","020","0031","0260","481","263","218","7","488","1072","0","45.52","24.53"
"63","000","00","020","0032","0000","2658","1625","1033","29","2687","5784","0","46.46","28.09"
"63","000","00","020","0032","0261","580","385","195","5","585","1135","0","51.54","33.92"
"63","000","00","020","0032","0262","569","336","233","7","576","1144","0","50.35","29.37"
"63","000","00","020","0032","0263","478","279","199","3","481","1202","0","40.02","23.21"
"63","000","00","020","0032","0264","404","250","154","8","412","1005","0","41.00","24.88"
"63","000","00","020","0032","0265","627","375","252","6","633","1298","0","48.77","28.89"
"63","000","00","020","0033","0000","2730","1530","1200","25","2755","6519","0","42.26","23.47"
"63","000","00","020","0033","0266","352","205","147","4","356","861","0","41.35","23.81"
"63","000","00","020","0033","0267","437","240","197","3","440","1055","0","41.71","22.75"
"63","000","00","020","0033","0268","520","315","205","6","526","1206","0","43.62","26.12"
"63","000","00","020","0033","0269","451","233","218","5","456","1101","0","41.42","21.16"
"63","000","00","020","0033","0270","529","284","245","2","531","1261","0","42.11","22.52"
"63","000","00","020","0033","0271","441","253","188","5","446","1035","0","43.09","24.44"
"63","000","00","020","0034","0000","1913","1044","869","18","1931","3961","0","48.75","26.36"
"63","000","00","020","0034","0272","483","241","242","6","489","1027","0","47.61","23.47"
"63","000","00","020","0034","0273","449","272","177","1","450","996","0","45.18","27.31"
"63","000","00","020","0034","0274","521","245","276","5","526","1050","0","50.10","23.33"
"63","000","00","020","0034","0275","460","286","174","6","466","888","0","52.48","32.21"
"63","000","00","020","0035","0000","1478","851","627","11","1489","3292","0","45.23","25.85"
"63","000","00","020","0035","0276","443","251","192","2","445","1039","0","42.83","24.16"
"63","000","00","020","0035","0277","526","272","254","4","530","1122","0","47.24","24.24"
"63","000","00","020","0035","0278","509","328","181","5","514","1131","0","45.45","29.00"
"63","000","00","020","0036","0000","2930","1693","1237","22","2952","6033","0","48.93","28.06"
"63","000","00","020","0036","0279","630","335","295","5","635","1185","0","53.59","28.27"
"63","000","00","020","0036","0280","591","350","241","3","594","1151","0","51.61","30.41"
"63","000","00","020","0036","0281","596","326","270","6","602","1332","0","45.20","24.47"
"63","000","00","020","0036","0282","541","352","189","4","545","1113","0","48.97","31.63"
"63","000","00","020","0036","0283","572","330","242","4","576","1252","0","46.01","26.36"
"63","000","00","020","0037","0000","1322","708","614","14","1336","2713","0","49.24","26.10"
"63","000","00","020","0037","0284","445","250","195","5","450","849","0","53.00","29.45"
"63","000","00","020","0037","0285","460","214","246","6","466","948","0","49.16","22.57"
"63","000","00","020","0037","0286","417","244","173","3","420","916","0","45.85","26.64"
"63","000","00","020","0038","0000","1553","873","680","15","1568","3427","0","45.75","25.47"
"63","000","00","020","0038","0287","443","234","209","7","450","1169","0","38.49","20.02"
"63","000","00","020","0038","0288","548","310","238","2","550","1118","0","49.19","27.73"
"63","000","00","020","0038","0289","562","329","233","6","568","1140","0","49.82","28.86"
"63","000","00","020","0039","0000","2906","1637","1269","40","2946","5973","0","49.32","27.41"
"63","000","00","020","0039","0290","576","312","264","8","584","1196","0","48.83","26.09"
"63","000","00","020","0039","0291","590","331","259","14","604","1254","0","48.17","26.40"
"63","000","00","020","0039","0292","492","279","213","5","497","1025","0","48.49","27.22"
"63","000","00","020","0039","0293","619","372","247","6","625","1262","0","49.52","29.48"
"63","000","00","020","0039","0294","629","343","286","7","636","1236","0","51.46","27.75"
"63","000","00","020","0040","0000","1990","1116","874","15","2005","4141","0","48.42","26.95"
"63","000","00","020","0040","0295","535","299","236","5","540","1141","0","47.33","26.21"
"63","000","00","020","0040","0296","446","255","191","3","449","921","0","48.75","27.69"
"63","000","00","020","0040","0297","556","330","226","4","560","1111","0","50.41","29.70"
"63","000","00","020","0040","0298","453","232","221","3","456","968","0","47.11","23.97"
"63","000","00","020","0041","0000","733","470","263","16","749","1734","0","43.19","27.10"
"63","000","00","020","0041","0299","421","241","180","8","429","984","0","43.60","24.49"
"63","000","00","020","0041","0300","312","229","83","8","320","750","0","42.67","30.53"
"63","000","00","030","0000","0000","116995","64621","52374","1132","118127","242869","296546","48.64","26.61"
"63","000","00","030","0001","0000","2293","1377","916","15","2308","4632","0","49.83","29.73"
"63","000","00","030","0001","0301","532","295","237","4","536","1147","0","46.73","25.72"
"63","000","00","030","0001","0302","509","302","207","5","514","1124","0","45.73","26.87"
"63","000","00","030","0001","0303","619","382","237","1","620","1156","0","53.63","33.04"
"63","000","00","030","0001","0304","633","398","235","5","638","1205","0","52.95","33.03"
"63","000","00","030","0002","0000","2172","1084","1088","15","2187","4304","0","50.81","25.19"
"63","000","00","030","0002","0305","732","360","372","4","736","1462","0","50.34","24.62"
"63","000","00","030","0002","0306","629","294","335","4","633","1294","0","48.92","22.72"
"63","000","00","030","0002","0307","811","430","381","7","818","1548","0","52.84","27.78"
"63","000","00","030","0003","0000","2631","1478","1153","16","2647","5471","0","48.38","27.02"
"63","000","00","030","0003","0308","724","412","312","4","728","1325","0","54.94","31.09"
"63","000","00","030","0003","0309","554","298","256","5","559","1250","0","44.72","23.84"
"63","000","00","030","0003","0310","686","371","315","4","690","1501","0","45.97","24.72"
"63","000","00","030","0003","0311","667","397","270","3","670","1395","0","48.03","28.46"
"63","000","00","030","0004","0000","3229","1671","1558","23","3252","6608","0","49.21","25.29"
"63","000","00","030","0004","0312","562","281","281","4","566","1171","0","48.33","24.00"
"63","000","00","030","0004","0313","620","310","310","3","623","1230","0","50.65","25.20"
"63","000","00","030","0004","0314","691","305","386","4","695","1442","0","48.20","21.15"
"63","000","00","030","0004","0315","646","385","261","5","651","1332","0","48.87","28.90"
"63","000","00","030","0004","0316","710","390","320","7","717","1433","0","50.03","27.22"
"63","000","00","030","0005","0000","1910","1012","898","19","1929","4212","0","45.80","24.03"
"63","000","00","030","0005","0317","511","259","252","6","517","1096","0","47.17","23.63"
"63","000","00","030","0005","0318","499","256","243","2","501","1118","0","44.81","22.90"
"63","000","00","030","0005","0319","490","281","209","5","495","1060","0","46.70","26.51"
"63","000","00","030","0005","0320","410","216","194","6","416","938","0","44.35","23.03"
"63","000","00","030","0006","0000","2463","1578","885","17","2480","4707","0","52.69","33.52"
"63","000","00","030","0006","0321","452","329","123","6","458","917","0","49.95","35.88"
"63","000","00","030","0006","0322","653","511","142","4","657","1232","0","53.33","41.48"
"63","000","00","030","0006","0323","673","429","244","3","676","1294","0","52.24","33.15"
"63","000","00","030","0006","0324","685","309","376","4","689","1264","0","54.51","24.45"
"63","000","00","030","0007","0000","2708","1404","1304","25","2733","5704","0","47.91","24.61"
"63","000","00","030","0007","0325","721","377","344","5","726","1514","0","47.95","24.90"
"63","000","00","030","0007","0326","686","351","335","5","691","1390","0","49.71","25.25"
"63","000","00","030","0007","0327","755","397","358","10","765","1556","0","49.16","25.51"
"63","000","00","030","0007","0328","546","279","267","5","551","1244","0","44.29","22.43"
"63","000","00","030","0008","0000","1359","669","690","10","1369","2713","0","50.46","24.66"
"63","000","00","030","0008","0329","627","318","309","5","632","1229","0","51.42","25.87"
"63","000","00","030","0008","0330","732","351","381","5","737","1484","0","49.66","23.65"
"63","000","00","030","0009","0000","1666","848","818","18","1684","3427","0","49.14","24.74"
"63","000","00","030","0009","0331","545","278","267","4","549","1148","0","47.82","24.22"
"63","000","00","030","0009","0332","598","303","295","7","605","1179","0","51.31","25.70"
"63","000","00","030","0009","0333","523","267","256","7","530","1100","0","48.18","24.27"
"63","000","00","030","0010","0000","2846","1508","1338","28","2874","6211","0","46.27","24.28"
"63","000","00","030","0010","0334","500","287","213","2","502","1198","0","41.90","23.96"
"63","000","00","030","0010","0335","665","340","325","7","672","1375","0","48.87","24.73"
"63","000","00","030","0010","0336","594","302","292","6","600","1218","0","49.26","24.79"
"63","000","00","030","0010","0337","537","271","266","6","543","1217","0","44.62","22.27"
"63","000","00","030","0010","0338","550","308","242","7","557","1203","0","46.30","25.60"
"63","000","00","030","0011","0000","2339","1261","1078","30","2369","4608","0","51.41","27.37"
"63","000","00","030","0011","0339","490","244","246","7","497","1053","0","47.20","23.17"
"63","000","00","030","0011","0340","654","345","309","5","659","1248","0","52.80","27.64"
"63","000","00","030","0011","0341","656","332","324","10","666","1254","0","53.11","26.48"
"63","000","00","030","0011","0342","539","340","199","8","547","1053","0","51.95","32.29"
"63","000","00","030","0012","0000","1909","983","926","18","1927","4046","0","47.63","24.30"
"63","000","00","030","0012","0343","603","305","298","4","607","1305","0","46.51","23.37"
"63","000","00","030","0012","0344","684","351","333","9","693","1392","0","49.78","25.22"
"63","000","00","030","0012","0345","622","327","295","5","627","1349","0","46.48","24.24"
"63","000","00","030","0013","0000","1794","935","859","15","1809","3495","0","51.76","26.75"
"63","000","00","030","0013","0346","571","283","288","5","576","1134","0","50.79","24.96"
"63","000","00","030","0013","0347","629","328","301","6","635","1241","0","51.17","26.43"
"63","000","00","030","0013","0348","594","324","270","4","598","1120","0","53.39","28.93"
"63","000","00","030","0014","0000","2894","1534","1360","20","2914","6074","0","47.97","25.26"
"63","000","00","030","0014","0349","585","301","284","8","593","1185","0","50.04","25.40"
"63","000","00","030","0014","0350","579","359","220","4","583","1226","0","47.55","29.28"
"63","000","00","030","0014","0351","611","336","275","0","611","1198","0","51.00","28.05"
"63","000","00","030","0014","0352","559","266","293","4","563","1228","0","45.85","21.66"
"63","000","00","030","0014","0353","560","272","288","4","564","1237","0","45.59","21.99"
"63","000","00","030","0015","0000","2440","1235","1205","22","2462","6710","0","36.69","18.41"
"63","000","00","030","0015","0354","517","283","234","5","522","2719","0","19.20","10.41"
"63","000","00","030","0015","0355","602","273","329","2","604","1259","0","47.97","21.68"
"63","000","00","030","0015","0356","632","321","311","8","640","1287","0","49.73","24.94"
"63","000","00","030","0015","0357","689","358","331","7","696","1445","0","48.17","24.78"
"63","000","00","030","0016","0000","2353","1286","1067","16","2369","4806","0","49.29","26.76"
"63","000","00","030","0016","0358","521","328","193","4","525","1049","0","50.05","31.27"
"63","000","00","030","0016","0359","677","356","321","2","679","1290","0","52.64","27.60"
"63","000","00","030","0016","0360","560","297","263","4","564","1202","0","46.92","24.71"
"63","000","00","030","0016","0361","595","305","290","6","601","1265","0","47.51","24.11"
"63","000","00","030","0017","0000","2381","1221","1160","13","2394","5061","0","47.30","24.13"
"63","000","00","030","0017","0362","587","305","282","6","593","1302","0","45.55","23.43"
"63","000","00","030","0017","0363","577","299","278","2","579","1259","0","45.99","23.75"
"63","000","00","030","0017","0364","624","327","297","2","626","1317","0","47.53","24.83"
"63","000","00","030","0017","0365","593","290","303","3","596","1183","0","50.38","24.51"
"63","000","00","030","0018","0000","1431","761","670","10","1441","2977","0","48.40","25.56"
"63","000","00","030","0018","0366","463","239","224","4","467","963","0","48.49","24.82"
"63","000","00","030","0018","0367","484","266","218","5","489","965","0","50.67","27.56"
"63","000","00","030","0018","0368","484","256","228","1","485","1049","0","46.23","24.40"
"63","000","00","030","0019","0000","1466","782","684","23","1489","2987","0","49.85","26.18"
"63","000","00","030","0019","0369","742","417","325","11","753","1480","0","50.88","28.18"
"63","000","00","030","0019","0370","724","365","359","12","736","1507","0","48.84","24.22"
"63","000","00","030","0020","0000","1496","861","635","18","1514","3004","0","50.40","28.66"
"63","000","00","030","0020","0371","762","467","295","12","774","1491","0","51.91","31.32"
"63","000","00","030","0020","0372","734","394","340","6","740","1513","0","48.91","26.04"
"63","000","00","030","0021","0000","2362","1312","1050","18","2380","4627","0","51.44","28.36"
"63","000","00","030","0021","0373","499","277","222","7","506","1046","0","48.37","26.48"
"63","000","00","030","0021","0374","616","368","248","3","619","1115","0","55.52","33.00"
"63","000","00","030","0021","0375","617","331","286","5","622","1231","0","50.53","26.89"
"63","000","00","030","0021","0376","630","336","294","3","633","1235","0","51.26","27.21"
"63","000","00","030","0022","0000","2699","1559","1140","25","2724","5613","0","48.53","27.77"
"63","000","00","030","0022","0377","586","339","247","9","595","1322","0","45.01","25.64"
"63","000","00","030","0022","0378","738","425","313","10","748","1477","0","50.64","28.77"
"63","000","00","030","0022","0379","644","367","277","4","648","1373","0","47.20","26.73"
"63","000","00","030","0022","0380","731","428","303","2","733","1441","0","50.87","29.70"
"63","000","00","030","0023","0000","2882","1897","985","25","2907","5527","0","52.60","34.32"
"63","000","00","030","0023","0381","699","401","298","5","704","1329","0","52.97","30.17"
"63","000","00","030","0023","0382","681","444","237","8","689","1388","0","49.64","31.99"
"63","000","00","030","0023","0383","745","488","257","6","751","1411","0","53.22","34.59"
"63","000","00","030","0023","0384","757","564","193","6","763","1399","0","54.54","40.31"
"63","000","00","030","0026","0000","1468","820","648","17","1485","2947","0","50.39","27.82"
"63","000","00","030","0026","0385","762","418","344","8","770","1551","0","49.65","26.95"
"63","000","00","030","0026","0386","706","402","304","9","715","1396","0","51.22","28.80"
"63","000","00","030","0027","0000","1994","1061","933","19","2013","3937","0","51.13","26.95"
"63","000","00","030","0027","0387","735","397","338","4","739","1446","0","51.11","27.46"
"63","000","00","030","0027","0388","745","391","354","8","753","1365","0","55.16","28.64"
"63","000","00","030","0027","0389","514","273","241","7","521","1126","0","46.27","24.25"
"63","000","00","030","0028","0000","2747","1553","1194","34","2781","5409","0","51.41","28.71"
"63","000","00","030","0028","0390","710","398","312","8","718","1374","0","52.26","28.97"
"63","000","00","030","0028","0391","699","388","311","13","712","1398","0","50.93","27.75"
"63","000","00","030","0028","0392","670","381","289","10","680","1316","0","51.67","28.95"
"63","000","00","030","0028","0393","668","386","282","3","671","1321","0","50.79","29.22"
"63","000","00","030","0029","0000","1877","1072","805","16","1893","4245","0","44.59","25.25"
"63","000","00","030","0029","0394","639","359","280","3","642","1423","0","45.12","25.23"
"63","000","00","030","0029","0395","575","310","265","5","580","1399","0","41.46","22.16"
"63","000","00","030","0029","0396","663","403","260","8","671","1423","0","47.15","28.32"
"63","000","00","030","0030","0000","2073","1186","887","12","2085","4455","0","46.80","26.62"
"63","000","00","030","0030","0397","511","290","221","3","514","1155","0","44.50","25.11"
"63","000","00","030","0030","0398","520","300","220","2","522","1055","0","49.48","28.44"
"63","000","00","030","0030","0399","537","303","234","3","540","1149","0","47.00","26.37"
"63","000","00","030","0030","0400","505","293","212","4","509","1096","0","46.44","26.73"
"63","000","00","030","0031","0000","2475","1219","1256","29","2504","5249","0","47.70","23.22"
"63","000","00","030","0031","0401","616","317","299","6","622","1288","0","48.29","24.61"
"63","000","00","030","0031","0402","666","353","313","10","676","1358","0","49.78","25.99"
"63","000","00","030","0031","0403","628","293","335","10","638","1347","0","47.36","21.75"
"63","000","00","030","0031","0404","565","256","309","3","568","1256","0","45.22","20.38"
"63","000","00","030","0032","0000","2183","1150","1033","26","2209","4590","0","48.13","25.05"
"63","000","00","030","0032","0405","530","295","235","5","535","1089","0","49.13","27.09"
"63","000","00","030","0032","0406","503","235","268","6","509","1011","0","50.35","23.24"
"63","000","00","030","0032","0407","572","308","264","5","577","1284","0","44.94","23.99"
"63","000","00","030","0032","0408","578","312","266","10","588","1206","0","48.76","25.87"
"63","000","00","030","0033","0000","1628","870","758","23","1651","3527","0","46.81","24.67"
"63","000","00","030","0033","0409","533","287","246","9","542","1261","0","42.98","22.76"
"63","000","00","030","0033","0410","571","299","272","9","580","1202","0","48.25","24.88"
"63","000","00","030","0033","0411","524","284","240","5","529","1064","0","49.72","26.69"
"63","000","00","030","0034","0000","1867","1132","735","19","1886","3732","0","50.54","30.33"
"63","000","00","030","0034","0412","566","344","222","6","572","1154","0","49.57","29.81"
"63","000","00","030","0034","0413","680","455","225","6","686","1375","0","49.89","33.09"
"63","000","00","030","0034","0414","621","333","288","7","628","1203","0","52.20","27.68"
"63","000","00","030","0035","0000","1788","1026","762","15","1803","3699","0","48.74","27.74"
"63","000","00","030","0035","0415","593","323","270","1","594","1240","0","47.90","26.05"
"63","000","00","030","0035","0416","601","369","232","6","607","1244","0","48.79","29.66"
"63","000","00","030","0035","0417","594","334","260","8","602","1215","0","49.55","27.49"
"63","000","00","030","0036","0000","2397","1449","948","26","2423","4899","0","49.46","29.58"
"63","000","00","030","0036","0418","670","377","293","5","675","1323","0","51.02","28.50"
"63","000","00","030","0036","0419","538","303","235","8","546","1103","0","49.50","27.47"
"63","000","00","030","0036","0420","632","408","224","11","643","1320","0","48.71","30.91"
"63","000","00","030","0036","0421","557","361","196","2","559","1153","0","48.48","31.31"
"63","000","00","030","0037","0000","3129","2209","920","33","3162","5848","0","54.07","37.77"
"63","000","00","030","0037","0422","627","513","114","11","638","1157","0","55.14","44.34"
"63","000","00","030","0037","0423","591","404","187","5","596","1064","0","56.02","37.97"
"63","000","00","030","0037","0424","609","428","181","4","613","1133","0","54.10","37.78"
"63","000","00","030","0037","0425","677","434","243","8","685","1271","0","53.89","34.15"
"63","000","00","030","0037","0426","625","430","195","5","630","1223","0","51.51","35.16"
"63","000","00","030","0038","0000","1553","853","700","10","1563","3137","0","49.82","27.19"
"63","000","00","030","0038","0427","719","363","356","3","722","1433","0","50.38","25.33"
"63","000","00","030","0038","0428","391","233","158","5","396","752","0","52.66","30.98"
"63","000","00","030","0038","0429","443","257","186","2","445","952","0","46.74","27.00"
"63","000","00","030","0039","0000","870","508","362","13","883","1729","0","51.07","29.38"
"63","000","00","030","0039","0430","435","261","174","3","438","900","0","48.67","29.00"
"63","000","00","030","0039","0431","435","247","188","10","445","829","0","53.68","29.79"
"63","000","00","030","0040","0000","3680","1955","1725","31","3711","7435","0","49.91","26.29"
"63","000","00","030","0040","0432","634","338","296","8","642","1325","0","48.45","25.51"
"63","000","00","030","0040","0433","664","375","289","5","669","1272","0","52.59","29.48"
"63","000","00","030","0040","0434","560","301","259","3","563","1129","0","49.87","26.66"
"63","000","00","030","0040","0435","592","326","266","5","597","1265","0","47.19","25.77"
"63","000","00","030","0040","0436","624","301","323","5","629","1228","0","51.22","24.51"
"63","000","00","030","0040","0437","606","314","292","5","611","1216","0","50.25","25.82"
"63","000","00","030","0041","0000","1840","960","880","20","1860","3529","0","52.71","27.20"
"63","000","00","030","0041","0438","611","302","309","8","619","1232","0","50.24","24.51"
"63","000","00","030","0041","0439","580","302","278","5","585","1083","0","54.02","27.89"
"63","000","00","030","0041","0440","649","356","293","7","656","1214","0","54.04","29.32"
"63","000","00","030","0043","0000","3640","1963","1677","37","3677","6961","0","52.82","28.20"
"63","000","00","030","0043","0441","790","412","378","9","799","1475","0","54.17","27.93"
"63","000","00","030","0043","0442","705","388","317","7","712","1387","0","51.33","27.97"
"63","000","00","030","0043","0443","706","376","330","9","715","1364","0","52.42","27.57"
"63","000","00","030","0043","0444","706","410","296","8","714","1407","0","50.75","29.14"
"63","000","00","030","0043","0445","733","377","356","4","737","1328","0","55.50","28.39"
"63","000","00","030","0044","0000","2338","1337","1001","23","2361","4904","0","48.14","27.26"
"63","000","00","030","0044","0446","558","330","228","7","565","1238","0","45.64","26.66"
"63","000","00","030","0044","0447","595","345","250","6","601","1191","0","50.46","28.97"
"63","000","00","030","0044","0448","577","327","250","6","583","1232","0","47.32","26.54"
"63","000","00","030","0044","0449","608","335","273","4","612","1243","0","49.24","26.95"
"63","000","00","030","0046","0000","2088","1130","958","34","2122","4683","0","45.31","24.13"
"63","000","00","030","0046","0450","556","318","238","9","565","1277","0","44.24","24.90"
"63","000","00","030","0046","0451","499","261","238","7","506","1094","0","46.25","23.86"
"63","000","00","030","0046","0452","488","251","237","9","497","1019","0","48.77","24.63"
"63","000","00","030","0046","0453","545","300","245","9","554","1293","0","42.85","23.20"
"63","000","00","030","0047","0000","3195","1742","1453","37","3232","6467","0","49.98","26.94"
"63","000","00","030","0047","0454","669","348","321","8","677","1403","0","48.25","24.80"
"63","000","00","030","0047","0455","617","355","262","5","622","1308","0","47.55","27.14"
"63","000","00","030","0047","0456","631","345","286","8","639","1228","0","52.04","28.09"
"63","000","00","030","0047","0457","650","360","290","10","660","1247","0","52.93","28.87"
"63","000","00","030","0047","0458","628","334","294","6","634","1281","0","49.49","26.07"
"63","000","00","030","0048","0000","1876","1097","779","25","1901","3938","0","48.27","27.86"
"63","000","00","030","0048","0459","622","362","260","7","629","1357","0","46.35","26.68"
"63","000","00","030","0048","0460","625","349","276","9","634","1244","0","50.96","28.05"
"63","000","00","030","0048","0461","629","386","243","9","638","1337","0","47.72","28.87"
"63","000","00","030","0049","0000","1821","1009","812","11","1832","4048","0","45.26","24.93"
"63","000","00","030","0049","0462","608","322","286","5","613","1380","0","44.42","23.33"
"63","000","00","030","0049","0463","625","354","271","3","628","1304","0","48.16","27.15"
"63","000","00","030","0049","0464","588","333","255","3","591","1364","0","43.33","24.41"
"63","000","00","030","0050","0000","2267","1231","1036","24","2291","5023","0","45.61","24.51"
"63","000","00","030","0050","0465","505","282","223","5","510","1200","0","42.50","23.50"
"63","000","00","030","0050","0466","592","313","279","10","602","1336","0","45.06","23.43"
"63","000","00","030","0050","0467","568","311","257","5","573","1233","0","46.47","25.22"
"63","000","00","030","0050","0468","602","325","277","4","606","1254","0","48.33","25.92"
"63","000","00","030","0051","0000","2345","1222","1123","26","2371","5100","0","46.49","23.96"
"63","000","00","030","0051","0469","559","280","279","6","565","1255","0","45.02","22.31"
"63","000","00","030","0051","0470","656","327","329","4","660","1308","0","50.46","25.00"
"63","000","00","030","0051","0471","548","303","245","9","557","1232","0","45.21","24.59"
"63","000","00","030","0051","0472","582","312","270","7","589","1305","0","45.13","23.91"
"63","000","00","030","0052","0000","1761","995","766","19","1780","3818","0","46.62","26.06"
"63","000","00","030","0052","0473","632","384","248","5","637","1303","0","48.89","29.47"
"63","000","00","030","0052","0474","577","328","249","6","583","1280","0","45.55","25.63"
"63","000","00","030","0052","0475","552","283","269","8","560","1235","0","45.34","22.91"
"63","000","00","030","0053","0000","2336","1229","1107","26","2362","4922","0","47.99","24.97"
"63","000","00","030","0053","0476","587","322","265","6","593","1205","0","49.21","26.72"
"63","000","00","030","0053","0477","553","322","231","6","559","1247","0","44.83","25.82"
"63","000","00","030","0053","0478","623","295","328","8","631","1201","0","52.54","24.56"
"63","000","00","030","0053","0479","573","290","283","6","579","1269","0","45.63","22.85"
"63","000","00","030","0054","0000","1577","860","717","10","1587","3473","0","45.70","24.76"
"63","000","00","030","0054","0480","554","282","272","0","554","1241","0","44.64","22.72"
"63","000","00","030","0054","0481","482","301","181","4","486","1142","0","42.56","26.36"
"63","000","00","030","0054","0482","541","277","264","6","547","1090","0","50.18","25.41"
"63","000","00","030","0055","0000","2435","1273","1162","23","2458","5221","0","47.08","24.38"
"63","000","00","030","0055","0483","560","271","289","9","569","1255","0","45.34","21.59"
"63","000","00","030","0055","0484","598","325","273","6","604","1275","0","47.37","25.49"
"63","000","00","030","0055","0485","657","369","288","5","662","1322","0","50.08","27.91"
"63","000","00","030","0055","0486","620","308","312","3","623","1369","0","45.51","22.50"
"63","000","00","030","0056","0000","3054","1675","1379","43","3097","6249","0","49.56","26.80"
"63","000","00","030","0056","0487","724","413","311","13","737","1392","0","52.95","29.67"
"63","000","00","030","0056","0488","554","275","279","4","558","1217","0","45.85","22.60"
"63","000","00","030","0056","0489","567","322","245","9","576","1233","0","46.72","26.12"
"63","000","00","030","0056","0490","577","333","244","10","587","1199","0","48.96","27.77"
"63","000","00","030","0056","0491","632","332","300","7","639","1208","0","52.90","27.48"
"63","000","00","030","0057","0000","970","579","391","12","982","2171","0","45.23","26.67"
"63","000","00","030","0057","0492","367","230","137","1","368","866","0","42.49","26.56"
"63","000","00","030","0057","0493","247","147","100","6","253","604","0","41.89","24.34"
"63","000","00","030","0057","0494","356","202","154","5","361","701","0","51.50","28.82"
"63","000","00","040","0000","0000","86263","41082","45181","794","87057","188193","219840","46.26","21.83"
"63","000","00","040","0001","0000","1271","603","668","15","1286","2806","0","45.83","21.49"
"63","000","00","040","0001","0495","661","334","327","6","667","1509","0","44.20","22.13"
"63","000","00","040","0001","0496","610","269","341","9","619","1297","0","47.73","20.74"
"63","000","00","040","0002","0000","1848","920","928","14","1862","4541","0","41.00","20.26"
"63","000","00","040","0002","0497","628","325","303","4","632","1571","0","40.23","20.69"
"63","000","00","040","0002","0498","622","307","315","6","628","1540","0","40.78","19.94"
"63","000","00","040","0002","0499","598","288","310","4","602","1430","0","42.10","20.14"
"63","000","00","040","0003","0000","1370","669","701","17","1387","3136","0","44.23","21.33"
"63","000","00","040","0003","0500","688","331","357","4","692","1538","0","44.99","21.52"
"63","000","00","040","0003","0501","682","338","344","13","695","1598","0","43.49","21.15"
"63","000","00","040","0004","0000","1820","809","1011","17","1837","3798","0","48.37","21.30"
"63","000","00","040","0004","0502","604","238","366","5","609","1279","0","47.62","18.61"
"63","000","00","040","0004","0503","554","268","286","7","561","1123","0","49.96","23.86"
"63","000","00","040","0004","0504","662","303","359","5","667","1396","0","47.78","21.70"
"63","000","00","040","0005","0000","1005","518","487","9","1014","2307","0","43.95","22.45"
"63","000","00","040","0005","0505","437","222","215","4","441","1020","0","43.24","21.76"
"63","000","00","040","0005","0506","568","296","272","5","573","1287","0","44.52","23.00"
"63","000","00","040","0006","0000","2493","1161","1332","25","2518","5902","0","42.66","19.67"
"63","000","00","040","0006","0507","486","212","274","2","488","1110","0","43.96","19.10"
"63","000","00","040","0006","0508","532","238","294","7","539","1186","0","45.45","20.07"
"63","000","00","040","0006","0509","461","225","236","4","465","1142","0","40.72","19.70"
"63","000","00","040","0006","0510","434","231","203","8","442","1169","0","37.81","19.76"
"63","000","00","040","0006","0511","580","255","325","4","584","1295","0","45.10","19.69"
"63","000","00","040","0007","0000","1463","761","702","10","1473","3728","0","39.51","20.41"
"63","000","00","040","0007","0512","508","234","274","5","513","1263","0","40.62","18.53"
"63","000","00","040","0007","0513","507","260","247","0","507","1204","0","42.11","21.59"
"63","000","00","040","0007","0514","448","267","181","5","453","1261","0","35.92","21.17"
"63","000","00","040","0008","0000","2719","1166","1553","21","2740","5936","0","46.16","19.64"
"63","000","00","040","0008","0515","716","288","428","6","722","1470","0","49.12","19.59"
"63","000","00","040","0008","0516","703","319","384","5","708","1533","0","46.18","20.81"
"63","000","00","040","0008","0517","669","263","406","6","675","1503","0","44.91","17.50"
"63","000","00","040","0008","0518","631","296","335","4","635","1430","0","44.41","20.70"
"63","000","00","040","0009","0000","1488","667","821","10","1498","3471","0","43.16","19.22"
"63","000","00","040","0009","0519","480","221","259","9","489","1125","0","43.47","19.64"
"63","000","00","040","0009","0520","582","241","341","0","582","1195","0","48.70","20.17"
"63","000","00","040","0009","0521","426","205","221","1","427","1151","0","37.10","17.81"
"63","000","00","040","0010","0000","1776","823","953","17","1793","4310","0","41.60","19.10"
"63","000","00","040","0010","0522","500","205","295","5","505","1124","0","44.93","18.24"
"63","000","00","040","0010","0523","483","226","257","5","488","1202","0","40.60","18.80"
"63","000","00","040","0010","0524","448","218","230","4","452","1056","0","42.80","20.64"
"63","000","00","040","0010","0525","345","174","171","3","348","928","0","37.50","18.75"
"63","000","00","040","0011","0000","1939","977","962","18","1957","4704","0","41.60","20.77"
"63","000","00","040","0011","0526","458","238","220","5","463","1208","0","38.33","19.70"
"63","000","00","040","0011","0527","446","230","216","8","454","1030","0","44.08","22.33"
"63","000","00","040","0011","0528","530","253","277","2","532","1227","0","43.36","20.62"
"63","000","00","040","0011","0529","505","256","249","3","508","1239","0","41.00","20.66"
"63","000","00","040","0012","0000","1542","700","842","16","1558","3587","0","43.43","19.51"
"63","000","00","040","0012","0530","462","207","255","7","469","1136","0","41.29","18.22"
"63","000","00","040","0012","0531","602","272","330","5","607","1288","0","47.13","21.12"
"63","000","00","040","0012","0532","478","221","257","4","482","1163","0","41.44","19.00"
"63","000","00","040","0013","0000","1553","1169","384","19","1572","3095","0","50.79","37.77"
"63","000","00","040","0013","0536","495","376","119","5","500","984","0","50.81","38.21"
"63","000","00","040","0013","0537","475","325","150","6","481","1081","0","44.50","30.06"
"63","000","00","040","0013","0538","583","468","115","8","591","1030","0","57.38","45.44"
"63","000","00","040","0014","0000","3692","2037","1655","39","3731","7456","0","50.04","27.32"
"63","000","00","040","0014","0539","669","348","321","8","677","1332","0","50.83","26.13"
"63","000","00","040","0014","0540","578","332","246","7","585","1154","0","50.69","28.77"
"63","000","00","040","0014","0541","588","301","287","8","596","1188","0","50.17","25.34"
"63","000","00","040","0014","0542","699","399","300","10","709","1363","0","52.02","29.27"
"63","000","00","040","0014","0543","502","301","201","2","504","1075","0","46.88","28.00"
"63","000","00","040","0014","0544","656","356","300","4","660","1344","0","49.11","26.49"
"63","000","00","040","0015","0000","2473","1201","1272","29","2502","5305","0","47.16","22.64"
"63","000","00","040","0015","0545","690","321","369","7","697","1379","0","50.54","23.28"
"63","000","00","040","0015","0546","677","304","373","5","682","1402","0","48.64","21.68"
"63","000","00","040","0015","0547","621","328","293","8","629","1329","0","47.33","24.68"
"63","000","00","040","0015","0548","485","248","237","9","494","1195","0","41.34","20.75"
"63","000","00","040","0016","0000","3811","1979","1832","41","3852","7732","0","49.82","25.59"
"63","000","00","040","0016","0549","616","328","288","10","626","1314","0","47.64","24.96"
"63","000","00","040","0016","0550","718","383","335","5","723","1494","0","48.39","25.64"
"63","000","00","040","0016","0551","801","406","395","9","810","1607","0","50.40","25.26"
"63","000","00","040","0016","0552","798","411","387","11","809","1612","0","50.19","25.50"
"63","000","00","040","0016","0553","878","451","427","6","884","1705","0","51.85","26.45"
"63","000","00","040","0017","0000","412","134","278","4","416","904","0","46.02","14.82"
"63","000","00","040","0017","0577","412","134","278","4","416","904","0","46.02","14.82"
"63","000","00","040","0018","0000","1948","823","1125","14","1962","4399","0","44.60","18.71"
"63","000","00","040","0018","0561","641","270","371","4","645","1516","0","42.55","17.81"
"63","000","00","040","0018","0562","664","257","407","5","669","1441","0","46.43","17.83"
"63","000","00","040","0018","0563","643","296","347","5","648","1442","0","44.94","20.53"
"63","000","00","040","0019","0000","1996","883","1113","21","2017","4267","0","47.27","20.69"
"63","000","00","040","0019","0533","616","301","315","7","623","1447","0","43.05","20.80"
"63","000","00","040","0019","0534","758","327","431","9","767","1498","0","51.20","21.83"
"63","000","00","040","0019","0535","622","255","367","5","627","1322","0","47.43","19.29"
"63","000","00","040","0020","0000","2108","822","1286","19","2127","4414","0","48.19","18.62"
"63","000","00","040","0020","0564","747","255","492","6","753","1503","0","50.10","16.97"
"63","000","00","040","0020","0565","679","271","408","6","685","1424","0","48.10","19.03"
"63","000","00","040","0020","0566","682","296","386","7","689","1487","0","46.33","19.91"
"63","000","00","040","0021","0000","2564","1132","1432","22","2586","5384","0","48.03","21.03"
"63","000","00","040","0021","0567","558","224","334","2","560","1281","0","43.72","17.49"
"63","000","00","040","0021","0568","706","302","404","4","710","1432","0","49.58","21.09"
"63","000","00","040","0021","0569","670","307","363","9","679","1363","0","49.82","22.52"
"63","000","00","040","0021","0570","630","299","331","7","637","1308","0","48.70","22.86"
"63","000","00","040","0022","0000","1854","788","1066","20","1874","4061","0","46.15","19.40"
"63","000","00","040","0022","0571","581","273","308","7","588","1207","0","48.72","22.62"
"63","000","00","040","0022","0572","619","237","382","6","625","1373","0","45.52","17.26"
"63","000","00","040","0022","0573","654","278","376","7","661","1481","0","44.63","18.77"
"63","000","00","040","0023","0000","1953","817","1136","19","1972","4318","0","45.67","18.92"
"63","000","00","040","0023","0574","683","278","405","8","691","1537","0","44.96","18.09"
"63","000","00","040","0023","0575","646","278","368","2","648","1382","0","46.89","20.12"
"63","000","00","040","0023","0576","624","261","363","9","633","1399","0","45.25","18.66"
"63","000","00","040","0024","0000","2333","1112","1221","21","2354","6616","0","35.58","16.81"
"63","000","00","040","0024","0578","507","223","284","2","509","1006","0","50.60","22.17"
"63","000","00","040","0024","0579","537","262","275","3","540","1144","0","47.20","22.90"
"63","000","00","040","0024","0580","621","301","320","6","627","1278","0","49.06","23.55"
"63","000","00","040","0024","0581","668","326","342","10","678","3188","0","21.27","10.23"
"63","000","00","040","0025","0000","3073","1303","1770","22","3095","6794","0","45.55","19.18"
"63","000","00","040","0025","0582","638","277","361","0","638","1305","0","48.89","21.23"
"63","000","00","040","0025","0583","689","274","415","4","693","1544","0","44.88","17.75"
"63","000","00","040","0025","0584","549","242","307","6","555","1265","0","43.87","19.13"
"63","000","00","040","0025","0585","583","241","342","8","591","1329","0","44.47","18.13"
"63","000","00","040","0025","0586","614","269","345","4","618","1351","0","45.74","19.91"
"63","000","00","040","0026","0000","1587","632","955","14","1601","3692","0","43.36","17.12"
"63","000","00","040","0026","0587","598","271","327","8","606","1322","0","45.84","20.50"
"63","000","00","040","0026","0588","427","159","268","3","430","1118","0","38.46","14.22"
"63","000","00","040","0026","0589","562","202","360","3","565","1252","0","45.13","16.13"
"63","000","00","040","0027","0000","3074","1353","1721","28","3102","6421","0","48.31","21.07"
"63","000","00","040","0027","0590","622","282","340","5","627","1340","0","46.79","21.04"
"63","000","00","040","0027","0591","616","285","331","9","625","1214","0","51.48","23.48"
"63","000","00","040","0027","0592","594","261","333","5","599","1275","0","46.98","20.47"
"63","000","00","040","0027","0593","649","276","373","6","655","1317","0","49.73","20.96"
"63","000","00","040","0027","0594","593","249","344","3","596","1275","0","46.75","19.53"
"63","000","00","040","0028","0000","2844","1382","1462","25","2869","5828","0","49.23","23.71"
"63","000","00","040","0028","0595","794","393","401","12","806","1584","0","50.88","24.81"
"63","000","00","040","0028","0596","680","340","340","6","686","1403","0","48.90","24.23"
"63","000","00","040","0028","0597","669","283","386","1","670","1364","0","49.12","20.75"
"63","000","00","040","0028","0598","701","366","335","6","707","1477","0","47.87","24.78"
"63","000","00","040","0029","0000","3104","1377","1727","24","3128","6371","0","49.10","21.61"
"63","000","00","040","0029","0599","623","295","328","4","627","1279","0","49.02","23.06"
"63","000","00","040","0029","0600","578","269","309","2","580","1280","0","45.31","21.02"
"63","000","00","040","0029","0601","652","238","414","4","656","1302","0","50.38","18.28"
"63","000","00","040","0029","0602","627","252","375","8","635","1232","0","51.54","20.45"
"63","000","00","040","0029","0603","624","323","301","6","630","1278","0","49.30","25.27"
"63","000","00","040","0030","0000","2267","970","1297","18","2285","4719","0","48.42","20.56"
"63","000","00","040","0030","0604","741","406","335","6","747","1540","0","48.51","26.36"
"63","000","00","040","0030","0605","794","290","504","9","803","1590","0","50.50","18.24"
"63","000","00","040","0030","0606","732","274","458","3","735","1589","0","46.26","17.24"
"63","000","00","040","0031","0000","2191","933","1258","9","2200","4380","0","50.23","21.30"
"63","000","00","040","0031","0607","746","318","428","5","751","1512","0","49.67","21.03"
"63","000","00","040","0031","0608","757","308","449","3","760","1451","0","52.38","21.23"
"63","000","00","040","0031","0609","688","307","381","1","689","1417","0","48.62","21.67"
"63","000","00","040","0032","0000","2151","978","1173","22","2173","4589","0","47.35","21.31"
"63","000","00","040","0032","0610","749","326","423","9","758","1593","0","47.58","20.46"
"63","000","00","040","0032","0611","709","337","372","7","716","1514","0","47.29","22.26"
"63","000","00","040","0032","0612","693","315","378","6","699","1482","0","47.17","21.26"
"63","000","00","040","0033","0000","1468","669","799","10","1478","3031","0","48.76","22.07"
"63","000","00","040","0033","0613","545","271","274","4","549","1128","0","48.67","24.02"
"63","000","00","040","0033","0614","490","221","269","3","493","1012","0","48.72","21.84"
"63","000","00","040","0033","0615","433","177","256","3","436","891","0","48.93","19.87"
"63","000","00","040","0034","0000","2073","1021","1052","17","2090","4892","0","42.72","20.87"
"63","000","00","040","0034","0616","545","264","281","5","550","1292","0","42.57","20.43"
"63","000","00","040","0034","0617","541","283","258","5","546","1233","0","44.28","22.95"
"63","000","00","040","0034","0618","469","226","243","5","474","1138","0","41.65","19.86"
"63","000","00","040","0034","0619","518","248","270","2","520","1229","0","42.31","20.18"
"63","000","00","040","0035","0000","2233","1496","737","23","2256","4278","0","52.73","34.97"
"63","000","00","040","0035","0620","506","297","209","9","515","1020","0","50.49","29.12"
"63","000","00","040","0035","0621","560","356","204","3","563","1085","0","51.89","32.81"
"63","000","00","040","0035","0622","585","414","171","2","587","1025","0","57.27","40.39"
"63","000","00","040","0035","0623","582","429","153","9","591","1148","0","51.48","37.37"
"63","000","00","040","0036","0000","1861","820","1041","14","1875","3885","0","48.26","21.11"
"63","000","00","040","0036","0624","617","270","347","4","621","1310","0","47.40","20.61"
"63","000","00","040","0036","0625","601","262","339","3","604","1240","0","48.71","21.13"
"63","000","00","040","0036","0626","643","288","355","7","650","1335","0","48.69","21.57"
"63","000","00","040","0037","0000","1308","638","670","12","1320","2772","0","47.62","23.02"
"63","000","00","040","0037","0627","415","217","198","3","418","920","0","45.43","23.59"
"63","000","00","040","0037","0628","421","201","220","6","427","894","0","47.76","22.48"
"63","000","00","040","0037","0629","472","220","252","3","475","958","0","49.58","22.96"
"63","000","00","040","0038","0000","1208","549","659","12","1220","2553","0","47.79","21.50"
"63","000","00","040","0038","0630","649","314","335","8","657","1354","0","48.52","23.19"
"63","000","00","040","0038","0631","559","235","324","4","563","1199","0","46.96","19.60"
"63","000","00","040","0039","0000","2483","1102","1381","26","2509","5215","0","48.11","21.13"
"63","000","00","040","0039","0632","620","264","356","5","625","1296","0","48.23","20.37"
"63","000","00","040","0039","0633","583","224","359","8","591","1294","0","45.67","17.31"
"63","000","00","040","0039","0634","597","283","314","5","602","1271","0","47.36","22.27"
"63","000","00","040","0039","0635","683","331","352","8","691","1354","0","51.03","24.45"
"63","000","00","040","0040","0000","1932","1048","884","26","1958","4000","0","48.95","26.20"
"63","000","00","040","0040","0636","646","365","281","5","651","1383","0","47.07","26.39"
"63","000","00","040","0040","0637","675","321","354","17","692","1372","0","50.44","23.40"
"63","000","00","040","0040","0638","611","362","249","4","615","1245","0","49.40","29.08"
"63","000","00","040","0041","0000","2896","1520","1376","24","2920","6417","0","45.50","23.69"
"63","000","00","040","0041","0554","488","229","259","0","488","1014","0","48.13","22.58"
"63","000","00","040","0041","0555","587","328","259","3","590","1269","0","46.49","25.85"
"63","000","00","040","0041","0556","537","275","262","5","542","1261","0","42.98","21.81"
"63","000","00","040","0041","0557","655","333","322","10","665","1449","0","45.89","22.98"
"63","000","00","040","0041","0558","629","355","274","6","635","1424","0","44.59","24.93"
"63","000","00","040","0042","0000","1079","620","459","11","1090","2179","0","50.02","28.45"
"63","000","00","040","0042","0559","592","359","233","3","595","1185","0","50.21","30.30"
"63","000","00","040","0042","0560","487","261","226","8","495","994","0","49.80","26.26"
"63","000","00","050","0000","0000","59119","31561","27558","584","59703","123767","153172","48.24","25.50"
"63","000","00","050","0001","0000","1188","586","602","18","1206","2569","0","46.94","22.81"
"63","000","00","050","0001","0720","414","217","197","9","423","837","0","50.54","25.93"
"63","000","00","050","0001","0721","426","202","224","6","432","920","0","46.96","21.96"
"63","000","00","050","0001","0722","348","167","181","3","351","812","0","43.23","20.57"
"63","000","00","050","0002","0000","893","575","318","7","900","2107","0","42.71","27.29"
"63","000","00","050","0002","0723","494","351","143","3","497","1034","0","48.07","33.95"
"63","000","00","050","0002","0724","399","224","175","4","403","1073","0","37.56","20.88"
"63","000","00","050","0003","0000","1113","573","540","7","1120","2181","0","51.35","26.27"
"63","000","00","050","0003","0725","632","311","321","4","636","1183","0","53.76","26.29"
"63","000","00","050","0003","0726","481","262","219","3","484","998","0","48.50","26.25"
"63","000","00","050","0004","0000","1894","1074","820","11","1905","4011","0","47.49","26.78"
"63","000","00","050","0004","0727","454","219","235","3","457","981","0","46.59","22.32"
"63","000","00","050","0004","0728","432","262","170","3","435","985","0","44.16","26.60"
"63","000","00","050","0004","0729","528","322","206","3","531","1136","0","46.74","28.35"
"63","000","00","050","0004","0730","480","271","209","2","482","909","0","53.03","29.81"
"63","000","00","050","0005","0000","1947","1109","838","12","1959","3802","0","51.53","29.17"
"63","000","00","050","0005","0731","518","301","217","7","525","990","0","53.03","30.40"
"63","000","00","050","0005","0732","461","248","213","2","463","940","0","49.26","26.38"
"63","000","00","050","0005","0733","538","329","209","1","539","989","0","54.50","33.27"
"63","000","00","050","0005","0734","430","231","199","2","432","883","0","48.92","26.16"
"63","000","00","050","0006","0000","2678","1398","1280","29","2707","5155","0","52.51","27.12"
"63","000","00","050","0006","0735","557","312","245","9","566","1073","0","52.75","29.08"
"63","000","00","050","0006","0736","533","277","256","8","541","1025","0","52.78","27.02"
"63","000","00","050","0006","0737","490","246","244","4","494","960","0","51.46","25.63"
"63","000","00","050","0006","0738","534","278","256","2","536","1025","0","52.29","27.12"
"63","000","00","050","0006","0739","564","285","279","6","570","1072","0","53.17","26.59"
"63","000","00","050","0007","0000","2485","1320","1165","27","2512","4893","0","51.34","26.98"
"63","000","00","050","0007","0740","642","373","269","9","651","1195","0","54.48","31.21"
"63","000","00","050","0007","0741","639","345","294","3","642","1283","0","50.04","26.89"
"63","000","00","050","0007","0742","579","283","296","5","584","1159","0","50.39","24.42"
"63","000","00","050","0007","0743","625","319","306","10","635","1256","0","50.56","25.40"
"63","000","00","050","0008","0000","1299","712","587","14","1313","2775","0","47.32","25.66"
"63","000","00","050","0008","0744","388","208","180","1","389","873","0","44.56","23.83"
"63","000","00","050","0008","0745","421","206","215","6","427","900","0","47.44","22.89"
"63","000","00","050","0008","0746","490","298","192","7","497","1002","0","49.60","29.74"
"63","000","00","050","0009","0000","2369","1319","1050","18","2387","4773","0","50.01","27.63"
"63","000","00","050","0009","0747","609","318","291","5","614","1259","0","48.77","25.26"
"63","000","00","050","0009","0748","690","402","288","5","695","1414","0","49.15","28.43"
"63","000","00","050","0009","0749","494","264","230","3","497","1022","0","48.63","25.83"
"63","000","00","050","0009","0750","576","335","241","5","581","1078","0","53.90","31.08"
"63","000","00","050","0010","0000","1765","960","805","15","1780","3653","0","48.73","26.28"
"63","000","00","050","0010","0751","620","346","274","6","626","1300","0","48.15","26.62"
"63","000","00","050","0010","0752","561","295","266","1","562","1136","0","49.47","25.97"
"63","000","00","050","0010","0753","584","319","265","8","592","1217","0","48.64","26.21"
"63","000","00","050","0011","0000","2466","1246","1220","28","2494","5214","0","47.83","23.90"
"63","000","00","050","0011","0639","488","248","240","6","494","1113","0","44.38","22.28"
"63","000","00","050","0011","0640","493","263","230","3","496","1048","0","47.33","25.10"
"63","000","00","050","0011","0641","457","225","232","2","459","986","0","46.55","22.82"
"63","000","00","050","0011","0642","480","248","232","9","489","974","0","50.21","25.46"
"63","000","00","050","0011","0643","548","262","286","8","556","1093","0","50.87","23.97"
"63","000","00","050","0012","0000","1980","1044","936","19","1999","4177","0","47.86","24.99"
"63","000","00","050","0012","0644","584","299","285","7","591","1112","0","53.15","26.89"
"63","000","00","050","0012","0645","474","228","246","2","476","1050","0","45.33","21.71"
"63","000","00","050","0012","0646","495","295","200","8","503","1061","0","47.41","27.80"
"63","000","00","050","0012","0647","427","222","205","2","429","954","0","44.97","23.27"
"63","000","00","050","0013","0000","1328","653","675","14","1342","2906","0","46.18","22.47"
"63","000","00","050","0013","0648","494","243","251","6","500","995","0","50.25","24.42"
"63","000","00","050","0013","0649","430","204","226","7","437","987","0","44.28","20.67"
"63","000","00","050","0013","0650","404","206","198","1","405","924","0","43.83","22.29"
"63","000","00","050","0014","0000","2327","1329","998","34","2361","5486","0","43.04","24.23"
"63","000","00","050","0014","0651","490","288","202","5","495","1183","0","41.84","24.34"
"63","000","00","050","0014","0652","484","296","188","9","493","1210","0","40.74","24.46"
"63","000","00","050","0014","0653","472","254","218","13","485","1041","0","46.59","24.40"
"63","000","00","050","0014","0654","380","230","150","3","383","894","0","42.84","25.73"
"63","000","00","050","0014","0655","501","261","240","4","505","1158","0","43.61","22.54"
"63","000","00","050","0015","0000","1586","750","836","15","1601","3475","0","46.07","21.58"
"63","000","00","050","0015","0656","511","244","267","7","518","1169","0","44.31","20.87"
"63","000","00","050","0015","0657","549","263","286","6","555","1189","0","46.68","22.12"
"63","000","00","050","0015","0658","526","243","283","2","528","1117","0","47.27","21.75"
"63","000","00","050","0016","0000","1229","607","622","11","1240","2583","0","48.01","23.50"
"63","000","00","050","0016","0659","399","165","234","4","403","837","0","48.15","19.71"
"63","000","00","050","0016","0660","418","244","174","2","420","897","0","46.82","27.20"
"63","000","00","050","0016","0661","412","198","214","5","417","849","0","49.12","23.32"
"63","000","00","050","0017","0000","1119","642","477","12","1131","2153","0","52.53","29.82"
"63","000","00","050","0017","0662","592","337","255","8","600","1091","0","55.00","30.89"
"63","000","00","050","0017","0663","527","305","222","4","531","1062","0","50.00","28.72"
"63","000","00","050","0018","0000","1352","745","607","13","1365","2662","0","51.28","27.99"
"63","000","00","050","0018","0664","510","264","246","3","513","997","0","51.45","26.48"
"63","000","00","050","0018","0665","432","266","166","2","434","825","0","52.61","32.24"
"63","000","00","050","0018","0666","410","215","195","8","418","840","0","49.76","25.60"
"63","000","00","050","0019","0000","4408","2364","2044","38","4446","8918","0","49.85","26.51"
"63","000","00","050","0019","0667","606","323","283","5","611","1313","0","46.53","24.60"
"63","000","00","050","0019","0668","583","310","273","4","587","1213","0","48.39","25.56"
"63","000","00","050","0019","0669","725","393","332","6","731","1369","0","53.40","28.71"
"63","000","00","050","0019","0670","665","355","310","3","668","1276","0","52.35","27.82"
"63","000","00","050","0019","0671","636","346","290","8","644","1239","0","51.98","27.93"
"63","000","00","050","0019","0672","575","293","282","4","579","1172","0","49.40","25.00"
"63","000","00","050","0019","0673","618","344","274","8","626","1336","0","46.86","25.75"
"63","000","00","050","0020","0000","2023","1067","956","23","2046","4216","0","48.53","25.31"
"63","000","00","050","0020","0674","475","246","229","6","481","1020","0","47.16","24.12"
"63","000","00","050","0020","0675","499","284","215","6","505","1068","0","47.28","26.59"
"63","000","00","050","0020","0676","525","286","239","3","528","1060","0","49.81","26.98"
"63","000","00","050","0020","0677","524","251","273","8","532","1068","0","49.81","23.50"
"63","000","00","050","0021","0000","3274","1893","1381","27","3301","6851","0","48.18","27.63"
"63","000","00","050","0021","0678","524","283","241","5","529","1112","0","47.57","25.45"
"63","000","00","050","0021","0679","551","313","238","4","555","1175","0","47.23","26.64"
"63","000","00","050","0021","0680","565","304","261","2","567","1173","0","48.34","25.92"
"63","000","00","050","0021","0681","551","322","229","5","556","1188","0","46.80","27.10"
"63","000","00","050","0021","0682","557","348","209","3","560","1089","0","51.42","31.96"
"63","000","00","050","0021","0683","526","323","203","8","534","1114","0","47.94","28.99"
"63","000","00","050","0022","0000","562","319","243","5","567","1240","0","45.73","25.73"
"63","000","00","050","0022","0684","562","319","243","5","567","1240","0","45.73","25.73"
"63","000","00","050","0023","0000","1400","719","681","14","1414","3153","0","44.85","22.80"
"63","000","00","050","0023","0685","376","212","164","4","380","887","0","42.84","23.90"
"63","000","00","050","0023","0686","507","241","266","4","511","1077","0","47.45","22.38"
"63","000","00","050","0023","0687","517","266","251","6","523","1189","0","43.99","22.37"
"63","000","00","050","0024","0000","1076","567","509","7","1083","2719","0","39.83","20.85"
"63","000","00","050","0024","0688","338","185","153","2","340","901","0","37.74","20.53"
"63","000","00","050","0024","0689","377","187","190","2","379","856","0","44.28","21.85"
"63","000","00","050","0024","0690","361","195","166","3","364","962","0","37.84","20.27"
"63","000","00","050","0025","0000","1288","611","677","10","1298","2626","0","49.43","23.27"
"63","000","00","050","0025","0691","464","216","248","5","469","896","0","52.34","24.11"
"63","000","00","050","0025","0692","393","196","197","4","397","860","0","46.16","22.79"
"63","000","00","050","0025","0693","431","199","232","1","432","870","0","49.66","22.87"
"63","000","00","050","0026","0000","1907","1030","877","20","1927","4871","0","39.56","21.15"
"63","000","00","050","0026","0694","561","305","256","3","564","1140","0","49.47","26.75"
"63","000","00","050","0026","0695","420","267","153","4","424","1775","0","23.89","15.04"
"63","000","00","050","0026","0696","454","241","213","8","462","1002","0","46.11","24.05"
"63","000","00","050","0026","0697","472","217","255","5","477","954","0","50.00","22.75"
"63","000","00","050","0027","0000","1926","961","965","15","1941","3689","0","52.62","26.05"
"63","000","00","050","0027","0698","459","234","225","3","462","863","0","53.53","27.11"
"63","000","00","050","0027","0699","503","223","280","4","507","988","0","51.32","22.57"
"63","000","00","050","0027","0700","529","274","255","7","536","974","0","55.03","28.13"
"63","000","00","050","0027","0701","435","230","205","1","436","864","0","50.46","26.62"
"63","000","00","050","0028","0000","1500","864","636","20","1520","3113","0","48.83","27.75"
"63","000","00","050","0028","0702","500","269","231","3","503","1047","0","48.04","25.69"
"63","000","00","050","0028","0703","494","292","202","10","504","1005","0","50.15","29.05"
"63","000","00","050","0028","0704","506","303","203","7","513","1061","0","48.35","28.56"
"63","000","00","050","0029","0000","2296","1185","1111","21","2317","4517","0","51.30","26.23"
"63","000","00","050","0029","0705","590","324","266","6","596","1216","0","49.01","26.64"
"63","000","00","050","0029","0706","604","310","294","6","610","1188","0","51.35","26.09"
"63","000","00","050","0029","0707","471","236","235","5","476","930","0","51.18","25.38"
"63","000","00","050","0029","0708","631","315","316","4","635","1183","0","53.68","26.63"
"63","000","00","050","0030","0000","3067","1602","1465","35","3102","6282","0","49.38","25.50"
"63","000","00","050","0030","0709","675","336","339","11","686","1389","0","49.39","24.19"
"63","000","00","050","0030","0710","568","303","265","4","572","1238","0","46.20","24.47"
"63","000","00","050","0030","0711","682","349","333","8","690","1381","0","49.96","25.27"
"63","000","00","050","0030","0712","530","286","244","3","533","1050","0","50.76","27.24"
"63","000","00","050","0030","0713","612","328","284","9","621","1224","0","50.74","26.80"
"63","000","00","050","0031","0000","3374","1737","1637","45","3419","6997","0","48.86","24.82"
"63","000","00","050","0031","0714","492","265","227","9","501","1095","0","45.75","24.20"
"63","000","00","050","0031","0715","562","268","294","7","569","1158","0","49.14","23.14"
"63","000","00","050","0031","0716","563","297","266","13","576","1170","0","49.23","25.38"
"63","000","00","050","0031","0717","568","258","310","7","575","1096","0","52.46","23.54"
"63","000","00","050","0031","0718","538","291","247","1","539","1168","0","46.15","24.91"
"63","000","00","050","0031","0719","651","358","293","8","659","1310","0","50.31","27.33"
"63","000","00","060","0000","0000","47280","18691","28589","402","47682","103815","122719","45.93","18.00"
"63","000","00","060","0001","0000","1136","461","675","13","1149","2534","0","45.34","18.19"
"63","000","00","060","0001","0754","528","202","326","8","536","1207","0","44.41","16.74"
"63","000","00","060","0001","0755","608","259","349","5","613","1327","0","46.19","19.52"
"63","000","00","060","0002","0000","1219","492","727","10","1229","2790","0","44.05","17.63"
"63","000","00","060","0002","0756","493","193","300","3","496","1018","0","48.72","18.96"
"63","000","00","060","0002","0757","429","156","273","4","433","997","0","43.43","15.65"
"63","000","00","060","0002","0758","297","143","154","3","300","775","0","38.71","18.45"
"63","000","00","060","0003","0000","1732","717","1015","19","1751","3999","0","43.79","17.93"
"63","000","00","060","0003","0759","583","246","337","6","589","1366","0","43.12","18.01"
"63","000","00","060","0003","0760","568","217","351","9","577","1269","0","45.47","17.10"
"63","000","00","060","0003","0761","581","254","327","4","585","1364","0","42.89","18.62"
"63","000","00","060","0004","0000","1423","550","873","26","1449","3039","0","47.68","18.10"
"63","000","00","060","0004","0762","454","195","259","6","460","969","0","47.47","20.12"
"63","000","00","060","0004","0763","462","172","290","10","472","926","0","50.97","18.57"
"63","000","00","060","0004","0764","507","183","324","10","517","1144","0","45.19","16.00"
"63","000","00","060","0005","0000","2040","766","1274","11","2051","4399","0","46.62","17.41"
"63","000","00","060","0005","0765","545","221","324","1","546","1146","0","47.64","19.28"
"63","000","00","060","0005","0766","408","159","249","0","408","970","0","42.06","16.39"
"63","000","00","060","0005","0767","512","170","342","7","519","1166","0","44.51","14.58"
"63","000","00","060","0005","0768","575","216","359","3","578","1117","0","51.75","19.34"
"63","000","00","060","0006","0000","1797","753","1044","17","1814","3812","0","47.59","19.75"
"63","000","00","060","0006","0769","596","300","296","1","597","1254","0","47.61","23.92"
"63","000","00","060","0006","0770","588","237","351","8","596","1307","0","45.60","18.13"
"63","000","00","060","0006","0771","613","216","397","8","621","1251","0","49.64","17.27"
"63","000","00","060","0007","0000","2179","927","1252","18","2197","4940","0","44.47","18.77"
"63","000","00","060","0007","0772","559","248","311","5","564","1235","0","45.67","20.08"
"63","000","00","060","0007","0773","501","204","297","4","505","1165","0","43.35","17.51"
"63","000","00","060","0007","0774","560","228","332","4","564","1243","0","45.37","18.34"
"63","000","00","060","0007","0775","559","247","312","5","564","1297","0","43.48","19.04"
"63","000","00","060","0008","0000","1952","775","1177","8","1960","4161","0","47.10","18.63"
"63","000","00","060","0008","0776","461","177","284","3","464","974","0","47.64","18.17"
"63","000","00","060","0008","0777","518","226","292","1","519","1129","0","45.97","20.02"
"63","000","00","060","0008","0778","461","164","297","4","465","942","0","49.36","17.41"
"63","000","00","060","0008","0779","512","208","304","0","512","1116","0","45.88","18.64"
"63","000","00","060","0009","0000","1808","650","1158","22","1830","3943","0","46.41","16.48"
"63","000","00","060","0009","0780","637","224","413","6","643","1338","0","48.06","16.74"
"63","000","00","060","0009","0781","570","229","341","6","576","1299","0","44.34","17.63"
"63","000","00","060","0009","0782","601","197","404","10","611","1306","0","46.78","15.08"
"63","000","00","060","0010","0000","1595","679","916","9","1604","3592","0","44.65","18.90"
"63","000","00","060","0010","0783","453","193","260","4","457","1082","0","42.24","17.84"
"63","000","00","060","0010","0784","567","265","302","2","569","1214","0","46.87","21.83"
"63","000","00","060","0010","0785","575","221","354","3","578","1296","0","44.60","17.05"
"63","000","00","060","0011","0000","3431","1392","2039","25","3456","7671","0","45.05","18.15"
"63","000","00","060","0011","0786","568","193","375","4","572","1340","0","42.69","14.40"
"63","000","00","060","0011","0787","540","231","309","4","544","1168","0","46.58","19.78"
"63","000","00","060","0011","0788","551","241","310","1","552","1259","0","43.84","19.14"
"63","000","00","060","0011","0789","668","272","396","8","676","1337","0","50.56","20.34"
"63","000","00","060","0011","0790","589","220","369","6","595","1357","0","43.85","16.21"
"63","000","00","060","0011","0791","515","235","280","2","517","1210","0","42.73","19.42"
"63","000","00","060","0012","0000","1541","588","953","11","1552","3376","0","45.97","17.42"
"63","000","00","060","0012","0792","554","206","348","4","558","1128","0","49.47","18.26"
"63","000","00","060","0012","0793","485","190","295","4","489","1097","0","44.58","17.32"
"63","000","00","060","0012","0794","502","192","310","3","505","1151","0","43.87","16.68"
"63","000","00","060","0013","0000","2476","1044","1432","27","2503","5223","0","47.92","19.99"
"63","000","00","060","0013","0795","610","243","367","9","619","1338","0","46.26","18.16"
"63","000","00","060","0013","0796","642","269","373","8","650","1305","0","49.81","20.61"
"63","000","00","060","0013","0797","631","266","365","5","636","1320","0","48.18","20.15"
"63","000","00","060","0013","0798","593","266","327","5","598","1260","0","47.46","21.11"
"63","000","00","060","0014","0000","981","368","613","10","991","2231","0","44.42","16.49"
"63","000","00","060","0014","0799","455","166","289","5","460","1080","0","42.59","15.37"
"63","000","00","060","0014","0800","526","202","324","5","531","1151","0","46.13","17.55"
"63","000","00","060","0015","0000","1412","517","895","11","1423","2898","0","49.10","17.84"
"63","000","00","060","0015","0801","629","222","407","6","635","1316","0","48.25","16.87"
"63","000","00","060","0015","0802","783","295","488","5","788","1582","0","49.81","18.65"
"63","000","00","060","0016","0000","1951","793","1158","16","1967","4213","0","46.69","18.82"
"63","000","00","060","0016","0803","486","201","285","5","491","1013","0","48.47","19.84"
"63","000","00","060","0016","0804","551","229","322","4","555","1206","0","46.02","18.99"
"63","000","00","060","0016","0805","440","169","271","4","444","935","0","47.49","18.07"
"63","000","00","060","0016","0806","474","194","280","3","477","1059","0","45.04","18.32"
"63","000","00","060","0017","0000","1001","361","640","7","1008","2305","0","43.73","15.66"
"63","000","00","060","0017","0807","550","200","350","2","552","1166","0","47.34","17.15"
"63","000","00","060","0017","0808","451","161","290","5","456","1139","0","40.04","14.14"
"63","000","00","060","0018","0000","1903","754","1149","15","1918","3894","0","49.26","19.36"
"63","000","00","060","0018","0809","625","247","378","7","632","1280","0","49.38","19.30"
"63","000","00","060","0018","0810","626","253","373","5","631","1272","0","49.61","19.89"
"63","000","00","060","0018","0811","652","254","398","3","655","1342","0","48.81","18.93"
"63","000","00","060","0019","0000","1424","531","893","12","1436","4063","0","35.34","13.07"
"63","000","00","060","0019","0812","466","174","292","8","474","959","0","49.43","18.14"
"63","000","00","060","0019","0813","463","179","284","3","466","2117","0","22.01","8.46"
"63","000","00","060","0019","0814","495","178","317","1","496","987","0","50.25","18.03"
"63","000","00","060","0020","0000","1811","677","1134","12","1823","4057","0","44.93","16.69"
"63","000","00","060","0020","0815","354","104","250","1","355","1012","0","35.08","10.28"
"63","000","00","060","0020","0816","463","180","283","0","463","1027","0","45.08","17.53"
"63","000","00","060","0020","0817","480","164","316","6","486","1062","0","45.76","15.44"
"63","000","00","060","0020","0818","514","229","285","5","519","956","0","54.29","23.95"
"63","000","00","060","0021","0000","2592","979","1613","22","2614","5537","0","47.21","17.68"
"63","000","00","060","0021","0819","509","176","333","3","512","1115","0","45.92","15.78"
"63","000","00","060","0021","0820","545","226","319","7","552","1099","0","50.23","20.56"
"63","000","00","060","0021","0821","537","196","341","0","537","1120","0","47.95","17.50"
"63","000","00","060","0021","0822","527","199","328","6","533","1167","0","45.67","17.05"
"63","000","00","060","0021","0823","474","182","292","6","480","1036","0","46.33","17.57"
"63","000","00","060","0022","0000","3178","1252","1926","30","3208","6748","0","47.54","18.55"
"63","000","00","060","0022","0824","455","176","279","4","459","1011","0","45.40","17.41"
"63","000","00","060","0022","0825","441","155","286","1","442","974","0","45.38","15.91"
"63","000","00","060","0022","0826","572","255","317","2","574","1101","0","52.13","23.16"
"63","000","00","060","0022","0827","580","258","322","7","587","1235","0","47.53","20.89"
"63","000","00","060","0022","0828","600","234","366","8","608","1276","0","47.65","18.34"
"63","000","00","060","0022","0829","530","174","356","8","538","1151","0","46.74","15.12"
"63","000","00","060","0024","0000","2155","785","1370","16","2171","4953","0","43.83","15.85"
"63","000","00","060","0024","0830","520","178","342","2","522","1265","0","41.26","14.07"
"63","000","00","060","0024","0831","590","213","377","6","596","1345","0","44.31","15.84"
"63","000","00","060","0024","0832","495","187","308","2","497","1162","0","42.77","16.09"
"63","000","00","060","0024","0833","550","207","343","6","556","1181","0","47.08","17.53"
"63","000","00","060","0025","0000","2688","1195","1493","15","2703","5666","0","47.71","21.09"
"63","000","00","060","0025","0834","471","199","272","2","473","1080","0","43.80","18.43"
"63","000","00","060","0025","0835","559","255","304","4","563","1144","0","49.21","22.29"
"63","000","00","060","0025","0836","575","284","291","4","579","1122","0","51.60","25.31"
"63","000","00","060","0025","0837","538","242","296","2","540","1138","0","47.45","21.27"
"63","000","00","060","0025","0838","545","215","330","3","548","1182","0","46.36","18.19"
"63","000","00","060","0026","0000","1855","685","1170","20","1875","3771","0","49.72","18.16"
"63","000","00","060","0026","0839","630","211","419","9","639","1310","0","48.78","16.11"
"63","000","00","060","0026","0840","645","258","387","2","647","1300","0","49.77","19.85"
"63","000","00","060","0026","0841","580","216","364","9","589","1161","0","50.73","18.60"
"63","000","00","070","0000","0000","71304","34430","36874","777","72081","157078","179485","45.89","21.92"
"63","000","00","070","0001","0000","1952","1028","924","25","1977","4638","0","42.63","22.16"
"63","000","00","070","0001","0842","527","265","262","5","532","1159","0","45.90","22.86"
"63","000","00","070","0001","0843","484","302","182","10","494","1153","0","42.84","26.19"
"63","000","00","070","0001","0844","473","229","244","7","480","1195","0","40.17","19.16"
"63","000","00","070","0001","0845","468","232","236","3","471","1131","0","41.64","20.51"
"63","000","00","070","0002","0000","1115","579","536","19","1134","2831","0","40.06","20.45"
"63","000","00","070","0002","0846","396","199","197","7","403","906","0","44.48","21.96"
"63","000","00","070","0002","0847","390","183","207","4","394","972","0","40.53","18.83"
"63","000","00","070","0002","0848","329","197","132","8","337","953","0","35.36","20.67"
"63","000","00","070","0003","0000","1338","698","640","15","1353","3187","0","42.45","21.90"
"63","000","00","070","0003","0849","474","270","204","8","482","1096","0","43.98","24.64"
"63","000","00","070","0003","0850","459","230","229","3","462","1114","0","41.47","20.65"
"63","000","00","070","0003","0851","405","198","207","4","409","977","0","41.86","20.27"
"63","000","00","070","0004","0000","2697","1297","1400","39","2736","5920","0","46.22","21.91"
"63","000","00","070","0004","0852","536","243","293","5","541","1156","0","46.80","21.02"
"63","000","00","070","0004","0853","533","239","294","10","543","1157","0","46.93","20.66"
"63","000","00","070","0004","0854","562","280","282","9","571","1252","0","45.61","22.36"
"63","000","00","070","0004","0855","646","317","329","7","653","1423","0","45.89","22.28"
"63","000","00","070","0004","0856","420","218","202","8","428","932","0","45.92","23.39"
"63","000","00","070","0005","0000","2505","1105","1400","25","2530","5356","0","47.24","20.63"
"63","000","00","070","0005","0857","555","226","329","4","559","1295","0","43.17","17.45"
"63","000","00","070","0005","0858","586","248","338","10","596","1255","0","47.49","19.76"
"63","000","00","070","0005","0859","645","335","310","4","649","1383","0","46.93","24.22"
"63","000","00","070","0005","0860","719","296","423","7","726","1423","0","51.02","20.80"
"63","000","00","070","0006","0000","2255","1006","1249","17","2272","5124","0","44.34","19.63"
"63","000","00","070","0006","0861","600","302","298","3","603","1318","0","45.75","22.91"
"63","000","00","070","0006","0862","606","265","341","6","612","1329","0","46.05","19.94"
"63","000","00","070","0006","0863","498","197","301","6","504","1198","0","42.07","16.44"
"63","000","00","070","0006","0864","551","242","309","2","553","1279","0","43.24","18.92"
"63","000","00","070","0007","0000","1960","778","1182","29","1989","4299","0","46.27","18.10"
"63","000","00","070","0007","0865","464","178","286","4","468","1100","0","42.55","16.18"
"63","000","00","070","0007","0866","561","249","312","10","571","1170","0","48.80","21.28"
"63","000","00","070","0007","0867","433","175","258","7","440","1008","0","43.65","17.36"
"63","000","00","070","0007","0868","502","176","326","8","510","1021","0","49.95","17.24"
"63","000","00","070","0008","0000","1569","661","908","9","1578","3366","0","46.88","19.64"
"63","000","00","070","0008","0869","537","229","308","1","538","1219","0","44.13","18.79"
"63","000","00","070","0008","0870","498","223","275","5","503","985","0","51.07","22.64"
"63","000","00","070","0008","0871","534","209","325","3","537","1162","0","46.21","17.99"
"63","000","00","070","0009","0000","2022","929","1093","16","2038","4094","0","49.78","22.69"
"63","000","00","070","0009","0872","623","300","323","2","625","1188","0","52.61","25.25"
"63","000","00","070","0009","0873","512","246","266","3","515","1001","0","51.45","24.58"
"63","000","00","070","0009","0874","464","189","275","5","469","1041","0","45.05","18.16"
"63","000","00","070","0009","0875","423","194","229","6","429","864","0","49.65","22.45"
"63","000","00","070","0010","0000","1914","775","1139","21","1935","5354","0","36.14","14.48"
"63","000","00","070","0010","0876","557","220","337","3","560","2607","0","21.48","8.44"
"63","000","00","070","0010","0877","436","181","255","3","439","868","0","50.58","20.85"
"63","000","00","070","0010","0878","461","188","273","5","466","944","0","49.36","19.92"
"63","000","00","070","0010","0879","460","186","274","10","470","935","0","50.27","19.89"
"63","000","00","070","0011","0000","2810","1170","1640","32","2842","6064","0","46.87","19.29"
"63","000","00","070","0011","0897","431","170","261","4","435","994","0","43.76","17.10"
"63","000","00","070","0011","0898","588","232","356","8","596","1188","0","50.17","19.53"
"63","000","00","070","0011","0899","496","195","301","3","499","1047","0","47.66","18.62"
"63","000","00","070","0011","0900","652","273","379","13","665","1424","0","46.70","19.17"
"63","000","00","070","0011","0901","643","300","343","4","647","1411","0","45.85","21.26"
"63","000","00","070","0012","0000","1769","755","1014","23","1792","3864","0","46.38","19.54"
"63","000","00","070","0012","0902","595","237","358","6","601","1315","0","45.70","18.02"
"63","000","00","070","0012","0903","612","262","350","12","624","1349","0","46.26","19.42"
"63","000","00","070","0012","0904","562","256","306","5","567","1200","0","47.25","21.33"
"63","000","00","070","0013","0000","1525","1160","365","15","1540","2993","0","51.45","38.76"
"63","000","00","070","0013","0960","386","237","149","3","389","946","0","41.12","25.05"
"63","000","00","070","0013","0961","514","403","111","8","522","925","0","56.43","43.57"
"63","000","00","070","0013","0962","625","520","105","4","629","1122","0","56.06","46.35"
"63","000","00","070","0014","0000","3760","2663","1097","53","3813","7108","0","53.64","37.46"
"63","000","00","070","0014","0963","649","501","148","12","661","1152","0","57.38","43.49"
"63","000","00","070","0014","0964","633","459","174","8","641","1127","0","56.88","40.73"
"63","000","00","070","0014","0965","595","388","207","11","606","1181","0","51.31","32.85"
"63","000","00","070","0014","0966","647","452","195","11","658","1233","0","53.37","36.66"
"63","000","00","070","0014","0967","602","446","156","5","607","1179","0","51.48","37.83"
"63","000","00","070","0014","0968","634","417","217","6","640","1236","0","51.78","33.74"
"63","000","00","070","0015","0000","2204","937","1267","16","2220","4679","0","47.45","20.03"
"63","000","00","070","0015","0890","542","197","345","6","548","1159","0","47.28","17.00"
"63","000","00","070","0015","0891","547","236","311","2","549","1147","0","47.86","20.58"
"63","000","00","070","0015","0892","544","253","291","5","549","1261","0","43.54","20.06"
"63","000","00","070","0015","0893","571","251","320","3","574","1112","0","51.62","22.57"
"63","000","00","070","0016","0000","2477","889","1588","31","2508","5752","0","43.60","15.46"
"63","000","00","070","0016","0905","535","173","362","10","545","1294","0","42.12","13.37"
"63","000","00","070","0016","0906","466","162","304","4","470","1064","0","44.17","15.23"
"63","000","00","070","0016","0907","547","194","353","6","553","1172","0","47.18","16.55"
"63","000","00","070","0016","0908","474","186","288","4","478","1041","0","45.92","17.87"
"63","000","00","070","0016","0909","455","174","281","7","462","1181","0","39.12","14.73"
"63","000","00","070","0017","0000","1513","736","777","16","1529","3698","0","41.35","19.90"
"63","000","00","070","0017","0894","514","238","276","5","519","1181","0","43.95","20.15"
"63","000","00","070","0017","0895","513","268","245","3","516","1248","0","41.35","21.47"
"63","000","00","070","0017","0896","486","230","256","8","494","1269","0","38.93","18.12"
"63","000","00","070","0018","0000","3195","1421","1774","24","3219","7226","0","44.55","19.67"
"63","000","00","070","0018","0884","457","229","228","5","462","1190","0","38.82","19.24"
"63","000","00","070","0018","0885","570","236","334","3","573","1256","0","45.62","18.79"
"63","000","00","070","0018","0886","542","230","312","1","543","1146","0","47.38","20.07"
"63","000","00","070","0018","0887","630","291","339","4","634","1231","0","51.50","23.64"
"63","000","00","070","0018","0888","578","230","348","7","585","1275","0","45.88","18.04"
"63","000","00","070","0018","0889","418","205","213","4","422","1128","0","37.41","18.17"
"63","000","00","070","0019","0000","1899","756","1143","18","1917","4403","0","43.54","17.17"
"63","000","00","070","0019","0880","428","173","255","2","430","1013","0","42.45","17.08"
"63","000","00","070","0019","0881","533","204","329","5","538","1167","0","46.10","17.48"
"63","000","00","070","0019","0882","476","194","282","6","482","1092","0","44.14","17.77"
"63","000","00","070","0019","0883","462","185","277","5","467","1131","0","41.29","16.36"
"63","000","00","070","0020","0000","1450","621","829","12","1462","3103","0","47.12","20.01"
"63","000","00","070","0020","0918","446","196","250","2","448","996","0","44.98","19.68"
"63","000","00","070","0020","0919","489","197","292","4","493","1033","0","47.73","19.07"
"63","000","00","070","0020","0920","515","228","287","6","521","1074","0","48.51","21.23"
"63","000","00","070","0021","0000","2213","1291","922","31","2244","5228","0","42.92","24.69"
"63","000","00","070","0021","0969","451","241","210","5","456","1160","0","39.31","20.78"
"63","000","00","070","0021","0970","376","197","179","7","383","948","0","40.40","20.78"
"63","000","00","070","0021","0971","373","197","176","6","379","955","0","39.69","20.63"
"63","000","00","070","0021","0972","501","298","203","7","508","1146","0","44.33","26.00"
"63","000","00","070","0021","0973","512","358","154","6","518","1019","0","50.83","35.13"
"63","000","00","070","0022","0000","1749","726","1023","14","1763","3813","0","46.24","19.04"
"63","000","00","070","0022","0921","575","223","352","5","580","1320","0","43.94","16.89"
"63","000","00","070","0022","0922","580","263","317","4","584","1197","0","48.79","21.97"
"63","000","00","070","0022","0923","594","240","354","5","599","1296","0","46.22","18.52"
"63","000","00","070","0023","0000","1315","504","811","7","1322","2802","0","47.18","17.99"
"63","000","00","070","0023","0928","615","244","371","5","620","1359","0","45.62","17.95"
"63","000","00","070","0023","0929","700","260","440","2","702","1443","0","48.65","18.02"
"63","000","00","070","0024","0000","2298","958","1340","20","2318","5570","0","41.62","17.20"
"63","000","00","070","0024","0910","520","197","323","5","525","1117","0","47.00","17.64"
"63","000","00","070","0024","0911","469","179","290","5","474","1190","0","39.83","15.04"
"63","000","00","070","0024","0912","348","148","200","4","352","944","0","37.29","15.68"
"63","000","00","070","0024","0913","427","195","232","2","429","1119","0","38.34","17.43"
"63","000","00","070","0024","0914","534","239","295","4","538","1200","0","44.83","19.92"
"63","000","00","070","0025","0000","2097","925","1172","21","2118","4714","0","44.93","19.62"
"63","000","00","070","0025","0924","582","262","320","6","588","1197","0","49.12","21.89"
"63","000","00","070","0025","0925","554","256","298","4","558","1234","0","45.22","20.75"
"63","000","00","070","0025","0926","496","206","290","5","501","1197","0","41.85","17.21"
"63","000","00","070","0025","0927","465","201","264","6","471","1086","0","43.37","18.51"
"63","000","00","070","0026","0000","1681","776","905","26","1707","3631","0","47.01","21.37"
"63","000","00","070","0026","0915","509","243","266","9","518","1119","0","46.29","21.72"
"63","000","00","070","0026","0916","609","229","380","6","615","1335","0","46.07","17.15"
"63","000","00","070","0026","0917","563","304","259","11","574","1177","0","48.77","25.83"
"63","000","00","070","0027","0000","1335","597","738","12","1347","2752","0","48.95","21.69"
"63","000","00","070","0027","0937","496","214","282","4","500","1024","0","48.83","20.90"
"63","000","00","070","0027","0938","407","174","233","5","412","853","0","48.30","20.40"
"63","000","00","070","0027","0939","432","209","223","3","435","875","0","49.71","23.89"
"63","000","00","070","0028","0000","1770","752","1018","16","1786","3985","0","44.82","18.87"
"63","000","00","070","0028","0934","629","268","361","7","636","1313","0","48.44","20.41"
"63","000","00","070","0028","0935","607","251","356","5","612","1357","0","45.10","18.50"
"63","000","00","070","0028","0936","534","233","301","4","538","1315","0","40.91","17.72"
"63","000","00","070","0029","0000","1486","635","851","17","1503","3075","0","48.88","20.65"
"63","000","00","070","0029","0940","506","212","294","2","508","1014","0","50.10","20.91"
"63","000","00","070","0029","0941","488","207","281","7","495","1011","0","48.96","20.47"
"63","000","00","070","0029","0942","492","216","276","8","500","1050","0","47.62","20.57"
"63","000","00","070","0030","0000","1946","907","1039","17","1963","4233","0","46.37","21.43"
"63","000","00","070","0030","0930","465","202","263","6","471","1048","0","44.94","19.27"
"63","000","00","070","0030","0931","496","245","251","4","500","1159","0","43.14","21.14"
"63","000","00","070","0030","0932","470","220","250","4","474","1008","0","47.02","21.83"
"63","000","00","070","0030","0933","515","240","275","3","518","1018","0","50.88","23.58"
"63","000","00","070","0031","0000","1739","764","975","18","1757","3911","0","44.92","19.53"
"63","000","00","070","0031","0948","567","241","326","3","570","1243","0","45.86","19.39"
"63","000","00","070","0031","0949","639","307","332","8","647","1354","0","47.78","22.67"
"63","000","00","070","0031","0950","533","216","317","7","540","1314","0","41.10","16.44"
"63","000","00","070","0032","0000","2447","1032","1415","27","2474","5226","0","47.34","19.75"
"63","000","00","070","0032","0943","567","236","331","7","574","1147","0","50.04","20.58"
"63","000","00","070","0032","0944","409","185","224","10","419","944","0","44.39","19.60"
"63","000","00","070","0032","0945","521","214","307","3","524","1100","0","47.64","19.45"
"63","000","00","070","0032","0946","528","203","325","4","532","1124","0","47.33","18.06"
"63","000","00","070","0032","0947","422","194","228","3","425","911","0","46.65","21.30"
"63","000","00","070","0033","0000","2560","1580","980","22","2582","5167","0","49.97","30.58"
"63","000","00","070","0033","0951","424","226","198","6","430","990","0","43.43","22.83"
"63","000","00","070","0033","0952","507","283","224","2","509","998","0","51.00","28.36"
"63","000","00","070","0033","0953","658","511","147","6","664","1213","0","54.74","42.13"
"63","000","00","070","0033","0954","531","335","196","6","537","998","0","53.81","33.57"
"63","000","00","070","0033","0955","440","225","215","2","442","968","0","45.66","23.24"
"63","000","00","070","0034","0000","1947","1279","668","32","1979","4179","0","47.36","30.61"
"63","000","00","070","0034","0956","537","400","137","7","544","1034","0","52.61","38.68"
"63","000","00","070","0034","0957","534","377","157","12","546","1091","0","50.05","34.56"
"63","000","00","070","0034","0958","437","251","186","6","443","1038","0","42.68","24.18"
"63","000","00","070","0034","0959","439","251","188","7","446","1016","0","43.90","24.70"
"63","000","00","070","0035","0000","1458","919","539","23","1481","3097","0","47.82","29.67"
"63","000","00","070","0035","0974","498","315","183","8","506","1043","0","48.51","30.20"
"63","000","00","070","0035","0975","479","285","194","6","485","1019","0","47.60","27.97"
"63","000","00","070","0035","0976","481","319","162","9","490","1035","0","47.34","30.82"
"63","000","00","070","0036","0000","1334","821","513","19","1353","2636","0","51.33","31.15"
"63","000","00","070","0036","0977","680","439","241","6","686","1313","0","52.25","33.43"
"63","000","00","070","0036","0978","654","382","272","13","667","1323","0","50.42","28.87"
"63","000","00","080","0000","0000","106427","63545","42882","1022","107449","222227","264975","48.35","28.59"
"63","000","00","080","0001","0000","2890","1515","1375","24","2914","6344","0","45.93","23.88"
"63","000","00","080","0001","0979","594","270","324","3","597","1316","0","45.36","20.52"
"63","000","00","080","0001","0980","549","299","250","3","552","1204","0","45.85","24.83"
"63","000","00","080","0001","0981","564","284","280","4","568","1204","0","47.18","23.59"
"63","000","00","080","0001","0982","668","375","293","6","674","1421","0","47.43","26.39"
"63","000","00","080","0001","0983","515","287","228","8","523","1199","0","43.62","23.94"
"63","000","00","080","0002","0000","2821","1778","1043","18","2839","5987","0","47.42","29.70"
"63","000","00","080","0002","0984","731","453","278","8","739","1547","0","47.77","29.28"
"63","000","00","080","0002","0985","688","439","249","2","690","1500","0","46.00","29.27"
"63","000","00","080","0002","0986","669","435","234","5","674","1417","0","47.57","30.70"
"63","000","00","080","0002","0987","733","451","282","3","736","1523","0","48.33","29.61"
"63","000","00","080","0003","0000","2058","1091","967","10","2068","4219","0","49.02","25.86"
"63","000","00","080","0003","0988","709","386","323","1","710","1438","0","49.37","26.84"
"63","000","00","080","0003","0989","684","373","311","6","690","1374","0","50.22","27.15"
"63","000","00","080","0003","0990","665","332","333","3","668","1407","0","47.48","23.60"
"63","000","00","080","0004","0000","2630","1480","1150","29","2659","5431","0","48.96","27.25"
"63","000","00","080","0004","0991","619","345","274","7","626","1361","0","46.00","25.35"
"63","000","00","080","0004","0992","660","372","288","7","667","1352","0","49.33","27.51"
"63","000","00","080","0004","0993","672","384","288","9","681","1376","0","49.49","27.91"
"63","000","00","080","0004","0994","679","379","300","6","685","1342","0","51.04","28.24"
"63","000","00","080","0005","0000","2337","1375","962","30","2367","4675","0","50.63","29.41"
"63","000","00","080","0005","0995","565","336","229","7","572","1193","0","47.95","28.16"
"63","000","00","080","0005","0996","577","314","263","11","588","1239","0","47.46","25.34"
"63","000","00","080","0005","0997","644","389","255","6","650","1251","0","51.96","31.10"
"63","000","00","080","0005","0998","551","336","215","6","557","992","0","56.15","33.87"
"63","000","00","080","0006","0000","2365","1403","962","20","2385","4768","0","50.02","29.43"
"63","000","00","080","0006","0999","575","355","220","3","578","1168","0","49.49","30.39"
"63","000","00","080","0006","1000","516","308","208","8","524","1136","0","46.13","27.11"
"63","000","00","080","0006","1001","652","394","258","3","655","1238","0","52.91","31.83"
"63","000","00","080","0006","1002","622","346","276","6","628","1226","0","51.22","28.22"
"63","000","00","080","0007","0000","2330","1385","945","12","2342","4621","0","50.68","29.97"
"63","000","00","080","0007","1003","531","299","232","2","533","1098","0","48.54","27.23"
"63","000","00","080","0007","1004","583","318","265","4","587","1252","0","46.88","25.40"
"63","000","00","080","0007","1005","592","348","244","1","593","1157","0","51.25","30.08"
"63","000","00","080","0007","1006","624","420","204","5","629","1114","0","56.46","37.70"
"63","000","00","080","0008","0000","1864","1039","825","21","1885","3814","0","49.42","27.24"
"63","000","00","080","0008","1007","649","355","294","7","656","1284","0","51.09","27.65"
"63","000","00","080","0008","1008","596","337","259","8","604","1246","0","48.48","27.05"
"63","000","00","080","0008","1009","619","347","272","6","625","1284","0","48.68","27.02"
"63","000","00","080","0009","0000","3012","1804","1208","29","3041","6067","0","50.12","29.73"
"63","000","00","080","0009","1010","632","410","222","3","635","1284","0","49.45","31.93"
"63","000","00","080","0009","1011","601","364","237","4","605","1222","0","49.51","29.79"
"63","000","00","080","0009","1012","564","354","210","7","571","1170","0","48.80","30.26"
"63","000","00","080","0009","1013","600","313","287","6","606","1169","0","51.84","26.78"
"63","000","00","080","0009","1014","615","363","252","9","624","1222","0","51.06","29.71"
"63","000","00","080","0010","0000","2252","1264","988","22","2274","4515","0","50.37","28.00"
"63","000","00","080","0010","1015","525","270","255","8","533","1128","0","47.25","23.94"
"63","000","00","080","0010","1016","534","293","241","4","538","1099","0","48.95","26.66"
"63","000","00","080","0010","1017","623","355","268","3","626","1136","0","55.11","31.25"
"63","000","00","080","0010","1018","570","346","224","7","577","1152","0","50.09","30.03"
"63","000","00","080","0011","0000","1434","972","462","24","1458","2826","0","51.59","34.39"
"63","000","00","080","0011","1019","704","432","272","14","718","1431","0","50.17","30.19"
"63","000","00","080","0011","1020","730","540","190","10","740","1395","0","53.05","38.71"
"63","000","00","080","0012","0000","1945","1138","807","13","1958","3978","0","49.22","28.61"
"63","000","00","080","0012","1021","574","306","268","6","580","1231","0","47.12","24.86"
"63","000","00","080","0012","1022","634","369","265","1","635","1338","0","47.46","27.58"
"63","000","00","080","0012","1023","737","463","274","6","743","1409","0","52.73","32.86"
"63","000","00","080","0013","0000","2120","1247","873","34","2154","4213","0","51.13","29.60"
"63","000","00","080","0013","1024","702","378","324","10","712","1453","0","49.00","26.02"
"63","000","00","080","0013","1025","672","425","247","12","684","1408","0","48.58","30.18"
"63","000","00","080","0013","1026","746","444","302","12","758","1352","0","56.07","32.84"
"63","000","00","080","0014","0000","1452","873","579","22","1474","3144","0","46.88","27.77"
"63","000","00","080","0014","1030","725","398","327","10","735","1655","0","44.41","24.05"
"63","000","00","080","0014","1031","727","475","252","12","739","1489","0","49.63","31.90"
"63","000","00","080","0015","0000","3101","1937","1164","30","3131","6323","0","49.52","30.63"
"63","000","00","080","0015","1032","671","423","248","5","676","1334","0","50.67","31.71"
"63","000","00","080","0015","1033","646","423","223","7","653","1261","0","51.78","33.54"
"63","000","00","080","0015","1034","590","352","238","5","595","1245","0","47.79","28.27"
"63","000","00","080","0015","1035","613","397","216","6","619","1236","0","50.08","32.12"
"63","000","00","080","0015","1036","581","342","239","7","588","1247","0","47.15","27.43"
"63","000","00","080","0016","0000","2398","1460","938","32","2430","5161","0","47.08","28.29"
"63","000","00","080","0016","1037","684","400","284","9","693","1505","0","46.05","26.58"
"63","000","00","080","0016","1038","678","414","264","9","687","1421","0","48.35","29.13"
"63","000","00","080","0016","1039","540","345","195","7","547","1260","0","43.41","27.38"
"63","000","00","080","0016","1040","496","301","195","7","503","975","0","51.59","30.87"
"63","000","00","080","0017","0000","2266","1467","799","18","2284","4630","0","49.33","31.68"
"63","000","00","080","0017","1041","602","393","209","3","605","1158","0","52.25","33.94"
"63","000","00","080","0017","1042","525","345","180","5","530","1110","0","47.75","31.08"
"63","000","00","080","0017","1043","487","312","175","6","493","1053","0","46.82","29.63"
"63","000","00","080","0017","1044","652","417","235","4","656","1309","0","50.11","31.86"
"63","000","00","080","0018","0000","2891","1791","1100","26","2917","5698","0","51.19","31.43"
"63","000","00","080","0018","1045","789","461","328","7","796","1581","0","50.35","29.16"
"63","000","00","080","0018","1046","646","423","223","9","655","1365","0","47.99","30.99"
"63","000","00","080","0018","1047","768","476","292","4","772","1429","0","54.02","33.31"
"63","000","00","080","0018","1048","688","431","257","6","694","1323","0","52.46","32.58"
"63","000","00","080","0019","0000","2291","1275","1016","20","2311","4637","0","49.84","27.50"
"63","000","00","080","0019","1049","554","328","226","6","560","1106","0","50.63","29.66"
"63","000","00","080","0019","1050","553","308","245","6","559","1149","0","48.65","26.81"
"63","000","00","080","0019","1051","595","310","285","3","598","1208","0","49.50","25.66"
"63","000","00","080","0019","1052","589","329","260","5","594","1174","0","50.60","28.02"
"63","000","00","080","0020","0000","3245","2059","1186","32","3277","7009","0","46.75","29.38"
"63","000","00","080","0020","1053","528","348","180","5","533","1202","0","44.34","28.95"
"63","000","00","080","0020","1054","568","359","209","8","576","1206","0","47.76","29.77"
"63","000","00","080","0020","1055","581","356","225","2","583","1199","0","48.62","29.69"
"63","000","00","080","0020","1056","526","343","183","8","534","1095","0","48.77","31.32"
"63","000","00","080","0020","1057","512","320","192","4","516","1155","0","44.68","27.71"
"63","000","00","080","0020","1058","530","333","197","5","535","1152","0","46.44","28.91"
"63","000","00","080","0021","0000","1735","1009","726","16","1751","3527","0","49.65","28.61"
"63","000","00","080","0021","1059","558","327","231","2","560","1080","0","51.85","30.28"
"63","000","00","080","0021","1060","616","350","266","7","623","1199","0","51.96","29.19"
"63","000","00","080","0021","1061","561","332","229","7","568","1248","0","45.51","26.60"
"63","000","00","080","0022","0000","2712","1687","1025","26","2738","5643","0","48.52","29.90"
"63","000","00","080","0022","1062","592","403","189","4","596","1370","0","43.50","29.42"
"63","000","00","080","0022","1063","649","411","238","7","656","1407","0","46.62","29.21"
"63","000","00","080","0022","1064","729","411","318","5","734","1410","0","52.06","29.15"
"63","000","00","080","0022","1065","742","462","280","10","752","1456","0","51.65","31.73"
"63","000","00","080","0023","0000","2905","1860","1045","34","2939","5797","0","50.70","32.09"
"63","000","00","080","0023","1066","577","356","221","5","582","1112","0","52.34","32.01"
"63","000","00","080","0023","1067","552","357","195","7","559","1128","0","49.56","31.65"
"63","000","00","080","0023","1068","568","360","208","9","577","1090","0","52.94","33.03"
"63","000","00","080","0023","1069","583","380","203","9","592","1183","0","50.04","32.12"
"63","000","00","080","0023","1070","625","407","218","4","629","1284","0","48.99","31.70"
"63","000","00","080","0024","0000","3785","2326","1459","49","3834","7631","0","50.24","30.48"
"63","000","00","080","0024","1071","622","345","277","10","632","1336","0","47.31","25.82"
"63","000","00","080","0024","1072","693","422","271","13","706","1268","0","55.68","33.28"
"63","000","00","080","0024","1073","631","422","209","6","637","1264","0","50.40","33.39"
"63","000","00","080","0024","1074","621","368","253","3","624","1283","0","48.64","28.68"
"63","000","00","080","0024","1075","638","421","217","9","647","1286","0","50.31","32.74"
"63","000","00","080","0024","1076","580","348","232","8","588","1194","0","49.25","29.15"
"63","000","00","080","0025","0000","1537","900","637","14","1551","3738","0","41.49","24.08"
"63","000","00","080","0025","1077","652","367","285","8","660","1661","0","39.74","22.10"
"63","000","00","080","0025","1078","592","348","244","4","596","1309","0","45.53","26.59"
"63","000","00","080","0025","1079","293","185","108","2","295","768","0","38.41","24.09"
"63","000","00","080","0026","0000","2794","1701","1093","21","2815","5826","0","48.32","29.20"
"63","000","00","080","0026","1080","686","379","307","3","689","1449","0","47.55","26.16"
"63","000","00","080","0026","1081","609","389","220","9","618","1429","0","43.25","27.22"
"63","000","00","080","0026","1082","775","489","286","3","778","1481","0","52.53","33.02"
"63","000","00","080","0026","1083","724","444","280","6","730","1467","0","49.76","30.27"
"63","000","00","080","0027","0000","3841","2537","1304","37","3878","7776","0","49.87","32.63"
"63","000","00","080","0027","1084","633","383","250","6","639","1263","0","50.59","30.32"
"63","000","00","080","0027","1085","666","430","236","8","674","1371","0","49.16","31.36"
"63","000","00","080","0027","1086","650","419","231","6","656","1330","0","49.32","31.50"
"63","000","00","080","0027","1087","557","382","175","7","564","1191","0","47.36","32.07"
"63","000","00","080","0027","1088","651","434","217","5","656","1255","0","52.27","34.58"
"63","000","00","080","0027","1089","684","489","195","5","689","1366","0","50.44","35.80"
"63","000","00","080","0028","0000","3461","1918","1543","24","3485","8867","0","39.30","21.63"
"63","000","00","080","0028","1090","618","357","261","3","621","2449","0","25.36","14.58"
"63","000","00","080","0028","1091","534","284","250","8","542","1226","0","44.21","23.16"
"63","000","00","080","0028","1092","519","282","237","2","521","1233","0","42.25","22.87"
"63","000","00","080","0028","1093","537","299","238","5","542","1307","0","41.47","22.88"
"63","000","00","080","0028","1094","615","344","271","3","618","1305","0","47.36","26.36"
"63","000","00","080","0028","1095","638","352","286","3","641","1347","0","47.59","26.13"
"63","000","00","080","0029","0000","2981","1702","1279","28","3009","6234","0","48.27","27.30"
"63","000","00","080","0029","1096","545","302","243","7","552","1142","0","48.34","26.44"
"63","000","00","080","0029","1097","590","327","263","3","593","1276","0","46.47","25.63"
"63","000","00","080","0029","1098","567","319","248","3","570","1165","0","48.93","27.38"
"63","000","00","080","0029","1099","540","308","232","8","548","1255","0","43.67","24.54"
"63","000","00","080","0029","1100","739","446","293","7","746","1396","0","53.44","31.95"
"63","000","00","080","0030","0000","3284","2056","1228","27","3311","7099","0","46.64","28.96"
"63","000","00","080","0030","1104","691","434","257","7","698","1464","0","47.68","29.64"
"63","000","00","080","0030","1105","634","398","236","10","644","1347","0","47.81","29.55"
"63","000","00","080","0030","1106","644","382","262","3","647","1404","0","46.08","27.21"
"63","000","00","080","0030","1107","655","385","270","3","658","1520","0","43.29","25.33"
"63","000","00","080","0030","1108","660","457","203","4","664","1364","0","48.68","33.50"
"63","000","00","080","0031","0000","2290","1412","878","23","2313","4662","0","49.61","30.29"
"63","000","00","080","0031","1109","567","344","223","8","575","1198","0","48.00","28.71"
"63","000","00","080","0031","1110","600","394","206","3","603","1136","0","53.08","34.68"
"63","000","00","080","0031","1111","542","302","240","5","547","1145","0","47.77","26.38"
"63","000","00","080","0031","1112","581","372","209","7","588","1183","0","49.70","31.45"
"63","000","00","080","0032","0000","2241","1285","956","25","2266","4648","0","48.75","27.65"
"63","000","00","080","0032","1117","522","302","220","6","528","1066","0","49.53","28.33"
"63","000","00","080","0032","1118","520","290","230","7","527","1143","0","46.11","25.37"
"63","000","00","080","0032","1119","622","350","272","6","628","1286","0","48.83","27.22"
"63","000","00","080","0032","1120","577","343","234","6","583","1153","0","50.56","29.75"
"63","000","00","080","0033","0000","3203","1984","1219","25","3228","6704","0","48.15","29.59"
"63","000","00","080","0033","1124","703","403","300","3","706","1412","0","50.00","28.54"
"63","000","00","080","0033","1125","579","361","218","5","584","1275","0","45.80","28.31"
"63","000","00","080","0033","1126","658","415","243","3","661","1427","0","46.32","29.08"
"63","000","00","080","0033","1127","706","447","259","11","717","1370","0","52.34","32.63"
"63","000","00","080","0033","1128","557","358","199","3","560","1220","0","45.90","29.34"
"63","000","00","080","0034","0000","2359","1337","1022","16","2375","5050","0","47.03","26.48"
"63","000","00","080","0034","1134","504","236","268","4","508","1059","0","47.97","22.29"
"63","000","00","080","0034","1135","469","251","218","1","470","1018","0","46.17","24.66"
"63","000","00","080","0034","1136","450","277","173","3","453","989","0","45.80","28.01"
"63","000","00","080","0034","1137","426","281","145","2","428","994","0","43.06","28.27"
"63","000","00","080","0034","1138","510","292","218","6","516","990","0","52.12","29.49"
"63","000","00","080","0035","0000","3499","1962","1537","30","3529","7045","0","50.09","27.85"
"63","000","00","080","0035","1139","747","428","319","8","755","1437","0","52.54","29.78"
"63","000","00","080","0035","1140","725","409","316","5","730","1456","0","50.14","28.09"
"63","000","00","080","0035","1141","760","445","315","2","762","1462","0","52.12","30.44"
"63","000","00","080","0035","1142","681","365","316","6","687","1346","0","51.04","27.12"
"63","000","00","080","0035","1143","586","315","271","9","595","1344","0","44.27","23.44"
"63","000","00","080","0036","0000","1533","777","756","13","1546","3435","0","45.01","22.62"
"63","000","00","080","0036","1149","592","328","264","6","598","1267","0","47.20","25.89"
"63","000","00","080","0036","1150","610","339","271","3","613","1342","0","45.68","25.26"
"63","000","00","080","0036","1151","331","110","221","4","335","826","0","40.56","13.32"
"63","000","00","080","0037","0000","344","125","219","5","349","778","0","44.86","16.07"
"63","000","00","080","0037","1152","344","125","219","5","349","778","0","44.86","16.07"
"63","000","00","080","0038","0000","1895","1257","638","19","1914","3647","0","52.48","34.47"
"63","000","00","080","0038","1101","580","377","203","8","588","1060","0","55.47","35.57"
"63","000","00","080","0038","1102","687","452","235","5","692","1389","0","49.82","32.54"
"63","000","00","080","0038","1103","628","428","200","6","634","1198","0","52.92","35.73"
"63","000","00","080","0039","0000","2821","1728","1093","23","2844","6271","0","45.35","27.56"
"63","000","00","080","0039","1129","614","347","267","7","621","1252","0","49.60","27.72"
"63","000","00","080","0039","1130","575","359","216","8","583","1384","0","42.12","25.94"
"63","000","00","080","0039","1131","546","339","207","2","548","1208","0","45.36","28.06"
"63","000","00","080","0039","1132","512","337","175","4","516","1254","0","41.15","26.87"
"63","000","00","080","0039","1133","574","346","228","2","576","1173","0","49.10","29.50"
"63","000","00","080","0040","0000","3003","1738","1265","41","3044","6269","0","48.56","27.72"
"63","000","00","080","0040","1144","481","263","218","8","489","1042","0","46.93","25.24"
"63","000","00","080","0040","1145","561","324","237","12","573","1185","0","48.35","27.34"
"63","000","00","080","0040","1146","616","321","295","4","620","1305","0","47.51","24.60"
"63","000","00","080","0040","1147","665","402","263","9","674","1356","0","49.71","29.65"
"63","000","00","080","0040","1148","680","428","252","8","688","1381","0","49.82","30.99"
"63","000","00","080","0041","0000","2450","1384","1066","28","2478","5223","0","47.44","26.50"
"63","000","00","080","0041","1113","745","437","308","6","751","1534","0","48.96","28.49"
"63","000","00","080","0041","1114","547","291","256","9","556","1183","0","47.00","24.60"
"63","000","00","080","0041","1115","584","321","263","6","590","1252","0","47.12","25.64"
"63","000","00","080","0041","1116","574","335","239","7","581","1254","0","46.33","26.71"
"63","000","00","080","0042","0000","2145","1449","696","17","2162","4301","0","50.27","33.69"
"63","000","00","080","0042","1027","670","429","241","5","675","1359","0","49.67","31.57"
"63","000","00","080","0042","1028","748","509","239","3","751","1500","0","50.07","33.93"
"63","000","00","080","0042","1029","727","511","216","9","736","1442","0","51.04","35.44"
"63","000","00","080","0043","0000","1907","1058","849","15","1922","3996","0","48.10","26.48"
"63","000","00","080","0043","1121","615","345","270","6","621","1276","0","48.67","27.04"
"63","000","00","080","0043","1122","656","360","296","8","664","1354","0","49.04","26.59"
"63","000","00","080","0043","1123","636","353","283","1","637","1366","0","46.63","25.84"
"63","000","00","090","0000","0000","44480","22976","21504","409","44889","99364","117188","45.18","23.12"
"63","000","00","090","0001","0000","2167","1093","1074","14","2181","5637","0","38.69","19.39"
"63","000","00","090","0001","1153","429","179","250","1","430","1105","0","38.91","16.20"
"63","000","00","090","0001","1154","611","328","283","2","613","1427","0","42.96","22.99"
"63","000","00","090","0001","1155","538","280","258","5","543","1292","0","42.03","21.67"
"63","000","00","090","0001","1156","589","306","283","6","595","1813","0","32.82","16.88"
"63","000","00","090","0002","0000","1235","568","667","10","1245","3127","0","39.81","18.16"
"63","000","00","090","0002","1157","432","158","274","1","433","1028","0","42.12","15.37"
"63","000","00","090","0002","1158","433","231","202","6","439","1121","0","39.16","20.61"
"63","000","00","090","0002","1159","370","179","191","3","373","978","0","38.14","18.30"
"63","000","00","090","0003","0000","1471","667","804","17","1488","3300","0","45.09","20.21"
"63","000","00","090","0003","1165","462","226","236","4","466","989","0","47.12","22.85"
"63","000","00","090","0003","1166","525","228","297","7","532","1169","0","45.51","19.50"
"63","000","00","090","0003","1167","484","213","271","6","490","1142","0","42.91","18.65"
"63","000","00","090","0004","0000","2705","1397","1308","16","2721","6452","0","42.17","21.65"
"63","000","00","090","0004","1160","538","237","301","1","539","1291","0","41.75","18.36"
"63","000","00","090","0004","1161","501","266","235","2","503","1313","0","38.31","20.26"
"63","000","00","090","0004","1162","536","278","258","5","541","1293","0","41.84","21.50"
"63","000","00","090","0004","1163","548","308","240","6","554","1266","0","43.76","24.33"
"63","000","00","090","0004","1164","582","308","274","2","584","1289","0","45.31","23.89"
"63","000","00","090","0005","0000","2586","1273","1313","19","2605","6152","0","42.34","20.69"
"63","000","00","090","0005","1184","434","204","230","5","439","1238","0","35.46","16.48"
"63","000","00","090","0005","1185","582","293","289","4","586","1340","0","43.73","21.87"
"63","000","00","090","0005","1186","514","214","300","4","518","1184","0","43.75","18.07"
"63","000","00","090","0005","1187","545","306","239","3","548","1271","0","43.12","24.08"
"63","000","00","090","0005","1188","511","256","255","3","514","1119","0","45.93","22.88"
"63","000","00","090","0006","0000","1457","782","675","6","1463","3170","0","46.15","24.67"
"63","000","00","090","0006","1208","529","284","245","4","533","1126","0","47.34","25.22"
"63","000","00","090","0006","1209","503","271","232","0","503","1086","0","46.32","24.95"
"63","000","00","090","0006","1210","425","227","198","2","427","958","0","44.57","23.70"
"63","000","00","090","0007","0000","2309","1281","1028","24","2333","4785","0","48.76","26.77"
"63","000","00","090","0007","1193","548","298","250","6","554","1204","0","46.01","24.75"
"63","000","00","090","0007","1194","496","287","209","5","501","1063","0","47.13","27.00"
"63","000","00","090","0007","1195","639","349","290","7","646","1280","0","50.47","27.27"
"63","000","00","090","0007","1196","626","347","279","6","632","1238","0","51.05","28.03"
"63","000","00","090","0008","0000","1785","731","1054","18","1803","4037","0","44.66","18.11"
"63","000","00","090","0008","1197","594","259","335","7","601","1305","0","46.05","19.85"
"63","000","00","090","0008","1198","617","256","361","4","621","1374","0","45.20","18.63"
"63","000","00","090","0008","1199","574","216","358","7","581","1358","0","42.78","15.91"
"63","000","00","090","0009","0000","1857","862","995","15","1872","4075","0","45.94","21.15"
"63","000","00","090","0009","1200","635","270","365","6","641","1445","0","44.36","18.69"
"63","000","00","090","0009","1201","609","304","305","5","614","1314","0","46.73","23.14"
"63","000","00","090","0009","1202","613","288","325","4","617","1316","0","46.88","21.88"
"63","000","00","090","0010","0000","2715","1352","1363","19","2734","5716","0","47.83","23.65"
"63","000","00","090","0010","1203","499","250","249","5","504","1052","0","47.91","23.76"
"63","000","00","090","0010","1204","578","285","293","6","584","1198","0","48.75","23.79"
"63","000","00","090","0010","1205","574","299","275","3","577","1211","0","47.65","24.69"
"63","000","00","090","0010","1206","527","255","272","2","529","1106","0","47.83","23.06"
"63","000","00","090","0010","1207","537","263","274","3","540","1149","0","47.00","22.89"
"63","000","00","090","0011","0000","3037","1735","1302","30","3067","6413","0","47.82","27.05"
"63","000","00","090","0011","1224","625","341","284","5","630","1402","0","44.94","24.32"
"63","000","00","090","0011","1225","661","379","282","6","667","1396","0","47.78","27.15"
"63","000","00","090","0011","1226","566","313","253","3","569","1139","0","49.96","27.48"
"63","000","00","090","0011","1227","639","374","265","8","647","1224","0","52.86","30.56"
"63","000","00","090","0011","1228","546","328","218","8","554","1252","0","44.25","26.20"
"63","000","00","090","0012","0000","1886","1028","858","18","1904","3623","0","52.55","28.37"
"63","000","00","090","0012","1214","544","286","258","7","551","1133","0","48.63","25.24"
"63","000","00","090","0012","1215","672","316","356","8","680","1209","0","56.24","26.14"
"63","000","00","090","0012","1216","670","426","244","3","673","1281","0","52.54","33.26"
"63","000","00","090","0013","0000","1849","950","899","18","1867","3885","0","48.06","24.45"
"63","000","00","090","0013","1217","622","318","304","7","629","1340","0","46.94","23.73"
"63","000","00","090","0013","1218","587","314","273","7","594","1248","0","47.60","25.16"
"63","000","00","090","0013","1219","640","318","322","4","644","1297","0","49.65","24.52"
"63","000","00","090","0014","0000","1994","979","1015","23","2017","4544","0","44.39","21.54"
"63","000","00","090","0014","1220","460","237","223","2","462","1138","0","40.60","20.83"
"63","000","00","090","0014","1221","494","241","253","3","497","1141","0","43.56","21.12"
"63","000","00","090","0014","1222","511","251","260","5","516","1103","0","46.78","22.76"
"63","000","00","090","0014","1223","529","250","279","13","542","1162","0","46.64","21.51"
"63","000","00","090","0015","0000","1998","1070","928","26","2024","4274","0","47.36","25.04"
"63","000","00","090","0015","1211","698","412","286","6","704","1411","0","49.89","29.20"
"63","000","00","090","0015","1212","666","318","348","12","678","1488","0","45.56","21.37"
"63","000","00","090","0015","1213","634","340","294","8","642","1375","0","46.69","24.73"
"63","000","00","090","0016","0000","3008","1465","1543","30","3038","7580","0","40.08","19.33"
"63","000","00","090","0016","1178","481","208","273","8","489","1349","0","36.25","15.42"
"63","000","00","090","0016","1179","473","201","272","4","477","1297","0","36.78","15.50"
"63","000","00","090","0016","1180","512","250","262","2","514","1221","0","42.10","20.48"
"63","000","00","090","0016","1181","498","279","219","2","500","1185","0","42.19","23.54"
"63","000","00","090","0016","1182","479","252","227","6","485","1220","0","39.75","20.66"
"63","000","00","090","0016","1183","565","275","290","8","573","1308","0","43.81","21.02"
"63","000","00","090","0017","0000","3573","1751","1822","41","3614","7890","0","45.80","22.19"
"63","000","00","090","0017","1168","566","266","300","5","571","1435","0","39.79","18.54"
"63","000","00","090","0017","1169","596","281","315","8","604","1256","0","48.09","22.37"
"63","000","00","090","0017","1170","610","274","336","2","612","1279","0","47.85","21.42"
"63","000","00","090","0017","1171","646","315","331","7","653","1369","0","47.70","23.01"
"63","000","00","090","0017","1172","557","270","287","12","569","1331","0","42.75","20.29"
"63","000","00","090","0017","1173","598","345","253","7","605","1220","0","49.59","28.28"
"63","000","00","090","0018","0000","2386","1375","1011","28","2414","5386","0","44.82","25.53"
"63","000","00","090","0018","1174","578","284","294","9","587","1395","0","42.08","20.36"
"63","000","00","090","0018","1175","696","482","214","8","704","1324","0","53.17","36.40"
"63","000","00","090","0018","1176","466","221","245","4","470","1266","0","37.12","17.46"
"63","000","00","090","0018","1177","646","388","258","7","653","1401","0","46.61","27.69"
"63","000","00","090","0019","0000","2360","1459","901","19","2379","4777","0","49.80","30.54"
"63","000","00","090","0019","1229","559","352","207","5","564","1114","0","50.63","31.60"
"63","000","00","090","0019","1230","508","302","206","4","512","994","0","51.51","30.38"
"63","000","00","090","0019","1231","712","439","273","6","718","1323","0","54.27","33.18"
"63","000","00","090","0019","1232","581","366","215","4","585","1346","0","43.46","27.19"
"63","000","00","090","0020","0000","2102","1158","944","18","2120","4541","0","46.69","25.50"
"63","000","00","090","0020","1189","478","252","226","5","483","1166","0","41.42","21.61"
"63","000","00","090","0020","1190","499","265","234","1","500","1122","0","44.56","23.62"
"63","000","00","090","0020","1191","568","328","240","4","572","1123","0","50.93","29.21"
"63","000","00","090","0020","1192","557","313","244","8","565","1130","0","50.00","27.70"
"63","000","00","100","0000","0000","107117","56881","50236","1017","108134","232305","279598","46.55","24.49"
"63","000","00","100","0001","0000","2892","1407","1485","23","2915","6163","0","47.30","22.83"
"63","000","00","100","0001","1233","555","265","290","4","559","1205","0","46.39","21.99"
"63","000","00","100","0001","1234","528","256","272","5","533","1156","0","46.11","22.15"
"63","000","00","100","0001","1235","583","266","317","8","591","1251","0","47.24","21.26"
"63","000","00","100","0001","1236","590","310","280","3","593","1233","0","48.09","25.14"
"63","000","00","100","0001","1237","636","310","326","3","639","1318","0","48.48","23.52"
"63","000","00","100","0002","0000","3964","2182","1782","52","4016","8190","0","49.04","26.64"
"63","000","00","100","0002","1238","660","330","330","12","672","1315","0","51.10","25.10"
"63","000","00","100","0002","1239","719","389","330","8","727","1418","0","51.27","27.43"
"63","000","00","100","0002","1240","650","341","309","11","661","1367","0","48.35","24.95"
"63","000","00","100","0002","1241","647","322","325","3","650","1495","0","43.48","21.54"
"63","000","00","100","0002","1242","629","347","282","10","639","1324","0","48.26","26.21"
"63","000","00","100","0002","1243","659","453","206","8","667","1271","0","52.48","35.64"
"63","000","00","100","0003","0000","2741","1454","1287","38","2779","5644","0","49.24","25.76"
"63","000","00","100","0003","1244","632","340","292","13","645","1333","0","48.39","25.51"
"63","000","00","100","0003","1245","693","386","307","12","705","1414","0","49.86","27.30"
"63","000","00","100","0003","1246","689","327","362","6","695","1371","0","50.69","23.85"
"63","000","00","100","0003","1247","727","401","326","7","734","1526","0","48.10","26.28"
"63","000","00","100","0005","0000","2462","1243","1219","16","2478","5115","0","48.45","24.30"
"63","000","00","100","0005","1248","655","343","312","4","659","1302","0","50.61","26.34"
"63","000","00","100","0005","1249","611","319","292","5","616","1255","0","49.08","25.42"
"63","000","00","100","0005","1250","621","284","337","3","624","1331","0","46.88","21.34"
"63","000","00","100","0005","1251","575","297","278","4","579","1227","0","47.19","24.21"
"63","000","00","100","0006","0000","2123","1058","1065","19","2142","4642","0","46.14","22.79"
"63","000","00","100","0006","1252","695","349","346","4","699","1561","0","44.78","22.36"
"63","000","00","100","0006","1253","744","388","356","9","753","1528","0","49.28","25.39"
"63","000","00","100","0006","1254","684","321","363","6","690","1553","0","44.43","20.67"
"63","000","00","100","0007","0000","3758","1974","1784","33","3791","7960","0","47.63","24.80"
"63","000","00","100","0007","1255","540","276","264","7","547","1289","0","42.44","21.41"
"63","000","00","100","0007","1256","674","327","347","9","683","1435","0","47.60","22.79"
"63","000","00","100","0007","1257","564","308","256","4","568","1246","0","45.59","24.72"
"63","000","00","100","0007","1258","798","413","385","2","800","1553","0","51.51","26.59"
"63","000","00","100","0007","1259","605","332","273","4","609","1202","0","50.67","27.62"
"63","000","00","100","0007","1260","577","318","259","7","584","1235","0","47.29","25.75"
"63","000","00","100","0008","0000","3547","1812","1735","35","3582","7644","0","46.86","23.70"
"63","000","00","100","0008","1261","697","393","304","5","702","1480","0","47.43","26.55"
"63","000","00","100","0008","1262","739","397","342","10","749","1596","0","46.93","24.87"
"63","000","00","100","0008","1263","689","351","338","5","694","1459","0","47.57","24.06"
"63","000","00","100","0008","1264","708","337","371","10","718","1554","0","46.20","21.69"
"63","000","00","100","0008","1265","714","334","380","5","719","1555","0","46.24","21.48"
"63","000","00","100","0009","0000","2605","1439","1166","20","2625","5561","0","47.20","25.88"
"63","000","00","100","0009","1266","623","343","280","7","630","1287","0","48.95","26.65"
"63","000","00","100","0009","1267","557","289","268","5","562","1295","0","43.40","22.32"
"63","000","00","100","0009","1268","681","394","287","3","684","1402","0","48.79","28.10"
"63","000","00","100","0009","1269","744","413","331","5","749","1577","0","47.50","26.19"
"63","000","00","100","0010","0000","3660","2115","1545","33","3693","7099","0","52.02","29.79"
"63","000","00","100","0010","1270","872","469","403","9","881","1633","0","53.95","28.72"
"63","000","00","100","0010","1271","803","486","317","8","811","1559","0","52.02","31.17"
"63","000","00","100","0010","1272","782","415","367","5","787","1433","0","54.92","28.96"
"63","000","00","100","0010","1273","669","426","243","6","675","1356","0","49.78","31.42"
"63","000","00","100","0010","1274","534","319","215","5","539","1118","0","48.21","28.53"
"63","000","00","100","0011","0000","3333","1639","1694","28","3361","6865","0","48.96","23.87"
"63","000","00","100","0011","1275","694","340","354","8","702","1486","0","47.24","22.88"
"63","000","00","100","0011","1276","648","318","330","1","649","1325","0","48.98","24.00"
"63","000","00","100","0011","1277","730","372","358","11","741","1371","0","54.05","27.13"
"63","000","00","100","0011","1278","600","292","308","4","604","1350","0","44.74","21.63"
"63","000","00","100","0011","1279","661","317","344","4","665","1333","0","49.89","23.78"
"63","000","00","100","0012","0000","2219","1179","1040","14","2233","4641","0","48.11","25.40"
"63","000","00","100","0012","1280","729","378","351","6","735","1586","0","46.34","23.83"
"63","000","00","100","0012","1281","760","405","355","5","765","1515","0","50.50","26.73"
"63","000","00","100","0012","1282","730","396","334","3","733","1540","0","47.60","25.71"
"63","000","00","100","0013","0000","2132","1164","968","12","2144","4647","0","46.14","25.05"
"63","000","00","100","0013","1283","764","443","321","2","766","1629","0","47.02","27.19"
"63","000","00","100","0013","1284","653","333","320","1","654","1452","0","45.04","22.93"
"63","000","00","100","0013","1285","715","388","327","9","724","1566","0","46.23","24.78"
"63","000","00","100","0014","0000","2846","1419","1427","26","2872","5790","0","49.60","24.51"
"63","000","00","100","0014","1286","700","332","368","7","707","1430","0","49.44","23.22"
"63","000","00","100","0014","1287","775","421","354","8","783","1500","0","52.20","28.07"
"63","000","00","100","0014","1288","623","308","315","4","627","1374","0","45.63","22.42"
"63","000","00","100","0014","1289","748","358","390","7","755","1486","0","50.81","24.09"
"63","000","00","100","0015","0000","2897","1559","1338","31","2928","6061","0","48.31","25.72"
"63","000","00","100","0015","1290","177","52","125","0","177","430","0","41.16","12.09"
"63","000","00","100","0015","1291","781","411","370","2","783","1593","0","49.15","25.80"
"63","000","00","100","0015","1292","687","383","304","9","696","1366","0","50.95","28.04"
"63","000","00","100","0015","1293","683","415","268","8","691","1337","0","51.68","31.04"
"63","000","00","100","0015","1294","569","298","271","12","581","1335","0","43.52","22.32"
"63","000","00","100","0016","0000","2364","1423","941","19","2383","4880","0","48.83","29.16"
"63","000","00","100","0016","1295","634","342","292","5","639","1313","0","48.67","26.05"
"63","000","00","100","0016","1296","532","342","190","8","540","1077","0","50.14","31.75"
"63","000","00","100","0016","1297","557","369","188","5","562","1185","0","47.43","31.14"
"63","000","00","100","0016","1298","641","370","271","1","642","1305","0","49.20","28.35"
"63","000","00","100","0017","0000","3530","1920","1610","31","3561","7269","0","48.99","26.41"
"63","000","00","100","0017","1299","726","424","302","7","733","1532","0","47.85","27.68"
"63","000","00","100","0017","1300","740","413","327","8","748","1525","0","49.05","27.08"
"63","000","00","100","0017","1301","764","434","330","8","772","1585","0","48.71","27.38"
"63","000","00","100","0017","1302","621","296","325","7","628","1234","0","50.89","23.99"
"63","000","00","100","0017","1303","679","353","326","1","680","1393","0","48.82","25.34"
"63","000","00","100","0018","0000","2684","1528","1156","24","2708","5983","0","45.26","25.54"
"63","000","00","100","0018","1304","716","420","296","6","722","1509","0","47.85","27.83"
"63","000","00","100","0018","1305","578","323","255","5","583","1443","0","40.40","22.38"
"63","000","00","100","0018","1306","733","399","334","5","738","1526","0","48.36","26.15"
"63","000","00","100","0018","1307","657","386","271","8","665","1505","0","44.19","25.65"
"63","000","00","100","0019","0000","3377","1776","1601","34","3411","7104","0","48.02","25.00"
"63","000","00","100","0019","1308","696","366","330","10","706","1517","0","46.54","24.13"
"63","000","00","100","0019","1309","577","301","276","8","585","1306","0","44.79","23.05"
"63","000","00","100","0019","1310","645","301","344","4","649","1407","0","46.13","21.39"
"63","000","00","100","0019","1311","704","383","321","7","711","1372","0","51.82","27.92"
"63","000","00","100","0019","1312","755","425","330","5","760","1502","0","50.60","28.30"
"63","000","00","100","0020","0000","3422","2120","1302","35","3457","6596","0","52.41","32.14"
"63","000","00","100","0020","1313","756","497","259","9","765","1503","0","50.90","33.07"
"63","000","00","100","0020","1314","687","410","277","8","695","1333","0","52.14","30.76"
"63","000","00","100","0020","1315","668","404","264","3","671","1279","0","52.46","31.59"
"63","000","00","100","0020","1316","619","316","303","10","629","1206","0","52.16","26.20"
"63","000","00","100","0020","1317","692","493","199","5","697","1275","0","54.67","38.67"
"63","000","00","100","0021","0000","1946","1204","742","18","1964","3925","0","50.04","30.68"
"63","000","00","100","0021","1318","697","382","315","4","701","1448","0","48.41","26.38"
"63","000","00","100","0021","1319","618","401","217","6","624","1209","0","51.61","33.17"
"63","000","00","100","0021","1320","631","421","210","8","639","1268","0","50.39","33.20"
"63","000","00","100","0022","0000","3426","1722","1704","30","3456","8758","0","39.46","19.66"
"63","000","00","100","0022","1321","607","274","333","5","612","1473","0","41.55","18.60"
"63","000","00","100","0022","1322","600","342","258","6","606","1453","0","41.71","23.54"
"63","000","00","100","0022","1323","569","268","301","6","575","1433","0","40.13","18.70"
"63","000","00","100","0022","1324","560","264","296","3","563","1490","0","37.79","17.72"
"63","000","00","100","0022","1325","545","309","236","7","552","1433","0","38.52","21.56"
"63","000","00","100","0022","1326","545","265","280","3","548","1476","0","37.13","17.95"
"63","000","00","100","0023","0000","2952","1503","1449","24","2976","6861","0","43.38","21.91"
"63","000","00","100","0023","1327","608","293","315","9","617","1436","0","42.97","20.40"
"63","000","00","100","0023","1328","531","254","277","3","534","1243","0","42.96","20.43"
"63","000","00","100","0023","1329","604","314","290","5","609","1411","0","43.16","22.25"
"63","000","00","100","0023","1330","562","329","233","6","568","1354","0","41.95","24.30"
"63","000","00","100","0023","1331","647","313","334","1","648","1417","0","45.73","22.09"
"63","000","00","100","0024","0000","2902","1472","1430","22","2924","6927","0","42.21","21.25"
"63","000","00","100","0024","1332","569","294","275","4","573","1409","0","40.67","20.87"
"63","000","00","100","0024","1333","656","340","316","6","662","1556","0","42.54","21.85"
"63","000","00","100","0024","1334","559","259","300","4","563","1272","0","44.26","20.36"
"63","000","00","100","0024","1335","595","283","312","3","598","1420","0","42.11","19.93"
"63","000","00","100","0024","1336","523","296","227","5","528","1270","0","41.57","23.31"
"63","000","00","100","0025","0000","1792","949","843","20","1812","4037","0","44.88","23.51"
"63","000","00","100","0025","1337","564","282","282","3","567","1161","0","48.84","24.29"
"63","000","00","100","0025","1338","452","263","189","7","459","1129","0","40.66","23.29"
"63","000","00","100","0025","1339","491","300","191","6","497","1004","0","49.50","29.88"
"63","000","00","100","0025","1340","285","104","181","4","289","743","0","38.90","14.00"
"63","000","00","100","0026","0000","3312","1581","1731","27","3339","7466","0","44.72","21.18"
"63","000","00","100","0026","1341","617","236","381","6","623","1450","0","42.97","16.28"
"63","000","00","100","0026","1342","716","346","370","5","721","1617","0","44.59","21.40"
"63","000","00","100","0026","1343","629","253","376","8","637","1380","0","46.16","18.33"
"63","000","00","100","0026","1344","657","370","287","5","662","1440","0","45.97","25.69"
"63","000","00","100","0026","1345","693","376","317","3","696","1579","0","44.08","23.81"
"63","000","00","100","0027","0000","2937","1417","1520","31","2968","6099","0","48.66","23.23"
"63","000","00","100","0027","1346","625","250","375","7","632","1416","0","44.63","17.66"
"63","000","00","100","0027","1347","749","358","391","5","754","1483","0","50.84","24.14"
"63","000","00","100","0027","1348","724","389","335","12","736","1542","0","47.73","25.23"
"63","000","00","100","0027","1349","839","420","419","7","846","1658","0","51.03","25.33"
"63","000","00","100","0028","0000","1444","770","674","11","1455","3369","0","43.19","22.86"
"63","000","00","100","0028","1350","627","278","349","4","631","1424","0","44.31","19.52"
"63","000","00","100","0028","1351","539","325","214","3","542","1307","0","41.47","24.87"
"63","000","00","100","0028","1352","278","167","111","4","282","638","0","44.20","26.18"
"63","000","00","100","0029","0000","2731","1424","1307","23","2754","7424","0","37.10","19.18"
"63","000","00","100","0029","1353","656","336","320","5","661","1516","0","43.60","22.16"
"63","000","00","100","0029","1354","733","430","303","8","741","2870","0","25.82","14.98"
"63","000","00","100","0029","1355","645","342","303","5","650","1489","0","43.65","22.97"
"63","000","00","100","0029","1356","697","316","381","5","702","1549","0","45.32","20.40"
"63","000","00","100","0030","0000","2102","1061","1041","24","2126","4537","0","46.86","23.39"
"63","000","00","100","0030","1357","718","362","356","10","728","1553","0","46.88","23.31"
"63","000","00","100","0030","1358","706","334","372","9","715","1512","0","47.29","22.09"
"63","000","00","100","0030","1359","678","365","313","5","683","1472","0","46.40","24.80"
"63","000","00","100","0031","0000","2865","1451","1414","28","2893","6387","0","45.30","22.72"
"63","000","00","100","0031","1360","469","217","252","5","474","1117","0","42.44","19.43"
"63","000","00","100","0031","1361","554","281","273","5","559","1208","0","46.27","23.26"
"63","000","00","100","0031","1362","544","258","286","8","552","1224","0","45.10","21.08"
"63","000","00","100","0031","1363","667","368","299","3","670","1403","0","47.75","26.23"
"63","000","00","100","0031","1364","631","327","304","7","638","1435","0","44.46","22.79"
"63","000","00","100","0032","0000","2580","1487","1093","33","2613","5366","0","48.70","27.71"
"63","000","00","100","0032","1365","673","373","300","8","681","1397","0","48.75","26.70"
"63","000","00","100","0032","1366","625","376","249","7","632","1334","0","47.38","28.19"
"63","000","00","100","0032","1367","658","384","274","10","668","1346","0","49.63","28.53"
"63","000","00","100","0032","1368","624","354","270","8","632","1289","0","49.03","27.46"
"63","000","00","100","0033","0000","1956","1044","912","12","1968","4591","0","42.87","22.74"
"63","000","00","100","0033","1369","715","373","342","4","719","1624","0","44.27","22.97"
"63","000","00","100","0033","1370","659","365","294","3","662","1594","0","41.53","22.90"
"63","000","00","100","0033","1371","582","306","276","5","587","1373","0","42.75","22.29"
"63","000","00","100","0034","0000","3782","2092","1690","46","3828","8128","0","47.10","25.74"
"63","000","00","100","0034","1372","736","386","350","2","738","1635","0","45.14","23.61"
"63","000","00","100","0034","1373","757","426","331","13","770","1627","0","47.33","26.18"
"63","000","00","100","0034","1374","769","420","349","9","778","1611","0","48.29","26.07"
"63","000","00","100","0034","1375","774","434","340","12","786","1595","0","49.28","27.21"
"63","000","00","100","0034","1376","746","426","320","10","756","1660","0","45.54","25.66"
"63","000","00","100","0035","0000","3339","1845","1494","27","3366","7322","0","45.97","25.20"
"63","000","00","100","0035","1377","563","323","240","4","567","1223","0","46.36","26.41"
"63","000","00","100","0035","1378","616","340","276","4","620","1384","0","44.80","24.57"
"63","000","00","100","0035","1379","670","362","308","3","673","1436","0","46.87","25.21"
"63","000","00","100","0035","1380","734","379","355","12","746","1683","0","44.33","22.52"
"63","000","00","100","0035","1381","756","441","315","4","760","1596","0","47.62","27.63"
"63","000","00","100","0036","0000","1992","952","1040","15","2007","4501","0","44.59","21.15"
"63","000","00","100","0036","1382","690","324","366","5","695","1469","0","47.31","22.06"
"63","000","00","100","0036","1383","654","296","358","4","658","1596","0","41.23","18.55"
"63","000","00","100","0036","1384","648","332","316","6","654","1436","0","45.54","23.12"
"63","000","00","100","0037","0000","390","163","227","9","399","1126","0","35.44","14.48"
"63","000","00","100","0037","1385","390","163","227","9","399","1126","0","35.44","14.48"
"63","000","00","100","0038","0000","2286","1067","1219","21","2307","4994","0","46.20","21.37"
"63","000","00","100","0038","1386","641","275","366","6","647","1342","0","48.21","20.49"
"63","000","00","100","0038","1387","534","263","271","5","539","1196","0","45.07","21.99"
"63","000","00","100","0038","1388","576","259","317","5","581","1330","0","43.68","19.47"
"63","000","00","100","0038","1389","535","270","265","5","540","1126","0","47.96","23.98"
"63","000","00","100","0039","0000","3694","2065","1629","37","3731","7959","0","46.88","25.95"
"63","000","00","100","0039","1390","707","416","291","6","713","1516","0","47.03","27.44"
"63","000","00","100","0039","1391","782","418","364","6","788","1553","0","50.74","26.92"
"63","000","00","100","0039","1392","770","438","332","10","780","1683","0","46.35","26.02"
"63","000","00","100","0039","1393","761","430","331","10","771","1670","0","46.17","25.75"
"63","000","00","100","0039","1394","674","363","311","5","679","1537","0","44.18","23.62"
"63","000","00","100","0040","0000","2133","1201","932","36","2169","4674","0","46.41","25.70"
"63","000","00","100","0040","1395","717","405","312","17","734","1493","0","49.16","27.13"
"63","000","00","100","0040","1396","687","380","307","12","699","1531","0","45.66","24.82"
"63","000","00","100","0040","1397","729","416","313","7","736","1650","0","44.61","25.21"
"63","000","00","110","0000","0000","107873","48047","59826","1013","108886","233253","274056","46.68","20.60"
"63","000","00","110","0001","0000","1550","629","921","10","1560","3285","0","47.49","19.15"
"63","000","00","110","0001","1398","513","198","315","5","518","1145","0","45.24","17.29"
"63","000","00","110","0001","1399","476","184","292","0","476","997","0","47.74","18.46"
"63","000","00","110","0001","1400","561","247","314","5","566","1143","0","49.52","21.61"
"63","000","00","110","0002","0000","1239","592","647","9","1248","2736","0","45.61","21.64"
"63","000","00","110","0002","1401","537","250","287","4","541","1227","0","44.09","20.37"
"63","000","00","110","0002","1402","702","342","360","5","707","1509","0","46.85","22.66"
"63","000","00","110","0003","0000","1131","521","610","19","1150","2482","0","46.33","20.99"
"63","000","00","110","0003","1403","445","229","216","10","455","1123","0","40.52","20.39"
"63","000","00","110","0003","1404","686","292","394","9","695","1359","0","51.14","21.49"
"63","000","00","110","0004","0000","1833","928","905","13","1846","5079","0","36.35","18.27"
"63","000","00","110","0004","1405","473","223","250","5","478","964","0","49.59","23.13"
"63","000","00","110","0004","1406","447","226","221","4","451","961","0","46.93","23.52"
"63","000","00","110","0004","1407","521","284","237","3","524","1044","0","50.19","27.20"
"63","000","00","110","0004","1408","392","195","197","1","393","2110","0","18.63","9.24"
"63","000","00","110","0005","0000","3378","1699","1679","21","3399","6507","0","52.24","26.11"
"63","000","00","110","0005","1409","608","333","275","3","611","1213","0","50.37","27.45"
"63","000","00","110","0005","1410","618","396","222","7","625","1222","0","51.15","32.41"
"63","000","00","110","0005","1411","606","305","301","2","608","1142","0","53.24","26.71"
"63","000","00","110","0005","1412","716","296","420","4","720","1421","0","50.67","20.83"
"63","000","00","110","0005","1413","830","369","461","5","835","1509","0","55.33","24.45"
"63","000","00","110","0006","0000","2597","1200","1397","19","2616","5295","0","49.41","22.66"
"63","000","00","110","0006","1414","603","319","284","1","604","1181","0","51.14","27.01"
"63","000","00","110","0006","1415","546","255","291","6","552","1241","0","44.48","20.55"
"63","000","00","110","0006","1416","779","352","427","5","784","1494","0","52.48","23.56"
"63","000","00","110","0006","1417","669","274","395","7","676","1379","0","49.02","19.87"
"63","000","00","110","0007","0000","3179","1479","1700","36","3215","6549","0","49.09","22.58"
"63","000","00","110","0007","1418","520","219","301","6","526","1118","0","47.05","19.59"
"63","000","00","110","0007","1419","673","292","381","9","682","1338","0","50.97","21.82"
"63","000","00","110","0007","1420","665","333","332","4","669","1387","0","48.23","24.01"
"63","000","00","110","0007","1421","751","373","378","11","762","1462","0","52.12","25.51"
"63","000","00","110","0007","1422","570","262","308","6","576","1244","0","46.30","21.06"
"63","000","00","110","0008","0000","2950","1184","1766","23","2973","6846","0","43.43","17.29"
"63","000","00","110","0008","1423","580","237","343","8","588","1350","0","43.56","17.56"
"63","000","00","110","0008","1424","553","212","341","5","558","1399","0","39.89","15.15"
"63","000","00","110","0008","1425","613","256","357","2","615","1422","0","43.25","18.00"
"63","000","00","110","0008","1426","558","207","351","2","560","1276","0","43.89","16.22"
"63","000","00","110","0008","1427","646","272","374","6","652","1399","0","46.60","19.44"
"63","000","00","110","0009","0000","2641","1078","1563","16","2657","5673","0","46.84","19.00"
"63","000","00","110","0009","1428","591","240","351","1","592","1346","0","43.98","17.83"
"63","000","00","110","0009","1429","635","255","380","3","638","1335","0","47.79","19.10"
"63","000","00","110","0009","1430","743","328","415","7","750","1489","0","50.37","22.03"
"63","000","00","110","0009","1431","672","255","417","5","677","1503","0","45.04","16.97"
"63","000","00","110","0010","0000","1731","666","1065","20","1751","3851","0","45.47","17.29"
"63","000","00","110","0010","1432","615","251","364","6","621","1349","0","46.03","18.61"
"63","000","00","110","0010","1433","621","214","407","11","632","1374","0","46.00","15.57"
"63","000","00","110","0010","1434","495","201","294","3","498","1128","0","44.15","17.82"
"63","000","00","110","0011","0000","2778","1126","1652","28","2806","5841","0","48.04","19.28"
"63","000","00","110","0011","1435","677","283","394","5","682","1459","0","46.74","19.40"
"63","000","00","110","0011","1436","694","267","427","10","704","1436","0","49.03","18.59"
"63","000","00","110","0011","1437","724","302","422","8","732","1493","0","49.03","20.23"
"63","000","00","110","0011","1438","683","274","409","5","688","1453","0","47.35","18.86"
"63","000","00","110","0012","0000","2182","1048","1134","19","2201","4783","0","46.02","21.91"
"63","000","00","110","0012","1439","497","253","244","6","503","1111","0","45.27","22.77"
"63","000","00","110","0012","1440","614","275","339","5","619","1342","0","46.13","20.49"
"63","000","00","110","0012","1441","541","259","282","4","545","1150","0","47.39","22.52"
"63","000","00","110","0012","1442","530","261","269","4","534","1180","0","45.25","22.12"
"63","000","00","110","0013","0000","2249","959","1290","28","2277","5342","0","42.62","17.95"
"63","000","00","110","0013","1443","538","254","284","2","540","1252","0","43.13","20.29"
"63","000","00","110","0013","1444","479","194","285","4","483","1235","0","39.11","15.71"
"63","000","00","110","0013","1445","553","237","316","11","564","1422","0","39.66","16.67"
"63","000","00","110","0013","1446","679","274","405","11","690","1433","0","48.15","19.12"
"63","000","00","110","0014","0000","1993","888","1105","13","2006","4156","0","48.27","21.37"
"63","000","00","110","0014","1447","643","320","323","4","647","1373","0","47.12","23.31"
"63","000","00","110","0014","1448","654","279","375","7","661","1421","0","46.52","19.63"
"63","000","00","110","0014","1449","696","289","407","2","698","1362","0","51.25","21.22"
"63","000","00","110","0015","0000","2168","830","1338","26","2194","4679","0","46.89","17.74"
"63","000","00","110","0015","1450","545","198","347","5","550","1152","0","47.74","17.19"
"63","000","00","110","0015","1451","567","235","332","5","572","1210","0","47.27","19.42"
"63","000","00","110","0015","1452","612","252","360","8","620","1300","0","47.69","19.38"
"63","000","00","110","0015","1453","444","145","299","8","452","1017","0","44.44","14.26"
"63","000","00","110","0016","0000","2234","851","1383","28","2262","5082","0","44.51","16.75"
"63","000","00","110","0016","1454","570","221","349","12","582","1288","0","45.19","17.16"
"63","000","00","110","0016","1455","482","171","311","3","485","1182","0","41.03","14.47"
"63","000","00","110","0016","1456","604","212","392","7","611","1306","0","46.78","16.23"
"63","000","00","110","0016","1457","578","247","331","6","584","1306","0","44.72","18.91"
"63","000","00","110","0017","0000","2900","1251","1649","32","2932","6264","0","46.81","19.97"
"63","000","00","110","0017","1458","526","197","329","6","532","1195","0","44.52","16.49"
"63","000","00","110","0017","1459","590","214","376","6","596","1310","0","45.50","16.34"
"63","000","00","110","0017","1460","572","206","366","10","582","1274","0","45.68","16.17"
"63","000","00","110","0017","1461","569","359","210","6","575","1164","0","49.40","30.84"
"63","000","00","110","0017","1462","643","275","368","4","647","1321","0","48.98","20.82"
"63","000","00","110","0018","0000","1608","642","966","8","1616","3514","0","45.99","18.27"
"63","000","00","110","0018","1463","490","206","284","4","494","1063","0","46.47","19.38"
"63","000","00","110","0018","1464","576","218","358","3","579","1233","0","46.96","17.68"
"63","000","00","110","0018","1465","542","218","324","1","543","1218","0","44.58","17.90"
"63","000","00","110","0019","0000","2423","907","1516","23","2446","5517","0","44.34","16.44"
"63","000","00","110","0019","1466","600","232","368","7","607","1280","0","47.42","18.13"
"63","000","00","110","0019","1467","627","200","427","4","631","1437","0","43.91","13.92"
"63","000","00","110","0019","1468","607","277","330","7","614","1425","0","43.09","19.44"
"63","000","00","110","0019","1469","589","198","391","5","594","1375","0","43.20","14.40"
"63","000","00","110","0020","0000","3260","1172","2088","34","3294","7737","0","42.57","15.15"
"63","000","00","110","0020","1470","604","217","387","3","607","1295","0","46.87","16.76"
"63","000","00","110","0020","1471","498","163","335","7","505","1204","0","41.94","13.54"
"63","000","00","110","0020","1472","516","205","311","4","520","1262","0","41.20","16.24"
"63","000","00","110","0020","1473","612","190","422","5","617","1445","0","42.70","13.15"
"63","000","00","110","0020","1474","506","214","292","6","512","1281","0","39.97","16.71"
"63","000","00","110","0020","1475","524","183","341","9","533","1250","0","42.64","14.64"
"63","000","00","110","0021","0000","2756","945","1811","37","2793","6210","0","44.98","15.22"
"63","000","00","110","0021","1476","483","185","298","2","485","1078","0","44.99","17.16"
"63","000","00","110","0021","1477","476","137","339","7","483","1148","0","42.07","11.93"
"63","000","00","110","0021","1478","601","198","403","12","613","1372","0","44.68","14.43"
"63","000","00","110","0021","1479","594","217","377","12","606","1360","0","44.56","15.96"
"63","000","00","110","0021","1480","602","208","394","4","606","1252","0","48.40","16.61"
"63","000","00","110","0022","0000","2686","960","1726","22","2708","6117","0","44.27","15.69"
"63","000","00","110","0022","1481","517","182","335","4","521","1222","0","42.64","14.89"
"63","000","00","110","0022","1482","520","180","340","3","523","1213","0","43.12","14.84"
"63","000","00","110","0022","1483","569","217","352","5","574","1242","0","46.22","17.47"
"63","000","00","110","0022","1484","516","168","348","6","522","1153","0","45.27","14.57"
"63","000","00","110","0022","1485","564","213","351","4","568","1287","0","44.13","16.55"
"63","000","00","110","0023","0000","1896","450","1446","19","1915","4416","0","43.37","10.19"
"63","000","00","110","0023","1486","598","140","458","7","605","1415","0","42.76","9.89"
"63","000","00","110","0023","1487","633","150","483","7","640","1459","0","43.87","10.28"
"63","000","00","110","0023","1488","665","160","505","5","670","1542","0","43.45","10.38"
"63","000","00","110","0024","0000","2263","602","1661","28","2291","5424","0","42.24","11.10"
"63","000","00","110","0024","1489","474","134","340","8","482","1135","0","42.47","11.81"
"63","000","00","110","0024","1490","660","150","510","4","664","1550","0","42.84","9.68"
"63","000","00","110","0024","1491","551","152","399","8","559","1340","0","41.72","11.34"
"63","000","00","110","0024","1492","578","166","412","8","586","1399","0","41.89","11.87"
"63","000","00","110","0025","0000","1335","693","642","10","1345","2895","0","46.46","23.94"
"63","000","00","110","0025","1493","632","305","327","6","638","1446","0","44.12","21.09"
"63","000","00","110","0025","1494","703","388","315","4","707","1449","0","48.79","26.78"
"63","000","00","110","0026","0000","3100","1539","1561","22","3122","6048","0","51.62","25.45"
"63","000","00","110","0026","1495","680","344","336","4","684","1313","0","52.09","26.20"
"63","000","00","110","0026","1496","601","323","278","5","606","1205","0","50.29","26.80"
"63","000","00","110","0026","1497","677","330","347","6","683","1337","0","51.08","24.68"
"63","000","00","110","0026","1498","630","331","299","3","633","1209","0","52.36","27.38"
"63","000","00","110","0026","1499","512","211","301","4","516","984","0","52.44","21.44"
"63","000","00","110","0027","0000","1865","857","1008","12","1877","3773","0","49.75","22.71"
"63","000","00","110","0027","1500","733","343","390","4","737","1315","0","56.05","26.08"
"63","000","00","110","0027","1501","540","254","286","5","545","1227","0","44.42","20.70"
"63","000","00","110","0027","1502","592","260","332","3","595","1231","0","48.33","21.12"
"63","000","00","110","0028","0000","2287","1028","1259","17","2304","4821","0","47.79","21.32"
"63","000","00","110","0028","1503","566","236","330","3","569","1220","0","46.64","19.34"
"63","000","00","110","0028","1504","532","217","315","3","535","1178","0","45.42","18.42"
"63","000","00","110","0028","1505","615","320","295","8","623","1283","0","48.56","24.94"
"63","000","00","110","0028","1506","574","255","319","3","577","1140","0","50.61","22.37"
"63","000","00","110","0029","0000","2139","1164","975","13","2152","4319","0","49.83","26.95"
"63","000","00","110","0029","1507","717","332","385","8","725","1478","0","49.05","22.46"
"63","000","00","110","0029","1508","668","311","357","1","669","1352","0","49.48","23.00"
"63","000","00","110","0029","1509","754","521","233","4","758","1489","0","50.91","34.99"
"63","000","00","110","0030","0000","2254","1361","893","19","2273","4739","0","47.96","28.72"
"63","000","00","110","0030","1510","574","384","190","9","583","1216","0","47.94","31.58"
"63","000","00","110","0030","1511","530","296","234","6","536","1133","0","47.31","26.13"
"63","000","00","110","0030","1512","610","381","229","1","611","1243","0","49.16","30.65"
"63","000","00","110","0030","1513","540","300","240","3","543","1147","0","47.34","26.16"
"63","000","00","110","0031","0000","3149","1478","1671","38","3187","6439","0","49.50","22.95"
"63","000","00","110","0031","1514","665","292","373","8","673","1360","0","49.49","21.47"
"63","000","00","110","0031","1515","670","320","350","11","681","1391","0","48.96","23.01"
"63","000","00","110","0031","1516","638","340","298","6","644","1291","0","49.88","26.34"
"63","000","00","110","0031","1517","561","254","307","7","568","1149","0","49.43","22.11"
"63","000","00","110","0031","1518","615","272","343","6","621","1248","0","49.76","21.79"
"63","000","00","110","0032","0000","2095","1167","928","25","2120","4371","0","48.50","26.70"
"63","000","00","110","0032","1519","697","437","260","6","703","1466","0","47.95","29.81"
"63","000","00","110","0032","1520","683","360","323","11","694","1391","0","49.89","25.88"
"63","000","00","110","0032","1521","715","370","345","8","723","1514","0","47.75","24.44"
"63","000","00","110","0033","0000","2348","1148","1200","18","2366","4881","0","48.47","23.52"
"63","000","00","110","0033","1522","594","305","289","7","601","1260","0","47.70","24.21"
"63","000","00","110","0033","1523","568","289","279","2","570","1229","0","46.38","23.52"
"63","000","00","110","0033","1524","584","261","323","8","592","1211","0","48.89","21.55"
"63","000","00","110","0033","1525","602","293","309","1","603","1181","0","51.06","24.81"
"63","000","00","110","0034","0000","3425","1642","1783","40","3465","7425","0","46.67","22.11"
"63","000","00","110","0034","1526","529","265","264","6","535","1202","0","44.51","22.05"
"63","000","00","110","0034","1527","550","243","307","7","557","1207","0","46.15","20.13"
"63","000","00","110","0034","1528","548","251","297","3","551","1160","0","47.50","21.64"
"63","000","00","110","0034","1529","668","312","356","12","680","1347","0","50.48","23.16"
"63","000","00","110","0034","1530","595","311","284","5","600","1373","0","43.70","22.65"
"63","000","00","110","0034","1531","535","260","275","7","542","1136","0","47.71","22.89"
"63","000","00","110","0035","0000","2680","1223","1457","19","2699","5452","0","49.50","22.43"
"63","000","00","110","0035","1532","653","319","334","6","659","1391","0","47.38","22.93"
"63","000","00","110","0035","1533","737","319","418","7","744","1458","0","51.03","21.88"
"63","000","00","110","0035","1534","731","337","394","4","735","1472","0","49.93","22.89"
"63","000","00","110","0035","1535","559","248","311","2","561","1131","0","49.60","21.93"
"63","000","00","110","0036","0000","2432","1176","1256","16","2448","5286","0","46.31","22.25"
"63","000","00","110","0036","1536","714","335","379","4","718","1502","0","47.80","22.30"
"63","000","00","110","0036","1537","557","252","305","4","561","1245","0","45.06","20.24"
"63","000","00","110","0036","1538","599","297","302","5","604","1256","0","48.09","23.65"
"63","000","00","110","0036","1539","562","292","270","3","565","1283","0","44.04","22.76"
"63","000","00","110","0037","0000","2111","947","1164","16","2127","4413","0","48.20","21.46"
"63","000","00","110","0037","1540","792","342","450","6","798","1727","0","46.21","19.80"
"63","000","00","110","0037","1541","634","303","331","7","641","1262","0","50.79","24.01"
"63","000","00","110","0037","1542","685","302","383","3","688","1424","0","48.31","21.21"
"63","000","00","110","0038","0000","2068","980","1088","17","2085","4299","0","48.50","22.80"
"63","000","00","110","0038","1543","699","332","367","4","703","1450","0","48.48","22.90"
"63","000","00","110","0038","1544","631","298","333","2","633","1323","0","47.85","22.52"
"63","000","00","110","0038","1545","738","350","388","11","749","1526","0","49.08","22.94"
"63","000","00","110","0039","0000","2996","1446","1550","36","3032","6370","0","47.60","22.70"
"63","000","00","110","0039","1546","626","298","328","5","631","1302","0","48.46","22.89"
"63","000","00","110","0039","1547","576","277","299","10","586","1185","0","49.45","23.38"
"63","000","00","110","0039","1548","590","281","309","4","594","1220","0","48.69","23.03"
"63","000","00","110","0039","1549","609","317","292","7","616","1300","0","47.38","24.38"
"63","000","00","110","0039","1550","595","273","322","10","605","1363","0","44.39","20.03"
"63","000","00","110","0040","0000","2794","1429","1365","34","2828","5880","0","48.10","24.30"
"63","000","00","110","0040","1551","683","359","324","9","692","1489","0","46.47","24.11"
"63","000","00","110","0040","1552","691","392","299","9","700","1472","0","47.55","26.63"
"63","000","00","110","0040","1553","695","316","379","10","705","1415","0","49.82","22.33"
"63","000","00","110","0040","1554","725","362","363","6","731","1504","0","48.60","24.07"
"63","000","00","110","0041","0000","3535","1726","1809","29","3564","7345","0","48.52","23.50"
"63","000","00","110","0041","1555","756","339","417","5","761","1592","0","47.80","21.29"
"63","000","00","110","0041","1556","678","350","328","7","685","1461","0","46.89","23.96"
"63","000","00","110","0041","1557","705","371","334","5","710","1480","0","47.97","25.07"
"63","000","00","110","0041","1558","765","348","417","7","772","1542","0","50.06","22.57"
"63","000","00","110","0041","1559","631","318","313","5","636","1270","0","50.08","25.04"
"63","000","00","110","0042","0000","2684","1326","1358","29","2713","5559","0","48.80","23.85"
"63","000","00","110","0042","1560","597","258","339","8","605","1191","0","50.80","21.66"
"63","000","00","110","0042","1561","688","358","330","4","692","1444","0","47.92","24.79"
"63","000","00","110","0042","1562","737","370","367","8","745","1485","0","50.17","24.92"
"63","000","00","110","0042","1563","662","340","322","9","671","1439","0","46.63","23.63"
"63","000","00","110","0043","0000","520","185","335","5","525","1083","0","48.48","17.08"
"63","000","00","110","0043","1564","520","185","335","5","525","1083","0","48.48","17.08"
"63","000","00","110","0044","0000","497","159","338","7","504","1228","0","41.04","12.95"
"63","000","00","110","0044","1565","497","159","338","7","504","1228","0","41.04","12.95"
"63","000","00","110","0045","0000","792","295","497","11","803","1668","0","48.14","17.69"
"63","000","00","110","0045","1566","390","144","246","7","397","840","0","47.26","17.14"
"63","000","00","110","0045","1567","402","151","251","4","406","828","0","49.03","18.24"
"63","000","00","110","0046","0000","1111","505","606","14","1125","2666","0","42.20","18.94"
"63","000","00","110","0046","1568","395","132","263","6","401","936","0","42.84","14.10"
"63","000","00","110","0046","1569","370","179","191","6","376","909","0","41.36","19.69"
"63","000","00","110","0046","1570","346","194","152","2","348","821","0","42.39","23.63"
"63","000","00","110","0047","0000","557","219","338","5","562","1421","0","39.55","15.41"
"63","000","00","110","0047","1571","325","123","202","4","329","889","0","37.01","13.84"
"63","000","00","110","0047","1572","232","96","136","1","233","532","0","43.80","18.05"
"63","000","00","110","0048","0000","551","140","411","4","555","1306","0","42.50","10.72"
"63","000","00","110","0048","1573","551","140","411","4","555","1306","0","42.50","10.72"
"63","000","00","110","0049","0000","565","223","342","7","572","1328","0","43.07","16.79"
"63","000","00","110","0049","1574","565","223","342","7","572","1328","0","43.07","16.79"
"63","000","00","110","0050","0000","1198","784","414","10","1208","2345","0","51.51","33.43"
"63","000","00","110","0050","1575","577","390","187","4","581","1144","0","50.79","34.09"
"63","000","00","110","0050","1576","621","394","227","6","627","1201","0","52.21","32.81"
"63","000","00","110","0051","0000","1160","600","560","9","1169","2508","0","46.61","23.92"
"63","000","00","110","0051","1577","625","335","290","6","631","1396","0","45.20","24.00"
"63","000","00","110","0051","1578","535","265","270","3","538","1112","0","48.38","23.83"
"63","000","00","120","0000","0000","94087","44293","49794","873","94960","207834","247333","45.69","21.31"
"63","000","00","120","0001","0000","1847","794","1053","11","1858","3704","0","50.16","21.44"
"63","000","00","120","0001","1579","600","272","328","5","605","1229","0","49.23","22.13"
"63","000","00","120","0001","1580","630","244","386","5","635","1241","0","51.17","19.66"
"63","000","00","120","0001","1581","617","278","339","1","618","1234","0","50.08","22.53"
"63","000","00","120","0002","0000","1703","721","982","12","1715","3685","0","46.54","19.57"
"63","000","00","120","0002","1582","525","225","300","4","529","1148","0","46.08","19.60"
"63","000","00","120","0002","1583","591","239","352","5","596","1285","0","46.38","18.60"
"63","000","00","120","0002","1584","587","257","330","3","590","1252","0","47.12","20.53"
"63","000","00","120","0003","0000","2130","937","1193","25","2155","4492","0","47.97","20.86"
"63","000","00","120","0003","1585","587","254","333","8","595","1166","0","51.03","21.78"
"63","000","00","120","0003","1586","671","300","371","5","676","1369","0","49.38","21.91"
"63","000","00","120","0003","1587","370","173","197","7","377","854","0","44.15","20.26"
"63","000","00","120","0003","1588","502","210","292","5","507","1103","0","45.97","19.04"
"63","000","00","120","0004","0000","2885","1356","1529","33","2918","5935","0","49.17","22.85"
"63","000","00","120","0004","1589","613","271","342","5","618","1227","0","50.37","22.09"
"63","000","00","120","0004","1590","556","277","279","11","567","1156","0","49.05","23.96"
"63","000","00","120","0004","1591","588","290","298","7","595","1220","0","48.77","23.77"
"63","000","00","120","0004","1592","577","286","291","4","581","1174","0","49.49","24.36"
"63","000","00","120","0004","1593","551","232","319","6","557","1158","0","48.10","20.03"
"63","000","00","120","0005","0000","2596","1239","1357","32","2628","6019","0","43.66","20.58"
"63","000","00","120","0005","1594","477","185","292","5","482","1256","0","38.38","14.73"
"63","000","00","120","0005","1595","495","250","245","9","504","1244","0","40.51","20.10"
"63","000","00","120","0005","1596","536","218","318","7","543","1181","0","45.98","18.46"
"63","000","00","120","0005","1597","534","277","257","5","539","1135","0","47.49","24.41"
"63","000","00","120","0005","1598","554","309","245","6","560","1203","0","46.55","25.69"
"63","000","00","120","0006","0000","3125","1511","1614","22","3147","6221","0","50.59","24.29"
"63","000","00","120","0006","1599","599","305","294","3","602","1323","0","45.50","23.05"
"63","000","00","120","0006","1600","690","319","371","4","694","1328","0","52.26","24.02"
"63","000","00","120","0006","1601","701","355","346","7","708","1358","0","52.14","26.14"
"63","000","00","120","0006","1602","607","250","357","2","609","1143","0","53.28","21.87"
"63","000","00","120","0006","1603","528","282","246","6","534","1069","0","49.95","26.38"
"63","000","00","120","0007","0000","3049","1469","1580","23","3072","6632","0","46.32","22.15"
"63","000","00","120","0007","1604","640","292","348","3","643","1376","0","46.73","21.22"
"63","000","00","120","0007","1605","567","269","298","4","571","1255","0","45.50","21.43"
"63","000","00","120","0007","1606","618","317","301","9","627","1414","0","44.34","22.42"
"63","000","00","120","0007","1607","649","319","330","4","653","1290","0","50.62","24.73"
"63","000","00","120","0007","1608","575","272","303","3","578","1297","0","44.56","20.97"
"63","000","00","120","0008","0000","2987","1497","1490","20","3007","6389","0","47.07","23.43"
"63","000","00","120","0008","1609","595","333","262","5","600","1231","0","48.74","27.05"
"63","000","00","120","0008","1610","610","287","323","4","614","1349","0","45.52","21.28"
"63","000","00","120","0008","1611","511","277","234","3","514","1200","0","42.83","23.08"
"63","000","00","120","0008","1612","654","279","375","5","659","1331","0","49.51","20.96"
"63","000","00","120","0008","1613","617","321","296","3","620","1278","0","48.51","25.12"
"63","000","00","120","0009","0000","3718","1744","1974","20","3738","7885","0","47.41","22.12"
"63","000","00","120","0009","1614","541","255","286","3","544","1137","0","47.85","22.43"
"63","000","00","120","0009","1615","609","265","344","1","610","1257","0","48.53","21.08"
"63","000","00","120","0009","1616","667","327","340","6","673","1461","0","46.06","22.38"
"63","000","00","120","0009","1617","688","329","359","2","690","1474","0","46.81","22.32"
"63","000","00","120","0009","1618","565","253","312","3","568","1285","0","44.20","19.69"
"63","000","00","120","0009","1619","648","315","333","5","653","1271","0","51.38","24.78"
"63","000","00","120","0010","0000","3254","1683","1571","26","3280","6840","0","47.95","24.61"
"63","000","00","120","0010","1620","608","300","308","8","616","1296","0","47.53","23.15"
"63","000","00","120","0010","1621","628","333","295","2","630","1270","0","49.61","26.22"
"63","000","00","120","0010","1622","666","381","285","3","669","1477","0","45.29","25.80"
"63","000","00","120","0010","1623","709","329","380","11","720","1482","0","48.58","22.20"
"63","000","00","120","0010","1624","643","340","303","2","645","1315","0","49.05","25.86"
"63","000","00","120","0011","0000","1984","994","990","18","2002","4020","0","49.80","24.73"
"63","000","00","120","0011","1625","730","399","331","9","739","1451","0","50.93","27.50"
"63","000","00","120","0011","1626","676","308","368","4","680","1385","0","49.10","22.24"
"63","000","00","120","0011","1627","578","287","291","5","583","1184","0","49.24","24.24"
"63","000","00","120","0012","0000","1893","1006","887","19","1912","3773","0","50.68","26.66"
"63","000","00","120","0012","1628","536","274","262","7","543","1073","0","50.61","25.54"
"63","000","00","120","0012","1629","649","364","285","7","656","1206","0","54.39","30.18"
"63","000","00","120","0012","1630","708","368","340","5","713","1494","0","47.72","24.63"
"63","000","00","120","0013","0000","2590","1370","1220","30","2620","5623","0","46.59","24.36"
"63","000","00","120","0013","1631","591","330","261","5","596","1285","0","46.38","25.68"
"63","000","00","120","0013","1632","422","210","212","3","425","860","0","49.42","24.42"
"63","000","00","120","0013","1633","546","281","265","7","553","1247","0","44.35","22.53"
"63","000","00","120","0013","1634","506","268","238","8","514","1181","0","43.52","22.69"
"63","000","00","120","0013","1635","525","281","244","7","532","1050","0","50.67","26.76"
"63","000","00","120","0014","0000","2001","831","1170","15","2016","4216","0","47.82","19.71"
"63","000","00","120","0014","1636","635","248","387","2","637","1400","0","45.50","17.71"
"63","000","00","120","0014","1637","663","263","400","5","668","1403","0","47.61","18.75"
"63","000","00","120","0014","1638","703","320","383","8","711","1413","0","50.32","22.65"
"63","000","00","120","0015","0000","1839","727","1112","13","1852","3960","0","46.77","18.36"
"63","000","00","120","0015","1639","621","253","368","6","627","1330","0","47.14","19.02"
"63","000","00","120","0015","1640","615","246","369","3","618","1325","0","46.64","18.57"
"63","000","00","120","0015","1641","603","228","375","4","607","1305","0","46.51","17.47"
"63","000","00","120","0016","0000","2094","972","1122","19","2113","4612","0","45.82","21.08"
"63","000","00","120","0016","1642","579","285","294","4","583","1188","0","49.07","23.99"
"63","000","00","120","0016","1643","548","242","306","6","554","1158","0","47.84","20.90"
"63","000","00","120","0016","1644","512","228","284","8","520","1172","0","44.37","19.45"
"63","000","00","120","0016","1645","455","217","238","1","456","1094","0","41.68","19.84"
"63","000","00","120","0017","0000","3619","1663","1956","35","3654","7578","0","48.22","21.95"
"63","000","00","120","0017","1646","568","317","251","4","572","1233","0","46.39","25.71"
"63","000","00","120","0017","1647","615","268","347","6","621","1268","0","48.97","21.14"
"63","000","00","120","0017","1648","642","296","346","10","652","1345","0","48.48","22.01"
"63","000","00","120","0017","1649","578","257","321","4","582","1219","0","47.74","21.08"
"63","000","00","120","0017","1650","637","263","374","7","644","1292","0","49.85","20.36"
"63","000","00","120","0017","1651","579","262","317","4","583","1221","0","47.75","21.46"
"63","000","00","120","0018","0000","2148","985","1163","13","2161","4729","0","45.70","20.83"
"63","000","00","120","0018","1652","591","267","324","1","592","1214","0","48.76","21.99"
"63","000","00","120","0018","1653","456","169","287","5","461","1114","0","41.38","15.17"
"63","000","00","120","0018","1654","466","208","258","2","468","1079","0","43.37","19.28"
"63","000","00","120","0018","1655","635","341","294","5","640","1322","0","48.41","25.79"
"63","000","00","120","0019","0000","934","316","618","7","941","1949","0","48.28","16.21"
"63","000","00","120","0019","1656","451","149","302","3","454","957","0","47.44","15.57"
"63","000","00","120","0019","1657","483","167","316","4","487","992","0","49.09","16.83"
"63","000","00","120","0020","0000","4442","2067","2375","37","4479","9427","0","47.51","21.93"
"63","000","00","120","0020","1658","798","351","447","7","805","1771","0","45.45","19.82"
"63","000","00","120","0020","1659","552","257","295","4","556","1186","0","46.88","21.67"
"63","000","00","120","0020","1660","623","309","314","7","630","1272","0","49.53","24.29"
"63","000","00","120","0020","1661","656","315","341","5","661","1418","0","46.61","22.21"
"63","000","00","120","0020","1662","572","278","294","1","573","1265","0","45.30","21.98"
"63","000","00","120","0020","1663","646","305","341","6","652","1273","0","51.22","23.96"
"63","000","00","120","0020","1664","595","252","343","7","602","1242","0","48.47","20.29"
"63","000","00","120","0021","0000","3373","1536","1837","39","3412","8533","0","39.99","18.00"
"63","000","00","120","0021","1665","427","184","243","3","430","2283","0","18.83","8.06"
"63","000","00","120","0021","1666","597","241","356","7","604","1292","0","46.75","18.65"
"63","000","00","120","0021","1667","743","332","411","11","754","1545","0","48.80","21.49"
"63","000","00","120","0021","1668","598","254","344","11","609","1335","0","45.62","19.03"
"63","000","00","120","0021","1669","493","203","290","3","496","1064","0","46.62","19.08"
"63","000","00","120","0021","1670","515","322","193","4","519","1014","0","51.18","31.76"
"63","000","00","120","0022","0000","3073","1309","1764","29","3102","7167","0","43.28","18.26"
"63","000","00","120","0022","1671","474","237","237","6","480","1163","0","41.27","20.38"
"63","000","00","120","0022","1672","584","240","344","4","588","1265","0","46.48","18.97"
"63","000","00","120","0022","1673","477","208","269","1","478","1052","0","45.44","19.77"
"63","000","00","120","0022","1674","466","189","277","4","470","1097","0","42.84","17.23"
"63","000","00","120","0022","1675","519","216","303","5","524","1265","0","41.42","17.08"
"63","000","00","120","0022","1676","553","219","334","9","562","1325","0","42.42","16.53"
"63","000","00","120","0023","0000","2209","982","1227","21","2230","5324","0","41.89","18.44"
"63","000","00","120","0023","1677","590","242","348","11","601","1350","0","44.52","17.93"
"63","000","00","120","0023","1678","535","238","297","3","538","1246","0","43.18","19.10"
"63","000","00","120","0023","1679","546","243","303","5","551","1293","0","42.61","18.79"
"63","000","00","120","0023","1680","538","259","279","2","540","1435","0","37.63","18.05"
"63","000","00","120","0024","0000","2164","879","1285","25","2189","4700","0","46.57","18.70"
"63","000","00","120","0024","1681","545","217","328","7","552","1300","0","42.46","16.69"
"63","000","00","120","0024","1682","591","220","371","3","594","1275","0","46.59","17.25"
"63","000","00","120","0024","1683","419","173","246","8","427","918","0","46.51","18.85"
"63","000","00","120","0024","1684","609","269","340","7","616","1207","0","51.04","22.29"
"63","000","00","120","0025","0000","2611","1193","1418","22","2633","5643","0","46.66","21.14"
"63","000","00","120","0025","1685","487","192","295","4","491","1084","0","45.30","17.71"
"63","000","00","120","0025","1686","444","190","254","4","448","933","0","48.02","20.36"
"63","000","00","120","0025","1687","566","257","309","8","574","1158","0","49.57","22.19"
"63","000","00","120","0025","1688","541","262","279","2","543","1251","0","43.41","20.94"
"63","000","00","120","0025","1689","573","292","281","4","577","1217","0","47.41","23.99"
"63","000","00","120","0026","0000","1023","534","489","5","1028","2679","0","38.37","19.93"
"63","000","00","120","0026","1690","504","290","214","3","507","1300","0","39.00","22.31"
"63","000","00","120","0026","1691","519","244","275","2","521","1379","0","37.78","17.69"
"63","000","00","120","0027","0000","2350","1159","1191","19","2369","5695","0","41.60","20.35"
"63","000","00","120","0027","1692","478","248","230","2","480","1114","0","43.09","22.26"
"63","000","00","120","0027","1693","501","246","255","5","506","1136","0","44.54","21.65"
"63","000","00","120","0027","1694","458","219","239","6","464","1159","0","40.03","18.90"
"63","000","00","120","0027","1695","430","222","208","3","433","1124","0","38.52","19.75"
"63","000","00","120","0027","1696","483","224","259","3","486","1162","0","41.82","19.28"
"63","000","00","120","0028","0000","1532","671","861","17","1549","3547","0","43.67","18.92"
"63","000","00","120","0028","1697","423","171","252","6","429","970","0","44.23","17.63"
"63","000","00","120","0028","1698","534","246","288","3","537","1280","0","41.95","19.22"
"63","000","00","120","0028","1699","575","254","321","8","583","1297","0","44.95","19.58"
"63","000","00","120","0029","0000","2667","1347","1320","43","2710","5783","0","46.86","23.29"
"63","000","00","120","0029","1700","564","266","298","9","573","1337","0","42.86","19.90"
"63","000","00","120","0029","1701","673","405","268","16","689","1459","0","47.22","27.76"
"63","000","00","120","0029","1702","762","370","392","7","769","1538","0","50.00","24.06"
"63","000","00","120","0029","1703","668","306","362","11","679","1449","0","46.86","21.12"
"63","000","00","120","0030","0000","2073","1024","1049","22","2095","4233","0","49.49","24.19"
"63","000","00","120","0030","1704","504","267","237","8","512","1063","0","48.17","25.12"
"63","000","00","120","0030","1705","718","342","376","8","726","1506","0","48.21","22.71"
"63","000","00","120","0030","1706","851","415","436","6","857","1664","0","51.50","24.94"
"63","000","00","120","0031","0000","2252","1120","1132","17","2269","5189","0","43.73","21.58"
"63","000","00","120","0031","1707","556","285","271","4","560","1297","0","43.18","21.97"
"63","000","00","120","0031","1708","498","230","268","7","505","1225","0","41.22","18.78"
"63","000","00","120","0031","1709","601","289","312","1","602","1308","0","46.02","22.09"
"63","000","00","120","0031","1710","597","316","281","5","602","1359","0","44.30","23.25"
"63","000","00","120","0032","0000","1230","625","605","18","1248","2834","0","44.04","22.05"
"63","000","00","120","0032","1711","553","287","266","10","563","1393","0","40.42","20.60"
"63","000","00","120","0032","1712","677","338","339","8","685","1441","0","47.54","23.46"
"63","000","00","120","0033","0000","1700","1109","591","20","1720","3518","0","48.89","31.52"
"63","000","00","120","0033","1713","548","353","195","3","551","1093","0","50.41","32.30"
"63","000","00","120","0033","1714","504","349","155","7","511","1073","0","47.62","32.53"
"63","000","00","120","0033","1715","648","407","241","10","658","1352","0","48.67","30.10"
"63","000","00","120","0034","0000","1488","735","753","8","1496","3811","0","39.25","19.29"
"63","000","00","120","0034","1716","502","282","220","3","505","1297","0","38.94","21.74"
"63","000","00","120","0034","1717","524","243","281","1","525","1322","0","39.71","18.38"
"63","000","00","120","0034","1718","462","210","252","4","466","1192","0","39.09","17.62"
"63","000","00","120","0035","0000","2063","1144","919","16","2079","4730","0","43.95","24.19"
"63","000","00","120","0035","1719","569","373","196","2","571","1178","0","48.47","31.66"
"63","000","00","120","0035","1720","496","264","232","5","501","1117","0","44.85","23.63"
"63","000","00","120","0035","1724","488","257","231","1","489","1179","0","41.48","21.80"
"63","000","00","120","0035","1725","510","250","260","8","518","1256","0","41.24","19.90"
"63","000","00","120","0036","0000","2391","1029","1362","18","2409","5227","0","46.09","19.69"
"63","000","00","120","0036","1721","515","193","322","7","522","1260","0","41.43","15.32"
"63","000","00","120","0036","1722","596","259","337","3","599","1373","0","43.63","18.86"
"63","000","00","120","0036","1723","616","284","332","5","621","1237","0","50.20","22.96"
"63","000","00","120","0036","1726","664","293","371","3","667","1357","0","49.15","21.59"
"63","000","00","120","0037","0000","2724","1178","1546","32","2756","6316","0","43.64","18.65"
"63","000","00","120","0037","1727","466","148","318","5","471","1120","0","42.05","13.21"
"63","000","00","120","0037","1728","529","204","325","9","538","1260","0","42.70","16.19"
"63","000","00","120","0037","1729","541","265","276","7","548","1301","0","42.12","20.37"
"63","000","00","120","0037","1730","590","272","318","7","597","1288","0","46.35","21.12"
"63","000","00","120","0037","1731","598","289","309","4","602","1347","0","44.69","21.46"
"63","000","00","120","0038","0000","4193","1979","2214","49","4242","9738","0","43.56","20.32"
"63","000","00","120","0038","1732","548","254","294","8","556","1326","0","41.93","19.16"
"63","000","00","120","0038","1733","590","308","282","1","591","1185","0","49.87","25.99"
"63","000","00","120","0038","1734","516","250","266","6","522","1165","0","44.81","21.46"
"63","000","00","120","0038","1735","462","228","234","8","470","1183","0","39.73","19.27"
"63","000","00","120","0038","1736","546","225","321","5","551","1190","0","46.30","18.91"
"63","000","00","120","0038","1737","527","233","294","5","532","1188","0","44.78","19.61"
"63","000","00","120","0038","1738","539","254","285","11","550","1286","0","42.77","19.75"
"63","000","00","120","0038","1739","465","227","238","5","470","1215","0","38.68","18.68"
"63","000","00","120","0039","0000","821","333","488","10","831","2119","0","39.22","15.71"
"63","000","00","120","0039","1740","262","105","157","3","265","534","0","49.63","19.66"
"63","000","00","120","0039","1741","559","228","331","7","566","1585","0","35.71","14.38"
"63","000","00","120","0040","0000","580","253","327","9","589","1446","0","40.73","17.50"
"63","000","00","120","0040","1742","299","122","177","3","302","780","0","38.72","15.64"
"63","000","00","120","0040","1743","281","131","150","6","287","666","0","43.09","19.67"
"63","000","00","120","0041","0000","415","139","276","2","417","1087","0","38.36","12.79"
"63","000","00","120","0041","1744","415","139","276","2","417","1087","0","38.36","12.79"
"63","000","00","120","0042","0000","317","133","184","2","319","826","0","38.62","16.10"
"63","000","00","120","0042","1745","317","133","184","2","319","826","0","38.62","16.10"
"65","000","00","000","0000","0000","1442763","692987","749776","13789","1456552","3427162","4021398","42.50","20.22"
"65","000","00","010","0000","0000","202768","90594","112174","1931","204699","466918","555551","43.84","19.40"
"65","000","00","010","0001","0000","699","388","311","6","705","1395","0","50.54","27.81"
"65","000","00","010","0001","0974","699","388","311","6","705","1395","0","50.54","27.81"
"65","000","00","010","0002","0000","559","253","306","3","562","1228","0","45.77","20.60"
"65","000","00","010","0002","0975","559","253","306","3","562","1228","0","45.77","20.60"
"65","000","00","010","0003","0000","421","208","213","2","423","838","0","50.48","24.82"
"65","000","00","010","0003","0976","421","208","213","2","423","838","0","50.48","24.82"
"65","000","00","010","0004","0000","464","190","274","8","472","1026","0","46.00","18.52"
"65","000","00","010","0004","0977","464","190","274","8","472","1026","0","46.00","18.52"
"65","000","00","010","0005","0000","829","477","352","6","835","1648","0","50.67","28.94"
"65","000","00","010","0005","0978","452","247","205","1","453","926","0","48.92","26.67"
"65","000","00","010","0005","0979","377","230","147","5","382","722","0","52.91","31.86"
"65","000","00","010","0006","0000","1908","902","1006","25","1933","4525","0","42.72","19.93"
"65","000","00","010","0006","0980","564","265","299","7","571","1322","0","43.19","20.05"
"65","000","00","010","0006","0981","421","188","233","7","428","1007","0","42.50","18.67"
"65","000","00","010","0006","0982","426","204","222","7","433","961","0","45.06","21.23"
"65","000","00","010","0006","0983","497","245","252","4","501","1235","0","40.57","19.84"
"65","000","00","010","0007","0000","1139","523","616","12","1151","2846","0","40.44","18.38"
"65","000","00","010","0007","0984","624","287","337","5","629","1503","0","41.85","19.10"
"65","000","00","010","0007","0985","515","236","279","7","522","1343","0","38.87","17.57"
"65","000","00","010","0008","0000","2470","1151","1319","21","2491","8998","0","27.68","12.79"
"65","000","00","010","0008","0986","875","429","446","8","883","5431","0","16.26","7.90"
"65","000","00","010","0008","0987","590","282","308","8","598","1305","0","45.82","21.61"
"65","000","00","010","0008","0988","532","241","291","2","534","1157","0","46.15","20.83"
"65","000","00","010","0008","0989","473","199","274","3","476","1105","0","43.08","18.01"
"65","000","00","010","0009","0000","1734","728","1006","11","1745","3907","0","44.66","18.63"
"65","000","00","010","0009","0990","670","275","395","5","675","1519","0","44.44","18.10"
"65","000","00","010","0009","0991","465","192","273","5","470","1105","0","42.53","17.38"
"65","000","00","010","0009","0992","599","261","338","1","600","1283","0","46.77","20.34"
"65","000","00","010","0010","0000","1873","827","1046","16","1889","4691","0","40.27","17.63"
"65","000","00","010","0010","0995","826","363","463","7","833","2219","0","37.54","16.36"
"65","000","00","010","0010","0996","506","231","275","5","511","1273","0","40.14","18.15"
"65","000","00","010","0010","0997","541","233","308","4","545","1199","0","45.45","19.43"
"65","000","00","010","0011","0000","2329","1268","1061","23","2352","4425","0","53.15","28.66"
"65","000","00","010","0011","0998","592","335","257","5","597","1091","0","54.72","30.71"
"65","000","00","010","0011","0999","576","302","274","14","590","1059","0","55.71","28.52"
"65","000","00","010","0011","1000","622","313","309","4","626","1200","0","52.17","26.08"
"65","000","00","010","0011","1001","539","318","221","0","539","1075","0","50.14","29.58"
"65","000","00","010","0012","0000","1154","468","686","6","1160","2471","0","46.94","18.94"
"65","000","00","010","0012","1002","595","248","347","4","599","1253","0","47.81","19.79"
"65","000","00","010","0012","1003","559","220","339","2","561","1218","0","46.06","18.06"
"65","000","00","010","0013","0000","1103","560","543","11","1114","2357","0","47.26","23.76"
"65","000","00","010","0013","1004","489","208","281","5","494","1117","0","44.23","18.62"
"65","000","00","010","0013","1005","614","352","262","6","620","1240","0","50.00","28.39"
"65","000","00","010","0014","0000","1792","1238","554","16","1808","3349","0","53.99","36.97"
"65","000","00","010","0014","1008","749","552","197","7","756","1332","0","56.76","41.44"
"65","000","00","010","0014","1009","552","425","127","8","560","977","0","57.32","43.50"
"65","000","00","010","0014","1010","491","261","230","1","492","1040","0","47.31","25.10"
"65","000","00","010","0015","0000","1225","590","635","10","1235","2463","0","50.14","23.95"
"65","000","00","010","0015","1011","563","257","306","6","569","1231","0","46.22","20.88"
"65","000","00","010","0015","1012","662","333","329","4","666","1232","0","54.06","27.03"
"65","000","00","010","0016","0000","1456","620","836","14","1470","3446","0","42.66","17.99"
"65","000","00","010","0016","1016","440","188","252","3","443","1041","0","42.56","18.06"
"65","000","00","010","0016","1017","477","203","274","5","482","1169","0","41.23","17.37"
"65","000","00","010","0016","1018","539","229","310","6","545","1236","0","44.09","18.53"
"65","000","00","010","0017","0000","1695","688","1007","17","1712","4107","0","41.68","16.75"
"65","000","00","010","0017","1019","462","187","275","4","466","1149","0","40.56","16.28"
"65","000","00","010","0017","1020","375","149","226","6","381","983","0","38.76","15.16"
"65","000","00","010","0017","1021","325","122","203","3","328","795","0","41.26","15.35"
"65","000","00","010","0017","1022","533","230","303","4","537","1180","0","45.51","19.49"
"65","000","00","010","0018","0000","1139","570","569","12","1151","2304","0","49.96","24.74"
"65","000","00","010","0018","1023","569","280","289","5","574","1106","0","51.90","25.32"
"65","000","00","010","0018","1024","570","290","280","7","577","1198","0","48.16","24.21"
"65","000","00","010","0019","0000","1420","575","845","23","1443","3109","0","46.41","18.49"
"65","000","00","010","0019","1027","459","180","279","3","462","999","0","46.25","18.02"
"65","000","00","010","0019","1028","420","180","240","14","434","976","0","44.47","18.44"
"65","000","00","010","0019","1029","541","215","326","6","547","1134","0","48.24","18.96"
"65","000","00","010","0020","0000","1793","839","954","18","1811","3542","0","51.13","23.69"
"65","000","00","010","0020","1030","577","308","269","6","583","1124","0","51.87","27.40"
"65","000","00","010","0020","1031","596","255","341","9","605","1177","0","51.40","21.67"
"65","000","00","010","0020","1032","620","276","344","3","623","1241","0","50.20","22.24"
"65","000","00","010","0021","0000","1466","588","878","12","1478","3318","0","44.54","17.72"
"65","000","00","010","0021","1033","488","204","284","2","490","1048","0","46.76","19.47"
"65","000","00","010","0021","1034","593","228","365","3","596","1280","0","46.56","17.81"
"65","000","00","010","0021","1035","385","156","229","7","392","990","0","39.60","15.76"
"65","000","00","010","0022","0000","1661","772","889","19","1680","3648","0","46.05","21.16"
"65","000","00","010","0022","1036","505","247","258","7","512","1103","0","46.42","22.39"
"65","000","00","010","0022","1037","566","247","319","3","569","1266","0","44.94","19.51"
"65","000","00","010","0022","1038","590","278","312","9","599","1279","0","46.83","21.74"
"65","000","00","010","0023","0000","1403","579","824","13","1416","3487","0","40.61","16.60"
"65","000","00","010","0023","1039","479","192","287","9","488","1158","0","42.14","16.58"
"65","000","00","010","0023","1040","524","221","303","2","526","1235","0","42.59","17.89"
"65","000","00","010","0023","1041","400","166","234","2","402","1094","0","36.75","15.17"
"65","000","00","010","0024","0000","1862","1255","607","15","1877","3605","0","52.07","34.81"
"65","000","00","010","0024","1044","558","359","199","6","564","1094","0","51.55","32.82"
"65","000","00","010","0024","1045","757","581","176","4","761","1407","0","54.09","41.29"
"65","000","00","010","0024","1046","547","315","232","5","552","1104","0","50.00","28.53"
"65","000","00","010","0025","0000","1035","465","570","10","1045","2364","0","44.20","19.67"
"65","000","00","010","0025","1049","576","278","298","5","581","1280","0","45.39","21.72"
"65","000","00","010","0025","1050","459","187","272","5","464","1084","0","42.80","17.25"
"65","000","00","010","0026","0000","1075","513","562","15","1090","2555","0","42.66","20.08"
"65","000","00","010","0026","1051","516","250","266","10","526","1280","0","41.09","19.53"
"65","000","00","010","0026","1052","559","263","296","5","564","1275","0","44.24","20.63"
"65","000","00","010","0027","0000","932","367","565","8","940","1865","0","50.40","19.68"
"65","000","00","010","0027","1053","429","163","266","4","433","847","0","51.12","19.24"
"65","000","00","010","0027","1054","503","204","299","4","507","1018","0","49.80","20.04"
"65","000","00","010","0028","0000","2820","1289","1531","20","2840","6159","0","46.11","20.93"
"65","000","00","010","0028","1055","715","327","388","3","718","1626","0","44.16","20.11"
"65","000","00","010","0028","1056","609","261","348","2","611","1285","0","47.55","20.31"
"65","000","00","010","0028","1057","782","335","447","10","792","1678","0","47.20","19.96"
"65","000","00","010","0028","1058","714","366","348","5","719","1570","0","45.80","23.31"
"65","000","00","010","0029","0000","1926","731","1195","17","1943","4582","0","42.41","15.95"
"65","000","00","010","0029","1059","699","266","433","6","705","1580","0","44.62","16.84"
"65","000","00","010","0029","1060","517","205","312","6","523","1255","0","41.67","16.33"
"65","000","00","010","0029","1061","710","260","450","5","715","1747","0","40.93","14.88"
"65","000","00","010","0030","0000","1986","784","1202","9","1995","4774","0","41.79","16.42"
"65","000","00","010","0030","1062","681","281","400","2","683","1576","0","43.34","17.83"
"65","000","00","010","0030","1063","674","263","411","3","677","1611","0","42.02","16.33"
"65","000","00","010","0030","1064","631","240","391","4","635","1587","0","40.01","15.12"
"65","000","00","010","0031","0000","2431","985","1446","14","2445","5675","0","43.08","17.36"
"65","000","00","010","0031","1065","451","175","276","5","456","1051","0","43.39","16.65"
"65","000","00","010","0031","1066","971","455","516","2","973","2203","0","44.17","20.65"
"65","000","00","010","0031","1067","390","140","250","5","395","1046","0","37.76","13.38"
"65","000","00","010","0031","1068","619","215","404","2","621","1375","0","45.16","15.64"
"65","000","00","010","0032","0000","1456","716","740","11","1467","3287","0","44.63","21.78"
"65","000","00","010","0032","1069","753","419","334","3","756","1671","0","45.24","25.07"
"65","000","00","010","0032","1070","703","297","406","8","711","1616","0","44.00","18.38"
"65","000","00","010","0033","0000","1987","917","1070","15","2002","4715","0","42.46","19.45"
"65","000","00","010","0033","1073","724","306","418","9","733","1735","0","42.25","17.64"
"65","000","00","010","0033","1074","556","213","343","2","558","1238","0","45.07","17.21"
"65","000","00","010","0033","1075","707","398","309","4","711","1742","0","40.82","22.85"
"65","000","00","010","0034","0000","1125","386","739","15","1140","2555","0","44.62","15.11"
"65","000","00","010","0034","1076","601","205","396","8","609","1351","0","45.08","15.17"
"65","000","00","010","0034","1077","524","181","343","7","531","1204","0","44.10","15.03"
"65","000","00","010","0035","0000","3171","1305","1866","19","3190","7107","0","44.89","18.36"
"65","000","00","010","0035","1078","762","219","543","5","767","1719","0","44.62","12.74"
"65","000","00","010","0035","1079","700","273","427","3","703","1678","0","41.90","16.27"
"65","000","00","010","0035","1080","837","407","430","5","842","1830","0","46.01","22.24"
"65","000","00","010","0035","1081","872","406","466","6","878","1880","0","46.70","21.60"
"65","000","00","010","0036","0000","1499","574","925","13","1512","3275","0","46.17","17.53"
"65","000","00","010","0036","1085","519","179","340","5","524","1100","0","47.64","16.27"
"65","000","00","010","0036","1086","500","194","306","5","505","1137","0","44.42","17.06"
"65","000","00","010","0036","1087","480","201","279","3","483","1038","0","46.53","19.36"
"65","000","00","010","0037","0000","2755","1303","1452","32","2787","6174","0","45.14","21.10"
"65","000","00","010","0037","1088","624","261","363","7","631","1601","0","39.41","16.30"
"65","000","00","010","0037","1089","683","301","382","3","686","1597","0","42.96","18.85"
"65","000","00","010","0037","1090","684","354","330","11","695","1462","0","47.54","24.21"
"65","000","00","010","0037","1091","764","387","377","11","775","1514","0","51.19","25.56"
"65","000","00","010","0038","0000","1123","384","739","14","1137","2666","0","42.65","14.40"
"65","000","00","010","0038","1095","328","117","211","8","336","818","0","41.08","14.30"
"65","000","00","010","0038","1096","369","119","250","2","371","819","0","45.30","14.53"
"65","000","00","010","0038","1097","426","148","278","4","430","1029","0","41.79","14.38"
"65","000","00","010","0039","0000","1829","744","1085","14","1843","4242","0","43.45","17.54"
"65","000","00","010","0039","1098","389","155","234","2","391","949","0","41.20","16.33"
"65","000","00","010","0039","1099","425","182","243","1","426","1051","0","40.53","17.32"
"65","000","00","010","0039","1100","399","165","234","7","406","985","0","41.22","16.75"
"65","000","00","010","0039","1101","616","242","374","4","620","1257","0","49.32","19.25"
"65","000","00","010","0040","0000","1298","504","794","10","1308","2962","0","44.16","17.02"
"65","000","00","010","0040","1102","561","204","357","5","566","1343","0","42.14","15.19"
"65","000","00","010","0040","1103","737","300","437","5","742","1619","0","45.83","18.53"
"65","000","00","010","0041","0000","1776","745","1031","20","1796","4168","0","43.09","17.87"
"65","000","00","010","0041","1104","484","198","286","6","490","1164","0","42.10","17.01"
"65","000","00","010","0041","1105","621","270","351","5","626","1372","0","45.63","19.68"
"65","000","00","010","0041","1106","671","277","394","9","680","1632","0","41.67","16.97"
"65","000","00","010","0042","0000","1900","759","1141","19","1919","4391","0","43.70","17.29"
"65","000","00","010","0042","1107","622","234","388","6","628","1451","0","43.28","16.13"
"65","000","00","010","0042","1108","615","229","386","6","621","1462","0","42.48","15.66"
"65","000","00","010","0042","1109","663","296","367","7","670","1478","0","45.33","20.03"
"65","000","00","010","0043","0000","1421","571","850","23","1444","3044","0","47.44","18.76"
"65","000","00","010","0043","1112","723","274","449","12","735","1579","0","46.55","17.35"
"65","000","00","010","0043","1113","698","297","401","11","709","1465","0","48.40","20.27"
"65","000","00","010","0044","0000","4151","1937","2214","42","4193","9043","0","46.37","21.42"
"65","000","00","010","0044","1116","729","348","381","6","735","1597","0","46.02","21.79"
"65","000","00","010","0044","1117","694","268","426","14","708","1434","0","49.37","18.69"
"65","000","00","010","0044","1118","752","373","379","4","756","1661","0","45.51","22.46"
"65","000","00","010","0044","1119","729","349","380","6","735","1583","0","46.43","22.05"
"65","000","00","010","0044","1120","605","294","311","5","610","1403","0","43.48","20.96"
"65","000","00","010","0044","1121","642","305","337","7","649","1365","0","47.55","22.34"
"65","000","00","010","0045","0000","922","329","593","6","928","2150","0","43.16","15.30"
"65","000","00","010","0045","1122","460","157","303","5","465","1076","0","43.22","14.59"
"65","000","00","010","0045","1123","462","172","290","1","463","1074","0","43.11","16.01"
"65","000","00","010","0046","0000","1562","657","905","10","1572","3515","0","44.72","18.69"
"65","000","00","010","0046","1126","579","240","339","3","582","1245","0","46.75","19.28"
"65","000","00","010","0046","1127","442","188","254","3","445","1011","0","44.02","18.60"
"65","000","00","010","0046","1128","541","229","312","4","545","1259","0","43.29","18.19"
"65","000","00","010","0047","0000","1119","431","688","12","1131","2638","0","42.87","16.34"
"65","000","00","010","0047","1129","503","203","300","3","506","1235","0","40.97","16.44"
"65","000","00","010","0047","1130","616","228","388","9","625","1403","0","44.55","16.25"
"65","000","00","010","0048","0000","2085","800","1285","10","2095","5414","0","38.70","14.78"
"65","000","00","010","0048","1131","607","237","370","4","611","1703","0","35.88","13.92"
"65","000","00","010","0048","1132","712","257","455","4","716","1874","0","38.21","13.71"
"65","000","00","010","0048","1133","766","306","460","2","768","1837","0","41.81","16.66"
"65","000","00","010","0049","0000","534","248","286","5","539","1221","0","44.14","20.31"
"65","000","00","010","0049","1134","534","248","286","5","539","1221","0","44.14","20.31"
"65","000","00","010","0050","0000","2284","962","1322","20","2304","5318","0","43.32","18.09"
"65","000","00","010","0050","1135","649","279","370","4","653","1533","0","42.60","18.20"
"65","000","00","010","0050","1136","538","233","305","7","545","1222","0","44.60","19.07"
"65","000","00","010","0050","1137","534","226","308","8","542","1337","0","40.54","16.90"
"65","000","00","010","0050","1138","563","224","339","1","564","1226","0","46.00","18.27"
"65","000","00","010","0051","0000","1803","764","1039","13","1816","3920","0","46.33","19.49"
"65","000","00","010","0051","1139","707","297","410","5","712","1489","0","47.82","19.95"
"65","000","00","010","0051","1140","453","182","271","2","455","926","0","49.14","19.65"
"65","000","00","010","0051","1141","643","285","358","6","649","1505","0","43.12","18.94"
"65","000","00","010","0052","0000","1676","650","1026","24","1700","3731","0","45.56","17.42"
"65","000","00","010","0052","1142","403","126","277","5","408","907","0","44.98","13.89"
"65","000","00","010","0052","1143","551","229","322","4","555","1187","0","46.76","19.29"
"65","000","00","010","0052","1144","722","295","427","15","737","1637","0","45.02","18.02"
"65","000","00","010","0053","0000","1284","535","749","10","1294","2939","0","44.03","18.20"
"65","000","00","010","0053","1145","654","282","372","7","661","1435","0","46.06","19.65"
"65","000","00","010","0053","1146","630","253","377","3","633","1504","0","42.09","16.82"
"65","000","00","010","0054","0000","2384","1015","1369","23","2407","5578","0","43.15","18.20"
"65","000","00","010","0054","1147","591","268","323","8","599","1539","0","38.92","17.41"
"65","000","00","010","0054","1148","860","355","505","4","864","1872","0","46.15","18.96"
"65","000","00","010","0054","1149","687","307","380","8","695","1626","0","42.74","18.88"
"65","000","00","010","0054","1150","246","85","161","3","249","541","0","46.03","15.71"
"65","000","00","010","0055","0000","1188","480","708","14","1202","2572","0","46.73","18.66"
"65","000","00","010","0055","1153","668","280","388","5","673","1465","0","45.94","19.11"
"65","000","00","010","0055","1154","520","200","320","9","529","1107","0","47.79","18.07"
"65","000","00","010","0056","0000","1309","663","646","16","1325","2920","0","45.38","22.71"
"65","000","00","010","0056","1155","654","366","288","7","661","1382","0","47.83","26.48"
"65","000","00","010","0056","1156","655","297","358","9","664","1538","0","43.17","19.31"
"65","000","00","010","0057","0000","2939","1305","1634","23","2962","6417","0","46.16","20.34"
"65","000","00","010","0057","1159","476","193","283","4","480","1110","0","43.24","17.39"
"65","000","00","010","0057","1160","522","230","292","3","525","1169","0","44.91","19.67"
"65","000","00","010","0057","1161","509","182","327","6","515","1221","0","42.18","14.91"
"65","000","00","010","0057","1162","352","140","212","2","354","860","0","41.16","16.28"
"65","000","00","010","0057","1163","1080","560","520","8","1088","2057","0","52.89","27.22"
"65","000","00","010","0058","0000","1080","395","685","13","1093","2522","0","43.34","15.66"
"65","000","00","010","0058","1164","612","219","393","6","618","1441","0","42.89","15.20"
"65","000","00","010","0058","1165","468","176","292","7","475","1081","0","43.94","16.28"
"65","000","00","010","0059","0000","1875","775","1100","24","1899","4586","0","41.41","16.90"
"65","000","00","010","0059","1168","800","377","423","11","811","1920","0","42.24","19.64"
"65","000","00","010","0059","1169","505","179","326","7","512","1299","0","39.41","13.78"
"65","000","00","010","0059","1170","570","219","351","6","576","1367","0","42.14","16.02"
"65","000","00","010","0060","0000","1121","490","631","15","1136","2444","0","46.48","20.05"
"65","000","00","010","0060","1171","567","257","310","8","575","1272","0","45.20","20.20"
"65","000","00","010","0060","1172","554","233","321","7","561","1172","0","47.87","19.88"
"65","000","00","010","0061","0000","1792","736","1056","14","1806","3765","0","47.97","19.55"
"65","000","00","010","0061","1173","546","213","333","4","550","1210","0","45.45","17.60"
"65","000","00","010","0061","1174","589","232","357","4","593","1284","0","46.18","18.07"
"65","000","00","010","0061","1175","657","291","366","6","663","1271","0","52.16","22.90"
"65","000","00","010","0062","0000","1327","512","815","11","1338","3069","0","43.60","16.68"
"65","000","00","010","0062","1178","586","232","354","6","592","1417","0","41.78","16.37"
"65","000","00","010","0062","1179","741","280","461","5","746","1652","0","45.16","16.95"
"65","000","00","010","0063","0000","1579","653","926","16","1595","3525","0","45.25","18.52"
"65","000","00","010","0063","1180","784","315","469","7","791","1759","0","44.97","17.91"
"65","000","00","010","0063","1181","795","338","457","9","804","1766","0","45.53","19.14"
"65","000","00","010","0064","0000","1219","522","697","17","1236","3031","0","40.78","17.22"
"65","000","00","010","0064","1182","315","151","164","4","319","866","0","36.84","17.44"
"65","000","00","010","0064","1183","407","181","226","9","416","1055","0","39.43","17.16"
"65","000","00","010","0064","1184","497","190","307","4","501","1110","0","45.14","17.12"
"65","000","00","010","0065","0000","3215","1604","1611","36","3251","7123","0","45.64","22.52"
"65","000","00","010","0065","1185","733","386","347","12","745","1713","0","43.49","22.53"
"65","000","00","010","0065","1186","855","369","486","8","863","1836","0","47.00","20.10"
"65","000","00","010","0065","1187","750","389","361","7","757","1721","0","43.99","22.60"
"65","000","00","010","0065","1188","877","460","417","9","886","1853","0","47.81","24.82"
"65","000","00","010","0066","0000","1345","565","780","6","1351","3179","0","42.50","17.77"
"65","000","00","010","0066","1189","431","189","242","1","432","1016","0","42.52","18.60"
"65","000","00","010","0066","1190","463","173","290","2","465","1056","0","44.03","16.38"
"65","000","00","010","0066","1191","451","203","248","3","454","1107","0","41.01","18.34"
"65","000","00","010","0067","0000","1018","440","578","8","1026","2350","0","43.66","18.72"
"65","000","00","010","0067","1192","501","206","295","4","505","1193","0","42.33","17.27"
"65","000","00","010","0067","1193","517","234","283","4","521","1157","0","45.03","20.22"
"65","000","00","010","0068","0000","1766","687","1079","20","1786","3895","0","45.85","17.64"
"65","000","00","010","0068","1194","543","204","339","6","549","1202","0","45.67","16.97"
"65","000","00","010","0068","1195","673","298","375","8","681","1442","0","47.23","20.67"
"65","000","00","010","0068","1196","550","185","365","6","556","1251","0","44.44","14.79"
"65","000","00","010","0069","0000","1747","673","1074","19","1766","3802","0","46.45","17.70"
"65","000","00","010","0069","1199","721","226","495","9","730","1581","0","46.17","14.29"
"65","000","00","010","0069","1200","555","238","317","4","559","1159","0","48.23","20.53"
"65","000","00","010","0069","1201","471","209","262","6","477","1062","0","44.92","19.68"
"65","000","00","010","0070","0000","2003","1050","953","19","2022","4141","0","48.83","25.36"
"65","000","00","010","0070","1204","741","364","377","8","749","1450","0","51.66","25.10"
"65","000","00","010","0070","1205","671","367","304","4","675","1381","0","48.88","26.57"
"65","000","00","010","0070","1206","591","319","272","7","598","1310","0","45.65","24.35"
"65","000","00","010","0071","0000","1465","775","690","12","1477","3382","0","43.67","22.92"
"65","000","00","010","0071","1207","775","413","362","5","780","1824","0","42.76","22.64"
"65","000","00","010","0071","1208","690","362","328","7","697","1558","0","44.74","23.23"
"65","000","00","010","0072","0000","1758","803","955","17","1775","3878","0","45.77","20.71"
"65","000","00","010","0072","1209","631","309","322","6","637","1477","0","43.13","20.92"
"65","000","00","010","0072","1210","617","278","339","5","622","1314","0","47.34","21.16"
"65","000","00","010","0072","1211","510","216","294","6","516","1087","0","47.47","19.87"
"65","000","00","010","0073","0000","1425","698","727","31","1456","3111","0","46.80","22.44"
"65","000","00","010","0073","1212","583","312","271","19","602","1383","0","43.53","22.56"
"65","000","00","010","0073","1213","842","386","456","12","854","1728","0","49.42","22.34"
"65","000","00","010","0074","0000","2033","903","1130","13","2046","4371","0","46.81","20.66"
"65","000","00","010","0074","1216","545","237","308","4","549","1178","0","46.60","20.12"
"65","000","00","010","0074","1217","707","329","378","3","710","1384","0","51.30","23.77"
"65","000","00","010","0074","1218","781","337","444","6","787","1809","0","43.50","18.63"
"65","000","00","010","0075","0000","1284","620","664","18","1302","3021","0","43.10","20.52"
"65","000","00","010","0075","1219","653","328","325","12","665","1528","0","43.52","21.47"
"65","000","00","010","0075","1220","631","292","339","6","637","1493","0","42.67","19.56"
"65","000","00","010","0076","0000","1511","697","814","8","1519","3064","0","49.58","22.75"
"65","000","00","010","0076","1221","777","355","422","4","781","1517","0","51.48","23.40"
"65","000","00","010","0076","1222","734","342","392","4","738","1547","0","47.71","22.11"
"65","000","00","010","0077","0000","1554","754","800","23","1577","3320","0","47.50","22.71"
"65","000","00","010","0077","1223","929","470","459","15","944","2020","0","46.73","23.27"
"65","000","00","010","0077","1224","625","284","341","8","633","1300","0","48.69","21.85"
"65","000","00","010","0078","0000","2628","1248","1380","22","2650","5909","0","44.85","21.12"
"65","000","00","010","0078","1225","793","390","403","7","800","1602","0","49.94","24.34"
"65","000","00","010","0078","1226","610","295","315","6","616","1482","0","41.57","19.91"
"65","000","00","010","0078","1227","608","288","320","4","612","1359","0","45.03","21.19"
"65","000","00","010","0078","1228","617","275","342","5","622","1466","0","42.43","18.76"
"65","000","00","010","0079","0000","1804","908","896","10","1814","4094","0","44.31","22.18"
"65","000","00","010","0079","1229","579","301","278","0","579","1426","0","40.60","21.11"
"65","000","00","010","0079","1230","621","321","300","6","627","1285","0","48.79","24.98"
"65","000","00","010","0079","1231","604","286","318","4","608","1383","0","43.96","20.68"
"65","000","00","010","0080","0000","3112","1501","1611","33","3145","7469","0","42.11","20.10"
"65","000","00","010","0080","1232","599","268","331","8","607","1527","0","39.75","17.55"
"65","000","00","010","0080","1233","612","289","323","3","615","1488","0","41.33","19.42"
"65","000","00","010","0080","1234","627","306","321","7","634","1488","0","42.61","20.56"
"65","000","00","010","0080","1235","621","307","314","6","627","1377","0","45.53","22.29"
"65","000","00","010","0080","1236","653","331","322","9","662","1589","0","41.66","20.83"
"65","000","00","010","0081","0000","1237","699","538","10","1247","2702","0","46.15","25.87"
"65","000","00","010","0081","1237","430","285","145","6","436","871","0","50.06","32.72"
"65","000","00","010","0081","1238","401","207","194","1","402","895","0","44.92","23.13"
"65","000","00","010","0081","1239","406","207","199","3","409","936","0","43.70","22.12"
"65","000","00","010","0082","0000","1403","769","634","12","1415","3281","0","43.13","23.44"
"65","000","00","010","0082","1240","798","454","344","6","804","1785","0","45.04","25.43"
"65","000","00","010","0082","1241","605","315","290","6","611","1496","0","40.84","21.06"
"65","000","00","010","0083","0000","1335","597","738","17","1352","3505","0","38.57","17.03"
"65","000","00","010","0083","1242","700","294","406","6","706","1743","0","40.50","16.87"
"65","000","00","010","0083","1243","635","303","332","11","646","1762","0","36.66","17.20"
"65","000","00","010","0084","0000","1708","794","914","16","1724","3734","0","46.17","21.26"
"65","000","00","010","0084","1247","577","259","318","3","580","1307","0","44.38","19.82"
"65","000","00","010","0084","1248","475","204","271","4","479","1112","0","43.08","18.35"
"65","000","00","010","0084","1249","656","331","325","9","665","1315","0","50.57","25.17"
"65","000","00","010","0085","0000","1037","435","602","12","1049","2257","0","46.48","19.27"
"65","000","00","010","0085","1250","520","226","294","6","526","1047","0","50.24","21.59"
"65","000","00","010","0085","1251","517","209","308","6","523","1210","0","43.22","17.27"
"65","000","00","010","0086","0000","2448","1169","1279","25","2473","6150","0","40.21","19.01"
"65","000","00","010","0086","1254","640","287","353","8","648","1816","0","35.68","15.80"
"65","000","00","010","0086","1255","405","172","233","4","409","961","0","42.56","17.90"
"65","000","00","010","0086","1256","712","327","385","6","718","1737","0","41.34","18.83"
"65","000","00","010","0086","1257","691","383","308","7","698","1636","0","42.67","23.41"
"65","000","00","010","0087","0000","3348","1772","1576","25","3373","6979","0","48.33","25.39"
"65","000","00","010","0087","1258","568","332","236","4","572","1139","0","50.22","29.15"
"65","000","00","010","0087","1259","726","372","354","8","734","1431","0","51.29","26.00"
"65","000","00","010","0087","1260","603","339","264","3","606","1356","0","44.69","25.00"
"65","000","00","010","0087","1261","686","318","368","5","691","1595","0","43.32","19.94"
"65","000","00","010","0087","1262","765","411","354","5","770","1458","0","52.81","28.19"
"65","000","00","010","0088","0000","1598","744","854","15","1613","3812","0","42.31","19.52"
"65","000","00","010","0088","1263","542","257","285","3","545","1346","0","40.49","19.09"
"65","000","00","010","0088","1264","484","230","254","8","492","1082","0","45.47","21.26"
"65","000","00","010","0088","1265","572","257","315","4","576","1384","0","41.62","18.57"
"65","000","00","010","0089","0000","1352","507","845","14","1366","3334","0","40.97","15.21"
"65","000","00","010","0089","1266","496","187","309","5","501","1218","0","41.13","15.35"
"65","000","00","010","0089","1267","407","160","247","6","413","1110","0","37.21","14.41"
"65","000","00","010","0089","1268","449","160","289","3","452","1006","0","44.93","15.90"
"65","000","00","010","0090","0000","1923","749","1174","15","1938","4625","0","41.90","16.19"
"65","000","00","010","0090","1269","607","239","368","5","612","1391","0","44.00","17.18"
"65","000","00","010","0090","1270","658","264","394","6","664","1542","0","43.06","17.12"
"65","000","00","010","0090","1271","658","246","412","4","662","1692","0","39.13","14.54"
"65","000","00","010","0091","0000","1437","557","880","8","1445","3700","0","39.05","15.05"
"65","000","00","010","0091","1272","451","181","270","4","455","1108","0","41.06","16.34"
"65","000","00","010","0091","1273","397","150","247","2","399","1087","0","36.71","13.80"
"65","000","00","010","0091","1274","589","226","363","2","591","1505","0","39.27","15.02"
"65","000","00","010","0092","0000","2506","1240","1266","19","2525","6074","0","41.57","20.41"
"65","000","00","010","0092","1278","438","172","266","6","444","1069","0","41.53","16.09"
"65","000","00","010","0092","1279","404","173","231","2","406","1003","0","40.48","17.25"
"65","000","00","010","0092","1280","422","197","225","4","426","1085","0","39.26","18.16"
"65","000","00","010","0092","1281","505","292","213","3","508","1216","0","41.78","24.01"
"65","000","00","010","0092","1282","737","406","331","4","741","1701","0","43.56","23.87"
"65","000","00","010","0093","0000","430","242","188","9","439","873","0","50.29","27.72"
"65","000","00","010","0093","1283","193","148","45","5","198","382","0","51.83","38.74"
"65","000","00","010","0093","1284","237","94","143","4","241","491","0","49.08","19.14"
"65","000","00","010","0094","0000","1472","634","838","12","1484","3466","0","42.82","18.29"
"65","000","00","010","0094","1285","466","193","273","3","469","1171","0","40.05","16.48"
"65","000","00","010","0094","1286","537","232","305","5","542","1184","0","45.78","19.59"
"65","000","00","010","0094","1287","469","209","260","4","473","1111","0","42.57","18.81"
"65","000","00","010","0095","0000","2638","1335","1303","27","2665","6234","0","42.75","21.41"
"65","000","00","010","0095","1288","425","245","180","6","431","966","0","44.62","25.36"
"65","000","00","010","0095","1289","472","169","303","5","477","1178","0","40.49","14.35"
"65","000","00","010","0095","1290","800","418","382","13","813","1919","0","42.37","21.78"
"65","000","00","010","0095","1291","941","503","438","3","944","2171","0","43.48","23.17"
"65","000","00","010","0096","0000","1785","725","1060","14","1799","4615","0","38.98","15.71"
"65","000","00","010","0096","1292","268","106","162","2","270","725","0","37.24","14.62"
"65","000","00","010","0096","1293","491","201","290","6","497","1306","0","38.06","15.39"
"65","000","00","010","0096","1294","473","212","261","1","474","1259","0","37.65","16.84"
"65","000","00","010","0096","1295","553","206","347","5","558","1325","0","42.11","15.55"
"65","000","00","010","0097","0000","1068","424","644","19","1087","2464","0","44.12","17.21"
"65","000","00","010","0097","1296","507","200","307","9","516","1161","0","44.44","17.23"
"65","000","00","010","0097","1297","561","224","337","10","571","1303","0","43.82","17.19"
"65","000","00","010","0098","0000","3333","1488","1845","35","3368","8523","0","39.52","17.46"
"65","000","00","010","0098","1298","491","208","283","8","499","1302","0","38.33","15.98"
"65","000","00","010","0098","1299","558","241","317","5","563","1449","0","38.85","16.63"
"65","000","00","010","0098","1300","522","225","297","3","525","1428","0","36.76","15.76"
"65","000","00","010","0098","1301","528","268","260","6","534","1493","0","35.77","17.95"
"65","000","00","010","0098","1302","653","288","365","5","658","1492","0","44.10","19.30"
"65","000","00","010","0098","1303","581","258","323","8","589","1359","0","43.34","18.98"
"65","000","00","010","0099","0000","2014","837","1177","22","2036","5148","0","39.55","16.26"
"65","000","00","010","0099","1308","669","279","390","9","678","1647","0","41.17","16.94"
"65","000","00","010","0099","1309","745","321","424","3","748","1803","0","41.49","17.80"
"65","000","00","010","0099","1310","600","237","363","10","610","1698","0","35.92","13.96"
"65","000","00","010","0100","0000","1293","565","728","14","1307","3079","0","42.45","18.35"
"65","000","00","010","0100","1319","621","271","350","7","628","1509","0","41.62","17.96"
"65","000","00","010","0100","1320","672","294","378","7","679","1570","0","43.25","18.73"
"65","000","00","010","0101","0000","1027","465","562","9","1036","2397","0","43.22","19.40"
"65","000","00","010","0101","0993","416","181","235","2","418","1000","0","41.80","18.10"
"65","000","00","010","0101","0994","611","284","327","7","618","1397","0","44.24","20.33"
"65","000","00","010","0102","0000","1656","691","965","14","1670","3742","0","44.63","18.47"
"65","000","00","010","0102","1013","485","206","279","5","490","1193","0","41.07","17.27"
"65","000","00","010","0102","1014","627","253","374","6","633","1380","0","45.87","18.33"
"65","000","00","010","0102","1015","544","232","312","3","547","1169","0","46.79","19.85"
"65","000","00","010","0103","0000","1191","554","637","5","1196","2692","0","44.43","20.58"
"65","000","00","010","0103","1042","663","308","355","4","667","1508","0","44.23","20.42"
"65","000","00","010","0103","1043","528","246","282","1","529","1184","0","44.68","20.78"
"65","000","00","010","0104","0000","1329","519","810","13","1342","2948","0","45.52","17.61"
"65","000","00","010","0104","1071","652","249","403","8","660","1482","0","44.53","16.80"
"65","000","00","010","0104","1072","677","270","407","5","682","1466","0","46.52","18.42"
"65","000","00","010","0105","0000","1289","516","773","9","1298","3027","0","42.88","17.05"
"65","000","00","010","0105","1092","414","159","255","4","418","1020","0","40.98","15.59"
"65","000","00","010","0105","1093","396","150","246","2","398","938","0","42.43","15.99"
"65","000","00","010","0105","1094","479","207","272","3","482","1069","0","45.09","19.36"
"65","000","00","010","0106","0000","1132","457","675","13","1145","2449","0","46.75","18.66"
"65","000","00","010","0106","1114","604","244","360","5","609","1286","0","47.36","18.97"
"65","000","00","010","0106","1115","528","213","315","8","536","1163","0","46.09","18.31"
"65","000","00","010","0107","0000","1003","439","564","8","1011","2040","0","49.56","21.52"
"65","000","00","010","0107","1151","482","183","299","1","483","1012","0","47.73","18.08"
"65","000","00","010","0107","1152","521","256","265","7","528","1028","0","51.36","24.90"
"65","000","00","010","0108","0000","1223","527","696","14","1237","2595","0","47.67","20.31"
"65","000","00","010","0108","1166","656","276","380","4","660","1481","0","44.56","18.64"
"65","000","00","010","0108","1167","567","251","316","10","577","1114","0","51.80","22.53"
"65","000","00","010","0109","0000","904","356","548","6","910","1940","0","46.91","18.35"
"65","000","00","010","0109","1197","426","148","278","3","429","946","0","45.35","15.64"
"65","000","00","010","0109","1198","478","208","270","3","481","994","0","48.39","20.93"
"65","000","00","010","0110","0000","1526","735","791","23","1549","3280","0","47.23","22.41"
"65","000","00","010","0110","1214","787","372","415","13","800","1610","0","49.69","23.11"
"65","000","00","010","0110","1215","739","363","376","10","749","1670","0","44.85","21.74"
"65","000","00","010","0111","0000","821","383","438","8","829","1789","0","46.34","21.41"
"65","000","00","010","0111","1252","468","220","248","4","472","968","0","48.76","22.73"
"65","000","00","010","0111","1253","353","163","190","4","357","821","0","43.48","19.85"
"65","000","00","010","0112","0000","1465","652","813","20","1485","3718","0","39.94","17.54"
"65","000","00","010","0112","1321","513","230","283","14","527","1358","0","38.81","16.94"
"65","000","00","010","0112","1322","373","162","211","2","375","935","0","40.11","17.33"
"65","000","00","010","0112","1323","579","260","319","4","583","1425","0","40.91","18.25"
"65","000","00","010","0113","0000","2168","985","1183","23","2191","6055","0","36.18","16.27"
"65","000","00","010","0113","1304","578","252","326","3","581","1576","0","36.87","15.99"
"65","000","00","010","0113","1305","531","234","297","5","536","1426","0","37.59","16.41"
"65","000","00","010","0113","1306","542","253","289","9","551","1445","0","38.13","17.51"
"65","000","00","010","0113","1307","517","246","271","6","523","1608","0","32.52","15.30"
"65","000","00","010","0114","0000","1028","524","504","9","1037","2287","0","45.34","22.91"
"65","000","00","010","0114","1006","542","271","271","1","543","1267","0","42.86","21.39"
"65","000","00","010","0114","1007","486","253","233","8","494","1020","0","48.43","24.80"
"65","000","00","010","0115","0000","834","406","428","5","839","1772","0","47.35","22.91"
"65","000","00","010","0115","1025","466","232","234","2","468","996","0","46.99","23.29"
"65","000","00","010","0115","1026","368","174","194","3","371","776","0","47.81","22.42"
"65","000","00","010","0116","0000","1125","429","696","9","1134","2400","0","47.25","17.88"
"65","000","00","010","0116","1047","613","245","368","5","618","1257","0","49.16","19.49"
"65","000","00","010","0116","1048","512","184","328","4","516","1143","0","45.14","16.10"
"65","000","00","010","0117","0000","1227","437","790","20","1247","2973","0","41.94","14.70"
"65","000","00","010","0117","1082","448","165","283","7","455","1084","0","41.97","15.22"
"65","000","00","010","0117","1083","361","114","247","6","367","865","0","42.43","13.18"
"65","000","00","010","0117","1084","418","158","260","7","425","1024","0","41.50","15.43"
"65","000","00","010","0118","0000","953","381","572","16","969","2012","0","48.16","18.94"
"65","000","00","010","0118","1110","521","214","307","10","531","1114","0","47.67","19.21"
"65","000","00","010","0118","1111","432","167","265","6","438","898","0","48.78","18.60"
"65","000","00","010","0119","0000","1497","560","937","13","1510","3479","0","43.40","16.10"
"65","000","00","010","0119","1124","696","246","450","4","700","1651","0","42.40","14.90"
"65","000","00","010","0119","1125","801","314","487","9","810","1828","0","44.31","17.18"
"65","000","00","010","0120","0000","1434","589","845","16","1450","3379","0","42.91","17.43"
"65","000","00","010","0120","1157","627","261","366","8","635","1481","0","42.88","17.62"
"65","000","00","010","0120","1158","807","328","479","8","815","1898","0","42.94","17.28"
"65","000","00","010","0121","0000","1663","772","891","15","1678","3540","0","47.40","21.81"
"65","000","00","010","0121","1176","986","469","517","8","994","2040","0","48.73","22.99"
"65","000","00","010","0121","1177","677","303","374","7","684","1500","0","45.60","20.20"
"65","000","00","010","0122","0000","825","330","495","12","837","2026","0","41.31","16.29"
"65","000","00","010","0122","1202","375","143","232","5","380","970","0","39.18","14.74"
"65","000","00","010","0122","1203","450","187","263","7","457","1056","0","43.28","17.71"
"65","000","00","010","0123","0000","1582","692","890","13","1595","3585","0","44.49","19.30"
"65","000","00","010","0123","1244","531","248","283","4","535","1241","0","43.11","19.98"
"65","000","00","010","0123","1245","523","221","302","7","530","1170","0","45.30","18.89"
"65","000","00","010","0123","1246","528","223","305","2","530","1174","0","45.14","18.99"
"65","000","00","010","0124","0000","4718","2185","2533","32","4750","12217","0","38.88","17.88"
"65","000","00","010","0124","1311","627","299","328","4","631","1619","0","38.97","18.47"
"65","000","00","010","0124","1312","649","269","380","5","654","1640","0","39.88","16.40"
"65","000","00","010","0124","1313","547","245","302","3","550","1507","0","36.50","16.26"
"65","000","00","010","0124","1314","666","296","370","4","670","1576","0","42.51","18.78"
"65","000","00","010","0124","1315","642","298","344","3","645","1628","0","39.62","18.30"
"65","000","00","010","0124","1316","618","303","315","5","623","1622","0","38.41","18.68"
"65","000","00","010","0124","1317","546","281","265","5","551","1400","0","39.36","20.07"
"65","000","00","010","0124","1318","423","194","229","3","426","1225","0","34.78","15.84"
"65","000","00","010","0125","0000","1245","458","787","14","1259","3210","0","39.22","14.27"
"65","000","00","010","0125","1275","616","252","364","10","626","1572","0","39.82","16.03"
"65","000","00","010","0125","1276","629","206","423","4","633","1638","0","38.64","12.58"
"65","000","00","010","0126","0000","498","186","312","2","500","1091","0","45.83","17.05"
"65","000","00","010","0126","1277","498","186","312","2","500","1091","0","45.83","17.05"
"65","000","00","020","0000","0000","141922","56727","85195","1312","143234","330362","383135","43.36","17.17"
"65","000","00","020","0001","0000","2039","788","1251","16","2055","4726","0","43.48","16.67"
"65","000","00","020","0001","0729","604","248","356","2","606","1466","0","41.34","16.92"
"65","000","00","020","0001","0730","378","130","248","3","381","834","0","45.68","15.59"
"65","000","00","020","0001","0731","546","192","354","9","555","1279","0","43.39","15.01"
"65","000","00","020","0001","0732","511","218","293","2","513","1147","0","44.73","19.01"
"65","000","00","020","0002","0000","565","212","353","9","574","1436","0","39.97","14.76"
"65","000","00","020","0002","0736","565","212","353","9","574","1436","0","39.97","14.76"
"65","000","00","020","0003","0000","968","332","636","1","969","2322","0","41.73","14.30"
"65","000","00","020","0003","0737","521","193","328","1","522","1257","0","41.53","15.35"
"65","000","00","020","0003","0738","447","139","308","0","447","1065","0","41.97","13.05"
"65","000","00","020","0004","0000","444","166","278","4","448","904","0","49.56","18.36"
"65","000","00","020","0004","0739","444","166","278","4","448","904","0","49.56","18.36"
"65","000","00","020","0005","0000","1651","613","1038","14","1665","3568","0","46.66","17.18"
"65","000","00","020","0005","0742","935","380","555","10","945","1978","0","47.78","19.21"
"65","000","00","020","0005","0743","716","233","483","4","720","1590","0","45.28","14.65"
"65","000","00","020","0006","0000","177","58","119","1","178","351","0","50.71","16.52"
"65","000","00","020","0006","0744","177","58","119","1","178","351","0","50.71","16.52"
"65","000","00","020","0007","0000","2615","1189","1426","16","2631","5671","0","46.39","20.97"
"65","000","00","020","0007","0745","477","207","270","2","479","1008","0","47.52","20.54"
"65","000","00","020","0007","0746","496","185","311","4","500","1139","0","43.90","16.24"
"65","000","00","020","0007","0747","807","376","431","4","811","1729","0","46.91","21.75"
"65","000","00","020","0007","0748","835","421","414","6","841","1795","0","46.85","23.45"
"65","000","00","020","0008","0000","2170","900","1270","15","2185","4889","0","44.69","18.41"
"65","000","00","020","0008","0749","610","240","370","6","616","1341","0","45.94","17.90"
"65","000","00","020","0008","0750","578","244","334","4","582","1263","0","46.08","19.32"
"65","000","00","020","0008","0751","499","201","298","3","502","1131","0","44.39","17.77"
"65","000","00","020","0008","0752","483","215","268","2","485","1154","0","42.03","18.63"
"65","000","00","020","0009","0000","1345","553","792","8","1353","3007","0","45.00","18.39"
"65","000","00","020","0009","0755","680","256","424","5","685","1549","0","44.22","16.53"
"65","000","00","020","0009","0756","665","297","368","3","668","1458","0","45.82","20.37"
"65","000","00","020","0010","0000","2498","1139","1359","22","2520","8822","0","28.56","12.91"
"65","000","00","020","0010","0757","681","276","405","5","686","4754","0","14.43","5.81"
"65","000","00","020","0010","0758","522","239","283","8","530","1199","0","44.20","19.93"
"65","000","00","020","0010","0759","686","323","363","6","692","1456","0","47.53","22.18"
"65","000","00","020","0010","0760","609","301","308","3","612","1413","0","43.31","21.30"
"65","000","00","020","0011","0000","829","343","486","6","835","1860","0","44.89","18.44"
"65","000","00","020","0011","0761","461","198","263","4","465","1008","0","46.13","19.64"
"65","000","00","020","0011","0762","368","145","223","2","370","852","0","43.43","17.02"
"65","000","00","020","0012","0000","1498","626","872","16","1514","3239","0","46.74","19.33"
"65","000","00","020","0012","0763","673","296","377","9","682","1486","0","45.90","19.92"
"65","000","00","020","0012","0764","825","330","495","7","832","1753","0","47.46","18.82"
"65","000","00","020","0013","0000","1890","782","1108","19","1909","3937","0","48.49","19.86"
"65","000","00","020","0013","0765","580","229","351","5","585","1296","0","45.14","17.67"
"65","000","00","020","0013","0766","637","271","366","10","647","1403","0","46.12","19.32"
"65","000","00","020","0013","0767","673","282","391","4","677","1238","0","54.68","22.78"
"65","000","00","020","0014","0000","2726","1163","1563","20","2746","5711","0","48.08","20.36"
"65","000","00","020","0014","0768","922","403","519","5","927","1945","0","47.66","20.72"
"65","000","00","020","0014","0769","458","189","269","3","461","983","0","46.90","19.23"
"65","000","00","020","0014","0770","643","262","381","1","644","1409","0","45.71","18.59"
"65","000","00","020","0014","0771","703","309","394","11","714","1374","0","51.97","22.49"
"65","000","00","020","0015","0000","1542","594","948","11","1553","3667","0","42.35","16.20"
"65","000","00","020","0015","0772","534","217","317","2","536","1203","0","44.56","18.04"
"65","000","00","020","0015","0773","509","211","298","7","516","1239","0","41.65","17.03"
"65","000","00","020","0015","0774","499","166","333","2","501","1225","0","40.90","13.55"
"65","000","00","020","0016","0000","1467","592","875","13","1480","3107","0","47.63","19.05"
"65","000","00","020","0016","0775","674","284","390","7","681","1475","0","46.17","19.25"
"65","000","00","020","0016","0776","793","308","485","6","799","1632","0","48.96","18.87"
"65","000","00","020","0017","0000","2418","856","1562","33","2451","5458","0","44.91","15.68"
"65","000","00","020","0017","0777","592","202","390","9","601","1304","0","46.09","15.49"
"65","000","00","020","0017","0778","622","245","377","7","629","1262","0","49.84","19.41"
"65","000","00","020","0017","0779","613","206","407","8","621","1438","0","43.18","14.33"
"65","000","00","020","0017","0780","591","203","388","9","600","1454","0","41.27","13.96"
"65","000","00","020","0018","0000","2414","974","1440","27","2441","5517","0","44.25","17.65"
"65","000","00","020","0018","0781","805","325","480","10","815","1689","0","48.25","19.24"
"65","000","00","020","0018","0782","881","382","499","9","890","2006","0","44.37","19.04"
"65","000","00","020","0018","0783","728","267","461","8","736","1822","0","40.40","14.65"
"65","000","00","020","0019","0000","1184","459","725","13","1197","2877","0","41.61","15.95"
"65","000","00","020","0019","0784","574","216","358","5","579","1432","0","40.43","15.08"
"65","000","00","020","0019","0785","610","243","367","8","618","1445","0","42.77","16.82"
"65","000","00","020","0020","0000","2794","1232","1562","20","2814","6525","0","43.13","18.88"
"65","000","00","020","0020","0786","608","303","305","4","612","1439","0","42.53","21.06"
"65","000","00","020","0020","0787","704","338","366","3","707","1694","0","41.74","19.95"
"65","000","00","020","0020","0788","723","296","427","8","731","1743","0","41.94","16.98"
"65","000","00","020","0020","0789","759","295","464","5","764","1649","0","46.33","17.89"
"65","000","00","020","0021","0000","1088","529","559","4","1092","2380","0","45.88","22.23"
"65","000","00","020","0021","0790","556","277","279","1","557","1186","0","46.96","23.36"
"65","000","00","020","0021","0791","532","252","280","3","535","1194","0","44.81","21.11"
"65","000","00","020","0022","0000","491","215","276","4","495","1288","0","38.43","16.69"
"65","000","00","020","0022","0792","491","215","276","4","495","1288","0","38.43","16.69"
"65","000","00","020","0023","0000","695","311","384","3","698","1582","0","44.12","19.66"
"65","000","00","020","0023","0793","695","311","384","3","698","1582","0","44.12","19.66"
"65","000","00","020","0024","0000","898","376","522","7","905","1982","0","45.66","18.97"
"65","000","00","020","0024","0794","505","212","293","4","509","1072","0","47.48","19.78"
"65","000","00","020","0024","0795","393","164","229","3","396","910","0","43.52","18.02"
"65","000","00","020","0025","0000","735","330","405","7","742","1664","0","44.59","19.83"
"65","000","00","020","0025","0796","735","330","405","7","742","1664","0","44.59","19.83"
"65","000","00","020","0026","0000","596","263","333","5","601","1261","0","47.66","20.86"
"65","000","00","020","0026","0797","596","263","333","5","601","1261","0","47.66","20.86"
"65","000","00","020","0027","0000","535","231","304","6","541","1289","0","41.97","17.92"
"65","000","00","020","0027","0798","535","231","304","6","541","1289","0","41.97","17.92"
"65","000","00","020","0028","0000","767","321","446","3","770","1819","0","42.33","17.65"
"65","000","00","020","0028","0799","767","321","446","3","770","1819","0","42.33","17.65"
"65","000","00","020","0029","0000","506","227","279","1","507","1130","0","44.87","20.09"
"65","000","00","020","0029","0800","506","227","279","1","507","1130","0","44.87","20.09"
"65","000","00","020","0030","0000","608","268","340","12","620","1363","0","45.49","19.66"
"65","000","00","020","0030","0801","608","268","340","12","620","1363","0","45.49","19.66"
"65","000","00","020","0031","0000","636","297","339","4","640","1483","0","43.16","20.03"
"65","000","00","020","0031","0802","636","297","339","4","640","1483","0","43.16","20.03"
"65","000","00","020","0032","0000","719","296","423","11","730","1785","0","40.90","16.58"
"65","000","00","020","0032","0803","344","148","196","7","351","879","0","39.93","16.84"
"65","000","00","020","0032","0804","375","148","227","4","379","906","0","41.83","16.34"
"65","000","00","020","0033","0000","711","304","407","8","719","1629","0","44.14","18.66"
"65","000","00","020","0033","0805","711","304","407","8","719","1629","0","44.14","18.66"
"65","000","00","020","0034","0000","511","213","298","5","516","1175","0","43.91","18.13"
"65","000","00","020","0034","0806","511","213","298","5","516","1175","0","43.91","18.13"
"65","000","00","020","0035","0000","538","230","308","4","542","1315","0","41.22","17.49"
"65","000","00","020","0035","0807","538","230","308","4","542","1315","0","41.22","17.49"
"65","000","00","020","0036","0000","611","261","350","5","616","1391","0","44.28","18.76"
"65","000","00","020","0036","0808","611","261","350","5","616","1391","0","44.28","18.76"
"65","000","00","020","0037","0000","556","239","317","2","558","1098","0","50.82","21.77"
"65","000","00","020","0037","0809","556","239","317","2","558","1098","0","50.82","21.77"
"65","000","00","020","0038","0000","925","423","502","6","931","2035","0","45.75","20.79"
"65","000","00","020","0038","0810","499","221","278","3","502","1070","0","46.92","20.65"
"65","000","00","020","0038","0811","426","202","224","3","429","965","0","44.46","20.93"
"65","000","00","020","0039","0000","1691","744","947","19","1710","3628","0","47.13","20.51"
"65","000","00","020","0039","0812","874","377","497","7","881","1889","0","46.64","19.96"
"65","000","00","020","0039","0813","817","367","450","12","829","1739","0","47.67","21.10"
"65","000","00","020","0040","0000","609","266","343","3","612","1275","0","48.00","20.86"
"65","000","00","020","0040","0814","609","266","343","3","612","1275","0","48.00","20.86"
"65","000","00","020","0041","0000","1085","454","631","8","1093","2448","0","44.65","18.55"
"65","000","00","020","0041","0815","611","255","356","6","617","1373","0","44.94","18.57"
"65","000","00","020","0041","0816","474","199","275","2","476","1075","0","44.28","18.51"
"65","000","00","020","0042","0000","1005","383","622","6","1011","2453","0","41.21","15.61"
"65","000","00","020","0042","0817","472","188","284","2","474","1172","0","40.44","16.04"
"65","000","00","020","0042","0818","533","195","338","4","537","1281","0","41.92","15.22"
"65","000","00","020","0043","0000","1137","540","597","12","1149","2406","0","47.76","22.44"
"65","000","00","020","0043","0819","535","245","290","9","544","1199","0","45.37","20.43"
"65","000","00","020","0043","0820","602","295","307","3","605","1207","0","50.12","24.44"
"65","000","00","020","0044","0000","1319","552","767","12","1331","3178","0","41.88","17.37"
"65","000","00","020","0044","0821","648","268","380","9","657","1629","0","40.33","16.45"
"65","000","00","020","0044","0822","671","284","387","3","674","1549","0","43.51","18.33"
"65","000","00","020","0045","0000","1648","590","1058","13","1661","3797","0","43.75","15.54"
"65","000","00","020","0045","0823","503","168","335","2","505","1145","0","44.10","14.67"
"65","000","00","020","0045","0824","608","204","404","3","611","1376","0","44.40","14.83"
"65","000","00","020","0045","0825","537","218","319","8","545","1276","0","42.71","17.08"
"65","000","00","020","0046","0000","642","204","438","10","652","1352","0","48.22","15.09"
"65","000","00","020","0046","0826","642","204","438","10","652","1352","0","48.22","15.09"
"65","000","00","020","0047","0000","466","195","271","1","467","1030","0","45.34","18.93"
"65","000","00","020","0047","0827","466","195","271","1","467","1030","0","45.34","18.93"
"65","000","00","020","0048","0000","774","314","460","8","782","1597","0","48.97","19.66"
"65","000","00","020","0048","0828","774","314","460","8","782","1597","0","48.97","19.66"
"65","000","00","020","0049","0000","801","356","445","6","807","1771","0","45.57","20.10"
"65","000","00","020","0049","0829","801","356","445","6","807","1771","0","45.57","20.10"
"65","000","00","020","0050","0000","695","254","441","8","703","1652","0","42.55","15.38"
"65","000","00","020","0050","0830","695","254","441","8","703","1652","0","42.55","15.38"
"65","000","00","020","0051","0000","955","397","558","5","960","2007","0","47.83","19.78"
"65","000","00","020","0051","0831","497","210","287","3","500","1046","0","47.80","20.08"
"65","000","00","020","0051","0832","458","187","271","2","460","961","0","47.87","19.46"
"65","000","00","020","0052","0000","684","253","431","7","691","1674","0","41.28","15.11"
"65","000","00","020","0052","0833","684","253","431","7","691","1674","0","41.28","15.11"
"65","000","00","020","0053","0000","396","193","203","3","399","855","0","46.67","22.57"
"65","000","00","020","0053","0834","396","193","203","3","399","855","0","46.67","22.57"
"65","000","00","020","0054","0000","628","268","360","13","641","1344","0","47.69","19.94"
"65","000","00","020","0054","0835","628","268","360","13","641","1344","0","47.69","19.94"
"65","000","00","020","0055","0000","679","284","395","5","684","1672","0","40.91","16.99"
"65","000","00","020","0055","0836","437","186","251","4","441","1007","0","43.79","18.47"
"65","000","00","020","0055","0837","242","98","144","1","243","665","0","36.54","14.74"
"65","000","00","020","0056","0000","818","317","501","9","827","1939","0","42.65","16.35"
"65","000","00","020","0056","0838","334","130","204","5","339","927","0","36.57","14.02"
"65","000","00","020","0056","0839","484","187","297","4","488","1012","0","48.22","18.48"
"65","000","00","020","0057","0000","886","364","522","6","892","2070","0","43.09","17.58"
"65","000","00","020","0057","0840","476","200","276","2","478","1035","0","46.18","19.32"
"65","000","00","020","0057","0841","410","164","246","4","414","1035","0","40.00","15.85"
"65","000","00","020","0058","0000","345","130","215","8","353","813","0","43.42","15.99"
"65","000","00","020","0058","0842","345","130","215","8","353","813","0","43.42","15.99"
"65","000","00","020","0059","0000","656","274","382","13","669","1385","0","48.30","19.78"
"65","000","00","020","0059","0843","656","274","382","13","669","1385","0","48.30","19.78"
"65","000","00","020","0060","0000","354","150","204","4","358","770","0","46.49","19.48"
"65","000","00","020","0060","0844","354","150","204","4","358","770","0","46.49","19.48"
"65","000","00","020","0061","0000","941","405","536","12","953","2229","0","42.75","18.17"
"65","000","00","020","0061","0845","450","170","280","6","456","1090","0","41.83","15.60"
"65","000","00","020","0061","0846","491","235","256","6","497","1139","0","43.63","20.63"
"65","000","00","020","0062","0000","816","330","486","12","828","1876","0","44.14","17.59"
"65","000","00","020","0062","0847","382","147","235","8","390","897","0","43.48","16.39"
"65","000","00","020","0062","0848","434","183","251","4","438","979","0","44.74","18.69"
"65","000","00","020","0063","0000","845","338","507","11","856","2003","0","42.74","16.87"
"65","000","00","020","0063","0849","499","191","308","5","504","1101","0","45.78","17.35"
"65","000","00","020","0063","0850","346","147","199","6","352","902","0","39.02","16.30"
"65","000","00","020","0064","0000","589","234","355","8","597","1436","0","41.57","16.30"
"65","000","00","020","0064","0851","589","234","355","8","597","1436","0","41.57","16.30"
"65","000","00","020","0065","0000","464","208","256","9","473","1039","0","45.52","20.02"
"65","000","00","020","0065","0852","464","208","256","9","473","1039","0","45.52","20.02"
"65","000","00","020","0066","0000","817","345","472","12","829","1775","0","46.70","19.44"
"65","000","00","020","0066","0853","350","135","215","7","357","850","0","42.00","15.88"
"65","000","00","020","0066","0854","467","210","257","5","472","925","0","51.03","22.70"
"65","000","00","020","0067","0000","805","291","514","8","813","2123","0","38.29","13.71"
"65","000","00","020","0067","0855","394","141","253","6","400","1062","0","37.66","13.28"
"65","000","00","020","0067","0856","411","150","261","2","413","1061","0","38.93","14.14"
"65","000","00","020","0068","0000","1265","510","755","17","1282","2926","0","43.81","17.43"
"65","000","00","020","0068","0857","598","240","358","6","604","1390","0","43.45","17.27"
"65","000","00","020","0068","0858","667","270","397","11","678","1536","0","44.14","17.58"
"65","000","00","020","0069","0000","683","293","390","4","687","1678","0","40.94","17.46"
"65","000","00","020","0069","0859","683","293","390","4","687","1678","0","40.94","17.46"
"65","000","00","020","0070","0000","468","179","289","6","474","1136","0","41.73","15.76"
"65","000","00","020","0070","0860","468","179","289","6","474","1136","0","41.73","15.76"
"65","000","00","020","0071","0000","721","278","443","8","729","1549","0","47.06","17.95"
"65","000","00","020","0071","0861","721","278","443","8","729","1549","0","47.06","17.95"
"65","000","00","020","0072","0000","1004","400","604","7","1011","2410","0","41.95","16.60"
"65","000","00","020","0072","0862","458","204","254","1","459","1160","0","39.57","17.59"
"65","000","00","020","0072","0863","546","196","350","6","552","1250","0","44.16","15.68"
"65","000","00","020","0073","0000","1180","454","726","15","1195","2698","0","44.29","16.83"
"65","000","00","020","0073","0864","572","215","357","9","581","1325","0","43.85","16.23"
"65","000","00","020","0073","0865","608","239","369","6","614","1373","0","44.72","17.41"
"65","000","00","020","0074","0000","720","314","406","6","726","1802","0","40.29","17.43"
"65","000","00","020","0074","0866","720","314","406","6","726","1802","0","40.29","17.43"
"65","000","00","020","0075","0000","813","293","520","5","818","1889","0","43.30","15.51"
"65","000","00","020","0075","0867","418","150","268","2","420","923","0","45.50","16.25"
"65","000","00","020","0075","0868","395","143","252","3","398","966","0","41.20","14.80"
"65","000","00","020","0076","0000","1782","692","1090","13","1795","4172","0","43.02","16.59"
"65","000","00","020","0076","0869","616","239","377","5","621","1498","0","41.46","15.95"
"65","000","00","020","0076","0870","602","231","371","5","607","1418","0","42.81","16.29"
"65","000","00","020","0076","0871","564","222","342","3","567","1256","0","45.14","17.68"
"65","000","00","020","0077","0000","1452","565","887","19","1471","3336","0","44.09","16.94"
"65","000","00","020","0077","0872","693","256","437","6","699","1597","0","43.77","16.03"
"65","000","00","020","0077","0873","759","309","450","13","772","1739","0","44.39","17.77"
"65","000","00","020","0078","0000","2036","750","1286","18","2054","4936","0","41.61","15.19"
"65","000","00","020","0078","0874","460","130","330","4","464","1238","0","37.48","10.50"
"65","000","00","020","0078","0875","529","211","318","5","534","1141","0","46.80","18.49"
"65","000","00","020","0078","0876","524","219","305","7","531","1230","0","43.17","17.80"
"65","000","00","020","0078","0877","523","190","333","2","525","1327","0","39.56","14.32"
"65","000","00","020","0079","0000","882","342","540","20","902","2027","0","44.50","16.87"
"65","000","00","020","0079","0878","476","189","287","11","487","1086","0","44.84","17.40"
"65","000","00","020","0079","0879","406","153","253","9","415","941","0","44.10","16.26"
"65","000","00","020","0080","0000","716","270","446","6","722","1631","0","44.27","16.55"
"65","000","00","020","0080","0880","716","270","446","6","722","1631","0","44.27","16.55"
"65","000","00","020","0081","0000","932","378","554","15","947","2145","0","44.15","17.62"
"65","000","00","020","0081","0881","427","163","264","6","433","1031","0","42.00","15.81"
"65","000","00","020","0081","0882","505","215","290","9","514","1114","0","46.14","19.30"
"65","000","00","020","0082","0000","1543","572","971","11","1554","3509","0","44.29","16.30"
"65","000","00","020","0082","0883","557","208","349","4","561","1208","0","46.44","17.22"
"65","000","00","020","0082","0884","455","179","276","4","459","1013","0","45.31","17.67"
"65","000","00","020","0082","0885","531","185","346","3","534","1288","0","41.46","14.36"
"65","000","00","020","0083","0000","1468","597","871","8","1476","3088","0","47.80","19.33"
"65","000","00","020","0083","0886","708","283","425","3","711","1550","0","45.87","18.26"
"65","000","00","020","0083","0887","760","314","446","5","765","1538","0","49.74","20.42"
"65","000","00","020","0084","0000","1167","441","726","18","1185","2545","0","46.56","17.33"
"65","000","00","020","0084","0888","663","230","433","7","670","1327","0","50.49","17.33"
"65","000","00","020","0084","0889","504","211","293","11","515","1218","0","42.28","17.32"
"65","000","00","020","0085","0000","1126","461","665","9","1135","2674","0","42.45","17.24"
"65","000","00","020","0085","0890","676","268","408","6","682","1583","0","43.08","16.93"
"65","000","00","020","0085","0891","450","193","257","3","453","1091","0","41.52","17.69"
"65","000","00","020","0086","0000","1499","559","940","8","1507","3267","0","46.13","17.11"
"65","000","00","020","0086","0892","744","279","465","3","747","1597","0","46.78","17.47"
"65","000","00","020","0086","0893","755","280","475","5","760","1670","0","45.51","16.77"
"65","000","00","020","0087","0000","1805","674","1131","21","1826","4360","0","41.88","15.46"
"65","000","00","020","0087","0896","610","255","355","11","621","1511","0","41.10","16.88"
"65","000","00","020","0087","0897","534","168","366","6","540","1298","0","41.60","12.94"
"65","000","00","020","0087","0898","661","251","410","4","665","1551","0","42.88","16.18"
"65","000","00","020","0088","0000","1236","452","784","15","1251","2861","0","43.73","15.80"
"65","000","00","020","0088","0904","579","216","363","8","587","1397","0","42.02","15.46"
"65","000","00","020","0088","0905","657","236","421","7","664","1464","0","45.36","16.12"
"65","000","00","020","0089","0000","2046","763","1283","19","2065","4596","0","44.93","16.60"
"65","000","00","020","0089","0913","622","221","401","5","627","1373","0","45.67","16.10"
"65","000","00","020","0089","0914","705","254","451","7","712","1633","0","43.60","15.55"
"65","000","00","020","0089","0915","719","288","431","7","726","1590","0","45.66","18.11"
"65","000","00","020","0090","0000","1899","639","1260","10","1909","4710","0","40.53","13.57"
"65","000","00","020","0090","0916","630","199","431","3","633","1574","0","40.22","12.64"
"65","000","00","020","0090","0917","632","214","418","3","635","1628","0","39.00","13.14"
"65","000","00","020","0090","0918","637","226","411","4","641","1508","0","42.51","14.99"
"65","000","00","020","0091","0000","1516","575","941","11","1527","3553","0","42.98","16.18"
"65","000","00","020","0091","0908","777","303","474","9","786","1917","0","41.00","15.81"
"65","000","00","020","0091","0909","739","272","467","2","741","1636","0","45.29","16.63"
"65","000","00","020","0092","0000","971","334","637","13","984","2263","0","43.48","14.76"
"65","000","00","020","0092","0899","519","205","314","6","525","1157","0","45.38","17.72"
"65","000","00","020","0092","0900","452","129","323","7","459","1106","0","41.50","11.66"
"65","000","00","020","0093","0000","3390","1320","2070","32","3422","7625","0","44.88","17.31"
"65","000","00","020","0093","0922","556","212","344","3","559","1166","0","47.94","18.18"
"65","000","00","020","0093","0923","717","266","451","12","729","1543","0","47.25","17.24"
"65","000","00","020","0093","0924","685","272","413","3","688","1585","0","43.41","17.16"
"65","000","00","020","0093","0925","677","268","409","3","680","1598","0","42.55","16.77"
"65","000","00","020","0093","0926","755","302","453","11","766","1733","0","44.20","17.43"
"65","000","00","020","0094","0000","1623","612","1011","11","1634","3940","0","41.47","15.53"
"65","000","00","020","0094","0927","529","190","339","7","536","1289","0","41.58","14.74"
"65","000","00","020","0094","0928","555","208","347","3","558","1371","0","40.70","15.17"
"65","000","00","020","0094","0929","539","214","325","1","540","1280","0","42.19","16.72"
"65","000","00","020","0095","0000","1604","615","989","21","1625","3874","0","41.95","15.88"
"65","000","00","020","0095","0930","531","208","323","5","536","1267","0","42.30","16.42"
"65","000","00","020","0095","0931","560","213","347","8","568","1281","0","44.34","16.63"
"65","000","00","020","0095","0932","513","194","319","8","521","1326","0","39.29","14.63"
"65","000","00","020","0096","0000","1350","533","817","11","1361","3407","0","39.95","15.64"
"65","000","00","020","0096","0933","431","159","272","3","434","1035","0","41.93","15.36"
"65","000","00","020","0096","0934","345","126","219","4","349","986","0","35.40","12.78"
"65","000","00","020","0096","0935","574","248","326","4","578","1386","0","41.70","17.89"
"65","000","00","020","0097","0000","1017","403","614","11","1028","2802","0","36.69","14.38"
"65","000","00","020","0097","0936","523","210","313","9","532","1500","0","35.47","14.00"
"65","000","00","020","0097","0937","494","193","301","2","496","1302","0","38.10","14.82"
"65","000","00","020","0098","0000","859","286","573","10","869","1998","0","43.49","14.31"
"65","000","00","020","0098","0938","355","119","236","6","361","821","0","43.97","14.49"
"65","000","00","020","0098","0939","504","167","337","4","508","1177","0","43.16","14.19"
"65","000","00","020","0099","0000","934","369","565","9","943","2046","0","46.09","18.04"
"65","000","00","020","0099","0940","505","188","317","5","510","1032","0","49.42","18.22"
"65","000","00","020","0099","0941","429","181","248","4","433","1014","0","42.70","17.85"
"65","000","00","020","0100","0000","911","299","612","5","916","2029","0","45.15","14.74"
"65","000","00","020","0100","0942","408","126","282","3","411","933","0","44.05","13.50"
"65","000","00","020","0100","0943","503","173","330","2","505","1096","0","46.08","15.78"
"65","000","00","020","0101","0000","1387","497","890","15","1402","3070","0","45.67","16.19"
"65","000","00","020","0101","0944","630","216","414","5","635","1451","0","43.76","14.89"
"65","000","00","020","0101","0945","757","281","476","10","767","1619","0","47.37","17.36"
"65","000","00","020","0102","0000","929","351","578","8","937","2229","0","42.04","15.75"
"65","000","00","020","0102","0946","432","151","281","6","438","1050","0","41.71","14.38"
"65","000","00","020","0102","0947","497","200","297","2","499","1179","0","42.32","16.96"
"65","000","00","020","0103","0000","1835","701","1134","11","1846","4356","0","42.38","16.09"
"65","000","00","020","0103","0948","531","202","329","4","535","1287","0","41.57","15.70"
"65","000","00","020","0103","0949","638","230","408","3","641","1507","0","42.53","15.26"
"65","000","00","020","0103","0950","666","269","397","4","670","1562","0","42.89","17.22"
"65","000","00","020","0104","0000","1926","738","1188","17","1943","4540","0","42.80","16.26"
"65","000","00","020","0104","0958","557","224","333","5","562","1334","0","42.13","16.79"
"65","000","00","020","0104","0959","649","228","421","7","656","1653","0","39.69","13.79"
"65","000","00","020","0104","0960","720","286","434","5","725","1553","0","46.68","18.42"
"65","000","00","020","0105","0000","2469","1094","1375","16","2485","5713","0","43.50","19.15"
"65","000","00","020","0105","0953","723","282","441","7","730","1790","0","40.78","15.75"
"65","000","00","020","0105","0954","881","377","504","4","885","1886","0","46.92","19.99"
"65","000","00","020","0105","0955","865","435","430","5","870","2037","0","42.71","21.35"
"65","000","00","020","0106","0000","1143","460","683","15","1158","2882","0","40.18","15.96"
"65","000","00","020","0106","0951","548","212","336","5","553","1373","0","40.28","15.44"
"65","000","00","020","0106","0952","595","248","347","10","605","1509","0","40.09","16.43"
"65","000","00","020","0107","0000","683","251","432","3","686","1839","0","37.30","13.65"
"65","000","00","020","0107","0956","315","111","204","3","318","872","0","36.47","12.73"
"65","000","00","020","0107","0957","368","140","228","0","368","967","0","38.06","14.48"
"65","000","00","020","0108","0000","3112","1418","1694","28","3140","7294","0","43.05","19.44"
"65","000","00","020","0108","0961","449","197","252","3","452","1028","0","43.97","19.16"
"65","000","00","020","0108","0962","494","174","320","5","499","1240","0","40.24","14.03"
"65","000","00","020","0108","0963","564","263","301","7","571","1339","0","42.64","19.64"
"65","000","00","020","0108","0964","708","330","378","8","716","1724","0","41.53","19.14"
"65","000","00","020","0108","0965","897","454","443","5","902","1963","0","45.95","23.13"
"65","000","00","020","0109","0000","818","322","496","10","828","1740","0","47.59","18.51"
"65","000","00","020","0109","0740","415","166","249","5","420","936","0","44.87","17.74"
"65","000","00","020","0109","0741","403","156","247","5","408","804","0","50.75","19.40"
"65","000","00","020","0110","0000","1795","742","1053","12","1807","4013","0","45.03","18.49"
"65","000","00","020","0110","0733","626","228","398","2","628","1344","0","46.73","16.96"
"65","000","00","020","0110","0734","660","347","313","6","666","1389","0","47.95","24.98"
"65","000","00","020","0110","0735","509","167","342","4","513","1280","0","40.08","13.05"
"65","000","00","020","0111","0000","1567","680","887","11","1578","3686","0","42.81","18.45"
"65","000","00","020","0111","0753","788","325","463","8","796","1821","0","43.71","17.85"
"65","000","00","020","0111","0754","779","355","424","3","782","1865","0","41.93","19.03"
"65","000","00","020","0112","0000","1031","408","623","12","1043","2539","0","41.08","16.07"
"65","000","00","020","0112","0906","592","263","329","8","600","1332","0","45.05","19.74"
"65","000","00","020","0112","0907","439","145","294","4","443","1207","0","36.70","12.01"
"65","000","00","020","0113","0000","2248","777","1471","17","2265","5046","0","44.89","15.40"
"65","000","00","020","0113","0901","717","282","435","2","719","1748","0","41.13","16.13"
"65","000","00","020","0113","0902","639","213","426","5","644","1520","0","42.37","14.01"
"65","000","00","020","0113","0903","892","282","610","10","902","1778","0","50.73","15.86"
"65","000","00","020","0114","0000","1665","570","1095","12","1677","4437","0","37.80","12.85"
"65","000","00","020","0114","0919","530","185","345","5","535","1355","0","39.48","13.65"
"65","000","00","020","0114","0920","590","206","384","6","596","1620","0","36.79","12.72"
"65","000","00","020","0114","0921","545","179","366","1","546","1462","0","37.35","12.24"
"65","000","00","020","0115","0000","2064","739","1325","21","2085","5061","0","41.20","14.60"
"65","000","00","020","0115","0910","634","241","393","4","638","1589","0","40.15","15.17"
"65","000","00","020","0115","0911","726","263","463","7","733","1744","0","42.03","15.08"
"65","000","00","020","0115","0912","704","235","469","10","714","1728","0","41.32","13.60"
"65","000","00","020","0116","0000","1339","523","816","20","1359","2994","0","45.39","17.47"
"65","000","00","020","0116","0894","614","234","380","8","622","1325","0","46.94","17.66"
"65","000","00","020","0116","0895","725","289","436","12","737","1669","0","44.16","17.32"
"65","000","00","020","0117","0000","1354","502","852","12","1366","3293","0","41.48","15.24"
"65","000","00","020","0117","0966","655","232","423","9","664","1597","0","41.58","14.53"
"65","000","00","020","0117","0967","699","270","429","3","702","1696","0","41.39","15.92"
"65","000","00","020","0118","0000","1683","677","1006","18","1701","3764","0","45.19","17.99"
"65","000","00","020","0118","0968","495","169","326","3","498","1063","0","46.85","15.90"
"65","000","00","020","0118","0969","612","237","375","12","624","1337","0","46.67","17.73"
"65","000","00","020","0118","0970","576","271","305","3","579","1364","0","42.45","19.87"
"65","000","00","020","0119","0000","1346","517","829","10","1356","3524","0","38.48","14.67"
"65","000","00","020","0119","0971","328","116","212","1","329","862","0","38.17","13.46"
"65","000","00","020","0119","0972","576","230","346","8","584","1521","0","38.40","15.12"
"65","000","00","020","0119","0973","442","171","271","1","443","1141","0","38.83","14.99"
"65","000","00","030","0000","0000","161747","89185","72562","1657","163404","355238","408654","46.00","25.11"
"65","000","00","030","0001","0000","2693","1348","1345","20","2713","6550","0","41.42","20.58"
"65","000","00","030","0001","1324","743","329","414","4","747","1906","0","39.19","17.26"
"65","000","00","030","0001","1325","681","369","312","5","686","1627","0","42.16","22.68"
"65","000","00","030","0001","1326","506","236","270","2","508","1165","0","43.61","20.26"
"65","000","00","030","0001","1327","763","414","349","9","772","1852","0","41.68","22.35"
"65","000","00","030","0002","0000","3632","1906","1726","34","3666","7974","0","45.97","23.90"
"65","000","00","030","0002","1376","661","287","374","3","664","1660","0","40.00","17.29"
"65","000","00","030","0002","1377","800","371","429","11","811","1796","0","45.16","20.66"
"65","000","00","030","0002","1378","560","310","250","4","564","1304","0","43.25","23.77"
"65","000","00","030","0002","1379","895","530","365","9","904","1889","0","47.86","28.06"
"65","000","00","030","0002","1380","716","408","308","7","723","1325","0","54.57","30.79"
"65","000","00","030","0003","0000","1705","803","902","18","1723","3796","0","45.39","21.15"
"65","000","00","030","0003","1381","563","243","320","3","566","1146","0","49.39","21.20"
"65","000","00","030","0003","1382","522","259","263","7","529","1242","0","42.59","20.85"
"65","000","00","030","0003","1383","620","301","319","8","628","1408","0","44.60","21.38"
"65","000","00","030","0004","0000","1406","723","683","12","1418","3469","0","40.88","20.84"
"65","000","00","030","0004","1384","458","261","197","3","461","1181","0","39.03","22.10"
"65","000","00","030","0004","1385","400","188","212","4","404","1003","0","40.28","18.74"
"65","000","00","030","0004","1386","548","274","274","5","553","1285","0","43.04","21.32"
"65","000","00","030","0005","0000","1350","657","693","17","1367","3452","0","39.60","19.03"
"65","000","00","030","0005","1387","688","339","349","9","697","1732","0","40.24","19.57"
"65","000","00","030","0005","1388","662","318","344","8","670","1720","0","38.95","18.49"
"65","000","00","030","0006","0000","1551","943","608","17","1568","3096","0","50.65","30.46"
"65","000","00","030","0006","1389","454","338","116","7","461","816","0","56.50","41.42"
"65","000","00","030","0006","1390","488","301","187","5","493","959","0","51.41","31.39"
"65","000","00","030","0006","1391","609","304","305","5","614","1321","0","46.48","23.01"
"65","000","00","030","0007","0000","1026","663","363","8","1034","2171","0","47.63","30.54"
"65","000","00","030","0007","1328","477","269","208","7","484","994","0","48.69","27.06"
"65","000","00","030","0007","1329","549","394","155","1","550","1177","0","46.73","33.47"
"65","000","00","030","0008","0000","2718","1597","1121","20","2738","5682","0","48.19","28.11"
"65","000","00","030","0008","1330","797","448","349","7","804","1659","0","48.46","27.00"
"65","000","00","030","0008","1331","580","419","161","6","586","1087","0","53.91","38.55"
"65","000","00","030","0008","1332","754","378","376","3","757","1672","0","45.28","22.61"
"65","000","00","030","0008","1333","587","352","235","4","591","1264","0","46.76","27.85"
"65","000","00","030","0009","0000","2522","1314","1208","23","2545","5265","0","48.34","24.96"
"65","000","00","030","0009","1334","928","503","425","8","936","1894","0","49.42","26.56"
"65","000","00","030","0009","1335","759","377","382","5","764","1629","0","46.90","23.14"
"65","000","00","030","0009","1336","835","434","401","10","845","1742","0","48.51","24.91"
"65","000","00","030","0010","0000","1508","768","740","15","1523","3312","0","45.98","23.19"
"65","000","00","030","0010","1342","820","401","419","7","827","1733","0","47.72","23.14"
"65","000","00","030","0010","1343","688","367","321","8","696","1579","0","44.08","23.24"
"65","000","00","030","0011","0000","1569","834","735","13","1582","3410","0","46.39","24.46"
"65","000","00","030","0011","1344","908","489","419","7","915","1936","0","47.26","25.26"
"65","000","00","030","0011","1345","661","345","316","6","667","1474","0","45.25","23.41"
"65","000","00","030","0012","0000","1802","924","878","14","1816","3887","0","46.72","23.77"
"65","000","00","030","0012","1346","574","262","312","8","582","1234","0","47.16","21.23"
"65","000","00","030","0012","1347","558","304","254","5","563","1224","0","46.00","24.84"
"65","000","00","030","0012","1348","670","358","312","1","671","1429","0","46.96","25.05"
"65","000","00","030","0013","0000","1685","845","840","16","1701","3709","0","45.86","22.78"
"65","000","00","030","0013","1349","841","463","378","10","851","1918","0","44.37","24.14"
"65","000","00","030","0013","1350","844","382","462","6","850","1791","0","47.46","21.33"
"65","000","00","030","0014","0000","1787","928","859","17","1804","3832","0","47.08","24.22"
"65","000","00","030","0014","1351","532","293","239","7","539","1144","0","47.12","25.61"
"65","000","00","030","0014","1352","630","331","299","4","634","1371","0","46.24","24.14"
"65","000","00","030","0014","1353","625","304","321","6","631","1317","0","47.91","23.08"
"65","000","00","030","0015","0000","1868","986","882","19","1887","3903","0","48.35","25.26"
"65","000","00","030","0015","1354","716","444","272","4","720","1368","0","52.63","32.46"
"65","000","00","030","0015","1355","586","301","285","5","591","1286","0","45.96","23.41"
"65","000","00","030","0015","1356","566","241","325","10","576","1249","0","46.12","19.30"
"65","000","00","030","0016","0000","2127","1052","1075","21","2148","4460","0","48.16","23.59"
"65","000","00","030","0016","1357","641","307","334","4","645","1356","0","47.57","22.64"
"65","000","00","030","0016","1358","590","317","273","2","592","1266","0","46.76","25.04"
"65","000","00","030","0016","1359","896","428","468","15","911","1838","0","49.56","23.29"
"65","000","00","030","0017","0000","2077","1052","1025","15","2092","4916","0","42.55","21.40"
"65","000","00","030","0017","1360","697","330","367","4","701","1767","0","39.67","18.68"
"65","000","00","030","0017","1361","712","398","314","5","717","1655","0","43.32","24.05"
"65","000","00","030","0017","1362","668","324","344","6","674","1494","0","45.11","21.69"
"65","000","00","030","0018","0000","1490","765","725","14","1504","3253","0","46.23","23.52"
"65","000","00","030","0018","1363","438","236","202","1","439","974","0","45.07","24.23"
"65","000","00","030","0018","1364","522","240","282","9","531","1123","0","47.28","21.37"
"65","000","00","030","0018","1365","530","289","241","4","534","1156","0","46.19","25.00"
"65","000","00","030","0019","0000","2089","1097","992","31","2120","4420","0","47.96","24.82"
"65","000","00","030","0019","1366","785","440","345","16","801","1761","0","45.49","24.99"
"65","000","00","030","0019","1367","814","387","427","12","826","1554","0","53.15","24.90"
"65","000","00","030","0019","1368","490","270","220","3","493","1105","0","44.62","24.43"
"65","000","00","030","0020","0000","1683","1033","650","15","1698","3265","0","52.01","31.64"
"65","000","00","030","0020","1534","706","407","299","6","712","1463","0","48.67","27.82"
"65","000","00","030","0020","1535","458","280","178","5","463","839","0","55.18","33.37"
"65","000","00","030","0020","1536","519","346","173","4","523","963","0","54.31","35.93"
"65","000","00","030","0021","0000","1410","793","617","7","1417","2767","0","51.21","28.66"
"65","000","00","030","0021","1537","659","350","309","3","662","1337","0","49.51","26.18"
"65","000","00","030","0021","1538","751","443","308","4","755","1430","0","52.80","30.98"
"65","000","00","030","0022","0000","2692","1688","1004","36","2728","5289","0","51.58","31.92"
"65","000","00","030","0022","1542","940","597","343","16","956","1844","0","51.84","32.38"
"65","000","00","030","0022","1543","876","524","352","11","887","1796","0","49.39","29.18"
"65","000","00","030","0022","1544","876","567","309","9","885","1649","0","53.67","34.38"
"65","000","00","030","0023","0000","2083","1316","767","15","2098","3903","0","53.75","33.72"
"65","000","00","030","0023","1545","704","448","256","8","712","1335","0","53.33","33.56"
"65","000","00","030","0023","1546","628","419","209","4","632","1230","0","51.38","34.07"
"65","000","00","030","0023","1547","751","449","302","3","754","1338","0","56.35","33.56"
"65","000","00","030","0024","0000","1465","797","668","19","1484","3171","0","46.80","25.13"
"65","000","00","030","0024","1548","570","316","254","9","579","1159","0","49.96","27.26"
"65","000","00","030","0024","1549","330","202","128","3","333","811","0","41.06","24.91"
"65","000","00","030","0024","1550","565","279","286","7","572","1201","0","47.63","23.23"
"65","000","00","030","0025","0000","3302","1788","1514","30","3332","7115","0","46.83","25.13"
"65","000","00","030","0025","1369","833","365","468","3","836","1768","0","47.29","20.64"
"65","000","00","030","0025","1370","896","488","408","11","907","1899","0","47.76","25.70"
"65","000","00","030","0025","1371","732","430","302","9","741","1633","0","45.38","26.33"
"65","000","00","030","0025","1372","841","505","336","7","848","1815","0","46.72","27.82"
"65","000","00","030","0026","0000","2156","1226","930","14","2170","4499","0","48.23","27.25"
"65","000","00","030","0026","1373","700","385","315","4","704","1494","0","47.12","25.77"
"65","000","00","030","0026","1374","535","288","247","5","540","1184","0","45.61","24.32"
"65","000","00","030","0026","1375","921","553","368","5","926","1821","0","50.85","30.37"
"65","000","00","030","0027","0000","1863","1089","774","10","1873","4018","0","46.62","27.10"
"65","000","00","030","0027","1551","610","356","254","2","612","1308","0","46.79","27.22"
"65","000","00","030","0027","1552","586","326","260","4","590","1346","0","43.83","24.22"
"65","000","00","030","0027","1553","667","407","260","4","671","1364","0","49.19","29.84"
"65","000","00","030","0028","0000","1435","814","621","16","1451","3062","0","47.39","26.58"
"65","000","00","030","0028","1554","697","380","317","10","707","1456","0","48.56","26.10"
"65","000","00","030","0028","1555","738","434","304","6","744","1606","0","46.33","27.02"
"65","000","00","030","0029","0000","2061","1175","886","20","2081","4298","0","48.42","27.34"
"65","000","00","030","0029","1558","680","378","302","11","691","1501","0","46.04","25.18"
"65","000","00","030","0029","1559","609","359","250","2","611","1280","0","47.73","28.05"
"65","000","00","030","0029","1560","772","438","334","7","779","1517","0","51.35","28.87"
"65","000","00","030","0030","0000","2766","1733","1033","32","2798","5620","0","49.79","30.84"
"65","000","00","030","0030","1561","844","548","296","12","856","1667","0","51.35","32.87"
"65","000","00","030","0030","1562","869","534","335","7","876","1914","0","45.77","27.90"
"65","000","00","030","0030","1563","422","250","172","6","428","887","0","48.25","28.18"
"65","000","00","030","0030","1564","631","401","230","7","638","1152","0","55.38","34.81"
"65","000","00","030","0031","0000","2124","1405","719","19","2143","4436","0","48.31","31.67"
"65","000","00","030","0031","1565","748","502","246","4","752","1473","0","51.05","34.08"
"65","000","00","030","0031","1566","695","474","221","5","700","1543","0","45.37","30.72"
"65","000","00","030","0031","1567","681","429","252","10","691","1420","0","48.66","30.21"
"65","000","00","030","0032","0000","2033","1235","798","19","2052","4318","0","47.52","28.60"
"65","000","00","030","0032","1568","534","334","200","10","544","1116","0","48.75","29.93"
"65","000","00","030","0032","1569","787","462","325","6","793","1668","0","47.54","27.70"
"65","000","00","030","0032","1570","712","439","273","3","715","1534","0","46.61","28.62"
"65","000","00","030","0033","0000","1301","788","513","15","1316","2931","0","44.90","26.89"
"65","000","00","030","0033","1576","640","373","267","10","650","1467","0","44.31","25.43"
"65","000","00","030","0033","1577","661","415","246","5","666","1464","0","45.49","28.35"
"65","000","00","030","0034","0000","1251","798","453","12","1263","2614","0","48.32","30.53"
"65","000","00","030","0034","1399","557","355","202","4","561","1215","0","46.17","29.22"
"65","000","00","030","0034","1400","694","443","251","8","702","1399","0","50.18","31.67"
"65","000","00","030","0035","0000","2730","1697","1033","29","2759","6686","0","41.27","25.38"
"65","000","00","030","0035","1401","570","371","199","9","579","1448","0","39.99","25.62"
"65","000","00","030","0035","1402","673","435","238","4","677","1563","0","43.31","27.83"
"65","000","00","030","0035","1403","842","508","334","9","851","1947","0","43.71","26.09"
"65","000","00","030","0035","1404","645","383","262","7","652","1728","0","37.73","22.16"
"65","000","00","030","0036","0000","1790","1329","461","22","1812","3818","0","47.46","34.81"
"65","000","00","030","0036","1405","544","451","93","6","550","1132","0","48.59","39.84"
"65","000","00","030","0036","1406","569","352","217","3","572","1346","0","42.50","26.15"
"65","000","00","030","0036","1407","677","526","151","13","690","1340","0","51.49","39.25"
"65","000","00","030","0037","0000","2003","1285","718","20","2023","4482","0","45.14","28.67"
"65","000","00","030","0037","1408","690","441","249","8","698","1589","0","43.93","27.75"
"65","000","00","030","0037","1409","703","469","234","6","709","1540","0","46.04","30.45"
"65","000","00","030","0037","1410","610","375","235","6","616","1353","0","45.53","27.72"
"65","000","00","030","0038","0000","1709","1097","612","21","1730","4171","0","41.48","26.30"
"65","000","00","030","0038","1411","666","402","264","8","674","1583","0","42.58","25.39"
"65","000","00","030","0038","1412","473","310","163","7","480","1235","0","38.87","25.10"
"65","000","00","030","0038","1413","570","385","185","6","576","1353","0","42.57","28.46"
"65","000","00","030","0039","0000","1904","1212","692","31","1935","3856","0","50.18","31.43"
"65","000","00","030","0039","1414","693","432","261","10","703","1374","0","51.16","31.44"
"65","000","00","030","0039","1415","633","403","230","12","645","1307","0","49.35","30.83"
"65","000","00","030","0039","1416","578","377","201","9","587","1175","0","49.96","32.09"
"65","000","00","030","0040","0000","1240","766","474","18","1258","2778","0","45.28","27.57"
"65","000","00","030","0040","1419","583","366","217","10","593","1303","0","45.51","28.09"
"65","000","00","030","0040","1420","657","400","257","8","665","1475","0","45.08","27.12"
"65","000","00","030","0041","0000","142","61","81","0","142","310","0","45.81","19.68"
"65","000","00","030","0041","1423","142","61","81","0","142","310","0","45.81","19.68"
"65","000","00","030","0042","0000","1888","1133","755","28","1916","4421","0","43.34","25.63"
"65","000","00","030","0042","1424","587","344","243","8","595","1407","0","42.29","24.45"
"65","000","00","030","0042","1425","660","407","253","10","670","1499","0","44.70","27.15"
"65","000","00","030","0042","1426","641","382","259","10","651","1515","0","42.97","25.21"
"65","000","00","030","0043","0000","964","550","414","11","975","2183","0","44.66","25.19"
"65","000","00","030","0043","1427","648","382","266","5","653","1416","0","46.12","26.98"
"65","000","00","030","0043","1428","316","168","148","6","322","767","0","41.98","21.90"
"65","000","00","030","0044","0000","1622","879","743","10","1632","6944","0","23.50","12.66"
"65","000","00","030","0044","1432","601","326","275","6","607","4669","0","13.00","6.98"
"65","000","00","030","0044","1433","487","249","238","1","488","1164","0","41.92","21.39"
"65","000","00","030","0044","1434","534","304","230","3","537","1111","0","48.33","27.36"
"65","000","00","030","0045","0000","2083","1166","917","9","2092","4423","0","47.30","26.36"
"65","000","00","030","0045","1441","782","519","263","4","786","1561","0","50.35","33.25"
"65","000","00","030","0045","1442","701","328","373","3","704","1526","0","46.13","21.49"
"65","000","00","030","0045","1443","600","319","281","2","602","1336","0","45.06","23.88"
"65","000","00","030","0046","0000","1893","1087","806","30","1923","3949","0","48.70","27.53"
"65","000","00","030","0046","1444","534","319","215","12","546","1030","0","53.01","30.97"
"65","000","00","030","0046","1445","781","408","373","9","790","1704","0","46.36","23.94"
"65","000","00","030","0046","1446","578","360","218","9","587","1215","0","48.31","29.63"
"65","000","00","030","0047","0000","2382","1438","944","28","2410","4885","0","49.33","29.44"
"65","000","00","030","0047","1447","555","334","221","8","563","1167","0","48.24","28.62"
"65","000","00","030","0047","1448","827","510","317","8","835","1779","0","46.94","28.67"
"65","000","00","030","0047","1449","555","337","218","4","559","959","0","58.29","35.14"
"65","000","00","030","0047","1450","445","257","188","8","453","980","0","46.22","26.22"
"65","000","00","030","0048","0000","1540","886","654","19","1559","3210","0","48.57","27.60"
"65","000","00","030","0048","1451","753","427","326","9","762","1579","0","48.26","27.04"
"65","000","00","030","0048","1452","787","459","328","10","797","1631","0","48.87","28.14"
"65","000","00","030","0049","0000","2374","1427","947","29","2403","5145","0","46.71","27.74"
"65","000","00","030","0049","1453","881","546","335","13","894","1905","0","46.93","28.66"
"65","000","00","030","0049","1454","730","436","294","10","740","1566","0","47.25","27.84"
"65","000","00","030","0049","1455","763","445","318","6","769","1674","0","45.94","26.58"
"65","000","00","030","0050","0000","2192","1307","885","28","2220","4350","0","51.03","30.05"
"65","000","00","030","0050","1456","443","259","184","6","449","898","0","50.00","28.84"
"65","000","00","030","0050","1457","631","420","211","8","639","1199","0","53.29","35.03"
"65","000","00","030","0050","1458","640","355","285","7","647","1298","0","49.85","27.35"
"65","000","00","030","0050","1459","478","273","205","7","485","955","0","50.79","28.59"
"65","000","00","030","0051","0000","1615","952","663","18","1633","3381","0","48.30","28.16"
"65","000","00","030","0051","1460","937","544","393","8","945","1932","0","48.91","28.16"
"65","000","00","030","0051","1461","678","408","270","10","688","1449","0","47.48","28.16"
"65","000","00","030","0052","0000","2112","1124","988","22","2134","4740","0","45.02","23.71"
"65","000","00","030","0052","1462","718","354","364","9","727","1540","0","47.21","22.99"
"65","000","00","030","0052","1463","628","361","267","6","634","1506","0","42.10","23.97"
"65","000","00","030","0052","1464","766","409","357","7","773","1694","0","45.63","24.14"
"65","000","00","030","0053","0000","948","573","375","10","958","1986","0","48.24","28.85"
"65","000","00","030","0053","1465","472","300","172","4","476","995","0","47.84","30.15"
"65","000","00","030","0053","1466","476","273","203","6","482","991","0","48.64","27.55"
"65","000","00","030","0054","0000","277","117","160","4","281","699","0","40.20","16.74"
"65","000","00","030","0054","1467","277","117","160","4","281","699","0","40.20","16.74"
"65","000","00","030","0055","0000","3452","1753","1699","26","3478","7243","0","48.02","24.20"
"65","000","00","030","0055","1468","643","269","374","4","647","1509","0","42.88","17.83"
"65","000","00","030","0055","1469","553","262","291","2","555","1168","0","47.52","22.43"
"65","000","00","030","0055","1470","569","343","226","7","576","1214","0","47.45","28.25"
"65","000","00","030","0055","1471","531","311","220","6","537","1077","0","49.86","28.88"
"65","000","00","030","0055","1472","318","156","162","3","321","626","0","51.28","24.92"
"65","000","00","030","0055","1473","838","412","426","4","842","1649","0","51.06","24.98"
"65","000","00","030","0056","0000","1081","447","634","8","1089","2221","0","49.03","20.13"
"65","000","00","030","0056","1474","524","225","299","3","527","1072","0","49.16","20.99"
"65","000","00","030","0056","1475","557","222","335","5","562","1149","0","48.91","19.32"
"65","000","00","030","0057","0000","2431","1172","1259","23","2454","5500","0","44.62","21.31"
"65","000","00","030","0057","1476","595","278","317","2","597","1288","0","46.35","21.58"
"65","000","00","030","0057","1477","688","308","380","8","696","1586","0","43.88","19.42"
"65","000","00","030","0057","1478","639","319","320","8","647","1446","0","44.74","22.06"
"65","000","00","030","0057","1479","509","267","242","5","514","1180","0","43.56","22.63"
"65","000","00","030","0058","0000","1111","534","577","10","1121","2534","0","44.24","21.07"
"65","000","00","030","0058","1480","645","318","327","4","649","1501","0","43.24","21.19"
"65","000","00","030","0058","1481","466","216","250","6","472","1033","0","45.69","20.91"
"65","000","00","030","0059","0000","2037","923","1114","22","2059","4552","0","45.23","20.28"
"65","000","00","030","0059","1482","627","298","329","4","631","1472","0","42.87","20.24"
"65","000","00","030","0059","1483","669","265","404","10","679","1531","0","44.35","17.31"
"65","000","00","030","0059","1484","741","360","381","8","749","1549","0","48.35","23.24"
"65","000","00","030","0060","0000","1467","694","773","19","1486","3544","0","41.93","19.58"
"65","000","00","030","0060","1485","696","338","358","6","702","1717","0","40.89","19.69"
"65","000","00","030","0060","1486","771","356","415","13","784","1827","0","42.91","19.49"
"65","000","00","030","0061","0000","1972","913","1059","17","1989","4463","0","44.57","20.46"
"65","000","00","030","0061","1487","641","274","367","8","649","1392","0","46.62","19.68"
"65","000","00","030","0061","1488","674","322","352","6","680","1478","0","46.01","21.79"
"65","000","00","030","0061","1489","657","317","340","3","660","1593","0","41.43","19.90"
"65","000","00","030","0062","0000","1710","758","952","12","1722","4026","0","42.77","18.83"
"65","000","00","030","0062","1490","562","236","326","5","567","1213","0","46.74","19.46"
"65","000","00","030","0062","1491","607","299","308","4","611","1502","0","40.68","19.91"
"65","000","00","030","0062","1492","541","223","318","3","544","1311","0","41.50","17.01"
"65","000","00","030","0063","0000","979","522","457","10","989","2090","0","47.32","24.98"
"65","000","00","030","0063","1493","508","246","262","4","512","1121","0","45.67","21.94"
"65","000","00","030","0063","1494","471","276","195","6","477","969","0","49.23","28.48"
"65","000","00","030","0064","0000","1832","840","992","11","1843","3932","0","46.87","21.36"
"65","000","00","030","0064","1495","618","274","344","2","620","1246","0","49.76","21.99"
"65","000","00","030","0064","1496","589","281","308","4","593","1309","0","45.30","21.47"
"65","000","00","030","0064","1497","625","285","340","5","630","1377","0","45.75","20.70"
"65","000","00","030","0065","0000","1303","611","692","11","1314","2811","0","46.74","21.74"
"65","000","00","030","0065","1498","624","289","335","2","626","1324","0","47.28","21.83"
"65","000","00","030","0065","1499","679","322","357","9","688","1487","0","46.27","21.65"
"65","000","00","030","0066","0000","1855","823","1032","17","1872","4374","0","42.80","18.82"
"65","000","00","030","0066","1500","632","301","331","6","638","1485","0","42.96","20.27"
"65","000","00","030","0066","1501","630","245","385","7","637","1525","0","41.77","16.07"
"65","000","00","030","0066","1502","593","277","316","4","597","1364","0","43.77","20.31"
"65","000","00","030","0067","0000","1818","928","890","24","1842","4038","0","45.62","22.98"
"65","000","00","030","0067","1503","625","310","315","8","633","1378","0","45.94","22.50"
"65","000","00","030","0067","1504","589","258","331","9","598","1441","0","41.50","17.90"
"65","000","00","030","0067","1505","604","360","244","7","611","1219","0","50.12","29.53"
"65","000","00","030","0068","0000","1745","848","897","29","1774","3746","0","47.36","22.64"
"65","000","00","030","0068","1506","827","402","425","17","844","1768","0","47.74","22.74"
"65","000","00","030","0068","1507","547","253","294","2","549","1137","0","48.28","22.25"
"65","000","00","030","0068","1508","371","193","178","10","381","841","0","45.30","22.95"
"65","000","00","030","0069","0000","1590","808","782","18","1608","3413","0","47.11","23.67"
"65","000","00","030","0069","1509","698","338","360","8","706","1505","0","46.91","22.46"
"65","000","00","030","0069","1510","892","470","422","10","902","1908","0","47.27","24.63"
"65","000","00","030","0070","0000","1950","1274","676","24","1974","3950","0","49.97","32.25"
"65","000","00","030","0070","1511","648","407","241","9","657","1394","0","47.13","29.20"
"65","000","00","030","0070","1512","557","302","255","8","565","1177","0","48.00","25.66"
"65","000","00","030","0070","1513","745","565","180","7","752","1379","0","54.53","40.97"
"65","000","00","030","0071","0000","1430","640","790","19","1449","3434","0","42.20","18.64"
"65","000","00","030","0071","1514","459","176","283","9","468","1043","0","44.87","16.87"
"65","000","00","030","0071","1515","462","201","261","6","468","1185","0","39.49","16.96"
"65","000","00","030","0071","1516","509","263","246","4","513","1206","0","42.54","21.81"
"65","000","00","030","0072","0000","1466","920","546","16","1482","3329","0","44.52","27.64"
"65","000","00","030","0072","1573","493","298","195","6","499","1122","0","44.47","26.56"
"65","000","00","030","0072","1574","490","292","198","6","496","1152","0","43.06","25.35"
"65","000","00","030","0072","1575","483","330","153","4","487","1055","0","46.16","31.28"
"65","000","00","030","0073","0000","2813","1578","1235","27","2840","5696","0","49.86","27.70"
"65","000","00","030","0073","1339","968","582","386","11","979","1975","0","49.57","29.47"
"65","000","00","030","0073","1340","861","483","378","6","867","1730","0","50.12","27.92"
"65","000","00","030","0073","1341","984","513","471","10","994","1991","0","49.92","25.77"
"65","000","00","030","0074","0000","863","526","337","13","876","1721","0","50.90","30.56"
"65","000","00","030","0074","1533","863","526","337","13","876","1721","0","50.90","30.56"
"65","000","00","030","0075","0000","1976","1195","781","31","2007","3886","0","51.65","30.75"
"65","000","00","030","0075","1539","569","361","208","6","575","1086","0","52.95","33.24"
"65","000","00","030","0075","1540","737","415","322","17","754","1443","0","52.25","28.76"
"65","000","00","030","0075","1541","670","419","251","8","678","1357","0","49.96","30.88"
"65","000","00","030","0076","0000","1190","639","551","15","1205","2405","0","50.10","26.57"
"65","000","00","030","0076","1556","643","322","321","11","654","1325","0","49.36","24.30"
"65","000","00","030","0076","1557","547","317","230","4","551","1080","0","51.02","29.35"
"65","000","00","030","0077","0000","1008","633","375","12","1020","2226","0","45.82","28.44"
"65","000","00","030","0077","1571","446","316","130","6","452","1062","0","42.56","29.76"
"65","000","00","030","0077","1572","562","317","245","6","568","1164","0","48.80","27.23"
"65","000","00","030","0078","0000","1250","761","489","20","1270","2756","0","46.08","27.61"
"65","000","00","030","0078","1417","625","357","268","12","637","1417","0","44.95","25.19"
"65","000","00","030","0078","1418","625","404","221","8","633","1339","0","47.27","30.17"
"65","000","00","030","0079","0000","932","543","389","15","947","1883","0","50.29","28.84"
"65","000","00","030","0079","1421","417","244","173","7","424","859","0","49.36","28.41"
"65","000","00","030","0079","1422","515","299","216","8","523","1024","0","51.07","29.20"
"65","000","00","030","0080","0000","1671","1084","587","20","1691","3773","0","44.82","28.73"
"65","000","00","030","0080","1429","627","388","239","5","632","1367","0","46.23","28.38"
"65","000","00","030","0080","1430","585","402","183","9","594","1399","0","42.46","28.73"
"65","000","00","030","0080","1431","459","294","165","6","465","1007","0","46.18","29.20"
"65","000","00","030","0081","0000","2646","1512","1134","24","2670","5825","0","45.84","25.96"
"65","000","00","030","0081","1435","660","372","288","4","664","1461","0","45.45","25.46"
"65","000","00","030","0081","1436","672","408","264","8","680","1506","0","45.15","27.09"
"65","000","00","030","0081","1437","625","336","289","4","629","1436","0","43.80","23.40"
"65","000","00","030","0081","1438","689","396","293","8","697","1422","0","49.02","27.85"
"65","000","00","030","0082","0000","1192","723","469","6","1198","2623","0","45.67","27.56"
"65","000","00","030","0082","1439","638","390","248","3","641","1345","0","47.66","29.00"
"65","000","00","030","0082","1440","554","333","221","3","557","1278","0","43.58","26.06"
"65","000","00","030","0083","0000","998","480","518","10","1008","2395","0","42.09","20.04"
"65","000","00","030","0083","1392","443","196","247","6","449","1007","0","44.59","19.46"
"65","000","00","030","0083","1393","555","284","271","4","559","1388","0","40.27","20.46"
"65","000","00","030","0084","0000","2038","1055","983","23","2061","4326","0","47.64","24.39"
"65","000","00","030","0084","1394","654","334","320","9","663","1428","0","46.43","23.39"
"65","000","00","030","0084","1395","621","269","352","2","623","1216","0","51.23","22.12"
"65","000","00","030","0084","1396","763","452","311","12","775","1682","0","46.08","26.87"
"65","000","00","030","0085","0000","1552","790","762","18","1570","3643","0","43.10","21.69"
"65","000","00","030","0085","1517","553","299","254","10","563","1304","0","43.17","22.93"
"65","000","00","030","0085","1518","423","202","221","2","425","1032","0","41.18","19.57"
"65","000","00","030","0085","1519","576","289","287","6","582","1307","0","44.53","22.11"
"65","000","00","030","0086","0000","1484","679","805","19","1503","3432","0","43.79","19.78"
"65","000","00","030","0086","1520","754","338","416","10","764","1751","0","43.63","19.30"
"65","000","00","030","0086","1521","730","341","389","9","739","1681","0","43.96","20.29"
"65","000","00","030","0087","0000","1176","574","602","8","1184","2486","0","47.63","23.09"
"65","000","00","030","0087","1522","573","283","290","3","576","1178","0","48.90","24.02"
"65","000","00","030","0087","1523","603","291","312","5","608","1308","0","46.48","22.25"
"65","000","00","030","0088","0000","1357","618","739","14","1371","3236","0","42.37","19.10"
"65","000","00","030","0088","1524","627","283","344","5","632","1443","0","43.80","19.61"
"65","000","00","030","0088","1525","730","335","395","9","739","1793","0","41.22","18.68"
"65","000","00","030","0089","0000","1507","708","799","10","1517","3862","0","39.28","18.33"
"65","000","00","030","0089","1526","441","217","224","0","441","1199","0","36.78","18.10"
"65","000","00","030","0089","1527","528","238","290","6","534","1339","0","39.88","17.77"
"65","000","00","030","0089","1528","538","253","285","4","542","1324","0","40.94","19.11"
"65","000","00","030","0090","0000","1454","651","803","15","1469","2946","0","49.86","22.10"
"65","000","00","030","0090","1529","738","297","441","10","748","1578","0","47.40","18.82"
"65","000","00","030","0090","1530","716","354","362","5","721","1368","0","52.70","25.88"
"65","000","00","030","0091","0000","1312","602","710","17","1329","2987","0","44.49","20.15"
"65","000","00","030","0091","1531","541","249","292","8","549","1233","0","44.53","20.19"
"65","000","00","030","0091","1532","771","353","418","9","780","1754","0","44.47","20.13"
"65","000","00","030","0092","0000","1287","824","463","11","1298","3087","0","42.05","26.69"
"65","000","00","030","0092","1397","670","440","230","5","675","1642","0","41.11","26.80"
"65","000","00","030","0092","1398","617","384","233","6","623","1445","0","43.11","26.57"
"65","000","00","030","0093","0000","1174","633","541","3","1177","2564","0","45.90","24.69"
"65","000","00","030","0093","1337","554","269","285","2","556","1190","0","46.72","22.61"
"65","000","00","030","0093","1338","620","364","256","1","621","1374","0","45.20","26.49"
"65","000","00","040","0000","0000","88923","52597","36326","886","89809","186020","217795","48.28","28.27"
"65","000","00","040","0001","0000","1369","793","576","10","1379","2917","0","47.27","27.19"
"65","000","00","040","0001","1588","695","388","307","9","704","1488","0","47.31","26.08"
"65","000","00","040","0001","1589","674","405","269","1","675","1429","0","47.24","28.34"
"65","000","00","040","0002","0000","1189","722","467","11","1200","2476","0","48.47","29.16"
"65","000","00","040","0002","1706","579","348","231","3","582","1187","0","49.03","29.32"
"65","000","00","040","0002","1707","610","374","236","8","618","1289","0","47.94","29.01"
"65","000","00","040","0003","0000","1555","948","607","22","1577","4502","0","35.03","21.06"
"65","000","00","040","0003","1597","770","476","294","13","783","1554","0","50.39","30.63"
"65","000","00","040","0003","1598","785","472","313","9","794","2948","0","26.93","16.01"
"65","000","00","040","0004","0000","1335","813","522","15","1350","2581","0","52.31","31.50"
"65","000","00","040","0004","1599","597","369","228","8","605","1196","0","50.59","30.85"
"65","000","00","040","0004","1600","738","444","294","7","745","1385","0","53.79","32.06"
"65","000","00","040","0005","0000","1229","720","509","13","1242","2419","0","51.34","29.76"
"65","000","00","040","0005","1704","631","372","259","5","636","1192","0","53.36","31.21"
"65","000","00","040","0005","1705","598","348","250","8","606","1227","0","49.39","28.36"
"65","000","00","040","0006","0000","1465","829","636","22","1487","2938","0","50.61","28.22"
"65","000","00","040","0006","1607","772","435","337","11","783","1501","0","52.17","28.98"
"65","000","00","040","0006","1608","693","394","299","11","704","1437","0","48.99","27.42"
"65","000","00","040","0007","0000","1243","728","515","7","1250","2396","0","52.17","30.38"
"65","000","00","040","0007","1609","656","394","262","1","657","1231","0","53.37","32.01"
"65","000","00","040","0007","1610","587","334","253","6","593","1165","0","50.90","28.67"
"65","000","00","040","0008","0000","1063","645","418","10","1073","2525","0","42.50","25.54"
"65","000","00","040","0008","1645","527","333","194","6","533","1230","0","43.33","27.07"
"65","000","00","040","0008","1646","536","312","224","4","540","1295","0","41.70","24.09"
"65","000","00","040","0009","0000","411","321","90","5","416","876","0","47.49","36.64"
"65","000","00","040","0009","1702","411","321","90","5","416","876","0","47.49","36.64"
"65","000","00","040","0010","0000","347","278","69","5","352","704","0","50.00","39.49"
"65","000","00","040","0010","1703","347","278","69","5","352","704","0","50.00","39.49"
"65","000","00","040","0011","0000","1979","1146","833","19","1998","4085","0","48.91","28.05"
"65","000","00","040","0011","1616","731","423","308","8","739","1460","0","50.62","28.97"
"65","000","00","040","0011","1617","640","390","250","5","645","1244","0","51.85","31.35"
"65","000","00","040","0011","1618","608","333","275","6","614","1381","0","44.46","24.11"
"65","000","00","040","0012","0000","1720","881","839","12","1732","3437","0","50.39","25.63"
"65","000","00","040","0012","1629","860","418","442","7","867","1708","0","50.76","24.47"
"65","000","00","040","0012","1630","860","463","397","5","865","1729","0","50.03","26.78"
"65","000","00","040","0013","0000","3045","1717","1328","33","3078","6137","0","50.15","27.98"
"65","000","00","040","0013","1686","745","375","370","6","751","1585","0","47.38","23.66"
"65","000","00","040","0013","1687","777","456","321","8","785","1539","0","51.01","29.63"
"65","000","00","040","0013","1688","790","462","328","4","794","1494","0","53.15","30.92"
"65","000","00","040","0013","1689","733","424","309","15","748","1519","0","49.24","27.91"
"65","000","00","040","0014","0000","2117","1163","954","22","2139","4473","0","47.82","26.00"
"65","000","00","040","0014","1683","743","416","327","7","750","1518","0","49.41","27.40"
"65","000","00","040","0014","1684","700","403","297","8","708","1477","0","47.94","27.29"
"65","000","00","040","0014","1685","674","344","330","7","681","1478","0","46.08","23.27"
"65","000","00","040","0015","0000","1873","1142","731","14","1887","3634","0","51.93","31.43"
"65","000","00","040","0015","1661","640","392","248","5","645","1213","0","53.17","32.32"
"65","000","00","040","0015","1662","544","331","213","5","549","1102","0","49.82","30.04"
"65","000","00","040","0015","1663","689","419","270","4","693","1319","0","52.54","31.77"
"65","000","00","040","0016","0000","1935","1159","776","18","1953","3986","0","49.00","29.08"
"65","000","00","040","0016","1622","629","393","236","8","637","1279","0","49.80","30.73"
"65","000","00","040","0016","1623","659","378","281","7","666","1308","0","50.92","28.90"
"65","000","00","040","0016","1624","647","388","259","3","650","1399","0","46.46","27.73"
"65","000","00","040","0017","0000","1836","1081","755","13","1849","3852","0","48.00","28.06"
"65","000","00","040","0017","1619","649","386","263","5","654","1325","0","49.36","29.13"
"65","000","00","040","0017","1620","707","435","272","6","713","1462","0","48.77","29.75"
"65","000","00","040","0017","1621","480","260","220","2","482","1065","0","45.26","24.41"
"65","000","00","040","0018","0000","1307","762","545","17","1324","2760","0","47.97","27.61"
"65","000","00","040","0018","1591","600","352","248","7","607","1248","0","48.64","28.21"
"65","000","00","040","0018","1592","707","410","297","10","717","1512","0","47.42","27.12"
"65","000","00","040","0019","0000","491","226","265","4","495","1091","0","45.37","20.71"
"65","000","00","040","0019","1590","491","226","265","4","495","1091","0","45.37","20.71"
"65","000","00","040","0020","0000","1518","834","684","16","1534","3358","0","45.68","24.84"
"65","000","00","040","0020","1625","761","462","299","9","770","1653","0","46.58","27.95"
"65","000","00","040","0020","1626","757","372","385","7","764","1705","0","44.81","21.82"
"65","000","00","040","0021","0000","1195","667","528","10","1205","2545","0","47.35","26.21"
"65","000","00","040","0021","1627","589","313","276","2","591","1259","0","46.94","24.86"
"65","000","00","040","0021","1628","606","354","252","8","614","1286","0","47.74","27.53"
"65","000","00","040","0022","0000","783","430","353","6","789","1702","0","46.36","25.26"
"65","000","00","040","0022","1712","374","212","162","2","376","855","0","43.98","24.80"
"65","000","00","040","0022","1713","409","218","191","4","413","847","0","48.76","25.74"
"65","000","00","040","0023","0000","1499","937","562","14","1513","3222","0","46.96","29.08"
"65","000","00","040","0023","1582","782","491","291","7","789","1691","0","46.66","29.04"
"65","000","00","040","0023","1583","717","446","271","7","724","1531","0","47.29","29.13"
"65","000","00","040","0024","0000","1761","1027","734","18","1779","3413","0","52.12","30.09"
"65","000","00","040","0024","1671","896","554","342","11","907","1726","0","52.55","32.10"
"65","000","00","040","0024","1672","865","473","392","7","872","1687","0","51.69","28.04"
"65","000","00","040","0025","0000","1663","991","672","19","1682","3354","0","50.15","29.55"
"65","000","00","040","0025","1673","563","320","243","2","565","1124","0","50.27","28.47"
"65","000","00","040","0025","1674","547","317","230","7","554","1124","0","49.29","28.20"
"65","000","00","040","0025","1675","553","354","199","10","563","1106","0","50.90","32.01"
"65","000","00","040","0026","0000","1787","1045","742","17","1804","3469","0","52.00","30.12"
"65","000","00","040","0026","1666","614","383","231","6","620","1158","0","53.54","33.07"
"65","000","00","040","0026","1667","545","322","223","4","549","1137","0","48.28","28.32"
"65","000","00","040","0026","1668","628","340","288","7","635","1174","0","54.09","28.96"
"65","000","00","040","0027","0000","1272","726","546","10","1282","2623","0","48.88","27.68"
"65","000","00","040","0027","1669","612","335","277","5","617","1297","0","47.57","25.83"
"65","000","00","040","0027","1670","660","391","269","5","665","1326","0","50.15","29.49"
"65","000","00","040","0028","0000","1381","842","539","12","1393","2995","0","46.51","28.11"
"65","000","00","040","0028","1716","757","466","291","8","765","1605","0","47.66","29.03"
"65","000","00","040","0028","1717","624","376","248","4","628","1390","0","45.18","27.05"
"65","000","00","040","0029","0000","1115","648","467","20","1135","2205","0","51.47","29.39"
"65","000","00","040","0029","1714","597","361","236","8","605","1216","0","49.75","29.69"
"65","000","00","040","0029","1715","518","287","231","12","530","989","0","53.59","29.02"
"65","000","00","040","0030","0000","1975","1264","711","20","1995","3956","0","50.43","31.95"
"65","000","00","040","0030","1653","670","423","247","15","685","1326","0","51.66","31.90"
"65","000","00","040","0030","1654","630","398","232","0","630","1326","0","47.51","30.02"
"65","000","00","040","0030","1655","675","443","232","5","680","1304","0","52.15","33.97"
"65","000","00","040","0031","0000","2000","1266","734","29","2029","4105","0","49.43","30.84"
"65","000","00","040","0031","1649","473","304","169","6","479","989","0","48.43","30.74"
"65","000","00","040","0031","1650","507","331","176","5","512","997","0","51.35","33.20"
"65","000","00","040","0031","1651","550","348","202","11","561","1118","0","50.18","31.13"
"65","000","00","040","0031","1652","470","283","187","7","477","1001","0","47.65","28.27"
"65","000","00","040","0032","0000","1151","684","467","14","1165","2298","0","50.70","29.77"
"65","000","00","040","0032","1659","581","344","237","8","589","1158","0","50.86","29.71"
"65","000","00","040","0032","1660","570","340","230","6","576","1140","0","50.53","29.82"
"65","000","00","040","0033","0000","2025","1106","919","23","2048","4115","0","49.77","26.88"
"65","000","00","040","0033","1680","610","365","245","12","622","1309","0","47.52","27.88"
"65","000","00","040","0033","1681","691","372","319","4","695","1348","0","51.56","27.60"
"65","000","00","040","0033","1682","724","369","355","7","731","1458","0","50.14","25.31"
"65","000","00","040","0034","0000","1508","861","647","11","1519","3433","0","44.25","25.08"
"65","000","00","040","0034","1638","764","430","334","9","773","1669","0","46.32","25.76"
"65","000","00","040","0034","1639","744","431","313","2","746","1764","0","42.29","24.43"
"65","000","00","040","0035","0000","2051","1285","766","21","2072","4047","0","51.20","31.75"
"65","000","00","040","0035","1642","665","442","223","4","669","1297","0","51.58","34.08"
"65","000","00","040","0035","1643","748","471","277","13","761","1430","0","53.22","32.94"
"65","000","00","040","0035","1644","638","372","266","4","642","1320","0","48.64","28.18"
"65","000","00","040","0036","0000","713","426","287","5","718","1527","0","47.02","27.90"
"65","000","00","040","0036","1578","713","426","287","5","718","1527","0","47.02","27.90"
"65","000","00","040","0037","0000","1040","647","393","8","1048","2119","0","49.46","30.53"
"65","000","00","040","0037","1580","510","306","204","4","514","1041","0","49.38","29.39"
"65","000","00","040","0037","1581","530","341","189","4","534","1078","0","49.54","31.63"
"65","000","00","040","0038","0000","2203","1343","860","17","2220","4495","0","49.39","29.88"
"65","000","00","040","0038","1601","736","442","294","9","745","1473","0","50.58","30.01"
"65","000","00","040","0038","1602","684","424","260","3","687","1437","0","47.81","29.51"
"65","000","00","040","0038","1603","783","477","306","5","788","1585","0","49.72","30.09"
"65","000","00","040","0039","0000","1934","1233","701","21","1955","3718","0","52.58","33.16"
"65","000","00","040","0039","1604","677","426","251","7","684","1293","0","52.90","32.95"
"65","000","00","040","0039","1605","635","423","212","5","640","1201","0","53.29","35.22"
"65","000","00","040","0039","1606","622","384","238","9","631","1224","0","51.55","31.37"
"65","000","00","040","0040","0000","1219","724","495","16","1235","2845","0","43.41","25.45"
"65","000","00","040","0040","1647","616","374","242","7","623","1470","0","42.38","25.44"
"65","000","00","040","0040","1648","603","350","253","9","612","1375","0","44.51","25.45"
"65","000","00","040","0041","0000","382","269","113","6","388","809","0","47.96","33.25"
"65","000","00","040","0041","1701","382","269","113","6","388","809","0","47.96","33.25"
"65","000","00","040","0042","0000","443","318","125","3","446","907","0","49.17","35.06"
"65","000","00","040","0042","1700","443","318","125","3","446","907","0","49.17","35.06"
"65","000","00","040","0043","0000","911","572","339","8","919","1894","0","48.52","30.20"
"65","000","00","040","0043","1676","911","572","339","8","919","1894","0","48.52","30.20"
"65","000","00","040","0044","0000","1939","1114","825","21","1960","4232","0","46.31","26.32"
"65","000","00","040","0044","1677","707","387","320","7","714","1472","0","48.51","26.29"
"65","000","00","040","0044","1678","599","333","266","6","605","1293","0","46.79","25.75"
"65","000","00","040","0044","1679","633","394","239","8","641","1467","0","43.69","26.86"
"65","000","00","040","0045","0000","1011","602","409","12","1023","1996","0","51.25","30.16"
"65","000","00","040","0045","1718","533","306","227","5","538","1030","0","52.23","29.71"
"65","000","00","040","0045","1719","478","296","182","7","485","966","0","50.21","30.64"
"65","000","00","040","0046","0000","1907","1077","830","23","1930","3972","0","48.59","27.11"
"65","000","00","040","0046","1697","642","358","284","6","648","1347","0","48.11","26.58"
"65","000","00","040","0046","1698","610","336","274","11","621","1339","0","46.38","25.09"
"65","000","00","040","0046","1699","655","383","272","6","661","1286","0","51.40","29.78"
"65","000","00","040","0047","0000","2094","1216","878","24","2118","4293","0","49.34","28.33"
"65","000","00","040","0047","1613","755","438","317","13","768","1595","0","48.15","27.46"
"65","000","00","040","0047","1614","603","358","245","6","609","1193","0","51.05","30.01"
"65","000","00","040","0047","1615","736","420","316","5","741","1505","0","49.24","27.91"
"65","000","00","040","0048","0000","1326","777","549","8","1334","2797","0","47.69","27.78"
"65","000","00","040","0048","1611","624","382","242","5","629","1365","0","46.08","27.99"
"65","000","00","040","0048","1612","702","395","307","3","705","1432","0","49.23","27.58"
"65","000","00","040","0049","0000","1614","926","688","6","1620","3428","0","47.26","27.01"
"65","000","00","040","0049","1635","501","284","217","0","501","1082","0","46.30","26.25"
"65","000","00","040","0049","1636","535","302","233","4","539","1133","0","47.57","26.65"
"65","000","00","040","0049","1637","578","340","238","2","580","1213","0","47.82","28.03"
"65","000","00","040","0050","0000","1073","637","436","12","1085","2304","0","47.09","27.65"
"65","000","00","040","0050","1631","610","371","239","5","615","1240","0","49.60","29.92"
"65","000","00","040","0050","1632","463","266","197","7","470","1064","0","44.17","25.00"
"65","000","00","040","0051","0000","1522","988","534","12","1534","3036","0","50.53","32.54"
"65","000","00","040","0051","1586","773","491","282","4","777","1504","0","51.66","32.65"
"65","000","00","040","0051","1587","749","497","252","8","757","1532","0","49.41","32.44"
"65","000","00","040","0052","0000","465","302","163","4","469","1031","0","45.49","29.29"
"65","000","00","040","0052","1579","465","302","163","4","469","1031","0","45.49","29.29"
"65","000","00","040","0053","0000","925","558","367","17","942","1963","0","47.99","28.43"
"65","000","00","040","0053","1595","502","296","206","9","511","1061","0","48.16","27.90"
"65","000","00","040","0053","1596","423","262","161","8","431","902","0","47.78","29.05"
"65","000","00","040","0054","0000","1286","774","512","14","1300","2764","0","47.03","28.00"
"65","000","00","040","0054","1593","623","360","263","4","627","1360","0","46.10","26.47"
"65","000","00","040","0054","1594","663","414","249","10","673","1404","0","47.93","29.49"
"65","000","00","040","0055","0000","1492","956","536","16","1508","3259","0","46.27","29.33"
"65","000","00","040","0055","1584","807","496","311","8","815","1714","0","47.55","28.94"
"65","000","00","040","0055","1585","685","460","225","8","693","1545","0","44.85","29.77"
"65","000","00","040","0056","0000","1642","971","671","10","1652","3607","0","45.80","26.92"
"65","000","00","040","0056","1656","494","285","209","1","495","1158","0","42.75","24.61"
"65","000","00","040","0056","1657","537","320","217","7","544","1206","0","45.11","26.53"
"65","000","00","040","0056","1658","611","366","245","2","613","1243","0","49.32","29.44"
"65","000","00","040","0057","0000","1156","676","480","10","1166","2350","0","49.62","28.77"
"65","000","00","040","0057","1708","677","406","271","7","684","1355","0","50.48","29.96"
"65","000","00","040","0057","1709","479","270","209","3","482","995","0","48.44","27.14"
"65","000","00","040","0058","0000","899","469","430","9","908","1783","0","50.93","26.30"
"65","000","00","040","0058","1710","418","203","215","6","424","831","0","51.02","24.43"
"65","000","00","040","0058","1711","481","266","215","3","484","952","0","50.84","27.94"
"65","000","00","040","0059","0000","1153","677","476","14","1167","2527","0","46.18","26.79"
"65","000","00","040","0059","1640","544","312","232","8","552","1274","0","43.33","24.49"
"65","000","00","040","0059","1641","609","365","244","6","615","1253","0","49.08","29.13"
"65","000","00","040","0060","0000","1268","734","534","11","1279","2627","0","48.69","27.94"
"65","000","00","040","0060","1633","628","373","255","6","634","1349","0","47.00","27.65"
"65","000","00","040","0060","1634","640","361","279","5","645","1278","0","50.47","28.25"
"65","000","00","040","0061","0000","978","517","461","11","989","2095","0","47.21","24.68"
"65","000","00","040","0061","1664","489","264","225","7","496","1049","0","47.28","25.17"
"65","000","00","040","0061","1665","489","253","236","4","493","1046","0","47.13","24.19"
"65","000","00","040","0062","0000","4135","2407","1728","36","4171","9013","0","46.28","26.71"
"65","000","00","040","0062","1690","499","244","255","9","508","1184","0","42.91","20.61"
"65","000","00","040","0062","1691","622","355","267","2","624","1333","0","46.81","26.63"
"65","000","00","040","0062","1692","623","353","270","5","628","1296","0","48.46","27.24"
"65","000","00","040","0062","1693","522","323","199","4","526","1192","0","44.13","27.10"
"65","000","00","040","0062","1694","585","377","208","6","591","1303","0","45.36","28.93"
"65","000","00","040","0062","1695","697","418","279","7","704","1460","0","48.22","28.63"
"65","000","00","040","0062","1696","587","337","250","3","590","1245","0","47.39","27.07"
"65","000","00","050","0000","0000","144817","61045","83772","1312","146129","352098","422668","41.50","17.34"
"65","000","00","050","0001","0000","2119","886","1233","17","2136","4736","0","45.10","18.71"
"65","000","00","050","0001","0346","499","179","320","4","503","1101","0","45.69","16.26"
"65","000","00","050","0001","0347","576","249","327","4","580","1256","0","46.18","19.82"
"65","000","00","050","0001","0348","505","236","269","7","512","1099","0","46.59","21.47"
"65","000","00","050","0001","0349","539","222","317","2","541","1280","0","42.27","17.34"
"65","000","00","050","0002","0000","3570","1518","2052","43","3613","8383","0","43.10","18.11"
"65","000","00","050","0002","0373","571","178","393","10","581","1343","0","43.26","13.25"
"65","000","00","050","0002","0374","620","260","360","5","625","1470","0","42.52","17.69"
"65","000","00","050","0002","0375","573","288","285","7","580","1320","0","43.94","21.82"
"65","000","00","050","0002","0376","628","279","349","8","636","1495","0","42.54","18.66"
"65","000","00","050","0002","0377","549","236","313","4","553","1295","0","42.70","18.22"
"65","000","00","050","0002","0378","629","277","352","9","638","1460","0","43.70","18.97"
"65","000","00","050","0003","0000","561","231","330","2","563","1293","0","43.54","17.87"
"65","000","00","050","0003","0507","561","231","330","2","563","1293","0","43.54","17.87"
"65","000","00","050","0004","0000","1861","755","1106","11","1872","3916","0","47.80","19.28"
"65","000","00","050","0004","0350","591","226","365","3","594","1166","0","50.94","19.38"
"65","000","00","050","0004","0351","509","175","334","4","513","1165","0","44.03","15.02"
"65","000","00","050","0004","0352","761","354","407","4","765","1585","0","48.26","22.33"
"65","000","00","050","0005","0000","2018","913","1105","12","2030","4570","0","44.42","19.98"
"65","000","00","050","0005","0379","679","349","330","5","684","1438","0","47.57","24.27"
"65","000","00","050","0005","0380","567","247","320","5","572","1327","0","43.10","18.61"
"65","000","00","050","0005","0381","772","317","455","2","774","1805","0","42.88","17.56"
"65","000","00","050","0006","0000","1356","547","809","14","1370","3237","0","42.32","16.90"
"65","000","00","050","0006","0504","441","208","233","8","449","1112","0","40.38","18.71"
"65","000","00","050","0006","0505","447","163","284","2","449","1005","0","44.68","16.22"
"65","000","00","050","0006","0506","468","176","292","4","472","1120","0","42.14","15.71"
"65","000","00","050","0007","0000","2050","881","1169","21","2071","4625","0","44.78","19.05"
"65","000","00","050","0007","0356","785","347","438","5","790","1825","0","43.29","19.01"
"65","000","00","050","0007","0357","653","268","385","9","662","1384","0","47.83","19.36"
"65","000","00","050","0007","0358","612","266","346","7","619","1416","0","43.71","18.79"
"65","000","00","050","0008","0000","1739","757","982","12","1751","3906","0","44.83","19.38"
"65","000","00","050","0008","0436","583","258","325","6","589","1353","0","43.53","19.07"
"65","000","00","050","0008","0437","576","246","330","5","581","1320","0","44.02","18.64"
"65","000","00","050","0008","0438","580","253","327","1","581","1233","0","47.12","20.52"
"65","000","00","050","0009","0000","2780","1128","1652","24","2804","6314","0","44.41","17.87"
"65","000","00","050","0009","0562","448","174","274","5","453","1093","0","41.45","15.92"
"65","000","00","050","0009","0563","553","229","324","4","557","1334","0","41.75","17.17"
"65","000","00","050","0009","0564","594","215","379","3","597","1185","0","50.38","18.14"
"65","000","00","050","0009","0565","603","264","339","7","610","1356","0","44.99","19.47"
"65","000","00","050","0009","0566","582","246","336","5","587","1346","0","43.61","18.28"
"65","000","00","050","0010","0000","907","371","536","4","911","1879","0","48.48","19.74"
"65","000","00","050","0010","0359","459","195","264","1","460","941","0","48.88","20.72"
"65","000","00","050","0010","0360","448","176","272","3","451","938","0","48.08","18.76"
"65","000","00","050","0011","0000","2335","983","1352","15","2350","5211","0","45.10","18.86"
"65","000","00","050","0011","0432","571","230","341","2","573","1177","0","48.68","19.54"
"65","000","00","050","0011","0433","535","218","317","3","538","1320","0","40.76","16.52"
"65","000","00","050","0011","0434","476","214","262","3","479","1176","0","40.73","18.20"
"65","000","00","050","0011","0435","753","321","432","7","760","1538","0","49.41","20.87"
"65","000","00","050","0012","0000","1020","410","610","10","1030","2744","0","37.54","14.94"
"65","000","00","050","0012","0581","485","204","281","5","490","1415","0","34.63","14.42"
"65","000","00","050","0012","0582","535","206","329","5","540","1329","0","40.63","15.50"
"65","000","00","050","0013","0000","1404","706","698","16","1420","2917","0","48.68","24.20"
"65","000","00","050","0013","0363","463","210","253","7","470","973","0","48.30","21.58"
"65","000","00","050","0013","0364","507","285","222","2","509","1021","0","49.85","27.91"
"65","000","00","050","0013","0365","434","211","223","7","441","923","0","47.78","22.86"
"65","000","00","050","0014","0000","1818","770","1048","17","1835","4028","0","45.56","19.12"
"65","000","00","050","0014","0443","641","278","363","6","647","1337","0","48.39","20.79"
"65","000","00","050","0014","0444","580","233","347","5","585","1343","0","43.56","17.35"
"65","000","00","050","0014","0445","597","259","338","6","603","1348","0","44.73","19.21"
"65","000","00","050","0015","0000","4302","1818","2484","37","4339","10595","0","40.95","17.16"
"65","000","00","050","0015","0611","486","183","303","3","489","1147","0","42.63","15.95"
"65","000","00","050","0015","0612","521","201","320","2","523","1127","0","46.41","17.83"
"65","000","00","050","0015","0613","651","273","378","10","661","1552","0","42.59","17.59"
"65","000","00","050","0015","0614","455","183","272","3","458","1069","0","42.84","17.12"
"65","000","00","050","0015","0615","426","170","256","3","429","1167","0","36.76","14.57"
"65","000","00","050","0015","0616","590","298","292","5","595","1407","0","42.29","21.18"
"65","000","00","050","0015","0617","583","281","302","3","586","1548","0","37.86","18.15"
"65","000","00","050","0015","0618","590","229","361","8","598","1578","0","37.90","14.51"
"65","000","00","050","0016","0000","1296","570","726","10","1306","5142","0","25.40","11.09"
"65","000","00","050","0016","0366","499","240","259","2","501","1100","0","45.55","21.82"
"65","000","00","050","0016","0367","797","330","467","8","805","4042","0","19.92","8.16"
"65","000","00","050","0017","0000","1565","546","1019","19","1584","3896","0","40.66","14.01"
"65","000","00","050","0017","0446","520","179","341","7","527","1258","0","41.89","14.23"
"65","000","00","050","0017","0447","545","197","348","7","552","1393","0","39.63","14.14"
"65","000","00","050","0017","0448","500","170","330","5","505","1245","0","40.56","13.65"
"65","000","00","050","0018","0000","2026","748","1278","21","2047","5058","0","40.47","14.79"
"65","000","00","050","0018","0510","552","235","317","4","556","1328","0","41.87","17.70"
"65","000","00","050","0018","0511","559","187","372","7","566","1160","0","48.79","16.12"
"65","000","00","050","0018","0512","477","164","313","5","482","1287","0","37.45","12.74"
"65","000","00","050","0018","0513","438","162","276","5","443","1283","0","34.53","12.63"
"65","000","00","050","0019","0000","731","353","378","9","740","1553","0","47.65","22.73"
"65","000","00","050","0019","0368","731","353","378","9","740","1553","0","47.65","22.73"
"65","000","00","050","0020","0000","761","263","498","4","765","1903","0","40.20","13.82"
"65","000","00","050","0020","0469","381","123","258","1","382","967","0","39.50","12.72"
"65","000","00","050","0020","0470","380","140","240","3","383","936","0","40.92","14.96"
"65","000","00","050","0021","0000","2398","915","1483","25","2423","6057","0","40.00","15.11"
"65","000","00","050","0021","0544","586","240","346","7","593","1490","0","39.80","16.11"
"65","000","00","050","0021","0545","629","227","402","7","636","1596","0","39.85","14.22"
"65","000","00","050","0021","0546","594","208","386","8","602","1471","0","40.92","14.14"
"65","000","00","050","0021","0547","589","240","349","3","592","1500","0","39.47","16.00"
"65","000","00","050","0022","0000","663","263","400","10","673","1547","0","43.50","17.00"
"65","000","00","050","0022","0369","663","263","400","10","673","1547","0","43.50","17.00"
"65","000","00","050","0023","0000","2323","943","1380","26","2349","5390","0","43.58","17.50"
"65","000","00","050","0023","0471","538","220","318","6","544","1365","0","39.85","16.12"
"65","000","00","050","0023","0472","542","211","331","7","549","1369","0","40.10","15.41"
"65","000","00","050","0023","0473","644","274","370","8","652","1420","0","45.92","19.30"
"65","000","00","050","0023","0474","599","238","361","5","604","1236","0","48.87","19.26"
"65","000","00","050","0024","0000","854","349","505","11","865","2056","0","42.07","16.97"
"65","000","00","050","0024","0550","409","166","243","6","415","1010","0","41.09","16.44"
"65","000","00","050","0024","0551","445","183","262","5","450","1046","0","43.02","17.50"
"65","000","00","050","0025","0000","1986","772","1214","20","2006","4652","0","43.12","16.60"
"65","000","00","050","0025","0423","521","191","330","2","523","1163","0","44.97","16.42"
"65","000","00","050","0025","0424","482","190","292","9","491","1132","0","43.37","16.78"
"65","000","00","050","0025","0425","474","175","299","4","478","1173","0","40.75","14.92"
"65","000","00","050","0025","0426","509","216","293","5","514","1184","0","43.41","18.24"
"65","000","00","050","0026","0000","837","502","335","12","849","1674","0","50.72","29.99"
"65","000","00","050","0026","0439","393","198","195","4","397","811","0","48.95","24.41"
"65","000","00","050","0026","0440","444","304","140","8","452","863","0","52.38","35.23"
"65","000","00","050","0027","0000","1765","729","1036","26","1791","4664","0","38.40","15.63"
"65","000","00","050","0027","0570","400","157","243","4","404","1146","0","35.25","13.70"
"65","000","00","050","0027","0571","445","166","279","8","453","1091","0","41.52","15.22"
"65","000","00","050","0027","0572","457","192","265","8","465","1206","0","38.56","15.92"
"65","000","00","050","0027","0573","463","214","249","6","469","1221","0","38.41","17.53"
"65","000","00","050","0028","0000","942","353","589","4","946","2389","0","39.60","14.78"
"65","000","00","050","0028","0413","425","156","269","2","427","1153","0","37.03","13.53"
"65","000","00","050","0028","0414","517","197","320","2","519","1236","0","41.99","15.94"
"65","000","00","050","0029","0000","1047","484","563","4","1051","2305","0","45.60","21.00"
"65","000","00","050","0029","0441","542","255","287","1","543","1141","0","47.59","22.35"
"65","000","00","050","0029","0442","505","229","276","3","508","1164","0","43.64","19.67"
"65","000","00","050","0030","0000","1874","781","1093","23","1897","4652","0","40.78","16.79"
"65","000","00","050","0030","0400","435","189","246","4","439","1157","0","37.94","16.34"
"65","000","00","050","0030","0401","421","150","271","6","427","1032","0","41.38","14.53"
"65","000","00","050","0030","0402","511","202","309","5","516","1277","0","40.41","15.82"
"65","000","00","050","0030","0403","507","240","267","8","515","1186","0","43.42","20.24"
"65","000","00","050","0031","0000","1878","846","1032","16","1894","4324","0","43.80","19.57"
"65","000","00","050","0031","0501","653","282","371","8","661","1478","0","44.72","19.08"
"65","000","00","050","0031","0502","637","303","334","4","641","1439","0","44.54","21.06"
"65","000","00","050","0031","0503","588","261","327","4","592","1407","0","42.08","18.55"
"65","000","00","050","0032","0000","1966","869","1097","21","1987","5143","0","38.64","16.90"
"65","000","00","050","0032","0586","436","167","269","4","440","1301","0","33.82","12.84"
"65","000","00","050","0032","0587","560","276","284","5","565","1355","0","41.70","20.37"
"65","000","00","050","0032","0588","485","192","293","9","494","1212","0","40.76","15.84"
"65","000","00","050","0032","0589","485","234","251","3","488","1275","0","38.27","18.35"
"65","000","00","050","0033","0000","1717","616","1101","22","1739","4178","0","41.62","14.74"
"65","000","00","050","0033","0391","489","184","305","5","494","1314","0","37.60","14.00"
"65","000","00","050","0033","0392","538","172","366","11","549","1354","0","40.55","12.70"
"65","000","00","050","0033","0393","690","260","430","6","696","1510","0","46.09","17.22"
"65","000","00","050","0034","0000","1250","482","768","9","1259","3266","0","38.55","14.76"
"65","000","00","050","0034","0495","340","145","195","2","342","982","0","34.83","14.77"
"65","000","00","050","0034","0496","441","179","262","5","446","1154","0","38.65","15.51"
"65","000","00","050","0034","0497","469","158","311","2","471","1130","0","41.68","13.98"
"65","000","00","050","0035","0000","1007","357","650","7","1014","2666","0","38.03","13.39"
"65","000","00","050","0035","0593","538","184","354","5","543","1348","0","40.28","13.65"
"65","000","00","050","0035","0594","469","173","296","2","471","1318","0","35.74","13.13"
"65","000","00","050","0036","0000","1489","565","924","9","1498","3422","0","43.78","16.51"
"65","000","00","050","0036","0370","448","134","314","0","448","1050","0","42.67","12.76"
"65","000","00","050","0036","0371","442","167","275","4","446","1037","0","43.01","16.10"
"65","000","00","050","0036","0372","599","264","335","5","604","1335","0","45.24","19.78"
"65","000","00","050","0037","0000","1475","553","922","18","1493","3451","0","43.26","16.02"
"65","000","00","050","0037","0455","469","166","303","4","473","1202","0","39.35","13.81"
"65","000","00","050","0037","0456","510","181","329","10","520","1157","0","44.94","15.64"
"65","000","00","050","0037","0457","496","206","290","4","500","1092","0","45.79","18.86"
"65","000","00","050","0038","0000","2231","933","1298","22","2253","6136","0","36.72","15.21"
"65","000","00","050","0038","0606","421","183","238","4","425","1263","0","33.65","14.49"
"65","000","00","050","0038","0607","450","176","274","5","455","1198","0","37.98","14.69"
"65","000","00","050","0038","0608","459","199","260","3","462","1292","0","35.76","15.40"
"65","000","00","050","0038","0609","370","121","249","5","375","1161","0","32.30","10.42"
"65","000","00","050","0038","0610","531","254","277","5","536","1222","0","43.86","20.79"
"65","000","00","050","0039","0000","1629","659","970","10","1639","3692","0","44.39","17.85"
"65","000","00","050","0039","0427","570","261","309","2","572","1210","0","47.27","21.57"
"65","000","00","050","0039","0428","517","184","333","5","522","1220","0","42.79","15.08"
"65","000","00","050","0039","0429","542","214","328","3","545","1262","0","43.19","16.96"
"65","000","00","050","0040","0000","770","336","434","5","775","1701","0","45.56","19.75"
"65","000","00","050","0040","0516","261","138","123","1","262","631","0","41.52","21.87"
"65","000","00","050","0040","0517","509","198","311","4","513","1070","0","47.94","18.50"
"65","000","00","050","0041","0000","1344","597","747","12","1356","3835","0","35.36","15.57"
"65","000","00","050","0041","0601","476","216","260","4","480","1327","0","36.17","16.28"
"65","000","00","050","0041","0602","447","192","255","4","451","1264","0","35.68","15.19"
"65","000","00","050","0041","0603","421","189","232","4","425","1244","0","34.16","15.19"
"65","000","00","050","0042","0000","841","325","516","9","850","2341","0","36.31","13.88"
"65","000","00","050","0042","0421","414","164","250","6","420","1134","0","37.04","14.46"
"65","000","00","050","0042","0422","427","161","266","3","430","1207","0","35.63","13.34"
"65","000","00","050","0043","0000","2911","1317","1594","27","2938","7720","0","38.06","17.06"
"65","000","00","050","0043","0518","525","216","309","3","528","1368","0","38.60","15.79"
"65","000","00","050","0043","0519","496","224","272","2","498","1377","0","36.17","16.27"
"65","000","00","050","0043","0520","517","207","310","2","519","1377","0","37.69","15.03"
"65","000","00","050","0043","0521","490","191","299","2","492","1260","0","39.05","15.16"
"65","000","00","050","0043","0522","495","267","228","10","505","1301","0","38.82","20.52"
"65","000","00","050","0043","0523","388","212","176","8","396","1037","0","38.19","20.44"
"65","000","00","050","0044","0000","1425","569","856","14","1439","4165","0","34.55","13.66"
"65","000","00","050","0044","0595","456","174","282","6","462","1390","0","33.24","12.52"
"65","000","00","050","0044","0596","479","195","284","3","482","1377","0","35.00","14.16"
"65","000","00","050","0044","0597","490","200","290","5","495","1398","0","35.41","14.31"
"65","000","00","050","0045","0000","1897","703","1194","29","1926","4667","0","41.27","15.06"
"65","000","00","050","0045","0417","533","203","330","8","541","1208","0","44.78","16.80"
"65","000","00","050","0045","0418","531","185","346","8","539","1241","0","43.43","14.91"
"65","000","00","050","0045","0419","465","169","296","9","474","1211","0","39.14","13.96"
"65","000","00","050","0045","0420","368","146","222","4","372","1007","0","36.94","14.50"
"65","000","00","050","0046","0000","1497","606","891","16","1513","4014","0","37.69","15.10"
"65","000","00","050","0046","0524","475","189","286","8","483","1300","0","37.15","14.54"
"65","000","00","050","0046","0525","489","209","280","6","495","1405","0","35.23","14.88"
"65","000","00","050","0046","0526","533","208","325","2","535","1309","0","40.87","15.89"
"65","000","00","050","0047","0000","1495","509","986","10","1505","3807","0","39.53","13.37"
"65","000","00","050","0047","0394","488","165","323","5","493","1264","0","39.00","13.05"
"65","000","00","050","0047","0395","477","161","316","3","480","1242","0","38.65","12.96"
"65","000","00","050","0047","0396","530","183","347","2","532","1301","0","40.89","14.07"
"65","000","00","050","0048","0000","3801","1769","2032","29","3830","9790","0","39.12","18.07"
"65","000","00","050","0048","0529","686","343","343","4","690","1613","0","42.78","21.26"
"65","000","00","050","0048","0530","591","286","305","8","599","1416","0","42.30","20.20"
"65","000","00","050","0048","0531","472","213","259","3","475","1379","0","34.45","15.45"
"65","000","00","050","0048","0532","523","258","265","3","526","1398","0","37.63","18.45"
"65","000","00","050","0048","0533","533","235","298","4","537","1322","0","40.62","17.78"
"65","000","00","050","0048","0534","502","223","279","2","504","1349","0","37.36","16.53"
"65","000","00","050","0048","0535","494","211","283","5","499","1313","0","38.00","16.07"
"65","000","00","050","0049","0000","865","311","554","8","873","2188","0","39.90","14.21"
"65","000","00","050","0049","0415","401","144","257","4","405","1043","0","38.83","13.81"
"65","000","00","050","0049","0416","464","167","297","4","468","1145","0","40.87","14.59"
"65","000","00","050","0050","0000","3416","1523","1893","22","3438","8555","0","40.19","17.80"
"65","000","00","050","0050","0538","600","239","361","4","604","1441","0","41.92","16.59"
"65","000","00","050","0050","0539","587","292","295","5","592","1445","0","40.97","20.21"
"65","000","00","050","0050","0540","534","197","337","3","537","1433","0","37.47","13.75"
"65","000","00","050","0050","0541","583","267","316","1","584","1467","0","39.81","18.20"
"65","000","00","050","0050","0542","549","263","286","7","556","1413","0","39.35","18.61"
"65","000","00","050","0050","0543","563","265","298","2","565","1356","0","41.67","19.54"
"65","000","00","050","0051","0000","1128","468","660","7","1135","2558","0","44.37","18.30"
"65","000","00","050","0051","0430","538","217","321","5","543","1229","0","44.18","17.66"
"65","000","00","050","0051","0431","590","251","339","2","592","1329","0","44.54","18.89"
"65","000","00","050","0052","0000","1708","709","999","17","1725","4343","0","39.72","16.33"
"65","000","00","050","0052","0492","625","240","385","5","630","1641","0","38.39","14.63"
"65","000","00","050","0052","0493","680","311","369","9","689","1673","0","41.18","18.59"
"65","000","00","050","0052","0494","403","158","245","3","406","1029","0","39.46","15.35"
"65","000","00","050","0053","0000","4524","1975","2549","46","4570","11108","0","41.14","17.78"
"65","000","00","050","0053","0485","951","446","505","10","961","2419","0","39.73","18.44"
"65","000","00","050","0053","0486","432","171","261","2","434","1169","0","37.13","14.63"
"65","000","00","050","0053","0487","511","221","290","5","516","1314","0","39.27","16.82"
"65","000","00","050","0053","0488","713","322","391","9","722","1625","0","44.43","19.82"
"65","000","00","050","0053","0489","611","259","352","5","616","1424","0","43.26","18.19"
"65","000","00","050","0053","0490","622","263","359","9","631","1491","0","42.32","17.64"
"65","000","00","050","0053","0491","684","293","391","6","690","1666","0","41.42","17.59"
"65","000","00","050","0054","0000","3012","1216","1796","26","3038","7280","0","41.73","16.70"
"65","000","00","050","0054","0475","605","254","351","5","610","1481","0","41.19","17.15"
"65","000","00","050","0054","0476","607","219","388","11","618","1414","0","43.71","15.49"
"65","000","00","050","0054","0477","604","238","366","5","609","1463","0","41.63","16.27"
"65","000","00","050","0054","0478","628","267","361","3","631","1448","0","43.58","18.44"
"65","000","00","050","0054","0479","568","238","330","2","570","1474","0","38.67","16.15"
"65","000","00","050","0055","0000","1458","573","885","24","1482","4090","0","36.23","14.01"
"65","000","00","050","0055","0567","485","193","292","3","488","1399","0","34.88","13.80"
"65","000","00","050","0055","0568","476","181","295","13","489","1304","0","37.50","13.88"
"65","000","00","050","0055","0569","497","199","298","8","505","1387","0","36.41","14.35"
"65","000","00","050","0056","0000","951","393","558","8","959","2178","0","44.03","18.04"
"65","000","00","050","0056","0560","468","216","252","6","474","1097","0","43.21","19.69"
"65","000","00","050","0056","0561","483","177","306","2","485","1081","0","44.87","16.37"
"65","000","00","050","0057","0000","1343","555","788","15","1358","3219","0","42.19","17.24"
"65","000","00","050","0057","0449","381","128","253","5","386","1064","0","36.28","12.03"
"65","000","00","050","0057","0450","537","230","307","3","540","1165","0","46.35","19.74"
"65","000","00","050","0057","0451","425","197","228","7","432","990","0","43.64","19.90"
"65","000","00","050","0058","0000","1195","377","818","9","1204","3118","0","38.61","12.09"
"65","000","00","050","0058","0452","426","128","298","2","428","1098","0","38.98","11.66"
"65","000","00","050","0058","0453","365","129","236","3","368","1004","0","36.65","12.85"
"65","000","00","050","0058","0454","404","120","284","4","408","1016","0","40.16","11.81"
"65","000","00","050","0059","0000","1851","814","1037","24","1875","4308","0","43.52","18.90"
"65","000","00","050","0059","0498","607","270","337","13","620","1497","0","41.42","18.04"
"65","000","00","050","0059","0499","625","251","374","5","630","1366","0","46.12","18.37"
"65","000","00","050","0059","0500","619","293","326","6","625","1445","0","43.25","20.28"
"65","000","00","050","0060","0000","2091","997","1094","20","2111","4287","0","49.24","23.26"
"65","000","00","050","0060","0353","695","361","334","13","708","1469","0","48.20","24.57"
"65","000","00","050","0060","0354","722","331","391","3","725","1480","0","48.99","22.36"
"65","000","00","050","0060","0355","674","305","369","4","678","1338","0","50.67","22.80"
"65","000","00","050","0061","0000","1274","454","820","7","1281","3271","0","39.16","13.88"
"65","000","00","050","0061","0410","421","146","275","1","422","1076","0","39.22","13.57"
"65","000","00","050","0061","0411","422","153","269","2","424","1060","0","40.00","14.43"
"65","000","00","050","0061","0412","431","155","276","4","435","1135","0","38.33","13.66"
"65","000","00","050","0062","0000","2466","1097","1369","18","2484","5316","0","46.73","20.64"
"65","000","00","050","0062","0465","626","296","330","3","629","1367","0","46.01","21.65"
"65","000","00","050","0062","0466","556","230","326","4","560","1240","0","45.16","18.55"
"65","000","00","050","0062","0467","621","273","348","5","626","1381","0","45.33","19.77"
"65","000","00","050","0062","0468","663","298","365","6","669","1328","0","50.38","22.44"
"65","000","00","050","0063","0000","1374","569","805","9","1383","3181","0","43.48","17.89"
"65","000","00","050","0063","0407","409","151","258","3","412","1004","0","41.04","15.04"
"65","000","00","050","0063","0408","453","175","278","5","458","1044","0","43.87","16.76"
"65","000","00","050","0063","0409","512","243","269","1","513","1133","0","45.28","21.45"
"65","000","00","050","0064","0000","2959","1421","1538","24","2983","7008","0","42.57","20.28"
"65","000","00","050","0064","0386","811","429","382","7","818","1912","0","42.78","22.44"
"65","000","00","050","0064","0387","493","222","271","2","495","1275","0","38.82","17.41"
"65","000","00","050","0064","0388","647","320","327","9","656","1417","0","46.29","22.58"
"65","000","00","050","0064","0389","513","214","299","4","517","1211","0","42.69","17.67"
"65","000","00","050","0064","0390","495","236","259","2","497","1193","0","41.66","19.78"
"65","000","00","050","0065","0000","1436","681","755","12","1448","2960","0","48.92","23.01"
"65","000","00","050","0065","0361","711","340","371","6","717","1451","0","49.41","23.43"
"65","000","00","050","0065","0362","725","341","384","6","731","1509","0","48.44","22.60"
"65","000","00","050","0066","0000","1275","507","768","8","1283","3234","0","39.67","15.68"
"65","000","00","050","0066","0557","422","190","232","5","427","1024","0","41.70","18.55"
"65","000","00","050","0066","0558","403","137","266","3","406","1046","0","38.81","13.10"
"65","000","00","050","0066","0559","450","180","270","0","450","1164","0","38.66","15.46"
"65","000","00","050","0067","0000","768","319","449","14","782","2075","0","37.69","15.37"
"65","000","00","050","0067","0548","374","136","238","8","382","1079","0","35.40","12.60"
"65","000","00","050","0067","0549","394","183","211","6","400","996","0","40.16","18.37"
"65","000","00","050","0068","0000","1002","399","603","2","1004","2274","0","44.15","17.55"
"65","000","00","050","0068","0514","443","173","270","0","443","1141","0","38.83","15.16"
"65","000","00","050","0068","0515","559","226","333","2","561","1133","0","49.51","19.95"
"65","000","00","050","0069","0000","1275","547","728","12","1287","2720","0","47.32","20.11"
"65","000","00","050","0069","0555","605","263","342","8","613","1352","0","45.34","19.45"
"65","000","00","050","0069","0556","670","284","386","4","674","1368","0","49.27","20.76"
"65","000","00","050","0070","0000","2312","935","1377","16","2328","5875","0","39.63","15.91"
"65","000","00","050","0070","0574","568","224","344","4","572","1453","0","39.37","15.42"
"65","000","00","050","0070","0575","564","232","332","3","567","1462","0","38.78","15.87"
"65","000","00","050","0070","0576","582","241","341","2","584","1460","0","40.00","16.51"
"65","000","00","050","0070","0577","598","238","360","7","605","1500","0","40.33","15.87"
"65","000","00","050","0071","0000","1616","670","946","8","1624","4416","0","36.78","15.17"
"65","000","00","050","0071","0583","539","213","326","4","543","1454","0","37.35","14.65"
"65","000","00","050","0071","0584","583","246","337","2","585","1517","0","38.56","16.22"
"65","000","00","050","0071","0585","494","211","283","2","496","1445","0","34.33","14.60"
"65","000","00","050","0072","0000","2278","935","1343","20","2298","5247","0","43.80","17.82"
"65","000","00","050","0072","0382","546","234","312","8","554","1319","0","42.00","17.74"
"65","000","00","050","0072","0383","634","241","393","4","638","1326","0","48.11","18.17"
"65","000","00","050","0072","0384","527","190","337","3","530","1238","0","42.81","15.35"
"65","000","00","050","0072","0385","571","270","301","5","576","1364","0","42.23","19.79"
"65","000","00","050","0073","0000","1352","562","790","6","1358","3272","0","41.50","17.18"
"65","000","00","050","0073","0404","466","201","265","0","466","1161","0","40.14","17.31"
"65","000","00","050","0073","0405","395","142","253","3","398","983","0","40.49","14.45"
"65","000","00","050","0073","0406","491","219","272","3","494","1128","0","43.79","19.41"
"65","000","00","050","0074","0000","1656","730","926","20","1676","3858","0","43.44","18.92"
"65","000","00","050","0074","0397","541","254","287","6","547","1233","0","44.36","20.60"
"65","000","00","050","0074","0398","552","209","343","6","558","1361","0","41.00","15.36"
"65","000","00","050","0074","0399","563","267","296","8","571","1264","0","45.17","21.12"
"65","000","00","050","0075","0000","3260","1538","1722","20","3280","7749","0","42.33","19.85"
"65","000","00","050","0075","0480","706","345","361","2","708","1510","0","46.89","22.85"
"65","000","00","050","0075","0481","631","313","318","4","635","1529","0","41.53","20.47"
"65","000","00","050","0075","0482","672","314","358","7","679","1635","0","41.53","19.20"
"65","000","00","050","0075","0483","643","291","352","4","647","1641","0","39.43","17.73"
"65","000","00","050","0075","0484","608","275","333","3","611","1434","0","42.61","19.18"
"65","000","00","050","0076","0000","4165","1932","2233","33","4198","9967","0","42.12","19.38"
"65","000","00","050","0076","0458","729","295","434","5","734","1697","0","43.25","17.38"
"65","000","00","050","0076","0459","574","246","328","4","578","1418","0","40.76","17.35"
"65","000","00","050","0076","0460","641","309","332","8","649","1434","0","45.26","21.55"
"65","000","00","050","0076","0461","567","289","278","3","570","1397","0","40.80","20.69"
"65","000","00","050","0076","0462","545","248","297","8","553","1274","0","43.41","19.47"
"65","000","00","050","0076","0463","573","258","315","1","574","1387","0","41.38","18.60"
"65","000","00","050","0076","0464","536","287","249","4","540","1360","0","39.71","21.10"
"65","000","00","050","0077","0000","956","411","545","16","972","2206","0","44.06","18.63"
"65","000","00","050","0077","0508","457","199","258","8","465","1079","0","43.10","18.44"
"65","000","00","050","0077","0509","499","212","287","8","507","1127","0","44.99","18.81"
"65","000","00","050","0078","0000","1454","632","822","7","1461","3404","0","42.92","18.57"
"65","000","00","050","0078","0552","489","179","310","2","491","1153","0","42.58","15.52"
"65","000","00","050","0078","0553","467","224","243","2","469","1058","0","44.33","21.17"
"65","000","00","050","0078","0554","498","229","269","3","501","1193","0","41.99","19.20"
"65","000","00","050","0079","0000","793","379","414","8","801","1990","0","40.25","19.05"
"65","000","00","050","0079","0536","426","195","231","4","430","1076","0","39.96","18.12"
"65","000","00","050","0079","0537","367","184","183","4","371","914","0","40.59","20.13"
"65","000","00","050","0080","0000","851","379","472","11","862","2133","0","40.41","17.77"
"65","000","00","050","0080","0527","430","212","218","6","436","1098","0","39.71","19.31"
"65","000","00","050","0080","0528","421","167","254","5","426","1035","0","41.16","16.14"
"65","000","00","050","0081","0000","1332","569","763","8","1340","3307","0","40.52","17.21"
"65","000","00","050","0081","0578","437","185","252","3","440","1043","0","42.19","17.74"
"65","000","00","050","0081","0579","479","208","271","3","482","1181","0","40.81","17.61"
"65","000","00","050","0081","0580","416","176","240","2","418","1083","0","38.60","16.25"
"65","000","00","050","0082","0000","1532","687","845","20","1552","3548","0","43.74","19.36"
"65","000","00","050","0082","0590","488","201","287","5","493","1179","0","41.82","17.05"
"65","000","00","050","0082","0591","471","245","226","6","477","1029","0","46.36","23.81"
"65","000","00","050","0082","0592","573","241","332","9","582","1340","0","43.43","17.99"
"65","000","00","050","0083","0000","1455","606","849","19","1474","3815","0","38.64","15.88"
"65","000","00","050","0083","0598","457","177","280","5","462","1268","0","36.44","13.96"
"65","000","00","050","0083","0599","508","206","302","7","515","1266","0","40.68","16.27"
"65","000","00","050","0083","0600","490","223","267","7","497","1281","0","38.80","17.41"
"65","000","00","050","0084","0000","903","319","584","4","907","2430","0","37.33","13.13"
"65","000","00","050","0084","0604","494","164","330","3","497","1231","0","40.37","13.32"
"65","000","00","050","0084","0605","409","155","254","1","410","1199","0","34.20","12.93"
"65","000","00","060","0000","0000","122627","74826","47801","1193","123820","265823","301768","46.58","28.15"
"65","000","00","060","0001","0000","1412","916","496","15","1427","2846","0","50.14","32.19"
"65","000","00","060","0001","2178","744","472","272","6","750","1426","0","52.59","33.10"
"65","000","00","060","0001","2179","668","444","224","9","677","1420","0","47.68","31.27"
"65","000","00","060","0002","0000","1684","1054","630","15","1699","3541","0","47.98","29.77"
"65","000","00","060","0002","2180","626","416","210","4","630","1329","0","47.40","31.30"
"65","000","00","060","0002","2181","489","302","187","7","496","1034","0","47.97","29.21"
"65","000","00","060","0002","2182","569","336","233","4","573","1178","0","48.64","28.52"
"65","000","00","060","0003","0000","1597","947","650","9","1606","3306","0","48.58","28.64"
"65","000","00","060","0003","2183","491","311","180","3","494","1047","0","47.18","29.70"
"65","000","00","060","0003","2184","584","343","241","3","587","1153","0","50.91","29.75"
"65","000","00","060","0003","2185","522","293","229","3","525","1106","0","47.47","26.49"
"65","000","00","060","0004","0000","1831","1096","735","21","1852","3497","0","52.96","31.34"
"65","000","00","060","0004","2186","525","289","236","6","531","1015","0","52.32","28.47"
"65","000","00","060","0004","2187","659","407","252","10","669","1251","0","53.48","32.53"
"65","000","00","060","0004","2188","647","400","247","5","652","1231","0","52.97","32.49"
"65","000","00","060","0005","0000","2477","1571","906","30","2507","4908","0","51.08","32.01"
"65","000","00","060","0005","2189","547","344","203","6","553","1117","0","49.51","30.80"
"65","000","00","060","0005","2190","671","440","231","7","678","1239","0","54.72","35.51"
"65","000","00","060","0005","2191","668","410","258","10","678","1293","0","52.44","31.71"
"65","000","00","060","0005","2192","591","377","214","7","598","1259","0","47.50","29.94"
"65","000","00","060","0006","0000","2525","1550","975","31","2556","4879","0","52.39","31.77"
"65","000","00","060","0006","2195","906","585","321","10","916","1685","0","54.36","34.72"
"65","000","00","060","0006","2196","550","362","188","10","560","1109","0","50.50","32.64"
"65","000","00","060","0006","2197","539","312","227","4","543","1027","0","52.87","30.38"
"65","000","00","060","0006","2198","530","291","239","7","537","1058","0","50.76","27.50"
"65","000","00","060","0007","0000","2457","1548","909","26","2483","4940","0","50.26","31.34"
"65","000","00","060","0007","2204","653","393","260","6","659","1268","0","51.97","30.99"
"65","000","00","060","0007","2205","567","372","195","8","575","1229","0","46.79","30.27"
"65","000","00","060","0007","2206","617","398","219","5","622","1196","0","52.01","33.28"
"65","000","00","060","0007","2207","620","385","235","7","627","1247","0","50.28","30.87"
"65","000","00","060","0008","0000","2989","1731","1258","27","3016","6086","0","49.56","28.44"
"65","000","00","060","0008","2208","453","287","166","2","455","971","0","46.86","29.56"
"65","000","00","060","0008","2209","1231","741","490","16","1247","2367","0","52.68","31.31"
"65","000","00","060","0008","2210","592","312","280","4","596","1283","0","46.45","24.32"
"65","000","00","060","0008","2211","713","391","322","5","718","1465","0","49.01","26.69"
"65","000","00","060","0009","0000","1075","715","360","9","1084","2525","0","42.93","28.32"
"65","000","00","060","0009","2212","553","350","203","2","555","1355","0","40.96","25.83"
"65","000","00","060","0009","2213","522","365","157","7","529","1170","0","45.21","31.20"
"65","000","00","060","0010","0000","1405","1130","275","20","1425","2477","0","57.53","45.62"
"65","000","00","060","0010","2214","730","601","129","11","741","1250","0","59.28","48.08"
"65","000","00","060","0010","2215","675","529","146","9","684","1227","0","55.75","43.11"
"65","000","00","060","0011","0000","1279","801","478","9","1288","2805","0","45.92","28.56"
"65","000","00","060","0011","2216","429","246","183","5","434","882","0","49.21","27.89"
"65","000","00","060","0011","2217","442","289","153","2","444","1009","0","44.00","28.64"
"65","000","00","060","0011","2218","408","266","142","2","410","914","0","44.86","29.10"
"65","000","00","060","0012","0000","576","330","246","7","583","1541","0","37.83","21.41"
"65","000","00","060","0012","2221","576","330","246","7","583","1541","0","37.83","21.41"
"65","000","00","060","0013","0000","1276","640","636","12","1288","2878","0","44.75","22.24"
"65","000","00","060","0013","2222","653","335","318","7","660","1460","0","45.21","22.95"
"65","000","00","060","0013","2223","623","305","318","5","628","1418","0","44.29","21.51"
"65","000","00","060","0014","0000","3368","1986","1382","27","3395","8098","0","41.92","24.52"
"65","000","00","060","0014","2224","644","408","236","5","649","1338","0","48.51","30.49"
"65","000","00","060","0014","2225","550","341","209","7","557","1317","0","42.29","25.89"
"65","000","00","060","0014","2226","441","207","234","1","442","1268","0","34.86","16.32"
"65","000","00","060","0014","2227","536","307","229","4","540","1382","0","39.07","22.21"
"65","000","00","060","0014","2228","573","327","246","6","579","1401","0","41.33","23.34"
"65","000","00","060","0014","2229","624","396","228","4","628","1392","0","45.11","28.45"
"65","000","00","060","0015","0000","1992","1086","906","12","2004","4606","0","43.51","23.58"
"65","000","00","060","0015","2235","505","277","228","2","507","1107","0","45.80","25.02"
"65","000","00","060","0015","2236","517","298","219","4","521","1192","0","43.71","25.00"
"65","000","00","060","0015","2237","445","236","209","2","447","1126","0","39.70","20.96"
"65","000","00","060","0015","2238","525","275","250","4","529","1181","0","44.79","23.29"
"65","000","00","060","0016","0000","4956","2956","2000","41","4997","11616","0","43.02","25.45"
"65","000","00","060","0016","2246","549","318","231","5","554","1259","0","44.00","25.26"
"65","000","00","060","0016","2247","542","295","247","4","546","1277","0","42.76","23.10"
"65","000","00","060","0016","2248","555","334","221","2","557","1322","0","42.13","25.26"
"65","000","00","060","0016","2249","549","319","230","3","552","1299","0","42.49","24.56"
"65","000","00","060","0016","2250","537","318","219","6","543","1242","0","43.72","25.60"
"65","000","00","060","0016","2251","532","345","187","2","534","1242","0","43.00","27.78"
"65","000","00","060","0016","2252","511","295","216","3","514","1307","0","39.33","22.57"
"65","000","00","060","0016","2253","586","380","206","8","594","1310","0","45.34","29.01"
"65","000","00","060","0016","2254","595","352","243","8","603","1358","0","44.40","25.92"
"65","000","00","060","0017","0000","2210","1196","1014","28","2238","5492","0","40.75","21.78"
"65","000","00","060","0017","2259","571","318","253","6","577","1324","0","43.58","24.02"
"65","000","00","060","0017","2260","563","306","257","9","572","1328","0","43.07","23.04"
"65","000","00","060","0017","2261","590","323","267","9","599","1461","0","41.00","22.11"
"65","000","00","060","0017","2262","486","249","237","4","490","1379","0","35.53","18.06"
"65","000","00","060","0018","0000","2121","1160","961","15","2136","5146","0","41.51","22.54"
"65","000","00","060","0018","2271","518","283","235","6","524","1359","0","38.56","20.82"
"65","000","00","060","0018","2272","453","246","207","1","454","1145","0","39.65","21.48"
"65","000","00","060","0018","2273","628","369","259","4","632","1442","0","43.83","25.59"
"65","000","00","060","0018","2274","522","262","260","4","526","1200","0","43.83","21.83"
"65","000","00","060","0019","0000","1984","1005","979","17","2001","5288","0","37.84","19.01"
"65","000","00","060","0019","2283","507","243","264","6","513","1438","0","35.67","16.90"
"65","000","00","060","0019","2284","464","229","235","6","470","1232","0","38.15","18.59"
"65","000","00","060","0019","2285","525","271","254","3","528","1307","0","40.40","20.73"
"65","000","00","060","0019","2286","488","262","226","2","490","1311","0","37.38","19.98"
"65","000","00","060","0020","0000","2368","1497","871","16","2384","5383","0","44.29","27.81"
"65","000","00","060","0020","2287","511","310","201","2","513","1151","0","44.57","26.93"
"65","000","00","060","0020","2288","576","370","206","5","581","1311","0","44.32","28.22"
"65","000","00","060","0020","2289","558","343","215","8","566","1291","0","43.84","26.57"
"65","000","00","060","0020","2290","723","474","249","1","724","1630","0","44.42","29.08"
"65","000","00","060","0021","0000","378","91","287","4","382","928","0","41.16","9.81"
"65","000","00","060","0021","2295","378","91","287","4","382","928","0","41.16","9.81"
"65","000","00","060","0022","0000","2081","1250","831","18","2099","4705","0","44.61","26.57"
"65","000","00","060","0022","2302","475","299","176","9","484","1147","0","42.20","26.07"
"65","000","00","060","0022","2303","539","306","233","0","539","1274","0","42.31","24.02"
"65","000","00","060","0022","2304","492","263","229","6","498","1173","0","42.46","22.42"
"65","000","00","060","0022","2305","575","382","193","3","578","1111","0","52.03","34.38"
"65","000","00","060","0023","0000","1962","1159","803","24","1986","4714","0","42.13","24.59"
"65","000","00","060","0023","2306","596","364","232","8","604","1449","0","41.68","25.12"
"65","000","00","060","0023","2307","818","514","304","8","826","1912","0","43.20","26.88"
"65","000","00","060","0023","2308","548","281","267","8","556","1353","0","41.09","20.77"
"65","000","00","060","0024","0000","250","96","154","5","255","726","0","35.12","13.22"
"65","000","00","060","0024","2309","250","96","154","5","255","726","0","35.12","13.22"
"65","000","00","060","0025","0000","1386","661","725","11","1397","2813","0","49.66","23.50"
"65","000","00","060","0025","2310","282","114","168","1","283","562","0","50.36","20.28"
"65","000","00","060","0025","2311","397","196","201","4","401","879","0","45.62","22.30"
"65","000","00","060","0025","2312","499","266","233","5","504","927","0","54.37","28.69"
"65","000","00","060","0025","2313","208","85","123","1","209","445","0","46.97","19.10"
"65","000","00","060","0026","0000","946","446","500","5","951","2253","0","42.21","19.80"
"65","000","00","060","0026","2314","485","202","283","3","488","1100","0","44.36","18.36"
"65","000","00","060","0026","2315","461","244","217","2","463","1153","0","40.16","21.16"
"65","000","00","060","0027","0000","636","279","357","4","640","1598","0","40.05","17.46"
"65","000","00","060","0027","2316","636","279","357","4","640","1598","0","40.05","17.46"
"65","000","00","060","0028","0000","495","185","310","7","502","1264","0","39.72","14.64"
"65","000","00","060","0028","2317","495","185","310","7","502","1264","0","39.72","14.64"
"65","000","00","060","0029","0000","510","193","317","6","516","1196","0","43.14","16.14"
"65","000","00","060","0029","2318","146","36","110","3","149","431","0","34.57","8.35"
"65","000","00","060","0029","2319","364","157","207","3","367","765","0","47.97","20.52"
"65","000","00","060","0030","0000","2060","1168","892","19","2079","4825","0","43.09","24.21"
"65","000","00","060","0030","2298","604","326","278","5","609","1361","0","44.75","23.95"
"65","000","00","060","0030","2299","489","270","219","4","493","1168","0","42.21","23.12"
"65","000","00","060","0030","2300","440","265","175","5","445","1029","0","43.25","25.75"
"65","000","00","060","0030","2301","527","307","220","5","532","1267","0","41.99","24.23"
"65","000","00","060","0031","0000","757","369","388","4","761","1629","0","46.72","22.65"
"65","000","00","060","0031","2105","757","369","388","4","761","1629","0","46.72","22.65"
"65","000","00","060","0032","0000","1076","650","426","7","1083","2137","0","50.68","30.42"
"65","000","00","060","0032","2106","479","310","169","5","484","858","0","56.41","36.13"
"65","000","00","060","0032","2107","597","340","257","2","599","1279","0","46.83","26.58"
"65","000","00","060","0033","0000","1027","564","463","10","1037","2320","0","44.70","24.31"
"65","000","00","060","0033","2108","471","245","226","6","477","1098","0","43.44","22.31"
"65","000","00","060","0033","2109","556","319","237","4","560","1222","0","45.83","26.10"
"65","000","00","060","0034","0000","731","475","256","10","741","1575","0","47.05","30.16"
"65","000","00","060","0034","2110","731","475","256","10","741","1575","0","47.05","30.16"
"65","000","00","060","0035","0000","409","178","231","8","417","782","0","53.32","22.76"
"65","000","00","060","0035","2111","409","178","231","8","417","782","0","53.32","22.76"
"65","000","00","060","0036","0000","1130","595","535","7","1137","2230","0","50.99","26.68"
"65","000","00","060","0036","2112","630","310","320","4","634","1280","0","49.53","24.22"
"65","000","00","060","0036","2113","500","285","215","3","503","950","0","52.95","30.00"
"65","000","00","060","0037","0000","2404","1549","855","21","2425","6858","0","35.36","22.59"
"65","000","00","060","0037","2114","593","387","206","6","599","1221","0","49.06","31.70"
"65","000","00","060","0037","2115","712","485","227","7","719","3419","0","21.03","14.19"
"65","000","00","060","0037","2116","661","433","228","6","667","1257","0","53.06","34.45"
"65","000","00","060","0037","2117","438","244","194","2","440","961","0","45.79","25.39"
"65","000","00","060","0038","0000","2615","1629","986","34","2649","5204","0","50.90","31.30"
"65","000","00","060","0038","2118","425","254","171","7","432","898","0","48.11","28.29"
"65","000","00","060","0038","2119","919","654","265","12","931","1598","0","58.26","40.93"
"65","000","00","060","0038","2120","632","354","278","6","638","1327","0","48.08","26.68"
"65","000","00","060","0038","2121","639","367","272","9","648","1381","0","46.92","26.57"
"65","000","00","060","0039","0000","1082","615","467","12","1094","2418","0","45.24","25.43"
"65","000","00","060","0039","2122","545","322","223","5","550","1223","0","44.97","26.33"
"65","000","00","060","0039","2123","537","293","244","7","544","1195","0","45.52","24.52"
"65","000","00","060","0040","0000","3673","2351","1322","40","3713","8055","0","46.10","29.19"
"65","000","00","060","0040","2124","538","302","236","8","546","1251","0","43.65","24.14"
"65","000","00","060","0040","2125","632","380","252","10","642","1271","0","50.51","29.90"
"65","000","00","060","0040","2126","638","392","246","6","644","1432","0","44.97","27.37"
"65","000","00","060","0040","2127","675","479","196","9","684","1477","0","46.31","32.43"
"65","000","00","060","0040","2128","619","392","227","3","622","1382","0","45.01","28.36"
"65","000","00","060","0040","2129","571","406","165","4","575","1242","0","46.30","32.69"
"65","000","00","060","0041","0000","3338","2057","1281","24","3362","6910","0","48.65","29.77"
"65","000","00","060","0041","2130","528","342","186","5","533","1119","0","47.63","30.56"
"65","000","00","060","0041","2131","603","366","237","2","605","1189","0","50.88","30.78"
"65","000","00","060","0041","2132","520","317","203","1","521","1134","0","45.94","27.95"
"65","000","00","060","0041","2133","542","316","226","6","548","1106","0","49.55","28.57"
"65","000","00","060","0041","2134","602","413","189","7","609","1192","0","51.09","34.65"
"65","000","00","060","0041","2135","543","303","240","3","546","1170","0","46.67","25.90"
"65","000","00","060","0042","0000","1742","1141","601","20","1762","3647","0","48.31","31.29"
"65","000","00","060","0042","2138","567","383","184","8","575","1114","0","51.62","34.38"
"65","000","00","060","0042","2139","227","139","88","2","229","507","0","45.17","27.42"
"65","000","00","060","0042","2140","445","280","165","3","448","938","0","47.76","29.85"
"65","000","00","060","0042","2141","503","339","164","7","510","1088","0","46.88","31.16"
"65","000","00","060","0043","0000","1150","705","445","9","1159","2185","0","53.04","32.27"
"65","000","00","060","0043","2142","621","384","237","4","625","1105","0","56.56","34.75"
"65","000","00","060","0043","2143","529","321","208","5","534","1080","0","49.44","29.72"
"65","000","00","060","0044","0000","2617","1672","945","28","2645","5458","0","48.46","30.63"
"65","000","00","060","0044","2144","722","429","293","6","728","1416","0","51.41","30.30"
"65","000","00","060","0044","2145","605","372","233","8","613","1353","0","45.31","27.49"
"65","000","00","060","0044","2146","716","480","236","6","722","1336","0","54.04","35.93"
"65","000","00","060","0044","2147","574","391","183","8","582","1353","0","43.02","28.90"
"65","000","00","060","0045","0000","1877","1282","595","15","1892","3832","0","49.37","33.46"
"65","000","00","060","0045","2148","621","422","199","6","627","1247","0","50.28","33.84"
"65","000","00","060","0045","2149","608","419","189","2","610","1201","0","50.79","34.89"
"65","000","00","060","0045","2150","648","441","207","7","655","1384","0","47.33","31.86"
"65","000","00","060","0046","0000","927","598","329","10","937","1791","0","52.32","33.39"
"65","000","00","060","0046","2151","475","291","184","3","478","919","0","52.01","31.66"
"65","000","00","060","0046","2152","452","307","145","7","459","872","0","52.64","35.21"
"65","000","00","060","0047","0000","1642","1069","573","21","1663","3376","0","49.26","31.66"
"65","000","00","060","0047","2155","408","276","132","7","415","922","0","45.01","29.93"
"65","000","00","060","0047","2156","538","358","180","6","544","1082","0","50.28","33.09"
"65","000","00","060","0047","2157","696","435","261","8","704","1372","0","51.31","31.71"
"65","000","00","060","0048","0000","1409","876","533","11","1420","2847","0","49.88","30.77"
"65","000","00","060","0048","2158","724","438","286","5","729","1420","0","51.34","30.85"
"65","000","00","060","0048","2159","685","438","247","6","691","1427","0","48.42","30.69"
"65","000","00","060","0049","0000","1567","973","594","21","1588","3469","0","45.78","28.05"
"65","000","00","060","0049","2160","495","313","182","5","500","1183","0","42.27","26.46"
"65","000","00","060","0049","2161","628","399","229","9","637","1283","0","49.65","31.10"
"65","000","00","060","0049","2162","444","261","183","7","451","1003","0","44.97","26.02"
"65","000","00","060","0050","0000","1681","1042","639","12","1693","3294","0","51.40","31.63"
"65","000","00","060","0050","2163","580","365","215","5","585","1113","0","52.56","32.79"
"65","000","00","060","0050","2164","509","309","200","5","514","1035","0","49.66","29.86"
"65","000","00","060","0050","2165","592","368","224","2","594","1146","0","51.83","32.11"
"65","000","00","060","0051","0000","1833","1319","514","15","1848","3726","0","49.60","35.40"
"65","000","00","060","0051","2166","704","505","199","5","709","1277","0","55.52","39.55"
"65","000","00","060","0051","2167","612","443","169","7","619","1282","0","48.28","34.56"
"65","000","00","060","0051","2168","517","371","146","3","520","1167","0","44.56","31.79"
"65","000","00","060","0052","0000","2324","1565","759","22","2346","4191","0","55.98","37.34"
"65","000","00","060","0052","2169","470","321","149","5","475","872","0","54.47","36.81"
"65","000","00","060","0052","2170","1066","697","369","12","1078","1924","0","56.03","36.23"
"65","000","00","060","0052","2171","788","547","241","5","793","1395","0","56.85","39.21"
"65","000","00","060","0053","0000","552","355","197","11","563","1240","0","45.40","28.63"
"65","000","00","060","0053","2172","250","158","92","4","254","573","0","44.33","27.57"
"65","000","00","060","0053","2173","302","197","105","7","309","667","0","46.33","29.54"
"65","000","00","060","0054","0000","2872","1898","974","15","2887","5278","0","54.70","35.96"
"65","000","00","060","0054","2174","779","517","262","5","784","1436","0","54.60","36.00"
"65","000","00","060","0054","2175","639","437","202","4","643","1195","0","53.81","36.57"
"65","000","00","060","0054","2176","765","498","267","4","769","1403","0","54.81","35.50"
"65","000","00","060","0054","2177","689","446","243","2","691","1244","0","55.55","35.85"
"65","000","00","060","0055","0000","1469","972","497","5","1474","3130","0","47.09","31.05"
"65","000","00","060","0055","2266","802","519","283","3","805","1707","0","47.16","30.40"
"65","000","00","060","0055","2267","667","453","214","2","669","1423","0","47.01","31.83"
"65","000","00","060","0056","0000","3082","1756","1326","42","3124","7029","0","44.44","24.98"
"65","000","00","060","0056","2230","778","447","331","10","788","1612","0","48.88","27.73"
"65","000","00","060","0056","2231","579","316","263","8","587","1376","0","42.66","22.97"
"65","000","00","060","0056","2232","599","340","259","7","606","1368","0","44.30","24.85"
"65","000","00","060","0056","2233","585","352","233","10","595","1328","0","44.80","26.51"
"65","000","00","060","0056","2234","541","301","240","7","548","1345","0","40.74","22.38"
"65","000","00","060","0057","0000","2032","1375","657","20","2052","4302","0","47.70","31.96"
"65","000","00","060","0057","2291","578","401","177","6","584","1226","0","47.63","32.71"
"65","000","00","060","0057","2292","576","407","169","4","580","1283","0","45.21","31.72"
"65","000","00","060","0057","2293","495","321","174","6","501","1032","0","48.55","31.10"
"65","000","00","060","0057","2294","383","246","137","4","387","761","0","50.85","32.33"
"65","000","00","060","0058","0000","3214","1978","1236","34","3248","6458","0","50.29","30.63"
"65","000","00","060","0058","2199","743","491","252","7","750","1341","0","55.93","36.61"
"65","000","00","060","0058","2200","599","305","294","6","605","1330","0","45.49","22.93"
"65","000","00","060","0058","2201","338","182","156","3","341","889","0","38.36","20.47"
"65","000","00","060","0058","2202","767","511","256","5","772","1413","0","54.64","36.16"
"65","000","00","060","0058","2203","767","489","278","13","780","1485","0","52.53","32.93"
"65","000","00","060","0059","0000","1656","1080","576","17","1673","3305","0","50.62","32.68"
"65","000","00","060","0059","2268","587","360","227","9","596","1133","0","52.60","31.77"
"65","000","00","060","0059","2269","583","397","186","6","589","1178","0","50.00","33.70"
"65","000","00","060","0059","2270","486","323","163","2","488","994","0","49.09","32.49"
"65","000","00","060","0060","0000","4470","2979","1491","36","4506","10096","0","44.63","29.51"
"65","000","00","060","0060","2275","674","412","262","1","675","1451","0","46.52","28.39"
"65","000","00","060","0060","2276","540","350","190","3","543","1170","0","46.41","29.91"
"65","000","00","060","0060","2277","520","352","168","7","527","1235","0","42.67","28.50"
"65","000","00","060","0060","2278","503","370","133","2","505","1262","0","40.02","29.32"
"65","000","00","060","0060","2279","452","310","142","3","455","1030","0","44.17","30.10"
"65","000","00","060","0060","2280","413","280","133","6","419","1123","0","37.31","24.93"
"65","000","00","060","0060","2281","622","397","225","6","628","1161","0","54.09","34.19"
"65","000","00","060","0060","2282","746","508","238","8","754","1664","0","45.31","30.53"
"65","000","00","060","0061","0000","1385","930","455","15","1400","2786","0","50.25","33.38"
"65","000","00","060","0061","2153","683","451","232","7","690","1436","0","48.05","31.41"
"65","000","00","060","0061","2154","702","479","223","8","710","1350","0","52.59","35.48"
"65","000","00","060","0062","0000","1191","704","487","10","1201","2930","0","40.99","24.03"
"65","000","00","060","0062","2193","555","293","262","4","559","1430","0","39.09","20.49"
"65","000","00","060","0062","2194","636","411","225","6","642","1500","0","42.80","27.40"
"65","000","00","060","0063","0000","1132","678","454","16","1148","2466","0","46.55","27.49"
"65","000","00","060","0063","2219","564","333","231","7","571","1244","0","45.90","26.77"
"65","000","00","060","0063","2220","568","345","223","9","577","1222","0","47.22","28.23"
"65","000","00","060","0064","0000","2245","1360","885","35","2280","4853","0","46.98","28.02"
"65","000","00","060","0064","2255","523","324","199","6","529","1202","0","44.01","26.96"
"65","000","00","060","0064","2256","525","306","219","9","534","1151","0","46.39","26.59"
"65","000","00","060","0064","2257","627","406","221","9","636","1313","0","48.44","30.92"
"65","000","00","060","0064","2258","570","324","246","11","581","1187","0","48.95","27.30"
"65","000","00","060","0065","0000","1220","757","463","15","1235","2304","0","53.60","32.86"
"65","000","00","060","0065","2136","628","380","248","6","634","1178","0","53.82","32.26"
"65","000","00","060","0065","2137","592","377","215","9","601","1126","0","53.37","33.48"
"65","000","00","060","0066","0000","1655","1075","580","17","1672","3718","0","44.97","28.91"
"65","000","00","060","0066","2239","563","394","169","6","569","1296","0","43.90","30.40"
"65","000","00","060","0066","2240","585","381","204","6","591","1276","0","46.32","29.86"
"65","000","00","060","0066","2241","507","300","207","5","512","1146","0","44.68","26.18"
"65","000","00","060","0067","0000","2184","1265","919","27","2211","4949","0","44.68","25.56"
"65","000","00","060","0067","2242","511","311","200","6","517","1278","0","40.45","24.33"
"65","000","00","060","0067","2243","620","373","247","3","623","1230","0","50.65","30.33"
"65","000","00","060","0067","2244","559","319","240","13","572","1299","0","44.03","24.56"
"65","000","00","060","0067","2245","494","262","232","5","499","1142","0","43.70","22.94"
"65","000","00","060","0068","0000","1670","1174","496","9","1679","3614","0","46.46","32.48"
"65","000","00","060","0068","2263","335","239","96","3","338","799","0","42.30","29.91"
"65","000","00","060","0068","2264","612","419","193","6","618","1213","0","50.95","34.54"
"65","000","00","060","0068","2265","723","516","207","0","723","1602","0","45.13","32.21"
"65","000","00","060","0069","0000","1301","773","528","18","1319","2551","0","51.71","30.30"
"65","000","00","060","0069","2296","541","318","223","8","549","1042","0","52.69","30.52"
"65","000","00","060","0069","2297","760","455","305","10","770","1509","0","51.03","30.15"
"65","000","00","070","0000","0000","61445","26834","34611","580","62025","152907","182668","40.56","17.55"
"65","000","00","070","0001","0000","1392","538","854","8","1400","3594","0","38.95","14.97"
"65","000","00","070","0001","1726","677","259","418","5","682","1939","0","35.17","13.36"
"65","000","00","070","0001","1727","715","279","436","3","718","1655","0","43.38","16.86"
"65","000","00","070","0002","0000","1335","605","730","18","1353","3437","0","39.37","17.60"
"65","000","00","070","0002","1723","419","177","242","3","422","1105","0","38.19","16.02"
"65","000","00","070","0002","1724","411","188","223","7","418","1093","0","38.24","17.20"
"65","000","00","070","0002","1725","505","240","265","8","513","1239","0","41.40","19.37"
"65","000","00","070","0003","0000","1568","665","903","12","1580","4203","0","37.59","15.82"
"65","000","00","070","0003","1720","436","193","243","2","438","1189","0","36.84","16.23"
"65","000","00","070","0003","1721","513","228","285","5","518","1351","0","38.34","16.88"
"65","000","00","070","0003","1722","619","244","375","5","624","1663","0","37.52","14.67"
"65","000","00","070","0004","0000","1331","481","850","13","1344","3354","0","40.07","14.34"
"65","000","00","070","0004","1749","454","164","290","5","459","1041","0","44.09","15.75"
"65","000","00","070","0004","1750","429","145","284","5","434","1133","0","38.31","12.80"
"65","000","00","070","0004","1751","448","172","276","3","451","1180","0","38.22","14.58"
"65","000","00","070","0005","0000","2346","1021","1325","28","2374","5473","0","43.38","18.66"
"65","000","00","070","0005","1745","629","255","374","4","633","1476","0","42.89","17.28"
"65","000","00","070","0005","1746","684","336","348","11","695","1500","0","46.33","22.40"
"65","000","00","070","0005","1747","599","258","341","10","609","1443","0","42.20","17.88"
"65","000","00","070","0005","1748","434","172","262","3","437","1054","0","41.46","16.32"
"65","000","00","070","0006","0000","1554","627","927","10","1564","4463","0","35.04","14.05"
"65","000","00","070","0006","1739","539","188","351","4","543","2105","0","25.80","8.93"
"65","000","00","070","0006","1740","394","173","221","3","397","870","0","45.63","19.89"
"65","000","00","070","0006","1741","621","266","355","3","624","1488","0","41.94","17.88"
"65","000","00","070","0007","0000","1549","547","1002","12","1561","4406","0","35.43","12.41"
"65","000","00","070","0007","1730","575","193","382","4","579","1428","0","40.55","13.52"
"65","000","00","070","0007","1731","508","176","332","1","509","1439","0","35.37","12.23"
"65","000","00","070","0007","1732","466","178","288","7","473","1539","0","30.73","11.57"
"65","000","00","070","0008","0000","1488","693","795","13","1501","3190","0","47.05","21.72"
"65","000","00","070","0008","1758","395","199","196","3","398","883","0","45.07","22.54"
"65","000","00","070","0008","1759","646","296","350","3","649","1314","0","49.39","22.53"
"65","000","00","070","0008","1760","447","198","249","7","454","993","0","45.72","19.94"
"65","000","00","070","0009","0000","2097","924","1173","17","2114","4496","0","47.02","20.55"
"65","000","00","070","0009","1763","668","304","364","4","672","1381","0","48.66","22.01"
"65","000","00","070","0009","1764","749","341","408","6","755","1580","0","47.78","21.58"
"65","000","00","070","0009","1765","680","279","401","7","687","1535","0","44.76","18.18"
"65","000","00","070","0010","0000","1623","709","914","13","1636","3699","0","44.23","19.17"
"65","000","00","070","0010","1773","512","191","321","6","518","1189","0","43.57","16.06"
"65","000","00","070","0010","1774","580","269","311","2","582","1306","0","44.56","20.60"
"65","000","00","070","0010","1775","531","249","282","5","536","1204","0","44.52","20.68"
"65","000","00","070","0011","0000","1221","629","592","8","1229","2937","0","41.85","21.42"
"65","000","00","070","0011","1769","696","355","341","4","700","1698","0","41.22","20.91"
"65","000","00","070","0011","1770","525","274","251","4","529","1239","0","42.70","22.11"
"65","000","00","070","0012","0000","585","222","363","6","591","1506","0","39.24","14.74"
"65","000","00","070","0012","1776","585","222","363","6","591","1506","0","39.24","14.74"
"65","000","00","070","0013","0000","445","219","226","1","446","1073","0","41.57","20.41"
"65","000","00","070","0013","1777","445","219","226","1","446","1073","0","41.57","20.41"
"65","000","00","070","0014","0000","1314","636","678","9","1323","3130","0","42.27","20.32"
"65","000","00","070","0014","1792","675","329","346","5","680","1495","0","45.48","22.01"
"65","000","00","070","0014","1793","639","307","332","4","643","1635","0","39.33","18.78"
"65","000","00","070","0015","0000","1338","557","781","16","1354","3345","0","40.48","16.65"
"65","000","00","070","0015","1782","504","237","267","2","506","1218","0","41.54","19.46"
"65","000","00","070","0015","1783","422","170","252","5","427","1087","0","39.28","15.64"
"65","000","00","070","0015","1784","412","150","262","9","421","1040","0","40.48","14.42"
"65","000","00","070","0016","0000","1555","589","966","12","1567","4373","0","35.83","13.47"
"65","000","00","070","0016","1789","548","198","350","4","552","1502","0","36.75","13.18"
"65","000","00","070","0016","1790","519","211","308","3","522","1432","0","36.45","14.73"
"65","000","00","070","0016","1791","488","180","308","5","493","1439","0","34.26","12.51"
"65","000","00","070","0017","0000","1813","766","1047","20","1833","4657","0","39.36","16.45"
"65","000","00","070","0017","1779","637","292","345","7","644","1718","0","37.49","17.00"
"65","000","00","070","0017","1780","584","203","381","10","594","1506","0","39.44","13.48"
"65","000","00","070","0017","1781","592","271","321","3","595","1433","0","41.52","18.91"
"65","000","00","070","0018","0000","1096","449","647","16","1112","2876","0","38.66","15.61"
"65","000","00","070","0018","1805","645","267","378","9","654","1634","0","40.02","16.34"
"65","000","00","070","0018","1806","451","182","269","7","458","1242","0","36.88","14.65"
"65","000","00","070","0019","0000","1984","864","1120","16","2000","5229","0","38.25","16.52"
"65","000","00","070","0019","1801","492","196","296","8","500","1284","0","38.94","15.26"
"65","000","00","070","0019","1802","448","189","259","1","449","1236","0","36.33","15.29"
"65","000","00","070","0019","1803","479","227","252","3","482","1378","0","34.98","16.47"
"65","000","00","070","0019","1804","565","252","313","4","569","1331","0","42.75","18.93"
"65","000","00","070","0020","0000","1759","751","1008","33","1792","4435","0","40.41","16.93"
"65","000","00","070","0020","1798","764","280","484","11","775","1881","0","41.20","14.89"
"65","000","00","070","0020","1799","643","297","346","17","660","1685","0","39.17","17.63"
"65","000","00","070","0020","1800","352","174","178","5","357","869","0","41.08","20.02"
"65","000","00","070","0021","0000","627","262","365","7","634","1769","0","35.84","14.81"
"65","000","00","070","0021","1814","627","262","365","7","634","1769","0","35.84","14.81"
"65","000","00","070","0022","0000","603","179","424","2","605","1494","0","40.50","11.98"
"65","000","00","070","0022","1828","603","179","424","2","605","1494","0","40.50","11.98"
"65","000","00","070","0023","0000","636","202","434","11","647","1602","0","40.39","12.61"
"65","000","00","070","0023","1820","636","202","434","11","647","1602","0","40.39","12.61"
"65","000","00","070","0024","0000","5258","2808","2450","36","5294","12321","0","42.97","22.79"
"65","000","00","070","0024","1821","724","330","394","6","730","1661","0","43.95","19.87"
"65","000","00","070","0024","1822","701","357","344","4","705","1589","0","44.37","22.47"
"65","000","00","070","0024","1823","862","472","390","8","870","1818","0","47.85","25.96"
"65","000","00","070","0024","1824","808","437","371","3","811","1807","0","44.88","24.18"
"65","000","00","070","0024","1825","784","455","329","2","786","1741","0","45.15","26.13"
"65","000","00","070","0024","1826","705","395","310","6","711","1890","0","37.62","20.90"
"65","000","00","070","0024","1827","674","362","312","7","681","1815","0","37.52","19.94"
"65","000","00","070","0025","0000","788","250","538","8","796","1967","0","40.47","12.71"
"65","000","00","070","0025","1829","358","124","234","4","362","926","0","39.09","13.39"
"65","000","00","070","0025","1830","430","126","304","4","434","1041","0","41.69","12.10"
"65","000","00","070","0026","0000","3484","1804","1680","36","3520","8030","0","43.84","22.47"
"65","000","00","070","0026","1815","554","195","359","8","562","1414","0","39.75","13.79"
"65","000","00","070","0026","1816","725","366","359","9","734","1769","0","41.49","20.69"
"65","000","00","070","0026","1817","777","433","344","7","784","1718","0","45.63","25.20"
"65","000","00","070","0026","1818","829","460","369","10","839","1722","0","48.72","26.71"
"65","000","00","070","0026","1819","599","350","249","2","601","1407","0","42.71","24.88"
"65","000","00","070","0027","0000","427","187","240","3","430","853","0","50.41","21.92"
"65","000","00","070","0027","1778","427","187","240","3","430","853","0","50.41","21.92"
"65","000","00","070","0028","0000","1533","675","858","10","1543","3833","0","40.26","17.61"
"65","000","00","070","0028","1752","579","274","305","0","579","1521","0","38.07","18.01"
"65","000","00","070","0028","1753","483","212","271","5","488","1147","0","42.55","18.48"
"65","000","00","070","0028","1754","471","189","282","5","476","1165","0","40.86","16.22"
"65","000","00","070","0029","0000","1331","616","715","9","1340","3184","0","42.09","19.35"
"65","000","00","070","0029","1766","396","211","185","2","398","1021","0","38.98","20.67"
"65","000","00","070","0029","1767","523","223","300","4","527","1182","0","44.59","18.87"
"65","000","00","070","0029","1768","412","182","230","3","415","981","0","42.30","18.55"
"65","000","00","070","0030","0000","1502","756","746","20","1522","3145","0","48.39","24.04"
"65","000","00","070","0030","1761","735","328","407","12","747","1619","0","46.14","20.26"
"65","000","00","070","0030","1762","767","428","339","8","775","1526","0","50.79","28.05"
"65","000","00","070","0031","0000","1357","539","818","12","1369","3600","0","38.03","14.97"
"65","000","00","070","0031","1733","462","168","294","4","466","1168","0","39.90","14.38"
"65","000","00","070","0031","1734","433","172","261","5","438","1301","0","33.67","13.22"
"65","000","00","070","0031","1735","462","199","263","3","465","1131","0","41.11","17.60"
"65","000","00","070","0032","0000","1460","568","892","26","1486","3906","0","38.04","14.54"
"65","000","00","070","0032","1736","448","178","270","9","457","1224","0","37.34","14.54"
"65","000","00","070","0032","1737","534","207","327","9","543","1374","0","39.52","15.07"
"65","000","00","070","0032","1738","478","183","295","8","486","1308","0","37.16","13.99"
"65","000","00","070","0033","0000","1825","714","1111","10","1835","5086","0","36.08","14.04"
"65","000","00","070","0033","1785","405","168","237","3","408","1134","0","35.98","14.81"
"65","000","00","070","0033","1786","400","185","215","2","402","1201","0","33.47","15.40"
"65","000","00","070","0033","1787","460","169","291","3","463","1264","0","36.63","13.37"
"65","000","00","070","0033","1788","560","192","368","2","562","1487","0","37.79","12.91"
"65","000","00","070","0034","0000","1840","833","1007","21","1861","4401","0","42.29","18.93"
"65","000","00","070","0034","1742","597","256","341","8","605","1397","0","43.31","18.32"
"65","000","00","070","0034","1743","621","283","338","9","630","1455","0","43.30","19.45"
"65","000","00","070","0034","1744","622","294","328","4","626","1549","0","40.41","18.98"
"65","000","00","070","0035","0000","1875","773","1102","16","1891","5096","0","37.11","15.17"
"65","000","00","070","0035","1807","428","173","255","3","431","1320","0","32.65","13.11"
"65","000","00","070","0035","1808","598","233","365","8","606","1594","0","38.02","14.62"
"65","000","00","070","0035","1809","408","191","217","1","409","1062","0","38.51","17.98"
"65","000","00","070","0035","1810","441","176","265","4","445","1120","0","39.73","15.71"
"65","000","00","070","0036","0000","1833","745","1088","24","1857","4640","0","40.02","16.06"
"65","000","00","070","0036","1811","645","260","385","7","652","1604","0","40.65","16.21"
"65","000","00","070","0036","1812","627","269","358","7","634","1501","0","42.24","17.92"
"65","000","00","070","0036","1813","561","216","345","10","571","1535","0","37.20","14.07"
"65","000","00","070","0037","0000","1245","559","686","13","1258","2790","0","45.09","20.04"
"65","000","00","070","0037","1771","645","257","388","6","651","1461","0","44.56","17.59"
"65","000","00","070","0037","1772","600","302","298","7","607","1329","0","45.67","22.72"
"65","000","00","070","0038","0000","1107","528","579","9","1116","3019","0","36.97","17.49"
"65","000","00","070","0038","1794","567","268","299","3","570","1594","0","35.76","16.81"
"65","000","00","070","0038","1795","540","260","280","6","546","1425","0","38.32","18.25"
"65","000","00","070","0039","0000","861","357","504","3","864","2412","0","35.82","14.80"
"65","000","00","070","0039","1796","413","190","223","2","415","1168","0","35.53","16.27"
"65","000","00","070","0039","1797","448","167","281","1","449","1244","0","36.09","13.42"
"65","000","00","070","0040","0000","1030","475","555","14","1044","2578","0","40.50","18.43"
"65","000","00","070","0040","1755","510","229","281","7","517","1260","0","41.03","18.17"
"65","000","00","070","0040","1756","520","246","274","7","527","1318","0","39.98","18.66"
"65","000","00","070","0041","0000","610","189","421","4","614","1430","0","42.94","13.22"
"65","000","00","070","0041","1757","610","189","421","4","614","1430","0","42.94","13.22"
"65","000","00","070","0042","0000","820","323","497","5","825","1875","0","44.00","17.23"
"65","000","00","070","0042","1728","294","107","187","3","297","737","0","40.30","14.52"
"65","000","00","070","0042","1729","526","216","310","2","528","1138","0","46.40","18.98"
"65","000","00","080","0000","0000","28942","12763","16179","241","29183","73981","88131","39.45","17.25"
"65","000","00","080","0001","0000","439","190","249","7","446","946","0","47.15","20.08"
"65","000","00","080","0001","1832","439","190","249","7","446","946","0","47.15","20.08"
"65","000","00","080","0002","0000","863","401","462","5","868","1968","0","44.11","20.38"
"65","000","00","080","0002","1836","451","208","243","0","451","978","0","46.11","21.27"
"65","000","00","080","0002","1837","412","193","219","5","417","990","0","42.12","19.49"
"65","000","00","080","0003","0000","2135","922","1213","14","2149","4997","0","43.01","18.45"
"65","000","00","080","0003","1839","760","322","438","5","765","1745","0","43.84","18.45"
"65","000","00","080","0003","1840","696","296","400","4","700","1634","0","42.84","18.12"
"65","000","00","080","0003","1841","679","304","375","5","684","1618","0","42.27","18.79"
"65","000","00","080","0004","0000","1483","724","759","12","1495","3748","0","39.89","19.32"
"65","000","00","080","0004","1833","439","210","229","4","443","967","0","45.81","21.72"
"65","000","00","080","0004","1834","503","236","267","3","506","1447","0","34.97","16.31"
"65","000","00","080","0004","1835","541","278","263","5","546","1334","0","40.93","20.84"
"65","000","00","080","0005","0000","464","198","266","4","468","940","0","49.79","21.06"
"65","000","00","080","0005","1838","464","198","266","4","468","940","0","49.79","21.06"
"65","000","00","080","0006","0000","240","100","140","1","241","518","0","46.53","19.31"
"65","000","00","080","0006","1831","240","100","140","1","241","518","0","46.53","19.31"
"65","000","00","080","0007","0000","636","259","377","2","638","1386","0","46.03","18.69"
"65","000","00","080","0007","1860","636","259","377","2","638","1386","0","46.03","18.69"
"65","000","00","080","0008","0000","2842","1276","1566","28","2870","7317","0","39.22","17.44"
"65","000","00","080","0008","1861","533","255","278","9","542","1292","0","41.95","19.74"
"65","000","00","080","0008","1862","527","247","280","4","531","1341","0","39.60","18.42"
"65","000","00","080","0008","1863","448","200","248","0","448","1229","0","36.45","16.27"
"65","000","00","080","0008","1864","447","223","224","6","453","1334","0","33.96","16.72"
"65","000","00","080","0008","1865","448","171","277","6","454","1027","0","44.21","16.65"
"65","000","00","080","0008","1866","439","180","259","3","442","1094","0","40.40","16.45"
"65","000","00","080","0009","0000","1318","507","811","11","1329","3154","0","42.14","16.07"
"65","000","00","080","0009","1857","392","173","219","1","393","884","0","44.46","19.57"
"65","000","00","080","0009","1858","588","210","378","9","597","1324","0","45.09","15.86"
"65","000","00","080","0009","1859","338","124","214","1","339","946","0","35.84","13.11"
"65","000","00","080","0010","0000","2946","1276","1670","24","2970","7755","0","38.30","16.45"
"65","000","00","080","0010","1852","682","309","373","2","684","1700","0","40.24","18.18"
"65","000","00","080","0010","1853","686","299","387","5","691","1670","0","41.38","17.90"
"65","000","00","080","0010","1854","513","231","282","3","516","1471","0","35.08","15.70"
"65","000","00","080","0010","1855","493","209","284","7","500","1295","0","38.61","16.14"
"65","000","00","080","0010","1856","572","228","344","7","579","1619","0","35.76","14.08"
"65","000","00","080","0011","0000","2657","1105","1552","21","2678","7334","0","36.51","15.07"
"65","000","00","080","0011","1847","531","201","330","3","534","1635","0","32.66","12.29"
"65","000","00","080","0011","1848","562","263","299","7","569","1547","0","36.78","17.00"
"65","000","00","080","0011","1849","467","197","270","1","468","1284","0","36.45","15.34"
"65","000","00","080","0011","1850","475","188","287","3","478","1279","0","37.37","14.70"
"65","000","00","080","0011","1851","622","256","366","7","629","1589","0","39.58","16.11"
"65","000","00","080","0012","0000","376","156","220","5","381","836","0","45.57","18.66"
"65","000","00","080","0012","1846","376","156","220","5","381","836","0","45.57","18.66"
"65","000","00","080","0013","0000","149","60","89","1","150","250","0","60.00","24.00"
"65","000","00","080","0013","1886","149","60","89","1","150","250","0","60.00","24.00"
"65","000","00","080","0014","0000","1873","901","972","17","1890","4527","0","41.75","19.90"
"65","000","00","080","0014","1879","583","252","331","5","588","1478","0","39.78","17.05"
"65","000","00","080","0014","1880","716","365","351","5","721","1698","0","42.46","21.50"
"65","000","00","080","0014","1881","574","284","290","7","581","1351","0","43.01","21.02"
"65","000","00","080","0015","0000","1757","773","984","14","1771","4996","0","35.45","15.47"
"65","000","00","080","0015","1873","523","234","289","4","527","1466","0","35.95","15.96"
"65","000","00","080","0015","1874","604","278","326","7","611","1714","0","35.65","16.22"
"65","000","00","080","0015","1875","630","261","369","3","633","1816","0","34.86","14.37"
"65","000","00","080","0016","0000","1473","653","820","14","1487","3896","0","38.17","16.76"
"65","000","00","080","0016","1876","519","217","302","6","525","1338","0","39.24","16.22"
"65","000","00","080","0016","1877","518","241","277","4","522","1282","0","40.72","18.80"
"65","000","00","080","0016","1878","436","195","241","4","440","1276","0","34.48","15.28"
"65","000","00","080","0017","0000","1710","810","900","18","1728","4275","0","40.42","18.95"
"65","000","00","080","0017","1867","612","294","318","7","619","1529","0","40.48","19.23"
"65","000","00","080","0017","1868","617","297","320","8","625","1496","0","41.78","19.85"
"65","000","00","080","0017","1869","481","219","262","3","484","1250","0","38.72","17.52"
"65","000","00","080","0018","0000","1827","855","972","14","1841","5088","0","36.18","16.80"
"65","000","00","080","0018","1882","526","223","303","4","530","1346","0","39.38","16.57"
"65","000","00","080","0018","1883","476","209","267","3","479","1250","0","38.32","16.72"
"65","000","00","080","0018","1884","481","261","220","3","484","1298","0","37.29","20.11"
"65","000","00","080","0018","1885","344","162","182","4","348","1194","0","29.15","13.57"
"65","000","00","080","0019","0000","1450","633","817","10","1460","3878","0","37.65","16.32"
"65","000","00","080","0019","1870","566","243","323","6","572","1510","0","37.88","16.09"
"65","000","00","080","0019","1871","448","192","256","1","449","1143","0","39.28","16.80"
"65","000","00","080","0019","1872","436","198","238","3","439","1225","0","35.84","16.16"
"65","000","00","080","0020","0000","2304","964","1340","19","2323","6172","0","37.64","15.62"
"65","000","00","080","0020","1842","611","247","364","9","620","1544","0","40.16","16.00"
"65","000","00","080","0020","1843","577","230","347","3","580","1538","0","37.71","14.95"
"65","000","00","080","0020","1844","528","215","313","3","531","1496","0","35.49","14.37"
"65","000","00","080","0020","1845","588","272","316","4","592","1594","0","37.14","17.06"
"65","000","00","090","0000","0000","36172","17386","18786","357","36529","96164","116549","37.99","18.08"
"65","000","00","090","0001","0000","161","73","88","3","164","285","0","57.54","25.61"
"65","000","00","090","0001","2033","161","73","88","3","164","285","0","57.54","25.61"
"65","000","00","090","0002","0000","227","95","132","3","230","575","0","40.00","16.52"
"65","000","00","090","0002","2034","227","95","132","3","230","575","0","40.00","16.52"
"65","000","00","090","0003","0000","1353","629","724","12","1365","3542","0","38.54","17.76"
"65","000","00","090","0003","2035","387","181","206","5","392","991","0","39.56","18.26"
"65","000","00","090","0003","2036","476","235","241","5","481","1214","0","39.62","19.36"
"65","000","00","090","0003","2037","490","213","277","2","492","1337","0","36.80","15.93"
"65","000","00","090","0004","0000","1061","558","503","13","1074","3013","0","35.65","18.52"
"65","000","00","090","0004","2038","519","280","239","6","525","1465","0","35.84","19.11"
"65","000","00","090","0004","2039","542","278","264","7","549","1548","0","35.47","17.96"
"65","000","00","090","0005","0000","366","125","241","2","368","1027","0","35.83","12.17"
"65","000","00","090","0005","2040","366","125","241","2","368","1027","0","35.83","12.17"
"65","000","00","090","0006","0000","2548","1158","1390","27","2575","6463","0","39.84","17.92"
"65","000","00","090","0006","2041","535","301","234","8","543","1332","0","40.77","22.60"
"65","000","00","090","0006","2042","419","174","245","0","419","1094","0","38.30","15.90"
"65","000","00","090","0006","2043","511","239","272","5","516","1310","0","39.39","18.24"
"65","000","00","090","0006","2044","486","184","302","4","490","1218","0","40.23","15.11"
"65","000","00","090","0006","2045","597","260","337","10","607","1509","0","40.23","17.23"
"65","000","00","090","0007","0000","1920","902","1018","14","1934","5237","0","36.93","17.22"
"65","000","00","090","0007","2069","495","240","255","3","498","1421","0","35.05","16.89"
"65","000","00","090","0007","2070","440","201","239","6","446","1229","0","36.29","16.35"
"65","000","00","090","0007","2071","479","221","258","4","483","1251","0","38.61","17.67"
"65","000","00","090","0007","2072","506","240","266","1","507","1336","0","37.95","17.96"
"65","000","00","090","0008","0000","3067","1388","1679","34","3101","8816","0","35.17","15.74"
"65","000","00","090","0008","2046","504","218","286","8","512","1461","0","35.04","14.92"
"65","000","00","090","0008","2047","448","203","245","10","458","1340","0","34.18","15.15"
"65","000","00","090","0008","2048","517","251","266","4","521","1432","0","36.38","17.53"
"65","000","00","090","0008","2049","549","234","315","8","557","1547","0","36.01","15.13"
"65","000","00","090","0008","2050","459","195","264","3","462","1420","0","32.54","13.73"
"65","000","00","090","0008","2051","590","287","303","1","591","1616","0","36.57","17.76"
"65","000","00","090","0009","0000","3091","1509","1582","37","3128","8410","0","37.19","17.94"
"65","000","00","090","0009","2052","481","183","298","5","486","1558","0","31.19","11.75"
"65","000","00","090","0009","2053","604","308","296","12","616","1793","0","34.36","17.18"
"65","000","00","090","0009","2054","661","329","332","11","672","1768","0","38.01","18.61"
"65","000","00","090","0009","2055","638","344","294","4","642","1584","0","40.53","21.72"
"65","000","00","090","0009","2056","707","345","362","5","712","1707","0","41.71","20.21"
"65","000","00","090","0010","0000","1346","696","650","11","1357","3676","0","36.92","18.93"
"65","000","00","090","0010","2084","365","171","194","1","366","1155","0","31.69","14.81"
"65","000","00","090","0010","2085","419","188","231","6","425","1163","0","36.54","16.17"
"65","000","00","090","0010","2086","562","337","225","4","566","1358","0","41.68","24.82"
"65","000","00","090","0011","0000","840","441","399","12","852","2111","0","40.36","20.89"
"65","000","00","090","0011","2087","415","212","203","6","421","1100","0","38.27","19.27"
"65","000","00","090","0011","2088","425","229","196","6","431","1011","0","42.63","22.65"
"65","000","00","090","0012","0000","379","143","236","7","386","1045","0","36.94","13.68"
"65","000","00","090","0012","2089","379","143","236","7","386","1045","0","36.94","13.68"
"65","000","00","090","0013","0000","176","64","112","4","180","486","0","37.04","13.17"
"65","000","00","090","0013","2090","176","64","112","4","180","486","0","37.04","13.17"
"65","000","00","090","0014","0000","231","104","127","5","236","794","0","29.72","13.10"
"65","000","00","090","0014","2091","231","104","127","5","236","794","0","29.72","13.10"
"65","000","00","090","0015","0000","279","88","191","3","282","632","0","44.62","13.92"
"65","000","00","090","0015","2092","279","88","191","3","282","632","0","44.62","13.92"
"65","000","00","090","0016","0000","216","63","153","2","218","683","0","31.92","9.22"
"65","000","00","090","0016","2093","216","63","153","2","218","683","0","31.92","9.22"
"65","000","00","090","0017","0000","871","350","521","8","879","2123","0","41.40","16.49"
"65","000","00","090","0017","2097","293","114","179","3","296","772","0","38.34","14.77"
"65","000","00","090","0017","2098","578","236","342","5","583","1351","0","43.15","17.47"
"65","000","00","090","0018","0000","587","232","355","7","594","1375","0","43.20","16.87"
"65","000","00","090","0018","2096","587","232","355","7","594","1375","0","43.20","16.87"
"65","000","00","090","0019","0000","986","454","532","10","996","2733","0","36.44","16.61"
"65","000","00","090","0019","2099","514","243","271","7","521","1397","0","37.29","17.39"
"65","000","00","090","0019","2100","472","211","261","3","475","1336","0","35.55","15.79"
"65","000","00","090","0020","0000","395","149","246","5","400","860","0","46.51","17.33"
"65","000","00","090","0020","2101","395","149","246","5","400","860","0","46.51","17.33"
"65","000","00","090","0021","0000","445","151","294","12","457","1294","0","35.32","11.67"
"65","000","00","090","0021","2104","445","151","294","12","457","1294","0","35.32","11.67"
"65","000","00","090","0022","0000","640","235","405","4","644","1870","0","34.44","12.57"
"65","000","00","090","0022","2102","250","65","185","1","251","732","0","34.29","8.88"
"65","000","00","090","0022","2103","390","170","220","3","393","1138","0","34.53","14.94"
"65","000","00","090","0023","0000","2006","895","1111","12","2018","6055","0","33.33","14.78"
"65","000","00","090","0023","2077","530","236","294","6","536","1521","0","35.24","15.52"
"65","000","00","090","0023","2078","514","231","283","1","515","1464","0","35.18","15.78"
"65","000","00","090","0023","2079","551","241","310","2","553","1548","0","35.72","15.57"
"65","000","00","090","0023","2080","411","187","224","3","414","1522","0","27.20","12.29"
"65","000","00","090","0024","0000","2319","1149","1170","25","2344","6654","0","35.23","17.27"
"65","000","00","090","0024","2073","542","226","316","3","545","1619","0","33.66","13.96"
"65","000","00","090","0024","2074","534","278","256","4","538","1739","0","30.94","15.99"
"65","000","00","090","0024","2075","537","291","246","8","545","1559","0","34.96","18.67"
"65","000","00","090","0024","2076","706","354","352","10","716","1737","0","41.22","20.38"
"65","000","00","090","0025","0000","1581","710","871","18","1599","4616","0","34.64","15.38"
"65","000","00","090","0025","2081","538","235","303","5","543","1567","0","34.65","15.00"
"65","000","00","090","0025","2082","518","266","252","7","525","1541","0","34.07","17.26"
"65","000","00","090","0025","2083","525","209","316","6","531","1508","0","35.21","13.86"
"65","000","00","090","0026","0000","1201","650","551","13","1214","3228","0","37.61","20.14"
"65","000","00","090","0026","2094","604","344","260","9","613","1596","0","38.41","21.55"
"65","000","00","090","0026","2095","597","306","291","4","601","1632","0","36.83","18.75"
"65","000","00","090","0027","0000","5476","3050","2426","40","5516","12581","0","43.84","24.24"
"65","000","00","090","0027","2061","660","347","313","4","664","1644","0","40.39","21.11"
"65","000","00","090","0027","2062","571","300","271","5","576","1487","0","38.74","20.17"
"65","000","00","090","0027","2063","800","469","331","5","805","1798","0","44.77","26.08"
"65","000","00","090","0027","2064","794","426","368","8","802","1605","0","49.97","26.54"
"65","000","00","090","0027","2065","645","356","289","5","650","1549","0","41.96","22.98"
"65","000","00","090","0027","2066","689","406","283","5","694","1533","0","45.27","26.48"
"65","000","00","090","0027","2067","659","405","254","2","661","1495","0","44.21","27.09"
"65","000","00","090","0027","2068","658","341","317","6","664","1470","0","45.17","23.20"
"65","000","00","090","0028","0000","2404","1325","1079","14","2418","5980","0","40.43","22.16"
"65","000","00","090","0028","2057","668","370","298","3","671","1602","0","41.89","23.10"
"65","000","00","090","0028","2058","684","380","304","6","690","1523","0","45.31","24.95"
"65","000","00","090","0028","2059","575","313","262","2","577","1410","0","40.92","22.20"
"65","000","00","090","0028","2060","477","262","215","3","480","1445","0","33.22","18.13"
"65","000","00","100","0000","0000","63238","32177","31061","586","63824","158577","184450","40.25","20.29"
"65","000","00","100","0001","0000","194","68","126","3","197","557","0","35.37","12.21"
"65","000","00","100","0001","0032","194","68","126","3","197","557","0","35.37","12.21"
"65","000","00","100","0002","0000","323","117","206","4","327","994","0","32.90","11.77"
"65","000","00","100","0002","0033","323","117","206","4","327","994","0","32.90","11.77"
"65","000","00","100","0003","0000","475","231","244","9","484","1447","0","33.45","15.96"
"65","000","00","100","0003","0034","475","231","244","9","484","1447","0","33.45","15.96"
"65","000","00","100","0004","0000","566","245","321","8","574","1510","0","38.01","16.23"
"65","000","00","100","0004","0035","566","245","321","8","574","1510","0","38.01","16.23"
"65","000","00","100","0005","0000","341","169","172","1","342","973","0","35.15","17.37"
"65","000","00","100","0005","0036","341","169","172","1","342","973","0","35.15","17.37"
"65","000","00","100","0006","0000","804","376","428","9","813","2422","0","33.57","15.52"
"65","000","00","100","0006","0038","398","177","221","4","402","1117","0","35.99","15.85"
"65","000","00","100","0006","0039","406","199","207","5","411","1305","0","31.49","15.25"
"65","000","00","100","0007","0000","323","149","174","7","330","803","0","41.10","18.56"
"65","000","00","100","0007","0037","323","149","174","7","330","803","0","41.10","18.56"
"65","000","00","100","0008","0000","6099","3407","2692","46","6145","17538","0","35.04","19.43"
"65","000","00","100","0008","0071","849","456","393","9","858","2045","0","41.96","22.30"
"65","000","00","100","0008","0072","593","342","251","7","600","2304","0","26.04","14.84"
"65","000","00","100","0008","0073","472","259","213","2","474","1275","0","37.18","20.31"
"65","000","00","100","0008","0074","556","286","270","3","559","1448","0","38.60","19.75"
"65","000","00","100","0008","0075","677","379","298","3","680","2254","0","30.17","16.81"
"65","000","00","100","0008","0076","619","360","259","7","626","1883","0","33.24","19.12"
"65","000","00","100","0008","0077","563","302","261","1","564","1442","0","39.11","20.94"
"65","000","00","100","0008","0078","881","515","366","5","886","2402","0","36.89","21.44"
"65","000","00","100","0008","0079","889","508","381","9","898","2485","0","36.14","20.44"
"65","000","00","100","0009","0000","579","261","318","4","583","1616","0","36.08","16.15"
"65","000","00","100","0009","0080","579","261","318","4","583","1616","0","36.08","16.15"
"65","000","00","100","0010","0000","2520","1348","1172","27","2547","6573","0","38.75","20.51"
"65","000","00","100","0010","0090","519","259","260","7","526","1383","0","38.03","18.73"
"65","000","00","100","0010","0091","687","409","278","8","695","1742","0","39.90","23.48"
"65","000","00","100","0010","0092","589","304","285","7","596","1575","0","37.84","19.30"
"65","000","00","100","0010","0093","725","376","349","5","730","1873","0","38.97","20.07"
"65","000","00","100","0011","0000","1979","916","1063","27","2006","5098","0","39.35","17.97"
"65","000","00","100","0011","0081","544","246","298","9","553","1445","0","38.27","17.02"
"65","000","00","100","0011","0082","470","237","233","3","473","1149","0","41.17","20.63"
"65","000","00","100","0011","0083","465","210","255","6","471","1207","0","39.02","17.40"
"65","000","00","100","0011","0084","500","223","277","9","509","1297","0","39.24","17.19"
"65","000","00","100","0012","0000","3657","1936","1721","30","3687","9067","0","40.66","21.35"
"65","000","00","100","0012","0106","750","378","372","3","753","1908","0","39.47","19.81"
"65","000","00","100","0012","0107","508","242","266","7","515","1358","0","37.92","17.82"
"65","000","00","100","0012","0108","947","500","447","11","958","2153","0","44.50","23.22"
"65","000","00","100","0012","0109","743","414","329","2","745","1837","0","40.56","22.54"
"65","000","00","100","0012","0110","709","402","307","7","716","1811","0","39.54","22.20"
"65","000","00","100","0013","0000","743","259","484","8","751","1974","0","38.04","13.12"
"65","000","00","100","0013","0040","423","167","256","4","427","1136","0","37.59","14.70"
"65","000","00","100","0013","0041","320","92","228","4","324","838","0","38.66","10.98"
"65","000","00","100","0014","0000","401","145","256","5","406","1054","0","38.52","13.76"
"65","000","00","100","0014","0042","401","145","256","5","406","1054","0","38.52","13.76"
"65","000","00","100","0015","0000","548","255","293","6","554","1361","0","40.71","18.74"
"65","000","00","100","0015","0043","548","255","293","6","554","1361","0","40.71","18.74"
"65","000","00","100","0016","0000","543","262","281","5","548","1263","0","43.39","20.74"
"65","000","00","100","0016","0044","543","262","281","5","548","1263","0","43.39","20.74"
"65","000","00","100","0017","0000","3086","1680","1406","23","3109","6369","0","48.81","26.38"
"65","000","00","100","0017","0045","875","465","410","9","884","1797","0","49.19","25.88"
"65","000","00","100","0017","0046","507","259","248","0","507","1021","0","49.66","25.37"
"65","000","00","100","0017","0047","488","277","211","4","492","1016","0","48.43","27.26"
"65","000","00","100","0017","0048","626","334","292","4","630","1241","0","50.77","26.91"
"65","000","00","100","0017","0049","590","345","245","6","596","1294","0","46.06","26.66"
"65","000","00","100","0018","0000","2567","1346","1221","22","2589","5639","0","45.91","23.87"
"65","000","00","100","0018","0050","538","262","276","4","542","1302","0","41.63","20.12"
"65","000","00","100","0018","0051","639","370","269","5","644","1240","0","51.94","29.84"
"65","000","00","100","0018","0052","640","317","323","7","647","1418","0","45.63","22.36"
"65","000","00","100","0018","0053","750","397","353","6","756","1679","0","45.03","23.65"
"65","000","00","100","0019","0000","2761","1355","1406","13","2774","6465","0","42.91","20.96"
"65","000","00","100","0019","0057","780","383","397","5","785","1819","0","43.16","21.06"
"65","000","00","100","0019","0058","563","229","334","3","566","1252","0","45.21","18.29"
"65","000","00","100","0019","0059","688","331","357","4","692","1570","0","44.08","21.08"
"65","000","00","100","0019","0060","730","412","318","1","731","1824","0","40.08","22.59"
"65","000","00","100","0020","0000","2561","1351","1210","32","2593","6014","0","43.12","22.46"
"65","000","00","100","0020","0061","628","313","315","7","635","1474","0","43.08","21.23"
"65","000","00","100","0020","0062","663","338","325","8","671","1626","0","41.27","20.79"
"65","000","00","100","0020","0063","533","315","218","10","543","1327","0","40.92","23.74"
"65","000","00","100","0020","0064","737","385","352","7","744","1587","0","46.88","24.26"
"65","000","00","100","0021","0000","4064","2211","1853","38","4102","10029","0","40.90","22.05"
"65","000","00","100","0021","0065","742","438","304","6","748","1824","0","41.01","24.01"
"65","000","00","100","0021","0066","785","409","376","8","793","1862","0","42.59","21.97"
"65","000","00","100","0021","0067","674","387","287","7","681","1788","0","38.09","21.64"
"65","000","00","100","0021","0068","698","325","373","6","704","1653","0","42.59","19.66"
"65","000","00","100","0021","0069","622","358","264","8","630","1381","0","45.62","25.92"
"65","000","00","100","0021","0070","543","294","249","3","546","1521","0","35.90","19.33"
"65","000","00","100","0022","0000","2290","1177","1113","23","2313","5542","0","41.74","21.24"
"65","000","00","100","0022","0111","549","294","255","7","556","1280","0","43.44","22.97"
"65","000","00","100","0022","0112","407","219","188","7","414","981","0","42.20","22.32"
"65","000","00","100","0022","0113","554","264","290","7","561","1209","0","46.40","21.84"
"65","000","00","100","0022","0114","342","184","158","1","343","958","0","35.80","19.21"
"65","000","00","100","0022","0115","438","216","222","1","439","1114","0","39.41","19.39"
"65","000","00","100","0023","0000","1395","660","735","18","1413","3650","0","38.71","18.08"
"65","000","00","100","0023","0123","462","208","254","6","468","1305","0","35.86","15.94"
"65","000","00","100","0023","0124","488","232","256","6","494","1284","0","38.47","18.07"
"65","000","00","100","0023","0125","445","220","225","6","451","1061","0","42.51","20.74"
"65","000","00","100","0024","0000","608","269","339","9","617","1326","0","46.53","20.29"
"65","000","00","100","0024","0126","608","269","339","9","617","1326","0","46.53","20.29"
"65","000","00","100","0025","0000","422","169","253","3","425","1068","0","39.79","15.82"
"65","000","00","100","0025","0127","422","169","253","3","425","1068","0","39.79","15.82"
"65","000","00","100","0026","0000","305","123","182","5","310","682","0","45.45","18.04"
"65","000","00","100","0026","0128","305","123","182","5","310","682","0","45.45","18.04"
"65","000","00","100","0027","0000","519","225","294","3","522","1339","0","38.98","16.80"
"65","000","00","100","0027","0129","519","225","294","3","522","1339","0","38.98","16.80"
"65","000","00","100","0028","0000","397","173","224","3","400","804","0","49.75","21.52"
"65","000","00","100","0028","0130","397","173","224","3","400","804","0","49.75","21.52"
"65","000","00","100","0029","0000","315","130","185","8","323","624","0","51.76","20.83"
"65","000","00","100","0029","0131","315","130","185","8","323","624","0","51.76","20.83"
"65","000","00","100","0030","0000","184","81","103","2","186","396","0","46.97","20.45"
"65","000","00","100","0030","0132","184","81","103","2","186","396","0","46.97","20.45"
"65","000","00","100","0031","0000","666","353","313","6","672","1587","0","42.34","22.24"
"65","000","00","100","0031","0133","666","353","313","6","672","1587","0","42.34","22.24"
"65","000","00","100","0032","0000","2042","1094","948","20","2062","4932","0","41.81","22.18"
"65","000","00","100","0032","0134","674","377","297","2","676","1590","0","42.52","23.71"
"65","000","00","100","0032","0135","777","414","363","14","791","1743","0","45.38","23.75"
"65","000","00","100","0032","0136","591","303","288","4","595","1599","0","37.21","18.95"
"65","000","00","100","0033","0000","1590","842","748","9","1599","4158","0","38.46","20.25"
"65","000","00","100","0033","0137","604","305","299","3","607","1668","0","36.39","18.29"
"65","000","00","100","0033","0138","568","278","290","4","572","1410","0","40.57","19.72"
"65","000","00","100","0033","0139","418","259","159","2","420","1080","0","38.89","23.98"
"65","000","00","100","0034","0000","1350","566","784","13","1363","3658","0","37.26","15.47"
"65","000","00","100","0034","0094","474","201","273","6","480","1250","0","38.40","16.08"
"65","000","00","100","0034","0095","358","144","214","2","360","1050","0","34.29","13.71"
"65","000","00","100","0034","0096","518","221","297","5","523","1358","0","38.51","16.27"
"65","000","00","100","0035","0000","2937","1449","1488","23","2960","7974","0","37.12","18.17"
"65","000","00","100","0035","0097","589","260","329","1","590","1563","0","37.75","16.63"
"65","000","00","100","0035","0098","560","277","283","8","568","1551","0","36.62","17.86"
"65","000","00","100","0035","0099","509","271","238","1","510","1485","0","34.34","18.25"
"65","000","00","100","0035","0100","374","204","170","5","379","927","0","40.88","22.01"
"65","000","00","100","0035","0101","417","181","236","4","421","1200","0","35.08","15.08"
"65","000","00","100","0035","0102","488","256","232","4","492","1248","0","39.42","20.51"
"65","000","00","100","0036","0000","1759","882","877","14","1773","4269","0","41.53","20.66"
"65","000","00","100","0036","0103","626","278","348","5","631","1450","0","43.52","19.17"
"65","000","00","100","0036","0104","540","290","250","5","545","1384","0","39.38","20.95"
"65","000","00","100","0036","0105","593","314","279","4","597","1435","0","41.60","21.88"
"65","000","00","100","0037","0000","1644","892","752","13","1657","4169","0","39.75","21.40"
"65","000","00","100","0037","0087","615","316","299","3","618","1519","0","40.68","20.80"
"65","000","00","100","0037","0088","546","298","248","5","551","1402","0","39.30","21.26"
"65","000","00","100","0037","0089","483","278","205","5","488","1248","0","39.10","22.28"
"65","000","00","100","0038","0000","962","491","471","4","966","2486","0","38.86","19.75"
"65","000","00","100","0038","0085","513","253","260","3","516","1279","0","40.34","19.78"
"65","000","00","100","0038","0086","449","238","211","1","450","1207","0","37.28","19.72"
"65","000","00","100","0039","0000","1926","906","1020","15","1941","4221","0","45.98","21.46"
"65","000","00","100","0039","0054","553","244","309","8","561","1200","0","46.75","20.33"
"65","000","00","100","0039","0055","737","346","391","6","743","1527","0","48.66","22.66"
"65","000","00","100","0039","0056","636","316","320","1","637","1494","0","42.64","21.15"
"65","000","00","100","0040","0000","1410","655","755","18","1428","3477","0","41.07","18.84"
"65","000","00","100","0040","0116","382","181","201","9","391","1022","0","38.26","17.71"
"65","000","00","100","0040","0117","534","246","288","3","537","1289","0","41.66","19.08"
"65","000","00","100","0040","0118","494","228","266","6","500","1166","0","42.88","19.55"
"65","000","00","100","0041","0000","1574","832","742","10","1584","4251","0","37.26","19.57"
"65","000","00","100","0041","0119","318","181","137","4","322","948","0","33.97","19.09"
"65","000","00","100","0041","0120","504","258","246","5","509","1141","0","44.61","22.61"
"65","000","00","100","0041","0121","369","180","189","0","369","1062","0","34.75","16.95"
"65","000","00","100","0041","0122","383","213","170","1","384","1100","0","34.91","19.36"
"65","000","00","100","0042","0000","3809","2121","1688","40","3849","9198","0","41.85","23.06"
"65","000","00","100","0042","0140","642","331","311","8","650","1432","0","45.39","23.11"
"65","000","00","100","0042","0141","591","269","322","5","596","1387","0","42.97","19.39"
"65","000","00","100","0042","0142","736","366","370","10","746","2001","0","37.28","18.29"
"65","000","00","100","0042","0143","591","334","257","5","596","1432","0","41.62","23.32"
"65","000","00","100","0042","0144","727","489","238","6","733","1809","0","40.52","27.03"
"65","000","00","100","0042","0145","522","332","190","6","528","1137","0","46.44","29.20"
"65","000","00","110","0000","0000","74973","39015","35958","711","75684","179909","205551","42.07","21.69"
"65","000","00","110","0001","0000","528","264","264","4","532","1238","0","42.97","21.32"
"65","000","00","110","0001","2501","528","264","264","4","532","1238","0","42.97","21.32"
"65","000","00","110","0002","0000","449","194","255","3","452","980","0","46.12","19.80"
"65","000","00","110","0002","2502","449","194","255","3","452","980","0","46.12","19.80"
"65","000","00","110","0003","0000","1869","1049","820","11","1880","4239","0","44.35","24.75"
"65","000","00","110","0003","2503","586","341","245","3","589","1387","0","42.47","24.59"
"65","000","00","110","0003","2504","681","389","292","7","688","1409","0","48.83","27.61"
"65","000","00","110","0003","2505","602","319","283","1","603","1443","0","41.79","22.11"
"65","000","00","110","0004","0000","145","68","77","2","147","320","0","45.94","21.25"
"65","000","00","110","0004","2508","145","68","77","2","147","320","0","45.94","21.25"
"65","000","00","110","0005","0000","1243","610","633","11","1254","2889","0","43.41","21.11"
"65","000","00","110","0005","2544","680","337","343","2","682","1525","0","44.72","22.10"
"65","000","00","110","0005","2545","563","273","290","9","572","1364","0","41.94","20.01"
"65","000","00","110","0006","0000","1407","668","739","19","1426","4888","0","29.17","13.67"
"65","000","00","110","0006","2516","282","125","157","6","288","1897","0","15.18","6.59"
"65","000","00","110","0006","2517","593","281","312","8","601","1577","0","38.11","17.82"
"65","000","00","110","0006","2518","532","262","270","5","537","1414","0","37.98","18.53"
"65","000","00","110","0007","0000","1951","943","1008","22","1973","4758","0","41.47","19.82"
"65","000","00","110","0007","2509","689","326","363","6","695","1562","0","44.49","20.87"
"65","000","00","110","0007","2510","641","304","337","7","648","1629","0","39.78","18.66"
"65","000","00","110","0007","2511","621","313","308","9","630","1567","0","40.20","19.97"
"65","000","00","110","0008","0000","3158","1699","1459","33","3191","6286","0","50.76","27.03"
"65","000","00","110","0008","2522","689","371","318","7","696","1459","0","47.70","25.43"
"65","000","00","110","0008","2523","773","414","359","5","778","1586","0","49.05","26.10"
"65","000","00","110","0008","2524","853","474","379","7","860","1666","0","51.62","28.45"
"65","000","00","110","0008","2525","843","440","403","14","857","1575","0","54.41","27.94"
"65","000","00","110","0009","0000","1379","661","718","12","1391","3956","0","35.16","16.71"
"65","000","00","110","0009","2535","491","227","264","5","496","1359","0","36.50","16.70"
"65","000","00","110","0009","2536","451","225","226","3","454","1362","0","33.33","16.52"
"65","000","00","110","0009","2537","437","209","228","4","441","1235","0","35.71","16.92"
"65","000","00","110","0010","0000","631","291","340","8","639","1489","0","42.91","19.54"
"65","000","00","110","0010","2549","631","291","340","8","639","1489","0","42.91","19.54"
"65","000","00","110","0011","0000","544","256","288","7","551","1494","0","36.88","17.14"
"65","000","00","110","0011","2550","544","256","288","7","551","1494","0","36.88","17.14"
"65","000","00","110","0012","0000","1665","789","876","23","1688","4194","0","40.25","18.81"
"65","000","00","110","0012","2552","523","223","300","8","531","1297","0","40.94","17.19"
"65","000","00","110","0012","2553","620","298","322","11","631","1623","0","38.88","18.36"
"65","000","00","110","0012","2554","522","268","254","4","526","1274","0","41.29","21.04"
"65","000","00","110","0013","0000","933","427","506","9","942","2101","0","44.84","20.32"
"65","000","00","110","0013","2557","552","248","304","6","558","1310","0","42.60","18.93"
"65","000","00","110","0013","2558","381","179","202","3","384","791","0","48.55","22.63"
"65","000","00","110","0014","0000","2112","1035","1077","18","2130","5478","0","38.88","18.89"
"65","000","00","110","0014","2559","504","282","222","2","506","1245","0","40.64","22.65"
"65","000","00","110","0014","2560","508","230","278","2","510","1316","0","38.75","17.48"
"65","000","00","110","0014","2561","557","264","293","8","565","1603","0","35.25","16.47"
"65","000","00","110","0014","2562","543","259","284","6","549","1314","0","41.78","19.71"
"65","000","00","110","0015","0000","1597","828","769","11","1608","4648","0","34.60","17.81"
"65","000","00","110","0015","2563","422","231","191","7","429","1486","0","28.87","15.55"
"65","000","00","110","0015","2564","544","245","299","2","546","1553","0","35.16","15.78"
"65","000","00","110","0015","2565","631","352","279","2","633","1609","0","39.34","21.88"
"65","000","00","110","0016","0000","626","312","314","7","633","1479","0","42.80","21.10"
"65","000","00","110","0016","2566","626","312","314","7","633","1479","0","42.80","21.10"
"65","000","00","110","0017","0000","339","139","200","3","342","921","0","37.13","15.09"
"65","000","00","110","0017","2567","339","139","200","3","342","921","0","37.13","15.09"
"65","000","00","110","0018","0000","764","350","414","10","774","1990","0","38.89","17.59"
"65","000","00","110","0018","2575","764","350","414","10","774","1990","0","38.89","17.59"
"65","000","00","110","0019","0000","1722","756","966","13","1735","4527","0","38.33","16.70"
"65","000","00","110","0019","2569","660","278","382","2","662","1665","0","39.76","16.70"
"65","000","00","110","0019","2570","517","230","287","3","520","1472","0","35.33","15.63"
"65","000","00","110","0019","2571","545","248","297","8","553","1390","0","39.78","17.84"
"65","000","00","110","0020","0000","2414","1236","1178","16","2430","5282","0","46.01","23.40"
"65","000","00","110","0020","2609","660","363","297","3","663","1484","0","44.68","24.46"
"65","000","00","110","0020","2610","663","349","314","3","666","1313","0","50.72","26.58"
"65","000","00","110","0020","2611","601","280","321","8","609","1313","0","46.38","21.33"
"65","000","00","110","0020","2612","490","244","246","2","492","1172","0","41.98","20.82"
"65","000","00","110","0021","0000","1603","806","797","14","1617","3974","0","40.69","20.28"
"65","000","00","110","0021","2532","526","281","245","6","532","1227","0","43.36","22.90"
"65","000","00","110","0021","2533","537","240","297","6","543","1399","0","38.81","17.16"
"65","000","00","110","0021","2534","540","285","255","2","542","1348","0","40.21","21.14"
"65","000","00","110","0022","0000","1827","943","884","23","1850","4272","0","43.31","22.07"
"65","000","00","110","0022","2616","628","340","288","8","636","1457","0","43.65","23.34"
"65","000","00","110","0022","2617","575","300","275","5","580","1380","0","42.03","21.74"
"65","000","00","110","0022","2618","624","303","321","10","634","1435","0","44.18","21.11"
"65","000","00","110","0023","0000","216","101","115","2","218","542","0","40.22","18.63"
"65","000","00","110","0023","2551","216","101","115","2","218","542","0","40.22","18.63"
"65","000","00","110","0024","0000","1546","817","729","11","1557","3388","0","45.96","24.11"
"65","000","00","110","0024","2619","733","379","354","5","738","1745","0","42.29","21.72"
"65","000","00","110","0024","2620","813","438","375","6","819","1643","0","49.85","26.66"
"65","000","00","110","0025","0000","1328","783","545","10","1338","2728","0","49.05","28.70"
"65","000","00","110","0025","2621","607","392","215","6","613","1312","0","46.72","29.88"
"65","000","00","110","0025","2622","721","391","330","4","725","1416","0","51.20","27.61"
"65","000","00","110","0026","0000","2723","1289","1434","29","2752","7130","0","38.60","18.08"
"65","000","00","110","0026","2587","536","238","298","9","545","1408","0","38.71","16.90"
"65","000","00","110","0026","2588","500","233","267","7","507","1368","0","37.06","17.03"
"65","000","00","110","0026","2589","533","259","274","3","536","1460","0","36.71","17.74"
"65","000","00","110","0026","2590","553","266","287","6","559","1386","0","40.33","19.19"
"65","000","00","110","0026","2591","601","293","308","4","605","1508","0","40.12","19.43"
"65","000","00","110","0027","0000","2472","1382","1090","28","2500","5589","0","44.73","24.73"
"65","000","00","110","0027","2599","632","313","319","8","640","1388","0","46.11","22.55"
"65","000","00","110","0027","2600","552","309","243","6","558","1396","0","39.97","22.13"
"65","000","00","110","0027","2601","649","350","299","10","659","1429","0","46.12","24.49"
"65","000","00","110","0027","2602","639","410","229","4","643","1376","0","46.73","29.80"
"65","000","00","110","0028","0000","733","375","358","14","747","1675","0","44.60","22.39"
"65","000","00","110","0028","2500","733","375","358","14","747","1675","0","44.60","22.39"
"65","000","00","110","0029","0000","2443","1326","1117","18","2461","6767","0","36.37","19.60"
"65","000","00","110","0029","2581","631","317","314","4","635","1700","0","37.35","18.65"
"65","000","00","110","0029","2582","613","350","263","2","615","1655","0","37.16","21.15"
"65","000","00","110","0029","2583","651","353","298","7","658","1720","0","38.26","20.52"
"65","000","00","110","0029","2584","548","306","242","5","553","1692","0","32.68","18.09"
"65","000","00","110","0030","0000","2936","1549","1387","21","2957","7500","0","39.43","20.65"
"65","000","00","110","0030","2576","550","275","275","4","554","1416","0","39.12","19.42"
"65","000","00","110","0030","2577","587","301","286","4","591","1547","0","38.20","19.46"
"65","000","00","110","0030","2578","584","346","238","1","585","1512","0","38.69","22.88"
"65","000","00","110","0030","2579","598","293","305","6","604","1468","0","41.14","19.96"
"65","000","00","110","0030","2580","617","334","283","6","623","1557","0","40.01","21.45"
"65","000","00","110","0031","0000","2146","1078","1068","20","2166","5118","0","42.32","21.06"
"65","000","00","110","0031","2526","713","352","361","9","722","1683","0","42.90","20.92"
"65","000","00","110","0031","2527","650","311","339","4","654","1716","0","38.11","18.12"
"65","000","00","110","0031","2528","783","415","368","7","790","1719","0","45.96","24.14"
"65","000","00","110","0032","0000","1728","870","858","12","1740","4130","0","42.13","21.07"
"65","000","00","110","0032","2529","575","253","322","6","581","1534","0","37.87","16.49"
"65","000","00","110","0032","2530","655","356","299","3","658","1554","0","42.34","22.91"
"65","000","00","110","0032","2531","498","261","237","3","501","1042","0","48.08","25.05"
"65","000","00","110","0033","0000","1931","976","955","22","1953","4841","0","40.34","20.16"
"65","000","00","110","0033","2572","632","337","295","5","637","1600","0","39.81","21.06"
"65","000","00","110","0033","2573","645","335","310","11","656","1660","0","39.52","20.18"
"65","000","00","110","0033","2574","654","304","350","6","660","1581","0","41.75","19.23"
"65","000","00","110","0034","0000","1133","545","588","10","1143","2985","0","38.29","18.26"
"65","000","00","110","0034","2592","612","267","345","4","616","1514","0","40.69","17.64"
"65","000","00","110","0034","2593","521","278","243","6","527","1471","0","35.83","18.90"
"65","000","00","110","0035","0000","1273","674","599","3","1276","2904","0","43.94","23.21"
"65","000","00","110","0035","2594","660","388","272","1","661","1423","0","46.45","27.27"
"65","000","00","110","0035","2595","613","286","327","2","615","1481","0","41.53","19.31"
"65","000","00","110","0036","0000","1863","962","901","23","1886","4716","0","39.99","20.40"
"65","000","00","110","0036","2596","611","332","279","5","616","1564","0","39.39","21.23"
"65","000","00","110","0036","2597","586","294","292","8","594","1493","0","39.79","19.69"
"65","000","00","110","0036","2598","666","336","330","10","676","1659","0","40.75","20.25"
"65","000","00","110","0037","0000","1629","985","644","20","1649","3115","0","52.94","31.62"
"65","000","00","110","0037","2613","735","455","280","12","747","1475","0","50.64","30.85"
"65","000","00","110","0037","2614","894","530","364","8","902","1640","0","55.00","32.32"
"65","000","00","110","0038","0000","513","194","319","4","517","1145","0","45.15","16.94"
"65","000","00","110","0038","2615","513","194","319","4","517","1145","0","45.15","16.94"
"65","000","00","110","0039","0000","2072","1164","908","20","2092","4238","0","49.36","27.47"
"65","000","00","110","0039","2623","578","276","302","9","587","1209","0","48.55","22.83"
"65","000","00","110","0039","2624","529","315","214","5","534","1080","0","49.44","29.17"
"65","000","00","110","0039","2625","965","573","392","6","971","1949","0","49.82","29.40"
"65","000","00","110","0040","0000","894","524","370","7","901","2598","0","34.68","20.17"
"65","000","00","110","0040","2585","492","290","202","3","495","1428","0","34.66","20.31"
"65","000","00","110","0040","2586","402","234","168","4","406","1170","0","34.70","20.00"
"65","000","00","110","0041","0000","1088","575","513","5","1093","2552","0","42.83","22.53"
"65","000","00","110","0041","2506","535","270","265","3","538","1262","0","42.63","21.39"
"65","000","00","110","0041","2507","553","305","248","2","555","1290","0","43.02","23.64"
"65","000","00","110","0042","0000","1922","969","953","19","1941","4444","0","43.68","21.80"
"65","000","00","110","0042","2538","697","346","351","7","704","1693","0","41.58","20.44"
"65","000","00","110","0042","2539","661","300","361","9","670","1577","0","42.49","19.02"
"65","000","00","110","0042","2540","564","323","241","3","567","1174","0","48.30","27.51"
"65","000","00","110","0043","0000","2745","1631","1114","19","2764","6020","0","45.91","27.09"
"65","000","00","110","0043","2605","708","425","283","6","714","1571","0","45.45","27.05"
"65","000","00","110","0043","2606","711","429","282","2","713","1458","0","48.90","29.42"
"65","000","00","110","0043","2607","645","367","278","4","649","1568","0","41.39","23.41"
"65","000","00","110","0043","2608","681","410","271","7","688","1423","0","48.35","28.81"
"65","000","00","110","0044","0000","452","248","204","9","461","872","0","52.87","28.44"
"65","000","00","110","0044","2568","452","248","204","9","461","872","0","52.87","28.44"
"65","000","00","110","0045","0000","2263","1140","1123","21","2284","5639","0","40.50","20.22"
"65","000","00","110","0045","2512","524","267","257","6","530","1345","0","39.41","19.85"
"65","000","00","110","0045","2513","597","305","292","7","604","1426","0","42.36","21.39"
"65","000","00","110","0045","2514","580","285","295","4","584","1437","0","40.64","19.83"
"65","000","00","110","0045","2515","562","283","279","4","566","1431","0","39.55","19.78"
"65","000","00","110","0046","0000","1671","889","782","18","1689","3952","0","42.74","22.49"
"65","000","00","110","0046","2519","536","263","273","3","539","1277","0","42.21","20.60"
"65","000","00","110","0046","2520","536","262","274","7","543","1304","0","41.64","20.09"
"65","000","00","110","0046","2521","599","364","235","8","607","1371","0","44.27","26.55"
"65","000","00","110","0047","0000","2115","1191","924","29","2144","4633","0","46.28","25.71"
"65","000","00","110","0047","2546","805","430","375","9","814","1663","0","48.95","25.86"
"65","000","00","110","0047","2547","751","446","305","6","757","1703","0","44.45","26.19"
"65","000","00","110","0047","2548","559","315","244","14","573","1267","0","45.22","24.86"
"65","000","00","110","0048","0000","1848","1036","812","14","1862","4091","0","45.51","25.32"
"65","000","00","110","0048","2541","609","319","290","6","615","1270","0","48.43","25.12"
"65","000","00","110","0048","2542","611","356","255","5","616","1351","0","45.60","26.35"
"65","000","00","110","0048","2543","628","361","267","3","631","1470","0","42.93","24.56"
"65","000","00","110","0049","0000","1351","831","520","16","1367","2514","0","54.38","33.05"
"65","000","00","110","0049","2603","598","365","233","7","605","1154","0","52.43","31.63"
"65","000","00","110","0049","2604","753","466","287","9","762","1360","0","56.03","34.26"
"65","000","00","110","0050","0000","1033","587","446","8","1041","2680","0","38.84","21.90"
"65","000","00","110","0050","2555","783","494","289","5","788","1988","0","39.64","24.85"
"65","000","00","110","0050","2556","250","93","157","3","253","692","0","36.56","13.44"
"65","000","00","120","0000","0000","11965","5663","6302","130","12095","34231","38764","35.33","16.54"
"65","000","00","120","0001","0000","303","139","164","3","306","728","0","42.03","19.09"
"65","000","00","120","0001","2379","303","139","164","3","306","728","0","42.03","19.09"
"65","000","00","120","0002","0000","784","385","399","7","791","1862","0","42.48","20.68"
"65","000","00","120","0002","2380","454","218","236","4","458","1044","0","43.87","20.88"
"65","000","00","120","0002","2381","330","167","163","3","333","818","0","40.71","20.42"
"65","000","00","120","0003","0000","465","230","235","4","469","1203","0","38.99","19.12"
"65","000","00","120","0003","2382","465","230","235","4","469","1203","0","38.99","19.12"
"65","000","00","120","0004","0000","592","279","313","3","595","1573","0","37.83","17.74"
"65","000","00","120","0004","2384","328","159","169","2","330","861","0","38.33","18.47"
"65","000","00","120","0004","2385","264","120","144","1","265","712","0","37.22","16.85"
"65","000","00","120","0005","0000","482","266","216","3","485","1281","0","37.86","20.77"
"65","000","00","120","0005","2386","482","266","216","3","485","1281","0","37.86","20.77"
"65","000","00","120","0006","0000","217","112","105","5","222","598","0","37.12","18.73"
"65","000","00","120","0006","2383","217","112","105","5","222","598","0","37.12","18.73"
"65","000","00","120","0007","0000","1294","554","740","14","1308","3539","0","36.96","15.65"
"65","000","00","120","0007","2387","535","219","316","2","537","1534","0","35.01","14.28"
"65","000","00","120","0007","2388","370","165","205","4","374","945","0","39.58","17.46"
"65","000","00","120","0007","2389","389","170","219","8","397","1060","0","37.45","16.04"
"65","000","00","120","0008","0000","367","144","223","4","371","1041","0","35.64","13.83"
"65","000","00","120","0008","2394","367","144","223","4","371","1041","0","35.64","13.83"
"65","000","00","120","0009","0000","565","263","302","4","569","1589","0","35.81","16.55"
"65","000","00","120","0009","2392","342","152","190","1","343","954","0","35.95","15.93"
"65","000","00","120","0009","2393","223","111","112","3","226","635","0","35.59","17.48"
"65","000","00","120","0010","0000","469","225","244","3","472","1272","0","37.11","17.69"
"65","000","00","120","0010","2404","242","125","117","0","242","666","0","36.34","18.77"
"65","000","00","120","0010","2405","227","100","127","3","230","606","0","37.95","16.50"
"65","000","00","120","0011","0000","558","291","267","8","566","1680","0","33.69","17.32"
"65","000","00","120","0011","2399","306","138","168","4","310","815","0","38.04","16.93"
"65","000","00","120","0011","2400","252","153","99","4","256","865","0","29.60","17.69"
"65","000","00","120","0012","0000","978","476","502","13","991","2918","0","33.96","16.31"
"65","000","00","120","0012","2401","257","125","132","5","262","758","0","34.56","16.49"
"65","000","00","120","0012","2402","378","197","181","4","382","1137","0","33.60","17.33"
"65","000","00","120","0012","2403","343","154","189","4","347","1023","0","33.92","15.05"
"65","000","00","120","0013","0000","663","280","383","7","670","1891","0","35.43","14.81"
"65","000","00","120","0013","2406","371","167","204","3","374","1054","0","35.48","15.84"
"65","000","00","120","0013","2407","292","113","179","4","296","837","0","35.36","13.50"
"65","000","00","120","0014","0000","142","53","89","0","142","434","0","32.72","12.21"
"65","000","00","120","0014","2396","142","53","89","0","142","434","0","32.72","12.21"
"65","000","00","120","0015","0000","91","35","56","3","94","241","0","39.00","14.52"
"65","000","00","120","0015","2397","91","35","56","3","94","241","0","39.00","14.52"
"65","000","00","120","0016","0000","116","37","79","3","119","264","0","45.08","14.02"
"65","000","00","120","0016","2395","116","37","79","3","119","264","0","45.08","14.02"
"65","000","00","120","0017","0000","72","34","38","1","73","138","0","52.90","24.64"
"65","000","00","120","0017","2398","72","34","38","1","73","138","0","52.90","24.64"
"65","000","00","120","0018","0000","180","77","103","3","183","417","0","43.88","18.47"
"65","000","00","120","0018","2408","180","77","103","3","183","417","0","43.88","18.47"
"65","000","00","120","0019","0000","128","60","68","0","128","408","0","31.37","14.71"
"65","000","00","120","0019","2409","128","60","68","0","128","408","0","31.37","14.71"
"65","000","00","120","0020","0000","114","46","68","2","116","296","0","39.19","15.54"
"65","000","00","120","0020","2410","114","46","68","2","116","296","0","39.19","15.54"
"65","000","00","120","0021","0000","69","38","31","2","71","164","0","43.29","23.17"
"65","000","00","120","0021","2411","69","38","31","2","71","164","0","43.29","23.17"
"65","000","00","120","0022","0000","119","61","58","1","120","326","0","36.81","18.71"
"65","000","00","120","0022","2412","119","61","58","1","120","326","0","36.81","18.71"
"65","000","00","120","0023","0000","107","53","54","2","109","339","0","32.15","15.63"
"65","000","00","120","0023","2415","107","53","54","2","109","339","0","32.15","15.63"
"65","000","00","120","0024","0000","72","42","30","2","74","164","0","45.12","25.61"
"65","000","00","120","0024","2413","72","42","30","2","74","164","0","45.12","25.61"
"65","000","00","120","0025","0000","80","33","47","2","82","186","0","44.09","17.74"
"65","000","00","120","0025","2414","80","33","47","2","82","186","0","44.09","17.74"
"65","000","00","120","0026","0000","110","63","47","0","110","321","0","34.27","19.63"
"65","000","00","120","0026","2416","110","63","47","0","110","321","0","34.27","19.63"
"65","000","00","120","0027","0000","79","35","44","1","80","286","0","27.97","12.24"
"65","000","00","120","0027","2418","79","35","44","1","80","286","0","27.97","12.24"
"65","000","00","120","0028","0000","167","96","71","3","170","459","0","37.04","20.92"
"65","000","00","120","0028","2417","167","96","71","3","170","459","0","37.04","20.92"
"65","000","00","120","0029","0000","335","188","147","3","338","1241","0","27.24","15.15"
"65","000","00","120","0029","2421","335","188","147","3","338","1241","0","27.24","15.15"
"65","000","00","120","0030","0000","590","284","306","6","596","1905","0","31.29","14.91"
"65","000","00","120","0030","2422","338","156","182","4","342","979","0","34.93","15.93"
"65","000","00","120","0030","2423","252","128","124","2","254","926","0","27.43","13.82"
"65","000","00","120","0031","0000","366","202","164","1","367","1290","0","28.45","15.66"
"65","000","00","120","0031","2424","366","202","164","1","367","1290","0","28.45","15.66"
"65","000","00","120","0032","0000","119","46","73","1","120","264","0","45.45","17.42"
"65","000","00","120","0032","2419","119","46","73","1","120","264","0","45.45","17.42"
"65","000","00","120","0033","0000","265","92","173","5","270","853","0","31.65","10.79"
"65","000","00","120","0033","2420","265","92","173","5","270","853","0","31.65","10.79"
"65","000","00","120","0034","0000","907","444","463","11","918","3060","0","30.00","14.51"
"65","000","00","120","0034","2390","460","223","237","6","466","1454","0","32.05","15.34"
"65","000","00","120","0034","2391","447","221","226","5","452","1606","0","28.14","13.76"
"65","000","00","130","0000","0000","80689","37192","43497","746","81435","203012","238020","40.11","18.32"
"65","000","00","130","0001","0000","1287","584","703","10","1297","5065","0","25.61","11.53"
"65","000","00","130","0001","1912","435","196","239","4","439","2800","0","15.68","7.00"
"65","000","00","130","0001","1913","452","199","253","2","454","1215","0","37.37","16.38"
"65","000","00","130","0001","1914","400","189","211","4","404","1050","0","38.48","18.00"
"65","000","00","130","0002","0000","741","351","390","12","753","1838","0","40.97","19.10"
"65","000","00","130","0002","1915","378","184","194","9","387","952","0","40.65","19.33"
"65","000","00","130","0002","1916","363","167","196","3","366","886","0","41.31","18.85"
"65","000","00","130","0003","0000","2579","1281","1298","24","2603","6368","0","40.88","20.12"
"65","000","00","130","0003","1922","623","293","330","4","627","1619","0","38.73","18.10"
"65","000","00","130","0003","1923","642","308","334","10","652","1625","0","40.12","18.95"
"65","000","00","130","0003","1924","651","327","324","3","654","1521","0","43.00","21.50"
"65","000","00","130","0003","1925","663","353","310","7","670","1603","0","41.80","22.02"
"65","000","00","130","0004","0000","1845","866","979","17","1862","4879","0","38.16","17.75"
"65","000","00","130","0004","1908","518","229","289","6","524","1322","0","39.64","17.32"
"65","000","00","130","0004","1909","438","197","241","6","444","1209","0","36.72","16.29"
"65","000","00","130","0004","1910","458","271","187","4","462","1171","0","39.45","23.14"
"65","000","00","130","0004","1911","431","169","262","1","432","1177","0","36.70","14.36"
"65","000","00","130","0005","0000","989","714","275","9","998","1844","0","54.12","38.72"
"65","000","00","130","0005","1917","454","320","134","4","458","895","0","51.17","35.75"
"65","000","00","130","0005","1918","535","394","141","5","540","949","0","56.90","41.52"
"65","000","00","130","0006","0000","1715","737","978","21","1736","4107","0","42.27","17.94"
"65","000","00","130","0006","1934","578","222","356","10","588","1365","0","43.08","16.26"
"65","000","00","130","0006","1935","505","264","241","4","509","1374","0","37.05","19.21"
"65","000","00","130","0006","1936","632","251","381","7","639","1368","0","46.71","18.35"
"65","000","00","130","0007","0000","2372","1010","1362","21","2393","5788","0","41.34","17.45"
"65","000","00","130","0007","1930","674","311","363","8","682","1558","0","43.77","19.96"
"65","000","00","130","0007","1931","620","275","345","8","628","1488","0","42.20","18.48"
"65","000","00","130","0007","1932","565","217","348","3","568","1477","0","38.46","14.69"
"65","000","00","130","0007","1933","513","207","306","2","515","1265","0","40.71","16.36"
"65","000","00","130","0008","0000","1611","646","965","11","1622","3999","0","40.56","16.15"
"65","000","00","130","0008","1941","470","198","272","2","472","1247","0","37.85","15.88"
"65","000","00","130","0008","1942","671","266","405","1","672","1652","0","40.68","16.10"
"65","000","00","130","0008","1943","470","182","288","8","478","1100","0","43.45","16.55"
"65","000","00","130","0009","0000","1326","621","705","11","1337","3209","0","41.66","19.35"
"65","000","00","130","0009","1972","468","216","252","3","471","1130","0","41.68","19.12"
"65","000","00","130","0009","1973","409","204","205","5","414","1017","0","40.71","20.06"
"65","000","00","130","0009","1974","449","201","248","3","452","1062","0","42.56","18.93"
"65","000","00","130","0010","0000","3168","1514","1654","25","3193","7337","0","43.52","20.64"
"65","000","00","130","0010","1954","635","267","368","3","638","1545","0","41.29","17.28"
"65","000","00","130","0010","1955","580","256","324","5","585","1409","0","41.52","18.17"
"65","000","00","130","0010","1956","649","302","347","4","653","1506","0","43.36","20.05"
"65","000","00","130","0010","1957","662","341","321","10","672","1470","0","45.71","23.20"
"65","000","00","130","0010","1958","642","348","294","3","645","1407","0","45.84","24.73"
"65","000","00","130","0011","0000","1075","405","670","10","1085","2741","0","39.58","14.78"
"65","000","00","130","0011","1944","527","208","319","8","535","1322","0","40.47","15.73"
"65","000","00","130","0011","1945","548","197","351","2","550","1419","0","38.76","13.88"
"65","000","00","130","0012","0000","2809","1269","1540","19","2828","7167","0","39.46","17.71"
"65","000","00","130","0012","1990","442","199","243","3","445","1261","0","35.29","15.78"
"65","000","00","130","0012","1991","533","242","291","5","538","1314","0","40.94","18.42"
"65","000","00","130","0012","1992","603","283","320","4","607","1512","0","40.15","18.72"
"65","000","00","130","0012","1993","644","289","355","5","649","1553","0","41.79","18.61"
"65","000","00","130","0012","1994","587","256","331","2","589","1527","0","38.57","16.76"
"65","000","00","130","0013","0000","1971","830","1141","30","2001","5572","0","35.91","14.90"
"65","000","00","130","0013","1979","498","180","318","4","502","1292","0","38.85","13.93"
"65","000","00","130","0013","1980","466","169","297","12","478","1483","0","32.23","11.40"
"65","000","00","130","0013","1981","505","215","290","3","508","1411","0","36.00","15.24"
"65","000","00","130","0013","1982","502","266","236","11","513","1386","0","37.01","19.19"
"65","000","00","130","0014","0000","1492","749","743","13","1505","3780","0","39.81","19.81"
"65","000","00","130","0014","1995","489","218","271","6","495","1228","0","40.31","17.75"
"65","000","00","130","0014","1996","446","225","221","5","451","1228","0","36.73","18.32"
"65","000","00","130","0014","1997","557","306","251","2","559","1324","0","42.22","23.11"
"65","000","00","130","0015","0000","576","233","343","7","583","1455","0","40.07","16.01"
"65","000","00","130","0015","1983","576","233","343","7","583","1455","0","40.07","16.01"
"65","000","00","130","0016","0000","2426","1172","1254","29","2455","6034","0","40.69","19.42"
"65","000","00","130","0016","1984","548","246","302","5","553","1479","0","37.39","16.63"
"65","000","00","130","0016","1985","627","315","312","4","631","1492","0","42.29","21.11"
"65","000","00","130","0016","1986","633","309","324","9","642","1565","0","41.02","19.74"
"65","000","00","130","0016","1987","618","302","316","11","629","1498","0","41.99","20.16"
"65","000","00","130","0017","0000","2368","1027","1341","27","2395","6492","0","36.89","15.82"
"65","000","00","130","0017","2008","557","260","297","6","563","1314","0","42.85","19.79"
"65","000","00","130","0017","2009","441","190","251","7","448","1306","0","34.30","14.55"
"65","000","00","130","0017","2010","391","170","221","5","396","1144","0","34.62","14.86"
"65","000","00","130","0017","2011","472","185","287","6","478","1267","0","37.73","14.60"
"65","000","00","130","0017","2012","507","222","285","3","510","1461","0","34.91","15.20"
"65","000","00","130","0018","0000","2482","1053","1429","16","2498","6188","0","40.37","17.02"
"65","000","00","130","0018","2022","579","251","328","0","579","1463","0","39.58","17.16"
"65","000","00","130","0018","2023","720","296","424","10","730","1610","0","45.34","18.39"
"65","000","00","130","0018","2024","578","261","317","3","581","1540","0","37.73","16.95"
"65","000","00","130","0018","2025","605","245","360","3","608","1575","0","38.60","15.56"
"65","000","00","130","0019","0000","1742","725","1017","11","1753","4348","0","40.32","16.67"
"65","000","00","130","0019","2001","590","251","339","4","594","1312","0","45.27","19.13"
"65","000","00","130","0019","2002","563","256","307","3","566","1509","0","37.51","16.96"
"65","000","00","130","0019","2003","589","218","371","4","593","1527","0","38.83","14.28"
"65","000","00","130","0020","0000","1852","862","990","20","1872","4345","0","43.08","19.84"
"65","000","00","130","0020","1904","495","217","278","10","505","1220","0","41.39","17.79"
"65","000","00","130","0020","1905","561","243","318","5","566","1201","0","47.13","20.23"
"65","000","00","130","0020","1906","382","210","172","3","385","968","0","39.77","21.69"
"65","000","00","130","0020","1907","414","192","222","2","416","956","0","43.51","20.08"
"65","000","00","130","0021","0000","2674","1260","1414","34","2708","7273","0","37.23","17.32"
"65","000","00","130","0021","1899","504","218","286","11","515","1510","0","34.11","14.44"
"65","000","00","130","0021","1900","564","255","309","8","572","1484","0","38.54","17.18"
"65","000","00","130","0021","1901","479","194","285","6","485","1399","0","34.67","13.87"
"65","000","00","130","0021","1902","550","291","259","5","555","1357","0","40.90","21.44"
"65","000","00","130","0021","1903","577","302","275","4","581","1523","0","38.15","19.83"
"65","000","00","130","0022","0000","1725","749","976","30","1755","4244","0","41.35","17.65"
"65","000","00","130","0022","1896","536","219","317","10","546","1326","0","41.18","16.52"
"65","000","00","130","0022","1897","508","233","275","9","517","1329","0","38.90","17.53"
"65","000","00","130","0022","1898","681","297","384","11","692","1589","0","43.55","18.69"
"65","000","00","130","0023","0000","1719","808","911","24","1743","4447","0","39.19","18.17"
"65","000","00","130","0023","1893","570","263","307","6","576","1408","0","40.91","18.68"
"65","000","00","130","0023","1894","564","310","254","12","576","1556","0","37.02","19.92"
"65","000","00","130","0023","1895","585","235","350","6","591","1483","0","39.85","15.85"
"65","000","00","130","0024","0000","1798","851","947","18","1816","4672","0","38.87","18.21"
"65","000","00","130","0024","1890","482","231","251","5","487","1377","0","35.37","16.78"
"65","000","00","130","0024","1891","612","282","330","4","616","1638","0","37.61","17.22"
"65","000","00","130","0024","1892","704","338","366","9","713","1657","0","43.03","20.40"
"65","000","00","130","0025","0000","1152","713","439","10","1162","2561","0","45.37","27.84"
"65","000","00","130","0025","1888","565","331","234","6","571","1299","0","43.96","25.48"
"65","000","00","130","0025","1889","587","382","205","4","591","1262","0","46.83","30.27"
"65","000","00","130","0026","0000","570","203","367","4","574","1476","0","38.89","13.75"
"65","000","00","130","0026","1887","570","203","367","4","574","1476","0","38.89","13.75"
"65","000","00","130","0027","0000","1836","841","995","21","1857","4491","0","41.35","18.73"
"65","000","00","130","0027","1961","628","285","343","8","636","1559","0","40.80","18.28"
"65","000","00","130","0027","1962","582","219","363","7","589","1402","0","42.01","15.62"
"65","000","00","130","0027","1963","626","337","289","6","632","1530","0","41.31","22.03"
"65","000","00","130","0028","0000","2212","1071","1141","13","2225","4980","0","44.68","21.51"
"65","000","00","130","0028","1949","732","348","384","2","734","1695","0","43.30","20.53"
"65","000","00","130","0028","1950","758","396","362","5","763","1605","0","47.54","24.67"
"65","000","00","130","0028","1951","722","327","395","6","728","1680","0","43.33","19.46"
"65","000","00","130","0029","0000","1270","580","690","16","1286","3076","0","41.81","18.86"
"65","000","00","130","0029","1964","678","307","371","11","689","1574","0","43.77","19.50"
"65","000","00","130","0029","1965","592","273","319","5","597","1502","0","39.75","18.18"
"65","000","00","130","0030","0000","1527","684","843","7","1534","3907","0","39.26","17.51"
"65","000","00","130","0030","2016","514","243","271","3","517","1249","0","41.39","19.46"
"65","000","00","130","0030","2017","527","222","305","3","530","1314","0","40.33","16.89"
"65","000","00","130","0030","2018","486","219","267","1","487","1344","0","36.24","16.29"
"65","000","00","130","0031","0000","1817","769","1048","14","1831","4353","0","42.06","17.67"
"65","000","00","130","0031","2026","630","255","375","3","633","1363","0","46.44","18.71"
"65","000","00","130","0031","2027","600","239","361","8","608","1489","0","40.83","16.05"
"65","000","00","130","0031","2028","587","275","312","3","590","1501","0","39.31","18.32"
"65","000","00","130","0032","0000","1168","531","637","11","1179","2751","0","42.86","19.30"
"65","000","00","130","0032","1977","595","277","318","5","600","1387","0","43.26","19.97"
"65","000","00","130","0032","1978","573","254","319","6","579","1364","0","42.45","18.62"
"65","000","00","130","0033","0000","1939","883","1056","15","1954","4879","0","40.05","18.10"
"65","000","00","130","0033","1926","520","232","288","6","526","1264","0","41.61","18.35"
"65","000","00","130","0033","1927","399","167","232","2","401","1131","0","35.46","14.77"
"65","000","00","130","0033","1928","554","276","278","4","558","1306","0","42.73","21.13"
"65","000","00","130","0033","1929","466","208","258","3","469","1178","0","39.81","17.66"
"65","000","00","130","0034","0000","1437","584","853","12","1449","3854","0","37.60","15.15"
"65","000","00","130","0034","2013","443","202","241","5","448","1198","0","37.40","16.86"
"65","000","00","130","0034","2014","576","219","357","3","579","1443","0","40.12","15.18"
"65","000","00","130","0034","2015","418","163","255","4","422","1213","0","34.79","13.44"
"65","000","00","130","0035","0000","1631","742","889","14","1645","3997","0","41.16","18.56"
"65","000","00","130","0035","1946","457","207","250","3","460","1239","0","37.13","16.71"
"65","000","00","130","0035","1947","506","207","299","5","511","1314","0","38.89","15.75"
"65","000","00","130","0035","1948","668","328","340","6","674","1444","0","46.68","22.71"
"65","000","00","130","0036","0000","1980","825","1155","13","1993","4880","0","40.84","16.91"
"65","000","00","130","0036","1937","476","155","321","3","479","1117","0","42.88","13.88"
"65","000","00","130","0036","1938","500","220","280","4","504","1290","0","39.07","17.05"
"65","000","00","130","0036","1939","539","246","293","1","540","1342","0","40.24","18.33"
"65","000","00","130","0036","1940","465","204","261","5","470","1131","0","41.56","18.04"
"65","000","00","130","0037","0000","1444","691","753","8","1452","3873","0","37.49","17.84"
"65","000","00","130","0037","1919","491","228","263","5","496","1302","0","38.10","17.51"
"65","000","00","130","0037","1920","483","229","254","1","484","1333","0","36.31","17.18"
"65","000","00","130","0037","1921","470","234","236","2","472","1238","0","38.13","18.90"
"65","000","00","130","0038","0000","1814","831","983","16","1830","4972","0","36.81","16.71"
"65","000","00","130","0038","1998","465","228","237","5","470","1384","0","33.96","16.47"
"65","000","00","130","0038","1999","556","235","321","6","562","1556","0","36.12","15.10"
"65","000","00","130","0038","2000","793","368","425","5","798","2032","0","39.27","18.11"
"65","000","00","130","0039","0000","1294","523","771","8","1302","2895","0","44.97","18.07"
"65","000","00","130","0039","1952","574","258","316","4","578","1341","0","43.10","19.24"
"65","000","00","130","0039","1953","720","265","455","4","724","1554","0","46.59","17.05"
"65","000","00","130","0040","0000","2356","1154","1202","23","2379","5897","0","40.34","19.57"
"65","000","00","130","0040","2029","646","283","363","6","652","1527","0","42.70","18.53"
"65","000","00","130","0040","2030","532","245","287","8","540","1350","0","40.00","18.15"
"65","000","00","130","0040","2031","595","338","257","7","602","1493","0","40.32","22.64"
"65","000","00","130","0040","2032","583","288","295","2","585","1527","0","38.31","18.86"
"65","000","00","130","0041","0000","1210","572","638","14","1224","2851","0","42.93","20.06"
"65","000","00","130","0041","1975","631","293","338","6","637","1508","0","42.24","19.43"
"65","000","00","130","0041","1976","579","279","300","8","587","1343","0","43.71","20.77"
"65","000","00","130","0042","0000","1882","904","978","10","1892","4214","0","44.90","21.45"
"65","000","00","130","0042","1969","621","329","292","2","623","1431","0","43.54","22.99"
"65","000","00","130","0042","1970","608","272","336","3","611","1299","0","47.04","20.94"
"65","000","00","130","0042","1971","653","303","350","5","658","1484","0","44.34","20.42"
"65","000","00","130","0043","0000","2200","1094","1106","21","2221","5145","0","43.17","21.26"
"65","000","00","130","0043","1966","705","344","361","6","711","1689","0","42.10","20.37"
"65","000","00","130","0043","1967","703","326","377","7","710","1671","0","42.49","19.51"
"65","000","00","130","0043","1968","792","424","368","8","800","1785","0","44.82","23.75"
"65","000","00","130","0044","0000","1242","592","650","12","1254","3049","0","41.13","19.42"
"65","000","00","130","0044","1959","645","303","342","6","651","1592","0","40.89","19.03"
"65","000","00","130","0044","1960","597","289","308","6","603","1457","0","41.39","19.84"
"65","000","00","130","0045","0000","1078","463","615","4","1082","2621","0","41.28","17.67"
"65","000","00","130","0045","1988","620","261","359","1","621","1353","0","45.90","19.29"
"65","000","00","130","0045","1989","458","202","256","3","461","1268","0","36.36","15.93"
"65","000","00","130","0046","0000","1993","1064","929","17","2010","5390","0","37.29","19.74"
"65","000","00","130","0046","2004","467","252","215","3","470","1290","0","36.43","19.53"
"65","000","00","130","0046","2005","532","298","234","5","537","1377","0","39.00","21.64"
"65","000","00","130","0046","2006","499","262","237","2","501","1344","0","37.28","19.49"
"65","000","00","130","0046","2007","495","252","243","7","502","1379","0","36.40","18.27"
"65","000","00","130","0047","0000","1295","561","734","14","1309","3708","0","35.30","15.13"
"65","000","00","130","0047","2019","476","240","236","3","479","1358","0","35.27","17.67"
"65","000","00","130","0047","2020","370","159","211","7","377","1143","0","32.98","13.91"
"65","000","00","130","0047","2021","449","162","287","4","453","1207","0","37.53","13.42"
"65","000","00","140","0000","0000","67503","26039","41464","664","68167","170282","202131","40.03","15.29"
"65","000","00","140","0001","0000","4814","2022","2792","47","4861","11581","0","41.97","17.46"
"65","000","00","140","0001","0647","628","283","345","6","634","1574","0","40.28","17.98"
"65","000","00","140","0001","0648","764","318","446","9","773","1667","0","46.37","19.08"
"65","000","00","140","0001","0649","616","225","391","7","623","1537","0","40.53","14.64"
"65","000","00","140","0001","0650","830","373","457","5","835","1816","0","45.98","20.54"
"65","000","00","140","0001","0651","614","249","365","7","621","1588","0","39.11","15.68"
"65","000","00","140","0001","0652","715","307","408","6","721","1735","0","41.56","17.69"
"65","000","00","140","0001","0653","647","267","380","7","654","1664","0","39.30","16.05"
"65","000","00","140","0002","0000","2047","833","1214","18","2065","5216","0","39.59","15.97"
"65","000","00","140","0002","0638","564","277","287","6","570","1369","0","41.64","20.23"
"65","000","00","140","0002","0639","567","184","383","5","572","1342","0","42.62","13.71"
"65","000","00","140","0002","0640","454","171","283","1","455","1240","0","36.69","13.79"
"65","000","00","140","0002","0641","462","201","261","6","468","1265","0","37.00","15.89"
"65","000","00","140","0003","0000","1450","565","885","17","1467","3615","0","40.58","15.63"
"65","000","00","140","0003","0625","486","182","304","6","492","1311","0","37.53","13.88"
"65","000","00","140","0003","0626","598","233","365","8","606","1490","0","40.67","15.64"
"65","000","00","140","0003","0627","366","150","216","3","369","814","0","45.33","18.43"
"65","000","00","140","0004","0000","1916","715","1201","17","1933","4716","0","40.99","15.16"
"65","000","00","140","0004","0619","694","247","447","5","699","1591","0","43.93","15.52"
"65","000","00","140","0004","0620","612","231","381","7","619","1492","0","41.49","15.48"
"65","000","00","140","0004","0621","610","237","373","5","615","1633","0","37.66","14.51"
"65","000","00","140","0005","0000","1278","531","747","13","1291","3348","0","38.56","15.86"
"65","000","00","140","0005","0725","613","254","359","6","619","1636","0","37.84","15.53"
"65","000","00","140","0005","0726","665","277","388","7","672","1712","0","39.25","16.18"
"65","000","00","140","0006","0000","3648","1437","2211","33","3681","9167","0","40.15","15.68"
"65","000","00","140","0006","0715","767","320","447","10","777","1811","0","42.90","17.67"
"65","000","00","140","0006","0716","661","260","401","6","667","1803","0","36.99","14.42"
"65","000","00","140","0006","0717","761","273","488","6","767","1882","0","40.75","14.51"
"65","000","00","140","0006","0718","683","264","419","6","689","1805","0","38.17","14.63"
"65","000","00","140","0006","0719","776","320","456","5","781","1866","0","41.85","17.15"
"65","000","00","140","0007","0000","2460","1044","1416","19","2479","5872","0","42.22","17.78"
"65","000","00","140","0007","0671","664","318","346","7","671","1522","0","44.09","20.89"
"65","000","00","140","0007","0672","741","308","433","6","747","1714","0","43.58","17.97"
"65","000","00","140","0007","0673","437","162","275","0","437","1073","0","40.73","15.10"
"65","000","00","140","0007","0674","618","256","362","6","624","1563","0","39.92","16.38"
"65","000","00","140","0008","0000","1938","754","1184","17","1955","4812","0","40.63","15.67"
"65","000","00","140","0008","0685","710","274","436","7","717","1735","0","41.33","15.79"
"65","000","00","140","0008","0686","631","269","362","7","638","1573","0","40.56","17.10"
"65","000","00","140","0008","0687","597","211","386","3","600","1504","0","39.89","14.03"
"65","000","00","140","0009","0000","2235","968","1267","24","2259","5571","0","40.55","17.38"
"65","000","00","140","0009","0688","512","216","296","7","519","1321","0","39.29","16.35"
"65","000","00","140","0009","0689","536","222","314","5","541","1380","0","39.20","16.09"
"65","000","00","140","0009","0690","507","214","293","4","511","1378","0","37.08","15.53"
"65","000","00","140","0009","0691","680","316","364","8","688","1492","0","46.11","21.18"
"65","000","00","140","0010","0000","1233","442","791","10","1243","2798","0","44.42","15.80"
"65","000","00","140","0010","0692","555","183","372","3","558","1306","0","42.73","14.01"
"65","000","00","140","0010","0693","678","259","419","7","685","1492","0","45.91","17.36"
"65","000","00","140","0011","0000","1296","502","794","15","1311","2888","0","45.39","17.38"
"65","000","00","140","0011","0706","695","276","419","7","702","1549","0","45.32","17.82"
"65","000","00","140","0011","0707","601","226","375","8","609","1339","0","45.48","16.88"
"65","000","00","140","0012","0000","942","374","568","10","952","2322","0","41.00","16.11"
"65","000","00","140","0012","0704","454","177","277","7","461","1151","0","40.05","15.38"
"65","000","00","140","0012","0705","488","197","291","3","491","1171","0","41.93","16.82"
"65","000","00","140","0013","0000","734","283","451","5","739","1885","0","39.20","15.01"
"65","000","00","140","0013","0694","734","283","451","5","739","1885","0","39.20","15.01"
"65","000","00","140","0014","0000","1180","458","722","9","1189","2972","0","40.01","15.41"
"65","000","00","140","0014","0700","542","231","311","1","543","1321","0","41.11","17.49"
"65","000","00","140","0014","0701","638","227","411","8","646","1651","0","39.13","13.75"
"65","000","00","140","0015","0000","1916","709","1207","22","1938","5162","0","37.54","13.73"
"65","000","00","140","0015","0654","580","212","368","6","586","1648","0","35.56","12.86"
"65","000","00","140","0015","0655","665","252","413","6","671","1726","0","38.88","14.60"
"65","000","00","140","0015","0656","671","245","426","10","681","1788","0","38.09","13.70"
"65","000","00","140","0016","0000","2142","852","1290","14","2156","5439","0","39.64","15.66"
"65","000","00","140","0016","0657","734","285","449","3","737","1869","0","39.43","15.25"
"65","000","00","140","0016","0658","683","275","408","5","688","1773","0","38.80","15.51"
"65","000","00","140","0016","0659","725","292","433","6","731","1797","0","40.68","16.25"
"65","000","00","140","0017","0000","2253","841","1412","19","2272","5948","0","38.20","14.14"
"65","000","00","140","0017","0664","505","184","321","2","507","1370","0","37.01","13.43"
"65","000","00","140","0017","0665","537","177","360","0","537","1452","0","36.98","12.19"
"65","000","00","140","0017","0666","580","224","356","11","591","1547","0","38.20","14.48"
"65","000","00","140","0017","0667","631","256","375","6","637","1579","0","40.34","16.21"
"65","000","00","140","0018","0000","1398","501","897","13","1411","3564","0","39.59","14.06"
"65","000","00","140","0018","0675","730","278","452","8","738","1798","0","41.05","15.46"
"65","000","00","140","0018","0676","668","223","445","5","673","1766","0","38.11","12.63"
"65","000","00","140","0019","0000","2203","932","1271","13","2216","5243","0","42.27","17.78"
"65","000","00","140","0019","0677","587","219","368","6","593","1439","0","41.21","15.22"
"65","000","00","140","0019","0678","559","237","322","2","561","1396","0","40.19","16.98"
"65","000","00","140","0019","0679","605","268","337","3","608","1362","0","44.64","19.68"
"65","000","00","140","0019","0680","452","208","244","2","454","1046","0","43.40","19.89"
"65","000","00","140","0020","0000","1353","455","898","17","1370","3166","0","43.27","14.37"
"65","000","00","140","0020","0681","675","224","451","7","682","1558","0","43.77","14.38"
"65","000","00","140","0020","0682","678","231","447","10","688","1608","0","42.79","14.37"
"65","000","00","140","0021","0000","3221","1190","2031","33","3254","8441","0","38.55","14.10"
"65","000","00","140","0021","0710","681","283","398","7","688","1706","0","40.33","16.59"
"65","000","00","140","0021","0711","586","206","380","4","590","1564","0","37.72","13.17"
"65","000","00","140","0021","0712","674","223","451","12","686","1798","0","38.15","12.40"
"65","000","00","140","0021","0713","655","223","432","7","662","1759","0","37.64","12.68"
"65","000","00","140","0021","0714","625","255","370","3","628","1614","0","38.91","15.80"
"65","000","00","140","0022","0000","1883","702","1181","22","1905","4663","0","40.85","15.05"
"65","000","00","140","0022","0720","654","236","418","7","661","1503","0","43.98","15.70"
"65","000","00","140","0022","0721","646","216","430","11","657","1644","0","39.96","13.14"
"65","000","00","140","0022","0722","583","250","333","4","587","1516","0","38.72","16.49"
"65","000","00","140","0023","0000","1018","377","641","15","1033","2855","0","36.18","13.20"
"65","000","00","140","0023","0645","457","181","276","6","463","1338","0","34.60","13.53"
"65","000","00","140","0023","0646","561","196","365","9","570","1517","0","37.57","12.92"
"65","000","00","140","0024","0000","1857","744","1113","15","1872","4834","0","38.73","15.39"
"65","000","00","140","0024","0631","615","227","388","7","622","1559","0","39.90","14.56"
"65","000","00","140","0024","0632","604","228","376","5","609","1595","0","38.18","14.29"
"65","000","00","140","0024","0633","638","289","349","3","641","1680","0","38.15","17.20"
"65","000","00","140","0025","0000","1259","458","801","7","1266","2975","0","42.55","15.39"
"65","000","00","140","0025","0636","640","194","446","2","642","1539","0","41.72","12.61"
"65","000","00","140","0025","0637","619","264","355","5","624","1436","0","43.45","18.38"
"65","000","00","140","0026","0000","1234","466","768","16","1250","2688","0","46.50","17.34"
"65","000","00","140","0026","0702","643","254","389","10","653","1327","0","49.21","19.14"
"65","000","00","140","0026","0703","591","212","379","6","597","1361","0","43.86","15.58"
"65","000","00","140","0027","0000","1962","720","1242","21","1983","4838","0","40.99","14.88"
"65","000","00","140","0027","0695","675","246","429","6","681","1714","0","39.73","14.35"
"65","000","00","140","0027","0696","667","251","416","9","676","1566","0","43.17","16.03"
"65","000","00","140","0027","0697","620","223","397","6","626","1558","0","40.18","14.31"
"65","000","00","140","0028","0000","1589","628","961","17","1606","4916","0","32.67","12.77"
"65","000","00","140","0028","0698","829","366","463","8","837","3136","0","26.69","11.67"
"65","000","00","140","0028","0699","760","262","498","9","769","1780","0","43.20","14.72"
"65","000","00","140","0029","0000","1705","633","1072","19","1724","4262","0","40.45","14.85"
"65","000","00","140","0029","0622","511","186","325","7","518","1319","0","39.27","14.10"
"65","000","00","140","0029","0623","564","173","391","4","568","1381","0","41.13","12.53"
"65","000","00","140","0029","0624","630","274","356","8","638","1562","0","40.85","17.54"
"65","000","00","140","0030","0000","1326","514","812","12","1338","3431","0","39.00","14.98"
"65","000","00","140","0030","0727","597","229","368","6","603","1560","0","38.65","14.68"
"65","000","00","140","0030","0728","729","285","444","6","735","1871","0","39.28","15.23"
"65","000","00","140","0031","0000","1620","542","1078","15","1635","4622","0","35.37","11.73"
"65","000","00","140","0031","0642","493","177","316","5","498","1537","0","32.40","11.52"
"65","000","00","140","0031","0643","575","177","398","4","579","1498","0","38.65","11.82"
"65","000","00","140","0031","0644","552","188","364","6","558","1587","0","35.16","11.85"
"65","000","00","140","0032","0000","1009","403","606","11","1020","2400","0","42.50","16.79"
"65","000","00","140","0032","0708","608","252","356","7","615","1483","0","41.47","16.99"
"65","000","00","140","0032","0709","401","151","250","4","405","917","0","44.17","16.47"
"65","000","00","140","0033","0000","878","287","591","3","881","2171","0","40.58","13.22"
"65","000","00","140","0033","0723","442","154","288","3","445","1183","0","37.62","13.02"
"65","000","00","140","0033","0724","436","133","303","0","436","988","0","44.13","13.46"
"65","000","00","140","0034","0000","1209","460","749","15","1224","2886","0","42.41","15.94"
"65","000","00","140","0034","0683","676","249","427","6","682","1655","0","41.21","15.05"
"65","000","00","140","0034","0684","533","211","322","9","542","1231","0","44.03","17.14"
"65","000","00","140","0035","0000","1829","652","1177","26","1855","4625","0","40.11","14.10"
"65","000","00","140","0035","0628","563","186","377","5","568","1367","0","41.55","13.61"
"65","000","00","140","0035","0629","689","276","413","17","706","1659","0","42.56","16.64"
"65","000","00","140","0035","0630","577","190","387","4","581","1599","0","36.34","11.88"
"65","000","00","140","0036","0000","1472","550","922","22","1494","3685","0","40.54","14.93"
"65","000","00","140","0036","0634","775","303","472","11","786","1897","0","41.43","15.97"
"65","000","00","140","0036","0635","697","247","450","11","708","1788","0","39.60","13.81"
"65","000","00","140","0037","0000","2587","967","1620","26","2613","6695","0","39.03","14.44"
"65","000","00","140","0037","0660","617","245","372","6","623","1637","0","38.06","14.97"
"65","000","00","140","0037","0661","658","257","401","9","667","1729","0","38.58","14.86"
"65","000","00","140","0037","0662","679","256","423","6","685","1761","0","38.90","14.54"
"65","000","00","140","0037","0663","633","209","424","5","638","1568","0","40.69","13.33"
"65","000","00","140","0038","0000","1409","528","881","17","1426","4010","0","35.56","13.17"
"65","000","00","140","0038","0668","433","176","257","7","440","1382","0","31.84","12.74"
"65","000","00","140","0038","0669","516","186","330","3","519","1316","0","39.44","14.13"
"65","000","00","140","0038","0670","460","166","294","7","467","1312","0","35.59","12.65"
"65","000","00","150","0000","0000","30080","12700","17380","274","30354","76657","90027","39.60","16.57"
"65","000","00","150","0001","0000","1736","548","1188","15","1751","4197","0","41.72","13.06"
"65","000","00","150","0001","0243","571","172","399","5","576","1398","0","41.20","12.30"
"65","000","00","150","0001","0244","554","197","357","4","558","1495","0","37.32","13.18"
"65","000","00","150","0001","0245","611","179","432","6","617","1304","0","47.32","13.73"
"65","000","00","150","0002","0000","489","119","370","3","492","1073","0","45.85","11.09"
"65","000","00","150","0002","0246","489","119","370","3","492","1073","0","45.85","11.09"
"65","000","00","150","0003","0000","1488","573","915","8","1496","3475","0","43.05","16.49"
"65","000","00","150","0003","0248","698","263","435","2","700","1616","0","43.32","16.27"
"65","000","00","150","0003","0249","595","251","344","6","601","1381","0","43.52","18.18"
"65","000","00","150","0003","0250","195","59","136","0","195","478","0","40.79","12.34"
"65","000","00","150","0004","0000","494","139","355","5","499","1260","0","39.60","11.03"
"65","000","00","150","0004","0247","494","139","355","5","499","1260","0","39.60","11.03"
"65","000","00","150","0005","0000","1965","730","1235","26","1991","5457","0","36.49","13.38"
"65","000","00","150","0005","0255","544","185","359","8","552","1534","0","35.98","12.06"
"65","000","00","150","0005","0256","598","247","351","6","604","1546","0","39.07","15.98"
"65","000","00","150","0005","0257","379","128","251","5","384","1182","0","32.49","10.83"
"65","000","00","150","0005","0258","444","170","274","7","451","1195","0","37.74","14.23"
"65","000","00","150","0006","0000","2406","896","1510","23","2429","6462","0","37.59","13.87"
"65","000","00","150","0006","0259","683","310","373","5","688","2035","0","33.81","15.23"
"65","000","00","150","0006","0260","583","182","401","7","590","1499","0","39.36","12.14"
"65","000","00","150","0006","0261","550","180","370","3","553","1426","0","38.78","12.62"
"65","000","00","150","0006","0262","590","224","366","8","598","1502","0","39.81","14.91"
"65","000","00","150","0007","0000","524","129","395","3","527","1245","0","42.33","10.36"
"65","000","00","150","0007","0269","524","129","395","3","527","1245","0","42.33","10.36"
"65","000","00","150","0008","0000","1388","573","815","15","1403","3885","0","36.11","14.75"
"65","000","00","150","0008","0276","472","218","254","4","476","1638","0","29.06","13.31"
"65","000","00","150","0008","0277","485","217","268","9","494","1191","0","41.48","18.22"
"65","000","00","150","0008","0278","431","138","293","2","433","1056","0","41.00","13.07"
"65","000","00","150","0009","0000","1240","509","731","9","1249","3097","0","40.33","16.44"
"65","000","00","150","0009","0270","610","250","360","5","615","1519","0","40.49","16.46"
"65","000","00","150","0009","0271","630","259","371","4","634","1578","0","40.18","16.41"
"65","000","00","150","0010","0000","1945","904","1041","23","1968","4718","0","41.71","19.16"
"65","000","00","150","0010","0279","603","298","305","7","610","1591","0","38.34","18.73"
"65","000","00","150","0010","0280","619","275","344","7","626","1475","0","42.44","18.64"
"65","000","00","150","0010","0281","723","331","392","9","732","1652","0","44.31","20.04"
"65","000","00","150","0011","0000","1050","830","220","9","1059","2315","0","45.75","35.85"
"65","000","00","150","0011","0294","531","418","113","5","536","1133","0","47.31","36.89"
"65","000","00","150","0011","0295","519","412","107","4","523","1182","0","44.25","34.86"
"65","000","00","150","0012","0000","1243","864","379","17","1260","2648","0","47.58","32.63"
"65","000","00","150","0012","0292","697","451","246","11","708","1418","0","49.93","31.81"
"65","000","00","150","0012","0293","546","413","133","6","552","1230","0","44.88","33.58"
"65","000","00","150","0013","0000","1554","728","826","14","1568","3948","0","39.72","18.44"
"65","000","00","150","0013","0289","517","249","268","4","521","1439","0","36.21","17.30"
"65","000","00","150","0013","0290","562","272","290","3","565","1324","0","42.67","20.54"
"65","000","00","150","0013","0291","475","207","268","7","482","1185","0","40.68","17.47"
"65","000","00","150","0014","0000","1114","435","679","7","1121","3009","0","37.25","14.46"
"65","000","00","150","0014","0253","530","214","316","6","536","1530","0","35.03","13.99"
"65","000","00","150","0014","0254","584","221","363","1","585","1479","0","39.55","14.94"
"65","000","00","150","0015","0000","1357","639","718","17","1374","3460","0","39.71","18.47"
"65","000","00","150","0015","0272","669","313","356","9","678","1737","0","39.03","18.02"
"65","000","00","150","0015","0273","688","326","362","8","696","1723","0","40.39","18.92"
"65","000","00","150","0016","0000","1490","529","961","12","1502","3661","0","41.03","14.45"
"65","000","00","150","0016","0251","757","273","484","7","764","1876","0","40.72","14.55"
"65","000","00","150","0016","0252","733","256","477","5","738","1785","0","41.34","14.34"
"65","000","00","150","0017","0000","1304","568","736","7","1311","3192","0","41.07","17.79"
"65","000","00","150","0017","0274","568","246","322","3","571","1480","0","38.58","16.62"
"65","000","00","150","0017","0275","736","322","414","4","740","1712","0","43.22","18.81"
"65","000","00","150","0018","0000","3532","1480","2052","29","3561","9533","0","37.35","15.53"
"65","000","00","150","0018","0263","414","193","221","1","415","1230","0","33.74","15.69"
"65","000","00","150","0018","0264","403","186","217","2","405","1151","0","35.19","16.16"
"65","000","00","150","0018","0265","692","328","364","6","698","1879","0","37.15","17.46"
"65","000","00","150","0018","0266","600","227","373","5","605","1635","0","37.00","13.88"
"65","000","00","150","0018","0267","720","296","424","3","723","1808","0","39.99","16.37"
"65","000","00","150","0018","0268","703","250","453","12","715","1830","0","39.07","13.66"
"65","000","00","150","0019","0000","2738","1075","1663","24","2762","7004","0","39.43","15.35"
"65","000","00","150","0019","0284","545","219","326","4","549","1436","0","38.23","15.25"
"65","000","00","150","0019","0285","499","168","331","4","503","1317","0","38.19","12.76"
"65","000","00","150","0019","0286","549","230","319","8","557","1359","0","40.99","16.92"
"65","000","00","150","0019","0287","573","218","355","6","579","1483","0","39.04","14.70"
"65","000","00","150","0019","0288","572","240","332","2","574","1409","0","40.74","17.03"
"65","000","00","150","0020","0000","1023","432","591","8","1031","3018","0","34.16","14.31"
"65","000","00","150","0020","0282","507","204","303","5","512","1440","0","35.56","14.17"
"65","000","00","150","0020","0283","516","228","288","3","519","1578","0","32.89","14.45"
"65","000","00","160","0000","0000","26225","11896","14329","217","26442","64477","77862","41.01","18.45"
"65","000","00","160","0001","0000","325","124","201","3","328","822","0","39.90","15.09"
"65","000","00","160","0001","0296","228","78","150","3","231","646","0","35.76","12.07"
"65","000","00","160","0001","0297","97","46","51","0","97","176","0","55.11","26.14"
"65","000","00","160","0002","0000","1223","551","672","9","1232","3030","0","40.66","18.18"
"65","000","00","160","0002","0298","610","263","347","7","617","1445","0","42.70","18.20"
"65","000","00","160","0002","0299","613","288","325","2","615","1585","0","38.80","18.17"
"65","000","00","160","0003","0000","2243","1024","1219","14","2257","5956","0","37.89","17.19"
"65","000","00","160","0003","0300","619","311","308","4","623","1689","0","36.89","18.41"
"65","000","00","160","0003","0301","657","277","380","5","662","1784","0","37.11","15.53"
"65","000","00","160","0003","0302","425","224","201","4","429","1197","0","35.84","18.71"
"65","000","00","160","0003","0303","542","212","330","1","543","1286","0","42.22","16.49"
"65","000","00","160","0004","0000","985","428","557","18","1003","2521","0","39.79","16.98"
"65","000","00","160","0004","0304","486","237","249","9","495","1254","0","39.47","18.90"
"65","000","00","160","0004","0305","499","191","308","9","508","1267","0","40.09","15.07"
"65","000","00","160","0005","0000","1542","698","844","14","1556","3870","0","40.21","18.04"
"65","000","00","160","0005","0308","504","250","254","8","512","1283","0","39.91","19.49"
"65","000","00","160","0005","0309","479","202","277","2","481","1254","0","38.36","16.11"
"65","000","00","160","0005","0310","559","246","313","4","563","1333","0","42.24","18.45"
"65","000","00","160","0006","0000","1505","731","774","18","1523","3617","0","42.11","20.21"
"65","000","00","160","0006","0311","552","302","250","9","561","1312","0","42.76","23.02"
"65","000","00","160","0006","0312","540","250","290","7","547","1221","0","44.80","20.48"
"65","000","00","160","0006","0313","413","179","234","2","415","1084","0","38.28","16.51"
"65","000","00","160","0007","0000","1672","738","934","10","1682","4172","0","40.32","17.69"
"65","000","00","160","0007","0322","594","255","339","1","595","1404","0","42.38","18.16"
"65","000","00","160","0007","0323","538","228","310","6","544","1446","0","37.62","15.77"
"65","000","00","160","0007","0324","540","255","285","3","543","1322","0","41.07","19.29"
"65","000","00","160","0008","0000","1447","653","794","11","1458","3385","0","43.07","19.29"
"65","000","00","160","0008","0330","475","209","266","1","476","1277","0","37.27","16.37"
"65","000","00","160","0008","0331","476","222","254","1","477","1076","0","44.33","20.63"
"65","000","00","160","0008","0332","496","222","274","9","505","1032","0","48.93","21.51"
"65","000","00","160","0009","0000","1572","754","818","7","1579","3571","0","44.22","21.11"
"65","000","00","160","0009","0337","528","291","237","0","528","1227","0","43.03","23.72"
"65","000","00","160","0009","0338","603","251","352","3","606","1329","0","45.60","18.89"
"65","000","00","160","0009","0339","441","212","229","4","445","1015","0","43.84","20.89"
"65","000","00","160","0010","0000","1820","814","1006","12","1832","4404","0","41.60","18.48"
"65","000","00","160","0010","0343","568","289","279","6","574","1387","0","41.38","20.84"
"65","000","00","160","0010","0344","574","240","334","5","579","1367","0","42.36","17.56"
"65","000","00","160","0010","0345","678","285","393","1","679","1650","0","41.15","17.27"
"65","000","00","160","0011","0000","1374","560","814","14","1388","3234","0","42.92","17.32"
"65","000","00","160","0011","0314","452","213","239","4","456","1085","0","42.03","19.63"
"65","000","00","160","0011","0315","465","177","288","5","470","1108","0","42.42","15.97"
"65","000","00","160","0011","0316","457","170","287","5","462","1041","0","44.38","16.33"
"65","000","00","160","0012","0000","2892","1277","1615","16","2908","7169","0","40.56","17.81"
"65","000","00","160","0012","0325","607","260","347","4","611","1520","0","40.20","17.11"
"65","000","00","160","0012","0326","638","256","382","5","643","1565","0","41.09","16.36"
"65","000","00","160","0012","0327","485","208","277","4","489","1310","0","37.33","15.88"
"65","000","00","160","0012","0328","583","285","298","2","585","1577","0","37.10","18.07"
"65","000","00","160","0012","0329","579","268","311","1","580","1197","0","48.45","22.39"
"65","000","00","160","0013","0000","767","353","414","6","773","1857","0","41.63","19.01"
"65","000","00","160","0013","0333","370","180","190","2","372","954","0","38.99","18.87"
"65","000","00","160","0013","0334","397","173","224","4","401","903","0","44.41","19.16"
"65","000","00","160","0014","0000","1146","498","648","11","1157","2868","0","40.34","17.36"
"65","000","00","160","0014","0335","560","242","318","5","565","1396","0","40.47","17.34"
"65","000","00","160","0014","0336","586","256","330","6","592","1472","0","40.22","17.39"
"65","000","00","160","0015","0000","1534","733","801","10","1544","3300","0","46.79","22.21"
"65","000","00","160","0015","0340","565","270","295","5","570","1110","0","51.35","24.32"
"65","000","00","160","0015","0341","478","252","226","1","479","1150","0","41.65","21.91"
"65","000","00","160","0015","0342","491","211","280","4","495","1040","0","47.60","20.29"
"65","000","00","160","0016","0000","1255","605","650","14","1269","3114","0","40.75","19.43"
"65","000","00","160","0016","0306","585","270","315","8","593","1513","0","39.19","17.85"
"65","000","00","160","0016","0307","670","335","335","6","676","1601","0","42.22","20.92"
"65","000","00","160","0017","0000","2923","1355","1568","30","2953","7587","0","38.92","17.86"
"65","000","00","160","0017","0317","536","253","283","8","544","1571","0","34.63","16.10"
"65","000","00","160","0017","0318","604","276","328","6","610","1584","0","38.51","17.42"
"65","000","00","160","0017","0319","728","355","373","3","731","1661","0","44.01","21.37"
"65","000","00","160","0017","0320","562","262","300","7","569","1479","0","38.47","17.71"
"65","000","00","160","0017","0321","493","209","284","6","499","1292","0","38.62","16.18"
"65","000","00","170","0000","0000","39380","19868","19512","378","39758","97167","123095","40.92","20.45"
"65","000","00","170","0001","0000","1217","492","725","22","1239","3528","0","35.12","13.95"
"65","000","00","170","0001","0167","386","157","229","7","393","1217","0","32.29","12.90"
"65","000","00","170","0001","0168","352","153","199","7","359","1114","0","32.23","13.73"
"65","000","00","170","0001","0169","479","182","297","8","487","1197","0","40.69","15.20"
"65","000","00","170","0002","0000","1731","827","904","16","1747","4811","0","36.31","17.19"
"65","000","00","170","0002","0170","509","258","251","5","514","1383","0","37.17","18.66"
"65","000","00","170","0002","0171","401","197","204","3","404","1157","0","34.92","17.03"
"65","000","00","170","0002","0172","421","190","231","3","424","1197","0","35.42","15.87"
"65","000","00","170","0002","0173","400","182","218","5","405","1074","0","37.71","16.95"
"65","000","00","170","0003","0000","3743","1771","1972","38","3781","9419","0","40.14","18.80"
"65","000","00","170","0003","0174","451","188","263","8","459","1292","0","35.53","14.55"
"65","000","00","170","0003","0175","387","189","198","2","389","1337","0","29.09","14.14"
"65","000","00","170","0003","0176","518","251","267","3","521","1367","0","38.11","18.36"
"65","000","00","170","0003","0177","635","326","309","5","640","1385","0","46.21","23.54"
"65","000","00","170","0003","0178","615","304","311","9","624","1351","0","46.19","22.50"
"65","000","00","170","0003","0179","561","269","292","6","567","1282","0","44.23","20.98"
"65","000","00","170","0003","0180","576","244","332","5","581","1405","0","41.35","17.37"
"65","000","00","170","0004","0000","1647","683","964","21","1668","3771","0","44.23","18.11"
"65","000","00","170","0004","0181","628","252","376","9","637","1345","0","47.36","18.74"
"65","000","00","170","0004","0182","419","142","277","10","429","1162","0","36.92","12.22"
"65","000","00","170","0004","0183","600","289","311","2","602","1264","0","47.63","22.86"
"65","000","00","170","0005","0000","1553","681","872","11","1564","4170","0","37.51","16.33"
"65","000","00","170","0005","0184","505","210","295","4","509","1348","0","37.76","15.58"
"65","000","00","170","0005","0185","456","244","212","4","460","1373","0","33.50","17.77"
"65","000","00","170","0005","0186","592","227","365","3","595","1449","0","41.06","15.67"
"65","000","00","170","0006","0000","609","222","387","14","623","1384","0","45.01","16.04"
"65","000","00","170","0006","0187","609","222","387","14","623","1384","0","45.01","16.04"
"65","000","00","170","0007","0000","8362","4587","3775","65","8427","20700","0","40.71","22.16"
"65","000","00","170","0007","0188","442","271","171","5","447","1181","0","37.85","22.95"
"65","000","00","170","0007","0189","448","275","173","4","452","1225","0","36.90","22.45"
"65","000","00","170","0007","0190","517","296","221","2","519","1363","0","38.08","21.72"
"65","000","00","170","0007","0191","554","318","236","4","558","1362","0","40.97","23.35"
"65","000","00","170","0007","0192","470","266","204","1","471","1228","0","38.36","21.66"
"65","000","00","170","0007","0193","507","305","202","3","510","1165","0","43.78","26.18"
"65","000","00","170","0007","0194","551","333","218","4","555","1168","0","47.52","28.51"
"65","000","00","170","0007","0195","641","332","309","8","649","1433","0","45.29","23.17"
"65","000","00","170","0007","0196","556","309","247","2","558","1194","0","46.73","25.88"
"65","000","00","170","0007","0197","512","298","214","2","514","1245","0","41.29","23.94"
"65","000","00","170","0007","0198","543","246","297","5","548","1353","0","40.50","18.18"
"65","000","00","170","0007","0199","473","223","250","3","476","1097","0","43.39","20.33"
"65","000","00","170","0007","0200","557","292","265","6","563","1447","0","38.91","20.18"
"65","000","00","170","0007","0201","507","259","248","3","510","1384","0","36.85","18.71"
"65","000","00","170","0007","0202","548","280","268","7","555","1421","0","39.06","19.70"
"65","000","00","170","0007","0203","536","284","252","6","542","1434","0","37.80","19.80"
"65","000","00","170","0008","0000","8650","4598","4052","74","8724","20299","0","42.98","22.65"
"65","000","00","170","0008","0204","560","263","297","2","562","1444","0","38.92","18.21"
"65","000","00","170","0008","0205","633","300","333","3","636","1365","0","46.59","21.98"
"65","000","00","170","0008","0206","508","231","277","5","513","1343","0","38.20","17.20"
"65","000","00","170","0008","0207","555","342","213","2","557","1258","0","44.28","27.19"
"65","000","00","170","0008","0208","570","290","280","6","576","1264","0","45.57","22.94"
"65","000","00","170","0008","0209","552","303","249","6","558","1274","0","43.80","23.78"
"65","000","00","170","0008","0210","618","327","291","5","623","1312","0","47.48","24.92"
"65","000","00","170","0008","0211","647","355","292","6","653","1413","0","46.21","25.12"
"65","000","00","170","0008","0212","555","305","250","5","560","1254","0","44.66","24.32"
"65","000","00","170","0008","0213","580","345","235","4","584","1351","0","43.23","25.54"
"65","000","00","170","0008","0214","541","295","246","4","545","1365","0","39.93","21.61"
"65","000","00","170","0008","0215","650","348","302","6","656","1702","0","38.54","20.45"
"65","000","00","170","0008","0216","596","294","302","3","599","1356","0","44.17","21.68"
"65","000","00","170","0008","0217","572","323","249","11","583","1379","0","42.28","23.42"
"65","000","00","170","0008","0218","513","277","236","6","519","1219","0","42.58","22.72"
"65","000","00","170","0009","0000","2729","1452","1277","21","2750","6489","0","42.38","22.38"
"65","000","00","170","0009","0230","522","275","247","4","526","1189","0","44.24","23.13"
"65","000","00","170","0009","0231","597","317","280","4","601","1262","0","47.62","25.12"
"65","000","00","170","0009","0232","486","273","213","6","492","1253","0","39.27","21.79"
"65","000","00","170","0009","0233","595","301","294","2","597","1315","0","45.40","22.89"
"65","000","00","170","0009","0234","529","286","243","5","534","1470","0","36.33","19.46"
"65","000","00","170","0010","0000","357","92","265","4","361","1010","0","35.74","9.11"
"65","000","00","170","0010","0238","357","92","265","4","361","1010","0","35.74","9.11"
"65","000","00","170","0011","0000","451","178","273","6","457","1229","0","37.18","14.48"
"65","000","00","170","0011","0239","451","178","273","6","457","1229","0","37.18","14.48"
"65","000","00","170","0012","0000","397","138","259","4","401","911","0","44.02","15.15"
"65","000","00","170","0012","0240","397","138","259","4","401","911","0","44.02","15.15"
"65","000","00","170","0013","0000","262","90","172","1","263","763","0","34.47","11.80"
"65","000","00","170","0013","0241","262","90","172","1","263","763","0","34.47","11.80"
"65","000","00","170","0014","0000","459","139","320","7","466","1461","0","31.90","9.51"
"65","000","00","170","0014","0242","459","139","320","7","466","1461","0","31.90","9.51"
"65","000","00","170","0015","0000","2515","1393","1122","20","2535","6006","0","42.21","23.19"
"65","000","00","170","0015","0219","404","213","191","9","413","1099","0","37.58","19.38"
"65","000","00","170","0015","0220","487","288","199","0","487","1157","0","42.09","24.89"
"65","000","00","170","0015","0221","452","250","202","6","458","1191","0","38.46","20.99"
"65","000","00","170","0015","0222","552","330","222","2","554","1190","0","46.55","27.73"
"65","000","00","170","0015","0223","620","312","308","3","623","1369","0","45.51","22.79"
"65","000","00","170","0016","0000","3147","1753","1394","31","3178","7589","0","41.88","23.10"
"65","000","00","170","0016","0224","571","317","254","1","572","1355","0","42.21","23.39"
"65","000","00","170","0016","0225","422","237","185","6","428","1140","0","37.54","20.79"
"65","000","00","170","0016","0226","478","282","196","7","485","1207","0","40.18","23.36"
"65","000","00","170","0016","0227","518","292","226","2","520","1233","0","42.17","23.68"
"65","000","00","170","0016","0228","580","319","261","9","589","1404","0","41.95","22.72"
"65","000","00","170","0016","0229","578","306","272","6","584","1250","0","46.72","24.48"
"65","000","00","170","0017","0000","1551","772","779","23","1574","3627","0","43.40","21.28"
"65","000","00","170","0017","0235","510","252","258","6","516","1308","0","39.45","19.27"
"65","000","00","170","0017","0236","497","248","249","6","503","1126","0","44.67","22.02"
"65","000","00","170","0017","0237","544","272","272","11","555","1193","0","46.52","22.80"
"65","000","00","180","0000","0000","9006","4628","4378","64","9070","20901","23730","43.40","22.14"
"65","000","00","180","0001","0000","1331","637","694","6","1337","3097","0","43.17","20.57"
"65","000","00","180","0001","2326","621","282","339","2","623","1536","0","40.56","18.36"
"65","000","00","180","0001","2327","710","355","355","4","714","1561","0","45.74","22.74"
"65","000","00","180","0002","0000","957","461","496","6","963","2316","0","41.58","19.91"
"65","000","00","180","0002","2320","450","206","244","0","450","1157","0","38.89","17.80"
"65","000","00","180","0002","2321","507","255","252","6","513","1159","0","44.26","22.00"
"65","000","00","180","0003","0000","1143","567","576","10","1153","2749","0","41.94","20.63"
"65","000","00","180","0003","2324","590","299","291","4","594","1376","0","43.17","21.73"
"65","000","00","180","0003","2325","553","268","285","6","559","1373","0","40.71","19.52"
"65","000","00","180","0004","0000","902","494","408","8","910","1926","0","47.25","25.65"
"65","000","00","180","0004","2332","345","149","196","4","349","765","0","45.62","19.48"
"65","000","00","180","0004","2333","557","345","212","4","561","1161","0","48.32","29.72"
"65","000","00","180","0005","0000","236","108","128","2","238","558","0","42.65","19.35"
"65","000","00","180","0005","2336","236","108","128","2","238","558","0","42.65","19.35"
"65","000","00","180","0006","0000","2426","1281","1145","20","2446","5654","0","43.26","22.66"
"65","000","00","180","0006","2328","614","321","293","7","621","1458","0","42.59","22.02"
"65","000","00","180","0006","2329","626","338","288","7","633","1402","0","45.15","24.11"
"65","000","00","180","0006","2330","554","299","255","2","556","1334","0","41.68","22.41"
"65","000","00","180","0006","2331","632","323","309","4","636","1460","0","43.56","22.12"
"65","000","00","180","0007","0000","1046","517","529","5","1051","2486","0","42.28","20.80"
"65","000","00","180","0007","2322","438","188","250","2","440","1063","0","41.39","17.69"
"65","000","00","180","0007","2323","608","329","279","3","611","1423","0","42.94","23.12"
"65","000","00","180","0008","0000","965","563","402","7","972","2115","0","45.96","26.62"
"65","000","00","180","0008","2334","618","373","245","6","624","1380","0","45.22","27.03"
"65","000","00","180","0008","2335","347","190","157","1","348","735","0","47.35","25.85"
"65","000","00","190","0000","0000","2608","996","1612","24","2632","6790","7487","38.76","14.67"
"65","000","00","190","0001","0000","143","59","84","0","143","365","0","39.18","16.16"
"65","000","00","190","0001","2337","143","59","84","0","143","365","0","39.18","16.16"
"65","000","00","190","0002","0000","292","148","144","1","293","798","0","36.72","18.55"
"65","000","00","190","0002","2338","292","148","144","1","293","798","0","36.72","18.55"
"65","000","00","190","0003","0000","237","98","139","3","240","668","0","35.93","14.67"
"65","000","00","190","0003","2343","237","98","139","3","240","668","0","35.93","14.67"
"65","000","00","190","0004","0000","243","83","160","2","245","607","0","40.36","13.67"
"65","000","00","190","0004","2339","243","83","160","2","245","607","0","40.36","13.67"
"65","000","00","190","0005","0000","105","47","58","1","106","296","0","35.81","15.88"
"65","000","00","190","0005","2340","105","47","58","1","106","296","0","35.81","15.88"
"65","000","00","190","0006","0000","184","80","104","1","185","387","0","47.80","20.67"
"65","000","00","190","0006","2341","134","61","73","0","134","291","0","46.05","20.96"
"65","000","00","190","0006","2342","50","19","31","1","51","96","0","53.13","19.79"
"65","000","00","190","0007","0000","202","76","126","3","205","589","0","34.80","12.90"
"65","000","00","190","0007","2346","202","76","126","3","205","589","0","34.80","12.90"
"65","000","00","190","0008","0000","249","94","155","2","251","717","0","35.01","13.11"
"65","000","00","190","0008","2345","249","94","155","2","251","717","0","35.01","13.11"
"65","000","00","190","0009","0000","106","33","73","1","107","261","0","41.00","12.64"
"65","000","00","190","0009","2347","106","33","73","1","107","261","0","41.00","12.64"
"65","000","00","190","0010","0000","123","51","72","1","124","302","0","41.06","16.89"
"65","000","00","190","0010","2344","123","51","72","1","124","302","0","41.06","16.89"
"65","000","00","190","0011","0000","314","89","225","5","319","809","0","39.43","11.00"
"65","000","00","190","0011","2348","314","89","225","5","319","809","0","39.43","11.00"
"65","000","00","190","0012","0000","410","138","272","4","414","991","0","41.78","13.93"
"65","000","00","190","0012","2349","410","138","272","4","414","991","0","41.78","13.93"
"65","000","00","200","0000","0000","2196","781","1415","28","2224","6057","6670","36.72","12.89"
"65","000","00","200","0001","0000","325","141","184","2","327","853","0","38.34","16.53"
"65","000","00","200","0001","2354","222","88","134","0","222","583","0","38.08","15.09"
"65","000","00","200","0001","2355","103","53","50","2","105","270","0","38.89","19.63"
"65","000","00","200","0002","0000","495","197","298","7","502","1290","0","38.91","15.27"
"65","000","00","200","0002","2350","495","197","298","7","502","1290","0","38.91","15.27"
"65","000","00","200","0003","0000","440","117","323","4","444","1167","0","38.05","10.03"
"65","000","00","200","0003","2352","440","117","323","4","444","1167","0","38.05","10.03"
"65","000","00","200","0004","0000","136","43","93","3","139","420","0","33.10","10.24"
"65","000","00","200","0004","2353","136","43","93","3","139","420","0","33.10","10.24"
"65","000","00","200","0005","0000","279","111","168","5","284","836","0","33.97","13.28"
"65","000","00","200","0005","2356","112","26","86","0","112","350","0","32.00","7.43"
"65","000","00","200","0005","2357","167","85","82","5","172","486","0","35.39","17.49"
"65","000","00","200","0006","0000","209","84","125","3","212","631","0","33.60","13.31"
"65","000","00","200","0006","2351","209","84","125","3","212","631","0","33.60","13.31"
"65","000","00","200","0007","0000","312","88","224","4","316","860","0","36.74","10.23"
"65","000","00","200","0007","2358","161","43","118","1","162","402","0","40.30","10.70"
"65","000","00","200","0007","2359","151","45","106","3","154","458","0","33.62","9.83"
"65","000","00","210","0000","0000","6786","3352","3434","69","6855","19927","22460","34.40","16.82"
"65","000","00","210","0001","0000","105","29","76","2","107","311","0","34.41","9.32"
"65","000","00","210","0001","0011","105","29","76","2","107","311","0","34.41","9.32"
"65","000","00","210","0002","0000","1559","780","779","8","1567","4787","0","32.73","16.29"
"65","000","00","210","0002","0012","404","219","185","0","404","1228","0","32.90","17.83"
"65","000","00","210","0002","0013","429","213","216","3","432","1228","0","35.18","17.35"
"65","000","00","210","0002","0014","393","188","205","3","396","1250","0","31.68","15.04"
"65","000","00","210","0002","0015","333","160","173","2","335","1081","0","30.99","14.80"
"65","000","00","210","0003","0000","381","187","194","3","384","1113","0","34.50","16.80"
"65","000","00","210","0003","0016","381","187","194","3","384","1113","0","34.50","16.80"
"65","000","00","210","0004","0000","276","137","139","0","276","776","0","35.57","17.65"
"65","000","00","210","0004","0017","276","137","139","0","276","776","0","35.57","17.65"
"65","000","00","210","0005","0000","1890","998","892","30","1920","6124","0","31.35","16.30"
"65","000","00","210","0005","0018","411","210","201","5","416","1267","0","32.83","16.57"
"65","000","00","210","0005","0019","402","198","204","6","408","1324","0","30.82","14.95"
"65","000","00","210","0005","0020","372","195","177","5","377","1174","0","32.11","16.61"
"65","000","00","210","0005","0021","343","181","162","10","353","1207","0","29.25","15.00"
"65","000","00","210","0005","0022","362","214","148","4","366","1152","0","31.77","18.58"
"65","000","00","210","0006","0000","276","138","138","3","279","604","0","46.19","22.85"
"65","000","00","210","0006","0023","276","138","138","3","279","604","0","46.19","22.85"
"65","000","00","210","0007","0000","161","94","67","1","162","477","0","33.96","19.71"
"65","000","00","210","0007","0024","161","94","67","1","162","477","0","33.96","19.71"
"65","000","00","210","0008","0000","281","121","160","4","285","661","0","43.12","18.31"
"65","000","00","210","0008","0025","281","121","160","4","285","661","0","43.12","18.31"
"65","000","00","210","0009","0000","775","436","339","5","780","2030","0","38.42","21.48"
"65","000","00","210","0009","0026","315","162","153","3","318","862","0","36.89","18.79"
"65","000","00","210","0009","0027","460","274","186","2","462","1168","0","39.55","23.46"
"65","000","00","210","0010","0000","300","139","161","4","304","762","0","39.90","18.24"
"65","000","00","210","0010","0028","300","139","161","4","304","762","0","39.90","18.24"
"65","000","00","210","0011","0000","156","61","95","2","158","532","0","29.70","11.47"
"65","000","00","210","0011","0029","156","61","95","2","158","532","0","29.70","11.47"
"65","000","00","210","0012","0000","192","69","123","0","192","580","0","33.10","11.90"
"65","000","00","210","0012","0030","192","69","123","0","192","580","0","33.10","11.90"
"65","000","00","210","0013","0000","434","163","271","7","441","1170","0","37.69","13.93"
"65","000","00","210","0013","0031","434","163","271","7","441","1170","0","37.69","13.93"
"65","000","00","220","0000","0000","3202","1568","1634","47","3249","10089","11303","32.20","15.54"
"65","000","00","220","0001","0000","336","144","192","6","342","1087","0","31.46","13.25"
"65","000","00","220","0001","0001","336","144","192","6","342","1087","0","31.46","13.25"
"65","000","00","220","0002","0000","481","245","236","7","488","1316","0","37.08","18.62"
"65","000","00","220","0002","0002","481","245","236","7","488","1316","0","37.08","18.62"
"65","000","00","220","0003","0000","624","289","335","12","636","2052","0","30.99","14.08"
"65","000","00","220","0003","0003","315","153","162","6","321","876","0","36.64","17.47"
"65","000","00","220","0003","0004","309","136","173","6","315","1176","0","26.79","11.56"
"65","000","00","220","0004","0000","268","131","137","2","270","867","0","31.14","15.11"
"65","000","00","220","0004","0005","268","131","137","2","270","867","0","31.14","15.11"
"65","000","00","220","0005","0000","517","271","246","8","525","1496","0","35.09","18.11"
"65","000","00","220","0005","0006","517","271","246","8","525","1496","0","35.09","18.11"
"65","000","00","220","0006","0000","427","213","214","6","433","1452","0","29.82","14.67"
"65","000","00","220","0006","0007","427","213","214","6","433","1452","0","29.82","14.67"
"65","000","00","220","0007","0000","100","49","51","0","100","315","0","31.75","15.56"
"65","000","00","220","0007","0008","100","49","51","0","100","315","0","31.75","15.56"
"65","000","00","220","0008","0000","192","90","102","2","194","589","0","32.94","15.28"
"65","000","00","220","0008","0009","192","90","102","2","194","589","0","32.94","15.28"
"65","000","00","220","0009","0000","257","136","121","4","261","915","0","28.52","14.86"
"65","000","00","220","0009","0010","257","136","121","4","261","915","0","28.52","14.86"
"65","000","00","230","0000","0000","12724","5702","7022","103","12827","34221","39799","37.48","16.66"
"65","000","00","230","0001","0000","2778","1328","1450","23","2801","6740","0","41.56","19.70"
"65","000","00","230","0001","0146","714","290","424","5","719","1851","0","38.84","15.67"
"65","000","00","230","0001","0147","714","384","330","7","721","1727","0","41.75","22.24"
"65","000","00","230","0001","0148","606","287","319","8","614","1504","0","40.82","19.08"
"65","000","00","230","0001","0149","744","367","377","3","747","1658","0","45.05","22.14"
"65","000","00","230","0002","0000","1195","561","634","4","1199","3256","0","36.82","17.23"
"65","000","00","230","0002","0150","619","287","332","2","621","1748","0","35.53","16.42"
"65","000","00","230","0002","0151","576","274","302","2","578","1508","0","38.33","18.17"
"65","000","00","230","0003","0000","1204","518","686","10","1214","3091","0","39.28","16.76"
"65","000","00","230","0003","0152","678","296","382","5","683","1611","0","42.40","18.37"
"65","000","00","230","0003","0153","526","222","304","5","531","1480","0","35.88","15.00"
"65","000","00","230","0004","0000","1419","606","813","7","1426","3745","0","38.08","16.18"
"65","000","00","230","0004","0154","628","237","391","1","629","1770","0","35.54","13.39"
"65","000","00","230","0004","0155","791","369","422","6","797","1975","0","40.35","18.68"
"65","000","00","230","0005","0000","780","355","425","7","787","2139","0","36.79","16.60"
"65","000","00","230","0005","0156","780","355","425","7","787","2139","0","36.79","16.60"
"65","000","00","230","0006","0000","2324","993","1331","17","2341","6501","0","36.01","15.27"
"65","000","00","230","0006","0157","584","233","351","4","588","1568","0","37.50","14.86"
"65","000","00","230","0006","0158","601","261","340","6","607","1630","0","37.24","16.01"
"65","000","00","230","0006","0159","594","251","343","3","597","1656","0","36.05","15.16"
"65","000","00","230","0006","0160","545","248","297","4","549","1647","0","33.33","15.06"
"65","000","00","230","0007","0000","1461","655","806","17","1478","4113","0","35.93","15.93"
"65","000","00","230","0007","0161","531","250","281","4","535","1388","0","38.54","18.01"
"65","000","00","230","0007","0162","439","192","247","4","443","1380","0","32.10","13.91"
"65","000","00","230","0007","0163","491","213","278","9","500","1345","0","37.17","15.84"
"65","000","00","230","0008","0000","563","244","319","2","565","1639","0","34.47","14.89"
"65","000","00","230","0008","0164","563","244","319","2","565","1639","0","34.47","14.89"
"65","000","00","230","0009","0000","507","213","294","8","515","1521","0","33.86","14.00"
"65","000","00","230","0009","0165","507","213","294","8","515","1521","0","33.86","14.00"
"65","000","00","230","0010","0000","493","229","264","8","501","1476","0","33.94","15.51"
"65","000","00","230","0010","0166","493","229","264","8","501","1476","0","33.94","15.51"
"65","000","00","240","0000","0000","1449","637","812","25","1474","4076","4354","36.16","15.63"
"65","000","00","240","0001","0000","132","46","86","2","134","361","0","37.12","12.74"
"65","000","00","240","0001","2367","132","46","86","2","134","361","0","37.12","12.74"
"65","000","00","240","0002","0000","85","49","36","0","85","226","0","37.61","21.68"
"65","000","00","240","0002","2368","85","49","36","0","85","226","0","37.61","21.68"
"65","000","00","240","0003","0000","96","35","61","1","97","229","0","42.36","15.28"
"65","000","00","240","0003","2369","96","35","61","1","97","229","0","42.36","15.28"
"65","000","00","240","0004","0000","160","50","110","2","162","417","0","38.85","11.99"
"65","000","00","240","0004","2370","160","50","110","2","162","417","0","38.85","11.99"
"65","000","00","240","0005","0000","101","60","41","1","102","247","0","41.30","24.29"
"65","000","00","240","0005","2371","101","60","41","1","102","247","0","41.30","24.29"
"65","000","00","240","0006","0000","177","82","95","3","180","586","0","30.72","13.99"
"65","000","00","240","0006","2372","177","82","95","3","180","586","0","30.72","13.99"
"65","000","00","240","0007","0000","156","66","90","4","160","406","0","39.41","16.26"
"65","000","00","240","0007","2373","156","66","90","4","160","406","0","39.41","16.26"
"65","000","00","240","0008","0000","58","24","34","0","58","154","0","37.66","15.58"
"65","000","00","240","0008","2375","58","24","34","0","58","154","0","37.66","15.58"
"65","000","00","240","0009","0000","119","54","65","5","124","337","0","36.80","16.02"
"65","000","00","240","0009","2376","119","54","65","5","124","337","0","36.80","16.02"
"65","000","00","240","0010","0000","72","32","40","0","72","164","0","43.90","19.51"
"65","000","00","240","0010","2378","72","32","40","0","72","164","0","43.90","19.51"
"65","000","00","240","0011","0000","254","121","133","6","260","798","0","32.58","15.16"
"65","000","00","240","0011","2374","254","121","133","6","260","798","0","32.58","15.16"
"65","000","00","240","0012","0000","39","18","21","1","40","151","0","26.49","11.92"
"65","000","00","240","0012","2377","39","18","21","1","40","151","0","26.49","11.92"
"65","000","00","250","0000","0000","2695","1140","1555","41","2736","7605","8307","35.98","14.99"
"65","000","00","250","0001","0000","175","87","88","4","179","444","0","40.32","19.59"
"65","000","00","250","0001","2425","175","87","88","4","179","444","0","40.32","19.59"
"65","000","00","250","0002","0000","134","57","77","0","134","363","0","36.91","15.70"
"65","000","00","250","0002","2437","134","57","77","0","134","363","0","36.91","15.70"
"65","000","00","250","0003","0000","296","145","151","8","304","713","0","42.64","20.34"
"65","000","00","250","0003","2426","121","65","56","1","122","268","0","45.52","24.25"
"65","000","00","250","0003","2427","175","80","95","7","182","445","0","40.90","17.98"
"65","000","00","250","0004","0000","231","90","141","3","234","678","0","34.51","13.27"
"65","000","00","250","0004","2438","109","28","81","0","109","337","0","32.34","8.31"
"65","000","00","250","0004","2439","122","62","60","3","125","341","0","36.66","18.18"
"65","000","00","250","0005","0000","123","41","82","1","124","345","0","35.94","11.88"
"65","000","00","250","0005","2428","123","41","82","1","124","345","0","35.94","11.88"
"65","000","00","250","0006","0000","491","207","284","11","502","1416","0","35.45","14.62"
"65","000","00","250","0006","2429","278","112","166","4","282","800","0","35.25","14.00"
"65","000","00","250","0006","2430","213","95","118","7","220","616","0","35.71","15.42"
"65","000","00","250","0007","0000","107","45","62","1","108","319","0","33.86","14.11"
"65","000","00","250","0007","2431","107","45","62","1","108","319","0","33.86","14.11"
"65","000","00","250","0008","0000","331","160","171","1","332","860","0","38.60","18.60"
"65","000","00","250","0008","2432","216","101","115","0","216","602","0","35.88","16.78"
"65","000","00","250","0008","2433","115","59","56","1","116","258","0","44.96","22.87"
"65","000","00","250","0009","0000","207","64","143","4","211","593","0","35.58","10.79"
"65","000","00","250","0009","2434","207","64","143","4","211","593","0","35.58","10.79"
"65","000","00","250","0010","0000","162","77","85","1","163","394","0","41.37","19.54"
"65","000","00","250","0010","2435","162","77","85","1","163","394","0","41.37","19.54"
"65","000","00","250","0011","0000","109","28","81","0","109","351","0","31.05","7.98"
"65","000","00","250","0011","2436","109","28","81","0","109","351","0","31.05","7.98"
"65","000","00","250","0012","0000","329","139","190","7","336","1129","0","29.76","12.31"
"65","000","00","250","0012","2440","329","139","190","7","336","1129","0","29.76","12.31"
"65","000","00","260","0000","0000","4146","1007","3139","59","4205","10765","11658","39.06","9.35"
"65","000","00","260","0001","0000","316","116","200","4","320","823","0","38.88","14.09"
"65","000","00","260","0001","2441","316","116","200","4","320","823","0","38.88","14.09"
"65","000","00","260","0002","0000","158","49","109","4","162","462","0","35.06","10.61"
"65","000","00","260","0002","2443","158","49","109","4","162","462","0","35.06","10.61"
"65","000","00","260","0003","0000","242","59","183","4","246","631","0","38.99","9.35"
"65","000","00","260","0003","2444","120","27","93","2","122","341","0","35.78","7.92"
"65","000","00","260","0003","2445","122","32","90","2","124","290","0","42.76","11.03"
"65","000","00","260","0004","0000","145","39","106","3","148","398","0","37.19","9.80"
"65","000","00","260","0004","2442","145","39","106","3","148","398","0","37.19","9.80"
"65","000","00","260","0005","0000","284","49","235","0","284","630","0","45.08","7.78"
"65","000","00","260","0005","2450","284","49","235","0","284","630","0","45.08","7.78"
"65","000","00","260","0006","0000","584","167","417","10","594","1599","0","37.15","10.44"
"65","000","00","260","0006","2448","288","90","198","4","292","776","0","37.63","11.60"
"65","000","00","260","0006","2449","296","77","219","6","302","823","0","36.70","9.36"
"65","000","00","260","0007","0000","733","190","543","8","741","1652","0","44.85","11.50"
"65","000","00","260","0007","2453","317","86","231","4","321","725","0","44.28","11.86"
"65","000","00","260","0007","2454","416","104","312","4","420","927","0","45.31","11.22"
"65","000","00","260","0008","0000","734","114","620","15","749","1987","0","37.70","5.74"
"65","000","00","260","0008","2451","388","67","321","13","401","1072","0","37.41","6.25"
"65","000","00","260","0008","2452","346","47","299","2","348","915","0","38.03","5.14"
"65","000","00","260","0009","0000","320","80","240","1","321","886","0","36.23","9.03"
"65","000","00","260","0009","2446","170","53","117","1","171","495","0","34.55","10.71"
"65","000","00","260","0009","2447","150","27","123","0","150","391","0","38.36","6.91"
"65","000","00","260","0010","0000","292","69","223","7","299","716","0","41.76","9.64"
"65","000","00","260","0010","2455","172","36","136","4","176","391","0","45.01","9.21"
"65","000","00","260","0010","2456","120","33","87","3","123","325","0","37.85","10.15"
"65","000","00","260","0011","0000","338","75","263","3","341","981","0","34.76","7.65"
"65","000","00","260","0011","2457","179","39","140","2","181","490","0","36.94","7.96"
"65","000","00","260","0011","2458","159","36","123","1","160","491","0","32.59","7.33"
"65","000","00","270","0000","0000","6507","2732","3775","72","6579","18573","20926","35.42","14.71"
"65","000","00","270","0001","0000","188","98","90","3","191","456","0","41.89","21.49"
"65","000","00","270","0001","2459","188","98","90","3","191","456","0","41.89","21.49"
"65","000","00","270","0002","0000","244","117","127","2","246","712","0","34.55","16.43"
"65","000","00","270","0002","2460","244","117","127","2","246","712","0","34.55","16.43"
"65","000","00","270","0003","0000","193","76","117","2","195","502","0","38.84","15.14"
"65","000","00","270","0003","2461","193","76","117","2","195","502","0","38.84","15.14"
"65","000","00","270","0004","0000","624","196","428","6","630","1719","0","36.65","11.40"
"65","000","00","270","0004","2462","282","86","196","1","283","802","0","35.29","10.72"
"65","000","00","270","0004","2463","342","110","232","5","347","917","0","37.84","12.00"
"65","000","00","270","0005","0000","1308","602","706","13","1321","3777","0","34.97","15.94"
"65","000","00","270","0005","2470","455","178","277","6","461","1241","0","37.15","14.34"
"65","000","00","270","0005","2471","410","189","221","1","411","1229","0","33.44","15.38"
"65","000","00","270","0005","2472","443","235","208","6","449","1307","0","34.35","17.98"
"65","000","00","270","0006","0000","597","280","317","8","605","1641","0","36.87","17.06"
"65","000","00","270","0006","2468","317","159","158","4","321","783","0","41.00","20.31"
"65","000","00","270","0006","2469","280","121","159","4","284","858","0","33.10","14.10"
"65","000","00","270","0007","0000","404","148","256","2","406","1182","0","34.35","12.52"
"65","000","00","270","0007","2473","404","148","256","2","406","1182","0","34.35","12.52"
"65","000","00","270","0008","0000","122","52","70","1","123","377","0","32.63","13.79"
"65","000","00","270","0008","2474","122","52","70","1","123","377","0","32.63","13.79"
"65","000","00","270","0009","0000","239","84","155","5","244","643","0","37.95","13.06"
"65","000","00","270","0009","2475","239","84","155","5","244","643","0","37.95","13.06"
"65","000","00","270","0010","0000","235","83","152","2","237","619","0","38.29","13.41"
"65","000","00","270","0010","2476","235","83","152","2","237","619","0","38.29","13.41"
"65","000","00","270","0011","0000","250","114","136","4","254","801","0","31.71","14.23"
"65","000","00","270","0011","2478","250","114","136","4","254","801","0","31.71","14.23"
"65","000","00","270","0012","0000","162","55","107","4","166","443","0","37.47","12.42"
"65","000","00","270","0012","2477","162","55","107","4","166","443","0","37.47","12.42"
"65","000","00","270","0013","0000","71","31","40","2","73","177","0","41.24","17.51"
"65","000","00","270","0013","2479","71","31","40","2","73","177","0","41.24","17.51"
"65","000","00","270","0014","0000","179","63","116","3","182","570","0","31.93","11.05"
"65","000","00","270","0014","2480","179","63","116","3","182","570","0","31.93","11.05"
"65","000","00","270","0015","0000","1691","733","958","15","1706","4954","0","34.44","14.80"
"65","000","00","270","0015","2464","440","180","260","4","444","1183","0","37.53","15.22"
"65","000","00","270","0015","2465","504","227","277","3","507","1352","0","37.50","16.79"
"65","000","00","270","0015","2466","405","164","241","4","409","1269","0","32.23","12.92"
"65","000","00","270","0015","2467","342","162","180","4","346","1150","0","30.09","14.09"
"65","000","00","280","0000","0000","6344","2960","3384","59","6403","19074","21542","33.57","15.52"
"65","000","00","280","0001","0000","1473","695","778","12","1485","4232","0","35.09","16.42"
"65","000","00","280","0001","2481","353","186","167","0","353","1004","0","35.16","18.53"
"65","000","00","280","0001","2482","287","130","157","5","292","903","0","32.34","14.40"
"65","000","00","280","0001","2483","360","164","196","3","363","937","0","38.74","17.50"
"65","000","00","280","0001","2484","473","215","258","4","477","1388","0","34.37","15.49"
"65","000","00","280","0002","0000","767","370","397","2","769","2548","0","30.18","14.52"
"65","000","00","280","0002","2487","365","192","173","2","367","1229","0","29.86","15.62"
"65","000","00","280","0002","2488","402","178","224","0","402","1319","0","30.48","13.50"
"65","000","00","280","0003","0000","1022","461","561","10","1032","3153","0","32.73","14.62"
"65","000","00","280","0003","2489","278","120","158","4","282","838","0","33.65","14.32"
"65","000","00","280","0003","2490","249","111","138","0","249","799","0","31.16","13.89"
"65","000","00","280","0003","2491","495","230","265","6","501","1516","0","33.05","15.17"
"65","000","00","280","0004","0000","950","441","509","9","959","2681","0","35.77","16.45"
"65","000","00","280","0004","2492","329","140","189","3","332","951","0","34.91","14.72"
"65","000","00","280","0004","2493","349","146","203","5","354","893","0","39.64","16.35"
"65","000","00","280","0004","2494","272","155","117","1","273","837","0","32.62","18.52"
"65","000","00","280","0005","0000","184","92","92","1","185","574","0","32.23","16.03"
"65","000","00","280","0005","2495","184","92","92","1","185","574","0","32.23","16.03"
"65","000","00","280","0006","0000","323","125","198","7","330","966","0","34.16","12.94"
"65","000","00","280","0006","2496","323","125","198","7","330","966","0","34.16","12.94"
"65","000","00","280","0007","0000","199","65","134","5","204","659","0","30.96","9.86"
"65","000","00","280","0007","2497","199","65","134","5","204","659","0","30.96","9.86"
"65","000","00","280","0008","0000","146","45","101","2","148","403","0","36.72","11.17"
"65","000","00","280","0008","2498","146","45","101","2","148","403","0","36.72","11.17"
"65","000","00","280","0009","0000","356","172","184","3","359","1107","0","32.43","15.54"
"65","000","00","280","0009","2499","356","172","184","3","359","1107","0","32.43","15.54"
"65","000","00","280","0010","0000","924","494","430","8","932","2751","0","33.88","17.96"
"65","000","00","280","0010","2485","471","263","208","7","478","1411","0","33.88","18.64"
"65","000","00","280","0010","2486","453","231","222","1","454","1340","0","33.88","17.24"
"65","000","00","290","0000","0000","1684","977","707","23","1707","5261","6343","32.45","18.57"
"65","000","00","290","0001","0000","778","450","328","8","786","2348","0","33.48","19.17"
"65","000","00","290","0001","2362","446","232","214","3","449","1186","0","37.86","19.56"
"65","000","00","290","0001","2363","332","218","114","5","337","1162","0","29.00","18.76"
"65","000","00","290","0002","0000","531","314","217","7","538","1572","0","34.22","19.97"
"65","000","00","290","0002","2360","349","176","173","4","353","938","0","37.63","18.76"
"65","000","00","290","0002","2361","182","138","44","3","185","634","0","29.18","21.77"
"65","000","00","290","0003","0000","152","114","38","6","158","606","0","26.07","18.81"
"65","000","00","290","0003","2366","152","114","38","6","158","606","0","26.07","18.81"
"65","000","00","290","0004","0000","156","70","86","1","157","504","0","31.15","13.89"
"65","000","00","290","0004","2365","156","70","86","1","157","504","0","31.15","13.89"
"65","000","00","290","0005","0000","67","29","38","1","68","231","0","29.44","12.55"
"65","000","00","290","0005","2364","67","29","38","1","68","231","0","29.44","12.55"
"68","000","00","000","0000","0000","741363","382314","359049","6835","748198","1869908","2272459","40.01","20.45"
"68","000","00","010","0000","0000","153899","76543","77356","1361","155260","375012","458824","41.40","20.41"
"68","000","00","010","0001","0000","485","227","258","2","487","1024","0","47.56","22.17"
"68","000","00","010","0001","0036","485","227","258","2","487","1024","0","47.56","22.17"
"68","000","00","010","0002","0000","689","338","351","6","695","1396","0","49.79","24.21"
"68","000","00","010","0002","0038","689","338","351","6","695","1396","0","49.79","24.21"
"68","000","00","010","0003","0000","622","299","323","5","627","1628","0","38.51","18.37"
"68","000","00","010","0003","0047","622","299","323","5","627","1628","0","38.51","18.37"
"68","000","00","010","0004","0000","2534","1269","1265","26","2560","6940","0","36.89","18.29"
"68","000","00","010","0004","0001","551","263","288","7","558","1515","0","36.83","17.36"
"68","000","00","010","0004","0002","388","295","93","0","388","1110","0","34.95","26.58"
"68","000","00","010","0004","0003","466","216","250","10","476","1357","0","35.08","15.92"
"68","000","00","010","0004","0004","598","250","348","6","604","1422","0","42.48","17.58"
"68","000","00","010","0004","0005","531","245","286","3","534","1536","0","34.77","15.95"
"68","000","00","010","0005","0000","1366","738","628","11","1377","3581","0","38.45","20.61"
"68","000","00","010","0005","0219","694","402","292","7","701","1850","0","37.89","21.73"
"68","000","00","010","0005","0220","672","336","336","4","676","1731","0","39.05","19.41"
"68","000","00","010","0006","0000","3775","2102","1673","20","3795","9791","0","38.76","21.47"
"68","000","00","010","0006","0233","615","323","292","3","618","1612","0","38.34","20.04"
"68","000","00","010","0006","0234","581","303","278","6","587","1483","0","39.58","20.43"
"68","000","00","010","0006","0235","609","330","279","1","610","1694","0","36.01","19.48"
"68","000","00","010","0006","0236","675","378","297","3","678","1728","0","39.24","21.88"
"68","000","00","010","0006","0237","690","410","280","4","694","1709","0","40.61","23.99"
"68","000","00","010","0006","0238","605","358","247","3","608","1565","0","38.85","22.88"
"68","000","00","010","0007","0000","469","168","301","2","471","1005","0","46.87","16.72"
"68","000","00","010","0007","0048","469","168","301","2","471","1005","0","46.87","16.72"
"68","000","00","010","0008","0000","677","319","358","9","686","1649","0","41.60","19.35"
"68","000","00","010","0008","0040","677","319","358","9","686","1649","0","41.60","19.35"
"68","000","00","010","0009","0000","745","309","436","7","752","1820","0","41.32","16.98"
"68","000","00","010","0009","0041","745","309","436","7","752","1820","0","41.32","16.98"
"68","000","00","010","0010","0000","2591","1123","1468","24","2615","6542","0","39.97","17.17"
"68","000","00","010","0010","0215","845","376","469","9","854","2211","0","38.63","17.01"
"68","000","00","010","0010","0216","612","268","344","8","620","1496","0","41.44","17.91"
"68","000","00","010","0010","0217","572","288","284","5","577","1496","0","38.57","19.25"
"68","000","00","010","0010","0218","562","191","371","2","564","1339","0","42.12","14.26"
"68","000","00","010","0011","0000","2059","821","1238","26","2085","4520","0","46.13","18.16"
"68","000","00","010","0011","0131","628","288","340","11","639","1382","0","46.24","20.84"
"68","000","00","010","0011","0132","675","275","400","7","682","1577","0","43.25","17.44"
"68","000","00","010","0011","0133","756","258","498","8","764","1561","0","48.94","16.53"
"68","000","00","010","0012","0000","1872","806","1066","20","1892","4602","0","41.11","17.51"
"68","000","00","010","0012","0152","630","256","374","4","634","1668","0","38.01","15.35"
"68","000","00","010","0012","0153","624","280","344","10","634","1533","0","41.36","18.26"
"68","000","00","010","0012","0154","618","270","348","6","624","1401","0","44.54","19.27"
"68","000","00","010","0013","0000","1357","691","666","10","1367","3019","0","45.28","22.89"
"68","000","00","010","0013","0222","651","338","313","3","654","1512","0","43.25","22.35"
"68","000","00","010","0013","0223","706","353","353","7","713","1507","0","47.31","23.42"
"68","000","00","010","0014","0000","810","362","448","7","817","1896","0","43.09","19.09"
"68","000","00","010","0014","0221","810","362","448","7","817","1896","0","43.09","19.09"
"68","000","00","010","0015","0000","391","145","246","3","394","924","0","42.64","15.69"
"68","000","00","010","0015","0239","391","145","246","3","394","924","0","42.64","15.69"
"68","000","00","010","0016","0000","1483","625","858","8","1491","3527","0","42.27","17.72"
"68","000","00","010","0016","0155","694","267","427","4","698","1701","0","41.03","15.70"
"68","000","00","010","0016","0156","789","358","431","4","793","1826","0","43.43","19.61"
"68","000","00","010","0017","0000","977","362","615","9","986","2382","0","41.39","15.20"
"68","000","00","010","0017","0122","542","224","318","7","549","1327","0","41.37","16.88"
"68","000","00","010","0017","0123","435","138","297","2","437","1055","0","41.42","13.08"
"68","000","00","010","0018","0000","1332","511","821","13","1345","3082","0","43.64","16.58"
"68","000","00","010","0018","0148","817","315","502","9","826","2001","0","41.28","15.74"
"68","000","00","010","0018","0149","515","196","319","4","519","1081","0","48.01","18.13"
"68","000","00","010","0019","0000","639","293","346","5","644","1626","0","39.61","18.02"
"68","000","00","010","0019","0045","639","293","346","5","644","1626","0","39.61","18.02"
"68","000","00","010","0020","0000","612","261","351","10","622","1307","0","47.59","19.97"
"68","000","00","010","0020","0031","612","261","351","10","622","1307","0","47.59","19.97"
"68","000","00","010","0021","0000","380","134","246","4","384","778","0","49.36","17.22"
"68","000","00","010","0021","0037","380","134","246","4","384","778","0","49.36","17.22"
"68","000","00","010","0022","0000","4193","2289","1904","41","4234","9814","0","43.14","23.32"
"68","000","00","010","0022","0177","666","345","321","4","670","1694","0","39.55","20.37"
"68","000","00","010","0022","0178","752","422","330","5","757","1619","0","46.76","26.07"
"68","000","00","010","0022","0179","751","417","334","9","760","1575","0","48.25","26.48"
"68","000","00","010","0022","0180","718","386","332","9","727","1803","0","40.32","21.41"
"68","000","00","010","0022","0181","624","333","291","6","630","1462","0","43.09","22.78"
"68","000","00","010","0022","0182","682","386","296","8","690","1661","0","41.54","23.24"
"68","000","00","010","0023","0000","2874","1481","1393","23","2897","6789","0","42.67","21.81"
"68","000","00","010","0023","0054","686","355","331","5","691","1687","0","40.96","21.04"
"68","000","00","010","0023","0055","776","394","382","4","780","1721","0","45.32","22.89"
"68","000","00","010","0023","0056","644","327","317","5","649","1644","0","39.48","19.89"
"68","000","00","010","0023","0057","768","405","363","9","777","1737","0","44.73","23.32"
"68","000","00","010","0024","0000","2447","1157","1290","18","2465","6329","0","38.95","18.28"
"68","000","00","010","0024","0173","613","256","357","4","617","1665","0","37.06","15.38"
"68","000","00","010","0024","0174","594","342","252","4","598","1549","0","38.61","22.08"
"68","000","00","010","0024","0175","610","243","367","4","614","1518","0","40.45","16.01"
"68","000","00","010","0024","0176","630","316","314","6","636","1597","0","39.82","19.79"
"68","000","00","010","0025","0000","632","309","323","6","638","1430","0","44.62","21.61"
"68","000","00","010","0025","0046","632","309","323","6","638","1430","0","44.62","21.61"
"68","000","00","010","0026","0000","2475","1183","1292","26","2501","5908","0","42.33","20.02"
"68","000","00","010","0026","0049","867","412","455","5","872","2055","0","42.43","20.05"
"68","000","00","010","0026","0050","418","204","214","8","426","996","0","42.77","20.48"
"68","000","00","010","0026","0051","459","210","249","8","467","1063","0","43.93","19.76"
"68","000","00","010","0026","0052","731","357","374","5","736","1794","0","41.03","19.90"
"68","000","00","010","0027","0000","604","237","367","11","615","1365","0","45.05","17.36"
"68","000","00","010","0027","0053","604","237","367","11","615","1365","0","45.05","17.36"
"68","000","00","010","0028","0000","2060","911","1149","20","2080","4880","0","42.62","18.67"
"68","000","00","010","0028","0092","642","249","393","9","651","1424","0","45.72","17.49"
"68","000","00","010","0028","0093","458","204","254","3","461","1203","0","38.32","16.96"
"68","000","00","010","0028","0094","514","251","263","8","522","1137","0","45.91","22.08"
"68","000","00","010","0028","0095","446","207","239","0","446","1116","0","39.96","18.55"
"68","000","00","010","0029","0000","2263","1041","1222","12","2275","5722","0","39.76","18.19"
"68","000","00","010","0029","0065","548","186","362","3","551","1135","0","48.55","16.39"
"68","000","00","010","0029","0066","438","210","228","3","441","1231","0","35.82","17.06"
"68","000","00","010","0029","0067","814","352","462","2","816","1962","0","41.59","17.94"
"68","000","00","010","0029","0068","463","293","170","4","467","1394","0","33.50","21.02"
"68","000","00","010","0030","0000","2870","1481","1389","20","2890","6550","0","44.12","22.61"
"68","000","00","010","0030","0061","761","410","351","4","765","1565","0","48.88","26.20"
"68","000","00","010","0030","0062","668","337","331","3","671","1569","0","42.77","21.48"
"68","000","00","010","0030","0063","799","389","410","11","810","1914","0","42.32","20.32"
"68","000","00","010","0030","0064","642","345","297","2","644","1502","0","42.88","22.97"
"68","000","00","010","0031","0000","730","290","440","3","733","1710","0","42.87","16.96"
"68","000","00","010","0031","0039","730","290","440","3","733","1710","0","42.87","16.96"
"68","000","00","010","0032","0000","2628","1304","1324","22","2650","6053","0","43.78","21.54"
"68","000","00","010","0032","0016","662","283","379","3","665","1416","0","46.96","19.99"
"68","000","00","010","0032","0017","597","297","300","8","605","1425","0","42.46","20.84"
"68","000","00","010","0032","0018","639","312","327","5","644","1556","0","41.39","20.05"
"68","000","00","010","0032","0019","730","412","318","6","736","1656","0","44.44","24.88"
"68","000","00","010","0033","0000","2642","1253","1389","30","2672","5943","0","44.96","21.08"
"68","000","00","010","0033","0023","663","317","346","9","672","1409","0","47.69","22.50"
"68","000","00","010","0033","0024","749","344","405","7","756","1576","0","47.97","21.83"
"68","000","00","010","0033","0025","660","317","343","7","667","1515","0","44.03","20.92"
"68","000","00","010","0033","0026","570","275","295","7","577","1443","0","39.99","19.06"
"68","000","00","010","0034","0000","2134","921","1213","16","2150","4548","0","47.27","20.25"
"68","000","00","010","0034","0042","651","271","380","6","657","1579","0","41.61","17.16"
"68","000","00","010","0034","0043","728","313","415","3","731","1467","0","49.83","21.34"
"68","000","00","010","0034","0044","755","337","418","7","762","1502","0","50.73","22.44"
"68","000","00","010","0035","0000","1284","677","607","20","1304","3479","0","37.48","19.46"
"68","000","00","010","0035","0099","413","196","217","7","420","1135","0","37.00","17.27"
"68","000","00","010","0035","0100","448","265","183","5","453","1170","0","38.72","22.65"
"68","000","00","010","0035","0101","423","216","207","8","431","1174","0","36.71","18.40"
"68","000","00","010","0036","0000","2316","1264","1052","29","2345","5803","0","40.41","21.78"
"68","000","00","010","0036","0106","590","301","289","6","596","1414","0","42.15","21.29"
"68","000","00","010","0036","0107","576","320","256","11","587","1557","0","37.70","20.55"
"68","000","00","010","0036","0108","610","347","263","8","618","1519","0","40.68","22.84"
"68","000","00","010","0036","0109","540","296","244","4","544","1313","0","41.43","22.54"
"68","000","00","010","0037","0000","1804","927","877","17","1821","3846","0","47.35","24.10"
"68","000","00","010","0037","0212","527","278","249","5","532","1124","0","47.33","24.73"
"68","000","00","010","0037","0213","606","296","310","2","608","1346","0","45.17","21.99"
"68","000","00","010","0037","0214","671","353","318","10","681","1376","0","49.49","25.65"
"68","000","00","010","0038","0000","1825","752","1073","22","1847","4213","0","43.84","17.85"
"68","000","00","010","0038","0224","545","219","326","5","550","1272","0","43.24","17.22"
"68","000","00","010","0038","0225","639","238","401","9","648","1458","0","44.44","16.32"
"68","000","00","010","0038","0226","641","295","346","8","649","1483","0","43.76","19.89"
"68","000","00","010","0039","0000","894","379","515","10","904","1970","0","45.89","19.24"
"68","000","00","010","0039","0231","493","201","292","6","499","1010","0","49.41","19.90"
"68","000","00","010","0039","0232","401","178","223","4","405","960","0","42.19","18.54"
"68","000","00","010","0040","0000","2461","1088","1373","15","2476","5681","0","43.58","19.15"
"68","000","00","010","0040","0032","582","251","331","5","587","1321","0","44.44","19.00"
"68","000","00","010","0040","0033","609","256","353","6","615","1458","0","42.18","17.56"
"68","000","00","010","0040","0034","706","288","418","4","710","1543","0","46.01","18.66"
"68","000","00","010","0040","0035","564","293","271","0","564","1359","0","41.50","21.56"
"68","000","00","010","0041","0000","2835","1367","1468","18","2853","6243","0","45.70","21.90"
"68","000","00","010","0041","0027","728","365","363","7","735","1654","0","44.44","22.07"
"68","000","00","010","0041","0028","711","346","365","3","714","1620","0","44.07","21.36"
"68","000","00","010","0041","0029","657","319","338","3","660","1478","0","44.65","21.58"
"68","000","00","010","0041","0030","739","337","402","5","744","1491","0","49.90","22.60"
"68","000","00","010","0042","0000","2215","1106","1109","30","2245","5129","0","43.77","21.56"
"68","000","00","010","0042","0012","559","280","279","9","568","1282","0","44.31","21.84"
"68","000","00","010","0042","0013","600","285","315","8","608","1393","0","43.65","20.46"
"68","000","00","010","0042","0014","513","281","232","5","518","1225","0","42.29","22.94"
"68","000","00","010","0042","0015","543","260","283","8","551","1229","0","44.83","21.16"
"68","000","00","010","0043","0000","2042","953","1089","15","2057","4911","0","41.89","19.41"
"68","000","00","010","0043","0009","723","358","365","6","729","1811","0","40.25","19.77"
"68","000","00","010","0043","0010","652","294","358","6","658","1554","0","42.34","18.92"
"68","000","00","010","0043","0011","667","301","366","3","670","1546","0","43.34","19.47"
"68","000","00","010","0044","0000","1751","869","882","16","1767","4122","0","42.87","21.08"
"68","000","00","010","0044","0020","541","295","246","3","544","1284","0","42.37","22.98"
"68","000","00","010","0044","0021","520","251","269","8","528","1373","0","38.46","18.28"
"68","000","00","010","0044","0022","690","323","367","5","695","1465","0","47.44","22.05"
"68","000","00","010","0045","0000","1968","1106","862","15","1983","4162","0","47.65","26.57"
"68","000","00","010","0045","0199","646","358","288","3","649","1412","0","45.96","25.35"
"68","000","00","010","0045","0200","709","400","309","7","716","1371","0","52.22","29.18"
"68","000","00","010","0045","0201","613","348","265","5","618","1379","0","44.82","25.24"
"68","000","00","010","0046","0000","1989","901","1088","13","2002","5398","0","37.09","16.69"
"68","000","00","010","0046","0209","610","272","338","4","614","1776","0","34.57","15.32"
"68","000","00","010","0046","0210","685","301","384","4","689","1801","0","38.26","16.71"
"68","000","00","010","0046","0211","694","328","366","5","699","1821","0","38.39","18.01"
"68","000","00","010","0047","0000","2236","1034","1202","28","2264","6093","0","37.16","16.97"
"68","000","00","010","0047","0227","591","285","306","5","596","1510","0","39.47","18.87"
"68","000","00","010","0047","0228","559","250","309","10","569","1429","0","39.82","17.49"
"68","000","00","010","0047","0229","573","245","328","8","581","1537","0","37.80","15.94"
"68","000","00","010","0047","0230","513","254","259","5","518","1617","0","32.03","15.71"
"68","000","00","010","0048","0000","2773","1235","1538","24","2797","6914","0","40.45","17.86"
"68","000","00","010","0048","0160","536","196","340","4","540","1304","0","41.41","15.03"
"68","000","00","010","0048","0161","471","224","247","2","473","1299","0","36.41","17.24"
"68","000","00","010","0048","0162","564","238","326","10","574","1385","0","41.44","17.18"
"68","000","00","010","0048","0163","608","271","337","2","610","1554","0","39.25","17.44"
"68","000","00","010","0048","0164","594","306","288","6","600","1372","0","43.73","22.30"
"68","000","00","010","0049","0000","2408","1297","1111","18","2426","6089","0","39.84","21.30"
"68","000","00","010","0049","0124","607","300","307","7","614","1473","0","41.68","20.37"
"68","000","00","010","0049","0125","621","319","302","6","627","1457","0","43.03","21.89"
"68","000","00","010","0049","0126","563","335","228","1","564","1674","0","33.69","20.01"
"68","000","00","010","0049","0127","617","343","274","4","621","1485","0","41.82","23.10"
"68","000","00","010","0050","0000","3882","1926","1956","25","3907","9540","0","40.95","20.19"
"68","000","00","010","0050","0134","780","403","377","8","788","1817","0","43.37","22.18"
"68","000","00","010","0050","0135","719","329","390","3","722","1956","0","36.91","16.82"
"68","000","00","010","0050","0136","810","414","396","6","816","1892","0","43.13","21.88"
"68","000","00","010","0050","0137","900","444","456","5","905","2195","0","41.23","20.23"
"68","000","00","010","0050","0138","673","336","337","3","676","1680","0","40.24","20.00"
"68","000","00","010","0051","0000","3702","2094","1608","27","3729","8779","0","42.48","23.85"
"68","000","00","010","0051","0168","712","401","311","6","718","1689","0","42.51","23.74"
"68","000","00","010","0051","0169","791","423","368","6","797","1772","0","44.98","23.87"
"68","000","00","010","0051","0170","679","355","324","5","684","1766","0","38.73","20.10"
"68","000","00","010","0051","0171","777","442","335","6","783","1837","0","42.62","24.06"
"68","000","00","010","0051","0172","743","473","270","4","747","1715","0","43.56","27.58"
"68","000","00","010","0052","0000","1764","878","886","13","1777","3991","0","44.53","22.00"
"68","000","00","010","0052","0090","813","373","440","7","820","1990","0","41.21","18.74"
"68","000","00","010","0052","0091","951","505","446","6","957","2001","0","47.83","25.24"
"68","000","00","010","0053","0000","1630","831","799","22","1652","3653","0","45.22","22.75"
"68","000","00","010","0053","0096","537","290","247","7","544","1225","0","44.41","23.67"
"68","000","00","010","0053","0097","596","292","304","6","602","1294","0","46.52","22.57"
"68","000","00","010","0053","0098","497","249","248","9","506","1134","0","44.62","21.96"
"68","000","00","010","0054","0000","1597","818","779","23","1620","3883","0","41.72","21.07"
"68","000","00","010","0054","0083","576","290","286","7","583","1263","0","46.16","22.96"
"68","000","00","010","0054","0084","476","244","232","8","484","1258","0","38.47","19.40"
"68","000","00","010","0054","0085","545","284","261","8","553","1362","0","40.60","20.85"
"68","000","00","010","0055","0000","2675","1318","1357","22","2697","6452","0","41.80","20.43"
"68","000","00","010","0055","0086","661","333","328","7","668","1637","0","40.81","20.34"
"68","000","00","010","0055","0087","596","310","286","5","601","1439","0","41.77","21.54"
"68","000","00","010","0055","0088","750","293","457","6","756","1571","0","48.12","18.65"
"68","000","00","010","0055","0089","668","382","286","4","672","1805","0","37.23","21.16"
"68","000","00","010","0056","0000","1821","1043","778","16","1837","4939","0","37.19","21.12"
"68","000","00","010","0056","0110","600","340","260","4","604","1619","0","37.31","21.00"
"68","000","00","010","0056","0111","578","332","246","5","583","1625","0","35.88","20.43"
"68","000","00","010","0056","0112","643","371","272","7","650","1695","0","38.35","21.89"
"68","000","00","010","0057","0000","2394","1316","1078","20","2414","6433","0","37.53","20.46"
"68","000","00","010","0057","0202","572","317","255","8","580","1570","0","36.94","20.19"
"68","000","00","010","0057","0203","564","323","241","9","573","1596","0","35.90","20.24"
"68","000","00","010","0057","0204","638","367","271","2","640","1631","0","39.24","22.50"
"68","000","00","010","0057","0205","620","309","311","1","621","1636","0","37.96","18.89"
"68","000","00","010","0058","0000","3153","1666","1487","26","3179","8491","0","37.44","19.62"
"68","000","00","010","0058","0243","586","302","284","5","591","1547","0","38.20","19.52"
"68","000","00","010","0058","0244","526","258","268","2","528","1359","0","38.85","18.98"
"68","000","00","010","0058","0245","501","269","232","4","505","1427","0","35.39","18.85"
"68","000","00","010","0058","0246","547","309","238","4","551","1709","0","32.24","18.08"
"68","000","00","010","0058","0247","561","309","252","7","568","1318","0","43.10","23.44"
"68","000","00","010","0058","0248","432","219","213","4","436","1131","0","38.55","19.36"
"68","000","00","010","0059","0000","2979","1583","1396","21","3000","9776","0","30.69","16.19"
"68","000","00","010","0059","0117","647","346","301","2","649","1561","0","41.58","22.17"
"68","000","00","010","0059","0118","482","239","243","4","486","3546","0","13.71","6.74"
"68","000","00","010","0059","0119","639","351","288","3","642","1647","0","38.98","21.31"
"68","000","00","010","0059","0120","567","297","270","5","572","1477","0","38.73","20.11"
"68","000","00","010","0059","0121","644","350","294","7","651","1545","0","42.14","22.65"
"68","000","00","010","0060","0000","2100","1089","1011","17","2117","5408","0","39.15","20.14"
"68","000","00","010","0060","0102","544","255","289","4","548","1283","0","42.71","19.88"
"68","000","00","010","0060","0103","576","272","304","6","582","1448","0","40.19","18.78"
"68","000","00","010","0060","0104","512","292","220","4","516","1323","0","39.00","22.07"
"68","000","00","010","0060","0105","468","270","198","3","471","1354","0","34.79","19.94"
"68","000","00","010","0061","0000","3216","1693","1523","40","3256","7355","0","44.27","23.02"
"68","000","00","010","0061","0143","755","407","348","11","766","1721","0","44.51","23.65"
"68","000","00","010","0061","0144","587","303","284","10","597","1489","0","40.09","20.35"
"68","000","00","010","0061","0145","598","285","313","8","606","1401","0","43.25","20.34"
"68","000","00","010","0061","0146","600","323","277","6","606","1288","0","47.05","25.08"
"68","000","00","010","0061","0147","676","375","301","5","681","1456","0","46.77","25.76"
"68","000","00","010","0062","0000","2208","1131","1077","18","2226","5612","0","39.67","20.15"
"68","000","00","010","0062","0069","600","306","294","3","603","1319","0","45.72","23.20"
"68","000","00","010","0062","0070","568","283","285","3","571","1436","0","39.76","19.71"
"68","000","00","010","0062","0071","545","271","274","7","552","1426","0","38.71","19.00"
"68","000","00","010","0062","0072","495","271","224","5","500","1431","0","34.94","18.94"
"68","000","00","010","0063","0000","2201","1003","1198","9","2210","4931","0","44.82","20.34"
"68","000","00","010","0063","0157","773","355","418","5","778","1686","0","46.14","21.06"
"68","000","00","010","0063","0158","593","256","337","3","596","1351","0","44.12","18.95"
"68","000","00","010","0063","0159","835","392","443","1","836","1894","0","44.14","20.70"
"68","000","00","010","0064","0000","1955","1008","947","17","1972","4612","0","42.76","21.86"
"68","000","00","010","0064","0058","689","381","308","6","695","1749","0","39.74","21.78"
"68","000","00","010","0064","0059","705","367","338","5","710","1615","0","43.96","22.72"
"68","000","00","010","0064","0060","561","260","301","6","567","1248","0","45.43","20.83"
"68","000","00","010","0065","0000","2015","1090","925","18","2033","4570","0","44.49","23.85"
"68","000","00","010","0065","0073","674","365","309","4","678","1613","0","42.03","22.63"
"68","000","00","010","0065","0074","744","413","331","2","746","1562","0","47.76","26.44"
"68","000","00","010","0065","0075","597","312","285","12","609","1395","0","43.66","22.37"
"68","000","00","010","0066","0000","1826","1021","805","16","1842","4145","0","44.44","24.63"
"68","000","00","010","0066","0076","659","376","283","3","662","1502","0","44.07","25.03"
"68","000","00","010","0066","0077","533","294","239","6","539","1338","0","40.28","21.97"
"68","000","00","010","0066","0078","634","351","283","7","641","1305","0","49.12","26.90"
"68","000","00","010","0067","0000","2094","986","1108","24","2118","4872","0","43.47","20.24"
"68","000","00","010","0067","0165","713","320","393","9","722","1649","0","43.78","19.41"
"68","000","00","010","0067","0166","712","329","383","8","720","1602","0","44.94","20.54"
"68","000","00","010","0067","0167","669","337","332","7","676","1621","0","41.70","20.79"
"68","000","00","010","0068","0000","2560","1360","1200","24","2584","6169","0","41.89","22.05"
"68","000","00","010","0068","0192","655","332","323","6","661","1510","0","43.77","21.99"
"68","000","00","010","0068","0193","718","389","329","8","726","1652","0","43.95","23.55"
"68","000","00","010","0068","0194","650","355","295","4","654","1639","0","39.90","21.66"
"68","000","00","010","0068","0195","537","284","253","6","543","1368","0","39.69","20.76"
"68","000","00","010","0069","0000","1907","993","914","23","1930","4734","0","40.77","20.98"
"68","000","00","010","0069","0128","619","287","332","9","628","1573","0","39.92","18.25"
"68","000","00","010","0069","0129","656","384","272","6","662","1571","0","42.14","24.44"
"68","000","00","010","0069","0130","632","322","310","8","640","1590","0","40.25","20.25"
"68","000","00","010","0070","0000","2309","1352","957","21","2330","5481","0","42.51","24.67"
"68","000","00","010","0070","0079","503","324","179","5","508","1388","0","36.60","23.34"
"68","000","00","010","0070","0080","539","309","230","3","542","1281","0","42.31","24.12"
"68","000","00","010","0070","0081","588","322","266","7","595","1429","0","41.64","22.53"
"68","000","00","010","0070","0082","679","397","282","6","685","1383","0","49.53","28.71"
"68","000","00","010","0071","0000","2468","1217","1251","21","2489","6540","0","38.06","18.61"
"68","000","00","010","0071","0113","658","346","312","5","663","1601","0","41.41","21.61"
"68","000","00","010","0071","0114","618","283","335","5","623","1641","0","37.96","17.25"
"68","000","00","010","0071","0115","587","263","324","5","592","1685","0","35.13","15.61"
"68","000","00","010","0071","0116","605","325","280","6","611","1613","0","37.88","20.15"
"68","000","00","010","0072","0000","2582","1405","1177","22","2604","6061","0","42.96","23.18"
"68","000","00","010","0072","0139","650","362","288","1","651","1564","0","41.62","23.15"
"68","000","00","010","0072","0140","671","355","316","9","680","1538","0","44.21","23.08"
"68","000","00","010","0072","0141","624","333","291","6","630","1490","0","42.28","22.35"
"68","000","00","010","0072","0142","637","355","282","6","643","1469","0","43.77","24.17"
"68","000","00","010","0073","0000","1445","760","685","13","1458","3179","0","45.86","23.91"
"68","000","00","010","0073","0150","606","320","286","4","610","1412","0","43.20","22.66"
"68","000","00","010","0073","0151","839","440","399","9","848","1767","0","47.99","24.90"
"68","000","00","010","0074","0000","3086","1637","1449","31","3117","8113","0","38.42","20.18"
"68","000","00","010","0074","0187","610","321","289","7","617","1563","0","39.48","20.54"
"68","000","00","010","0074","0188","545","280","265","7","552","1624","0","33.99","17.24"
"68","000","00","010","0074","0189","620","332","288","4","624","1546","0","40.36","21.47"
"68","000","00","010","0074","0190","654","337","317","7","661","1637","0","40.38","20.59"
"68","000","00","010","0074","0191","657","367","290","6","663","1743","0","38.04","21.06"
"68","000","00","010","0075","0000","2261","1175","1086","16","2277","5936","0","38.36","19.79"
"68","000","00","010","0075","0183","519","253","266","4","523","1567","0","33.38","16.15"
"68","000","00","010","0075","0184","628","336","292","6","634","1483","0","42.75","22.66"
"68","000","00","010","0075","0185","590","318","272","5","595","1486","0","40.04","21.40"
"68","000","00","010","0075","0186","524","268","256","1","525","1400","0","37.50","19.14"
"68","000","00","010","0076","0000","1531","780","751","12","1543","3791","0","40.70","20.58"
"68","000","00","010","0076","0196","560","263","297","4","564","1360","0","41.47","19.34"
"68","000","00","010","0076","0197","438","218","220","4","442","1109","0","39.86","19.66"
"68","000","00","010","0076","0198","533","299","234","4","537","1322","0","40.62","22.62"
"68","000","00","010","0077","0000","1496","688","808","7","1503","3881","0","38.73","17.73"
"68","000","00","010","0077","0006","542","230","312","1","543","1445","0","37.58","15.92"
"68","000","00","010","0077","0007","486","220","266","3","489","1245","0","39.28","17.67"
"68","000","00","010","0077","0008","468","238","230","3","471","1191","0","39.55","19.98"
"68","000","00","010","0078","0000","1995","1022","973","22","2017","5006","0","40.29","20.42"
"68","000","00","010","0078","0206","746","368","378","7","753","1727","0","43.60","21.31"
"68","000","00","010","0078","0207","643","337","306","8","651","1658","0","39.26","20.33"
"68","000","00","010","0078","0208","606","317","289","7","613","1621","0","37.82","19.56"
"68","000","00","010","0079","0000","1829","945","884","10","1839","4546","0","40.45","20.79"
"68","000","00","010","0079","0240","584","314","270","4","588","1367","0","43.01","22.97"
"68","000","00","010","0079","0241","716","344","372","4","720","1804","0","39.91","19.07"
"68","000","00","010","0079","0242","529","287","242","2","531","1375","0","38.62","20.87"
"68","000","00","020","0000","0000","143036","80175","62861","1232","144268","347023","422582","41.57","23.10"
"68","000","00","020","0001","0000","1278","969","309","20","1298","2898","0","44.79","33.44"
"68","000","00","020","0001","0712","651","514","137","11","662","1343","0","49.29","38.27"
"68","000","00","020","0001","0713","627","455","172","9","636","1555","0","40.90","29.26"
"68","000","00","020","0002","0000","2249","1420","829","20","2269","5428","0","41.80","26.16"
"68","000","00","020","0002","0708","682","431","251","5","687","1406","0","48.86","30.65"
"68","000","00","020","0002","0709","478","309","169","2","480","1263","0","38.00","24.47"
"68","000","00","020","0002","0710","558","360","198","6","564","1382","0","40.81","26.05"
"68","000","00","020","0002","0711","531","320","211","7","538","1377","0","39.07","23.24"
"68","000","00","020","0003","0000","1274","807","467","19","1293","3064","0","42.20","26.34"
"68","000","00","020","0003","0755","649","389","260","11","660","1595","0","41.38","24.39"
"68","000","00","020","0003","0756","625","418","207","8","633","1469","0","43.09","28.45"
"68","000","00","020","0004","0000","392","197","195","4","396","914","0","43.33","21.55"
"68","000","00","020","0004","0881","392","197","195","4","396","914","0","43.33","21.55"
"68","000","00","020","0005","0000","912","550","362","12","924","2196","0","42.08","25.05"
"68","000","00","020","0005","0793","451","248","203","4","455","1093","0","41.63","22.69"
"68","000","00","020","0005","0794","461","302","159","8","469","1103","0","42.52","27.38"
"68","000","00","020","0006","0000","1744","1013","731","16","1760","4380","0","40.18","23.13"
"68","000","00","020","0006","0795","640","369","271","6","646","1563","0","41.33","23.61"
"68","000","00","020","0006","0796","526","293","233","3","529","1513","0","34.96","19.37"
"68","000","00","020","0006","0797","578","351","227","7","585","1304","0","44.86","26.92"
"68","000","00","020","0007","0000","2377","1320","1057","29","2406","5320","0","45.23","24.81"
"68","000","00","020","0007","0889","638","362","276","10","648","1498","0","43.26","24.17"
"68","000","00","020","0007","0890","460","234","226","5","465","1022","0","45.50","22.90"
"68","000","00","020","0007","0891","630","352","278","6","636","1398","0","45.49","25.18"
"68","000","00","020","0007","0892","649","372","277","8","657","1402","0","46.86","26.53"
"68","000","00","020","0008","0000","2332","1909","423","26","2358","5087","0","46.35","37.53"
"68","000","00","020","0008","0781","587","506","81","5","592","1239","0","47.78","40.84"
"68","000","00","020","0008","0782","591","500","91","6","597","1242","0","48.07","40.26"
"68","000","00","020","0008","0783","634","511","123","6","640","1313","0","48.74","38.92"
"68","000","00","020","0008","0784","520","392","128","9","529","1293","0","40.91","30.32"
"68","000","00","020","0009","0000","1529","1002","527","11","1540","3497","0","44.04","28.65"
"68","000","00","020","0009","0777","741","474","267","5","746","1642","0","45.43","28.87"
"68","000","00","020","0009","0778","788","528","260","6","794","1855","0","42.80","28.46"
"68","000","00","020","0010","0000","1509","977","532","9","1518","3778","0","40.18","25.86"
"68","000","00","020","0010","0764","598","374","224","3","601","1453","0","41.36","25.74"
"68","000","00","020","0010","0765","324","215","109","4","328","803","0","40.85","26.77"
"68","000","00","020","0010","0766","587","388","199","2","589","1522","0","38.70","25.49"
"68","000","00","020","0011","0000","1784","977","807","19","1803","4305","0","41.88","22.69"
"68","000","00","020","0011","0696","517","291","226","0","517","1243","0","41.59","23.41"
"68","000","00","020","0011","0697","628","342","286","12","640","1469","0","43.57","23.28"
"68","000","00","020","0011","0698","639","344","295","7","646","1593","0","40.55","21.59"
"68","000","00","020","0012","0000","2208","1310","898","12","2220","5566","0","39.89","23.54"
"68","000","00","020","0012","0714","745","478","267","4","749","1853","0","40.42","25.80"
"68","000","00","020","0012","0715","438","256","182","6","444","1229","0","36.13","20.83"
"68","000","00","020","0012","0716","451","271","180","1","452","1105","0","40.90","24.52"
"68","000","00","020","0012","0717","574","305","269","1","575","1379","0","41.70","22.12"
"68","000","00","020","0013","0000","1295","718","577","7","1302","3006","0","43.31","23.89"
"68","000","00","020","0013","0753","650","360","290","3","653","1507","0","43.33","23.89"
"68","000","00","020","0013","0754","645","358","287","4","649","1499","0","43.30","23.88"
"68","000","00","020","0014","0000","981","509","472","6","987","2310","0","42.73","22.03"
"68","000","00","020","0014","0871","423","189","234","4","427","1114","0","38.33","16.97"
"68","000","00","020","0014","0872","558","320","238","2","560","1196","0","46.82","26.76"
"68","000","00","020","0015","0000","1637","852","785","10","1647","3407","0","48.34","25.01"
"68","000","00","020","0015","0830","670","368","302","0","670","1408","0","47.59","26.14"
"68","000","00","020","0015","0831","498","257","241","6","504","1042","0","48.37","24.66"
"68","000","00","020","0015","0832","469","227","242","4","473","957","0","49.43","23.72"
"68","000","00","020","0016","0000","1618","914","704","11","1629","4240","0","38.42","21.56"
"68","000","00","020","0016","0724","569","313","256","5","574","1395","0","41.15","22.44"
"68","000","00","020","0016","0725","525","289","236","2","527","1420","0","37.11","20.35"
"68","000","00","020","0016","0726","524","312","212","4","528","1425","0","37.05","21.89"
"68","000","00","020","0017","0000","1724","989","735","24","1748","5599","0","31.22","17.66"
"68","000","00","020","0017","0740","595","334","261","10","605","1175","0","51.49","28.43"
"68","000","00","020","0017","0741","565","323","242","9","574","1204","0","47.67","26.83"
"68","000","00","020","0017","0742","564","332","232","5","569","3220","0","17.67","10.31"
"68","000","00","020","0018","0000","1578","857","721","9","1587","3943","0","40.25","21.73"
"68","000","00","020","0018","0748","513","271","242","4","517","1519","0","34.04","17.84"
"68","000","00","020","0018","0749","588","303","285","3","591","1316","0","44.91","23.02"
"68","000","00","020","0018","0750","477","283","194","2","479","1108","0","43.23","25.54"
"68","000","00","020","0019","0000","1985","1237","748","14","1999","5241","0","38.14","23.60"
"68","000","00","020","0019","0769","558","342","216","3","561","1661","0","33.77","20.59"
"68","000","00","020","0019","0770","687","426","261","6","693","1781","0","38.91","23.92"
"68","000","00","020","0019","0771","740","469","271","5","745","1799","0","41.41","26.07"
"68","000","00","020","0020","0000","1277","744","533","9","1286","3393","0","37.90","21.93"
"68","000","00","020","0020","0767","669","377","292","5","674","1721","0","39.16","21.91"
"68","000","00","020","0020","0768","608","367","241","4","612","1672","0","36.60","21.95"
"68","000","00","020","0021","0000","1474","761","713","21","1495","3315","0","45.10","22.96"
"68","000","00","020","0021","0842","681","360","321","11","692","1653","0","41.86","21.78"
"68","000","00","020","0021","0843","793","401","392","10","803","1662","0","48.32","24.13"
"68","000","00","020","0022","0000","2801","1359","1442","26","2827","6960","0","40.62","19.53"
"68","000","00","020","0022","0909","648","246","402","7","655","1850","0","35.41","13.30"
"68","000","00","020","0022","0910","804","411","393","6","810","1830","0","44.26","22.46"
"68","000","00","020","0022","0911","714","361","353","7","721","1657","0","43.51","21.79"
"68","000","00","020","0022","0912","635","341","294","6","641","1623","0","39.49","21.01"
"68","000","00","020","0023","0000","1002","572","430","8","1010","2660","0","37.97","21.50"
"68","000","00","020","0023","0775","457","261","196","3","460","1295","0","35.52","20.15"
"68","000","00","020","0023","0776","545","311","234","5","550","1365","0","40.29","22.78"
"68","000","00","020","0024","0000","1580","725","855","12","1592","3765","0","42.28","19.26"
"68","000","00","020","0024","0886","524","219","305","6","530","1251","0","42.37","17.51"
"68","000","00","020","0024","0887","511","224","287","3","514","1200","0","42.83","18.67"
"68","000","00","020","0024","0888","545","282","263","3","548","1314","0","41.70","21.46"
"68","000","00","020","0025","0000","1543","839","704","11","1554","3646","0","42.62","23.01"
"68","000","00","020","0025","0833","782","443","339","8","790","1804","0","43.79","24.56"
"68","000","00","020","0025","0834","761","396","365","3","764","1842","0","41.48","21.50"
"68","000","00","020","0026","0000","1561","845","716","7","1568","3654","0","42.91","23.13"
"68","000","00","020","0026","0800","542","238","304","0","542","1182","0","45.85","20.14"
"68","000","00","020","0026","0801","504","285","219","4","508","1242","0","40.90","22.95"
"68","000","00","020","0026","0802","515","322","193","3","518","1230","0","42.11","26.18"
"68","000","00","020","0027","0000","2456","1091","1365","16","2472","6882","0","35.92","15.85"
"68","000","00","020","0027","0824","440","185","255","3","443","1216","0","36.43","15.21"
"68","000","00","020","0027","0825","441","204","237","4","445","1212","0","36.72","16.83"
"68","000","00","020","0027","0826","540","229","311","1","541","1547","0","34.97","14.80"
"68","000","00","020","0027","0827","547","241","306","2","549","1629","0","33.70","14.79"
"68","000","00","020","0027","0828","488","232","256","6","494","1278","0","38.65","18.15"
"68","000","00","020","0028","0000","293","146","147","2","295","674","0","43.77","21.66"
"68","000","00","020","0028","0882","293","146","147","2","295","674","0","43.77","21.66"
"68","000","00","020","0029","0000","1997","1314","683","24","2021","4607","0","43.87","28.52"
"68","000","00","020","0029","0702","693","444","249","3","696","1627","0","42.78","27.29"
"68","000","00","020","0029","0703","656","433","223","13","669","1481","0","45.17","29.24"
"68","000","00","020","0029","0704","648","437","211","8","656","1499","0","43.76","29.15"
"68","000","00","020","0030","0000","1057","699","358","15","1072","2813","0","38.11","24.85"
"68","000","00","020","0030","0759","572","370","202","9","581","1530","0","37.97","24.18"
"68","000","00","020","0030","0760","485","329","156","6","491","1283","0","38.27","25.64"
"68","000","00","020","0031","0000","1503","725","778","12","1515","3634","0","41.69","19.95"
"68","000","00","020","0031","0847","438","156","282","5","443","1095","0","40.46","14.25"
"68","000","00","020","0031","0848","577","293","284","4","581","1340","0","43.36","21.87"
"68","000","00","020","0031","0849","488","276","212","3","491","1199","0","40.95","23.02"
"68","000","00","020","0032","0000","2629","1314","1315","16","2645","6486","0","40.78","20.26"
"68","000","00","020","0032","0867","678","327","351","3","681","1738","0","39.18","18.81"
"68","000","00","020","0032","0868","652","320","332","4","656","1632","0","40.20","19.61"
"68","000","00","020","0032","0869","735","374","361","5","740","1800","0","41.11","20.78"
"68","000","00","020","0032","0870","564","293","271","4","568","1316","0","43.16","22.26"
"68","000","00","020","0033","0000","3482","1922","1560","28","3510","9665","0","36.32","19.89"
"68","000","00","020","0033","0806","568","357","211","10","578","1504","0","38.43","23.74"
"68","000","00","020","0033","0807","558","333","225","3","561","1533","0","36.59","21.72"
"68","000","00","020","0033","0808","676","324","352","6","682","1820","0","37.47","17.80"
"68","000","00","020","0033","0809","587","294","293","2","589","1796","0","32.80","16.37"
"68","000","00","020","0033","0810","560","327","233","3","563","1562","0","36.04","20.93"
"68","000","00","020","0033","0811","533","287","246","4","537","1450","0","37.03","19.79"
"68","000","00","020","0034","0000","3401","1750","1651","20","3421","8837","0","38.71","19.80"
"68","000","00","020","0034","0816","508","256","252","2","510","1257","0","40.57","20.37"
"68","000","00","020","0034","0817","446","226","220","7","453","1221","0","37.10","18.51"
"68","000","00","020","0034","0818","504","241","263","1","505","1255","0","40.24","19.20"
"68","000","00","020","0034","0819","563","317","246","3","566","1522","0","37.19","20.83"
"68","000","00","020","0034","0820","673","329","344","4","677","1765","0","38.36","18.64"
"68","000","00","020","0034","0821","707","381","326","3","710","1817","0","39.08","20.97"
"68","000","00","020","0035","0000","854","393","461","9","863","1888","0","45.71","20.82"
"68","000","00","020","0035","0875","396","171","225","5","401","952","0","42.12","17.96"
"68","000","00","020","0035","0876","458","222","236","4","462","936","0","49.36","23.72"
"68","000","00","020","0036","0000","3161","1682","1479","27","3188","7822","0","40.76","21.50"
"68","000","00","020","0036","0853","508","236","272","2","510","1203","0","42.39","19.62"
"68","000","00","020","0036","0854","414","205","209","2","416","1109","0","37.51","18.49"
"68","000","00","020","0036","0855","564","333","231","8","572","1129","0","50.66","29.50"
"68","000","00","020","0036","0856","517","251","266","3","520","1336","0","38.92","18.79"
"68","000","00","020","0036","0857","584","320","264","8","592","1390","0","42.59","23.02"
"68","000","00","020","0036","0858","574","337","237","4","578","1655","0","34.92","20.36"
"68","000","00","020","0037","0000","1981","1117","864","10","1991","4334","0","45.94","25.77"
"68","000","00","020","0037","0734","652","348","304","4","656","1346","0","48.74","25.85"
"68","000","00","020","0037","0735","683","392","291","2","685","1428","0","47.97","27.45"
"68","000","00","020","0037","0736","646","377","269","4","650","1560","0","41.67","24.17"
"68","000","00","020","0038","0000","702","323","379","5","707","1585","0","44.61","20.38"
"68","000","00","020","0038","0829","702","323","379","5","707","1585","0","44.61","20.38"
"68","000","00","020","0039","0000","2062","1563","499","21","2083","4952","0","42.06","31.56"
"68","000","00","020","0039","0705","659","481","178","8","667","1661","0","40.16","28.96"
"68","000","00","020","0039","0706","686","541","145","7","693","1566","0","44.25","34.55"
"68","000","00","020","0039","0707","717","541","176","6","723","1725","0","41.91","31.36"
"68","000","00","020","0040","0000","449","183","266","2","451","991","0","45.51","18.47"
"68","000","00","020","0040","0884","449","183","266","2","451","991","0","45.51","18.47"
"68","000","00","020","0041","0000","1273","726","547","19","1292","3012","0","42.90","24.10"
"68","000","00","020","0041","0873","621","315","306","9","630","1395","0","45.16","22.58"
"68","000","00","020","0041","0874","652","411","241","10","662","1617","0","40.94","25.42"
"68","000","00","020","0042","0000","1831","1035","796","16","1847","4849","0","38.09","21.34"
"68","000","00","020","0042","0685","643","369","274","4","647","1542","0","41.96","23.93"
"68","000","00","020","0042","0686","560","305","255","9","569","1500","0","37.93","20.33"
"68","000","00","020","0042","0687","628","361","267","3","631","1807","0","34.92","19.98"
"68","000","00","020","0043","0000","3004","1397","1607","33","3037","7935","0","38.27","17.61"
"68","000","00","020","0043","0923","668","271","397","11","679","1535","0","44.23","17.65"
"68","000","00","020","0043","0924","556","268","288","8","564","1413","0","39.92","18.97"
"68","000","00","020","0043","0925","538","232","306","5","543","1432","0","37.92","16.20"
"68","000","00","020","0043","0926","613","319","294","4","617","1715","0","35.98","18.60"
"68","000","00","020","0043","0927","629","307","322","5","634","1840","0","34.46","16.68"
"68","000","00","020","0044","0000","2551","1244","1307","23","2574","6137","0","41.94","20.27"
"68","000","00","020","0044","0899","565","266","299","9","574","1392","0","41.24","19.11"
"68","000","00","020","0044","0900","649","283","366","4","653","1577","0","41.41","17.95"
"68","000","00","020","0044","0901","576","304","272","4","580","1466","0","39.56","20.74"
"68","000","00","020","0044","0902","761","391","370","6","767","1702","0","45.06","22.97"
"68","000","00","020","0045","0000","702","311","391","11","713","1460","0","48.84","21.30"
"68","000","00","020","0045","0885","702","311","391","11","713","1460","0","48.84","21.30"
"68","000","00","020","0046","0000","1710","708","1002","15","1725","4196","0","41.11","16.87"
"68","000","00","020","0046","0906","593","211","382","5","598","1413","0","42.32","14.93"
"68","000","00","020","0046","0907","574","199","375","5","579","1297","0","44.64","15.34"
"68","000","00","020","0046","0908","543","298","245","5","548","1486","0","36.88","20.05"
"68","000","00","020","0047","0000","2094","705","1389","26","2120","5631","0","37.65","12.52"
"68","000","00","020","0047","0916","592","227","365","9","601","1509","0","39.83","15.04"
"68","000","00","020","0047","0917","456","159","297","12","468","1374","0","34.06","11.57"
"68","000","00","020","0047","0918","607","181","426","3","610","1589","0","38.39","11.39"
"68","000","00","020","0047","0919","439","138","301","2","441","1159","0","38.05","11.91"
"68","000","00","020","0048","0000","1268","548","720","8","1276","3254","0","39.21","16.84"
"68","000","00","020","0048","0897","622","268","354","5","627","1591","0","39.41","16.84"
"68","000","00","020","0048","0898","646","280","366","3","649","1663","0","39.03","16.84"
"68","000","00","020","0049","0000","1473","470","1003","15","1488","3746","0","39.72","12.55"
"68","000","00","020","0049","0920","491","172","319","3","494","1266","0","39.02","13.59"
"68","000","00","020","0049","0921","511","160","351","6","517","1248","0","41.43","12.82"
"68","000","00","020","0049","0922","471","138","333","6","477","1232","0","38.72","11.20"
"68","000","00","020","0050","0000","381","175","206","5","386","827","0","46.67","21.16"
"68","000","00","020","0050","0883","381","175","206","5","386","827","0","46.67","21.16"
"68","000","00","020","0051","0000","2045","852","1193","15","2060","4787","0","43.03","17.80"
"68","000","00","020","0051","0913","699","295","404","7","706","1738","0","40.62","16.97"
"68","000","00","020","0051","0914","598","240","358","1","599","1429","0","41.92","16.79"
"68","000","00","020","0051","0915","748","317","431","7","755","1620","0","46.60","19.57"
"68","000","00","020","0052","0000","2097","1205","892","22","2119","4813","0","44.03","25.04"
"68","000","00","020","0052","0838","549","322","227","4","553","1234","0","44.81","26.09"
"68","000","00","020","0052","0839","537","308","229","4","541","1296","0","41.74","23.77"
"68","000","00","020","0052","0840","533","324","209","10","543","1221","0","44.47","26.54"
"68","000","00","020","0052","0841","478","251","227","4","482","1062","0","45.39","23.63"
"68","000","00","020","0053","0000","1147","666","481","7","1154","2583","0","44.68","25.78"
"68","000","00","020","0053","0732","558","322","236","4","562","1298","0","43.30","24.81"
"68","000","00","020","0053","0733","589","344","245","3","592","1285","0","46.07","26.77"
"68","000","00","020","0054","0000","1226","542","684","9","1235","2700","0","45.74","20.07"
"68","000","00","020","0054","0879","425","156","269","4","429","1018","0","42.14","15.32"
"68","000","00","020","0054","0880","801","386","415","5","806","1682","0","47.92","22.95"
"68","000","00","020","0055","0000","2218","1114","1104","17","2235","5435","0","41.12","20.50"
"68","000","00","020","0055","0893","514","209","305","5","519","1332","0","38.96","15.69"
"68","000","00","020","0055","0894","703","390","313","3","706","1491","0","47.35","26.16"
"68","000","00","020","0055","0895","505","243","262","6","511","1215","0","42.06","20.00"
"68","000","00","020","0055","0896","496","272","224","3","499","1397","0","35.72","19.47"
"68","000","00","020","0056","0000","2226","1217","1009","19","2245","5563","0","40.36","21.88"
"68","000","00","020","0056","0812","506","274","232","4","510","1314","0","38.81","20.85"
"68","000","00","020","0056","0813","658","343","315","3","661","1492","0","44.30","22.99"
"68","000","00","020","0056","0814","404","222","182","2","406","1218","0","33.33","18.23"
"68","000","00","020","0056","0815","658","378","280","10","668","1539","0","43.40","24.56"
"68","000","00","020","0057","0000","1866","1056","810","21","1887","4591","0","41.10","23.00"
"68","000","00","020","0057","0803","735","389","346","7","742","1613","0","46.00","24.12"
"68","000","00","020","0057","0804","510","289","221","8","518","1432","0","36.17","20.18"
"68","000","00","020","0057","0805","621","378","243","6","627","1546","0","40.56","24.45"
"68","000","00","020","0058","0000","1213","680","533","10","1223","2834","0","43.15","23.99"
"68","000","00","020","0058","0798","572","304","268","5","577","1349","0","42.77","22.54"
"68","000","00","020","0058","0799","641","376","265","5","646","1485","0","43.50","25.32"
"68","000","00","020","0059","0000","1007","548","459","2","1009","2525","0","39.96","21.70"
"68","000","00","020","0059","0822","461","249","212","1","462","1264","0","36.55","19.70"
"68","000","00","020","0059","0823","546","299","247","1","547","1261","0","43.38","23.71"
"68","000","00","020","0060","0000","1452","813","639","7","1459","3252","0","44.86","25.00"
"68","000","00","020","0060","0727","782","428","354","4","786","1718","0","45.75","24.91"
"68","000","00","020","0060","0728","670","385","285","3","673","1534","0","43.87","25.10"
"68","000","00","020","0061","0000","1689","1012","677","10","1699","3683","0","46.13","27.48"
"68","000","00","020","0061","0729","627","382","245","4","631","1328","0","47.52","28.77"
"68","000","00","020","0061","0730","480","286","194","4","484","1109","0","43.64","25.79"
"68","000","00","020","0061","0731","582","344","238","2","584","1246","0","46.87","27.61"
"68","000","00","020","0062","0000","2032","1112","920","13","2045","4693","0","43.58","23.69"
"68","000","00","020","0062","0688","748","429","319","6","754","1701","0","44.33","25.22"
"68","000","00","020","0062","0689","606","323","283","3","609","1475","0","41.29","21.90"
"68","000","00","020","0062","0690","678","360","318","4","682","1517","0","44.96","23.73"
"68","000","00","020","0063","0000","1420","954","466","14","1434","3713","0","38.62","25.69"
"68","000","00","020","0063","0691","645","449","196","6","651","1627","0","40.01","27.60"
"68","000","00","020","0063","0692","775","505","270","8","783","2086","0","37.54","24.21"
"68","000","00","020","0064","0000","1486","700","786","15","1501","3620","0","41.46","19.34"
"68","000","00","020","0064","0903","447","176","271","5","452","1081","0","41.81","16.28"
"68","000","00","020","0064","0904","434","220","214","3","437","1147","0","38.10","19.18"
"68","000","00","020","0064","0905","605","304","301","7","612","1392","0","43.97","21.84"
"68","000","00","020","0065","0000","1771","1066","705","16","1787","4104","0","43.54","25.97"
"68","000","00","020","0065","0699","567","315","252","5","572","1339","0","42.72","23.53"
"68","000","00","020","0065","0700","616","358","258","4","620","1309","0","47.36","27.35"
"68","000","00","020","0065","0701","588","393","195","7","595","1456","0","40.87","26.99"
"68","000","00","020","0066","0000","1913","1019","894","13","1926","4282","0","44.98","23.80"
"68","000","00","020","0066","0737","638","328","310","7","645","1409","0","45.78","23.28"
"68","000","00","020","0066","0738","605","325","280","3","608","1379","0","44.09","23.57"
"68","000","00","020","0066","0739","670","366","304","3","673","1494","0","45.05","24.50"
"68","000","00","020","0067","0000","1012","762","250","8","1020","2050","0","49.76","37.17"
"68","000","00","020","0067","0751","450","339","111","2","452","960","0","47.08","35.31"
"68","000","00","020","0067","0752","562","423","139","6","568","1090","0","52.11","38.81"
"68","000","00","020","0068","0000","1833","1139","694","13","1846","4761","0","38.77","23.92"
"68","000","00","020","0068","0772","580","348","232","4","584","1506","0","38.78","23.11"
"68","000","00","020","0068","0773","676","417","259","5","681","1746","0","39.00","23.88"
"68","000","00","020","0068","0774","577","374","203","4","581","1509","0","38.50","24.78"
"68","000","00","020","0069","0000","1126","611","515","14","1140","2501","0","45.58","24.43"
"68","000","00","020","0069","0743","482","250","232","4","486","1112","0","43.71","22.48"
"68","000","00","020","0069","0744","644","361","283","10","654","1389","0","47.08","25.99"
"68","000","00","020","0070","0000","1596","832","764","13","1609","3783","0","42.53","21.99"
"68","000","00","020","0070","0745","508","287","221","7","515","1155","0","44.59","24.85"
"68","000","00","020","0070","0746","552","267","285","3","555","1321","0","42.01","20.21"
"68","000","00","020","0070","0747","536","278","258","3","539","1307","0","41.24","21.27"
"68","000","00","020","0071","0000","1479","1040","439","17","1496","3965","0","37.73","26.23"
"68","000","00","020","0071","0761","445","348","97","7","452","1028","0","43.97","33.85"
"68","000","00","020","0071","0762","455","296","159","5","460","1232","0","37.34","24.03"
"68","000","00","020","0071","0763","579","396","183","5","584","1705","0","34.25","23.23"
"68","000","00","020","0072","0000","1839","1193","646","19","1858","4804","0","38.68","24.83"
"68","000","00","020","0072","0718","690","449","241","4","694","1635","0","42.45","27.46"
"68","000","00","020","0072","0719","607","410","197","9","616","1578","0","39.04","25.98"
"68","000","00","020","0072","0720","542","334","208","6","548","1591","0","34.44","20.99"
"68","000","00","020","0073","0000","2441","1271","1170","24","2465","6095","0","40.44","20.85"
"68","000","00","020","0073","0859","658","292","366","5","663","1586","0","41.80","18.41"
"68","000","00","020","0073","0860","639","334","305","9","648","1706","0","37.98","19.58"
"68","000","00","020","0073","0861","519","281","238","4","523","1357","0","38.54","20.71"
"68","000","00","020","0073","0862","625","364","261","6","631","1446","0","43.64","25.17"
"68","000","00","020","0074","0000","2434","1220","1214","14","2448","5469","0","44.76","22.31"
"68","000","00","020","0074","0863","263","117","146","0","263","640","0","41.09","18.28"
"68","000","00","020","0074","0864","738","358","380","5","743","1523","0","48.79","23.51"
"68","000","00","020","0074","0865","707","355","352","5","712","1621","0","43.92","21.90"
"68","000","00","020","0074","0866","726","390","336","4","730","1685","0","43.32","23.15"
"68","000","00","020","0075","0000","1386","856","530","14","1400","3582","0","39.08","23.90"
"68","000","00","020","0075","0757","699","415","284","10","709","1740","0","40.75","23.85"
"68","000","00","020","0075","0758","687","441","246","4","691","1842","0","37.51","23.94"
"68","000","00","020","0076","0000","1357","855","502","14","1371","3555","0","38.57","24.05"
"68","000","00","020","0076","0721","449","277","172","8","457","1220","0","37.46","22.70"
"68","000","00","020","0076","0722","458","301","157","4","462","1102","0","41.92","27.31"
"68","000","00","020","0076","0723","450","277","173","2","452","1233","0","36.66","22.47"
"68","000","00","020","0077","0000","1621","1236","385","19","1640","3413","0","48.05","36.21"
"68","000","00","020","0077","0789","847","738","109","13","860","1711","0","50.26","43.13"
"68","000","00","020","0077","0790","774","498","276","6","780","1702","0","45.83","29.26"
"68","000","00","020","0078","0000","1653","1240","413","14","1667","3620","0","46.05","34.25"
"68","000","00","020","0078","0791","829","613","216","8","837","1830","0","45.74","33.50"
"68","000","00","020","0078","0792","824","627","197","6","830","1790","0","46.37","35.03"
"68","000","00","020","0079","0000","1906","1092","814","20","1926","4454","0","43.24","24.52"
"68","000","00","020","0079","0844","613","341","272","3","616","1393","0","44.22","24.48"
"68","000","00","020","0079","0845","614","384","230","9","623","1526","0","40.83","25.16"
"68","000","00","020","0079","0846","679","367","312","8","687","1535","0","44.76","23.91"
"68","000","00","020","0080","0000","1154","521","633","2","1156","2395","0","48.27","21.75"
"68","000","00","020","0080","0877","570","258","312","0","570","1222","0","46.64","21.11"
"68","000","00","020","0080","0878","584","263","321","2","586","1173","0","49.96","22.42"
"68","000","00","020","0081","0000","1352","877","475","10","1362","3376","0","40.34","25.98"
"68","000","00","020","0081","0779","623","419","204","3","626","1783","0","35.11","23.50"
"68","000","00","020","0081","0780","729","458","271","7","736","1593","0","46.20","28.75"
"68","000","00","020","0082","0000","2009","1278","731","13","2022","4787","0","42.24","26.70"
"68","000","00","020","0082","0693","506","272","234","1","507","1135","0","44.67","23.96"
"68","000","00","020","0082","0694","762","491","271","7","769","1881","0","40.88","26.10"
"68","000","00","020","0082","0695","741","515","226","5","746","1771","0","42.12","29.08"
"68","000","00","020","0083","0000","2297","1435","862","14","2311","5590","0","41.34","25.67"
"68","000","00","020","0083","0785","550","355","195","4","554","1376","0","40.26","25.80"
"68","000","00","020","0083","0786","544","354","190","3","547","1275","0","42.90","27.76"
"68","000","00","020","0083","0787","634","412","222","4","638","1523","0","41.89","27.05"
"68","000","00","020","0083","0788","569","314","255","3","572","1416","0","40.40","22.18"
"68","000","00","020","0084","0000","1702","988","714","11","1713","3821","0","44.83","25.86"
"68","000","00","020","0084","0835","614","369","245","5","619","1346","0","45.99","27.41"
"68","000","00","020","0084","0836","511","290","221","1","512","1229","0","41.66","23.60"
"68","000","00","020","0084","0837","577","329","248","5","582","1246","0","46.71","26.40"
"68","000","00","020","0085","0000","2073","1260","813","19","2092","4035","0","51.85","31.23"
"68","000","00","020","0085","0850","735","448","287","6","741","1414","0","52.40","31.68"
"68","000","00","020","0085","0851","672","412","260","4","676","1341","0","50.41","30.72"
"68","000","00","020","0085","0852","666","400","266","9","675","1280","0","52.73","31.25"
"68","000","00","030","0000","0000","31050","14303","16747","365","31415","79690","95240","39.42","17.95"
"68","000","00","030","0001","0000","669","234","435","7","676","1435","0","47.11","16.31"
"68","000","00","030","0001","0611","669","234","435","7","676","1435","0","47.11","16.31"
"68","000","00","030","0002","0000","453","146","307","4","457","963","0","47.46","15.16"
"68","000","00","030","0002","0612","453","146","307","4","457","963","0","47.46","15.16"
"68","000","00","030","0003","0000","1822","779","1043","12","1834","4760","0","38.53","16.37"
"68","000","00","030","0003","0616","450","188","262","3","453","1140","0","39.74","16.49"
"68","000","00","030","0003","0617","502","221","281","3","505","1263","0","39.98","17.50"
"68","000","00","030","0003","0618","493","204","289","4","497","1213","0","40.97","16.82"
"68","000","00","030","0003","0619","377","166","211","2","379","1144","0","33.13","14.51"
"68","000","00","030","0004","0000","1999","748","1251","24","2023","5582","0","36.24","13.40"
"68","000","00","030","0004","0620","507","173","334","3","510","1224","0","41.67","14.13"
"68","000","00","030","0004","0621","445","201","244","8","453","1395","0","32.47","14.41"
"68","000","00","030","0004","0622","529","176","353","4","533","1415","0","37.67","12.44"
"68","000","00","030","0004","0623","518","198","320","9","527","1548","0","34.04","12.79"
"68","000","00","030","0005","0000","475","131","344","9","484","1237","0","39.13","10.59"
"68","000","00","030","0005","0624","475","131","344","9","484","1237","0","39.13","10.59"
"68","000","00","030","0006","0000","431","113","318","5","436","964","0","45.23","11.72"
"68","000","00","030","0006","0625","431","113","318","5","436","964","0","45.23","11.72"
"68","000","00","030","0007","0000","1234","413","821","11","1245","3069","0","40.57","13.46"
"68","000","00","030","0007","0629","463","137","326","4","467","1059","0","44.10","12.94"
"68","000","00","030","0007","0630","480","180","300","5","485","1253","0","38.71","14.37"
"68","000","00","030","0007","0631","291","96","195","2","293","757","0","38.71","12.68"
"68","000","00","030","0008","0000","892","280","612","15","907","2222","0","40.82","12.60"
"68","000","00","030","0008","0632","496","185","311","6","502","1271","0","39.50","14.56"
"68","000","00","030","0008","0633","396","95","301","9","405","951","0","42.59","9.99"
"68","000","00","030","0009","0000","346","121","225","7","353","859","0","41.09","14.09"
"68","000","00","030","0009","0634","346","121","225","7","353","859","0","41.09","14.09"
"68","000","00","030","0010","0000","301","111","190","8","309","808","0","38.24","13.74"
"68","000","00","030","0010","0635","301","111","190","8","309","808","0","38.24","13.74"
"68","000","00","030","0011","0000","579","163","416","8","587","1300","0","45.15","12.54"
"68","000","00","030","0011","0626","579","163","416","8","587","1300","0","45.15","12.54"
"68","000","00","030","0012","0000","720","245","475","11","731","1752","0","41.72","13.98"
"68","000","00","030","0012","0627","455","153","302","7","462","1114","0","41.47","13.73"
"68","000","00","030","0012","0628","265","92","173","4","269","638","0","42.16","14.42"
"68","000","00","030","0013","0000","1003","376","627","10","1013","2714","0","37.32","13.85"
"68","000","00","030","0013","0638","564","166","398","8","572","1403","0","40.77","11.83"
"68","000","00","030","0013","0639","439","210","229","2","441","1311","0","33.64","16.02"
"68","000","00","030","0014","0000","672","234","438","8","680","1519","0","44.77","15.40"
"68","000","00","030","0014","0636","364","112","252","3","367","827","0","44.38","13.54"
"68","000","00","030","0014","0637","308","122","186","5","313","692","0","45.23","17.63"
"68","000","00","030","0015","0000","1060","733","327","18","1078","2831","0","38.08","25.89"
"68","000","00","030","0015","0648","549","357","192","11","560","1447","0","38.70","24.67"
"68","000","00","030","0015","0649","511","376","135","7","518","1384","0","37.43","27.17"
"68","000","00","030","0016","0000","1091","898","193","8","1099","2488","0","44.17","36.09"
"68","000","00","030","0016","0646","602","535","67","5","607","1222","0","49.67","43.78"
"68","000","00","030","0016","0647","489","363","126","3","492","1266","0","38.86","28.67"
"68","000","00","030","0017","0000","1780","855","925","13","1793","4490","0","39.93","19.04"
"68","000","00","030","0017","0640","562","218","344","3","565","1488","0","37.97","14.65"
"68","000","00","030","0017","0641","503","275","228","2","505","1271","0","39.73","21.64"
"68","000","00","030","0017","0642","715","362","353","8","723","1731","0","41.77","20.91"
"68","000","00","030","0018","0000","1946","930","1016","22","1968","5178","0","38.01","17.96"
"68","000","00","030","0018","0653","543","272","271","6","549","1345","0","40.82","20.22"
"68","000","00","030","0018","0654","481","206","275","9","490","1100","0","44.55","18.73"
"68","000","00","030","0018","0655","517","234","283","4","521","1337","0","38.97","17.50"
"68","000","00","030","0018","0656","405","218","187","3","408","1396","0","29.23","15.62"
"68","000","00","030","0019","0000","1264","676","588","13","1277","3244","0","39.36","20.84"
"68","000","00","030","0019","0657","719","369","350","11","730","1758","0","41.52","20.99"
"68","000","00","030","0019","0658","545","307","238","2","547","1486","0","36.81","20.66"
"68","000","00","030","0020","0000","601","289","312","2","603","1577","0","38.24","18.33"
"68","000","00","030","0020","0668","601","289","312","2","603","1577","0","38.24","18.33"
"68","000","00","030","0021","0000","1777","789","988","30","1807","5101","0","35.42","15.47"
"68","000","00","030","0021","0662","440","166","274","4","444","1174","0","37.82","14.14"
"68","000","00","030","0021","0663","490","196","294","7","497","1320","0","37.65","14.85"
"68","000","00","030","0021","0664","403","182","221","9","412","1290","0","31.94","14.11"
"68","000","00","030","0021","0665","444","245","199","10","454","1317","0","34.47","18.60"
"68","000","00","030","0022","0000","1451","633","818","9","1460","3734","0","39.10","16.95"
"68","000","00","030","0022","0671","465","223","242","7","472","1254","0","37.64","17.78"
"68","000","00","030","0022","0672","456","242","214","1","457","1156","0","39.53","20.93"
"68","000","00","030","0022","0673","530","168","362","1","531","1324","0","40.11","12.69"
"68","000","00","030","0023","0000","922","576","346","20","942","2437","0","38.65","23.64"
"68","000","00","030","0023","0666","426","241","185","13","439","1271","0","34.54","18.96"
"68","000","00","030","0023","0667","496","335","161","7","503","1166","0","43.14","28.73"
"68","000","00","030","0024","0000","1193","791","402","20","1213","3012","0","40.27","26.26"
"68","000","00","030","0024","0669","597","374","223","12","609","1470","0","41.43","25.44"
"68","000","00","030","0024","0670","596","417","179","8","604","1542","0","39.17","27.04"
"68","000","00","030","0025","0000","1848","681","1167","17","1865","4436","0","42.04","15.35"
"68","000","00","030","0025","0613","652","267","385","4","656","1541","0","42.57","17.33"
"68","000","00","030","0025","0614","610","202","408","9","619","1427","0","43.38","14.16"
"68","000","00","030","0025","0615","586","212","374","4","590","1468","0","40.19","14.44"
"68","000","00","030","0026","0000","1469","786","683","18","1487","3897","0","38.16","20.17"
"68","000","00","030","0026","0659","455","235","220","3","458","1378","0","33.24","17.05"
"68","000","00","030","0026","0660","409","244","165","6","415","1040","0","39.90","23.46"
"68","000","00","030","0026","0661","605","307","298","9","614","1479","0","41.51","20.76"
"68","000","00","030","0027","0000","1813","907","906","20","1833","4772","0","38.41","19.01"
"68","000","00","030","0027","0650","675","385","290","6","681","1647","0","41.35","23.38"
"68","000","00","030","0027","0651","568","262","306","6","574","1561","0","36.77","16.78"
"68","000","00","030","0027","0652","570","260","310","8","578","1564","0","36.96","16.62"
"68","000","00","030","0028","0000","1239","665","574","16","1255","3309","0","37.93","20.10"
"68","000","00","030","0028","0643","368","208","160","8","376","977","0","38.49","21.29"
"68","000","00","030","0028","0644","412","218","194","5","417","1074","0","38.83","20.30"
"68","000","00","030","0028","0645","459","239","220","3","462","1258","0","36.72","19.00"
"68","000","00","040","0000","0000","53917","30264","23653","471","54388","144349","176189","37.68","20.97"
"68","000","00","040","0001","0000","1576","914","662","8","1584","3845","0","41.20","23.77"
"68","000","00","040","0001","1104","552","287","265","3","555","1363","0","40.72","21.06"
"68","000","00","040","0001","1105","465","266","199","3","468","1274","0","36.73","20.88"
"68","000","00","040","0001","1106","559","361","198","2","561","1208","0","46.44","29.88"
"68","000","00","040","0002","0000","469","275","194","5","474","1054","0","44.97","26.09"
"68","000","00","040","0002","1107","469","275","194","5","474","1054","0","44.97","26.09"
"68","000","00","040","0003","0000","1090","641","449","10","1100","2595","0","42.39","24.70"
"68","000","00","040","0003","1110","467","266","201","3","470","1252","0","37.54","21.25"
"68","000","00","040","0003","1111","623","375","248","7","630","1343","0","46.91","27.92"
"68","000","00","040","0004","0000","2462","1363","1099","20","2482","7481","0","33.18","18.22"
"68","000","00","040","0004","1112","479","210","269","3","482","2073","0","23.25","10.13"
"68","000","00","040","0004","1113","635","319","316","8","643","1799","0","35.74","17.73"
"68","000","00","040","0004","1114","655","414","241","3","658","1744","0","37.73","23.74"
"68","000","00","040","0004","1115","693","420","273","6","699","1865","0","37.48","22.52"
"68","000","00","040","0005","0000","1134","684","450","10","1144","3148","0","36.34","21.73"
"68","000","00","040","0005","1116","528","339","189","7","535","1572","0","34.03","21.56"
"68","000","00","040","0005","1117","606","345","261","3","609","1576","0","38.64","21.89"
"68","000","00","040","0006","0000","985","440","545","11","996","2934","0","33.95","15.00"
"68","000","00","040","0006","1120","576","229","347","6","582","1761","0","33.05","13.00"
"68","000","00","040","0006","1121","409","211","198","5","414","1173","0","35.29","17.99"
"68","000","00","040","0007","0000","1609","845","764","11","1620","4097","0","39.54","20.62"
"68","000","00","040","0007","1155","577","302","275","5","582","1453","0","40.06","20.78"
"68","000","00","040","0007","1156","470","258","212","3","473","1337","0","35.38","19.30"
"68","000","00","040","0007","1157","562","285","277","3","565","1307","0","43.23","21.81"
"68","000","00","040","0008","0000","971","451","520","11","982","2632","0","37.31","17.14"
"68","000","00","040","0008","1139","445","200","245","5","450","1196","0","37.63","16.72"
"68","000","00","040","0008","1140","526","251","275","6","532","1436","0","37.05","17.48"
"68","000","00","040","0009","0000","796","470","326","6","802","1933","0","41.49","24.31"
"68","000","00","040","0009","1108","380","236","144","2","382","904","0","42.26","26.11"
"68","000","00","040","0009","1109","416","234","182","4","420","1029","0","40.82","22.74"
"68","000","00","040","0010","0000","1427","852","575","17","1444","3487","0","41.41","24.43"
"68","000","00","040","0010","1100","730","422","308","9","739","1782","0","41.47","23.68"
"68","000","00","040","0010","1101","697","430","267","8","705","1705","0","41.35","25.22"
"68","000","00","040","0011","0000","658","314","344","12","670","1355","0","49.45","23.17"
"68","000","00","040","0011","1063","658","314","344","12","670","1355","0","49.45","23.17"
"68","000","00","040","0012","0000","561","390","171","12","573","1396","0","41.05","27.94"
"68","000","00","040","0012","1066","561","390","171","12","573","1396","0","41.05","27.94"
"68","000","00","040","0013","0000","2152","1135","1017","19","2171","5757","0","37.71","19.72"
"68","000","00","040","0013","1072","645","319","326","5","650","1648","0","39.44","19.36"
"68","000","00","040","0013","1073","467","244","223","4","471","1349","0","34.91","18.09"
"68","000","00","040","0013","1074","512","268","244","3","515","1460","0","35.27","18.36"
"68","000","00","040","0013","1075","528","304","224","7","535","1300","0","41.15","23.38"
"68","000","00","040","0014","0000","1900","1151","749","17","1917","4609","0","41.59","24.97"
"68","000","00","040","0014","1067","691","406","285","4","695","1679","0","41.39","24.18"
"68","000","00","040","0014","1068","637","405","232","7","644","1487","0","43.31","27.24"
"68","000","00","040","0014","1069","572","340","232","6","578","1443","0","40.06","23.56"
"68","000","00","040","0015","0000","1459","834","625","12","1471","4143","0","35.51","20.13"
"68","000","00","040","0015","1080","523","296","227","5","528","1416","0","37.29","20.90"
"68","000","00","040","0015","1081","485","266","219","5","490","1379","0","35.53","19.29"
"68","000","00","040","0015","1082","451","272","179","2","453","1348","0","33.61","20.18"
"68","000","00","040","0016","0000","1252","745","507","9","1261","3760","0","33.54","19.81"
"68","000","00","040","0016","1141","408","261","147","4","412","1198","0","34.39","21.79"
"68","000","00","040","0016","1142","400","221","179","2","402","1287","0","31.24","17.17"
"68","000","00","040","0016","1143","444","263","181","3","447","1275","0","35.06","20.63"
"68","000","00","040","0017","0000","1373","638","735","14","1387","3518","0","39.43","18.14"
"68","000","00","040","0017","1149","716","317","399","7","723","1721","0","42.01","18.42"
"68","000","00","040","0017","1150","657","321","336","7","664","1797","0","36.95","17.86"
"68","000","00","040","0018","0000","1654","956","698","14","1668","3818","0","43.69","25.04"
"68","000","00","040","0018","1060","515","288","227","5","520","1214","0","42.83","23.72"
"68","000","00","040","0018","1061","622","349","273","6","628","1331","0","47.18","26.22"
"68","000","00","040","0018","1062","517","319","198","3","520","1273","0","40.85","25.06"
"68","000","00","040","0019","0000","1306","812","494","16","1322","3153","0","41.93","25.75"
"68","000","00","040","0019","1064","634","410","224","6","640","1522","0","42.05","26.94"
"68","000","00","040","0019","1065","672","402","270","10","682","1631","0","41.81","24.65"
"68","000","00","040","0020","0000","696","394","302","7","703","1787","0","39.34","22.05"
"68","000","00","040","0020","1125","355","210","145","6","361","929","0","38.86","22.60"
"68","000","00","040","0020","1126","341","184","157","1","342","858","0","39.86","21.45"
"68","000","00","040","0021","0000","1458","797","661","9","1467","3873","0","37.88","20.58"
"68","000","00","040","0021","1122","530","308","222","3","533","1290","0","41.32","23.88"
"68","000","00","040","0021","1123","445","261","184","3","448","1244","0","36.01","20.98"
"68","000","00","040","0021","1124","483","228","255","3","486","1339","0","36.30","17.03"
"68","000","00","040","0022","0000","1054","552","502","16","1070","2859","0","37.43","19.31"
"68","000","00","040","0022","1129","573","298","275","9","582","1616","0","36.01","18.44"
"68","000","00","040","0022","1130","481","254","227","7","488","1243","0","39.26","20.43"
"68","000","00","040","0023","0000","1190","692","498","19","1209","3757","0","32.18","18.42"
"68","000","00","040","0023","1158","429","266","163","6","435","1251","0","34.77","21.26"
"68","000","00","040","0023","1159","381","226","155","8","389","1192","0","32.63","18.96"
"68","000","00","040","0023","1160","380","200","180","5","385","1314","0","29.30","15.22"
"68","000","00","040","0024","0000","969","476","493","8","977","2794","0","34.97","17.04"
"68","000","00","040","0024","1131","456","242","214","4","460","1335","0","34.46","18.13"
"68","000","00","040","0024","1132","513","234","279","4","517","1459","0","35.44","16.04"
"68","000","00","040","0025","0000","1954","1090","864","14","1968","5853","0","33.62","18.62"
"68","000","00","040","0025","1135","572","299","273","6","578","1606","0","35.99","18.62"
"68","000","00","040","0025","1136","512","267","245","1","513","1456","0","35.23","18.34"
"68","000","00","040","0025","1137","439","262","177","1","440","1404","0","31.34","18.66"
"68","000","00","040","0025","1138","431","262","169","6","437","1387","0","31.51","18.89"
"68","000","00","040","0026","0000","1209","694","515","6","1215","2986","0","40.69","23.24"
"68","000","00","040","0026","1102","697","406","291","3","700","1687","0","41.49","24.07"
"68","000","00","040","0026","1103","512","288","224","3","515","1299","0","39.65","22.17"
"68","000","00","040","0027","0000","2752","1556","1196","13","2765","7742","0","35.71","20.10"
"68","000","00","040","0027","1091","547","326","221","4","551","1482","0","37.18","22.00"
"68","000","00","040","0027","1092","593","341","252","1","594","1483","0","40.05","22.99"
"68","000","00","040","0027","1093","514","289","225","0","514","1499","0","34.29","19.28"
"68","000","00","040","0027","1094","604","356","248","5","609","1727","0","35.26","20.61"
"68","000","00","040","0027","1095","494","244","250","3","497","1551","0","32.04","15.73"
"68","000","00","040","0028","0000","1650","1009","641","16","1666","4048","0","41.16","24.93"
"68","000","00","040","0028","1086","424","262","162","3","427","1406","0","30.37","18.63"
"68","000","00","040","0028","1087","627","367","260","6","633","1270","0","49.84","28.90"
"68","000","00","040","0028","1088","599","380","219","7","606","1372","0","44.17","27.70"
"68","000","00","040","0029","0000","1478","912","566","12","1490","3286","0","45.34","27.75"
"68","000","00","040","0029","1096","743","468","275","4","747","1612","0","46.34","29.03"
"68","000","00","040","0029","1097","735","444","291","8","743","1674","0","44.38","26.52"
"68","000","00","040","0030","0000","1331","663","668","13","1344","3311","0","40.59","20.02"
"68","000","00","040","0030","1118","705","340","365","8","713","1669","0","42.72","20.37"
"68","000","00","040","0030","1119","626","323","303","5","631","1642","0","38.43","19.67"
"68","000","00","040","0031","0000","1431","854","577","10","1441","4482","0","32.15","19.05"
"68","000","00","040","0031","1146","468","285","183","8","476","1506","0","31.61","18.92"
"68","000","00","040","0031","1147","489","277","212","1","490","1537","0","31.88","18.02"
"68","000","00","040","0031","1148","474","292","182","1","475","1439","0","33.01","20.29"
"68","000","00","040","0032","0000","1418","731","687","14","1432","3453","0","41.47","21.17"
"68","000","00","040","0032","1153","758","378","380","9","767","1740","0","44.08","21.72"
"68","000","00","040","0032","1154","660","353","307","5","665","1713","0","38.82","20.61"
"68","000","00","040","0033","0000","1420","728","692","9","1429","3233","0","44.20","22.52"
"68","000","00","040","0033","1151","727","401","326","8","735","1620","0","45.37","24.75"
"68","000","00","040","0033","1152","693","327","366","1","694","1613","0","43.03","20.27"
"68","000","00","040","0034","0000","2088","1250","838","16","2104","5934","0","35.46","21.07"
"68","000","00","040","0034","1076","539","355","184","4","543","1488","0","36.49","23.86"
"68","000","00","040","0034","1077","459","270","189","6","465","1445","0","32.18","18.69"
"68","000","00","040","0034","1078","540","268","272","4","544","1510","0","36.03","17.75"
"68","000","00","040","0034","1079","550","357","193","2","552","1491","0","37.02","23.94"
"68","000","00","040","0035","0000","742","439","303","7","749","1966","0","38.10","22.33"
"68","000","00","040","0035","1070","269","153","116","1","270","870","0","31.03","17.59"
"68","000","00","040","0035","1071","473","286","187","6","479","1096","0","43.70","26.09"
"68","000","00","040","0036","0000","1185","702","483","8","1193","3639","0","32.78","19.29"
"68","000","00","040","0036","1083","390","223","167","0","390","1309","0","29.79","17.04"
"68","000","00","040","0036","1084","459","290","169","3","462","1200","0","38.50","24.17"
"68","000","00","040","0036","1085","336","189","147","5","341","1130","0","30.18","16.73"
"68","000","00","040","0037","0000","972","481","491","7","979","2766","0","35.39","17.39"
"68","000","00","040","0037","1144","490","220","270","3","493","1442","0","34.19","15.26"
"68","000","00","040","0037","1145","482","261","221","4","486","1324","0","36.71","19.71"
"68","000","00","040","0038","0000","1023","522","501","10","1033","3030","0","34.09","17.23"
"68","000","00","040","0038","1127","503","229","274","4","507","1453","0","34.89","15.76"
"68","000","00","040","0038","1128","520","293","227","6","526","1577","0","33.35","18.58"
"68","000","00","040","0039","0000","853","536","317","2","855","2486","0","34.39","21.56"
"68","000","00","040","0039","1098","371","243","128","1","372","1277","0","29.13","19.03"
"68","000","00","040","0039","1099","482","293","189","1","483","1209","0","39.95","24.23"
"68","000","00","040","0040","0000","1194","708","486","7","1201","3449","0","34.82","20.53"
"68","000","00","040","0040","1089","637","388","249","4","641","1681","0","38.13","23.08"
"68","000","00","040","0040","1090","557","320","237","3","560","1768","0","31.67","18.10"
"68","000","00","040","0041","0000","1016","568","448","14","1030","2900","0","35.52","19.59"
"68","000","00","040","0041","1133","518","315","203","7","525","1315","0","39.92","23.95"
"68","000","00","040","0041","1134","498","253","245","7","505","1585","0","31.86","15.96"
"68","000","00","050","0000","0000","52598","23843","28755","455","53053","133965","166690","39.60","17.80"
"68","000","00","050","0001","0000","1243","413","830","15","1258","2950","0","42.64","14.00"
"68","000","00","050","0001","0463","675","228","447","4","679","1566","0","43.36","14.56"
"68","000","00","050","0001","0464","568","185","383","11","579","1384","0","41.84","13.37"
"68","000","00","050","0002","0000","1651","567","1084","17","1668","4062","0","41.06","13.96"
"68","000","00","050","0002","0465","592","208","384","3","595","1441","0","41.29","14.43"
"68","000","00","050","0002","0466","532","185","347","10","542","1358","0","39.91","13.62"
"68","000","00","050","0002","0467","527","174","353","4","531","1263","0","42.04","13.78"
"68","000","00","050","0003","0000","1992","807","1185","18","2010","5043","0","39.86","16.00"
"68","000","00","050","0003","0473","651","275","376","9","660","1683","0","39.22","16.34"
"68","000","00","050","0003","0474","449","168","281","1","450","1172","0","38.40","14.33"
"68","000","00","050","0003","0475","435","155","280","4","439","1103","0","39.80","14.05"
"68","000","00","050","0003","0476","457","209","248","4","461","1085","0","42.49","19.26"
"68","000","00","050","0004","0000","1933","903","1030","17","1950","4969","0","39.24","18.17"
"68","000","00","050","0004","0482","673","311","362","10","683","1733","0","39.41","17.95"
"68","000","00","050","0004","0483","600","298","302","2","602","1657","0","36.33","17.98"
"68","000","00","050","0004","0484","660","294","366","5","665","1579","0","42.12","18.62"
"68","000","00","050","0006","0000","1571","523","1048","16","1587","4036","0","39.32","12.96"
"68","000","00","050","0006","0486","451","132","319","7","458","1238","0","37.00","10.66"
"68","000","00","050","0006","0487","561","182","379","3","564","1366","0","41.29","13.32"
"68","000","00","050","0006","0488","559","209","350","6","565","1432","0","39.46","14.59"
"68","000","00","050","0007","0000","1536","721","815","13","1549","3675","0","42.15","19.62"
"68","000","00","050","0007","0507","525","254","271","1","526","1152","0","45.66","22.05"
"68","000","00","050","0007","0508","546","231","315","6","552","1361","0","40.56","16.97"
"68","000","00","050","0007","0509","465","236","229","6","471","1162","0","40.53","20.31"
"68","000","00","050","0008","0000","1608","780","828","12","1620","3906","0","41.47","19.97"
"68","000","00","050","0008","0510","565","257","308","7","572","1344","0","42.56","19.12"
"68","000","00","050","0008","0511","466","196","270","3","469","1152","0","40.71","17.01"
"68","000","00","050","0008","0512","577","327","250","2","579","1410","0","41.06","23.19"
"68","000","00","050","0009","0000","1021","502","519","5","1026","2425","0","42.31","20.70"
"68","000","00","050","0009","0519","579","279","300","2","581","1215","0","47.82","22.96"
"68","000","00","050","0009","0520","442","223","219","3","445","1210","0","36.78","18.43"
"68","000","00","050","0010","0000","919","321","598","6","925","2595","0","35.65","12.37"
"68","000","00","050","0010","0542","380","137","243","0","380","1343","0","28.29","10.20"
"68","000","00","050","0010","0543","539","184","355","6","545","1252","0","43.53","14.70"
"68","000","00","050","0011","0000","594","240","354","9","603","1778","0","33.91","13.50"
"68","000","00","050","0011","0544","594","240","354","9","603","1778","0","33.91","13.50"
"68","000","00","050","0012","0000","1309","412","897","18","1327","3579","0","37.08","11.51"
"68","000","00","050","0012","0545","440","152","288","9","449","1192","0","37.67","12.75"
"68","000","00","050","0012","0546","463","140","323","5","468","1218","0","38.42","11.49"
"68","000","00","050","0012","0547","406","120","286","4","410","1169","0","35.07","10.27"
"68","000","00","050","0013","0000","619","150","469","11","630","1486","0","42.40","10.09"
"68","000","00","050","0013","0548","619","150","469","11","630","1486","0","42.40","10.09"
"68","000","00","050","0014","0000","617","160","457","7","624","1673","0","37.30","9.56"
"68","000","00","050","0014","0549","617","160","457","7","624","1673","0","37.30","9.56"
"68","000","00","050","0015","0000","981","320","661","4","985","2501","0","39.38","12.79"
"68","000","00","050","0015","0550","532","168","364","2","534","1310","0","40.76","12.82"
"68","000","00","050","0015","0551","449","152","297","2","451","1191","0","37.87","12.76"
"68","000","00","050","0016","0000","926","430","496","13","939","2969","0","31.63","14.48"
"68","000","00","050","0016","0552","436","203","233","9","445","1485","0","29.97","13.67"
"68","000","00","050","0016","0553","490","227","263","4","494","1484","0","33.29","15.30"
"68","000","00","050","0017","0000","1520","722","798","21","1541","3532","0","43.63","20.44"
"68","000","00","050","0017","0505","829","355","474","12","841","1881","0","44.71","18.87"
"68","000","00","050","0017","0506","691","367","324","9","700","1651","0","42.40","22.23"
"68","000","00","050","0018","0000","2191","1126","1065","12","2203","5162","0","42.68","21.81"
"68","000","00","050","0018","0489","482","250","232","6","488","1167","0","41.82","21.42"
"68","000","00","050","0018","0490","640","341","299","4","644","1347","0","47.81","25.32"
"68","000","00","050","0018","0491","520","246","274","1","521","1279","0","40.73","19.23"
"68","000","00","050","0018","0492","549","289","260","1","550","1369","0","40.18","21.11"
"68","000","00","050","0019","0000","857","383","474","12","869","2582","0","33.66","14.83"
"68","000","00","050","0019","0517","421","173","248","9","430","1148","0","37.46","15.07"
"68","000","00","050","0019","0518","436","210","226","3","439","1434","0","30.61","14.64"
"68","000","00","050","0020","0000","1321","592","729","13","1334","3128","0","42.65","18.93"
"68","000","00","050","0020","0513","622","235","387","7","629","1471","0","42.76","15.98"
"68","000","00","050","0020","0516","699","357","342","6","705","1657","0","42.55","21.54"
"68","000","00","050","0021","0000","574","146","428","7","581","1327","0","43.78","11.00"
"68","000","00","050","0021","0485","574","146","428","7","581","1327","0","43.78","11.00"
"68","000","00","050","0022","0000","1429","635","794","11","1440","3516","0","40.96","18.06"
"68","000","00","050","0022","0477","459","196","263","4","463","1181","0","39.20","16.60"
"68","000","00","050","0022","0478","720","321","399","3","723","1717","0","42.11","18.70"
"68","000","00","050","0022","0479","250","118","132","4","254","618","0","41.10","19.09"
"68","000","00","050","0023","0000","1164","449","715","15","1179","2982","0","39.54","15.06"
"68","000","00","050","0023","0480","626","236","390","9","635","1534","0","41.40","15.38"
"68","000","00","050","0023","0481","538","213","325","6","544","1448","0","37.57","14.71"
"68","000","00","050","0024","0000","1276","706","570","14","1290","3360","0","38.39","21.01"
"68","000","00","050","0024","0540","627","304","323","5","632","1645","0","38.42","18.48"
"68","000","00","050","0024","0541","649","402","247","9","658","1715","0","38.37","23.44"
"68","000","00","050","0025","0000","1939","1000","939","16","1955","4886","0","40.01","20.47"
"68","000","00","050","0025","0535","620","313","307","6","626","1506","0","41.57","20.78"
"68","000","00","050","0025","0536","702","387","315","3","705","1732","0","40.70","22.34"
"68","000","00","050","0025","0537","617","300","317","7","624","1648","0","37.86","18.20"
"68","000","00","050","0026","0000","1917","932","985","11","1928","4459","0","43.24","20.90"
"68","000","00","050","0026","0525","709","344","365","6","715","1624","0","44.03","21.18"
"68","000","00","050","0026","0526","640","307","333","4","644","1503","0","42.85","20.43"
"68","000","00","050","0026","0527","568","281","287","1","569","1332","0","42.72","21.10"
"68","000","00","050","0027","0000","1516","739","777","9","1525","3985","0","38.27","18.54"
"68","000","00","050","0027","0501","547","265","282","4","551","1579","0","34.90","16.78"
"68","000","00","050","0027","0502","440","192","248","4","444","1153","0","38.51","16.65"
"68","000","00","050","0027","0503","529","282","247","1","530","1253","0","42.30","22.51"
"68","000","00","050","0028","0000","1960","1055","905","13","1973","5062","0","38.98","20.84"
"68","000","00","050","0028","0493","667","365","302","4","671","1820","0","36.87","20.05"
"68","000","00","050","0028","0494","621","337","284","4","625","1628","0","38.39","20.70"
"68","000","00","050","0028","0495","672","353","319","5","677","1614","0","41.95","21.87"
"68","000","00","050","0029","0000","1352","660","692","7","1359","3442","0","39.48","19.17"
"68","000","00","050","0029","0496","674","335","339","2","676","1683","0","40.17","19.90"
"68","000","00","050","0029","0497","678","325","353","5","683","1759","0","38.83","18.48"
"68","000","00","050","0030","0000","594","265","329","6","600","1633","0","36.74","16.23"
"68","000","00","050","0030","0504","594","265","329","6","600","1633","0","36.74","16.23"
"68","000","00","050","0031","0000","2344","1228","1116","15","2359","5584","0","42.25","21.99"
"68","000","00","050","0031","0531","649","313","336","2","651","1522","0","42.77","20.57"
"68","000","00","050","0031","0532","526","298","228","6","532","1314","0","40.49","22.68"
"68","000","00","050","0031","0533","562","284","278","3","565","1352","0","41.79","21.01"
"68","000","00","050","0031","0534","607","333","274","4","611","1396","0","43.77","23.85"
"68","000","00","050","0032","0000","1748","967","781","23","1771","3690","0","47.99","26.21"
"68","000","00","050","0032","0528","569","310","259","10","579","1190","0","48.66","26.05"
"68","000","00","050","0032","0529","681","403","278","9","690","1245","0","55.42","32.37"
"68","000","00","050","0032","0530","498","254","244","4","502","1255","0","40.00","20.24"
"68","000","00","050","0033","0000","1227","639","588","9","1236","3243","0","38.11","19.70"
"68","000","00","050","0033","0521","662","356","306","4","666","1711","0","38.92","20.81"
"68","000","00","050","0033","0522","565","283","282","5","570","1532","0","37.21","18.47"
"68","000","00","050","0034","0000","1177","524","653","7","1184","3227","0","36.69","16.24"
"68","000","00","050","0034","0523","582","239","343","3","585","1535","0","38.11","15.57"
"68","000","00","050","0034","0524","595","285","310","4","599","1692","0","35.40","16.84"
"68","000","00","050","0035","0000","1232","629","603","8","1240","2793","0","44.40","22.52"
"68","000","00","050","0035","0514","607","310","297","4","611","1423","0","42.94","21.78"
"68","000","00","050","0035","0515","625","319","306","4","629","1370","0","45.91","23.28"
"68","000","00","050","0036","0000","1812","892","920","13","1825","5074","0","35.97","17.58"
"68","000","00","050","0036","0470","598","293","305","7","605","1498","0","40.39","19.56"
"68","000","00","050","0036","0471","584","286","298","1","585","1805","0","32.41","15.84"
"68","000","00","050","0036","0472","630","313","317","5","635","1771","0","35.86","17.67"
"68","000","00","050","0037","0000","1373","653","720","6","1379","3380","0","40.80","19.32"
"68","000","00","050","0037","0468","658","282","376","3","661","1591","0","41.55","17.72"
"68","000","00","050","0037","0469","715","371","344","3","718","1789","0","40.13","20.74"
"68","000","00","050","0038","0000","1279","636","643","10","1289","3296","0","39.11","19.30"
"68","000","00","050","0038","0538","595","284","311","4","599","1597","0","37.51","17.78"
"68","000","00","050","0038","0539","684","352","332","6","690","1699","0","40.61","20.72"
"68","000","00","050","0039","0000","1512","701","811","8","1520","4443","0","34.21","15.78"
"68","000","00","050","0039","0498","496","222","274","1","497","1512","0","32.87","14.68"
"68","000","00","050","0039","0499","577","260","317","4","581","1576","0","36.87","16.50"
"68","000","00","050","0039","0500","439","219","220","3","442","1355","0","32.62","16.16"
"68","000","00","050","0040","0000","764","315","449","8","772","2532","0","30.49","12.44"
"68","000","00","050","0040","0554","364","152","212","3","367","1210","0","30.33","12.56"
"68","000","00","050","0040","0555","400","163","237","5","405","1322","0","30.64","12.33"
"68","000","00","060","0000","0000","27880","11871","16009","263","28143","77353","93663","36.38","15.35"
"68","000","00","060","0001","0000","2333","1013","1320","23","2356","6107","0","38.58","16.59"
"68","000","00","060","0001","0556","618","292","326","5","623","1523","0","40.91","19.17"
"68","000","00","060","0001","0557","529","245","284","3","532","1639","0","32.46","14.95"
"68","000","00","060","0001","0558","550","213","337","7","557","1405","0","39.64","15.16"
"68","000","00","060","0001","0559","636","263","373","8","644","1540","0","41.82","17.08"
"68","000","00","060","0002","0000","2514","1065","1449","24","2538","6972","0","36.40","15.28"
"68","000","00","060","0002","0560","466","178","288","7","473","1233","0","38.36","14.44"
"68","000","00","060","0002","0561","552","244","308","4","556","1503","0","36.99","16.23"
"68","000","00","060","0002","0562","456","191","265","2","458","1312","0","34.91","14.56"
"68","000","00","060","0002","0563","523","238","285","6","529","1462","0","36.18","16.28"
"68","000","00","060","0002","0564","517","214","303","5","522","1462","0","35.70","14.64"
"68","000","00","060","0003","0000","1479","624","855","12","1491","4705","0","31.69","13.26"
"68","000","00","060","0003","0565","490","221","269","5","495","1601","0","30.92","13.80"
"68","000","00","060","0003","0566","474","186","288","5","479","1438","0","33.31","12.93"
"68","000","00","060","0003","0567","515","217","298","2","517","1666","0","31.03","13.03"
"68","000","00","060","0004","0000","640","212","428","6","646","1612","0","40.07","13.15"
"68","000","00","060","0004","0568","640","212","428","6","646","1612","0","40.07","13.15"
"68","000","00","060","0005","0000","4561","2109","2452","43","4604","11610","0","39.66","18.17"
"68","000","00","060","0005","0569","477","182","295","4","481","1434","0","33.54","12.69"
"68","000","00","060","0005","0570","478","204","274","5","483","1352","0","35.72","15.09"
"68","000","00","060","0005","0571","520","236","284","5","525","1488","0","35.28","15.86"
"68","000","00","060","0005","0572","740","278","462","10","750","1630","0","46.01","17.06"
"68","000","00","060","0005","0573","663","324","339","5","668","1450","0","46.07","22.34"
"68","000","00","060","0005","0574","596","322","274","4","600","1462","0","41.04","22.02"
"68","000","00","060","0005","0575","590","325","265","5","595","1443","0","41.23","22.52"
"68","000","00","060","0005","0576","497","238","259","5","502","1351","0","37.16","17.62"
"68","000","00","060","0006","0000","1985","676","1309","13","1998","5222","0","38.26","12.95"
"68","000","00","060","0006","0577","602","181","421","4","606","1412","0","42.92","12.82"
"68","000","00","060","0006","0578","544","185","359","5","549","1417","0","38.74","13.06"
"68","000","00","060","0006","0579","516","169","347","3","519","1488","0","34.88","11.36"
"68","000","00","060","0006","0580","323","141","182","1","324","905","0","35.80","15.58"
"68","000","00","060","0007","0000","2156","874","1282","12","2168","5896","0","36.77","14.82"
"68","000","00","060","0007","0581","533","226","307","3","536","1496","0","35.83","15.11"
"68","000","00","060","0007","0582","506","226","280","3","509","1434","0","35.50","15.76"
"68","000","00","060","0007","0583","568","249","319","3","571","1555","0","36.72","16.01"
"68","000","00","060","0007","0584","549","173","376","3","552","1411","0","39.12","12.26"
"68","000","00","060","0008","0000","652","347","305","10","662","1650","0","40.12","21.03"
"68","000","00","060","0008","0585","652","347","305","10","662","1650","0","40.12","21.03"
"68","000","00","060","0010","0000","1203","469","734","12","1215","2851","0","42.62","16.45"
"68","000","00","060","0010","0586","544","196","348","6","550","1446","0","38.04","13.55"
"68","000","00","060","0010","0587","659","273","386","6","665","1405","0","47.33","19.43"
"68","000","00","060","0011","0000","2483","1084","1399","32","2515","7202","0","34.92","15.05"
"68","000","00","060","0011","0588","529","204","325","10","539","1454","0","37.07","14.03"
"68","000","00","060","0011","0589","512","206","306","7","519","1396","0","37.18","14.76"
"68","000","00","060","0011","0590","500","246","254","6","506","1531","0","33.05","16.07"
"68","000","00","060","0011","0591","516","251","265","2","518","1598","0","32.42","15.71"
"68","000","00","060","0011","0592","426","177","249","7","433","1223","0","35.40","14.47"
"68","000","00","060","0012","0000","1192","542","650","8","1200","3212","0","37.36","16.87"
"68","000","00","060","0012","0593","590","262","328","3","593","1638","0","36.20","16.00"
"68","000","00","060","0012","0594","602","280","322","5","607","1574","0","38.56","17.79"
"68","000","00","060","0013","0000","597","285","312","10","607","1863","0","32.58","15.30"
"68","000","00","060","0013","0595","312","151","161","4","316","904","0","34.96","16.70"
"68","000","00","060","0013","0596","285","134","151","6","291","959","0","30.34","13.97"
"68","000","00","060","0014","0000","879","390","489","10","889","2595","0","34.26","15.03"
"68","000","00","060","0014","0597","364","172","192","4","368","1174","0","31.35","14.65"
"68","000","00","060","0014","0598","515","218","297","6","521","1421","0","36.66","15.34"
"68","000","00","060","0015","0000","816","366","450","6","822","2523","0","32.58","14.51"
"68","000","00","060","0015","0599","437","197","240","4","441","1277","0","34.53","15.43"
"68","000","00","060","0015","0600","379","169","210","2","381","1246","0","30.58","13.56"
"68","000","00","060","0016","0000","945","364","581","9","954","2566","0","37.18","14.19"
"68","000","00","060","0016","0601","445","191","254","3","448","1224","0","36.60","15.60"
"68","000","00","060","0016","0602","500","173","327","6","506","1342","0","37.70","12.89"
"68","000","00","060","0017","0000","754","289","465","8","762","2154","0","35.38","13.42"
"68","000","00","060","0017","0603","392","145","247","1","393","1095","0","35.89","13.24"
"68","000","00","060","0017","0604","362","144","218","7","369","1059","0","34.84","13.60"
"68","000","00","060","0018","0000","958","360","598","13","971","2912","0","33.34","12.36"
"68","000","00","060","0018","0605","508","170","338","8","516","1343","0","38.42","12.66"
"68","000","00","060","0018","0606","450","190","260","5","455","1569","0","29.00","12.11"
"68","000","00","060","0019","0000","1733","802","931","12","1745","5701","0","30.61","14.07"
"68","000","00","060","0019","0607","442","194","248","4","446","1557","0","28.64","12.46"
"68","000","00","060","0019","0608","471","217","254","2","473","1587","0","29.80","13.67"
"68","000","00","060","0019","0609","509","231","278","3","512","1496","0","34.22","15.44"
"68","000","00","060","0019","0610","311","160","151","3","314","1061","0","29.59","15.08"
"68","000","00","070","0000","0000","54048","26647","27401","512","54560","138592","165716","39.37","19.23"
"68","000","00","070","0001","0000","1702","733","969","9","1711","3984","0","42.95","18.40"
"68","000","00","070","0001","0318","551","267","284","4","555","1269","0","43.74","21.04"
"68","000","00","070","0001","0319","492","160","332","3","495","1186","0","41.74","13.49"
"68","000","00","070","0001","0320","659","306","353","2","661","1529","0","43.23","20.01"
"68","000","00","070","0002","0000","2585","1243","1342","20","2605","6579","0","39.60","18.89"
"68","000","00","070","0002","0332","504","264","240","4","508","1129","0","45.00","23.38"
"68","000","00","070","0002","0333","524","252","272","4","528","1252","0","42.17","20.13"
"68","000","00","070","0002","0334","630","253","377","4","634","1480","0","42.84","17.09"
"68","000","00","070","0002","0335","456","249","207","2","458","1378","0","33.24","18.07"
"68","000","00","070","0002","0336","471","225","246","6","477","1340","0","35.60","16.79"
"68","000","00","070","0003","0000","1564","703","861","8","1572","4492","0","35.00","15.65"
"68","000","00","070","0003","0288","354","142","212","3","357","823","0","43.38","17.25"
"68","000","00","070","0003","0289","426","205","221","3","429","1282","0","33.46","15.99"
"68","000","00","070","0003","0290","374","184","190","1","375","1197","0","31.33","15.37"
"68","000","00","070","0003","0291","410","172","238","1","411","1190","0","34.54","14.45"
"68","000","00","070","0004","0000","2214","1050","1164","24","2238","5834","0","38.36","18.00"
"68","000","00","070","0004","0249","579","289","290","6","585","1562","0","37.45","18.50"
"68","000","00","070","0004","0250","569","277","292","6","575","1423","0","40.41","19.47"
"68","000","00","070","0004","0251","557","238","319","7","564","1645","0","34.29","14.47"
"68","000","00","070","0004","0252","509","246","263","5","514","1204","0","42.69","20.43"
"68","000","00","070","0005","0000","1265","587","678","16","1281","3262","0","39.27","18.00"
"68","000","00","070","0005","0270","729","328","401","9","738","1853","0","39.83","17.70"
"68","000","00","070","0005","0271","536","259","277","7","543","1409","0","38.54","18.38"
"68","000","00","070","0006","0000","1962","965","997","14","1976","5439","0","36.33","17.74"
"68","000","00","070","0006","0267","622","276","346","3","625","1732","0","36.09","15.94"
"68","000","00","070","0006","0268","613","288","325","9","622","1922","0","32.36","14.98"
"68","000","00","070","0006","0269","727","401","326","2","729","1785","0","40.84","22.46"
"68","000","00","070","0007","0000","1775","1523","252","26","1801","3606","0","49.94","42.24"
"68","000","00","070","0007","0305","896","775","121","11","907","1738","0","52.19","44.59"
"68","000","00","070","0007","0306","879","748","131","15","894","1868","0","47.86","40.04"
"68","000","00","070","0008","0000","2147","1426","721","36","2183","5179","0","42.15","27.53"
"68","000","00","070","0008","0323","782","663","119","12","794","1616","0","49.13","41.03"
"68","000","00","070","0008","0324","667","421","246","13","680","1717","0","39.60","24.52"
"68","000","00","070","0008","0325","698","342","356","11","709","1846","0","38.41","18.53"
"68","000","00","070","0009","0000","627","271","356","6","633","1298","0","48.77","20.88"
"68","000","00","070","0009","0278","627","271","356","6","633","1298","0","48.77","20.88"
"68","000","00","070","0010","0000","1921","836","1085","14","1935","5523","0","35.04","15.14"
"68","000","00","070","0010","0326","767","323","444","6","773","2261","0","34.19","14.29"
"68","000","00","070","0010","0327","511","218","293","5","516","1546","0","33.38","14.10"
"68","000","00","070","0010","0328","643","295","348","3","646","1716","0","37.65","17.19"
"68","000","00","070","0011","0000","794","327","467","6","800","1874","0","42.69","17.45"
"68","000","00","070","0011","0298","794","327","467","6","800","1874","0","42.69","17.45"
"68","000","00","070","0012","0000","725","290","435","7","732","1975","0","37.06","14.68"
"68","000","00","070","0012","0253","355","155","200","3","358","983","0","36.42","15.77"
"68","000","00","070","0012","0254","370","135","235","4","374","992","0","37.70","13.61"
"68","000","00","070","0013","0000","1793","891","902","16","1809","4708","0","38.42","18.93"
"68","000","00","070","0013","0275","548","307","241","9","557","1612","0","34.55","19.04"
"68","000","00","070","0013","0276","682","321","361","3","685","1651","0","41.49","19.44"
"68","000","00","070","0013","0277","563","263","300","4","567","1445","0","39.24","18.20"
"68","000","00","070","0014","0000","1975","879","1096","25","2000","4790","0","41.75","18.35"
"68","000","00","070","0014","0272","678","310","368","4","682","1651","0","41.31","18.78"
"68","000","00","070","0014","0273","624","269","355","14","638","1480","0","43.11","18.18"
"68","000","00","070","0014","0274","673","300","373","7","680","1659","0","40.99","18.08"
"68","000","00","070","0015","0000","2288","1078","1210","27","2315","5265","0","43.97","20.47"
"68","000","00","070","0015","0307","635","313","322","7","642","1449","0","44.31","21.60"
"68","000","00","070","0015","0308","459","205","254","10","469","1021","0","45.94","20.08"
"68","000","00","070","0015","0309","528","247","281","2","530","1403","0","37.78","17.61"
"68","000","00","070","0015","0310","666","313","353","8","674","1392","0","48.42","22.49"
"68","000","00","070","0016","0000","1510","654","856","17","1527","4034","0","37.85","16.21"
"68","000","00","070","0016","0337","474","193","281","8","482","1222","0","39.44","15.79"
"68","000","00","070","0016","0338","600","276","324","6","606","1491","0","40.64","18.51"
"68","000","00","070","0016","0339","436","185","251","3","439","1321","0","33.23","14.00"
"68","000","00","070","0017","0000","691","226","465","5","696","1760","0","39.55","12.84"
"68","000","00","070","0017","0331","691","226","465","5","696","1760","0","39.55","12.84"
"68","000","00","070","0018","0000","1147","558","589","14","1161","2636","0","44.04","21.17"
"68","000","00","070","0018","0340","715","405","310","8","723","1578","0","45.82","25.67"
"68","000","00","070","0018","0341","432","153","279","6","438","1058","0","41.40","14.46"
"68","000","00","070","0019","0000","1403","662","741","13","1416","4111","0","34.44","16.10"
"68","000","00","070","0019","0255","462","212","250","1","463","1378","0","33.60","15.38"
"68","000","00","070","0019","0256","540","237","303","6","546","1472","0","37.09","16.10"
"68","000","00","070","0019","0257","401","213","188","6","407","1261","0","32.28","16.89"
"68","000","00","070","0020","0000","2727","1375","1352","24","2751","6959","0","39.53","19.76"
"68","000","00","070","0020","0279","717","397","320","7","724","1788","0","40.49","22.20"
"68","000","00","070","0020","0280","669","322","347","5","674","1712","0","39.37","18.81"
"68","000","00","070","0020","0281","710","350","360","3","713","1734","0","41.12","20.18"
"68","000","00","070","0020","0282","631","306","325","9","640","1725","0","37.10","17.74"
"68","000","00","070","0021","0000","911","408","503","7","918","2303","0","39.86","17.72"
"68","000","00","070","0021","0299","416","172","244","2","418","1137","0","36.76","15.13"
"68","000","00","070","0021","0300","495","236","259","5","500","1166","0","42.88","20.24"
"68","000","00","070","0022","0000","1683","839","844","23","1706","5268","0","32.38","15.93"
"68","000","00","070","0022","0292","593","320","273","7","600","1794","0","33.44","17.84"
"68","000","00","070","0022","0293","502","236","266","7","509","1622","0","31.38","14.55"
"68","000","00","070","0022","0294","588","283","305","9","597","1852","0","32.24","15.28"
"68","000","00","070","0023","0000","783","392","391","8","791","1960","0","40.36","20.00"
"68","000","00","070","0023","0321","604","303","301","7","611","1459","0","41.88","20.77"
"68","000","00","070","0023","0322","179","89","90","1","180","501","0","35.93","17.76"
"68","000","00","070","0024","0000","1335","586","749","14","1349","3423","0","39.41","17.12"
"68","000","00","070","0024","0329","794","336","458","6","800","1893","0","42.26","17.75"
"68","000","00","070","0024","0330","541","250","291","8","549","1530","0","35.88","16.34"
"68","000","00","070","0025","0000","2355","1110","1245","18","2373","6098","0","38.91","18.20"
"68","000","00","070","0025","0301","756","323","433","11","767","1934","0","39.66","16.70"
"68","000","00","070","0025","0302","504","248","256","2","506","1362","0","37.15","18.21"
"68","000","00","070","0025","0303","536","268","268","2","538","1420","0","37.89","18.87"
"68","000","00","070","0025","0304","559","271","288","3","562","1382","0","40.67","19.61"
"68","000","00","070","0026","0000","1407","646","761","10","1417","3965","0","35.74","16.29"
"68","000","00","070","0026","0313","458","225","233","3","461","1201","0","38.38","18.73"
"68","000","00","070","0026","0314","342","174","168","5","347","987","0","35.16","17.63"
"68","000","00","070","0026","0315","607","247","360","2","609","1777","0","34.27","13.90"
"68","000","00","070","0027","0000","2036","1015","1021","20","2056","5410","0","38.00","18.76"
"68","000","00","070","0027","0258","643","308","335","10","653","1690","0","38.64","18.22"
"68","000","00","070","0027","0259","686","350","336","7","693","1854","0","37.38","18.88"
"68","000","00","070","0027","0260","707","357","350","3","710","1866","0","38.05","19.13"
"68","000","00","070","0028","0000","3524","1665","1859","29","3553","8945","0","39.72","18.61"
"68","000","00","070","0028","0261","559","264","295","3","562","1485","0","37.85","17.78"
"68","000","00","070","0028","0262","564","256","308","6","570","1387","0","41.10","18.46"
"68","000","00","070","0028","0263","652","321","331","6","658","1533","0","42.92","20.94"
"68","000","00","070","0028","0264","685","317","368","4","689","1675","0","41.13","18.93"
"68","000","00","070","0028","0265","519","230","289","5","524","1402","0","37.38","16.41"
"68","000","00","070","0028","0266","545","277","268","5","550","1463","0","37.59","18.93"
"68","000","00","070","0029","0000","1768","755","1013","11","1779","4161","0","42.75","18.14"
"68","000","00","070","0029","0295","555","243","312","4","559","1426","0","39.20","17.04"
"68","000","00","070","0029","0296","562","236","326","3","565","1412","0","40.01","16.71"
"68","000","00","070","0029","0297","651","276","375","4","655","1323","0","49.51","20.86"
"68","000","00","070","0030","0000","931","582","349","11","942","3071","0","30.67","18.95"
"68","000","00","070","0030","0311","692","480","212","11","703","1528","0","46.01","31.41"
"68","000","00","070","0030","0312","239","102","137","0","239","1543","0","15.49","6.61"
"68","000","00","070","0031","0000","3128","1674","1454","24","3152","7571","0","41.63","22.11"
"68","000","00","070","0031","0283","605","318","287","5","610","1352","0","45.12","23.52"
"68","000","00","070","0031","0284","770","404","366","8","778","1899","0","40.97","21.27"
"68","000","00","070","0031","0285","515","287","228","4","519","1304","0","39.80","22.01"
"68","000","00","070","0031","0286","536","296","240","5","541","1365","0","39.63","21.68"
"68","000","00","070","0031","0287","702","369","333","2","704","1651","0","42.64","22.35"
"68","000","00","070","0032","0000","1372","698","674","10","1382","3109","0","44.45","22.45"
"68","000","00","070","0032","0316","719","359","360","5","724","1633","0","44.34","21.98"
"68","000","00","070","0032","0317","653","339","314","5","658","1476","0","44.58","22.97"
"68","000","00","080","0000","0000","67633","35044","32589","693","68326","172627","209448","39.58","20.30"
"68","000","00","080","0001","0000","2936","1496","1440","24","2960","9275","0","31.91","16.13"
"68","000","00","080","0001","0342","570","309","261","2","572","1693","0","33.79","18.25"
"68","000","00","080","0001","0343","564","280","284","8","572","1744","0","32.80","16.06"
"68","000","00","080","0001","0344","561","290","271","5","566","1597","0","35.44","18.16"
"68","000","00","080","0001","0345","516","273","243","6","522","1434","0","36.40","19.04"
"68","000","00","080","0001","0346","528","263","265","2","530","1402","0","37.80","18.76"
"68","000","00","080","0001","0347","197","81","116","1","198","1405","0","14.09","5.77"
"68","000","00","080","0002","0000","3370","1667","1703","22","3392","9960","0","34.06","16.74"
"68","000","00","080","0002","0348","602","285","317","2","604","1932","0","31.26","14.75"
"68","000","00","080","0002","0349","610","316","294","4","614","1941","0","31.63","16.28"
"68","000","00","080","0002","0350","662","335","327","7","669","1605","0","41.68","20.87"
"68","000","00","080","0002","0351","458","224","234","4","462","1536","0","30.08","14.58"
"68","000","00","080","0002","0352","564","301","263","5","569","1475","0","38.58","20.41"
"68","000","00","080","0002","0353","474","206","268","0","474","1471","0","32.22","14.00"
"68","000","00","080","0003","0000","1670","904","766","8","1678","4926","0","34.06","18.35"
"68","000","00","080","0003","0354","576","298","278","4","580","1519","0","38.18","19.62"
"68","000","00","080","0003","0355","630","364","266","1","631","1832","0","34.44","19.87"
"68","000","00","080","0003","0356","464","242","222","3","467","1575","0","29.65","15.37"
"68","000","00","080","0004","0000","1319","759","560","34","1353","3178","0","42.57","23.88"
"68","000","00","080","0004","0362","653","355","298","14","667","1582","0","42.16","22.44"
"68","000","00","080","0004","0363","666","404","262","20","686","1596","0","42.98","25.31"
"68","000","00","080","0005","0000","1341","833","508","27","1368","3521","0","38.85","23.66"
"68","000","00","080","0005","0364","690","424","266","14","704","1668","0","42.21","25.42"
"68","000","00","080","0005","0365","651","409","242","13","664","1853","0","35.83","22.07"
"68","000","00","080","0006","0000","1299","869","430","22","1321","3201","0","41.27","27.15"
"68","000","00","080","0006","0366","652","438","214","18","670","1588","0","42.19","27.58"
"68","000","00","080","0006","0367","647","431","216","4","651","1613","0","40.36","26.72"
"68","000","00","080","0007","0000","1267","581","686","9","1276","3233","0","39.47","17.97"
"68","000","00","080","0007","0370","643","300","343","5","648","1665","0","38.92","18.02"
"68","000","00","080","0007","0371","624","281","343","4","628","1568","0","40.05","17.92"
"68","000","00","080","0008","0000","1946","1020","926","19","1965","4536","0","43.32","22.49"
"68","000","00","080","0008","0372","778","444","334","9","787","1740","0","45.23","25.52"
"68","000","00","080","0008","0373","732","373","359","7","739","1776","0","41.61","21.00"
"68","000","00","080","0008","0374","436","203","233","3","439","1020","0","43.04","19.90"
"68","000","00","080","0009","0000","1251","606","645","17","1268","3596","0","35.26","16.85"
"68","000","00","080","0009","0375","633","295","338","10","643","1809","0","35.54","16.31"
"68","000","00","080","0009","0376","618","311","307","7","625","1787","0","34.97","17.40"
"68","000","00","080","0010","0000","823","373","450","13","836","2214","0","37.76","16.85"
"68","000","00","080","0010","0377","384","202","182","9","393","1091","0","36.02","18.52"
"68","000","00","080","0010","0378","439","171","268","4","443","1123","0","39.45","15.23"
"68","000","00","080","0011","0000","927","396","531","4","931","2537","0","36.70","15.61"
"68","000","00","080","0011","0384","476","212","264","1","477","1336","0","35.70","15.87"
"68","000","00","080","0011","0385","451","184","267","3","454","1201","0","37.80","15.32"
"68","000","00","080","0012","0000","1490","682","808","14","1504","3852","0","39.04","17.71"
"68","000","00","080","0012","0388","577","251","326","2","579","1366","0","42.39","18.37"
"68","000","00","080","0012","0389","409","202","207","7","416","1183","0","35.16","17.08"
"68","000","00","080","0012","0390","504","229","275","5","509","1303","0","39.06","17.57"
"68","000","00","080","0013","0000","1265","570","695","14","1279","3101","0","41.24","18.38"
"68","000","00","080","0013","0393","760","334","426","9","769","1902","0","40.43","17.56"
"68","000","00","080","0013","0394","505","236","269","5","510","1199","0","42.54","19.68"
"68","000","00","080","0014","0000","1471","633","838","12","1483","3930","0","37.74","16.11"
"68","000","00","080","0014","0395","586","256","330","4","590","1408","0","41.90","18.18"
"68","000","00","080","0014","0396","469","192","277","3","472","1273","0","37.08","15.08"
"68","000","00","080","0014","0397","416","185","231","5","421","1249","0","33.71","14.81"
"68","000","00","080","0015","0000","1370","579","791","17","1387","3486","0","39.79","16.61"
"68","000","00","080","0015","0405","528","198","330","4","532","1348","0","39.47","14.69"
"68","000","00","080","0015","0406","385","178","207","8","393","1052","0","37.36","16.92"
"68","000","00","080","0015","0407","457","203","254","5","462","1086","0","42.54","18.69"
"68","000","00","080","0016","0000","1514","744","770","9","1523","3792","0","40.16","19.62"
"68","000","00","080","0016","0409","517","256","261","7","524","1312","0","39.94","19.51"
"68","000","00","080","0016","0410","576","242","334","2","578","1356","0","42.63","17.85"
"68","000","00","080","0016","0411","421","246","175","0","421","1124","0","37.46","21.89"
"68","000","00","080","0017","0000","3003","1778","1225","35","3038","7352","0","41.32","24.18"
"68","000","00","080","0017","0418","571","380","191","5","576","1557","0","36.99","24.41"
"68","000","00","080","0017","0419","612","352","260","5","617","1341","0","46.01","26.25"
"68","000","00","080","0017","0420","569","325","244","8","577","1505","0","38.34","21.59"
"68","000","00","080","0017","0421","666","434","232","8","674","1575","0","42.79","27.56"
"68","000","00","080","0017","0422","585","287","298","9","594","1374","0","43.23","20.89"
"68","000","00","080","0018","0000","664","290","374","1","665","1505","0","44.19","19.27"
"68","000","00","080","0018","0431","664","290","374","1","665","1505","0","44.19","19.27"
"68","000","00","080","0019","0000","1425","669","756","12","1437","3312","0","43.39","20.20"
"68","000","00","080","0019","0433","713","289","424","4","717","1634","0","43.88","17.69"
"68","000","00","080","0019","0434","712","380","332","8","720","1678","0","42.91","22.65"
"68","000","00","080","0020","0000","1451","813","638","15","1466","3738","0","39.22","21.75"
"68","000","00","080","0020","0435","435","267","168","7","442","1219","0","36.26","21.90"
"68","000","00","080","0020","0436","502","236","266","5","507","1235","0","41.05","19.11"
"68","000","00","080","0020","0437","514","310","204","3","517","1284","0","40.26","24.14"
"68","000","00","080","0021","0000","714","369","345","6","720","1789","0","40.25","20.63"
"68","000","00","080","0021","0438","714","369","345","6","720","1789","0","40.25","20.63"
"68","000","00","080","0022","0000","2319","1187","1132","17","2336","5181","0","45.09","22.91"
"68","000","00","080","0022","0448","893","517","376","3","896","1752","0","51.14","29.51"
"68","000","00","080","0022","0449","725","338","387","7","732","1769","0","41.38","19.11"
"68","000","00","080","0022","0450","701","332","369","7","708","1660","0","42.65","20.00"
"68","000","00","080","0023","0000","1688","819","869","14","1702","4113","0","41.38","19.91"
"68","000","00","080","0023","0453","512","225","287","4","516","1303","0","39.60","17.27"
"68","000","00","080","0023","0454","553","274","279","7","560","1385","0","40.43","19.78"
"68","000","00","080","0023","0455","623","320","303","3","626","1425","0","43.93","22.46"
"68","000","00","080","0024","0000","1269","695","574","30","1299","3515","0","36.96","19.77"
"68","000","00","080","0024","0425","468","216","252","11","479","1470","0","32.59","14.69"
"68","000","00","080","0024","0426","275","239","36","13","288","624","0","46.15","38.30"
"68","000","00","080","0024","0427","526","240","286","6","532","1421","0","37.44","16.89"
"68","000","00","080","0025","0000","1063","561","502","7","1070","2531","0","42.28","22.17"
"68","000","00","080","0025","0414","558","278","280","6","564","1213","0","46.50","22.92"
"68","000","00","080","0025","0415","505","283","222","1","506","1318","0","38.39","21.47"
"68","000","00","080","0026","0000","1749","772","977","15","1764","4188","0","42.12","18.43"
"68","000","00","080","0026","0400","554","229","325","4","558","1227","0","45.48","18.66"
"68","000","00","080","0026","0401","618","273","345","7","625","1611","0","38.80","16.95"
"68","000","00","080","0026","0402","577","270","307","4","581","1350","0","43.04","20.00"
"68","000","00","080","0027","0000","1789","1098","691","16","1805","4256","0","42.41","25.80"
"68","000","00","080","0027","0439","610","377","233","2","612","1442","0","42.44","26.14"
"68","000","00","080","0027","0440","537","325","212","2","539","1327","0","40.62","24.49"
"68","000","00","080","0027","0441","642","396","246","12","654","1487","0","43.98","26.63"
"68","000","00","080","0028","0000","1578","769","809","11","1589","4161","0","38.19","18.48"
"68","000","00","080","0028","0359","627","295","332","3","630","1601","0","39.35","18.43"
"68","000","00","080","0028","0360","505","230","275","1","506","1234","0","41.00","18.64"
"68","000","00","080","0028","0361","446","244","202","7","453","1326","0","34.16","18.40"
"68","000","00","080","0029","0000","1184","622","562","21","1205","2848","0","42.31","21.84"
"68","000","00","080","0029","0423","571","294","277","15","586","1371","0","42.74","21.44"
"68","000","00","080","0029","0424","613","328","285","6","619","1477","0","41.91","22.21"
"68","000","00","080","0030","0000","1631","837","794","15","1646","4290","0","38.37","19.51"
"68","000","00","080","0030","0445","619","314","305","2","621","1461","0","42.51","21.49"
"68","000","00","080","0030","0446","501","258","243","12","513","1413","0","36.31","18.26"
"68","000","00","080","0030","0447","511","265","246","1","512","1416","0","36.16","18.71"
"68","000","00","080","0031","0000","1332","567","765","18","1350","3074","0","43.92","18.45"
"68","000","00","080","0031","0451","677","239","438","10","687","1546","0","44.44","15.46"
"68","000","00","080","0031","0452","655","328","327","8","663","1528","0","43.39","21.47"
"68","000","00","080","0032","0000","808","361","447","8","816","2030","0","40.20","17.78"
"68","000","00","080","0032","0398","430","193","237","6","436","1003","0","43.47","19.24"
"68","000","00","080","0032","0399","378","168","210","2","380","1027","0","37.00","16.36"
"68","000","00","080","0033","0000","1462","651","811","13","1475","3632","0","40.61","17.92"
"68","000","00","080","0033","0403","730","313","417","8","738","1878","0","39.30","16.67"
"68","000","00","080","0033","0404","732","338","394","5","737","1754","0","42.02","19.27"
"68","000","00","080","0034","0000","607","230","377","3","610","1474","0","41.38","15.60"
"68","000","00","080","0034","0408","607","230","377","3","610","1474","0","41.38","15.60"
"68","000","00","080","0035","0000","554","267","287","8","562","1414","0","39.75","18.88"
"68","000","00","080","0035","0432","554","267","287","8","562","1414","0","39.75","18.88"
"68","000","00","080","0036","0000","845","482","363","8","853","2222","0","38.39","21.69"
"68","000","00","080","0036","0458","432","254","178","8","440","1090","0","40.37","23.30"
"68","000","00","080","0036","0459","413","228","185","0","413","1132","0","36.48","20.14"
"68","000","00","080","0037","0000","762","369","393","13","775","1947","0","39.80","18.95"
"68","000","00","080","0037","0456","421","217","204","12","433","984","0","44.00","22.05"
"68","000","00","080","0037","0457","341","152","189","1","342","963","0","35.51","15.78"
"68","000","00","080","0038","0000","1776","929","847","13","1789","4778","0","37.44","19.44"
"68","000","00","080","0038","0381","670","351","319","7","677","1862","0","36.36","18.85"
"68","000","00","080","0038","0382","582","278","304","5","587","1457","0","40.29","19.08"
"68","000","00","080","0038","0383","524","300","224","1","525","1459","0","35.98","20.56"
"68","000","00","080","0039","0000","1235","622","613","7","1242","3114","0","39.88","19.97"
"68","000","00","080","0039","0391","634","317","317","3","637","1491","0","42.72","21.26"
"68","000","00","080","0039","0392","601","305","296","4","605","1623","0","37.28","18.79"
"68","000","00","080","0040","0000","1121","491","630","12","1133","2788","0","40.64","17.61"
"68","000","00","080","0040","0357","600","247","353","7","607","1554","0","39.06","15.89"
"68","000","00","080","0040","0358","521","244","277","5","526","1234","0","42.63","19.77"
"68","000","00","080","0041","0000","1065","585","480","15","1080","2512","0","42.99","23.29"
"68","000","00","080","0041","0412","511","271","240","13","524","1195","0","43.85","22.68"
"68","000","00","080","0041","0413","554","314","240","2","556","1317","0","42.22","23.84"
"68","000","00","080","0042","0000","1786","977","809","12","1798","4144","0","43.39","23.58"
"68","000","00","080","0042","0442","578","303","275","0","578","1313","0","44.02","23.08"
"68","000","00","080","0042","0443","645","337","308","8","653","1440","0","45.35","23.40"
"68","000","00","080","0042","0444","563","337","226","4","567","1391","0","40.76","24.23"
"68","000","00","080","0043","0000","1536","860","676","9","1545","3923","0","39.38","21.92"
"68","000","00","080","0043","0460","569","334","235","6","575","1412","0","40.72","23.65"
"68","000","00","080","0043","0461","478","259","219","2","480","1234","0","38.90","20.99"
"68","000","00","080","0043","0462","489","267","222","1","490","1277","0","38.37","20.91"
"68","000","00","080","0044","0000","1201","567","634","12","1213","2667","0","45.48","21.26"
"68","000","00","080","0044","0368","559","224","335","5","564","1302","0","43.32","17.20"
"68","000","00","080","0044","0369","642","343","299","7","649","1365","0","47.55","25.13"
"68","000","00","080","0045","0000","951","728","223","13","964","2166","0","44.51","33.61"
"68","000","00","080","0045","0379","467","363","104","8","475","1151","0","41.27","31.54"
"68","000","00","080","0045","0380","484","365","119","5","489","1015","0","48.18","35.96"
"68","000","00","080","0046","0000","1728","1350","378","31","1759","4338","0","40.55","31.12"
"68","000","00","080","0046","0428","598","456","142","5","603","1490","0","40.47","30.60"
"68","000","00","080","0046","0429","627","522","105","15","642","1550","0","41.42","33.68"
"68","000","00","080","0046","0430","503","372","131","11","514","1298","0","39.60","28.66"
"68","000","00","080","0047","0000","1062","496","566","14","1076","2762","0","38.96","17.96"
"68","000","00","080","0047","0386","508","240","268","7","515","1340","0","38.43","17.91"
"68","000","00","080","0047","0387","554","256","298","7","561","1422","0","39.45","18.00"
"68","000","00","080","0048","0000","1016","521","495","4","1020","2525","0","40.40","20.63"
"68","000","00","080","0048","0416","490","290","200","3","493","1152","0","42.80","25.17"
"68","000","00","080","0048","0417","526","231","295","1","527","1373","0","38.38","16.82"
"68","000","00","090","0000","0000","41213","24057","17156","358","41571","103835","124481","40.04","23.17"
"68","000","00","090","0001","0000","1691","850","841","13","1704","4655","0","36.61","18.26"
"68","000","00","090","0001","1161","594","325","269","5","599","1609","0","37.23","20.20"
"68","000","00","090","0001","1162","519","206","313","1","520","1528","0","34.03","13.48"
"68","000","00","090","0001","1163","578","319","259","7","585","1518","0","38.54","21.01"
"68","000","00","090","0002","0000","2295","1287","1008","20","2315","5884","0","39.34","21.87"
"68","000","00","090","0002","1166","738","368","370","7","745","2241","0","33.24","16.42"
"68","000","00","090","0002","1167","420","260","160","2","422","990","0","42.63","26.26"
"68","000","00","090","0002","1168","432","228","204","2","434","1055","0","41.14","21.61"
"68","000","00","090","0002","1169","705","431","274","9","714","1598","0","44.68","26.97"
"68","000","00","090","0003","0000","1491","830","661","11","1502","4416","0","34.01","18.80"
"68","000","00","090","0003","1172","506","243","263","3","509","1476","0","34.49","16.46"
"68","000","00","090","0003","1173","495","295","200","6","501","1595","0","31.41","18.50"
"68","000","00","090","0003","1174","490","292","198","2","492","1345","0","36.58","21.71"
"68","000","00","090","0004","0000","1196","578","618","8","1204","3205","0","37.57","18.03"
"68","000","00","090","0004","1226","637","329","308","4","641","1634","0","39.23","20.13"
"68","000","00","090","0004","1227","559","249","310","4","563","1571","0","35.84","15.85"
"68","000","00","090","0006","0000","1323","735","588","11","1334","3744","0","35.63","19.63"
"68","000","00","090","0006","1178","482","264","218","4","486","1287","0","37.76","20.51"
"68","000","00","090","0006","1179","458","259","199","4","462","1312","0","35.21","19.74"
"68","000","00","090","0006","1180","383","212","171","3","386","1145","0","33.71","18.52"
"68","000","00","090","0007","0000","1577","845","732","12","1589","4226","0","37.60","20.00"
"68","000","00","090","0007","1183","564","284","280","6","570","1419","0","40.17","20.01"
"68","000","00","090","0007","1184","450","256","194","4","454","1307","0","34.74","19.59"
"68","000","00","090","0007","1185","563","305","258","2","565","1500","0","37.67","20.33"
"68","000","00","090","0008","0000","281","88","193","2","283","652","0","43.40","13.50"
"68","000","00","090","0008","1233","281","88","193","2","283","652","0","43.40","13.50"
"68","000","00","090","0009","0000","1718","907","811","9","1727","4406","0","39.20","20.59"
"68","000","00","090","0009","1188","599","292","307","5","604","1769","0","34.14","16.51"
"68","000","00","090","0009","1189","575","295","280","2","577","1335","0","43.22","22.10"
"68","000","00","090","0009","1190","544","320","224","2","546","1302","0","41.94","24.58"
"68","000","00","090","0010","0000","2147","1371","776","16","2163","5430","0","39.83","25.25"
"68","000","00","090","0010","1196","589","362","227","6","595","1390","0","42.81","26.04"
"68","000","00","090","0010","1197","530","351","179","6","536","1343","0","39.91","26.14"
"68","000","00","090","0010","1198","496","321","175","2","498","1340","0","37.16","23.96"
"68","000","00","090","0010","1199","532","337","195","2","534","1357","0","39.35","24.83"
"68","000","00","090","0011","0000","836","415","421","5","841","1835","0","45.83","22.62"
"68","000","00","090","0011","1191","413","217","196","3","416","909","0","45.76","23.87"
"68","000","00","090","0011","1192","423","198","225","2","425","926","0","45.90","21.38"
"68","000","00","090","0012","0000","1620","821","799","23","1643","4539","0","36.20","18.09"
"68","000","00","090","0012","1228","597","270","327","14","611","1583","0","38.60","17.06"
"68","000","00","090","0012","1229","471","226","245","6","477","1395","0","34.19","16.20"
"68","000","00","090","0012","1230","552","325","227","3","555","1561","0","35.55","20.82"
"68","000","00","090","0013","0000","1441","851","590","12","1453","3741","0","38.84","22.75"
"68","000","00","090","0013","1202","572","356","216","5","577","1337","0","43.16","26.63"
"68","000","00","090","0013","1203","445","253","192","4","449","1293","0","34.73","19.57"
"68","000","00","090","0013","1204","424","242","182","3","427","1111","0","38.43","21.78"
"68","000","00","090","0014","0000","1573","960","613","11","1584","4232","0","37.43","22.68"
"68","000","00","090","0014","1210","477","307","170","4","481","1259","0","38.20","24.38"
"68","000","00","090","0014","1211","544","346","198","3","547","1406","0","38.90","24.61"
"68","000","00","090","0014","1212","552","307","245","4","556","1567","0","35.48","19.59"
"68","000","00","090","0015","0000","1567","1041","526","16","1583","3420","0","46.29","30.44"
"68","000","00","090","0015","1215","772","457","315","7","779","1765","0","44.14","25.89"
"68","000","00","090","0015","1216","795","584","211","9","804","1655","0","48.58","35.29"
"68","000","00","090","0016","0000","1187","719","468","7","1194","2574","0","46.39","27.93"
"68","000","00","090","0016","1231","321","141","180","2","323","857","0","37.69","16.45"
"68","000","00","090","0016","1232","866","578","288","5","871","1717","0","50.73","33.66"
"68","000","00","090","0017","0000","606","268","338","8","614","1466","0","41.88","18.28"
"68","000","00","090","0017","1217","606","268","338","8","614","1466","0","41.88","18.28"
"68","000","00","090","0018","0000","1033","562","471","6","1039","2332","0","44.55","24.10"
"68","000","00","090","0018","1218","550","293","257","3","553","1270","0","43.54","23.07"
"68","000","00","090","0018","1219","483","269","214","3","486","1062","0","45.76","25.33"
"68","000","00","090","0019","0000","1449","925","524","11","1460","3072","0","47.53","30.11"
"68","000","00","090","0019","1220","688","413","275","4","692","1581","0","43.77","26.12"
"68","000","00","090","0019","1221","761","512","249","7","768","1491","0","51.51","34.34"
"68","000","00","090","0020","0000","1079","575","504","12","1091","2825","0","38.62","20.35"
"68","000","00","090","0020","1164","494","263","231","6","500","1359","0","36.79","19.35"
"68","000","00","090","0020","1165","585","312","273","6","591","1466","0","40.31","21.28"
"68","000","00","090","0021","0000","1011","498","513","8","1019","2613","0","39.00","19.06"
"68","000","00","090","0021","1170","445","213","232","5","450","1213","0","37.10","17.56"
"68","000","00","090","0021","1171","566","285","281","3","569","1400","0","40.64","20.36"
"68","000","00","090","0022","0000","1964","1373","591","16","1980","4262","0","46.46","32.21"
"68","000","00","090","0022","1175","693","483","210","6","699","1532","0","45.63","31.53"
"68","000","00","090","0022","1176","695","476","219","7","702","1564","0","44.88","30.43"
"68","000","00","090","0022","1177","576","414","162","3","579","1166","0","49.66","35.51"
"68","000","00","090","0023","0000","1285","765","520","7","1292","3487","0","37.05","21.94"
"68","000","00","090","0023","1181","652","369","283","3","655","1677","0","39.06","22.00"
"68","000","00","090","0023","1182","633","396","237","4","637","1810","0","35.19","21.88"
"68","000","00","090","0024","0000","1137","558","579","8","1145","2995","0","38.23","18.63"
"68","000","00","090","0024","1186","528","238","290","2","530","1344","0","39.43","17.71"
"68","000","00","090","0024","1187","609","320","289","6","615","1651","0","37.25","19.38"
"68","000","00","090","0025","0000","1832","1081","751","19","1851","4094","0","45.21","26.40"
"68","000","00","090","0025","1193","673","404","269","7","680","1424","0","47.75","28.37"
"68","000","00","090","0025","1194","454","250","204","6","460","1033","0","44.53","24.20"
"68","000","00","090","0025","1195","705","427","278","6","711","1637","0","43.43","26.08"
"68","000","00","090","0026","0000","1383","888","495","16","1399","3238","0","43.21","27.42"
"68","000","00","090","0026","1200","738","425","313","9","747","1719","0","43.46","24.72"
"68","000","00","090","0026","1201","645","463","182","7","652","1519","0","42.92","30.48"
"68","000","00","090","0027","0000","556","343","213","6","562","1491","0","37.69","23.00"
"68","000","00","090","0027","1205","556","343","213","6","562","1491","0","37.69","23.00"
"68","000","00","090","0028","0000","1464","987","477","21","1485","3992","0","37.20","24.72"
"68","000","00","090","0028","1207","412","286","126","10","422","1322","0","31.92","21.63"
"68","000","00","090","0028","1208","461","317","144","5","466","1325","0","35.17","23.92"
"68","000","00","090","0028","1209","591","384","207","6","597","1345","0","44.39","28.55"
"68","000","00","090","0029","0000","771","483","288","10","781","2314","0","33.75","20.87"
"68","000","00","090","0029","1213","407","233","174","8","415","1280","0","32.42","18.20"
"68","000","00","090","0029","1214","364","250","114","2","366","1034","0","35.40","24.18"
"68","000","00","090","0030","0000","1784","1257","527","9","1793","3664","0","48.94","34.31"
"68","000","00","090","0030","1222","870","624","246","3","873","1832","0","47.65","34.06"
"68","000","00","090","0030","1223","914","633","281","6","920","1832","0","50.22","34.55"
"68","000","00","090","0031","0000","1436","960","476","17","1453","3448","0","42.14","27.84"
"68","000","00","090","0031","1224","720","482","238","6","726","1776","0","40.88","27.14"
"68","000","00","090","0031","1225","716","478","238","11","727","1672","0","43.48","28.59"
"68","000","00","090","0032","0000","480","236","244","8","488","1583","0","30.83","14.91"
"68","000","00","090","0032","1206","480","236","244","8","488","1583","0","30.83","14.91"
"68","000","00","100","0000","0000","76179","41642","34537","734","76913","187597","228672","41.00","22.20"
"68","000","00","100","0001","0000","1804","947","857","20","1824","4741","0","38.47","19.97"
"68","000","00","100","0001","0996","678","378","300","8","686","1721","0","39.86","21.96"
"68","000","00","100","0001","0997","568","277","291","7","575","1592","0","36.12","17.40"
"68","000","00","100","0001","0998","558","292","266","5","563","1428","0","39.43","20.45"
"68","000","00","100","0002","0000","1909","879","1030","10","1919","4288","0","44.75","20.50"
"68","000","00","100","0002","0999","710","291","419","5","715","1682","0","42.51","17.30"
"68","000","00","100","0002","1000","543","241","302","3","546","1318","0","41.43","18.29"
"68","000","00","100","0002","1001","656","347","309","2","658","1288","0","51.09","26.94"
"68","000","00","100","0003","0000","2289","1287","1002","12","2301","5412","0","42.52","23.78"
"68","000","00","100","0003","0981","573","327","246","4","577","1290","0","44.73","25.35"
"68","000","00","100","0003","0982","557","325","232","4","561","1357","0","41.34","23.95"
"68","000","00","100","0003","0983","580","307","273","2","582","1407","0","41.36","21.82"
"68","000","00","100","0003","0984","579","328","251","2","581","1358","0","42.78","24.15"
"68","000","00","100","0004","0000","2508","1303","1205","21","2529","5467","0","46.26","23.83"
"68","000","00","100","0004","0971","598","238","360","0","598","1293","0","46.25","18.41"
"68","000","00","100","0004","0972","580","307","273","4","584","1283","0","45.52","23.93"
"68","000","00","100","0004","0973","696","396","300","8","704","1411","0","49.89","28.07"
"68","000","00","100","0004","0974","634","362","272","9","643","1480","0","43.45","24.46"
"68","000","00","100","0005","0000","2049","1156","893","18","2067","5228","0","39.54","22.11"
"68","000","00","100","0005","0988","587","324","263","7","594","1353","0","43.90","23.95"
"68","000","00","100","0005","0989","564","316","248","5","569","1292","0","44.04","24.46"
"68","000","00","100","0005","0990","480","275","205","4","484","1303","0","37.15","21.11"
"68","000","00","100","0005","0991","418","241","177","2","420","1280","0","32.81","18.83"
"68","000","00","100","0006","0000","1664","868","796","21","1685","4332","0","38.90","20.04"
"68","000","00","100","0006","0964","583","302","281","10","593","1437","0","41.27","21.02"
"68","000","00","100","0006","0965","576","288","288","5","581","1466","0","39.63","19.65"
"68","000","00","100","0006","0966","505","278","227","6","511","1429","0","35.76","19.45"
"68","000","00","100","0007","0000","1579","800","779","16","1595","3659","0","43.59","21.86"
"68","000","00","100","0007","1007","461","229","232","6","467","1123","0","41.59","20.39"
"68","000","00","100","0007","1008","545","249","296","7","552","1253","0","44.05","19.87"
"68","000","00","100","0007","1009","573","322","251","3","576","1283","0","44.89","25.10"
"68","000","00","100","0008","0000","2363","1311","1052","28","2391","6520","0","36.67","20.11"
"68","000","00","100","0008","1015","455","244","211","6","461","2312","0","19.94","10.55"
"68","000","00","100","0008","1016","475","231","244","5","480","974","0","49.28","23.72"
"68","000","00","100","0008","1017","745","430","315","10","755","1569","0","48.12","27.41"
"68","000","00","100","0008","1018","688","406","282","7","695","1665","0","41.74","24.38"
"68","000","00","100","0009","0000","1163","564","599","7","1170","2424","0","48.27","23.27"
"68","000","00","100","0009","1002","592","268","324","4","596","1217","0","48.97","22.02"
"68","000","00","100","0009","1003","571","296","275","3","574","1207","0","47.56","24.52"
"68","000","00","100","0010","0000","1574","774","800","13","1587","3911","0","40.58","19.79"
"68","000","00","100","0010","1024","442","197","245","5","447","989","0","45.20","19.92"
"68","000","00","100","0010","1025","578","281","297","7","585","1454","0","40.23","19.33"
"68","000","00","100","0010","1026","554","296","258","1","555","1468","0","37.81","20.16"
"68","000","00","100","0011","0000","1701","854","847","12","1713","3974","0","43.11","21.49"
"68","000","00","100","0011","1029","587","266","321","6","593","1436","0","41.30","18.52"
"68","000","00","100","0011","1030","576","268","308","5","581","1386","0","41.92","19.34"
"68","000","00","100","0011","1031","538","320","218","1","539","1152","0","46.79","27.78"
"68","000","00","100","0012","0000","1670","845","825","18","1688","4457","0","37.87","18.96"
"68","000","00","100","0012","0928","502","235","267","4","506","1464","0","34.56","16.05"
"68","000","00","100","0012","0929","628","313","315","8","636","1551","0","41.01","20.18"
"68","000","00","100","0012","0930","540","297","243","6","546","1442","0","37.86","20.60"
"68","000","00","100","0013","0000","2264","1215","1049","15","2279","5771","0","39.49","21.05"
"68","000","00","100","0013","0933","609","318","291","3","612","1562","0","39.18","20.36"
"68","000","00","100","0013","0934","569","323","246","2","571","1364","0","41.86","23.68"
"68","000","00","100","0013","0935","582","305","277","6","588","1441","0","40.80","21.17"
"68","000","00","100","0013","0936","504","269","235","4","508","1404","0","36.18","19.16"
"68","000","00","100","0014","0000","1890","1156","734","34","1924","4674","0","41.16","24.73"
"68","000","00","100","0014","0956","476","280","196","8","484","1232","0","39.29","22.73"
"68","000","00","100","0014","0957","473","280","193","6","479","1183","0","40.49","23.67"
"68","000","00","100","0014","0958","400","299","101","15","415","1001","0","41.46","29.87"
"68","000","00","100","0014","0959","541","297","244","5","546","1258","0","43.40","23.61"
"68","000","00","100","0015","0000","908","547","361","7","915","2330","0","39.27","23.48"
"68","000","00","100","0015","0948","421","254","167","1","422","1134","0","37.21","22.40"
"68","000","00","100","0015","0949","487","293","194","6","493","1196","0","41.22","24.50"
"68","000","00","100","0016","0000","2114","1193","921","22","2136","5189","0","41.16","22.99"
"68","000","00","100","0016","0952","495","254","241","5","500","1328","0","37.65","19.13"
"68","000","00","100","0016","0953","514","293","221","9","523","1293","0","40.45","22.66"
"68","000","00","100","0016","0954","549","324","225","5","554","1304","0","42.48","24.85"
"68","000","00","100","0016","0955","556","322","234","3","559","1264","0","44.22","25.47"
"68","000","00","100","0017","0000","1115","735","380","14","1129","2791","0","40.45","26.33"
"68","000","00","100","0017","1050","527","349","178","9","536","1344","0","39.88","25.97"
"68","000","00","100","0017","1051","588","386","202","5","593","1447","0","40.98","26.68"
"68","000","00","100","0018","0000","1305","857","448","11","1316","3322","0","39.61","25.80"
"68","000","00","100","0018","1052","688","428","260","6","694","1699","0","40.85","25.19"
"68","000","00","100","0018","1053","617","429","188","5","622","1623","0","38.32","26.43"
"68","000","00","100","0019","0000","1067","761","306","15","1082","2548","0","42.46","29.87"
"68","000","00","100","0019","1057","453","300","153","3","456","1119","0","40.75","26.81"
"68","000","00","100","0019","1058","614","461","153","12","626","1429","0","43.81","32.26"
"68","000","00","100","0020","0000","918","615","303","10","928","1945","0","47.71","31.62"
"68","000","00","100","0020","1055","512","358","154","1","513","1087","0","47.19","32.93"
"68","000","00","100","0020","1056","406","257","149","9","415","858","0","48.37","29.95"
"68","000","00","100","0021","0000","601","430","171","4","605","1318","0","45.90","32.63"
"68","000","00","100","0021","1054","601","430","171","4","605","1318","0","45.90","32.63"
"68","000","00","100","0022","0000","699","518","181","15","714","1650","0","43.27","31.39"
"68","000","00","100","0022","1059","699","518","181","15","714","1650","0","43.27","31.39"
"68","000","00","100","0023","0000","1719","863","856","18","1737","4292","0","40.47","20.11"
"68","000","00","100","0023","1035","567","232","335","4","571","1260","0","45.32","18.41"
"68","000","00","100","0023","1036","642","370","272","7","649","1632","0","39.77","22.67"
"68","000","00","100","0023","1037","510","261","249","7","517","1400","0","36.93","18.64"
"68","000","00","100","0024","0000","2053","972","1081","22","2075","5410","0","38.35","17.97"
"68","000","00","100","0024","1046","406","150","256","5","411","1095","0","37.53","13.70"
"68","000","00","100","0024","1047","607","294","313","6","613","1440","0","42.57","20.42"
"68","000","00","100","0024","1048","522","229","293","4","526","1327","0","39.64","17.26"
"68","000","00","100","0024","1049","518","299","219","7","525","1548","0","33.91","19.32"
"68","000","00","100","0025","0000","1017","659","358","6","1023","2812","0","36.38","23.44"
"68","000","00","100","0025","1041","515","332","183","5","520","1377","0","37.76","24.11"
"68","000","00","100","0025","1042","502","327","175","1","503","1435","0","35.05","22.79"
"68","000","00","100","0026","0000","1594","941","653","23","1617","4358","0","37.10","21.59"
"68","000","00","100","0026","1043","541","329","212","6","547","1522","0","35.94","21.62"
"68","000","00","100","0026","1044","523","291","232","8","531","1471","0","36.10","19.78"
"68","000","00","100","0026","1045","530","321","209","9","539","1365","0","39.49","23.52"
"68","000","00","100","0027","0000","1196","559","637","19","1215","3084","0","39.40","18.13"
"68","000","00","100","0027","0931","558","237","321","7","565","1378","0","41.00","17.20"
"68","000","00","100","0027","0932","638","322","316","12","650","1706","0","38.10","18.87"
"68","000","00","100","0028","0000","2956","1516","1440","19","2975","6850","0","43.43","22.13"
"68","000","00","100","0028","0992","838","404","434","6","844","1785","0","47.28","22.63"
"68","000","00","100","0028","0993","708","343","365","2","710","1619","0","43.85","21.19"
"68","000","00","100","0028","0994","709","367","342","6","715","1672","0","42.76","21.95"
"68","000","00","100","0028","0995","701","402","299","5","706","1774","0","39.80","22.66"
"68","000","00","100","0029","0000","711","390","321","9","720","1755","0","41.03","22.22"
"68","000","00","100","0029","0960","711","390","321","9","720","1755","0","41.03","22.22"
"68","000","00","100","0030","0000","1546","900","646","10","1556","4511","0","34.49","19.95"
"68","000","00","100","0030","0961","568","328","240","4","572","1675","0","34.15","19.58"
"68","000","00","100","0030","0962","508","293","215","4","512","1408","0","36.36","20.81"
"68","000","00","100","0030","0963","470","279","191","2","472","1428","0","33.05","19.54"
"68","000","00","100","0031","0000","1698","805","893","21","1719","3871","0","44.41","20.80"
"68","000","00","100","0031","0975","624","302","322","8","632","1378","0","45.86","21.92"
"68","000","00","100","0031","0976","528","243","285","7","535","1241","0","43.11","19.58"
"68","000","00","100","0031","0977","546","260","286","6","552","1252","0","44.09","20.77"
"68","000","00","100","0032","0000","1435","764","671","14","1449","3429","0","42.26","22.28"
"68","000","00","100","0032","0950","681","336","345","7","688","1650","0","41.70","20.36"
"68","000","00","100","0032","0951","754","428","326","7","761","1779","0","42.78","24.06"
"68","000","00","100","0033","0000","2436","1367","1069","24","2460","6586","0","37.35","20.76"
"68","000","00","100","0033","0937","723","426","297","5","728","1825","0","39.89","23.34"
"68","000","00","100","0033","0938","529","322","207","5","534","1782","0","29.97","18.07"
"68","000","00","100","0033","0939","628","307","321","7","635","1470","0","43.20","20.88"
"68","000","00","100","0033","0940","556","312","244","7","563","1509","0","37.31","20.68"
"68","000","00","100","0034","0000","1529","792","737","12","1541","4222","0","36.50","18.76"
"68","000","00","100","0034","0978","582","301","281","5","587","1459","0","40.23","20.63"
"68","000","00","100","0034","0979","511","273","238","4","515","1402","0","36.73","19.47"
"68","000","00","100","0034","0980","436","218","218","3","439","1361","0","32.26","16.02"
"68","000","00","100","0035","0000","1359","660","699","21","1380","3064","0","45.04","21.54"
"68","000","00","100","0035","1022","661","323","338","8","669","1531","0","43.70","21.10"
"68","000","00","100","0035","1023","698","337","361","13","711","1533","0","46.38","21.98"
"68","000","00","100","0036","0000","1667","817","850","15","1682","3878","0","43.37","21.07"
"68","000","00","100","0036","1032","551","322","229","5","556","1375","0","40.44","23.42"
"68","000","00","100","0036","1033","561","253","308","6","567","1257","0","45.11","20.13"
"68","000","00","100","0036","1034","555","242","313","4","559","1246","0","44.86","19.42"
"68","000","00","100","0037","0000","2249","1196","1053","19","2268","5110","0","44.38","23.41"
"68","000","00","100","0037","1012","793","395","398","8","801","1719","0","46.60","22.98"
"68","000","00","100","0037","1013","803","451","352","6","809","1764","0","45.86","25.57"
"68","000","00","100","0037","1014","653","350","303","5","658","1627","0","40.44","21.51"
"68","000","00","100","0038","0000","1520","985","535","16","1536","4282","0","35.87","23.00"
"68","000","00","100","0038","1038","507","334","173","6","513","1393","0","36.83","23.98"
"68","000","00","100","0038","1039","552","352","200","3","555","1337","0","41.51","26.33"
"68","000","00","100","0038","1040","461","299","162","7","468","1552","0","30.15","19.27"
"68","000","00","100","0039","0000","1264","702","562","11","1275","2823","0","45.16","24.87"
"68","000","00","100","0039","1027","597","314","283","5","602","1345","0","44.76","23.35"
"68","000","00","100","0039","1028","667","388","279","6","673","1478","0","45.53","26.25"
"68","000","00","100","0040","0000","733","336","397","3","736","1551","0","47.45","21.66"
"68","000","00","100","0040","1010","341","156","185","2","343","739","0","46.41","21.11"
"68","000","00","100","0040","1011","392","180","212","1","393","812","0","48.40","22.17"
"68","000","00","100","0041","0000","1725","989","736","11","1736","3758","0","46.19","26.32"
"68","000","00","100","0041","1004","591","347","244","2","593","1271","0","46.66","27.30"
"68","000","00","100","0041","1005","639","344","295","5","644","1376","0","46.80","25.00"
"68","000","00","100","0041","1006","495","298","197","4","499","1111","0","44.91","26.82"
"68","000","00","100","0042","0000","2197","1140","1057","20","2217","4904","0","45.21","23.25"
"68","000","00","100","0042","0985","773","382","391","9","782","1789","0","43.71","21.35"
"68","000","00","100","0042","0986","636","351","285","4","640","1442","0","44.38","24.34"
"68","000","00","100","0042","0987","788","407","381","7","795","1673","0","47.52","24.33"
"68","000","00","100","0043","0000","2181","1219","962","16","2197","5498","0","39.96","22.17"
"68","000","00","100","0043","0967","531","313","218","7","538","1345","0","40.00","23.27"
"68","000","00","100","0043","0968","592","331","261","5","597","1408","0","42.40","23.51"
"68","000","00","100","0043","0969","521","283","238","2","523","1392","0","37.57","20.33"
"68","000","00","100","0043","0970","537","292","245","2","539","1353","0","39.84","21.58"
"68","000","00","100","0044","0000","1599","971","628","15","1614","3806","0","42.41","25.51"
"68","000","00","100","0044","1019","483","291","192","1","484","1199","0","40.37","24.27"
"68","000","00","100","0044","1020","509","313","196","5","514","1209","0","42.51","25.89"
"68","000","00","100","0044","1021","607","367","240","9","616","1398","0","44.06","26.25"
"68","000","00","100","0045","0000","2021","1069","952","26","2047","5085","0","40.26","21.02"
"68","000","00","100","0045","0941","689","338","351","8","697","1842","0","37.84","18.35"
"68","000","00","100","0045","0942","578","303","275","9","587","1436","0","40.88","21.10"
"68","000","00","100","0045","0943","754","428","326","9","763","1807","0","42.22","23.69"
"68","000","00","100","0046","0000","2620","1415","1205","21","2641","6707","0","39.38","21.10"
"68","000","00","100","0046","0944","650","307","343","2","652","1806","0","36.10","17.00"
"68","000","00","100","0046","0945","636","335","301","7","643","1652","0","38.92","20.28"
"68","000","00","100","0046","0946","666","388","278","4","670","1524","0","43.96","25.46"
"68","000","00","100","0046","0947","668","385","283","8","676","1725","0","39.19","22.32"
"68","000","00","110","0000","0000","16081","7500","8581","149","16230","42036","49237","38.61","17.84"
"68","000","00","110","0001","0000","1136","574","562","12","1148","2883","0","39.82","19.91"
"68","000","00","110","0001","1234","592","302","290","7","599","1446","0","41.42","20.89"
"68","000","00","110","0001","1235","544","272","272","5","549","1437","0","38.20","18.93"
"68","000","00","110","0002","0000","1564","816","748","7","1571","3991","0","39.36","20.45"
"68","000","00","110","0002","1236","498","254","244","3","501","1337","0","37.47","19.00"
"68","000","00","110","0002","1237","486","250","236","3","489","1263","0","38.72","19.79"
"68","000","00","110","0002","1238","580","312","268","1","581","1391","0","41.77","22.43"
"68","000","00","110","0003","0000","540","254","286","3","543","1517","0","35.79","16.74"
"68","000","00","110","0003","1239","540","254","286","3","543","1517","0","35.79","16.74"
"68","000","00","110","0004","0000","1453","732","721","7","1460","4096","0","35.64","17.87"
"68","000","00","110","0004","1240","533","264","269","4","537","1368","0","39.25","19.30"
"68","000","00","110","0004","1241","481","256","225","2","483","1341","0","36.02","19.09"
"68","000","00","110","0004","1242","439","212","227","1","440","1387","0","31.72","15.28"
"68","000","00","110","0005","0000","1722","809","913","14","1736","4467","0","38.86","18.11"
"68","000","00","110","0005","1251","556","294","262","6","562","1581","0","35.55","18.60"
"68","000","00","110","0005","1252","608","279","329","4","612","1424","0","42.98","19.59"
"68","000","00","110","0005","1253","558","236","322","4","562","1462","0","38.44","16.14"
"68","000","00","110","0006","0000","886","426","460","5","891","2563","0","34.76","16.62"
"68","000","00","110","0006","1247","444","209","235","3","447","1263","0","35.39","16.55"
"68","000","00","110","0006","1248","442","217","225","2","444","1300","0","34.15","16.69"
"68","000","00","110","0007","0000","882","351","531","17","899","2292","0","39.22","15.31"
"68","000","00","110","0007","1249","506","213","293","7","513","1252","0","40.97","17.01"
"68","000","00","110","0007","1250","376","138","238","10","386","1040","0","37.12","13.27"
"68","000","00","110","0008","0000","534","233","301","6","540","1356","0","39.82","17.18"
"68","000","00","110","0008","1246","534","233","301","6","540","1356","0","39.82","17.18"
"68","000","00","110","0009","0000","570","273","297","7","577","1466","0","39.36","18.62"
"68","000","00","110","0009","1245","570","273","297","7","577","1466","0","39.36","18.62"
"68","000","00","110","0010","0000","807","340","467","18","825","2076","0","39.74","16.38"
"68","000","00","110","0010","1243","384","167","217","9","393","979","0","40.14","17.06"
"68","000","00","110","0010","1244","423","173","250","9","432","1097","0","39.38","15.77"
"68","000","00","110","0011","0000","308","132","176","2","310","730","0","42.47","18.08"
"68","000","00","110","0011","1264","308","132","176","2","310","730","0","42.47","18.08"
"68","000","00","110","0012","0000","630","298","332","7","637","1727","0","36.88","17.26"
"68","000","00","110","0012","1266","630","298","332","7","637","1727","0","36.88","17.26"
"68","000","00","110","0013","0000","385","191","194","3","388","926","0","41.90","20.63"
"68","000","00","110","0013","1265","385","191","194","3","388","926","0","41.90","20.63"
"68","000","00","110","0014","0000","493","232","261","7","500","1310","0","38.17","17.71"
"68","000","00","110","0014","1267","493","232","261","7","500","1310","0","38.17","17.71"
"68","000","00","110","0015","0000","418","186","232","4","422","1021","0","41.33","18.22"
"68","000","00","110","0015","1263","418","186","232","4","422","1021","0","41.33","18.22"
"68","000","00","110","0016","0000","901","415","486","9","910","2201","0","41.34","18.86"
"68","000","00","110","0016","1261","421","189","232","3","424","1015","0","41.77","18.62"
"68","000","00","110","0016","1262","480","226","254","6","486","1186","0","40.98","19.06"
"68","000","00","110","0017","0000","409","207","202","8","417","1020","0","40.88","20.29"
"68","000","00","110","0017","1260","409","207","202","8","417","1020","0","40.88","20.29"
"68","000","00","110","0018","0000","245","120","125","0","245","639","0","38.34","18.78"
"68","000","00","110","0018","1258","245","120","125","0","245","639","0","38.34","18.78"
"68","000","00","110","0019","0000","338","118","220","0","338","900","0","37.56","13.11"
"68","000","00","110","0019","1257","338","118","220","0","338","900","0","37.56","13.11"
"68","000","00","110","0020","0000","412","176","236","7","419","1072","0","39.09","16.42"
"68","000","00","110","0020","1259","412","176","236","7","419","1072","0","39.09","16.42"
"68","000","00","110","0021","0000","453","227","226","2","455","1098","0","41.44","20.67"
"68","000","00","110","0021","1256","453","227","226","2","455","1098","0","41.44","20.67"
"68","000","00","110","0022","0000","480","183","297","1","481","1294","0","37.17","14.14"
"68","000","00","110","0022","1254","480","183","297","1","481","1294","0","37.17","14.14"
"68","000","00","110","0023","0000","515","207","308","3","518","1391","0","37.24","14.88"
"68","000","00","110","0023","1255","515","207","308","3","518","1391","0","37.24","14.88"
"68","000","00","120","0000","0000","21111","8579","12532","206","21317","57793","69326","36.89","14.84"
"68","000","00","120","0001","0000","992","446","546","11","1003","2767","0","36.25","16.12"
"68","000","00","120","0001","1268","531","237","294","3","534","1359","0","39.29","17.44"
"68","000","00","120","0001","1269","461","209","252","8","469","1408","0","33.31","14.84"
"68","000","00","120","0002","0000","370","170","200","5","375","875","0","42.86","19.43"
"68","000","00","120","0002","1270","370","170","200","5","375","875","0","42.86","19.43"
"68","000","00","120","0003","0000","480","225","255","11","491","1310","0","37.48","17.18"
"68","000","00","120","0003","1271","480","225","255","11","491","1310","0","37.48","17.18"
"68","000","00","120","0004","0000","804","314","490","8","812","1899","0","42.76","16.54"
"68","000","00","120","0004","1272","804","314","490","8","812","1899","0","42.76","16.54"
"68","000","00","120","0005","0000","377","156","221","3","380","912","0","41.67","17.11"
"68","000","00","120","0005","1275","377","156","221","3","380","912","0","41.67","17.11"
"68","000","00","120","0006","0000","813","330","483","9","822","2180","0","37.71","15.14"
"68","000","00","120","0006","1273","454","186","268","4","458","1329","0","34.46","14.00"
"68","000","00","120","0006","1274","359","144","215","5","364","851","0","42.77","16.92"
"68","000","00","120","0007","0000","370","165","205","5","375","854","0","43.91","19.32"
"68","000","00","120","0007","1276","370","165","205","5","375","854","0","43.91","19.32"
"68","000","00","120","0008","0000","298","129","169","2","300","705","0","42.55","18.30"
"68","000","00","120","0008","1277","298","129","169","2","300","705","0","42.55","18.30"
"68","000","00","120","0009","0000","606","251","355","5","611","1831","0","33.37","13.71"
"68","000","00","120","0009","1278","606","251","355","5","611","1831","0","33.37","13.71"
"68","000","00","120","0010","0000","926","375","551","9","935","2633","0","35.51","14.24"
"68","000","00","120","0010","1279","459","185","274","3","462","1278","0","36.15","14.48"
"68","000","00","120","0010","1280","467","190","277","6","473","1355","0","34.91","14.02"
"68","000","00","120","0011","0000","1043","418","625","9","1052","2621","0","40.14","15.95"
"68","000","00","120","0011","1281","512","231","281","5","517","1329","0","38.90","17.38"
"68","000","00","120","0011","1282","531","187","344","4","535","1292","0","41.41","14.47"
"68","000","00","120","0012","0000","1195","418","777","14","1209","3116","0","38.80","13.41"
"68","000","00","120","0012","1283","617","204","413","9","626","1534","0","40.81","13.30"
"68","000","00","120","0012","1284","578","214","364","5","583","1582","0","36.85","13.53"
"68","000","00","120","0013","0000","544","184","360","4","548","1484","0","36.93","12.40"
"68","000","00","120","0013","1285","544","184","360","4","548","1484","0","36.93","12.40"
"68","000","00","120","0014","0000","1916","694","1222","11","1927","4757","0","40.51","14.59"
"68","000","00","120","0014","1286","460","135","325","3","463","1123","0","41.23","12.02"
"68","000","00","120","0014","1287","470","164","306","2","472","1105","0","42.71","14.84"
"68","000","00","120","0014","1288","526","196","330","1","527","1228","0","42.92","15.96"
"68","000","00","120","0014","1289","460","199","261","5","465","1301","0","35.74","15.30"
"68","000","00","120","0015","0000","1483","714","769","8","1491","3918","0","38.06","18.22"
"68","000","00","120","0015","1290","476","216","260","0","476","1271","0","37.45","16.99"
"68","000","00","120","0015","1291","524","255","269","5","529","1468","0","36.04","17.37"
"68","000","00","120","0015","1292","483","243","240","3","486","1179","0","41.22","20.61"
"68","000","00","120","0016","0000","972","408","564","10","982","2458","0","39.95","16.60"
"68","000","00","120","0016","1293","443","173","270","4","447","1102","0","40.56","15.70"
"68","000","00","120","0016","1294","529","235","294","6","535","1356","0","39.45","17.33"
"68","000","00","120","0017","0000","1132","419","713","6","1138","2971","0","38.30","14.10"
"68","000","00","120","0017","1295","616","252","364","3","619","1435","0","43.14","17.56"
"68","000","00","120","0017","1296","516","167","349","3","519","1536","0","33.79","10.87"
"68","000","00","120","0018","0000","918","348","570","13","931","2482","0","37.51","14.02"
"68","000","00","120","0018","1297","472","170","302","6","478","1272","0","37.58","13.36"
"68","000","00","120","0018","1298","446","178","268","7","453","1210","0","37.44","14.71"
"68","000","00","120","0019","0000","338","140","198","7","345","1021","0","33.79","13.71"
"68","000","00","120","0019","1299","338","140","198","7","345","1021","0","33.79","13.71"
"68","000","00","120","0020","0000","777","237","540","8","785","1950","0","40.26","12.15"
"68","000","00","120","0020","1300","360","106","254","5","365","992","0","36.79","10.69"
"68","000","00","120","0020","1301","417","131","286","3","420","958","0","43.84","13.67"
"68","000","00","120","0021","0000","984","377","607","9","993","2935","0","33.83","12.84"
"68","000","00","120","0021","1302","527","193","334","4","531","1462","0","36.32","13.20"
"68","000","00","120","0021","1303","457","184","273","5","462","1473","0","31.36","12.49"
"68","000","00","120","0022","0000","1234","557","677","20","1254","4468","0","28.07","12.47"
"68","000","00","120","0022","1308","439","189","250","3","442","1381","0","32.01","13.69"
"68","000","00","120","0022","1309","400","190","210","4","404","1531","0","26.39","12.41"
"68","000","00","120","0022","1310","395","178","217","13","408","1556","0","26.22","11.44"
"68","000","00","120","0023","0000","650","245","405","8","658","1926","0","34.16","12.72"
"68","000","00","120","0023","1311","331","110","221","4","335","874","0","38.33","12.59"
"68","000","00","120","0023","1312","319","135","184","4","323","1052","0","30.70","12.83"
"68","000","00","120","0024","0000","1889","859","1030","11","1900","5720","0","33.22","15.02"
"68","000","00","120","0024","1304","456","192","264","3","459","1372","0","33.45","13.99"
"68","000","00","120","0024","1305","513","231","282","2","515","1501","0","34.31","15.39"
"68","000","00","120","0024","1306","462","229","233","3","465","1355","0","34.32","16.90"
"68","000","00","120","0024","1307","458","207","251","3","461","1492","0","30.90","13.87"
"68","000","00","130","0000","0000","2718","1846","872","36","2754","10036","12391","27.44","18.39"
"68","000","00","130","0001","0000","665","345","320","16","681","2041","0","33.37","16.90"
"68","000","00","130","0001","0674","349","162","187","10","359","1020","0","35.20","15.88"
"68","000","00","130","0001","0675","316","183","133","6","322","1021","0","31.54","17.92"
"68","000","00","130","0002","0000","437","309","128","2","439","1426","0","30.79","21.67"
"68","000","00","130","0002","0676","437","309","128","2","439","1426","0","30.79","21.67"
"68","000","00","130","0003","0000","220","186","34","3","223","745","0","29.93","24.97"
"68","000","00","130","0003","0678","220","186","34","3","223","745","0","29.93","24.97"
"68","000","00","130","0004","0000","164","134","30","1","165","631","0","26.15","21.24"
"68","000","00","130","0004","0677","164","134","30","1","165","631","0","26.15","21.24"
"68","000","00","130","0005","0000","157","114","43","3","160","660","0","24.24","17.27"
"68","000","00","130","0005","0680","157","114","43","3","160","660","0","24.24","17.27"
"68","000","00","130","0006","0000","128","106","22","2","130","683","0","19.03","15.52"
"68","000","00","130","0006","0683","128","106","22","2","130","683","0","19.03","15.52"
"68","000","00","130","0007","0000","205","164","41","1","206","764","0","26.96","21.47"
"68","000","00","130","0007","0681","205","164","41","1","206","764","0","26.96","21.47"
"68","000","00","130","0008","0000","286","162","124","4","290","1265","0","22.92","12.81"
"68","000","00","130","0008","0684","286","162","124","4","290","1265","0","22.92","12.81"
"68","000","00","130","0009","0000","333","238","95","4","337","1067","0","31.58","22.31"
"68","000","00","130","0009","0679","333","238","95","4","337","1067","0","31.58","22.31"
"68","000","00","130","0010","0000","123","88","35","0","123","754","0","16.31","11.67"
"68","000","00","130","0010","0682","123","88","35","0","123","754","0","16.31","11.67"
"66","000","00","000","0000","0000","975209","474423","500786","9323","984532","2337667","2819081","42.12","20.29"
"66","000","00","010","0000","0000","6029","2765","3264","52","6081","14195","17930","42.84","19.48"
"66","000","00","010","0001","0000","641","267","374","5","646","1436","0","44.99","18.59"
"66","000","00","010","0001","1286","641","267","374","5","646","1436","0","44.99","18.59"
"66","000","00","010","0002","0000","825","377","448","3","828","1946","0","42.55","19.37"
"66","000","00","010","0002","1290","448","204","244","1","449","1121","0","40.05","18.20"
"66","000","00","010","0002","1291","377","173","204","2","379","825","0","45.94","20.97"
"66","000","00","010","0003","0000","680","292","388","7","687","1572","0","43.70","18.58"
"66","000","00","010","0003","1284","325","144","181","3","328","795","0","41.26","18.11"
"66","000","00","010","0003","1285","355","148","207","4","359","777","0","46.20","19.05"
"66","000","00","010","0004","0000","578","265","313","5","583","1353","0","43.09","19.59"
"66","000","00","010","0004","1287","578","265","313","5","583","1353","0","43.09","19.59"
"66","000","00","010","0005","0000","848","411","437","4","852","1913","0","44.54","21.48"
"66","000","00","010","0005","1288","466","232","234","1","467","1012","0","46.15","22.92"
"66","000","00","010","0005","1289","382","179","203","3","385","901","0","42.73","19.87"
"66","000","00","010","0006","0000","704","329","375","10","714","1884","0","37.90","17.46"
"66","000","00","010","0006","1292","407","178","229","6","413","1202","0","34.36","14.81"
"66","000","00","010","0006","1293","297","151","146","4","301","682","0","44.13","22.14"
"66","000","00","010","0007","0000","990","451","539","13","1003","2244","0","44.70","20.10"
"66","000","00","010","0007","1294","468","231","237","4","472","988","0","47.77","23.38"
"66","000","00","010","0007","1295","522","220","302","9","531","1256","0","42.28","17.52"
"66","000","00","010","0008","0000","763","373","390","5","768","1847","0","41.58","20.19"
"66","000","00","010","0008","1296","401","176","225","1","402","960","0","41.88","18.33"
"66","000","00","010","0008","1297","362","197","165","4","366","887","0","41.26","22.21"
"66","000","00","020","0000","0000","28815","13433","15382","292","29107","64617","75468","45.05","20.79"
"66","000","00","020","0001","0000","1167","510","657","9","1176","2974","0","39.54","17.15"
"66","000","00","020","0001","1298","368","155","213","3","371","1174","0","31.60","13.20"
"66","000","00","020","0001","1299","447","215","232","2","449","948","0","47.36","22.68"
"66","000","00","020","0001","1300","352","140","212","4","356","852","0","41.78","16.43"
"66","000","00","020","0002","0000","1424","569","855","19","1443","3053","0","47.26","18.64"
"66","000","00","020","0002","1301","526","224","302","6","532","1073","0","49.58","20.88"
"66","000","00","020","0002","1302","481","186","295","6","487","1098","0","44.35","16.94"
"66","000","00","020","0002","1303","417","159","258","7","424","882","0","48.07","18.03"
"66","000","00","020","0003","0000","1696","620","1076","20","1716","3732","0","45.98","16.61"
"66","000","00","020","0003","1304","589","226","363","8","597","1351","0","44.19","16.73"
"66","000","00","020","0003","1305","533","197","336","7","540","1201","0","44.96","16.40"
"66","000","00","020","0003","1306","574","197","377","5","579","1180","0","49.07","16.69"
"66","000","00","020","0004","0000","1240","517","723","19","1259","2791","0","45.11","18.52"
"66","000","00","020","0004","1307","585","250","335","4","589","1360","0","43.31","18.38"
"66","000","00","020","0004","1308","655","267","388","15","670","1431","0","46.82","18.66"
"66","000","00","020","0005","0000","910","409","501","11","921","1889","0","48.76","21.65"
"66","000","00","020","0005","1311","529","174","355","7","536","1122","0","47.77","15.51"
"66","000","00","020","0005","1312","381","235","146","4","385","767","0","50.20","30.64"
"66","000","00","020","0006","0000","924","403","521","12","936","2030","0","46.11","19.85"
"66","000","00","020","0006","1309","325","142","183","7","332","763","0","43.51","18.61"
"66","000","00","020","0006","1310","599","261","338","5","604","1267","0","47.67","20.60"
"66","000","00","020","0007","0000","1179","534","645","11","1190","2499","0","47.62","21.37"
"66","000","00","020","0007","1313","402","193","209","7","409","859","0","47.61","22.47"
"66","000","00","020","0007","1314","366","166","200","2","368","805","0","45.71","20.62"
"66","000","00","020","0007","1315","411","175","236","2","413","835","0","49.46","20.96"
"66","000","00","020","0008","0000","964","395","569","10","974","2244","0","43.40","17.60"
"66","000","00","020","0008","1316","512","205","307","6","518","1156","0","44.81","17.73"
"66","000","00","020","0008","1317","452","190","262","4","456","1088","0","41.91","17.46"
"66","000","00","020","0009","0000","3026","1213","1813","37","3063","6693","0","45.76","18.12"
"66","000","00","020","0009","1318","536","199","337","8","544","1158","0","46.98","17.18"
"66","000","00","020","0009","1319","432","164","268","4","436","1043","0","41.80","15.72"
"66","000","00","020","0009","1320","498","220","278","6","504","1172","0","43.00","18.77"
"66","000","00","020","0009","1321","671","249","422","10","681","1350","0","50.44","18.44"
"66","000","00","020","0009","1322","518","214","304","5","523","1089","0","48.03","19.65"
"66","000","00","020","0009","1323","371","167","204","4","375","881","0","42.57","18.96"
"66","000","00","020","0010","0000","2088","969","1119","15","2103","4732","0","44.44","20.48"
"66","000","00","020","0010","1324","549","254","295","5","554","1210","0","45.79","20.99"
"66","000","00","020","0010","1325","522","248","274","5","527","1164","0","45.27","21.31"
"66","000","00","020","0010","1326","524","246","278","2","526","1262","0","41.68","19.49"
"66","000","00","020","0010","1327","493","221","272","3","496","1096","0","45.26","20.16"
"66","000","00","020","0011","0000","1651","849","802","9","1660","3682","0","45.08","23.06"
"66","000","00","020","0011","1334","581","293","288","3","584","1306","0","44.72","22.43"
"66","000","00","020","0011","1335","519","248","271","1","520","1113","0","46.72","22.28"
"66","000","00","020","0011","1336","551","308","243","5","556","1263","0","44.02","24.39"
"66","000","00","020","0012","0000","1077","560","517","12","1089","2651","0","41.08","21.12"
"66","000","00","020","0012","1337","539","238","301","3","542","1307","0","41.47","18.21"
"66","000","00","020","0012","1338","538","322","216","9","547","1344","0","40.70","23.96"
"66","000","00","020","0013","0000","1673","1049","624","17","1690","3985","0","42.41","26.32"
"66","000","00","020","0013","1339","652","347","305","8","660","1410","0","46.81","24.61"
"66","000","00","020","0013","1340","443","243","200","4","447","1141","0","39.18","21.30"
"66","000","00","020","0013","1341","578","459","119","5","583","1434","0","40.66","32.01"
"66","000","00","020","0014","0000","762","495","267","5","767","1703","0","45.04","29.07"
"66","000","00","020","0014","1346","341","214","127","2","343","764","0","44.90","28.01"
"66","000","00","020","0014","1347","421","281","140","3","424","939","0","45.15","29.93"
"66","000","00","020","0015","0000","1844","1242","602","14","1858","4044","0","45.94","30.71"
"66","000","00","020","0015","1342","484","276","208","4","488","1172","0","41.64","23.55"
"66","000","00","020","0015","1343","436","361","75","3","439","914","0","48.03","39.50"
"66","000","00","020","0015","1344","496","274","222","4","500","993","0","50.35","27.59"
"66","000","00","020","0015","1345","428","331","97","3","431","965","0","44.66","34.30"
"66","000","00","020","0016","0000","3990","1656","2334","45","4035","8763","0","46.05","18.90"
"66","000","00","020","0016","1348","615","284","331","4","619","1254","0","49.36","22.65"
"66","000","00","020","0016","1349","593","207","386","9","602","1277","0","47.14","16.21"
"66","000","00","020","0016","1350","455","244","211","3","458","1276","0","35.89","19.12"
"66","000","00","020","0016","1351","587","232","355","8","595","1265","0","47.04","18.34"
"66","000","00","020","0016","1352","608","199","409","9","617","1258","0","49.05","15.82"
"66","000","00","020","0016","1353","522","224","298","6","528","1226","0","43.07","18.27"
"66","000","00","020","0016","1354","610","266","344","6","616","1207","0","51.04","22.04"
"66","000","00","020","0017","0000","3200","1443","1757","27","3227","7152","0","45.12","20.18"
"66","000","00","020","0017","1328","599","304","295","5","604","1228","0","49.19","24.76"
"66","000","00","020","0017","1329","450","203","247","4","454","1091","0","41.61","18.61"
"66","000","00","020","0017","1330","393","145","248","3","396","956","0","41.42","15.17"
"66","000","00","020","0017","1331","598","286","312","7","605","1293","0","46.79","22.12"
"66","000","00","020","0017","1332","611","249","362","4","615","1304","0","47.16","19.10"
"66","000","00","020","0017","1333","549","256","293","4","553","1280","0","43.20","20.00"
"66","000","00","030","0000","0000","46727","23033","23694","411","47138","105752","126574","44.57","21.78"
"66","000","00","030","0001","0000","1605","736","869","15","1620","3502","0","46.26","21.02"
"66","000","00","030","0001","1359","550","232","318","4","554","1194","0","46.40","19.43"
"66","000","00","030","0001","1360","530","255","275","7","537","1108","0","48.47","23.01"
"66","000","00","030","0001","1361","525","249","276","4","529","1200","0","44.08","20.75"
"66","000","00","030","0002","0000","1678","731","947","18","1696","3745","0","45.29","19.52"
"66","000","00","030","0002","1362","561","241","320","4","565","1213","0","46.58","19.87"
"66","000","00","030","0002","1363","541","234","307","8","549","1251","0","43.88","18.71"
"66","000","00","030","0002","1364","576","256","320","6","582","1281","0","45.43","19.98"
"66","000","00","030","0003","0000","1626","763","863","14","1640","3412","0","48.07","22.36"
"66","000","00","030","0003","1365","579","261","318","4","583","1156","0","50.43","22.58"
"66","000","00","030","0003","1366","572","293","279","7","579","1180","0","49.07","24.83"
"66","000","00","030","0003","1367","475","209","266","3","478","1076","0","44.42","19.42"
"66","000","00","030","0004","0000","1346","681","665","15","1361","2840","0","47.92","23.98"
"66","000","00","030","0004","1368","688","370","318","12","700","1361","0","51.43","27.19"
"66","000","00","030","0004","1369","658","311","347","3","661","1479","0","44.69","21.03"
"66","000","00","030","0005","0000","1151","518","633","7","1158","2506","0","46.21","20.67"
"66","000","00","030","0005","1370","524","224","300","5","529","1133","0","46.69","19.77"
"66","000","00","030","0005","1371","627","294","333","2","629","1373","0","45.81","21.41"
"66","000","00","030","0006","0000","1331","660","671","11","1342","2714","0","49.45","24.32"
"66","000","00","030","0006","1372","657","319","338","7","664","1324","0","50.15","24.09"
"66","000","00","030","0006","1373","674","341","333","4","678","1390","0","48.78","24.53"
"66","000","00","030","0007","0000","1902","1005","897","13","1915","4415","0","43.37","22.76"
"66","000","00","030","0007","1374","640","370","270","3","643","1505","0","42.72","24.58"
"66","000","00","030","0007","1375","650","333","317","7","657","1490","0","44.09","22.35"
"66","000","00","030","0007","1376","612","302","310","3","615","1420","0","43.31","21.27"
"66","000","00","030","0008","0000","1816","891","925","15","1831","3817","0","47.97","23.34"
"66","000","00","030","0008","1377","676","321","355","4","680","1314","0","51.75","24.43"
"66","000","00","030","0008","1378","602","276","326","10","612","1292","0","47.37","21.36"
"66","000","00","030","0008","1379","538","294","244","1","539","1211","0","44.51","24.28"
"66","000","00","030","0009","0000","2316","1096","1220","17","2333","5297","0","44.04","20.69"
"66","000","00","030","0009","1380","552","266","286","6","558","1305","0","42.76","20.38"
"66","000","00","030","0009","1381","625","296","329","0","625","1390","0","44.96","21.29"
"66","000","00","030","0009","1382","564","254","310","2","566","1292","0","43.81","19.66"
"66","000","00","030","0009","1383","575","280","295","9","584","1310","0","44.58","21.37"
"66","000","00","030","0010","0000","1553","756","797","15","1568","4091","0","38.33","18.48"
"66","000","00","030","0010","1388","608","281","327","3","611","1533","0","39.86","18.33"
"66","000","00","030","0010","1389","505","264","241","7","512","1216","0","42.11","21.71"
"66","000","00","030","0010","1390","440","211","229","5","445","1342","0","33.16","15.72"
"66","000","00","030","0011","0000","3513","1791","1722","25","3538","7871","0","44.95","22.75"
"66","000","00","030","0011","1399","470","232","238","3","473","1097","0","43.12","21.15"
"66","000","00","030","0011","1400","610","300","310","4","614","1260","0","48.73","23.81"
"66","000","00","030","0011","1401","598","328","270","2","600","1326","0","45.25","24.74"
"66","000","00","030","0011","1402","526","289","237","5","531","1330","0","39.92","21.73"
"66","000","00","030","0011","1403","599","295","304","5","604","1432","0","42.18","20.60"
"66","000","00","030","0011","1404","710","347","363","6","716","1426","0","50.21","24.33"
"66","000","00","030","0012","0000","5055","2449","2606","32","5087","11718","0","43.41","20.90"
"66","000","00","030","0012","1409","551","264","287","6","557","1458","0","38.20","18.11"
"66","000","00","030","0012","1410","569","303","266","3","572","1489","0","38.42","20.35"
"66","000","00","030","0012","1411","667","311","356","4","671","1437","0","46.69","21.64"
"66","000","00","030","0012","1412","714","344","370","5","719","1515","0","47.46","22.71"
"66","000","00","030","0012","1413","649","290","359","6","655","1498","0","43.72","19.36"
"66","000","00","030","0012","1414","608","299","309","1","609","1462","0","41.66","20.45"
"66","000","00","030","0012","1415","634","300","334","2","636","1435","0","44.32","20.91"
"66","000","00","030","0012","1416","663","338","325","5","668","1424","0","46.91","23.74"
"66","000","00","030","0013","0000","3749","1954","1795","40","3789","8372","0","45.26","23.34"
"66","000","00","030","0013","1422","601","309","292","3","604","1341","0","45.04","23.04"
"66","000","00","030","0013","1423","620","336","284","6","626","1430","0","43.78","23.50"
"66","000","00","030","0013","1424","647","341","306","7","654","1338","0","48.88","25.49"
"66","000","00","030","0013","1425","561","269","292","7","568","1309","0","43.39","20.55"
"66","000","00","030","0013","1426","624","345","279","6","630","1506","0","41.83","22.91"
"66","000","00","030","0013","1427","696","354","342","11","707","1448","0","48.83","24.45"
"66","000","00","030","0014","0000","1902","992","910","21","1923","4215","0","45.62","23.53"
"66","000","00","030","0014","1428","638","316","322","6","644","1390","0","46.33","22.73"
"66","000","00","030","0014","1429","620","313","307","9","629","1386","0","45.38","22.58"
"66","000","00","030","0014","1430","644","363","281","6","650","1439","0","45.17","25.23"
"66","000","00","030","0015","0000","893","407","486","12","905","1865","0","48.53","21.82"
"66","000","00","030","0015","1355","431","182","249","9","440","897","0","49.05","20.29"
"66","000","00","030","0015","1356","462","225","237","3","465","968","0","48.04","23.24"
"66","000","00","030","0016","0000","1156","549","607","18","1174","2394","0","49.04","22.93"
"66","000","00","030","0016","1357","567","278","289","6","573","1220","0","46.97","22.79"
"66","000","00","030","0016","1358","589","271","318","12","601","1174","0","51.19","23.08"
"66","000","00","030","0017","0000","2414","1208","1206","23","2437","5566","0","43.78","21.70"
"66","000","00","030","0017","1384","686","354","332","5","691","1394","0","49.57","25.39"
"66","000","00","030","0017","1385","580","287","293","8","588","1395","0","42.15","20.57"
"66","000","00","030","0017","1386","594","270","324","6","600","1330","0","45.11","20.30"
"66","000","00","030","0017","1387","554","297","257","4","558","1447","0","38.56","20.53"
"66","000","00","030","0018","0000","1504","675","829","18","1522","3459","0","44.00","19.51"
"66","000","00","030","0018","1391","505","225","280","10","515","1156","0","44.55","19.46"
"66","000","00","030","0018","1392","494","208","286","4","498","1165","0","42.75","17.85"
"66","000","00","030","0018","1393","505","242","263","4","509","1138","0","44.73","21.27"
"66","000","00","030","0019","0000","2980","1565","1415","24","3004","7374","0","40.74","21.22"
"66","000","00","030","0019","1394","686","375","311","2","688","1463","0","47.03","25.63"
"66","000","00","030","0019","1395","636","333","303","7","643","1961","0","32.79","16.98"
"66","000","00","030","0019","1396","537","266","271","7","544","1351","0","40.27","19.69"
"66","000","00","030","0019","1397","529","272","257","5","534","1339","0","39.88","20.31"
"66","000","00","030","0019","1398","592","319","273","3","595","1260","0","47.22","25.32"
"66","000","00","030","0020","0000","1947","976","971","16","1963","4610","0","42.58","21.17"
"66","000","00","030","0020","1405","481","240","241","5","486","1163","0","41.79","20.64"
"66","000","00","030","0020","1406","524","265","259","4","528","1243","0","42.48","21.32"
"66","000","00","030","0020","1407","488","247","241","4","492","1073","0","45.85","23.02"
"66","000","00","030","0020","1408","454","224","230","3","457","1131","0","40.41","19.81"
"66","000","00","030","0021","0000","2848","1463","1385","19","2867","6608","0","43.39","22.14"
"66","000","00","030","0021","1417","537","283","254","5","542","1367","0","39.65","20.70"
"66","000","00","030","0021","1418","554","280","274","6","560","1373","0","40.79","20.39"
"66","000","00","030","0021","1419","560","268","292","1","561","1360","0","41.25","19.71"
"66","000","00","030","0021","1420","674","353","321","4","678","1323","0","51.25","26.68"
"66","000","00","030","0021","1421","523","279","244","3","526","1185","0","44.39","23.54"
"66","000","00","030","0022","0000","2442","1167","1275","23","2465","5361","0","45.98","21.77"
"66","000","00","030","0022","1431","620","283","337","4","624","1259","0","49.56","22.48"
"66","000","00","030","0022","1432","630","296","334","10","640","1336","0","47.90","22.16"
"66","000","00","030","0022","1433","607","319","288","4","611","1358","0","44.99","23.49"
"66","000","00","030","0022","1434","585","269","316","5","590","1408","0","41.90","19.11"
"66","000","00","040","0000","0000","43136","20880","22256","362","43498","94273","113744","46.14","22.15"
"66","000","00","040","0001","0000","799","390","409","7","806","1694","0","47.58","23.02"
"66","000","00","040","0001","1210","365","176","189","2","367","787","0","46.63","22.36"
"66","000","00","040","0001","1211","434","214","220","5","439","907","0","48.40","23.59"
"66","000","00","040","0002","0000","622","349","273","8","630","1340","0","47.01","26.04"
"66","000","00","040","0002","1209","622","349","273","8","630","1340","0","47.01","26.04"
"66","000","00","040","0003","0000","803","415","388","3","806","2306","0","34.95","18.00"
"66","000","00","040","0003","1207","386","192","194","0","386","1504","0","25.66","12.77"
"66","000","00","040","0003","1208","417","223","194","3","420","802","0","52.37","27.81"
"66","000","00","040","0004","0000","1097","534","563","11","1108","2250","0","49.24","23.73"
"66","000","00","040","0004","1215","592","280","312","7","599","1175","0","50.98","23.83"
"66","000","00","040","0004","1216","505","254","251","4","509","1075","0","47.35","23.63"
"66","000","00","040","0005","0000","609","299","310","4","613","1370","0","44.74","21.82"
"66","000","00","040","0005","1212","609","299","310","4","613","1370","0","44.74","21.82"
"66","000","00","040","0006","0000","807","415","392","5","812","1840","0","44.13","22.55"
"66","000","00","040","0006","1213","429","226","203","3","432","967","0","44.67","23.37"
"66","000","00","040","0006","1214","378","189","189","2","380","873","0","43.53","21.65"
"66","000","00","040","0007","0000","2248","1094","1154","21","2269","4767","0","47.60","22.95"
"66","000","00","040","0007","1217","493","261","232","5","498","1078","0","46.20","24.21"
"66","000","00","040","0007","1218","569","278","291","4","573","1191","0","48.11","23.34"
"66","000","00","040","0007","1219","583","279","304","7","590","1233","0","47.85","22.63"
"66","000","00","040","0007","1220","603","276","327","5","608","1265","0","48.06","21.82"
"66","000","00","040","0008","0000","1835","906","929","32","1867","3884","0","48.07","23.33"
"66","000","00","040","0008","1221","614","303","311","10","624","1278","0","48.83","23.71"
"66","000","00","040","0008","1222","610","316","294","10","620","1306","0","47.47","24.20"
"66","000","00","040","0008","1223","611","287","324","12","623","1300","0","47.92","22.08"
"66","000","00","040","0009","0000","2515","1158","1357","18","2533","5582","0","45.38","20.75"
"66","000","00","040","0009","1224","645","306","339","6","651","1380","0","47.17","22.17"
"66","000","00","040","0009","1225","639","297","342","4","643","1356","0","47.42","21.90"
"66","000","00","040","0009","1226","519","259","260","2","521","1430","0","36.43","18.11"
"66","000","00","040","0009","1227","712","296","416","6","718","1416","0","50.71","20.90"
"66","000","00","040","0010","0000","986","425","561","11","997","2244","0","44.43","18.94"
"66","000","00","040","0010","1247","576","263","313","6","582","1271","0","45.79","20.69"
"66","000","00","040","0010","1248","410","162","248","5","415","973","0","42.65","16.65"
"66","000","00","040","0011","0000","1511","782","729","14","1525","3397","0","44.89","23.02"
"66","000","00","040","0011","1244","463","242","221","3","466","1021","0","45.64","23.70"
"66","000","00","040","0011","1245","668","345","323","4","672","1413","0","47.56","24.42"
"66","000","00","040","0011","1246","380","195","185","7","387","963","0","40.19","20.25"
"66","000","00","040","0012","0000","1487","708","779","13","1500","3447","0","43.52","20.54"
"66","000","00","040","0012","1249","433","202","231","2","435","1069","0","40.69","18.90"
"66","000","00","040","0012","1250","559","271","288","6","565","1208","0","46.77","22.43"
"66","000","00","040","0012","1251","495","235","260","5","500","1170","0","42.74","20.09"
"66","000","00","040","0013","0000","1371","640","731","12","1383","2776","0","49.82","23.05"
"66","000","00","040","0013","1228","641","314","327","4","645","1327","0","48.61","23.66"
"66","000","00","040","0013","1229","730","326","404","8","738","1449","0","50.93","22.50"
"66","000","00","040","0014","0000","2963","1516","1447","18","2981","6405","0","46.54","23.67"
"66","000","00","040","0014","1230","612","275","337","5","617","1318","0","46.81","20.86"
"66","000","00","040","0014","1231","601","321","280","4","605","1296","0","46.68","24.77"
"66","000","00","040","0014","1232","642","315","327","8","650","1282","0","50.70","24.57"
"66","000","00","040","0014","1233","585","320","265","0","585","1308","0","44.72","24.46"
"66","000","00","040","0014","1234","523","285","238","1","524","1201","0","43.63","23.73"
"66","000","00","040","0015","0000","2513","1172","1341","14","2527","5634","0","44.85","20.80"
"66","000","00","040","0015","1254","604","287","317","7","611","1433","0","42.64","20.03"
"66","000","00","040","0015","1255","610","267","343","1","611","1396","0","43.77","19.13"
"66","000","00","040","0015","1256","606","278","328","5","611","1385","0","44.12","20.07"
"66","000","00","040","0015","1257","693","340","353","1","694","1420","0","48.87","23.94"
"66","000","00","040","0016","0000","2681","1288","1393","18","2699","5653","0","47.74","22.78"
"66","000","00","040","0016","1275","518","239","279","2","520","1115","0","46.64","21.43"
"66","000","00","040","0016","1276","552","322","230","1","553","1117","0","49.51","28.83"
"66","000","00","040","0016","1277","536","256","280","2","538","1181","0","45.55","21.68"
"66","000","00","040","0016","1278","525","227","298","5","530","1082","0","48.98","20.98"
"66","000","00","040","0016","1279","550","244","306","8","558","1158","0","48.19","21.07"
"66","000","00","040","0017","0000","2911","1428","1483","31","2942","6172","0","47.67","23.14"
"66","000","00","040","0017","1266","525","254","271","3","528","1157","0","45.64","21.95"
"66","000","00","040","0017","1267","618","322","296","8","626","1252","0","50.00","25.72"
"66","000","00","040","0017","1268","551","247","304","6","557","1161","0","47.98","21.27"
"66","000","00","040","0017","1269","578","288","290","4","582","1270","0","45.83","22.68"
"66","000","00","040","0017","1270","639","317","322","10","649","1332","0","48.72","23.80"
"66","000","00","040","0018","0000","2569","1163","1406","21","2590","5619","0","46.09","20.70"
"66","000","00","040","0018","1235","431","217","214","4","435","904","0","48.12","24.00"
"66","000","00","040","0018","1236","520","217","303","8","528","1034","0","51.06","20.99"
"66","000","00","040","0018","1237","550","247","303","6","556","1267","0","43.88","19.49"
"66","000","00","040","0018","1238","512","217","295","2","514","1234","0","41.65","17.59"
"66","000","00","040","0018","1239","556","265","291","1","557","1180","0","47.20","22.46"
"66","000","00","040","0019","0000","2478","1178","1300","19","2497","5548","0","45.01","21.23"
"66","000","00","040","0019","1280","596","245","351","5","601","1416","0","42.44","17.30"
"66","000","00","040","0019","1281","615","294","321","5","620","1318","0","47.04","22.31"
"66","000","00","040","0019","1282","607","297","310","5","612","1398","0","43.78","21.24"
"66","000","00","040","0019","1283","660","342","318","4","664","1416","0","46.89","24.15"
"66","000","00","040","0020","0000","1262","551","711","13","1275","2725","0","46.79","20.22"
"66","000","00","040","0020","1261","650","285","365","8","658","1403","0","46.90","20.31"
"66","000","00","040","0020","1262","612","266","346","5","617","1322","0","46.67","20.12"
"66","000","00","040","0021","0000","1714","718","996","13","1727","3518","0","49.09","20.41"
"66","000","00","040","0021","1258","536","221","315","3","539","1148","0","46.95","19.25"
"66","000","00","040","0021","1259","622","261","361","7","629","1258","0","50.00","20.75"
"66","000","00","040","0021","1260","556","236","320","3","559","1112","0","50.27","21.22"
"66","000","00","040","0022","0000","2118","1114","1004","15","2133","4905","0","43.49","22.71"
"66","000","00","040","0022","1271","532","264","268","2","534","1220","0","43.77","21.64"
"66","000","00","040","0022","1272","535","260","275","3","538","1239","0","43.42","20.98"
"66","000","00","040","0022","1273","518","284","234","3","521","1213","0","42.95","23.41"
"66","000","00","040","0022","1274","533","306","227","7","540","1233","0","43.80","24.82"
"66","000","00","040","0023","0000","1869","929","940","15","1884","4170","0","45.18","22.28"
"66","000","00","040","0023","1263","621","313","308","3","624","1395","0","44.73","22.44"
"66","000","00","040","0023","1264","589","280","309","6","595","1372","0","43.37","20.41"
"66","000","00","040","0023","1265","659","336","323","6","665","1403","0","47.40","23.95"
"66","000","00","040","0024","0000","1239","631","608","12","1251","2712","0","46.13","23.27"
"66","000","00","040","0024","1252","583","295","288","4","587","1310","0","44.81","22.52"
"66","000","00","040","0024","1253","656","336","320","8","664","1402","0","47.36","23.97"
"66","000","00","040","0025","0000","2129","1077","1052","14","2143","4315","0","49.66","24.96"
"66","000","00","040","0025","1240","611","356","255","2","613","1135","0","54.01","31.37"
"66","000","00","040","0025","1241","468","239","229","3","471","1074","0","43.85","22.25"
"66","000","00","040","0025","1242","523","228","295","5","528","1079","0","48.93","21.13"
"66","000","00","040","0025","1243","527","254","273","4","531","1027","0","51.70","24.73"
"66","000","00","050","0000","0000","54404","27969","26435","468","54872","124160","145438","44.19","22.53"
"66","000","00","050","0001","0000","838","373","465","12","850","2049","0","41.48","18.20"
"66","000","00","050","0001","1111","427","190","237","4","431","1064","0","40.51","17.86"
"66","000","00","050","0001","1112","411","183","228","8","419","985","0","42.54","18.58"
"66","000","00","050","0002","0000","1619","1010","609","19","1638","3331","0","49.17","30.32"
"66","000","00","050","0002","1113","459","217","242","5","464","924","0","50.22","23.48"
"66","000","00","050","0002","1114","430","232","198","5","435","960","0","45.31","24.17"
"66","000","00","050","0002","1115","730","561","169","9","739","1447","0","51.07","38.77"
"66","000","00","050","0003","0000","560","233","327","9","569","1343","0","42.37","17.35"
"66","000","00","050","0003","1118","560","233","327","9","569","1343","0","42.37","17.35"
"66","000","00","050","0004","0000","615","351","264","6","621","1453","0","42.74","24.16"
"66","000","00","050","0004","1123","306","191","115","3","309","705","0","43.83","27.09"
"66","000","00","050","0004","1124","309","160","149","3","312","748","0","41.71","21.39"
"66","000","00","050","0005","0000","775","373","402","6","781","1655","0","47.19","22.54"
"66","000","00","050","0005","1121","346","169","177","2","348","683","0","50.95","24.74"
"66","000","00","050","0005","1122","429","204","225","4","433","972","0","44.55","20.99"
"66","000","00","050","0006","0000","1152","887","265","10","1162","2490","0","46.67","35.62"
"66","000","00","050","0006","1125","687","560","127","6","693","1389","0","49.89","40.32"
"66","000","00","050","0006","1126","465","327","138","4","469","1101","0","42.60","29.70"
"66","000","00","050","0007","0000","1508","786","722","7","1515","3071","0","49.33","25.59"
"66","000","00","050","0007","1127","812","408","404","5","817","1685","0","48.49","24.21"
"66","000","00","050","0007","1128","696","378","318","2","698","1386","0","50.36","27.27"
"66","000","00","050","0008","0000","2301","1124","1177","14","2315","5570","0","41.56","20.18"
"66","000","00","050","0008","1129","563","221","342","2","565","1271","0","44.45","17.39"
"66","000","00","050","0008","1130","457","180","277","2","459","1026","0","44.74","17.54"
"66","000","00","050","0008","1131","671","374","297","10","681","1714","0","39.73","21.82"
"66","000","00","050","0008","1132","610","349","261","0","610","1559","0","39.13","22.39"
"66","000","00","050","0009","0000","1451","807","644","17","1468","3236","0","45.36","24.94"
"66","000","00","050","0009","1136","445","230","215","4","449","1042","0","43.09","22.07"
"66","000","00","050","0009","1137","515","289","226","4","519","1138","0","45.61","25.40"
"66","000","00","050","0009","1138","491","288","203","9","500","1056","0","47.35","27.27"
"66","000","00","050","0010","0000","1176","640","536","7","1183","2501","0","47.30","25.59"
"66","000","00","050","0010","1142","558","304","254","3","561","1200","0","46.75","25.33"
"66","000","00","050","0010","1143","618","336","282","4","622","1301","0","47.81","25.83"
"66","000","00","050","0011","0000","1840","977","863","19","1859","4247","0","43.77","23.00"
"66","000","00","050","0011","1144","619","338","281","7","626","1375","0","45.53","24.58"
"66","000","00","050","0011","1145","622","345","277","7","629","1426","0","44.11","24.19"
"66","000","00","050","0011","1146","599","294","305","5","604","1446","0","41.77","20.33"
"66","000","00","050","0012","0000","995","510","485","5","1000","2256","0","44.33","22.61"
"66","000","00","050","0012","1147","493","256","237","4","497","1194","0","41.62","21.44"
"66","000","00","050","0012","1148","502","254","248","1","503","1062","0","47.36","23.92"
"66","000","00","050","0013","0000","2452","1182","1270","21","2473","5454","0","45.34","21.67"
"66","000","00","050","0013","1149","511","263","248","4","515","1184","0","43.50","22.21"
"66","000","00","050","0013","1150","564","273","291","3","567","1203","0","47.13","22.69"
"66","000","00","050","0013","1151","511","244","267","6","517","1053","0","49.10","23.17"
"66","000","00","050","0013","1152","437","205","232","4","441","1030","0","42.82","19.90"
"66","000","00","050","0013","1153","429","197","232","4","433","984","0","44.00","20.02"
"66","000","00","050","0014","0000","1869","990","879","15","1884","4109","0","45.85","24.09"
"66","000","00","050","0014","1154","540","289","251","1","541","1231","0","43.95","23.48"
"66","000","00","050","0014","1155","678","326","352","10","688","1467","0","46.90","22.22"
"66","000","00","050","0014","1156","651","375","276","4","655","1411","0","46.42","26.58"
"66","000","00","050","0015","0000","1716","972","744","9","1725","5017","0","34.38","19.37"
"66","000","00","050","0015","1160","458","267","191","3","461","2015","0","22.88","13.25"
"66","000","00","050","0015","1161","675","400","275","1","676","1543","0","43.81","25.92"
"66","000","00","050","0015","1162","583","305","278","5","588","1459","0","40.30","20.90"
"66","000","00","050","0016","0000","1929","889","1040","12","1941","4300","0","45.14","20.67"
"66","000","00","050","0016","1177","599","252","347","2","601","1308","0","45.95","19.27"
"66","000","00","050","0016","1178","638","295","343","6","644","1403","0","45.90","21.03"
"66","000","00","050","0016","1179","692","342","350","4","696","1589","0","43.80","21.52"
"66","000","00","050","0017","0000","1658","849","809","13","1671","3585","0","46.61","23.68"
"66","000","00","050","0017","1180","722","375","347","6","728","1496","0","48.66","25.07"
"66","000","00","050","0017","1181","390","187","203","1","391","929","0","42.09","20.13"
"66","000","00","050","0017","1182","546","287","259","6","552","1160","0","47.59","24.74"
"66","000","00","050","0018","0000","2258","1102","1156","22","2280","5018","0","45.44","21.96"
"66","000","00","050","0018","1183","651","323","328","5","656","1456","0","45.05","22.18"
"66","000","00","050","0018","1184","485","229","256","9","494","1137","0","43.45","20.14"
"66","000","00","050","0018","1185","604","278","326","3","607","1255","0","48.37","22.15"
"66","000","00","050","0018","1186","518","272","246","5","523","1170","0","44.70","23.25"
"66","000","00","050","0019","0000","1137","557","580","12","1149","2573","0","44.66","21.65"
"66","000","00","050","0019","1205","590","273","317","8","598","1352","0","44.23","20.19"
"66","000","00","050","0019","1206","547","284","263","4","551","1221","0","45.13","23.26"
"66","000","00","050","0020","0000","1966","1078","888","12","1978","4459","0","44.36","24.18"
"66","000","00","050","0020","1139","649","333","316","7","656","1555","0","42.19","21.41"
"66","000","00","050","0020","1140","658","363","295","2","660","1501","0","43.97","24.18"
"66","000","00","050","0020","1141","659","382","277","3","662","1403","0","47.18","27.23"
"66","000","00","050","0021","0000","3047","1398","1649","36","3083","6438","0","47.89","21.71"
"66","000","00","050","0021","1187","658","311","347","6","664","1313","0","50.57","23.69"
"66","000","00","050","0021","1188","496","236","260","5","501","1049","0","47.76","22.50"
"66","000","00","050","0021","1189","578","266","312","7","585","1266","0","46.21","21.01"
"66","000","00","050","0021","1190","629","280","349","6","635","1265","0","50.20","22.13"
"66","000","00","050","0021","1191","686","305","381","12","698","1545","0","45.18","19.74"
"66","000","00","050","0022","0000","2322","1136","1186","14","2336","5217","0","44.78","21.77"
"66","000","00","050","0022","1192","567","265","302","1","568","1313","0","43.26","20.18"
"66","000","00","050","0022","1193","624","286","338","5","629","1343","0","46.84","21.30"
"66","000","00","050","0022","1194","587","308","279","3","590","1302","0","45.31","23.66"
"66","000","00","050","0022","1195","544","277","267","5","549","1259","0","43.61","22.00"
"66","000","00","050","0023","0000","2568","1271","1297","21","2589","5993","0","43.20","21.21"
"66","000","00","050","0023","1198","600","289","311","2","602","1457","0","41.32","19.84"
"66","000","00","050","0023","1199","617","287","330","3","620","1455","0","42.61","19.73"
"66","000","00","050","0023","1200","709","375","334","2","711","1524","0","46.65","24.61"
"66","000","00","050","0023","1201","642","320","322","14","656","1557","0","42.13","20.55"
"66","000","00","050","0024","0000","1578","867","711","9","1587","3763","0","42.17","23.04"
"66","000","00","050","0024","1172","561","293","268","2","563","1240","0","45.40","23.63"
"66","000","00","050","0024","1173","499","309","190","1","500","1282","0","39.00","24.10"
"66","000","00","050","0024","1174","518","265","253","6","524","1241","0","42.22","21.35"
"66","000","00","050","0025","0000","1645","940","705","10","1655","3730","0","44.37","25.20"
"66","000","00","050","0025","1166","576","330","246","2","578","1420","0","40.70","23.24"
"66","000","00","050","0025","1167","527","291","236","5","532","1153","0","46.14","25.24"
"66","000","00","050","0025","1168","542","319","223","3","545","1157","0","47.10","27.57"
"66","000","00","050","0026","0000","574","218","356","4","578","1309","0","44.16","16.65"
"66","000","00","050","0026","1109","574","218","356","4","578","1309","0","44.16","16.65"
"66","000","00","050","0027","0000","674","260","414","6","680","1727","0","39.37","15.06"
"66","000","00","050","0027","1110","674","260","414","6","680","1727","0","39.37","15.06"
"66","000","00","050","0028","0000","817","323","494","9","826","2153","0","38.37","15.00"
"66","000","00","050","0028","1116","459","174","285","7","466","1267","0","36.78","13.73"
"66","000","00","050","0028","1117","358","149","209","2","360","886","0","40.63","16.82"
"66","000","00","050","0029","0000","781","377","404","3","784","1840","0","42.61","20.49"
"66","000","00","050","0029","1119","425","236","189","2","427","994","0","42.96","23.74"
"66","000","00","050","0029","1120","356","141","215","1","357","846","0","42.20","16.67"
"66","000","00","050","0030","0000","1555","801","754","18","1573","3229","0","48.71","24.81"
"66","000","00","050","0030","1133","459","230","229","2","461","1044","0","44.16","22.03"
"66","000","00","050","0030","1134","559","306","253","12","571","1091","0","52.34","28.05"
"66","000","00","050","0030","1135","537","265","272","4","541","1094","0","49.45","24.22"
"66","000","00","050","0031","0000","1438","713","725","17","1455","3417","0","42.58","20.87"
"66","000","00","050","0031","1157","463","231","232","6","469","1113","0","42.14","20.75"
"66","000","00","050","0031","1158","493","234","259","7","500","1140","0","43.86","20.53"
"66","000","00","050","0031","1159","482","248","234","4","486","1164","0","41.75","21.31"
"66","000","00","050","0032","0000","1650","858","792","17","1667","4259","0","39.14","20.15"
"66","000","00","050","0032","1169","455","247","208","5","460","1162","0","39.59","21.26"
"66","000","00","050","0032","1170","616","308","308","6","622","1634","0","38.07","18.85"
"66","000","00","050","0032","1171","579","303","276","6","585","1463","0","39.99","20.71"
"66","000","00","050","0033","0000","1161","603","558","17","1178","2661","0","44.27","22.66"
"66","000","00","050","0033","1196","589","318","271","11","600","1340","0","44.78","23.73"
"66","000","00","050","0033","1197","572","285","287","6","578","1321","0","43.75","21.57"
"66","000","00","050","0034","0000","1549","847","702","15","1564","3755","0","41.65","22.56"
"66","000","00","050","0034","1202","503","261","242","4","507","1190","0","42.61","21.93"
"66","000","00","050","0034","1203","550","314","236","3","553","1292","0","42.80","24.30"
"66","000","00","050","0034","1204","496","272","224","8","504","1273","0","39.59","21.37"
"66","000","00","050","0035","0000","1398","714","684","8","1406","3190","0","44.08","22.38"
"66","000","00","050","0035","1175","686","357","329","1","687","1578","0","43.54","22.62"
"66","000","00","050","0035","1176","712","357","355","7","719","1612","0","44.60","22.15"
"66","000","00","050","0036","0000","1832","953","879","17","1849","3762","0","49.15","25.33"
"66","000","00","050","0036","1163","713","377","336","5","718","1327","0","54.11","28.41"
"66","000","00","050","0036","1164","600","308","292","6","606","1318","0","45.98","23.37"
"66","000","00","050","0036","1165","519","268","251","6","525","1117","0","47.00","23.99"
"66","000","00","060","0000","0000","80774","41866","38908","769","81543","188793","231415","43.19","22.18"
"66","000","00","060","0001","0000","2262","1108","1154","15","2277","5165","0","44.09","21.45"
"66","000","00","060","0001","0668","540","259","281","7","547","1268","0","43.14","20.43"
"66","000","00","060","0001","0669","575","273","302","1","576","1310","0","43.97","20.84"
"66","000","00","060","0001","0670","497","219","278","3","500","1079","0","46.34","20.30"
"66","000","00","060","0001","0671","650","357","293","4","654","1508","0","43.37","23.67"
"66","000","00","060","0002","0000","2433","1140","1293","15","2448","5884","0","41.60","19.37"
"66","000","00","060","0002","0679","502","209","293","3","505","1176","0","42.94","17.77"
"66","000","00","060","0002","0680","477","216","261","4","481","1159","0","41.50","18.64"
"66","000","00","060","0002","0681","495","232","263","3","498","1179","0","42.24","19.68"
"66","000","00","060","0002","0682","503","240","263","4","507","1207","0","42.00","19.88"
"66","000","00","060","0002","0683","456","243","213","1","457","1163","0","39.29","20.89"
"66","000","00","060","0003","0000","2275","1139","1136","21","2296","6268","0","36.63","18.17"
"66","000","00","060","0003","0684","544","301","243","7","551","1438","0","38.32","20.93"
"66","000","00","060","0003","0685","569","269","300","6","575","1406","0","40.90","19.13"
"66","000","00","060","0003","0686","645","303","342","5","650","1318","0","49.32","22.99"
"66","000","00","060","0003","0687","517","266","251","3","520","2106","0","24.69","12.63"
"66","000","00","060","0004","0000","410","156","254","6","416","833","0","49.94","18.73"
"66","000","00","060","0004","0688","410","156","254","6","416","833","0","49.94","18.73"
"66","000","00","060","0005","0000","6200","3286","2914","63","6263","14638","0","42.79","22.45"
"66","000","00","060","0005","0689","524","286","238","7","531","1292","0","41.10","22.14"
"66","000","00","060","0005","0690","514","297","217","2","516","1309","0","39.42","22.69"
"66","000","00","060","0005","0691","545","282","263","2","547","1331","0","41.10","21.19"
"66","000","00","060","0005","0692","520","282","238","6","526","1316","0","39.97","21.43"
"66","000","00","060","0005","0693","543","298","245","5","548","1309","0","41.86","22.77"
"66","000","00","060","0005","0694","642","313","329","15","657","1497","0","43.89","20.91"
"66","000","00","060","0005","0695","548","310","238","5","553","1271","0","43.51","24.39"
"66","000","00","060","0005","0696","763","398","365","6","769","1704","0","45.13","23.36"
"66","000","00","060","0005","0697","505","284","221","9","514","1229","0","41.82","23.11"
"66","000","00","060","0005","0698","592","270","322","4","596","1213","0","49.13","22.26"
"66","000","00","060","0005","0699","504","266","238","2","506","1167","0","43.36","22.79"
"66","000","00","060","0006","0000","1972","1013","959","22","1994","5016","0","39.75","20.20"
"66","000","00","060","0006","0700","514","288","226","1","515","1290","0","39.92","22.33"
"66","000","00","060","0006","0701","480","216","264","5","485","1201","0","40.38","17.99"
"66","000","00","060","0006","0702","477","253","224","5","482","1236","0","39.00","20.47"
"66","000","00","060","0006","0703","501","256","245","11","512","1289","0","39.72","19.86"
"66","000","00","060","0007","0000","1751","897","854","11","1762","4314","0","40.84","20.79"
"66","000","00","060","0007","0711","577","304","273","4","581","1517","0","38.30","20.04"
"66","000","00","060","0007","0712","580","306","274","4","584","1383","0","42.23","22.13"
"66","000","00","060","0007","0713","594","287","307","3","597","1414","0","42.22","20.30"
"66","000","00","060","0008","0000","1243","1055","188","14","1257","2619","0","48.00","40.28"
"66","000","00","060","0008","0718","634","546","88","6","640","1334","0","47.98","40.93"
"66","000","00","060","0008","0719","609","509","100","8","617","1285","0","48.02","39.61"
"66","000","00","060","0009","0000","2196","1051","1145","22","2218","5075","0","43.70","20.71"
"66","000","00","060","0009","0734","596","270","326","5","601","1329","0","45.22","20.32"
"66","000","00","060","0009","0735","531","277","254","3","534","1247","0","42.82","22.21"
"66","000","00","060","0009","0736","538","263","275","6","544","1331","0","40.87","19.76"
"66","000","00","060","0009","0737","531","241","290","8","539","1168","0","46.15","20.63"
"66","000","00","060","0010","0000","1352","628","724","9","1361","3200","0","42.53","19.63"
"66","000","00","060","0010","0720","445","207","238","2","447","1041","0","42.94","19.88"
"66","000","00","060","0010","0721","458","220","238","3","461","1017","0","45.33","21.63"
"66","000","00","060","0010","0722","449","201","248","4","453","1142","0","39.67","17.60"
"66","000","00","060","0011","0000","1797","767","1030","15","1812","3726","0","48.63","20.59"
"66","000","00","060","0011","0754","578","235","343","6","584","1232","0","47.40","19.07"
"66","000","00","060","0011","0755","647","268","379","5","652","1225","0","53.22","21.88"
"66","000","00","060","0011","0756","572","264","308","4","576","1269","0","45.39","20.80"
"66","000","00","060","0012","0000","1022","866","156","19","1041","2082","0","50.00","41.59"
"66","000","00","060","0012","0757","501","426","75","8","509","1013","0","50.25","42.05"
"66","000","00","060","0012","0758","521","440","81","11","532","1069","0","49.77","41.16"
"66","000","00","060","0013","0000","1358","764","594","15","1373","3255","0","42.18","23.47"
"66","000","00","060","0013","0759","421","224","197","8","429","1038","0","41.33","21.58"
"66","000","00","060","0013","0760","419","219","200","3","422","1068","0","39.51","20.51"
"66","000","00","060","0013","0761","518","321","197","4","522","1149","0","45.43","27.94"
"66","000","00","060","0014","0000","1994","1106","888","13","2007","4745","0","42.30","23.31"
"66","000","00","060","0014","0762","588","302","286","4","592","1226","0","48.29","24.63"
"66","000","00","060","0014","0763","490","296","194","4","494","1220","0","40.49","24.26"
"66","000","00","060","0014","0764","552","300","252","2","554","1331","0","41.62","22.54"
"66","000","00","060","0014","0765","364","208","156","3","367","968","0","37.91","21.49"
"66","000","00","060","0015","0000","2121","1023","1098","22","2143","4944","0","43.35","20.69"
"66","000","00","060","0015","0766","475","178","297","7","482","1149","0","41.95","15.49"
"66","000","00","060","0015","0767","572","303","269","6","578","1282","0","45.09","23.63"
"66","000","00","060","0015","0768","527","272","255","4","531","1213","0","43.78","22.42"
"66","000","00","060","0015","0769","547","270","277","5","552","1300","0","42.46","20.77"
"66","000","00","060","0016","0000","1048","420","628","6","1054","2324","0","45.35","18.07"
"66","000","00","060","0016","0770","565","212","353","4","569","1257","0","45.27","16.87"
"66","000","00","060","0016","0771","483","208","275","2","485","1067","0","45.45","19.49"
"66","000","00","060","0017","0000","1428","762","666","14","1442","3398","0","42.44","22.42"
"66","000","00","060","0017","0772","533","334","199","3","536","1117","0","47.99","29.90"
"66","000","00","060","0017","0773","486","219","267","6","492","1182","0","41.62","18.53"
"66","000","00","060","0017","0774","409","209","200","5","414","1099","0","37.67","19.02"
"66","000","00","060","0018","0000","4987","2554","2433","45","5032","12696","0","39.63","20.12"
"66","000","00","060","0018","0775","655","211","444","11","666","1561","0","42.66","13.52"
"66","000","00","060","0018","0776","634","350","284","7","641","1432","0","44.76","24.44"
"66","000","00","060","0018","0777","595","291","304","4","599","1367","0","43.82","21.29"
"66","000","00","060","0018","0778","534","322","212","4","538","1387","0","38.79","23.22"
"66","000","00","060","0018","0779","521","255","266","2","523","1356","0","38.57","18.81"
"66","000","00","060","0018","0780","560","302","258","6","566","1397","0","40.52","21.62"
"66","000","00","060","0018","0781","495","286","209","5","500","1400","0","35.71","20.43"
"66","000","00","060","0018","0782","496","285","211","4","500","1401","0","35.69","20.34"
"66","000","00","060","0018","0783","497","252","245","2","499","1395","0","35.77","18.06"
"66","000","00","060","0019","0000","1348","695","653","14","1362","2940","0","46.33","23.64"
"66","000","00","060","0019","0784","696","351","345","7","703","1552","0","45.30","22.62"
"66","000","00","060","0019","0785","652","344","308","7","659","1388","0","47.48","24.78"
"66","000","00","060","0020","0000","1932","890","1042","17","1949","4642","0","41.99","19.17"
"66","000","00","060","0020","0810","515","240","275","5","520","1253","0","41.50","19.15"
"66","000","00","060","0020","0811","491","202","289","4","495","1123","0","44.08","17.99"
"66","000","00","060","0020","0812","443","217","226","4","447","1130","0","39.56","19.20"
"66","000","00","060","0020","0813","483","231","252","4","487","1136","0","42.87","20.33"
"66","000","00","060","0021","0000","2649","1286","1363","27","2676","6083","0","43.99","21.14"
"66","000","00","060","0021","0738","600","310","290","8","608","1478","0","41.14","20.97"
"66","000","00","060","0021","0739","634","297","337","5","639","1405","0","45.48","21.14"
"66","000","00","060","0021","0740","613","290","323","3","616","1367","0","45.06","21.21"
"66","000","00","060","0021","0741","385","184","201","2","387","890","0","43.48","20.67"
"66","000","00","060","0021","0742","417","205","212","9","426","943","0","45.17","21.74"
"66","000","00","060","0022","0000","1568","766","802","18","1586","3633","0","43.66","21.08"
"66","000","00","060","0022","0743","529","259","270","4","533","1229","0","43.37","21.07"
"66","000","00","060","0022","0744","539","261","278","9","548","1171","0","46.80","22.29"
"66","000","00","060","0022","0745","500","246","254","5","505","1233","0","40.96","19.95"
"66","000","00","060","0023","0000","2870","1509","1361","24","2894","6639","0","43.59","22.73"
"66","000","00","060","0023","0749","539","275","264","5","544","1243","0","43.77","22.12"
"66","000","00","060","0023","0750","559","297","262","4","563","1257","0","44.79","23.63"
"66","000","00","060","0023","0751","562","282","280","5","567","1319","0","42.99","21.38"
"66","000","00","060","0023","0752","630","344","286","7","637","1430","0","44.55","24.06"
"66","000","00","060","0023","0753","580","311","269","3","583","1390","0","41.94","22.37"
"66","000","00","060","0024","0000","1959","1181","778","20","1979","4807","0","41.17","24.57"
"66","000","00","060","0024","0675","459","281","178","0","459","1133","0","40.51","24.80"
"66","000","00","060","0024","0676","513","284","229","4","517","1296","0","39.89","21.91"
"66","000","00","060","0024","0677","567","411","156","12","579","1232","0","47.00","33.36"
"66","000","00","060","0024","0678","420","205","215","4","424","1146","0","37.00","17.89"
"66","000","00","060","0025","0000","1965","1027","938","15","1980","4097","0","48.33","25.07"
"66","000","00","060","0025","0726","643","355","288","6","649","1333","0","48.69","26.63"
"66","000","00","060","0025","0727","685","365","320","4","689","1386","0","49.71","26.33"
"66","000","00","060","0025","0728","637","307","330","5","642","1378","0","46.59","22.28"
"66","000","00","060","0026","0000","1907","1012","895","19","1926","4381","0","43.96","23.10"
"66","000","00","060","0026","0672","688","393","295","8","696","1616","0","43.07","24.32"
"66","000","00","060","0026","0673","569","293","276","7","576","1292","0","44.58","22.68"
"66","000","00","060","0026","0674","650","326","324","4","654","1473","0","44.40","22.13"
"66","000","00","060","0027","0000","2299","1185","1114","27","2326","5223","0","44.53","22.69"
"66","000","00","060","0027","0704","640","331","309","2","642","1385","0","46.35","23.90"
"66","000","00","060","0027","0705","563","264","299","8","571","1303","0","43.82","20.26"
"66","000","00","060","0027","0706","526","294","232","7","533","1286","0","41.45","22.86"
"66","000","00","060","0027","0707","570","296","274","10","580","1249","0","46.44","23.70"
"66","000","00","060","0028","0000","1870","1025","845","16","1886","4120","0","45.78","24.88"
"66","000","00","060","0028","0708","666","351","315","8","674","1380","0","48.84","25.43"
"66","000","00","060","0028","0709","572","313","259","4","576","1350","0","42.67","23.19"
"66","000","00","060","0028","0710","632","361","271","4","636","1390","0","45.76","25.97"
"66","000","00","060","0029","0000","2433","1312","1121","17","2450","5257","0","46.60","24.96"
"66","000","00","060","0029","0714","657","304","353","5","662","1425","0","46.46","21.33"
"66","000","00","060","0029","0715","598","346","252","5","603","1214","0","49.67","28.50"
"66","000","00","060","0029","0716","612","362","250","3","615","1307","0","47.05","27.70"
"66","000","00","060","0029","0717","566","300","266","4","570","1311","0","43.48","22.88"
"66","000","00","060","0030","0000","1686","815","871","13","1699","3558","0","47.75","22.91"
"66","000","00","060","0030","0723","615","279","336","1","616","1179","0","52.25","23.66"
"66","000","00","060","0030","0724","543","267","276","4","547","1194","0","45.81","22.36"
"66","000","00","060","0030","0725","528","269","259","8","536","1185","0","45.23","22.70"
"66","000","00","060","0031","0000","3067","1520","1547","23","3090","7080","0","43.64","21.47"
"66","000","00","060","0031","0729","648","320","328","4","652","1438","0","45.34","22.25"
"66","000","00","060","0031","0730","587","288","299","6","593","1449","0","40.92","19.88"
"66","000","00","060","0031","0731","623","284","339","4","627","1402","0","44.72","20.26"
"66","000","00","060","0031","0732","642","314","328","5","647","1403","0","46.12","22.38"
"66","000","00","060","0031","0733","567","314","253","4","571","1388","0","41.14","22.62"
"66","000","00","060","0032","0000","1951","916","1035","23","1974","4322","0","45.67","21.19"
"66","000","00","060","0032","0746","642","323","319","4","646","1423","0","45.40","22.70"
"66","000","00","060","0032","0747","655","299","356","13","668","1428","0","46.78","20.94"
"66","000","00","060","0032","0748","654","294","360","6","660","1471","0","44.87","19.99"
"66","000","00","060","0033","0000","1757","698","1059","21","1778","4278","0","41.56","16.32"
"66","000","00","060","0033","0800","629","235","394","6","635","1474","0","43.08","15.94"
"66","000","00","060","0033","0801","578","211","367","8","586","1430","0","40.98","14.76"
"66","000","00","060","0033","0802","550","252","298","7","557","1374","0","40.54","18.34"
"66","000","00","060","0034","0000","1373","680","693","16","1389","3203","0","43.37","21.23"
"66","000","00","060","0034","0803","501","249","252","5","506","1105","0","45.79","22.53"
"66","000","00","060","0034","0804","464","242","222","7","471","1048","0","44.94","23.09"
"66","000","00","060","0034","0805","408","189","219","4","412","1050","0","39.24","18.00"
"66","000","00","060","0035","0000","2246","1209","1037","23","2269","4778","0","47.49","25.30"
"66","000","00","060","0035","0806","573","295","278","4","577","1252","0","46.09","23.56"
"66","000","00","060","0035","0807","536","298","238","4","540","1183","0","45.65","25.19"
"66","000","00","060","0035","0808","543","312","231","7","550","1195","0","46.03","26.11"
"66","000","00","060","0035","0809","594","304","290","8","602","1148","0","52.44","26.48"
"66","000","00","060","0036","0000","1114","597","517","16","1130","3166","0","35.69","18.86"
"66","000","00","060","0036","0798","573","327","246","8","581","1626","0","35.73","20.11"
"66","000","00","060","0036","0799","541","270","271","8","549","1540","0","35.65","17.53"
"66","000","00","060","0037","0000","1120","641","479","9","1129","2980","0","37.89","21.51"
"66","000","00","060","0037","0796","588","335","253","3","591","1523","0","38.80","22.00"
"66","000","00","060","0037","0797","532","306","226","6","538","1457","0","36.93","21.00"
"66","000","00","060","0038","0000","3351","1869","1482","44","3395","7655","0","44.35","24.42"
"66","000","00","060","0038","0790","495","273","222","5","500","1275","0","39.22","21.41"
"66","000","00","060","0038","0791","567","341","226","11","578","1255","0","46.06","27.17"
"66","000","00","060","0038","0792","623","329","294","5","628","1404","0","44.73","23.43"
"66","000","00","060","0038","0793","554","262","292","10","564","1235","0","45.67","21.21"
"66","000","00","060","0038","0794","592","350","242","9","601","1274","0","47.17","27.47"
"66","000","00","060","0038","0795","520","314","206","4","524","1212","0","43.23","25.91"
"66","000","00","060","0039","0000","2460","1298","1162","20","2480","5769","0","42.99","22.50"
"66","000","00","060","0039","0786","623","319","304","5","628","1410","0","44.54","22.62"
"66","000","00","060","0039","0787","631","342","289","5","636","1394","0","45.62","24.53"
"66","000","00","060","0039","0788","642","320","322","7","649","1541","0","42.12","20.77"
"66","000","00","060","0039","0789","564","317","247","3","567","1424","0","39.82","22.26"
"66","000","00","070","0000","0000","61988","30899","31089","581","62569","142512","176754","43.90","21.68"
"66","000","00","070","0001","0000","3784","1830","1954","37","3821","8528","0","44.81","21.46"
"66","000","00","070","0001","0814","530","273","257","13","543","1220","0","44.51","22.38"
"66","000","00","070","0001","0815","552","237","315","5","557","1255","0","44.38","18.88"
"66","000","00","070","0001","0816","495","176","319","4","499","1129","0","44.20","15.59"
"66","000","00","070","0001","0817","614","253","361","4","618","1326","0","46.61","19.08"
"66","000","00","070","0001","0818","556","304","252","4","560","1272","0","44.03","23.90"
"66","000","00","070","0001","0819","562","326","236","3","565","1203","0","46.97","27.10"
"66","000","00","070","0001","0820","475","261","214","4","479","1123","0","42.65","23.24"
"66","000","00","070","0002","0000","5218","2570","2648","47","5265","11358","0","46.35","22.63"
"66","000","00","070","0002","0821","593","256","337","7","600","1414","0","42.43","18.10"
"66","000","00","070","0002","0822","617","297","320","8","625","1396","0","44.77","21.28"
"66","000","00","070","0002","0823","724","385","339","7","731","1591","0","45.95","24.20"
"66","000","00","070","0002","0824","660","328","332","4","664","1440","0","46.11","22.78"
"66","000","00","070","0002","0825","593","300","293","3","596","1349","0","44.18","22.24"
"66","000","00","070","0002","0826","645","312","333","6","651","1365","0","47.69","22.86"
"66","000","00","070","0002","0827","692","334","358","4","696","1434","0","48.54","23.29"
"66","000","00","070","0002","0828","694","358","336","8","702","1369","0","51.28","26.15"
"66","000","00","070","0003","0000","2805","1306","1499","28","2833","5891","0","48.09","22.17"
"66","000","00","070","0003","0829","677","328","349","7","684","1480","0","46.22","22.16"
"66","000","00","070","0003","0830","734","318","416","5","739","1525","0","48.46","20.85"
"66","000","00","070","0003","0831","694","311","383","10","704","1412","0","49.86","22.03"
"66","000","00","070","0003","0832","700","349","351","6","706","1474","0","47.90","23.68"
"66","000","00","070","0004","0000","1861","767","1094","15","1876","4324","0","43.39","17.74"
"66","000","00","070","0004","0833","616","266","350","9","625","1498","0","41.72","17.76"
"66","000","00","070","0004","0834","590","250","340","2","592","1384","0","42.77","18.06"
"66","000","00","070","0004","0835","655","251","404","4","659","1442","0","45.70","17.41"
"66","000","00","070","0005","0000","2463","1286","1177","22","2485","6534","0","38.03","19.68"
"66","000","00","070","0005","0838","489","224","265","5","494","1156","0","42.73","19.38"
"66","000","00","070","0005","0839","524","293","231","2","526","1270","0","41.42","23.07"
"66","000","00","070","0005","0840","510","264","246","3","513","1282","0","40.02","20.59"
"66","000","00","070","0005","0841","508","259","249","9","517","1358","0","38.07","19.07"
"66","000","00","070","0005","0842","432","246","186","3","435","1468","0","29.63","16.76"
"66","000","00","070","0006","0000","492","261","231","5","497","1366","0","36.38","19.11"
"66","000","00","070","0006","0843","492","261","231","5","497","1366","0","36.38","19.11"
"66","000","00","070","0007","0000","4276","2035","2241","29","4305","11272","0","38.19","18.05"
"66","000","00","070","0007","0844","451","208","243","6","457","1326","0","34.46","15.69"
"66","000","00","070","0007","0845","508","250","258","4","512","1248","0","41.03","20.03"
"66","000","00","070","0007","0846","472","213","259","2","474","1233","0","38.44","17.27"
"66","000","00","070","0007","0847","530","271","259","4","534","1433","0","37.26","18.91"
"66","000","00","070","0007","0848","579","266","313","2","581","1434","0","40.52","18.55"
"66","000","00","070","0007","0849","502","225","277","5","507","1405","0","36.09","16.01"
"66","000","00","070","0007","0850","637","316","321","3","640","1489","0","42.98","21.22"
"66","000","00","070","0007","0851","597","286","311","3","600","1704","0","35.21","16.78"
"66","000","00","070","0008","0000","909","420","489","10","919","2301","0","39.94","18.25"
"66","000","00","070","0008","0856","430","181","249","7","437","956","0","45.71","18.93"
"66","000","00","070","0008","0857","479","239","240","3","482","1345","0","35.84","17.77"
"66","000","00","070","0009","0000","2135","936","1199","20","2155","5105","0","42.21","18.33"
"66","000","00","070","0009","0858","509","231","278","6","515","1227","0","41.97","18.83"
"66","000","00","070","0009","0859","496","216","280","2","498","1207","0","41.26","17.90"
"66","000","00","070","0009","0860","538","212","326","7","545","1292","0","42.18","16.41"
"66","000","00","070","0009","0861","592","277","315","5","597","1379","0","43.29","20.09"
"66","000","00","070","0010","0000","2977","1534","1443","34","3011","7137","0","42.19","21.49"
"66","000","00","070","0010","0862","608","264","344","7","615","1334","0","46.10","19.79"
"66","000","00","070","0010","0863","617","331","286","5","622","1400","0","44.43","23.64"
"66","000","00","070","0010","0864","570","285","285","5","575","1397","0","41.16","20.40"
"66","000","00","070","0010","0865","617","323","294","13","630","1581","0","39.85","20.43"
"66","000","00","070","0010","0866","565","331","234","4","569","1425","0","39.93","23.23"
"66","000","00","070","0011","0000","2627","1353","1274","22","2649","5220","0","50.75","25.92"
"66","000","00","070","0011","0882","597","303","294","1","598","1150","0","52.00","26.35"
"66","000","00","070","0011","0883","665","339","326","11","676","1358","0","49.78","24.96"
"66","000","00","070","0011","0884","706","340","366","5","711","1425","0","49.89","23.86"
"66","000","00","070","0011","0885","659","371","288","5","664","1287","0","51.59","28.83"
"66","000","00","070","0012","0000","2750","1281","1469","33","2783","6268","0","44.40","20.44"
"66","000","00","070","0012","0896","742","368","374","9","751","1580","0","47.53","23.29"
"66","000","00","070","0012","0897","701","304","397","7","708","1498","0","47.26","20.29"
"66","000","00","070","0012","0898","693","332","361","8","701","1634","0","42.90","20.32"
"66","000","00","070","0012","0899","614","277","337","9","623","1556","0","40.04","17.80"
"66","000","00","070","0013","0000","1951","1147","804","19","1970","4151","0","47.46","27.63"
"66","000","00","070","0013","0878","515","322","193","4","519","951","0","54.57","33.86"
"66","000","00","070","0013","0879","466","278","188","5","471","1051","0","44.81","26.45"
"66","000","00","070","0013","0880","426","259","167","2","428","974","0","43.94","26.59"
"66","000","00","070","0013","0881","544","288","256","8","552","1175","0","46.98","24.51"
"66","000","00","070","0014","0000","578","217","361","11","589","1357","0","43.40","15.99"
"66","000","00","070","0014","0836","245","101","144","5","250","578","0","43.25","17.47"
"66","000","00","070","0014","0837","333","116","217","6","339","779","0","43.52","14.89"
"66","000","00","070","0015","0000","2268","1069","1199","16","2284","4877","0","46.83","21.92"
"66","000","00","070","0015","0910","591","286","305","4","595","1375","0","43.27","20.80"
"66","000","00","070","0015","0911","518","224","294","6","524","1133","0","46.25","19.77"
"66","000","00","070","0015","0912","592","278","314","3","595","1183","0","50.30","23.50"
"66","000","00","070","0015","0913","567","281","286","3","570","1186","0","48.06","23.69"
"66","000","00","070","0016","0000","1721","896","825","26","1747","3803","0","45.94","23.56"
"66","000","00","070","0016","0903","586","330","256","15","601","1233","0","48.74","26.76"
"66","000","00","070","0016","0904","618","303","315","6","624","1430","0","43.64","21.19"
"66","000","00","070","0016","0905","517","263","254","5","522","1140","0","45.79","23.07"
"66","000","00","070","0017","0000","2238","1150","1088","28","2266","5223","0","43.39","22.02"
"66","000","00","070","0017","0906","621","378","243","5","626","1499","0","41.76","25.22"
"66","000","00","070","0017","0907","678","344","334","6","684","1567","0","43.65","21.95"
"66","000","00","070","0017","0908","457","211","246","7","464","1019","0","45.53","20.71"
"66","000","00","070","0017","0909","482","217","265","10","492","1138","0","43.23","19.07"
"66","000","00","070","0018","0000","2162","1095","1067","19","2181","5433","0","40.14","20.15"
"66","000","00","070","0018","0900","750","341","409","6","756","1634","0","46.27","20.87"
"66","000","00","070","0018","0901","761","381","380","5","766","2281","0","33.58","16.70"
"66","000","00","070","0018","0902","651","373","278","8","659","1518","0","43.41","24.57"
"66","000","00","070","0019","0000","1637","805","832","17","1654","3609","0","45.83","22.31"
"66","000","00","070","0019","0917","511","258","253","7","518","1099","0","47.13","23.48"
"66","000","00","070","0019","0918","597","307","290","4","601","1292","0","46.52","23.76"
"66","000","00","070","0019","0919","529","240","289","6","535","1218","0","43.92","19.70"
"66","000","00","070","0020","0000","1995","939","1056","16","2011","4436","0","45.33","21.17"
"66","000","00","070","0020","0914","618","311","307","5","623","1289","0","48.33","24.13"
"66","000","00","070","0020","0915","656","301","355","4","660","1587","0","41.59","18.97"
"66","000","00","070","0020","0916","721","327","394","7","728","1560","0","46.67","20.96"
"66","000","00","070","0021","0000","3021","1557","1464","16","3037","6517","0","46.60","23.89"
"66","000","00","070","0021","0886","569","310","259","4","573","1209","0","47.39","25.64"
"66","000","00","070","0021","0887","584","311","273","0","584","1313","0","44.48","23.69"
"66","000","00","070","0021","0888","553","278","275","6","559","1259","0","44.40","22.08"
"66","000","00","070","0021","0889","615","302","313","3","618","1429","0","43.25","21.13"
"66","000","00","070","0021","0890","700","356","344","3","703","1307","0","53.79","27.24"
"66","000","00","070","0022","0000","3381","1718","1663","27","3408","7565","0","45.05","22.71"
"66","000","00","070","0022","0891","730","358","372","6","736","1629","0","45.18","21.98"
"66","000","00","070","0022","0892","624","353","271","4","628","1434","0","43.79","24.62"
"66","000","00","070","0022","0893","639","337","302","2","641","1470","0","43.61","22.93"
"66","000","00","070","0022","0894","649","319","330","5","654","1442","0","45.35","22.12"
"66","000","00","070","0022","0895","739","351","388","10","749","1590","0","47.11","22.08"
"66","000","00","070","0023","0000","2057","1029","1028","17","2074","5266","0","39.38","19.54"
"66","000","00","070","0023","0852","509","232","277","6","515","1275","0","40.39","18.20"
"66","000","00","070","0023","0853","444","213","231","5","449","1224","0","36.68","17.40"
"66","000","00","070","0023","0854","544","294","250","3","547","1334","0","41.00","22.04"
"66","000","00","070","0023","0855","560","290","270","3","563","1433","0","39.29","20.24"
"66","000","00","070","0024","0000","3776","2101","1675","45","3821","8478","0","45.07","24.78"
"66","000","00","070","0024","0872","656","354","302","6","662","1420","0","46.62","24.93"
"66","000","00","070","0024","0873","684","429","255","7","691","1475","0","46.85","29.08"
"66","000","00","070","0024","0874","682","375","307","14","696","1551","0","44.87","24.18"
"66","000","00","070","0024","0875","622","342","280","7","629","1345","0","46.77","25.43"
"66","000","00","070","0024","0876","571","306","265","9","580","1316","0","44.07","23.25"
"66","000","00","070","0024","0877","561","295","266","2","563","1371","0","41.06","21.52"
"66","000","00","070","0025","0000","2906","1597","1309","22","2928","6493","0","45.09","24.60"
"66","000","00","070","0025","0867","590","327","263","2","592","1339","0","44.21","24.42"
"66","000","00","070","0025","0868","549","322","227","5","554","1304","0","42.48","24.69"
"66","000","00","070","0025","0869","615","362","253","6","621","1290","0","48.14","28.06"
"66","000","00","070","0025","0870","603","302","301","5","608","1303","0","46.66","23.18"
"66","000","00","070","0025","0871","549","284","265","4","553","1257","0","43.99","22.59"
"66","000","00","080","0000","0000","101571","52864","48707","858","102429","238830","289830","42.89","22.13"
"66","000","00","080","0001","0000","1422","721","701","18","1440","3133","0","45.96","23.01"
"66","000","00","080","0001","0974","359","165","194","5","364","894","0","40.72","18.46"
"66","000","00","080","0001","0975","547","288","259","6","553","1150","0","48.09","25.04"
"66","000","00","080","0001","0976","516","268","248","7","523","1089","0","48.03","24.61"
"66","000","00","080","0002","0000","1469","820","649","14","1483","3392","0","43.72","24.17"
"66","000","00","080","0002","0968","524","273","251","4","528","1199","0","44.04","22.77"
"66","000","00","080","0002","0969","448","262","186","6","454","1081","0","42.00","24.24"
"66","000","00","080","0002","0970","497","285","212","4","501","1112","0","45.05","25.63"
"66","000","00","080","0003","0000","3033","1629","1404","34","3067","6954","0","44.10","23.43"
"66","000","00","080","0003","0920","598","342","256","8","606","1156","0","52.42","29.58"
"66","000","00","080","0003","0921","510","296","214","3","513","1215","0","42.22","24.36"
"66","000","00","080","0003","0922","433","224","209","5","438","1180","0","37.12","18.98"
"66","000","00","080","0003","0923","507","242","265","3","510","1178","0","43.29","20.54"
"66","000","00","080","0003","0924","471","236","235","8","479","1135","0","42.20","20.79"
"66","000","00","080","0003","0925","514","289","225","7","521","1090","0","47.80","26.51"
"66","000","00","080","0004","0000","2397","1272","1125","21","2418","5705","0","42.38","22.30"
"66","000","00","080","0004","0982","435","253","182","3","438","1072","0","40.86","23.60"
"66","000","00","080","0004","0983","556","249","307","7","563","1241","0","45.37","20.06"
"66","000","00","080","0004","0984","482","238","244","2","484","1103","0","43.88","21.58"
"66","000","00","080","0004","0985","432","244","188","4","436","1122","0","38.86","21.75"
"66","000","00","080","0004","0986","492","288","204","5","497","1167","0","42.59","24.68"
"66","000","00","080","0005","0000","2093","1146","947","13","2106","5097","0","41.32","22.48"
"66","000","00","080","0005","0991","529","270","259","3","532","1209","0","44.00","22.33"
"66","000","00","080","0005","0992","500","297","203","2","502","1196","0","41.97","24.83"
"66","000","00","080","0005","0993","576","307","269","5","581","1390","0","41.80","22.09"
"66","000","00","080","0005","0994","488","272","216","3","491","1302","0","37.71","20.89"
"66","000","00","080","0006","0000","1945","996","949","15","1960","4595","0","42.66","21.68"
"66","000","00","080","0006","1046","453","228","225","6","459","1081","0","42.46","21.09"
"66","000","00","080","0006","1047","366","145","221","4","370","929","0","39.83","15.61"
"66","000","00","080","0006","1048","608","321","287","1","609","1260","0","48.33","25.48"
"66","000","00","080","0006","1049","518","302","216","4","522","1325","0","39.40","22.79"
"66","000","00","080","0007","0000","2932","1467","1465","22","2954","7211","0","40.97","20.34"
"66","000","00","080","0007","1104","772","380","392","6","778","1803","0","43.15","21.08"
"66","000","00","080","0007","1105","619","298","321","2","621","1632","0","38.05","18.26"
"66","000","00","080","0007","1106","556","272","284","9","565","1425","0","39.65","19.09"
"66","000","00","080","0007","1107","522","259","263","1","523","1241","0","42.14","20.87"
"66","000","00","080","0007","1108","463","258","205","4","467","1110","0","42.07","23.24"
"66","000","00","080","0008","0000","5904","2867","3037","44","5948","13462","0","44.18","21.30"
"66","000","00","080","0008","0952","511","255","256","3","514","1240","0","41.45","20.56"
"66","000","00","080","0008","0953","490","234","256","1","491","1191","0","41.23","19.65"
"66","000","00","080","0008","0954","517","261","256","5","522","1183","0","44.13","22.06"
"66","000","00","080","0008","0955","628","304","324","6","634","1279","0","49.57","23.77"
"66","000","00","080","0008","0956","572","261","311","1","573","1268","0","45.19","20.58"
"66","000","00","080","0008","0957","584","269","315","5","589","1272","0","46.31","21.15"
"66","000","00","080","0008","0958","568","276","292","2","570","1359","0","41.94","20.31"
"66","000","00","080","0008","0959","520","257","263","4","524","1234","0","42.46","20.83"
"66","000","00","080","0008","0960","541","282","259","9","550","1248","0","44.07","22.60"
"66","000","00","080","0008","0961","533","271","262","4","537","1171","0","45.86","23.14"
"66","000","00","080","0008","0962","440","197","243","4","444","1017","0","43.66","19.37"
"66","000","00","080","0009","0000","5431","2518","2913","61","5492","12347","0","44.48","20.39"
"66","000","00","080","0009","1079","510","227","283","6","516","1139","0","45.30","19.93"
"66","000","00","080","0009","1080","540","247","293","8","548","1194","0","45.90","20.69"
"66","000","00","080","0009","1081","597","293","304","4","601","1299","0","46.27","22.56"
"66","000","00","080","0009","1082","448","221","227","4","452","1172","0","38.57","18.86"
"66","000","00","080","0009","1083","512","281","231","9","521","1261","0","41.32","22.28"
"66","000","00","080","0009","1084","570","236","334","5","575","1201","0","47.88","19.65"
"66","000","00","080","0009","1085","627","280","347","5","632","1360","0","46.47","20.59"
"66","000","00","080","0009","1086","620","313","307","6","626","1336","0","46.86","23.43"
"66","000","00","080","0009","1087","491","229","262","1","492","1154","0","42.63","19.84"
"66","000","00","080","0009","1088","516","191","325","13","529","1231","0","42.97","15.52"
"66","000","00","080","0010","0000","4750","2329","2421","32","4782","11410","0","41.91","20.41"
"66","000","00","080","0010","1033","706","319","387","5","711","1594","0","44.60","20.01"
"66","000","00","080","0010","1034","502","203","299","3","505","1202","0","42.01","16.89"
"66","000","00","080","0010","1035","733","385","348","6","739","1444","0","51.18","26.66"
"66","000","00","080","0010","1036","605","312","293","4","609","1675","0","36.36","18.63"
"66","000","00","080","0010","1037","586","295","291","4","590","1364","0","43.26","21.63"
"66","000","00","080","0010","1038","473","251","222","4","477","1201","0","39.72","20.90"
"66","000","00","080","0010","1039","549","285","264","1","550","1529","0","35.97","18.64"
"66","000","00","080","0010","1040","596","279","317","5","601","1401","0","42.90","19.91"
"66","000","00","080","0011","0000","919","366","553","11","930","2030","0","45.81","18.03"
"66","000","00","080","0011","1044","521","205","316","5","526","1165","0","45.15","17.60"
"66","000","00","080","0011","1045","398","161","237","6","404","865","0","46.71","18.61"
"66","000","00","080","0012","0000","374","174","200","3","377","1008","0","37.40","17.26"
"66","000","00","080","0012","1019","374","174","200","3","377","1008","0","37.40","17.26"
"66","000","00","080","0013","0000","5452","2833","2619","37","5489","14177","0","38.72","19.98"
"66","000","00","080","0013","1096","700","386","314","8","708","2133","0","33.19","18.10"
"66","000","00","080","0013","1097","663","350","313","2","665","1606","0","41.41","21.79"
"66","000","00","080","0013","1098","556","260","296","2","558","1395","0","40.00","18.64"
"66","000","00","080","0013","1099","707","386","321","2","709","1774","0","39.97","21.76"
"66","000","00","080","0013","1100","603","316","287","5","608","1463","0","41.56","21.60"
"66","000","00","080","0013","1101","652","348","304","3","655","1773","0","36.94","19.63"
"66","000","00","080","0013","1102","915","472","443","10","925","2505","0","36.93","18.84"
"66","000","00","080","0013","1103","656","315","341","5","661","1528","0","43.26","20.62"
"66","000","00","080","0014","0000","907","420","487","11","918","2160","0","42.50","19.44"
"66","000","00","080","0014","0931","458","180","278","6","464","1063","0","43.65","16.93"
"66","000","00","080","0014","0932","449","240","209","5","454","1097","0","41.39","21.88"
"66","000","00","080","0015","0000","356","163","193","3","359","905","0","39.67","18.01"
"66","000","00","080","0015","1020","356","163","193","3","359","905","0","39.67","18.01"
"66","000","00","080","0016","0000","3871","2140","1731","30","3901","8784","0","44.41","24.36"
"66","000","00","080","0016","1054","513","281","232","4","517","1170","0","44.19","24.02"
"66","000","00","080","0016","1055","519","329","190","4","523","1113","0","46.99","29.56"
"66","000","00","080","0016","1056","539","245","294","1","540","1174","0","46.00","20.87"
"66","000","00","080","0016","1057","517","260","257","5","522","1126","0","46.36","23.09"
"66","000","00","080","0016","1058","624","357","267","5","629","1416","0","44.42","25.21"
"66","000","00","080","0016","1059","574","336","238","5","579","1337","0","43.31","25.13"
"66","000","00","080","0016","1060","585","332","253","6","591","1448","0","40.81","22.93"
"66","000","00","080","0017","0000","3504","1812","1692","29","3533","9231","0","38.27","19.63"
"66","000","00","080","0017","0937","510","259","251","6","516","1107","0","46.61","23.40"
"66","000","00","080","0017","0938","495","281","214","2","497","1201","0","41.38","23.40"
"66","000","00","080","0017","0939","279","155","124","1","280","1948","0","14.37","7.96"
"66","000","00","080","0017","0940","528","239","289","9","537","1165","0","46.09","20.52"
"66","000","00","080","0017","0941","565","322","243","5","570","1231","0","46.30","26.16"
"66","000","00","080","0017","0942","514","250","264","4","518","1282","0","40.41","19.50"
"66","000","00","080","0017","0943","613","306","307","2","615","1297","0","47.42","23.59"
"66","000","00","080","0018","0000","3996","1995","2001","24","4020","9374","0","42.88","21.28"
"66","000","00","080","0018","0944","410","215","195","2","412","1044","0","39.46","20.59"
"66","000","00","080","0018","0945","445","243","202","0","445","1141","0","39.00","21.30"
"66","000","00","080","0018","0946","616","316","300","9","625","1323","0","47.24","23.89"
"66","000","00","080","0018","0947","490","221","269","3","493","1250","0","39.44","17.68"
"66","000","00","080","0018","0948","621","308","313","7","628","1543","0","40.70","19.96"
"66","000","00","080","0018","0949","700","340","360","2","702","1601","0","43.85","21.24"
"66","000","00","080","0018","0950","714","352","362","1","715","1472","0","48.57","23.91"
"66","000","00","080","0019","0000","689","324","365","8","697","1525","0","45.70","21.25"
"66","000","00","080","0019","0977","689","324","365","8","697","1525","0","45.70","21.25"
"66","000","00","080","0020","0000","4322","2537","1785","34","4356","9850","0","44.22","25.76"
"66","000","00","080","0020","1025","536","320","216","7","543","1258","0","43.16","25.44"
"66","000","00","080","0020","1026","426","246","180","1","427","1016","0","42.03","24.21"
"66","000","00","080","0020","1027","611","356","255","3","614","1250","0","49.12","28.48"
"66","000","00","080","0020","1028","546","292","254","4","550","1324","0","41.54","22.05"
"66","000","00","080","0020","1029","533","321","212","7","540","1210","0","44.63","26.53"
"66","000","00","080","0020","1030","515","308","207","3","518","1178","0","43.97","26.15"
"66","000","00","080","0020","1031","567","320","247","4","571","1337","0","42.71","23.93"
"66","000","00","080","0020","1032","588","374","214","5","593","1277","0","46.44","29.29"
"66","000","00","080","0021","0000","2400","1247","1153","29","2429","5327","0","45.60","23.41"
"66","000","00","080","0021","1021","699","321","378","10","709","1527","0","46.43","21.02"
"66","000","00","080","0021","1022","572","316","256","3","575","1230","0","46.75","25.69"
"66","000","00","080","0021","1023","538","292","246","11","549","1287","0","42.66","22.69"
"66","000","00","080","0021","1024","591","318","273","5","596","1283","0","46.45","24.79"
"66","000","00","080","0022","0000","477","286","191","5","482","1046","0","46.08","27.34"
"66","000","00","080","0022","0951","477","286","191","5","482","1046","0","46.08","27.34"
"66","000","00","080","0023","0000","2970","1523","1447","32","3002","6614","0","45.39","23.03"
"66","000","00","080","0023","0963","595","332","263","8","603","1355","0","44.50","24.50"
"66","000","00","080","0023","0964","556","308","248","5","561","1334","0","42.05","23.09"
"66","000","00","080","0023","0965","621","281","340","3","624","1246","0","50.08","22.55"
"66","000","00","080","0023","0966","612","326","286","10","622","1425","0","43.65","22.88"
"66","000","00","080","0023","0967","586","276","310","6","592","1254","0","47.21","22.01"
"66","000","00","080","0024","0000","1924","1085","839","20","1944","4564","0","42.59","23.77"
"66","000","00","080","0024","1089","605","325","280","10","615","1420","0","43.31","22.89"
"66","000","00","080","0024","1090","449","260","189","1","450","1078","0","41.74","24.12"
"66","000","00","080","0024","1091","397","190","207","5","402","1013","0","39.68","18.76"
"66","000","00","080","0024","1092","473","310","163","4","477","1053","0","45.30","29.44"
"66","000","00","080","0025","0000","1746","999","747","12","1758","4248","0","41.38","23.52"
"66","000","00","080","0025","1093","588","325","263","5","593","1520","0","39.01","21.38"
"66","000","00","080","0025","1094","537","324","213","4","541","1223","0","44.24","26.49"
"66","000","00","080","0025","1095","621","350","271","3","624","1505","0","41.46","23.26"
"66","000","00","080","0026","0000","2351","1174","1177","26","2377","5130","0","46.34","22.88"
"66","000","00","080","0026","0987","517","273","244","5","522","1126","0","46.36","24.25"
"66","000","00","080","0026","0988","625","285","340","5","630","1263","0","49.88","22.57"
"66","000","00","080","0026","0989","586","311","275","5","591","1345","0","43.94","23.12"
"66","000","00","080","0026","0990","623","305","318","11","634","1396","0","45.42","21.85"
"66","000","00","080","0027","0000","1394","700","694","10","1404","3146","0","44.63","22.25"
"66","000","00","080","0027","1003","505","253","252","2","507","1079","0","46.99","23.45"
"66","000","00","080","0027","1004","391","201","190","2","393","958","0","41.02","20.98"
"66","000","00","080","0027","1005","498","246","252","6","504","1109","0","45.45","22.18"
"66","000","00","080","0028","0000","2615","1355","1260","12","2627","6176","0","42.54","21.94"
"66","000","00","080","0028","1009","558","278","280","3","561","1311","0","42.79","21.21"
"66","000","00","080","0028","1010","554","271","283","3","557","1311","0","42.49","20.67"
"66","000","00","080","0028","1011","542","299","243","2","544","1360","0","40.00","21.99"
"66","000","00","080","0028","1012","517","265","252","2","519","1215","0","42.72","21.81"
"66","000","00","080","0028","1013","444","242","202","2","446","979","0","45.56","24.72"
"66","000","00","080","0029","0000","2054","1025","1029","23","2077","4780","0","43.45","21.44"
"66","000","00","080","0029","1050","487","219","268","5","492","1120","0","43.93","19.55"
"66","000","00","080","0029","1051","435","201","234","3","438","1117","0","39.21","17.99"
"66","000","00","080","0029","1052","572","298","274","8","580","1350","0","42.96","22.07"
"66","000","00","080","0029","1053","560","307","253","7","567","1193","0","47.53","25.73"
"66","000","00","080","0030","0000","2248","1254","994","22","2270","5241","0","43.31","23.93"
"66","000","00","080","0030","1070","597","340","257","7","604","1269","0","47.60","26.79"
"66","000","00","080","0030","1071","546","326","220","3","549","1345","0","40.82","24.24"
"66","000","00","080","0030","1072","573","323","250","9","582","1286","0","45.26","25.12"
"66","000","00","080","0030","1073","532","265","267","3","535","1341","0","39.90","19.76"
"66","000","00","080","0031","0000","2257","1307","950","20","2277","4863","0","46.82","26.88"
"66","000","00","080","0031","0933","609","325","284","3","612","1356","0","45.13","23.97"
"66","000","00","080","0031","0934","465","251","214","5","470","1034","0","45.45","24.27"
"66","000","00","080","0031","0935","612","373","239","8","620","1282","0","48.36","29.10"
"66","000","00","080","0031","0936","571","358","213","4","575","1191","0","48.28","30.06"
"66","000","00","080","0032","0000","2726","1385","1341","15","2741","6705","0","40.88","20.66"
"66","000","00","080","0032","1074","510","248","262","0","510","1295","0","39.38","19.15"
"66","000","00","080","0032","1075","563","286","277","6","569","1323","0","43.01","21.62"
"66","000","00","080","0032","1076","545","272","273","2","547","1370","0","39.93","19.85"
"66","000","00","080","0032","1077","504","269","235","3","507","1265","0","40.08","21.26"
"66","000","00","080","0032","1078","604","310","294","4","608","1452","0","41.87","21.35"
"66","000","00","080","0033","0000","2245","1181","1064","27","2272","5153","0","44.09","22.92"
"66","000","00","080","0033","1066","486","221","265","9","495","1316","0","37.61","16.79"
"66","000","00","080","0033","1067","571","299","272","6","577","1235","0","46.72","24.21"
"66","000","00","080","0033","1068","557","311","246","8","565","1260","0","44.84","24.68"
"66","000","00","080","0033","1069","631","350","281","4","635","1342","0","47.32","26.08"
"66","000","00","080","0034","0000","1453","687","766","14","1467","3180","0","46.13","21.60"
"66","000","00","080","0034","0971","469","202","267","5","474","1083","0","43.77","18.65"
"66","000","00","080","0034","0972","402","178","224","3","405","879","0","46.08","20.25"
"66","000","00","080","0034","0973","582","307","275","6","588","1218","0","48.28","25.21"
"66","000","00","080","0035","0000","2019","1063","956","8","2027","4765","0","42.54","22.31"
"66","000","00","080","0035","0978","524","256","268","3","527","1164","0","45.27","21.99"
"66","000","00","080","0035","0979","490","277","213","1","491","1164","0","42.18","23.80"
"66","000","00","080","0035","0980","526","269","257","2","528","1211","0","43.60","22.21"
"66","000","00","080","0035","0981","479","261","218","2","481","1226","0","39.23","21.29"
"66","000","00","080","0036","0000","1603","894","709","12","1615","3560","0","45.37","25.11"
"66","000","00","080","0036","1006","578","315","263","4","582","1161","0","50.13","27.13"
"66","000","00","080","0036","1007","488","290","198","3","491","1210","0","40.58","23.97"
"66","000","00","080","0036","1008","537","289","248","5","542","1189","0","45.58","24.31"
"66","000","00","080","0037","0000","2478","1299","1179","16","2494","6410","0","38.91","20.27"
"66","000","00","080","0037","1061","484","235","249","5","489","1275","0","38.35","18.43"
"66","000","00","080","0037","1062","506","285","221","4","510","1210","0","42.15","23.55"
"66","000","00","080","0037","1063","430","223","207","1","431","1292","0","33.36","17.26"
"66","000","00","080","0037","1064","549","294","255","2","551","1303","0","42.29","22.56"
"66","000","00","080","0037","1065","509","262","247","4","513","1330","0","38.57","19.70"
"66","000","00","080","0038","0000","2064","1087","977","19","2083","4887","0","42.62","22.24"
"66","000","00","080","0038","0999","469","240","229","6","475","1151","0","41.27","20.85"
"66","000","00","080","0038","1000","542","290","252","6","548","1303","0","42.06","22.26"
"66","000","00","080","0038","1001","464","234","230","2","466","1166","0","39.97","20.07"
"66","000","00","080","0038","1002","589","323","266","5","594","1267","0","46.88","25.49"
"66","000","00","080","0039","0000","2731","1433","1298","15","2746","6741","0","40.74","21.26"
"66","000","00","080","0039","1014","493","262","231","1","494","1422","0","34.74","18.42"
"66","000","00","080","0039","1015","580","283","297","1","581","1458","0","39.85","19.41"
"66","000","00","080","0039","1016","500","230","270","2","502","1280","0","39.22","17.97"
"66","000","00","080","0039","1017","552","284","268","5","557","1302","0","42.78","21.81"
"66","000","00","080","0039","1018","606","374","232","6","612","1279","0","47.85","29.24"
"66","000","00","080","0040","0000","1868","974","894","18","1886","4376","0","43.10","22.26"
"66","000","00","080","0040","0995","472","253","219","3","475","1106","0","42.95","22.88"
"66","000","00","080","0040","0996","444","229","215","5","449","1033","0","43.47","22.17"
"66","000","00","080","0040","0997","488","263","225","7","495","1193","0","41.49","22.05"
"66","000","00","080","0040","0998","464","229","235","3","467","1044","0","44.73","21.93"
"66","000","00","080","0041","0000","2479","1369","1110","24","2503","5662","0","44.21","24.18"
"66","000","00","080","0041","0926","584","348","236","4","588","1383","0","42.52","25.16"
"66","000","00","080","0041","0927","525","294","231","5","530","1302","0","40.71","22.58"
"66","000","00","080","0041","0928","571","312","259","5","576","1144","0","50.35","27.27"
"66","000","00","080","0041","0929","410","244","166","5","415","967","0","42.92","25.23"
"66","000","00","080","0041","0930","389","171","218","5","394","866","0","45.50","19.75"
"66","000","00","080","0042","0000","1703","1008","695","15","1718","3906","0","43.98","25.81"
"66","000","00","080","0042","1041","592","359","233","8","600","1361","0","44.09","26.38"
"66","000","00","080","0042","1042","653","379","274","4","657","1447","0","45.40","26.19"
"66","000","00","080","0042","1043","458","270","188","3","461","1098","0","41.99","24.59"
"66","000","00","090","0000","0000","58814","26452","32362","530","59344","136820","165529","43.37","19.33"
"66","000","00","090","0001","0000","984","517","467","15","999","2243","0","44.54","23.05"
"66","000","00","090","0001","1674","364","168","196","8","372","933","0","39.87","18.01"
"66","000","00","090","0001","1675","620","349","271","7","627","1310","0","47.86","26.64"
"66","000","00","090","0002","0000","422","169","253","1","423","919","0","46.03","18.39"
"66","000","00","090","0002","1677","422","169","253","1","423","919","0","46.03","18.39"
"66","000","00","090","0003","0000","402","171","231","4","406","795","0","51.07","21.51"
"66","000","00","090","0003","1678","402","171","231","4","406","795","0","51.07","21.51"
"66","000","00","090","0004","0000","514","204","310","7","521","1106","0","47.11","18.44"
"66","000","00","090","0004","1676","514","204","310","7","521","1106","0","47.11","18.44"
"66","000","00","090","0005","0000","298","127","171","3","301","744","0","40.46","17.07"
"66","000","00","090","0005","1679","298","127","171","3","301","744","0","40.46","17.07"
"66","000","00","090","0006","0000","384","150","234","3","387","720","0","53.75","20.83"
"66","000","00","090","0006","1703","384","150","234","3","387","720","0","53.75","20.83"
"66","000","00","090","0007","0000","301","121","180","3","304","607","0","50.08","19.93"
"66","000","00","090","0007","1704","301","121","180","3","304","607","0","50.08","19.93"
"66","000","00","090","0008","0000","756","355","401","4","760","1595","0","47.65","22.26"
"66","000","00","090","0008","1698","756","355","401","4","760","1595","0","47.65","22.26"
"66","000","00","090","0009","0000","2176","996","1180","19","2195","4781","0","45.91","20.83"
"66","000","00","090","0009","1705","568","267","301","4","572","1110","0","51.53","24.05"
"66","000","00","090","0009","1706","518","220","298","2","520","1225","0","42.45","17.96"
"66","000","00","090","0009","1707","543","254","289","7","550","1223","0","44.97","20.77"
"66","000","00","090","0009","1708","547","255","292","6","553","1223","0","45.22","20.85"
"66","000","00","090","0010","0000","1048","473","575","8","1056","2152","0","49.07","21.98"
"66","000","00","090","0010","1709","651","303","348","7","658","1286","0","51.17","23.56"
"66","000","00","090","0010","1710","397","170","227","1","398","866","0","45.96","19.63"
"66","000","00","090","0011","0000","663","286","377","7","670","1433","0","46.76","19.96"
"66","000","00","090","0011","1725","663","286","377","7","670","1433","0","46.76","19.96"
"66","000","00","090","0012","0000","469","184","285","3","472","1119","0","42.18","16.44"
"66","000","00","090","0012","1726","469","184","285","3","472","1119","0","42.18","16.44"
"66","000","00","090","0013","0000","1100","474","626","6","1106","2494","0","44.35","19.01"
"66","000","00","090","0013","1684","476","197","279","5","481","1068","0","45.04","18.45"
"66","000","00","090","0013","1685","624","277","347","1","625","1426","0","43.83","19.42"
"66","000","00","090","0014","0000","1281","644","637","17","1298","2882","0","45.04","22.35"
"66","000","00","090","0014","1686","630","326","304","6","636","1435","0","44.32","22.72"
"66","000","00","090","0014","1687","651","318","333","11","662","1447","0","45.75","21.98"
"66","000","00","090","0015","0000","1664","616","1048","12","1676","3976","0","42.15","15.49"
"66","000","00","090","0015","1688","572","201","371","5","577","1464","0","39.41","13.73"
"66","000","00","090","0015","1689","590","215","375","4","594","1377","0","43.14","15.61"
"66","000","00","090","0015","1690","502","200","302","3","505","1135","0","44.49","17.62"
"66","000","00","090","0016","0000","3831","1581","2250","44","3875","9125","0","42.47","17.33"
"66","000","00","090","0016","1691","589","232","357","11","600","1367","0","43.89","16.97"
"66","000","00","090","0016","1692","640","210","430","8","648","1439","0","45.03","14.59"
"66","000","00","090","0016","1693","409","166","243","5","414","1050","0","39.43","15.81"
"66","000","00","090","0016","1694","603","287","316","8","611","1428","0","42.79","20.10"
"66","000","00","090","0016","1695","455","191","264","2","457","1107","0","41.28","17.25"
"66","000","00","090","0016","1696","601","268","333","4","605","1364","0","44.35","19.65"
"66","000","00","090","0016","1697","534","227","307","6","540","1370","0","39.42","16.57"
"66","000","00","090","0017","0000","591","246","345","9","600","1231","0","48.74","19.98"
"66","000","00","090","0017","1699","591","246","345","9","600","1231","0","48.74","19.98"
"66","000","00","090","0018","0000","1497","734","763","11","1508","3367","0","44.79","21.80"
"66","000","00","090","0018","1700","540","274","266","4","544","1212","0","44.88","22.61"
"66","000","00","090","0018","1701","499","253","246","2","501","1065","0","47.04","23.76"
"66","000","00","090","0018","1702","458","207","251","5","463","1090","0","42.48","18.99"
"66","000","00","090","0019","0000","3897","1812","2085","32","3929","9864","0","39.83","18.37"
"66","000","00","090","0019","1713","511","226","285","6","517","1263","0","40.93","17.89"
"66","000","00","090","0019","1714","569","297","272","6","575","1411","0","40.75","21.05"
"66","000","00","090","0019","1715","541","260","281","7","548","1397","0","39.23","18.61"
"66","000","00","090","0019","1716","448","223","225","3","451","1418","0","31.81","15.73"
"66","000","00","090","0019","1717","586","299","287","2","588","1451","0","40.52","20.61"
"66","000","00","090","0019","1718","638","238","400","6","644","1415","0","45.51","16.82"
"66","000","00","090","0019","1719","604","269","335","2","606","1509","0","40.16","17.83"
"66","000","00","090","0020","0000","2792","1254","1538","25","2817","6283","0","44.84","19.96"
"66","000","00","090","0020","1720","544","259","285","8","552","1151","0","47.96","22.50"
"66","000","00","090","0020","1721","522","254","268","5","527","1164","0","45.27","21.82"
"66","000","00","090","0020","1722","602","276","326","4","606","1402","0","43.22","19.69"
"66","000","00","090","0020","1723","559","204","355","3","562","1228","0","45.77","16.61"
"66","000","00","090","0020","1724","565","261","304","5","570","1338","0","42.60","19.51"
"66","000","00","090","0021","0000","1231","676","555","19","1250","2877","0","43.45","23.50"
"66","000","00","090","0021","1711","579","287","292","9","588","1397","0","42.09","20.54"
"66","000","00","090","0021","1712","652","389","263","10","662","1480","0","44.73","26.28"
"66","000","00","090","0022","0000","2488","1141","1347","22","2510","6296","0","39.87","18.12"
"66","000","00","090","0022","1727","622","276","346","8","630","1991","0","31.64","13.86"
"66","000","00","090","0022","1728","632","303","329","5","637","1437","0","44.33","21.09"
"66","000","00","090","0022","1729","581","235","346","4","585","1370","0","42.70","17.15"
"66","000","00","090","0022","1730","653","327","326","5","658","1498","0","43.93","21.83"
"66","000","00","090","0023","0000","4262","1866","2396","31","4293","10193","0","42.12","18.31"
"66","000","00","090","0023","1731","658","282","376","6","664","1443","0","46.02","19.54"
"66","000","00","090","0023","1732","633","258","375","6","639","1446","0","44.19","17.84"
"66","000","00","090","0023","1733","599","226","373","5","604","1478","0","40.87","15.29"
"66","000","00","090","0023","1734","578","256","322","1","579","1443","0","40.12","17.74"
"66","000","00","090","0023","1735","596","266","330","4","600","1465","0","40.96","18.16"
"66","000","00","090","0023","1736","541","275","266","7","548","1383","0","39.62","19.88"
"66","000","00","090","0023","1737","657","303","354","2","659","1535","0","42.93","19.74"
"66","000","00","090","0024","0000","2000","902","1098","22","2022","4633","0","43.64","19.47"
"66","000","00","090","0024","1738","649","260","389","6","655","1537","0","42.62","16.92"
"66","000","00","090","0024","1739","647","309","338","12","659","1492","0","44.17","20.71"
"66","000","00","090","0024","1740","704","333","371","4","708","1604","0","44.14","20.76"
"66","000","00","090","0025","0000","4397","2072","2325","31","4428","10538","0","42.02","19.66"
"66","000","00","090","0025","1743","481","203","278","5","486","1243","0","39.10","16.33"
"66","000","00","090","0025","1744","537","288","249","9","546","1324","0","41.24","21.75"
"66","000","00","090","0025","1745","624","296","328","5","629","1402","0","44.86","21.11"
"66","000","00","090","0025","1746","622","286","336","3","625","1365","0","45.79","20.95"
"66","000","00","090","0025","1747","544","269","275","0","544","1364","0","39.88","19.72"
"66","000","00","090","0025","1748","546","265","281","4","550","1283","0","42.87","20.65"
"66","000","00","090","0025","1749","508","222","286","4","512","1200","0","42.67","18.50"
"66","000","00","090","0025","1750","535","243","292","1","536","1357","0","39.50","17.91"
"66","000","00","090","0026","0000","1160","548","612","15","1175","2631","0","44.66","20.83"
"66","000","00","090","0026","1741","519","246","273","10","529","1174","0","45.06","20.95"
"66","000","00","090","0026","1742","641","302","339","5","646","1457","0","44.34","20.73"
"66","000","00","090","0027","0000","5443","2545","2898","37","5480","12989","0","42.19","19.59"
"66","000","00","090","0027","1751","612","296","316","2","614","1520","0","40.39","19.47"
"66","000","00","090","0027","1752","609","265","344","7","616","1446","0","42.60","18.33"
"66","000","00","090","0027","1753","597","307","290","2","599","1448","0","41.37","21.20"
"66","000","00","090","0027","1754","649","279","370","2","651","1558","0","41.78","17.91"
"66","000","00","090","0027","1755","658","301","357","5","663","1499","0","44.23","20.08"
"66","000","00","090","0027","1756","610","293","317","7","617","1434","0","43.03","20.43"
"66","000","00","090","0027","1757","624","309","315","2","626","1469","0","42.61","21.03"
"66","000","00","090","0027","1758","507","252","255","5","512","1246","0","41.09","20.22"
"66","000","00","090","0027","1759","577","243","334","5","582","1369","0","42.51","17.75"
"66","000","00","090","0028","0000","2261","1079","1182","15","2276","5045","0","45.11","21.39"
"66","000","00","090","0028","1680","602","263","339","4","606","1333","0","45.46","19.73"
"66","000","00","090","0028","1681","551","253","298","1","552","1275","0","43.29","19.84"
"66","000","00","090","0028","1682","620","306","314","6","626","1371","0","45.66","22.32"
"66","000","00","090","0028","1683","488","257","231","4","492","1066","0","46.15","24.11"
"66","000","00","090","0029","0000","727","287","440","10","737","1574","0","46.82","18.23"
"66","000","00","090","0029","1760","727","287","440","10","737","1574","0","46.82","18.23"
"66","000","00","090","0030","0000","2321","997","1324","21","2342","5234","0","44.75","19.05"
"66","000","00","090","0030","1761","597","215","382","10","607","1400","0","43.36","15.36"
"66","000","00","090","0030","1762","579","242","337","2","581","1183","0","49.11","20.46"
"66","000","00","090","0030","1763","543","236","307","1","544","1198","0","45.41","19.70"
"66","000","00","090","0030","1764","602","304","298","8","610","1453","0","41.98","20.92"
"66","000","00","090","0031","0000","1392","576","816","16","1408","3175","0","44.35","18.14"
"66","000","00","090","0031","1765","450","210","240","5","455","1086","0","41.90","19.34"
"66","000","00","090","0031","1766","489","186","303","7","496","1085","0","45.71","17.14"
"66","000","00","090","0031","1767","453","180","273","4","457","1004","0","45.52","17.93"
"66","000","00","090","0032","0000","1442","592","850","15","1457","3377","0","43.14","17.53"
"66","000","00","090","0032","1768","480","192","288","2","482","1048","0","45.99","18.32"
"66","000","00","090","0032","1769","453","179","274","8","461","1096","0","42.06","16.33"
"66","000","00","090","0032","1770","509","221","288","5","514","1233","0","41.69","17.92"
"66","000","00","090","0033","0000","976","490","486","10","986","2265","0","43.53","21.63"
"66","000","00","090","0033","1771","490","255","235","5","495","1109","0","44.63","22.99"
"66","000","00","090","0033","1772","486","235","251","5","491","1156","0","42.47","20.33"
"66","000","00","090","0034","0000","1331","619","712","11","1342","3221","0","41.66","19.22"
"66","000","00","090","0034","1773","458","236","222","3","461","1053","0","43.78","22.41"
"66","000","00","090","0034","1774","428","174","254","6","434","1080","0","40.19","16.11"
"66","000","00","090","0034","1775","445","209","236","2","447","1088","0","41.08","19.21"
"66","000","00","090","0035","0000","956","418","538","10","966","2049","0","47.14","20.40"
"66","000","00","090","0035","1776","436","200","236","3","439","944","0","46.50","21.19"
"66","000","00","090","0035","1777","520","218","302","7","527","1105","0","47.69","19.73"
"66","000","00","090","0036","0000","1357","530","827","12","1369","3287","0","41.65","16.12"
"66","000","00","090","0036","1778","494","211","283","2","496","1089","0","45.55","19.38"
"66","000","00","090","0036","1779","420","168","252","6","426","1036","0","41.12","16.22"
"66","000","00","090","0036","1780","443","151","292","4","447","1162","0","38.47","12.99"
"66","000","00","100","0000","0000","16869","9349","7520","226","17095","42357","48747","40.36","22.07"
"66","000","00","100","0001","0000","492","298","194","8","500","1297","0","38.55","22.98"
"66","000","00","100","0001","1843","492","298","194","8","500","1297","0","38.55","22.98"
"66","000","00","100","0002","0000","364","235","129","7","371","833","0","44.54","28.21"
"66","000","00","100","0002","1842","364","235","129","7","371","833","0","44.54","28.21"
"66","000","00","100","0003","0000","430","257","173","3","433","996","0","43.47","25.80"
"66","000","00","100","0003","1841","430","257","173","3","433","996","0","43.47","25.80"
"66","000","00","100","0004","0000","804","517","287","8","812","1754","0","46.29","29.48"
"66","000","00","100","0004","1839","397","256","141","3","400","913","0","43.81","28.04"
"66","000","00","100","0004","1840","407","261","146","5","412","841","0","48.99","31.03"
"66","000","00","100","0005","0000","910","501","409","7","917","2138","0","42.89","23.43"
"66","000","00","100","0005","1837","468","275","193","4","472","1124","0","41.99","24.47"
"66","000","00","100","0005","1838","442","226","216","3","445","1014","0","43.89","22.29"
"66","000","00","100","0006","0000","424","262","162","1","425","951","0","44.69","27.55"
"66","000","00","100","0006","1835","424","262","162","1","425","951","0","44.69","27.55"
"66","000","00","100","0007","0000","570","332","238","9","579","1403","0","41.27","23.66"
"66","000","00","100","0007","1836","570","332","238","9","579","1403","0","41.27","23.66"
"66","000","00","100","0008","0000","1444","917","527","17","1461","3402","0","42.95","26.95"
"66","000","00","100","0008","1832","450","263","187","8","458","1103","0","41.52","23.84"
"66","000","00","100","0008","1833","543","370","173","6","549","1259","0","43.61","29.39"
"66","000","00","100","0008","1834","451","284","167","3","454","1040","0","43.65","27.31"
"66","000","00","100","0009","0000","667","384","283","11","678","1835","0","36.95","20.93"
"66","000","00","100","0009","1830","309","192","117","5","314","849","0","36.98","22.61"
"66","000","00","100","0009","1831","358","192","166","6","364","986","0","36.92","19.47"
"66","000","00","100","0010","0000","1463","841","622","18","1481","3709","0","39.93","22.67"
"66","000","00","100","0010","1826","487","295","192","7","494","1166","0","42.37","25.30"
"66","000","00","100","0010","1827","576","327","249","6","582","1411","0","41.25","23.18"
"66","000","00","100","0010","1828","400","219","181","5","405","1132","0","35.78","19.35"
"66","000","00","100","0011","0000","487","271","216","4","491","1418","0","34.63","19.11"
"66","000","00","100","0011","1829","487","271","216","4","491","1418","0","34.63","19.11"
"66","000","00","100","0012","0000","1888","986","902","20","1908","4812","0","39.65","20.49"
"66","000","00","100","0012","1822","449","207","242","9","458","1276","0","35.89","16.22"
"66","000","00","100","0012","1823","459","259","200","7","466","1144","0","40.73","22.64"
"66","000","00","100","0012","1824","504","252","252","2","506","1236","0","40.94","20.39"
"66","000","00","100","0012","1825","476","268","208","2","478","1156","0","41.35","23.18"
"66","000","00","100","0013","0000","665","333","332","13","678","1616","0","41.96","20.61"
"66","000","00","100","0013","1820","392","175","217","6","398","901","0","44.17","19.42"
"66","000","00","100","0013","1821","273","158","115","7","280","715","0","39.16","22.10"
"66","000","00","100","0014","0000","427","228","199","10","437","963","0","45.38","23.68"
"66","000","00","100","0014","1818","427","228","199","10","437","963","0","45.38","23.68"
"66","000","00","100","0015","0000","367","178","189","5","372","832","0","44.71","21.39"
"66","000","00","100","0015","1819","367","178","189","5","372","832","0","44.71","21.39"
"66","000","00","100","0016","0000","695","315","380","16","711","1825","0","38.96","17.26"
"66","000","00","100","0016","1816","357","163","194","11","368","988","0","37.25","16.50"
"66","000","00","100","0016","1817","338","152","186","5","343","837","0","40.98","18.16"
"66","000","00","100","0017","0000","375","195","180","5","380","1233","0","30.82","15.82"
"66","000","00","100","0017","1815","375","195","180","5","380","1233","0","30.82","15.82"
"66","000","00","100","0018","0000","854","521","333","12","866","1954","0","44.32","26.66"
"66","000","00","100","0018","1848","415","255","160","3","418","956","0","43.72","26.67"
"66","000","00","100","0018","1849","439","266","173","9","448","998","0","44.89","26.65"
"66","000","00","100","0019","0000","839","461","378","12","851","2023","0","42.07","22.79"
"66","000","00","100","0019","1844","295","177","118","3","298","723","0","41.22","24.48"
"66","000","00","100","0019","1845","544","284","260","9","553","1300","0","42.54","21.85"
"66","000","00","100","0020","0000","656","329","327","12","668","1651","0","40.46","19.93"
"66","000","00","100","0020","1846","423","205","218","5","428","1010","0","42.38","20.30"
"66","000","00","100","0020","1847","233","124","109","7","240","641","0","37.44","19.34"
"66","000","00","100","0021","0000","457","215","242","3","460","1172","0","39.25","18.34"
"66","000","00","100","0021","1850","457","215","242","3","460","1172","0","39.25","18.34"
"66","000","00","100","0022","0000","618","339","279","9","627","1817","0","34.51","18.66"
"66","000","00","100","0022","1851","258","128","130","4","262","901","0","29.08","14.21"
"66","000","00","100","0022","1852","360","211","149","5","365","916","0","39.85","23.03"
"66","000","00","100","0023","0000","226","121","105","2","228","701","0","32.52","17.26"
"66","000","00","100","0023","1853","226","121","105","2","228","701","0","32.52","17.26"
"66","000","00","100","0024","0000","285","107","178","6","291","657","0","44.29","16.29"
"66","000","00","100","0024","1854","285","107","178","6","291","657","0","44.29","16.29"
"66","000","00","100","0025","0000","462","206","256","8","470","1365","0","34.43","15.09"
"66","000","00","100","0025","1855","462","206","256","8","470","1365","0","34.43","15.09"
"66","000","00","110","0000","0000","23334","10815","12519","257","23591","62481","75819","37.76","17.31"
"66","000","00","110","0001","0000","577","260","317","5","582","1331","0","43.73","19.53"
"66","000","00","110","0001","0001","577","260","317","5","582","1331","0","43.73","19.53"
"66","000","00","110","0002","0000","435","183","252","3","438","991","0","44.20","18.47"
"66","000","00","110","0002","0002","435","183","252","3","438","991","0","44.20","18.47"
"66","000","00","110","0003","0000","683","302","381","4","687","1532","0","44.84","19.71"
"66","000","00","110","0003","0003","323","144","179","2","325","695","0","46.76","20.72"
"66","000","00","110","0003","0004","360","158","202","2","362","837","0","43.25","18.88"
"66","000","00","110","0004","0000","289","147","142","1","290","748","0","38.77","19.65"
"66","000","00","110","0004","0005","289","147","142","1","290","748","0","38.77","19.65"
"66","000","00","110","0005","0000","786","349","437","10","796","2008","0","39.64","17.38"
"66","000","00","110","0005","0006","365","169","196","6","371","864","0","42.94","19.56"
"66","000","00","110","0005","0007","421","180","241","4","425","1144","0","37.15","15.73"
"66","000","00","110","0006","0000","883","387","496","11","894","2055","0","43.50","18.83"
"66","000","00","110","0006","0008","385","149","236","6","391","899","0","43.49","16.57"
"66","000","00","110","0006","0009","498","238","260","5","503","1156","0","43.51","20.59"
"66","000","00","110","0007","0000","1330","651","679","15","1345","3394","0","39.63","19.18"
"66","000","00","110","0007","0010","417","196","221","4","421","1062","0","39.64","18.46"
"66","000","00","110","0007","0011","477","226","251","8","485","1276","0","38.01","17.71"
"66","000","00","110","0007","0012","436","229","207","3","439","1056","0","41.57","21.69"
"66","000","00","110","0008","0000","768","382","386","11","779","2042","0","38.15","18.71"
"66","000","00","110","0008","0013","389","177","212","4","393","1015","0","38.72","17.44"
"66","000","00","110","0008","0014","379","205","174","7","386","1027","0","37.59","19.96"
"66","000","00","110","0009","0000","1705","888","817","31","1736","4515","0","38.45","19.67"
"66","000","00","110","0009","0015","426","217","209","5","431","1112","0","38.76","19.51"
"66","000","00","110","0009","0016","423","205","218","12","435","1133","0","38.39","18.09"
"66","000","00","110","0009","0017","466","269","197","4","470","1282","0","36.66","20.98"
"66","000","00","110","0009","0018","390","197","193","10","400","988","0","40.49","19.94"
"66","000","00","110","0010","0000","326","154","172","5","331","813","0","40.71","18.94"
"66","000","00","110","0010","0019","326","154","172","5","331","813","0","40.71","18.94"
"66","000","00","110","0011","0000","397","168","229","5","402","860","0","46.74","19.53"
"66","000","00","110","0011","0020","397","168","229","5","402","860","0","46.74","19.53"
"66","000","00","110","0012","0000","1141","562","579","9","1150","3232","0","35.58","17.39"
"66","000","00","110","0012","0021","577","276","301","1","578","1628","0","35.50","16.95"
"66","000","00","110","0012","0022","564","286","278","8","572","1604","0","35.66","17.83"
"66","000","00","110","0013","0000","452","227","225","4","456","1160","0","39.31","19.57"
"66","000","00","110","0013","0023","452","227","225","4","456","1160","0","39.31","19.57"
"66","000","00","110","0014","0000","354","132","222","2","356","1073","0","33.18","12.30"
"66","000","00","110","0014","0024","354","132","222","2","356","1073","0","33.18","12.30"
"66","000","00","110","0015","0000","702","333","369","3","705","1810","0","38.95","18.40"
"66","000","00","110","0015","0025","390","189","201","1","391","966","0","40.48","19.57"
"66","000","00","110","0015","0026","312","144","168","2","314","844","0","37.20","17.06"
"66","000","00","110","0016","0000","2062","1003","1059","25","2087","5206","0","40.09","19.27"
"66","000","00","110","0016","0027","535","269","266","9","544","1322","0","41.15","20.35"
"66","000","00","110","0016","0028","434","198","236","3","437","1082","0","40.39","18.30"
"66","000","00","110","0016","0029","467","230","237","5","472","1161","0","40.65","19.81"
"66","000","00","110","0016","0030","379","182","197","8","387","955","0","40.52","19.06"
"66","000","00","110","0016","0031","247","124","123","0","247","686","0","36.01","18.08"
"66","000","00","110","0017","0000","795","404","391","5","800","1996","0","40.08","20.24"
"66","000","00","110","0017","0032","503","260","243","4","507","1241","0","40.85","20.95"
"66","000","00","110","0017","0033","292","144","148","1","293","755","0","38.81","19.07"
"66","000","00","110","0018","0000","635","255","380","3","638","1755","0","36.35","14.53"
"66","000","00","110","0018","0034","298","92","206","0","298","770","0","38.70","11.95"
"66","000","00","110","0018","0035","337","163","174","3","340","985","0","34.52","16.55"
"66","000","00","110","0019","0000","467","216","251","1","468","1356","0","34.51","15.93"
"66","000","00","110","0019","0036","467","216","251","1","468","1356","0","34.51","15.93"
"66","000","00","110","0020","0000","1670","776","894","18","1688","4450","0","37.93","17.44"
"66","000","00","110","0020","0037","454","198","256","5","459","1319","0","34.80","15.01"
"66","000","00","110","0020","0038","435","220","215","6","441","1156","0","38.15","19.03"
"66","000","00","110","0020","0039","358","152","206","5","363","928","0","39.12","16.38"
"66","000","00","110","0020","0040","423","206","217","2","425","1047","0","40.59","19.68"
"66","000","00","110","0021","0000","427","176","251","10","437","1233","0","35.44","14.27"
"66","000","00","110","0021","0041","427","176","251","10","437","1233","0","35.44","14.27"
"66","000","00","110","0022","0000","1373","594","779","14","1387","3909","0","35.48","15.20"
"66","000","00","110","0022","0042","524","251","273","6","530","1363","0","38.88","18.42"
"66","000","00","110","0022","0043","353","141","212","4","357","1160","0","30.78","12.16"
"66","000","00","110","0022","0044","496","202","294","4","500","1386","0","36.08","14.57"
"66","000","00","110","0023","0000","850","347","503","14","864","2515","0","34.35","13.80"
"66","000","00","110","0023","0045","385","140","245","7","392","1119","0","35.03","12.51"
"66","000","00","110","0023","0046","465","207","258","7","472","1396","0","33.81","14.83"
"66","000","00","110","0024","0000","1810","836","974","19","1829","5476","0","33.40","15.27"
"66","000","00","110","0024","0047","451","187","264","4","455","1231","0","36.96","15.19"
"66","000","00","110","0024","0048","477","227","250","6","483","1473","0","32.79","15.41"
"66","000","00","110","0024","0049","434","190","244","4","438","1415","0","30.95","13.43"
"66","000","00","110","0024","0050","448","232","216","5","453","1357","0","33.38","17.10"
"66","000","00","110","0025","0000","577","258","319","6","583","1475","0","39.53","17.49"
"66","000","00","110","0025","0051","255","133","122","4","259","640","0","40.47","20.78"
"66","000","00","110","0025","0052","322","125","197","2","324","835","0","38.80","14.97"
"66","000","00","110","0026","0000","594","282","312","7","601","1649","0","36.45","17.10"
"66","000","00","110","0026","0053","306","136","170","3","309","869","0","35.56","15.65"
"66","000","00","110","0026","0054","288","146","142","4","292","780","0","37.44","18.72"
"66","000","00","110","0027","0000","432","187","245","9","441","1340","0","32.91","13.96"
"66","000","00","110","0027","0055","432","187","245","9","441","1340","0","32.91","13.96"
"66","000","00","110","0028","0000","375","182","193","1","376","1111","0","33.84","16.38"
"66","000","00","110","0028","0056","375","182","193","1","376","1111","0","33.84","16.38"
"66","000","00","110","0029","0000","439","174","265","6","445","1446","0","30.77","12.03"
"66","000","00","110","0029","0057","439","174","265","6","445","1446","0","30.77","12.03"
"66","000","00","120","0000","0000","28476","12665","15811","299","28775","73629","88227","39.08","17.20"
"66","000","00","120","0001","0000","463","209","254","6","469","1063","0","44.12","19.66"
"66","000","00","120","0001","0099","463","209","254","6","469","1063","0","44.12","19.66"
"66","000","00","120","0002","0000","462","208","254","4","466","930","0","50.11","22.37"
"66","000","00","120","0002","0100","462","208","254","4","466","930","0","50.11","22.37"
"66","000","00","120","0003","0000","912","412","500","9","921","2049","0","44.95","20.11"
"66","000","00","120","0003","0101","375","154","221","5","380","892","0","42.60","17.26"
"66","000","00","120","0003","0102","537","258","279","4","541","1157","0","46.76","22.30"
"66","000","00","120","0004","0000","308","130","178","6","314","661","0","47.50","19.67"
"66","000","00","120","0004","0103","308","130","178","6","314","661","0","47.50","19.67"
"66","000","00","120","0005","0000","765","351","414","2","767","1743","0","44.00","20.14"
"66","000","00","120","0005","0104","380","175","205","2","382","853","0","44.78","20.52"
"66","000","00","120","0005","0105","385","176","209","0","385","890","0","43.26","19.78"
"66","000","00","120","0006","0000","660","277","383","3","663","1553","0","42.69","17.84"
"66","000","00","120","0006","0106","660","277","383","3","663","1553","0","42.69","17.84"
"66","000","00","120","0007","0000","324","141","183","7","331","673","0","49.18","20.95"
"66","000","00","120","0007","0107","324","141","183","7","331","673","0","49.18","20.95"
"66","000","00","120","0008","0000","210","91","119","1","211","391","0","53.96","23.27"
"66","000","00","120","0008","0108","210","91","119","1","211","391","0","53.96","23.27"
"66","000","00","120","0009","0000","954","413","541","12","966","2191","0","44.09","18.85"
"66","000","00","120","0009","0109","618","256","362","9","627","1424","0","44.03","17.98"
"66","000","00","120","0009","0110","336","157","179","3","339","767","0","44.20","20.47"
"66","000","00","120","0010","0000","4108","1889","2219","35","4143","9925","0","41.74","19.03"
"66","000","00","120","0010","0111","555","259","296","1","556","1315","0","42.28","19.70"
"66","000","00","120","0010","0112","667","288","379","11","678","1676","0","40.45","17.18"
"66","000","00","120","0010","0113","530","260","270","3","533","1327","0","40.17","19.59"
"66","000","00","120","0010","0114","624","319","305","4","628","1352","0","46.45","23.59"
"66","000","00","120","0010","0115","543","246","297","8","551","1392","0","39.58","17.67"
"66","000","00","120","0010","0116","631","281","350","7","638","1553","0","41.08","18.09"
"66","000","00","120","0010","0117","558","236","322","1","559","1310","0","42.67","18.02"
"66","000","00","120","0011","0000","540","230","310","4","544","1448","0","37.57","15.88"
"66","000","00","120","0011","0118","540","230","310","4","544","1448","0","37.57","15.88"
"66","000","00","120","0012","0000","593","271","322","6","599","1505","0","39.80","18.01"
"66","000","00","120","0012","0119","593","271","322","6","599","1505","0","39.80","18.01"
"66","000","00","120","0013","0000","1736","823","913","27","1763","4370","0","40.34","18.83"
"66","000","00","120","0013","0120","575","253","322","12","587","1508","0","38.93","16.78"
"66","000","00","120","0013","0121","670","315","355","11","681","1611","0","42.27","19.55"
"66","000","00","120","0013","0122","491","255","236","4","495","1251","0","39.57","20.38"
"66","000","00","120","0014","0000","1240","515","725","12","1252","3341","0","37.47","15.41"
"66","000","00","120","0014","0123","428","164","264","3","431","1170","0","36.84","14.02"
"66","000","00","120","0014","0124","495","218","277","3","498","1310","0","38.02","16.64"
"66","000","00","120","0014","0125","317","133","184","6","323","861","0","37.51","15.45"
"66","000","00","120","0015","0000","793","323","470","12","805","2104","0","38.26","15.35"
"66","000","00","120","0015","0126","429","170","259","7","436","1082","0","40.30","15.71"
"66","000","00","120","0015","0127","364","153","211","5","369","1022","0","36.11","14.97"
"66","000","00","120","0016","0000","2298","965","1333","16","2314","6655","0","34.77","14.50"
"66","000","00","120","0016","0128","575","253","322","2","577","1529","0","37.74","16.55"
"66","000","00","120","0016","0129","550","187","363","6","556","1473","0","37.75","12.70"
"66","000","00","120","0016","0130","657","300","357","7","664","2246","0","29.56","13.36"
"66","000","00","120","0016","0131","516","225","291","1","517","1407","0","36.74","15.99"
"66","000","00","120","0017","0000","1182","822","360","10","1192","2801","0","42.56","29.35"
"66","000","00","120","0017","0132","765","622","143","6","771","1641","0","46.98","37.90"
"66","000","00","120","0017","0133","417","200","217","4","421","1160","0","36.29","17.24"
"66","000","00","120","0018","0000","396","225","171","6","402","1278","0","31.46","17.61"
"66","000","00","120","0018","0134","396","225","171","6","402","1278","0","31.46","17.61"
"66","000","00","120","0019","0000","447","202","245","4","451","1330","0","33.91","15.19"
"66","000","00","120","0019","0135","447","202","245","4","451","1330","0","33.91","15.19"
"66","000","00","120","0020","0000","412","168","244","7","419","1234","0","33.95","13.61"
"66","000","00","120","0020","0136","412","168","244","7","419","1234","0","33.95","13.61"
"66","000","00","120","0021","0000","334","151","183","3","337","1155","0","29.18","13.07"
"66","000","00","120","0021","0137","334","151","183","3","337","1155","0","29.18","13.07"
"66","000","00","120","0022","0000","445","216","229","7","452","1309","0","34.53","16.50"
"66","000","00","120","0022","0138","445","216","229","7","452","1309","0","34.53","16.50"
"66","000","00","120","0023","0000","662","224","438","6","668","2039","0","32.76","10.99"
"66","000","00","120","0023","0139","338","109","229","4","342","1134","0","30.16","9.61"
"66","000","00","120","0023","0140","324","115","209","2","326","905","0","36.02","12.71"
"66","000","00","120","0024","0000","898","345","553","6","904","2252","0","40.14","15.32"
"66","000","00","120","0024","0141","462","180","282","5","467","1111","0","42.03","16.20"
"66","000","00","120","0024","0142","436","165","271","1","437","1141","0","38.30","14.46"
"66","000","00","120","0025","0000","598","263","335","6","604","1765","0","34.22","14.90"
"66","000","00","120","0025","0143","314","154","160","3","317","835","0","37.96","18.44"
"66","000","00","120","0025","0144","284","109","175","3","287","930","0","30.86","11.72"
"66","000","00","120","0026","0000","799","284","515","19","818","2488","0","32.88","11.41"
"66","000","00","120","0026","0145","449","170","279","12","461","1394","0","33.07","12.20"
"66","000","00","120","0026","0146","350","114","236","7","357","1094","0","32.63","10.42"
"66","000","00","120","0027","0000","2948","1201","1747","27","2975","7404","0","40.18","16.22"
"66","000","00","120","0027","0147","496","200","296","5","501","1346","0","37.22","14.86"
"66","000","00","120","0027","0148","594","232","362","4","598","1446","0","41.36","16.04"
"66","000","00","120","0027","0149","564","212","352","6","570","1336","0","42.66","15.87"
"66","000","00","120","0027","0150","741","337","404","7","748","1771","0","42.24","19.03"
"66","000","00","120","0027","0151","553","220","333","5","558","1505","0","37.08","14.62"
"66","000","00","120","0028","0000","1067","460","607","10","1077","2764","0","38.97","16.64"
"66","000","00","120","0028","0152","482","220","262","4","486","1340","0","36.27","16.42"
"66","000","00","120","0028","0153","585","240","345","6","591","1424","0","41.50","16.85"
"66","000","00","120","0029","0000","424","202","222","7","431","1197","0","36.01","16.88"
"66","000","00","120","0029","0154","424","202","222","7","431","1197","0","36.01","16.88"
"66","000","00","120","0030","0000","435","171","264","5","440","1156","0","38.06","14.79"
"66","000","00","120","0030","0156","435","171","264","5","440","1156","0","38.06","14.79"
"66","000","00","120","0031","0000","496","239","257","7","503","1390","0","36.19","17.19"
"66","000","00","120","0031","0157","496","239","257","7","503","1390","0","36.19","17.19"
"66","000","00","120","0032","0000","567","244","323","7","574","1465","0","39.18","16.66"
"66","000","00","120","0032","0155","567","244","323","7","574","1465","0","39.18","16.66"
"66","000","00","130","0000","0000","32936","15850","17086","304","33240","76561","95562","43.42","20.70"
"66","000","00","130","0001","0000","609","276","333","2","611","1364","0","44.79","20.23"
"66","000","00","130","0001","0198","376","140","236","2","378","765","0","49.41","18.30"
"66","000","00","130","0001","0199","233","136","97","0","233","599","0","38.90","22.70"
"66","000","00","130","0002","0000","1029","495","534","6","1035","1976","0","52.38","25.05"
"66","000","00","130","0002","0200","401","179","222","2","403","830","0","48.55","21.57"
"66","000","00","130","0002","0201","628","316","312","4","632","1146","0","55.15","27.57"
"66","000","00","130","0003","0000","467","175","292","2","469","893","0","52.52","19.60"
"66","000","00","130","0003","0202","467","175","292","2","469","893","0","52.52","19.60"
"66","000","00","130","0004","0000","234","116","118","4","238","489","0","48.67","23.72"
"66","000","00","130","0004","0203","234","116","118","4","238","489","0","48.67","23.72"
"66","000","00","130","0005","0000","1081","503","578","5","1086","2409","0","45.08","20.88"
"66","000","00","130","0005","0204","341","154","187","1","342","769","0","44.47","20.03"
"66","000","00","130","0005","0205","422","218","204","4","426","932","0","45.71","23.39"
"66","000","00","130","0005","0206","318","131","187","0","318","708","0","44.92","18.50"
"66","000","00","130","0006","0000","1979","918","1061","22","2001","4364","0","45.85","21.04"
"66","000","00","130","0006","0210","495","237","258","1","496","1058","0","46.88","22.40"
"66","000","00","130","0006","0211","471","223","248","3","474","974","0","48.67","22.90"
"66","000","00","130","0006","0212","602","258","344","12","614","1415","0","43.39","18.23"
"66","000","00","130","0006","0213","411","200","211","6","417","917","0","45.47","21.81"
"66","000","00","130","0007","0000","2334","1024","1310","21","2355","5345","0","44.06","19.16"
"66","000","00","130","0007","0214","516","231","285","7","523","1202","0","43.51","19.22"
"66","000","00","130","0007","0215","517","240","277","5","522","1205","0","43.32","19.92"
"66","000","00","130","0007","0216","617","237","380","3","620","1392","0","44.54","17.03"
"66","000","00","130","0007","0217","684","316","368","6","690","1546","0","44.63","20.44"
"66","000","00","130","0008","0000","3130","1236","1894","22","3152","6799","0","46.36","18.18"
"66","000","00","130","0008","0218","494","174","320","2","496","1176","0","42.18","14.80"
"66","000","00","130","0008","0219","514","192","322","7","521","1149","0","45.34","16.71"
"66","000","00","130","0008","0220","513","213","300","3","516","1155","0","44.68","18.44"
"66","000","00","130","0008","0221","498","179","319","3","501","1044","0","47.99","17.15"
"66","000","00","130","0008","0222","536","194","342","1","537","1143","0","46.98","16.97"
"66","000","00","130","0008","0223","575","284","291","6","581","1132","0","51.33","25.09"
"66","000","00","130","0009","0000","3079","1531","1548","35","3114","7344","0","42.40","20.85"
"66","000","00","130","0009","0224","391","216","175","3","394","936","0","42.09","23.08"
"66","000","00","130","0009","0225","369","174","195","3","372","879","0","42.32","19.80"
"66","000","00","130","0009","0226","466","259","207","6","472","1074","0","43.95","24.12"
"66","000","00","130","0009","0227","453","212","241","6","459","1103","0","41.61","19.22"
"66","000","00","130","0009","0228","421","182","239","6","427","1133","0","37.69","16.06"
"66","000","00","130","0009","0229","521","268","253","5","526","1137","0","46.26","23.57"
"66","000","00","130","0009","0230","458","220","238","6","464","1082","0","42.88","20.33"
"66","000","00","130","0010","0000","473","205","268","4","477","1089","0","43.80","18.82"
"66","000","00","130","0010","0231","473","205","268","4","477","1089","0","43.80","18.82"
"66","000","00","130","0011","0000","1870","937","933","17","1887","4904","0","38.48","19.11"
"66","000","00","130","0011","0235","376","180","196","6","382","974","0","39.22","18.48"
"66","000","00","130","0011","0236","376","197","179","1","377","919","0","41.02","21.44"
"66","000","00","130","0011","0237","419","198","221","4","423","1054","0","40.13","18.79"
"66","000","00","130","0011","0238","362","188","174","4","366","1025","0","35.71","18.34"
"66","000","00","130","0011","0239","337","174","163","2","339","932","0","36.37","18.67"
"66","000","00","130","0012","0000","1608","798","810","14","1622","3843","0","42.21","20.77"
"66","000","00","130","0012","0232","573","263","310","4","577","1403","0","41.13","18.75"
"66","000","00","130","0012","0233","496","270","226","6","502","1137","0","44.15","23.75"
"66","000","00","130","0012","0234","539","265","274","4","543","1303","0","41.67","20.34"
"66","000","00","130","0013","0000","772","367","405","11","783","1748","0","44.79","21.00"
"66","000","00","130","0013","0240","288","113","175","4","292","698","0","41.83","16.19"
"66","000","00","130","0013","0241","484","254","230","7","491","1050","0","46.76","24.19"
"66","000","00","130","0014","0000","2214","1019","1195","14","2228","5388","0","41.35","18.91"
"66","000","00","130","0014","0242","595","269","326","1","596","1434","0","41.56","18.76"
"66","000","00","130","0014","0243","474","209","265","6","480","1186","0","40.47","17.62"
"66","000","00","130","0014","0244","513","218","295","0","513","1272","0","40.33","17.14"
"66","000","00","130","0014","0245","632","323","309","7","639","1496","0","42.71","21.59"
"66","000","00","130","0015","0000","1407","715","692","12","1419","3381","0","41.97","21.15"
"66","000","00","130","0015","0246","298","152","146","4","302","729","0","41.43","20.85"
"66","000","00","130","0015","0247","369","176","193","1","370","853","0","43.38","20.63"
"66","000","00","130","0015","0248","427","215","212","4","431","1041","0","41.40","20.65"
"66","000","00","130","0015","0249","313","172","141","3","316","758","0","41.69","22.69"
"66","000","00","130","0016","0000","2515","1330","1185","18","2533","5682","0","44.58","23.41"
"66","000","00","130","0016","0250","541","249","292","3","544","1276","0","42.63","19.51"
"66","000","00","130","0016","0251","430","242","188","4","434","995","0","43.62","24.32"
"66","000","00","130","0016","0252","397","227","170","2","399","1026","0","38.89","22.12"
"66","000","00","130","0016","0253","541","254","287","4","545","1113","0","48.97","22.82"
"66","000","00","130","0016","0254","606","358","248","5","611","1272","0","48.03","28.14"
"66","000","00","130","0017","0000","1788","1028","760","35","1823","4396","0","41.47","23.38"
"66","000","00","130","0017","0261","526","266","260","11","537","1404","0","38.25","18.95"
"66","000","00","130","0017","0262","364","266","98","9","373","890","0","41.91","29.89"
"66","000","00","130","0017","0263","386","214","172","6","392","945","0","41.48","22.65"
"66","000","00","130","0017","0264","512","282","230","9","521","1157","0","45.03","24.37"
"66","000","00","130","0018","0000","1018","550","468","12","1030","2331","0","44.19","23.60"
"66","000","00","130","0018","0265","560","263","297","7","567","1296","0","43.75","20.29"
"66","000","00","130","0018","0266","458","287","171","5","463","1035","0","44.73","27.73"
"66","000","00","130","0019","0000","852","456","396","12","864","2130","0","40.56","21.41"
"66","000","00","130","0019","0267","457","228","229","7","464","1128","0","41.13","20.21"
"66","000","00","130","0019","0268","395","228","167","5","400","1002","0","39.92","22.75"
"66","000","00","130","0020","0000","1448","627","821","16","1464","3365","0","43.51","18.63"
"66","000","00","130","0020","0207","526","212","314","7","533","1294","0","41.19","16.38"
"66","000","00","130","0020","0208","501","233","268","4","505","1109","0","45.54","21.01"
"66","000","00","130","0020","0209","421","182","239","5","426","962","0","44.28","18.92"
"66","000","00","130","0021","0000","3029","1544","1485","20","3049","7321","0","41.65","21.09"
"66","000","00","130","0021","0255","610","297","313","6","616","1353","0","45.53","21.95"
"66","000","00","130","0021","0256","530","262","268","4","534","1340","0","39.85","19.55"
"66","000","00","130","0021","0257","502","254","248","4","506","1141","0","44.35","22.26"
"66","000","00","130","0021","0258","399","200","199","4","403","1000","0","40.30","20.00"
"66","000","00","130","0021","0259","318","158","160","1","319","886","0","36.00","17.83"
"66","000","00","130","0021","0260","670","373","297","1","671","1601","0","41.91","23.30"
"66","000","00","140","0000","0000","18611","8546","10065","202","18813","48591","59487","38.72","17.59"
"66","000","00","140","0001","0000","1426","668","758","14","1440","3632","0","39.65","18.39"
"66","000","00","140","0001","0158","437","168","269","5","442","1103","0","40.07","15.23"
"66","000","00","140","0001","0159","456","225","231","4","460","1200","0","38.33","18.75"
"66","000","00","140","0001","0160","533","275","258","5","538","1329","0","40.48","20.69"
"66","000","00","140","0002","0000","838","376","462","5","843","1967","0","42.86","19.12"
"66","000","00","140","0002","0161","484","208","276","2","486","1109","0","43.82","18.76"
"66","000","00","140","0002","0162","354","168","186","3","357","858","0","41.61","19.58"
"66","000","00","140","0003","0000","1492","740","752","15","1507","3879","0","38.85","19.08"
"66","000","00","140","0003","0163","403","186","217","3","406","1016","0","39.96","18.31"
"66","000","00","140","0003","0164","572","289","283","10","582","1440","0","40.42","20.07"
"66","000","00","140","0003","0165","517","265","252","2","519","1423","0","36.47","18.62"
"66","000","00","140","0004","0000","224","97","127","2","226","484","0","46.69","20.04"
"66","000","00","140","0004","0166","224","97","127","2","226","484","0","46.69","20.04"
"66","000","00","140","0005","0000","487","234","253","7","494","1161","0","42.55","20.16"
"66","000","00","140","0005","0167","487","234","253","7","494","1161","0","42.55","20.16"
"66","000","00","140","0006","0000","330","158","172","2","332","780","0","42.56","20.26"
"66","000","00","140","0006","0168","330","158","172","2","332","780","0","42.56","20.26"
"66","000","00","140","0007","0000","2410","1129","1281","25","2435","6132","0","39.71","18.41"
"66","000","00","140","0007","0169","374","194","180","5","379","993","0","38.17","19.54"
"66","000","00","140","0007","0170","563","266","297","6","569","1334","0","42.65","19.94"
"66","000","00","140","0007","0171","375","133","242","5","380","1020","0","37.25","13.04"
"66","000","00","140","0007","0172","551","279","272","6","557","1389","0","40.10","20.09"
"66","000","00","140","0007","0173","547","257","290","3","550","1396","0","39.40","18.41"
"66","000","00","140","0008","0000","1975","840","1135","20","1995","5294","0","37.68","15.87"
"66","000","00","140","0008","0174","470","177","293","9","479","1282","0","37.36","13.81"
"66","000","00","140","0008","0175","479","195","284","3","482","1292","0","37.31","15.09"
"66","000","00","140","0008","0176","503","204","299","4","507","1267","0","40.02","16.10"
"66","000","00","140","0008","0177","523","264","259","4","527","1453","0","36.27","18.17"
"66","000","00","140","0009","0000","1749","748","1001","20","1769","4953","0","35.72","15.10"
"66","000","00","140","0009","0178","461","184","277","7","468","1231","0","38.02","14.95"
"66","000","00","140","0009","0179","412","182","230","3","415","1235","0","33.60","14.74"
"66","000","00","140","0009","0180","454","202","252","5","459","1237","0","37.11","16.33"
"66","000","00","140","0009","0181","422","180","242","5","427","1250","0","34.16","14.40"
"66","000","00","140","0010","0000","2881","1383","1498","33","2914","7509","0","38.81","18.42"
"66","000","00","140","0010","0182","407","186","221","9","416","962","0","43.24","19.33"
"66","000","00","140","0010","0183","478","210","268","4","482","1238","0","38.93","16.96"
"66","000","00","140","0010","0184","532","252","280","4","536","1409","0","38.04","17.89"
"66","000","00","140","0010","0185","424","206","218","4","428","1181","0","36.24","17.44"
"66","000","00","140","0010","0186","462","237","225","6","468","1254","0","37.32","18.90"
"66","000","00","140","0010","0187","578","292","286","6","584","1465","0","39.86","19.93"
"66","000","00","140","0011","0000","2190","989","1201","24","2214","5687","0","38.93","17.39"
"66","000","00","140","0011","0188","550","252","298","3","553","1466","0","37.72","17.19"
"66","000","00","140","0011","0189","517","263","254","8","525","1348","0","38.95","19.51"
"66","000","00","140","0011","0190","472","188","284","10","482","1289","0","37.39","14.58"
"66","000","00","140","0011","0191","651","286","365","3","654","1584","0","41.29","18.06"
"66","000","00","140","0012","0000","828","359","469","9","837","2322","0","36.05","15.46"
"66","000","00","140","0012","0192","359","174","185","4","363","1034","0","35.11","16.83"
"66","000","00","140","0012","0193","469","185","284","5","474","1288","0","36.80","14.36"
"66","000","00","140","0013","0000","857","353","504","14","871","2298","0","37.90","15.36"
"66","000","00","140","0013","0194","401","155","246","2","403","1077","0","37.42","14.39"
"66","000","00","140","0013","0195","456","198","258","12","468","1221","0","38.33","16.22"
"66","000","00","140","0014","0000","924","472","452","12","936","2493","0","37.55","18.93"
"66","000","00","140","0014","0196","505","236","269","8","513","1394","0","36.80","16.93"
"66","000","00","140","0014","0197","419","236","183","4","423","1099","0","38.49","21.47"
"66","000","00","150","0000","0000","17397","8430","8967","212","17609","45052","54126","39.09","18.71"
"66","000","00","150","0001","0000","776","496","280","19","795","2076","0","38.29","23.89"
"66","000","00","150","0001","0456","328","200","128","7","335","882","0","37.98","22.68"
"66","000","00","150","0001","0457","448","296","152","12","460","1194","0","38.53","24.79"
"66","000","00","150","0002","0000","385","191","194","8","393","1031","0","38.12","18.53"
"66","000","00","150","0002","0458","385","191","194","8","393","1031","0","38.12","18.53"
"66","000","00","150","0003","0000","1191","695","496","13","1204","3086","0","39.01","22.52"
"66","000","00","150","0003","0459","407","233","174","2","409","1085","0","37.70","21.47"
"66","000","00","150","0003","0460","395","243","152","7","402","1020","0","39.41","23.82"
"66","000","00","150","0003","0461","389","219","170","4","393","981","0","40.06","22.32"
"66","000","00","150","0004","0000","1562","780","782","16","1578","3652","0","43.21","21.36"
"66","000","00","150","0004","0464","497","249","248","5","502","1169","0","42.94","21.30"
"66","000","00","150","0004","0465","510","246","264","6","516","1156","0","44.64","21.28"
"66","000","00","150","0004","0466","555","285","270","5","560","1327","0","42.20","21.48"
"66","000","00","150","0005","0000","827","405","422","12","839","2136","0","39.28","18.96"
"66","000","00","150","0005","0467","391","192","199","3","394","991","0","39.76","19.37"
"66","000","00","150","0005","0468","436","213","223","9","445","1145","0","38.86","18.60"
"66","000","00","150","0006","0000","1914","982","932","24","1938","4739","0","40.89","20.72"
"66","000","00","150","0006","0469","442","243","199","9","451","1171","0","38.51","20.75"
"66","000","00","150","0006","0470","492","257","235","2","494","1133","0","43.60","22.68"
"66","000","00","150","0006","0471","449","218","231","4","453","1252","0","36.18","17.41"
"66","000","00","150","0006","0472","531","264","267","9","540","1183","0","45.65","22.32"
"66","000","00","150","0007","0000","763","323","440","4","767","1917","0","40.01","16.85"
"66","000","00","150","0007","0473","369","167","202","3","372","954","0","38.99","17.51"
"66","000","00","150","0007","0474","394","156","238","1","395","963","0","41.02","16.20"
"66","000","00","150","0008","0000","1329","592","737","13","1342","3347","0","40.10","17.69"
"66","000","00","150","0008","0475","486","221","265","4","490","1173","0","41.77","18.84"
"66","000","00","150","0008","0476","456","198","258","5","461","1136","0","40.58","17.43"
"66","000","00","150","0008","0477","387","173","214","4","391","1038","0","37.67","16.67"
"66","000","00","150","0009","0000","1427","625","802","18","1445","3538","0","40.84","17.67"
"66","000","00","150","0009","0478","568","269","299","12","580","1278","0","45.38","21.05"
"66","000","00","150","0009","0479","408","158","250","3","411","1102","0","37.30","14.34"
"66","000","00","150","0009","0480","451","198","253","3","454","1158","0","39.21","17.10"
"66","000","00","150","0010","0000","943","396","547","8","951","2376","0","40.03","16.67"
"66","000","00","150","0010","0481","472","203","269","5","477","1179","0","40.46","17.22"
"66","000","00","150","0010","0482","471","193","278","3","474","1197","0","39.60","16.12"
"66","000","00","150","0011","0000","815","390","425","15","830","2187","0","37.95","17.83"
"66","000","00","150","0011","0483","451","217","234","8","459","1183","0","38.80","18.34"
"66","000","00","150","0011","0484","364","173","191","7","371","1004","0","36.95","17.23"
"66","000","00","150","0012","0000","616","265","351","6","622","1559","0","39.90","17.00"
"66","000","00","150","0012","0485","274","122","152","4","278","696","0","39.94","17.53"
"66","000","00","150","0012","0486","342","143","199","2","344","863","0","39.86","16.57"
"66","000","00","150","0013","0000","707","337","370","5","712","2131","0","33.41","15.81"
"66","000","00","150","0013","0487","355","183","172","4","359","1051","0","34.16","17.41"
"66","000","00","150","0013","0488","352","154","198","1","353","1080","0","32.69","14.26"
"66","000","00","150","0014","0000","1144","581","563","12","1156","3198","0","36.15","18.17"
"66","000","00","150","0014","0489","385","183","202","5","390","1084","0","35.98","16.88"
"66","000","00","150","0014","0490","424","208","216","5","429","1118","0","38.37","18.60"
"66","000","00","150","0014","0491","335","190","145","2","337","996","0","33.84","19.08"
"66","000","00","150","0015","0000","521","214","307","5","526","1393","0","37.76","15.36"
"66","000","00","150","0015","0496","521","214","307","5","526","1393","0","37.76","15.36"
"66","000","00","150","0016","0000","734","323","411","16","750","2139","0","35.06","15.10"
"66","000","00","150","0016","0494","379","148","231","8","387","1032","0","37.50","14.34"
"66","000","00","150","0016","0495","355","175","180","8","363","1107","0","32.79","15.81"
"66","000","00","150","0017","0000","775","304","471","6","781","1956","0","39.93","15.54"
"66","000","00","150","0017","0492","400","169","231","3","403","986","0","40.87","17.14"
"66","000","00","150","0017","0493","375","135","240","3","378","970","0","38.97","13.92"
"66","000","00","150","0018","0000","968","531","437","12","980","2591","0","37.82","20.49"
"66","000","00","150","0018","0462","481","264","217","8","489","1380","0","35.43","19.13"
"66","000","00","150","0018","0463","487","267","220","4","491","1211","0","40.55","22.05"
"66","000","00","160","0000","0000","21574","8840","12734","236","21810","54903","65143","39.72","16.10"
"66","000","00","160","0001","0000","1236","597","639","12","1248","3173","0","39.33","18.82"
"66","000","00","160","0001","0497","409","195","214","4","413","1055","0","39.15","18.48"
"66","000","00","160","0001","0498","396","192","204","4","400","978","0","40.90","19.63"
"66","000","00","160","0001","0499","431","210","221","4","435","1140","0","38.16","18.42"
"66","000","00","160","0002","0000","955","432","523","10","965","2296","0","42.03","18.82"
"66","000","00","160","0002","0500","498","218","280","6","504","1240","0","40.65","17.58"
"66","000","00","160","0002","0501","457","214","243","4","461","1056","0","43.66","20.27"
"66","000","00","160","0003","0000","1055","445","610","9","1064","2611","0","40.75","17.04"
"66","000","00","160","0003","0502","519","215","304","2","521","1298","0","40.14","16.56"
"66","000","00","160","0003","0503","536","230","306","7","543","1313","0","41.36","17.52"
"66","000","00","160","0004","0000","938","337","601","7","945","2220","0","42.57","15.18"
"66","000","00","160","0004","0504","474","148","326","6","480","1138","0","42.18","13.01"
"66","000","00","160","0004","0505","464","189","275","1","465","1082","0","42.98","17.47"
"66","000","00","160","0005","0000","2833","1186","1647","25","2858","7481","0","38.20","15.85"
"66","000","00","160","0005","0514","456","201","255","6","462","1258","0","36.72","15.98"
"66","000","00","160","0005","0515","462","203","259","2","464","1250","0","37.12","16.24"
"66","000","00","160","0005","0516","491","203","288","5","496","1377","0","36.02","14.74"
"66","000","00","160","0005","0517","445","196","249","2","447","1131","0","39.52","17.33"
"66","000","00","160","0005","0518","477","172","305","2","479","1232","0","38.88","13.96"
"66","000","00","160","0005","0519","502","211","291","8","510","1233","0","41.36","17.11"
"66","000","00","160","0006","0000","2092","785","1307","20","2112","5257","0","40.18","14.93"
"66","000","00","160","0006","0520","470","177","293","8","478","1379","0","34.66","12.84"
"66","000","00","160","0006","0521","529","190","339","3","532","1150","0","46.26","16.52"
"66","000","00","160","0006","0522","578","227","351","6","584","1442","0","40.50","15.74"
"66","000","00","160","0006","0523","515","191","324","3","518","1286","0","40.28","14.85"
"66","000","00","160","0007","0000","1079","401","678","9","1088","2555","0","42.58","15.69"
"66","000","00","160","0007","0524","530","191","339","3","533","1170","0","45.56","16.32"
"66","000","00","160","0007","0525","549","210","339","6","555","1385","0","40.07","15.16"
"66","000","00","160","0008","0000","1181","422","759","15","1196","2845","0","42.04","14.83"
"66","000","00","160","0008","0530","639","233","406","8","647","1444","0","44.81","16.14"
"66","000","00","160","0008","0531","542","189","353","7","549","1401","0","39.19","13.49"
"66","000","00","160","0009","0000","1686","757","929","12","1698","4465","0","38.03","16.95"
"66","000","00","160","0009","0526","478","192","286","5","483","1118","0","43.20","17.17"
"66","000","00","160","0009","0527","448","185","263","2","450","1124","0","40.04","16.46"
"66","000","00","160","0009","0528","342","179","163","3","345","1005","0","34.33","17.81"
"66","000","00","160","0009","0529","418","201","217","2","420","1218","0","34.48","16.50"
"66","000","00","160","0010","0000","2781","1155","1626","34","2815","7152","0","39.36","16.15"
"66","000","00","160","0010","0532","424","184","240","2","426","1229","0","34.66","14.97"
"66","000","00","160","0010","0533","475","192","283","6","481","1303","0","36.91","14.74"
"66","000","00","160","0010","0534","427","160","267","6","433","1075","0","40.28","14.88"
"66","000","00","160","0010","0535","546","226","320","6","552","1311","0","42.11","17.24"
"66","000","00","160","0010","0536","405","162","243","6","411","1024","0","40.14","15.82"
"66","000","00","160","0010","0537","504","231","273","8","512","1210","0","42.31","19.09"
"66","000","00","160","0011","0000","1075","400","675","19","1094","2539","0","43.09","15.75"
"66","000","00","160","0011","0538","538","195","343","7","545","1215","0","44.86","16.05"
"66","000","00","160","0011","0539","537","205","332","12","549","1324","0","41.47","15.48"
"66","000","00","160","0012","0000","1111","439","672","16","1127","2800","0","40.25","15.68"
"66","000","00","160","0012","0540","550","241","309","5","555","1464","0","37.91","16.46"
"66","000","00","160","0012","0541","561","198","363","11","572","1336","0","42.81","14.82"
"66","000","00","160","0013","0000","886","418","468","19","905","2268","0","39.90","18.43"
"66","000","00","160","0013","0506","508","204","304","9","517","1199","0","43.12","17.01"
"66","000","00","160","0013","0507","378","214","164","10","388","1069","0","36.30","20.02"
"66","000","00","160","0014","0000","1456","560","896","15","1471","4135","0","35.57","13.54"
"66","000","00","160","0014","0510","478","176","302","1","479","1301","0","36.82","13.53"
"66","000","00","160","0014","0511","528","197","331","10","538","1396","0","38.54","14.11"
"66","000","00","160","0014","0512","450","187","263","4","454","1438","0","31.57","13.00"
"66","000","00","160","0015","0000","797","362","435","11","808","2090","0","38.66","17.32"
"66","000","00","160","0015","0508","393","161","232","5","398","887","0","44.87","18.15"
"66","000","00","160","0015","0509","404","201","203","6","410","1203","0","34.08","16.71"
"66","000","00","160","0016","0000","413","144","269","3","416","1016","0","40.94","14.17"
"66","000","00","160","0016","0513","413","144","269","3","416","1016","0","40.94","14.17"
"66","000","00","170","0000","0000","37644","17813","19831","331","37975","91035","109158","41.71","19.57"
"66","000","00","170","0001","0000","4316","1993","2323","36","4352","10990","0","39.60","18.13"
"66","000","00","170","0001","0600","460","192","268","4","464","1184","0","39.19","16.22"
"66","000","00","170","0001","0601","468","216","252","2","470","1267","0","37.10","17.05"
"66","000","00","170","0001","0602","493","195","298","5","498","1322","0","37.67","14.75"
"66","000","00","170","0001","0603","386","183","203","5","391","987","0","39.61","18.54"
"66","000","00","170","0001","0604","565","248","317","4","569","1376","0","41.35","18.02"
"66","000","00","170","0001","0605","591","312","279","8","599","1485","0","40.34","21.01"
"66","000","00","170","0001","0606","471","234","237","3","474","1199","0","39.53","19.52"
"66","000","00","170","0001","0607","461","222","239","1","462","1120","0","41.25","19.82"
"66","000","00","170","0001","0608","421","191","230","4","425","1050","0","40.48","18.19"
"66","000","00","170","0002","0000","596","221","375","6","602","1262","0","47.70","17.51"
"66","000","00","170","0002","0597","596","221","375","6","602","1262","0","47.70","17.51"
"66","000","00","170","0003","0000","1017","531","486","8","1025","2378","0","43.10","22.33"
"66","000","00","170","0003","0598","486","276","210","3","489","1119","0","43.70","24.66"
"66","000","00","170","0003","0599","531","255","276","5","536","1259","0","42.57","20.25"
"66","000","00","170","0004","0000","4198","2170","2028","24","4222","10488","0","40.26","20.69"
"66","000","00","170","0004","0609","567","272","295","3","570","1308","0","43.58","20.80"
"66","000","00","170","0004","0610","522","271","251","3","525","1379","0","38.07","19.65"
"66","000","00","170","0004","0611","467","233","234","0","467","1426","0","32.75","16.34"
"66","000","00","170","0004","0612","462","249","213","5","467","1145","0","40.79","21.75"
"66","000","00","170","0004","0613","611","330","281","4","615","1425","0","43.16","23.16"
"66","000","00","170","0004","0614","634","335","299","4","638","1463","0","43.61","22.90"
"66","000","00","170","0004","0615","559","314","245","3","562","1339","0","41.97","23.45"
"66","000","00","170","0004","0616","376","166","210","2","378","1003","0","37.69","16.55"
"66","000","00","170","0005","0000","2275","1151","1124","21","2296","5345","0","42.96","21.53"
"66","000","00","170","0005","0617","654","320","334","6","660","1422","0","46.41","22.50"
"66","000","00","170","0005","0618","523","263","260","3","526","1365","0","38.53","19.27"
"66","000","00","170","0005","0619","567","297","270","4","571","1269","0","45.00","23.40"
"66","000","00","170","0005","0620","531","271","260","8","539","1289","0","41.82","21.02"
"66","000","00","170","0006","0000","3864","1931","1933","30","3894","9332","0","41.73","20.69"
"66","000","00","170","0006","0635","603","330","273","3","606","1324","0","45.77","24.92"
"66","000","00","170","0006","0636","611","302","309","6","617","1311","0","47.06","23.04"
"66","000","00","170","0006","0637","548","270","278","4","552","1372","0","40.23","19.68"
"66","000","00","170","0006","0638","604","261","343","1","605","1407","0","43.00","18.55"
"66","000","00","170","0006","0639","531","279","252","7","538","1325","0","40.60","21.06"
"66","000","00","170","0006","0640","459","225","234","3","462","1298","0","35.59","17.33"
"66","000","00","170","0006","0641","508","264","244","6","514","1295","0","39.69","20.39"
"66","000","00","170","0007","0000","5003","2260","2743","53","5056","12018","0","42.07","18.81"
"66","000","00","170","0007","0642","553","261","292","9","562","1369","0","41.05","19.07"
"66","000","00","170","0007","0643","591","269","322","4","595","1354","0","43.94","19.87"
"66","000","00","170","0007","0644","545","207","338","9","554","1268","0","43.69","16.32"
"66","000","00","170","0007","0645","605","277","328","6","611","1458","0","41.91","19.00"
"66","000","00","170","0007","0646","575","276","299","11","586","1250","0","46.88","22.08"
"66","000","00","170","0007","0647","515","274","241","6","521","1219","0","42.74","22.48"
"66","000","00","170","0007","0648","540","246","294","2","542","1470","0","36.87","16.73"
"66","000","00","170","0007","0649","596","237","359","4","600","1314","0","45.66","18.04"
"66","000","00","170","0007","0650","483","213","270","2","485","1316","0","36.85","16.19"
"66","000","00","170","0008","0000","1214","523","691","13","1227","2801","0","43.81","18.67"
"66","000","00","170","0008","0651","622","253","369","7","629","1453","0","43.29","17.41"
"66","000","00","170","0008","0652","592","270","322","6","598","1348","0","44.36","20.03"
"66","000","00","170","0009","0000","2556","1124","1432","20","2576","6066","0","42.47","18.53"
"66","000","00","170","0009","0653","625","303","322","4","629","1464","0","42.96","20.70"
"66","000","00","170","0009","0654","604","268","336","4","608","1529","0","39.76","17.53"
"66","000","00","170","0009","0655","655","280","375","3","658","1544","0","42.62","18.13"
"66","000","00","170","0009","0656","672","273","399","9","681","1529","0","44.54","17.85"
"66","000","00","170","0010","0000","2118","884","1234","18","2136","4733","0","45.13","18.68"
"66","000","00","170","0010","0657","557","255","302","3","560","1303","0","42.98","19.57"
"66","000","00","170","0010","0658","480","197","283","5","485","1066","0","45.50","18.48"
"66","000","00","170","0010","0659","537","236","301","7","544","1234","0","44.08","19.12"
"66","000","00","170","0010","0660","544","196","348","3","547","1130","0","48.41","17.35"
"66","000","00","170","0011","0000","1607","642","965","21","1628","3997","0","40.73","16.06"
"66","000","00","170","0011","0661","570","196","374","7","577","1442","0","40.01","13.59"
"66","000","00","170","0011","0662","593","269","324","7","600","1447","0","41.47","18.59"
"66","000","00","170","0011","0663","444","177","267","7","451","1108","0","40.70","15.97"
"66","000","00","170","0012","0000","661","260","401","5","666","1536","0","43.36","16.93"
"66","000","00","170","0012","0664","661","260","401","5","666","1536","0","43.36","16.93"
"66","000","00","170","0013","0000","1569","726","843","27","1596","4262","0","37.45","17.03"
"66","000","00","170","0013","0665","553","227","326","14","567","1374","0","41.27","16.52"
"66","000","00","170","0013","0666","558","277","281","7","565","1421","0","39.76","19.49"
"66","000","00","170","0013","0667","458","222","236","6","464","1467","0","31.63","15.13"
"66","000","00","170","0014","0000","1764","876","888","10","1774","4319","0","41.07","20.28"
"66","000","00","170","0014","0621","490","249","241","4","494","1307","0","37.80","19.05"
"66","000","00","170","0014","0622","551","301","250","4","555","1219","0","45.53","24.69"
"66","000","00","170","0014","0623","306","117","189","0","306","711","0","43.04","16.46"
"66","000","00","170","0014","0624","417","209","208","2","419","1082","0","38.72","19.32"
"66","000","00","170","0015","0000","2897","1518","1379","18","2915","6933","0","42.05","21.90"
"66","000","00","170","0015","0625","503","257","246","5","508","1302","0","39.02","19.74"
"66","000","00","170","0015","0626","463","246","217","2","465","1045","0","44.50","23.54"
"66","000","00","170","0015","0627","494","272","222","2","496","1155","0","42.94","23.55"
"66","000","00","170","0015","0628","511","299","212","3","514","1231","0","41.75","24.29"
"66","000","00","170","0015","0629","447","198","249","3","450","998","0","45.09","19.84"
"66","000","00","170","0015","0630","479","246","233","3","482","1202","0","40.10","20.47"
"66","000","00","170","0016","0000","1989","1003","986","21","2010","4575","0","43.93","21.92"
"66","000","00","170","0016","0631","636","310","326","3","639","1360","0","46.99","22.79"
"66","000","00","170","0016","0632","529","284","245","8","537","1215","0","44.20","23.37"
"66","000","00","170","0016","0633","395","203","192","5","400","901","0","44.40","22.53"
"66","000","00","170","0016","0634","429","206","223","5","434","1099","0","39.49","18.74"
"66","000","00","180","0000","0000","30338","14963","15375","296","30634","78438","95800","39.06","19.08"
"66","000","00","180","0001","0000","1784","875","909","19","1803","4325","0","41.69","20.23"
"66","000","00","180","0001","0546","591","312","279","7","598","1407","0","42.50","22.17"
"66","000","00","180","0001","0547","602","299","303","7","609","1456","0","41.83","20.54"
"66","000","00","180","0001","0548","591","264","327","5","596","1462","0","40.77","18.06"
"66","000","00","180","0002","0000","3615","1648","1967","37","3652","9201","0","39.69","17.91"
"66","000","00","180","0002","0578","588","278","310","4","592","1527","0","38.77","18.21"
"66","000","00","180","0002","0579","617","297","320","5","622","1547","0","40.21","19.20"
"66","000","00","180","0002","0580","592","286","306","5","597","1502","0","39.75","19.04"
"66","000","00","180","0002","0581","611","271","340","5","616","1502","0","41.01","18.04"
"66","000","00","180","0002","0582","558","242","316","8","566","1577","0","35.89","15.35"
"66","000","00","180","0002","0583","649","274","375","10","659","1546","0","42.63","17.72"
"66","000","00","180","0003","0000","2395","1279","1116","29","2424","6208","0","39.05","20.60"
"66","000","00","180","0003","0584","543","377","166","6","549","1489","0","36.87","25.32"
"66","000","00","180","0003","0585","696","312","384","9","705","1673","0","42.14","18.65"
"66","000","00","180","0003","0586","525","295","230","7","532","1495","0","35.59","19.73"
"66","000","00","180","0003","0587","631","295","336","7","638","1551","0","41.13","19.02"
"66","000","00","180","0004","0000","1345","615","730","11","1356","3353","0","40.44","18.34"
"66","000","00","180","0004","0588","409","187","222","6","415","1002","0","41.42","18.66"
"66","000","00","180","0004","0589","482","211","271","1","483","1182","0","40.86","17.85"
"66","000","00","180","0004","0590","454","217","237","4","458","1169","0","39.18","18.56"
"66","000","00","180","0005","0000","1293","959","334","19","1312","3594","0","36.51","26.68"
"66","000","00","180","0005","0594","361","294","67","8","369","1107","0","33.33","26.56"
"66","000","00","180","0005","0595","422","296","126","8","430","1175","0","36.60","25.19"
"66","000","00","180","0005","0596","510","369","141","3","513","1312","0","39.10","28.13"
"66","000","00","180","0006","0000","1704","816","888","14","1718","4313","0","39.83","18.92"
"66","000","00","180","0006","0591","563","251","312","5","568","1434","0","39.61","17.50"
"66","000","00","180","0006","0592","636","301","335","6","642","1557","0","41.23","19.33"
"66","000","00","180","0006","0593","505","264","241","3","508","1322","0","38.43","19.97"
"66","000","00","180","0007","0000","2040","981","1059","24","2064","5252","0","39.30","18.68"
"66","000","00","180","0007","0553","521","250","271","9","530","1293","0","40.99","19.33"
"66","000","00","180","0007","0554","602","255","347","7","609","1464","0","41.60","17.42"
"66","000","00","180","0007","0555","431","210","221","4","435","1194","0","36.43","17.59"
"66","000","00","180","0007","0556","486","266","220","4","490","1301","0","37.66","20.45"
"66","000","00","180","0008","0000","1748","785","963","21","1769","4779","0","37.02","16.43"
"66","000","00","180","0008","0564","553","267","286","6","559","1664","0","33.59","16.05"
"66","000","00","180","0008","0565","606","261","345","2","608","1558","0","39.02","16.75"
"66","000","00","180","0008","0566","589","257","332","13","602","1557","0","38.66","16.51"
"66","000","00","180","0009","0000","2292","1037","1255","24","2316","6244","0","37.09","16.61"
"66","000","00","180","0009","0567","588","272","316","2","590","1557","0","37.89","17.47"
"66","000","00","180","0009","0568","565","268","297","3","568","1511","0","37.59","17.74"
"66","000","00","180","0009","0569","528","211","317","10","538","1529","0","35.19","13.80"
"66","000","00","180","0009","0570","611","286","325","9","620","1647","0","37.64","17.36"
"66","000","00","180","0010","0000","2316","1134","1182","14","2330","5915","0","39.39","19.17"
"66","000","00","180","0010","0557","600","288","312","3","603","1450","0","41.59","19.86"
"66","000","00","180","0010","0558","564","258","306","6","570","1525","0","37.38","16.92"
"66","000","00","180","0010","0559","613","307","306","5","618","1467","0","42.13","20.93"
"66","000","00","180","0010","0560","539","281","258","0","539","1473","0","36.59","19.08"
"66","000","00","180","0011","0000","1903","979","924","16","1919","4622","0","41.52","21.18"
"66","000","00","180","0011","0561","645","339","306","4","649","1599","0","40.59","21.20"
"66","000","00","180","0011","0562","615","321","294","4","619","1526","0","40.56","21.04"
"66","000","00","180","0011","0563","643","319","324","8","651","1497","0","43.49","21.31"
"66","000","00","180","0012","0000","2275","1047","1228","19","2294","6037","0","38.00","17.34"
"66","000","00","180","0012","0542","580","311","269","3","583","1504","0","38.76","20.68"
"66","000","00","180","0012","0543","568","232","336","1","569","1478","0","38.50","15.70"
"66","000","00","180","0012","0544","500","198","302","9","509","1538","0","33.09","12.87"
"66","000","00","180","0012","0545","627","306","321","6","633","1517","0","41.73","20.17"
"66","000","00","180","0013","0000","2346","1217","1129","20","2366","6021","0","39.30","20.21"
"66","000","00","180","0013","0549","579","331","248","6","585","1530","0","38.24","21.63"
"66","000","00","180","0013","0550","606","331","275","6","612","1547","0","39.56","21.40"
"66","000","00","180","0013","0551","626","301","325","4","630","1499","0","42.03","20.08"
"66","000","00","180","0013","0552","535","254","281","4","539","1445","0","37.30","17.58"
"66","000","00","180","0014","0000","1954","928","1026","18","1972","5029","0","39.21","18.45"
"66","000","00","180","0014","0571","476","242","234","4","480","1310","0","36.64","18.47"
"66","000","00","180","0014","0572","522","251","271","6","528","1313","0","40.21","19.12"
"66","000","00","180","0014","0573","486","229","257","4","490","1210","0","40.50","18.93"
"66","000","00","180","0014","0574","470","206","264","4","474","1196","0","39.63","17.22"
"66","000","00","180","0015","0000","1328","663","665","11","1339","3545","0","37.77","18.70"
"66","000","00","180","0015","0575","391","180","211","4","395","1034","0","38.20","17.41"
"66","000","00","180","0015","0576","480","245","235","3","483","1122","0","43.05","21.84"
"66","000","00","180","0015","0577","457","238","219","4","461","1389","0","33.19","17.13"
"66","000","00","190","0000","0000","8046","3981","4065","132","8178","20710","23859","39.49","19.22"
"66","000","00","190","0001","0000","1369","731","638","18","1387","3261","0","42.53","22.42"
"66","000","00","190","0001","1792","448","224","224","7","455","1005","0","45.27","22.29"
"66","000","00","190","0001","1793","487","255","232","5","492","1181","0","41.66","21.59"
"66","000","00","190","0001","1794","434","252","182","6","440","1075","0","40.93","23.44"
"66","000","00","190","0002","0000","602","330","272","11","613","1835","0","33.41","17.98"
"66","000","00","190","0002","1795","298","161","137","4","302","906","0","33.33","17.77"
"66","000","00","190","0002","1796","304","169","135","7","311","929","0","33.48","18.19"
"66","000","00","190","0003","0000","538","271","267","5","543","1342","0","40.46","20.19"
"66","000","00","190","0003","1797","538","271","267","5","543","1342","0","40.46","20.19"
"66","000","00","190","0004","0000","380","162","218","9","389","986","0","39.45","16.43"
"66","000","00","190","0004","1798","380","162","218","9","389","986","0","39.45","16.43"
"66","000","00","190","0005","0000","468","160","308","4","472","1156","0","40.83","13.84"
"66","000","00","190","0005","1799","468","160","308","4","472","1156","0","40.83","13.84"
"66","000","00","190","0006","0000","725","366","359","12","737","1879","0","39.22","19.48"
"66","000","00","190","0006","1800","393","188","205","7","400","987","0","40.53","19.05"
"66","000","00","190","0006","1801","332","178","154","5","337","892","0","37.78","19.96"
"66","000","00","190","0007","0000","1159","448","711","18","1177","2983","0","39.46","15.02"
"66","000","00","190","0007","1802","380","181","199","5","385","1047","0","36.77","17.29"
"66","000","00","190","0007","1803","399","139","260","9","408","1060","0","38.49","13.11"
"66","000","00","190","0007","1804","380","128","252","4","384","876","0","43.84","14.61"
"66","000","00","190","0008","0000","265","198","67","2","267","582","0","45.88","34.02"
"66","000","00","190","0008","1805","265","198","67","2","267","582","0","45.88","34.02"
"66","000","00","190","0009","0000","1101","506","595","14","1115","2927","0","38.09","17.29"
"66","000","00","190","0009","1806","370","197","173","3","373","1004","0","37.15","19.62"
"66","000","00","190","0009","1807","361","133","228","7","368","909","0","40.48","14.63"
"66","000","00","190","0009","1808","370","176","194","4","374","1014","0","36.88","17.36"
"66","000","00","190","0010","0000","486","288","198","12","498","1187","0","41.95","24.26"
"66","000","00","190","0010","1809","486","288","198","12","498","1187","0","41.95","24.26"
"66","000","00","190","0011","0000","316","123","193","10","326","885","0","36.84","13.90"
"66","000","00","190","0011","1810","110","60","50","2","112","229","0","48.91","26.20"
"66","000","00","190","0011","1811","206","63","143","8","214","656","0","32.62","9.60"
"66","000","00","190","0012","0000","221","169","52","11","232","575","0","40.35","29.39"
"66","000","00","190","0012","1812","221","169","52","11","232","575","0","40.35","29.39"
"66","000","00","190","0013","0000","416","229","187","6","422","1112","0","37.95","20.59"
"66","000","00","190","0013","1813","322","160","162","4","326","897","0","36.34","17.84"
"66","000","00","190","0013","1814","94","69","25","2","96","215","0","44.65","32.09"
"66","000","00","200","0000","0000","5223","2744","2479","65","5288","12679","14532","41.71","21.64"
"66","000","00","200","0001","0000","440","222","218","6","446","1210","0","36.86","18.35"
"66","000","00","200","0001","1781","440","222","218","6","446","1210","0","36.86","18.35"
"66","000","00","200","0002","0000","648","324","324","8","656","1518","0","43.21","21.34"
"66","000","00","200","0002","1782","648","324","324","8","656","1518","0","43.21","21.34"
"66","000","00","200","0003","0000","521","263","258","5","526","1204","0","43.69","21.84"
"66","000","00","200","0003","1783","521","263","258","5","526","1204","0","43.69","21.84"
"66","000","00","200","0004","0000","461","220","241","8","469","1232","0","38.07","17.86"
"66","000","00","200","0004","1784","461","220","241","8","469","1232","0","38.07","17.86"
"66","000","00","200","0005","0000","261","127","134","2","263","638","0","41.22","19.91"
"66","000","00","200","0005","1785","261","127","134","2","263","638","0","41.22","19.91"
"66","000","00","200","0006","0000","621","318","303","9","630","1443","0","43.66","22.04"
"66","000","00","200","0006","1786","621","318","303","9","630","1443","0","43.66","22.04"
"66","000","00","200","0007","0000","754","393","361","10","764","1794","0","42.59","21.91"
"66","000","00","200","0007","1787","285","128","157","4","289","674","0","42.88","18.99"
"66","000","00","200","0007","1788","469","265","204","6","475","1120","0","42.41","23.66"
"66","000","00","200","0008","0000","414","232","182","6","420","1002","0","41.92","23.15"
"66","000","00","200","0008","1789","414","232","182","6","420","1002","0","41.92","23.15"
"66","000","00","200","0009","0000","573","329","244","8","581","1408","0","41.26","23.37"
"66","000","00","200","0009","1790","573","329","244","8","581","1408","0","41.26","23.37"
"66","000","00","200","0010","0000","530","316","214","3","533","1230","0","43.33","25.69"
"66","000","00","200","0010","1791","530","316","214","3","533","1230","0","43.33","25.69"
"66","000","00","210","0000","0000","9771","5051","4720","109","9880","27041","31790","36.54","18.68"
"66","000","00","210","0001","0000","386","204","182","4","390","1099","0","35.49","18.56"
"66","000","00","210","0001","0075","386","204","182","4","390","1099","0","35.49","18.56"
"66","000","00","210","0002","0000","774","417","357","6","780","2193","0","35.57","19.02"
"66","000","00","210","0002","0076","351","193","158","0","351","1038","0","33.82","18.59"
"66","000","00","210","0002","0077","423","224","199","6","429","1155","0","37.14","19.39"
"66","000","00","210","0003","0000","621","314","307","6","627","1887","0","33.23","16.64"
"66","000","00","210","0003","0087","395","198","197","3","398","1070","0","37.20","18.50"
"66","000","00","210","0003","0088","226","116","110","3","229","817","0","28.03","14.20"
"66","000","00","210","0004","0000","1767","967","800","14","1781","4680","0","38.06","20.66"
"66","000","00","210","0004","0078","419","232","187","2","421","1083","0","38.87","21.42"
"66","000","00","210","0004","0079","367","183","184","2","369","849","0","43.46","21.55"
"66","000","00","210","0004","0080","485","272","213","6","491","1305","0","37.62","20.84"
"66","000","00","210","0004","0081","496","280","216","4","500","1443","0","34.65","19.40"
"66","000","00","210","0005","0000","1251","632","619","18","1269","3392","0","37.41","18.63"
"66","000","00","210","0005","0089","399","189","210","6","405","1086","0","37.29","17.40"
"66","000","00","210","0005","0090","387","218","169","5","392","1086","0","36.10","20.07"
"66","000","00","210","0005","0091","465","225","240","7","472","1220","0","38.69","18.44"
"66","000","00","210","0006","0000","2338","1211","1127","24","2362","6342","0","37.24","19.09"
"66","000","00","210","0006","0082","421","219","202","4","425","1064","0","39.94","20.58"
"66","000","00","210","0006","0083","430","224","206","4","434","1212","0","35.81","18.48"
"66","000","00","210","0006","0084","437","224","213","4","441","1357","0","32.50","16.51"
"66","000","00","210","0006","0085","506","272","234","7","513","1367","0","37.53","19.90"
"66","000","00","210","0006","0086","544","272","272","5","549","1342","0","40.91","20.27"
"66","000","00","210","0007","0000","473","227","246","8","481","1384","0","34.75","16.40"
"66","000","00","210","0007","0095","473","227","246","8","481","1384","0","34.75","16.40"
"66","000","00","210","0008","0000","518","279","239","7","525","1210","0","43.39","23.06"
"66","000","00","210","0008","0094","518","279","239","7","525","1210","0","43.39","23.06"
"66","000","00","210","0009","0000","702","382","320","9","711","2115","0","33.62","18.06"
"66","000","00","210","0009","0092","293","161","132","4","297","944","0","31.46","17.06"
"66","000","00","210","0009","0093","409","221","188","5","414","1171","0","35.35","18.87"
"66","000","00","210","0010","0000","594","251","343","5","599","1581","0","37.89","15.88"
"66","000","00","210","0010","0096","295","106","189","3","298","815","0","36.56","13.01"
"66","000","00","210","0010","0097","299","145","154","2","301","766","0","39.30","18.93"
"66","000","00","210","0011","0000","347","167","180","8","355","1158","0","30.66","14.42"
"66","000","00","210","0011","0098","347","167","180","8","355","1158","0","30.66","14.42"
"66","000","00","220","0000","0000","5663","2504","3159","74","5737","16320","18688","35.15","15.34"
"66","000","00","220","0001","0000","355","130","225","7","362","1055","0","34.31","12.32"
"66","000","00","220","0001","0058","355","130","225","7","362","1055","0","34.31","12.32"
"66","000","00","220","0002","0000","355","160","195","2","357","1023","0","34.90","15.64"
"66","000","00","220","0002","0059","355","160","195","2","357","1023","0","34.90","15.64"
"66","000","00","220","0003","0000","860","361","499","8","868","2624","0","33.08","13.76"
"66","000","00","220","0003","0060","427","177","250","2","429","1210","0","35.45","14.63"
"66","000","00","220","0003","0061","433","184","249","6","439","1414","0","31.05","13.01"
"66","000","00","220","0004","0000","522","243","279","6","528","1502","0","35.15","16.18"
"66","000","00","220","0004","0064","357","170","187","4","361","872","0","41.40","19.50"
"66","000","00","220","0004","0065","165","73","92","2","167","630","0","26.51","11.59"
"66","000","00","220","0005","0000","396","171","225","4","400","1149","0","34.81","14.88"
"66","000","00","220","0005","0063","396","171","225","4","400","1149","0","34.81","14.88"
"66","000","00","220","0006","0000","449","183","266","1","450","1199","0","37.53","15.26"
"66","000","00","220","0006","0062","449","183","266","1","450","1199","0","37.53","15.26"
"66","000","00","220","0007","0000","336","163","173","10","346","889","0","38.92","18.34"
"66","000","00","220","0007","0066","336","163","173","10","346","889","0","38.92","18.34"
"66","000","00","220","0008","0000","559","255","304","11","570","1753","0","32.52","14.55"
"66","000","00","220","0008","0067","391","171","220","9","400","1291","0","30.98","13.25"
"66","000","00","220","0008","0068","168","84","84","2","170","462","0","36.80","18.18"
"66","000","00","220","0009","0000","335","147","188","3","338","1037","0","32.59","14.18"
"66","000","00","220","0009","0069","335","147","188","3","338","1037","0","32.59","14.18"
"66","000","00","220","0010","0000","452","225","227","2","454","1385","0","32.78","16.25"
"66","000","00","220","0010","0070","213","110","103","2","215","629","0","34.18","17.49"
"66","000","00","220","0010","0071","239","115","124","0","239","756","0","31.61","15.21"
"66","000","00","220","0011","0000","607","286","321","14","621","1738","0","35.73","16.46"
"66","000","00","220","0011","0072","339","132","207","9","348","938","0","37.10","14.07"
"66","000","00","220","0011","0073","268","154","114","5","273","800","0","34.13","19.25"
"66","000","00","220","0012","0000","437","180","257","6","443","966","0","45.86","18.63"
"66","000","00","220","0012","0074","437","180","257","6","443","966","0","45.86","18.63"
"66","000","00","230","0000","0000","28952","13465","15487","262","29214","63587","76907","45.94","21.18"
"66","000","00","230","0001","0000","4111","1877","2234","48","4159","8638","0","48.15","21.73"
"66","000","00","230","0001","0359","718","315","403","8","726","1437","0","50.52","21.92"
"66","000","00","230","0001","0360","613","278","335","9","622","1385","0","44.91","20.07"
"66","000","00","230","0001","0361","592","250","342","7","599","1271","0","47.13","19.67"
"66","000","00","230","0001","0362","696","316","380","4","700","1508","0","46.42","20.95"
"66","000","00","230","0001","0363","683","311","372","10","693","1415","0","48.98","21.98"
"66","000","00","230","0001","0364","809","407","402","10","819","1622","0","50.49","25.09"
"66","000","00","230","0002","0000","1157","504","653","8","1165","2486","0","46.86","20.27"
"66","000","00","230","0002","0365","593","241","352","5","598","1210","0","49.42","19.92"
"66","000","00","230","0002","0366","564","263","301","3","567","1276","0","44.44","20.61"
"66","000","00","230","0003","0000","2497","1228","1269","24","2521","5768","0","43.71","21.29"
"66","000","00","230","0003","0367","870","378","492","12","882","1785","0","49.41","21.18"
"66","000","00","230","0003","0368","692","320","372","3","695","1792","0","38.78","17.86"
"66","000","00","230","0003","0369","398","246","152","6","404","1012","0","39.92","24.31"
"66","000","00","230","0003","0370","537","284","253","3","540","1179","0","45.80","24.09"
"66","000","00","230","0004","0000","2461","1263","1198","16","2477","5795","0","42.74","21.79"
"66","000","00","230","0004","0371","662","351","311","2","664","1636","0","40.59","21.45"
"66","000","00","230","0004","0372","556","294","262","3","559","1379","0","40.54","21.32"
"66","000","00","230","0004","0373","609","308","301","9","618","1348","0","45.85","22.85"
"66","000","00","230","0004","0374","634","310","324","2","636","1432","0","44.41","21.65"
"66","000","00","230","0005","0000","1139","593","546","11","1150","2612","0","44.03","22.70"
"66","000","00","230","0005","0375","606","319","287","6","612","1389","0","44.06","22.97"
"66","000","00","230","0005","0376","533","274","259","5","538","1223","0","43.99","22.40"
"66","000","00","230","0006","0000","5794","2623","3171","38","5832","12829","0","45.46","20.45"
"66","000","00","230","0006","0377","748","334","414","4","752","1541","0","48.80","21.67"
"66","000","00","230","0006","0378","562","257","305","2","564","1305","0","43.22","19.69"
"66","000","00","230","0006","0379","606","252","354","5","611","1229","0","49.72","20.50"
"66","000","00","230","0006","0380","680","354","326","5","685","1492","0","45.91","23.73"
"66","000","00","230","0006","0381","491","164","327","7","498","1075","0","46.33","15.26"
"66","000","00","230","0006","0382","378","179","199","4","382","790","0","48.35","22.66"
"66","000","00","230","0006","0383","544","251","293","3","547","1426","0","38.36","17.60"
"66","000","00","230","0006","0384","577","238","339","3","580","1323","0","43.84","17.99"
"66","000","00","230","0006","0385","709","355","354","1","710","1419","0","50.04","25.02"
"66","000","00","230","0006","0386","499","239","260","4","503","1229","0","40.93","19.45"
"66","000","00","230","0007","0000","3568","1698","1870","26","3594","7556","0","47.56","22.47"
"66","000","00","230","0007","0387","653","263","390","6","659","1376","0","47.89","19.11"
"66","000","00","230","0007","0388","542","271","271","4","546","1280","0","42.66","21.17"
"66","000","00","230","0007","0389","688","358","330","2","690","1388","0","49.71","25.79"
"66","000","00","230","0007","0390","502","232","270","3","505","1069","0","47.24","21.70"
"66","000","00","230","0007","0391","600","302","298","3","603","1171","0","51.49","25.79"
"66","000","00","230","0007","0392","583","272","311","8","591","1272","0","46.46","21.38"
"66","000","00","230","0008","0000","798","312","486","9","807","1621","0","49.78","19.25"
"66","000","00","230","0008","0393","317","129","188","3","320","655","0","48.85","19.69"
"66","000","00","230","0008","0394","481","183","298","6","487","966","0","50.41","18.94"
"66","000","00","230","0009","0000","746","329","417","14","760","1676","0","45.35","19.63"
"66","000","00","230","0009","0395","746","329","417","14","760","1676","0","45.35","19.63"
"66","000","00","230","0010","0000","941","403","538","8","949","2095","0","45.30","19.24"
"66","000","00","230","0010","0396","396","153","243","2","398","884","0","45.02","17.31"
"66","000","00","230","0010","0397","545","250","295","6","551","1211","0","45.50","20.64"
"66","000","00","230","0011","0000","971","424","547","11","982","2196","0","44.72","19.31"
"66","000","00","230","0011","0398","545","259","286","5","550","1222","0","45.01","21.19"
"66","000","00","230","0011","0399","426","165","261","6","432","974","0","44.35","16.94"
"66","000","00","230","0012","0000","1924","852","1072","20","1944","4327","0","44.93","19.69"
"66","000","00","230","0012","0400","633","302","331","6","639","1383","0","46.20","21.84"
"66","000","00","230","0012","0401","739","334","405","7","746","1642","0","45.43","20.34"
"66","000","00","230","0012","0402","552","216","336","7","559","1302","0","42.93","16.59"
"66","000","00","230","0013","0000","1075","484","591","8","1083","2158","0","50.19","22.43"
"66","000","00","230","0013","0403","522","225","297","4","526","1037","0","50.72","21.70"
"66","000","00","230","0013","0404","553","259","294","4","557","1121","0","49.69","23.10"
"66","000","00","230","0014","0000","752","309","443","9","761","1651","0","46.09","18.72"
"66","000","00","230","0014","0405","752","309","443","9","761","1651","0","46.09","18.72"
"66","000","00","230","0015","0000","652","348","304","7","659","1350","0","48.81","25.78"
"66","000","00","230","0015","0406","652","348","304","7","659","1350","0","48.81","25.78"
"66","000","00","230","0016","0000","366","218","148","5","371","829","0","44.75","26.30"
"66","000","00","230","0016","0407","366","218","148","5","371","829","0","44.75","26.30"
"66","000","00","240","0000","0000","20495","9826","10669","193","20688","47755","56669","43.32","20.58"
"66","000","00","240","0001","0000","1739","762","977","18","1757","4325","0","40.62","17.62"
"66","000","00","240","0001","0320","631","263","368","6","637","1459","0","43.66","18.03"
"66","000","00","240","0001","0321","487","214","273","7","494","1373","0","35.98","15.59"
"66","000","00","240","0001","0322","621","285","336","5","626","1493","0","41.93","19.09"
"66","000","00","240","0002","0000","410","179","231","5","415","865","0","47.98","20.69"
"66","000","00","240","0002","0323","410","179","231","5","415","865","0","47.98","20.69"
"66","000","00","240","0003","0000","1490","687","803","12","1502","3486","0","43.09","19.71"
"66","000","00","240","0003","0324","568","289","279","6","574","1242","0","46.22","23.27"
"66","000","00","240","0003","0325","474","203","271","3","477","1254","0","38.04","16.19"
"66","000","00","240","0003","0326","448","195","253","3","451","990","0","45.56","19.70"
"66","000","00","240","0004","0000","642","316","326","6","648","1505","0","43.06","21.00"
"66","000","00","240","0004","0327","642","316","326","6","648","1505","0","43.06","21.00"
"66","000","00","240","0005","0000","1094","568","526","12","1106","2438","0","45.37","23.30"
"66","000","00","240","0005","0328","555","297","258","5","560","1188","0","47.14","25.00"
"66","000","00","240","0005","0329","539","271","268","7","546","1250","0","43.68","21.68"
"66","000","00","240","0006","0000","1126","542","584","8","1134","2601","0","43.60","20.84"
"66","000","00","240","0006","0330","581","275","306","5","586","1333","0","43.96","20.63"
"66","000","00","240","0006","0331","545","267","278","3","548","1268","0","43.22","21.06"
"66","000","00","240","0007","0000","1368","715","653","12","1380","3003","0","45.95","23.81"
"66","000","00","240","0007","0332","384","205","179","3","387","899","0","43.05","22.80"
"66","000","00","240","0007","0333","425","235","190","3","428","888","0","48.20","26.46"
"66","000","00","240","0007","0334","559","275","284","6","565","1216","0","46.46","22.62"
"66","000","00","240","0008","0000","1095","562","533","9","1104","2165","0","50.99","25.96"
"66","000","00","240","0008","0335","413","214","199","6","419","850","0","49.29","25.18"
"66","000","00","240","0008","0336","682","348","334","3","685","1315","0","52.09","26.46"
"66","000","00","240","0009","0000","397","208","189","6","403","819","0","49.21","25.40"
"66","000","00","240","0009","0337","397","208","189","6","403","819","0","49.21","25.40"
"66","000","00","240","0010","0000","726","338","388","8","734","1699","0","43.20","19.89"
"66","000","00","240","0010","0338","726","338","388","8","734","1699","0","43.20","19.89"
"66","000","00","240","0011","0000","767","334","433","9","776","1688","0","45.97","19.79"
"66","000","00","240","0011","0339","767","334","433","9","776","1688","0","45.97","19.79"
"66","000","00","240","0012","0000","369","195","174","5","374","943","0","39.66","20.68"
"66","000","00","240","0012","0340","369","195","174","5","374","943","0","39.66","20.68"
"66","000","00","240","0013","0000","578","279","299","6","584","1310","0","44.58","21.30"
"66","000","00","240","0013","0341","578","279","299","6","584","1310","0","44.58","21.30"
"66","000","00","240","0014","0000","3201","1627","1574","28","3229","7418","0","43.53","21.93"
"66","000","00","240","0014","0342","553","269","284","5","558","1316","0","42.40","20.44"
"66","000","00","240","0014","0343","521","232","289","5","526","1249","0","42.11","18.57"
"66","000","00","240","0014","0344","574","302","272","3","577","1369","0","42.15","22.06"
"66","000","00","240","0014","0345","533","276","257","6","539","1111","0","48.51","24.84"
"66","000","00","240","0014","0346","506","288","218","6","512","1213","0","42.21","23.74"
"66","000","00","240","0014","0347","514","260","254","3","517","1160","0","44.57","22.41"
"66","000","00","240","0015","0000","2052","926","1126","21","2073","5061","0","40.96","18.30"
"66","000","00","240","0015","0348","510","202","308","6","516","1197","0","43.11","16.88"
"66","000","00","240","0015","0349","566","244","322","8","574","1352","0","42.46","18.05"
"66","000","00","240","0015","0350","501","243","258","3","504","1212","0","41.58","20.05"
"66","000","00","240","0015","0351","475","237","238","4","479","1300","0","36.85","18.23"
"66","000","00","240","0016","0000","1940","788","1152","13","1953","4958","0","39.39","15.89"
"66","000","00","240","0016","0352","517","199","318","2","519","1302","0","39.86","15.28"
"66","000","00","240","0016","0353","479","188","291","2","481","1189","0","40.45","15.81"
"66","000","00","240","0016","0354","456","190","266","5","461","1192","0","38.67","15.94"
"66","000","00","240","0016","0355","488","211","277","4","492","1275","0","38.59","16.55"
"66","000","00","240","0017","0000","1501","800","701","15","1516","3471","0","43.68","23.05"
"66","000","00","240","0017","0356","466","195","271","9","475","1191","0","39.88","16.37"
"66","000","00","240","0017","0357","560","328","232","4","564","1187","0","47.51","27.63"
"66","000","00","240","0017","0358","475","277","198","2","477","1093","0","43.64","25.34"
"66","000","00","250","0000","0000","26540","12761","13779","241","26781","64759","78039","41.35","19.71"
"66","000","00","250","0001","0000","1237","624","613","7","1244","3019","0","41.21","20.67"
"66","000","00","250","0001","0269","380","169","211","2","382","932","0","40.99","18.13"
"66","000","00","250","0001","0270","324","165","159","1","325","852","0","38.15","19.37"
"66","000","00","250","0001","0271","533","290","243","4","537","1235","0","43.48","23.48"
"66","000","00","250","0002","0000","1161","562","599","4","1165","2849","0","40.89","19.73"
"66","000","00","250","0002","0272","582","266","316","4","586","1412","0","41.50","18.84"
"66","000","00","250","0002","0273","579","296","283","0","579","1437","0","40.29","20.60"
"66","000","00","250","0003","0000","772","416","356","12","784","1822","0","43.03","22.83"
"66","000","00","250","0003","0274","368","176","192","4","372","941","0","39.53","18.70"
"66","000","00","250","0003","0275","404","240","164","8","412","881","0","46.77","27.24"
"66","000","00","250","0004","0000","1578","732","846","16","1594","3624","0","43.98","20.20"
"66","000","00","250","0004","0276","562","256","306","7","569","1302","0","43.70","19.66"
"66","000","00","250","0004","0277","580","263","317","6","586","1264","0","46.36","20.81"
"66","000","00","250","0004","0278","436","213","223","3","439","1058","0","41.49","20.13"
"66","000","00","250","0005","0000","377","195","182","6","383","1043","0","36.72","18.70"
"66","000","00","250","0005","0279","377","195","182","6","383","1043","0","36.72","18.70"
"66","000","00","250","0006","0000","926","509","417","8","934","2271","0","41.13","22.41"
"66","000","00","250","0006","0280","553","324","229","4","557","1397","0","39.87","23.19"
"66","000","00","250","0006","0281","373","185","188","4","377","874","0","43.14","21.17"
"66","000","00","250","0007","0000","1980","825","1155","28","2008","5015","0","40.04","16.45"
"66","000","00","250","0007","0282","572","248","324","4","576","1465","0","39.32","16.93"
"66","000","00","250","0007","0283","576","282","294","12","588","1375","0","42.76","20.51"
"66","000","00","250","0007","0284","475","208","267","9","484","1318","0","36.72","15.78"
"66","000","00","250","0007","0285","357","87","270","3","360","857","0","42.01","10.15"
"66","000","00","250","0008","0000","1041","415","626","7","1048","2952","0","35.50","14.06"
"66","000","00","250","0008","0286","524","210","314","4","528","1533","0","34.44","13.70"
"66","000","00","250","0008","0287","517","205","312","3","520","1419","0","36.65","14.45"
"66","000","00","250","0009","0000","1971","812","1159","16","1987","4892","0","40.62","16.60"
"66","000","00","250","0009","0288","537","227","310","6","543","1172","0","46.33","19.37"
"66","000","00","250","0009","0289","475","177","298","2","477","1293","0","36.89","13.69"
"66","000","00","250","0009","0290","507","255","252","4","511","1256","0","40.68","20.30"
"66","000","00","250","0009","0291","452","153","299","4","456","1171","0","38.94","13.07"
"66","000","00","250","0010","0000","2186","970","1216","26","2212","5745","0","38.50","16.88"
"66","000","00","250","0010","0292","568","246","322","8","576","1510","0","38.15","16.29"
"66","000","00","250","0010","0293","521","219","302","6","527","1421","0","37.09","15.41"
"66","000","00","250","0010","0294","528","266","262","6","534","1470","0","36.33","18.10"
"66","000","00","250","0010","0295","569","239","330","6","575","1344","0","42.78","17.78"
"66","000","00","250","0011","0000","3086","1527","1559","35","3121","7612","0","41.00","20.06"
"66","000","00","250","0011","0296","567","307","260","8","575","1456","0","39.49","21.09"
"66","000","00","250","0011","0297","564","233","331","7","571","1565","0","36.49","14.89"
"66","000","00","250","0011","0298","626","317","309","7","633","1434","0","44.14","22.11"
"66","000","00","250","0011","0299","398","188","210","2","400","941","0","42.51","19.98"
"66","000","00","250","0011","0300","372","199","173","5","377","918","0","41.07","21.68"
"66","000","00","250","0011","0301","559","283","276","6","565","1298","0","43.53","21.80"
"66","000","00","250","0012","0000","1080","506","574","6","1086","2640","0","41.14","19.17"
"66","000","00","250","0012","0302","558","273","285","3","561","1489","0","37.68","18.33"
"66","000","00","250","0012","0303","522","233","289","3","525","1151","0","45.61","20.24"
"66","000","00","250","0013","0000","2528","1207","1321","22","2550","6354","0","40.13","19.00"
"66","000","00","250","0013","0304","552","272","280","4","556","1492","0","37.27","18.23"
"66","000","00","250","0013","0305","447","211","236","3","450","1197","0","37.59","17.63"
"66","000","00","250","0013","0306","443","241","202","6","449","1116","0","40.23","21.59"
"66","000","00","250","0013","0307","482","202","280","5","487","1155","0","42.16","17.49"
"66","000","00","250","0013","0308","604","281","323","4","608","1394","0","43.62","20.16"
"66","000","00","250","0014","0000","704","294","410","7","711","1558","0","45.64","18.87"
"66","000","00","250","0014","0309","704","294","410","7","711","1558","0","45.64","18.87"
"66","000","00","250","0015","0000","2079","1069","1010","17","2096","4747","0","44.15","22.52"
"66","000","00","250","0015","0310","484","220","264","7","491","1087","0","45.17","20.24"
"66","000","00","250","0015","0311","446","210","236","3","449","996","0","45.08","21.08"
"66","000","00","250","0015","0312","587","337","250","4","591","1404","0","42.09","24.00"
"66","000","00","250","0015","0313","562","302","260","3","565","1260","0","44.84","23.97"
"66","000","00","250","0016","0000","3834","2098","1736","24","3858","8616","0","44.78","24.35"
"66","000","00","250","0016","0314","586","306","280","2","588","1380","0","42.61","22.17"
"66","000","00","250","0016","0315","665","388","277","2","667","1523","0","43.80","25.48"
"66","000","00","250","0016","0316","680","314","366","5","685","1546","0","44.31","20.31"
"66","000","00","250","0016","0317","634","351","283","7","641","1423","0","45.05","24.67"
"66","000","00","250","0016","0318","643","355","288","5","648","1348","0","48.07","26.34"
"66","000","00","250","0016","0319","626","384","242","3","629","1396","0","45.06","27.51"
"66","000","00","260","0000","0000","24655","11686","12969","197","24852","55248","64801","44.98","21.15"
"66","000","00","260","0001","0000","540","225","315","6","546","1194","0","45.73","18.84"
"66","000","00","260","0001","0408","540","225","315","6","546","1194","0","45.73","18.84"
"66","000","00","260","0002","0000","4000","1959","2041","24","4024","9381","0","42.90","20.88"
"66","000","00","260","0002","0409","481","232","249","1","482","1155","0","41.73","20.09"
"66","000","00","260","0002","0410","524","243","281","1","525","1129","0","46.50","21.52"
"66","000","00","260","0002","0411","505","257","248","3","508","1253","0","40.54","20.51"
"66","000","00","260","0002","0412","460","220","240","1","461","1116","0","41.31","19.71"
"66","000","00","260","0002","0413","417","178","239","3","420","1037","0","40.50","17.16"
"66","000","00","260","0002","0414","484","263","221","9","493","1161","0","42.46","22.65"
"66","000","00","260","0002","0415","542","229","313","5","547","1248","0","43.83","18.35"
"66","000","00","260","0002","0416","587","337","250","1","588","1282","0","45.87","26.29"
"66","000","00","260","0003","0000","1965","996","969","21","1986","4671","0","42.52","21.32"
"66","000","00","260","0003","0417","476","237","239","4","480","1103","0","43.52","21.49"
"66","000","00","260","0003","0418","503","266","237","7","510","1253","0","40.70","21.23"
"66","000","00","260","0003","0419","504","273","231","3","507","1196","0","42.39","22.83"
"66","000","00","260","0003","0420","482","220","262","7","489","1119","0","43.70","19.66"
"66","000","00","260","0004","0000","1093","528","565","6","1099","2320","0","47.37","22.76"
"66","000","00","260","0004","0421","537","248","289","2","539","1066","0","50.56","23.26"
"66","000","00","260","0004","0422","556","280","276","4","560","1254","0","44.66","22.33"
"66","000","00","260","0005","0000","1002","495","507","1","1003","2025","0","49.53","24.44"
"66","000","00","260","0005","0423","592","324","268","1","593","1153","0","51.43","28.10"
"66","000","00","260","0005","0424","410","171","239","0","410","872","0","47.02","19.61"
"66","000","00","260","0006","0000","563","283","280","5","568","1224","0","46.41","23.12"
"66","000","00","260","0006","0425","563","283","280","5","568","1224","0","46.41","23.12"
"66","000","00","260","0007","0000","486","215","271","10","496","1045","0","47.46","20.57"
"66","000","00","260","0007","0426","486","215","271","10","496","1045","0","47.46","20.57"
"66","000","00","260","0008","0000","2663","1409","1254","15","2678","5783","0","46.31","24.36"
"66","000","00","260","0008","0427","523","264","259","3","526","1031","0","51.02","25.61"
"66","000","00","260","0008","0428","603","326","277","4","607","1250","0","48.56","26.08"
"66","000","00","260","0008","0429","546","309","237","4","550","1180","0","46.61","26.19"
"66","000","00","260","0008","0430","537","277","260","3","540","1268","0","42.59","21.85"
"66","000","00","260","0008","0431","454","233","221","1","455","1054","0","43.17","22.11"
"66","000","00","260","0009","0000","1331","701","630","14","1345","2918","0","46.09","24.02"
"66","000","00","260","0009","0450","485","282","203","5","490","1071","0","45.75","26.33"
"66","000","00","260","0009","0451","421","186","235","4","425","995","0","42.71","18.69"
"66","000","00","260","0009","0452","425","233","192","5","430","852","0","50.47","27.35"
"66","000","00","260","0010","0000","1760","769","991","9","1769","3965","0","44.62","19.39"
"66","000","00","260","0010","0432","550","279","271","3","553","1280","0","43.20","21.80"
"66","000","00","260","0010","0433","565","227","338","3","568","1289","0","44.07","17.61"
"66","000","00","260","0010","0434","645","263","382","3","648","1396","0","46.42","18.84"
"66","000","00","260","0011","0000","912","419","493","10","922","1860","0","49.57","22.53"
"66","000","00","260","0011","0435","501","236","265","4","505","995","0","50.75","23.72"
"66","000","00","260","0011","0436","411","183","228","6","417","865","0","48.21","21.16"
"66","000","00","260","0012","0000","1030","463","567","6","1036","2470","0","41.94","18.74"
"66","000","00","260","0012","0437","562","267","295","3","565","1360","0","41.54","19.63"
"66","000","00","260","0012","0438","468","196","272","3","471","1110","0","42.43","17.66"
"66","000","00","260","0013","0000","1197","547","650","16","1213","2651","0","45.76","20.63"
"66","000","00","260","0013","0439","630","299","331","9","639","1346","0","47.47","22.21"
"66","000","00","260","0013","0440","567","248","319","7","574","1305","0","43.98","19.00"
"66","000","00","260","0014","0000","1103","460","643","9","1112","2577","0","43.15","17.85"
"66","000","00","260","0014","0446","542","199","343","5","547","1294","0","42.27","15.38"
"66","000","00","260","0014","0447","561","261","300","4","565","1283","0","44.04","20.34"
"66","000","00","260","0015","0000","883","406","477","7","890","2046","0","43.50","19.84"
"66","000","00","260","0015","0448","412","171","241","5","417","973","0","42.86","17.57"
"66","000","00","260","0015","0449","471","235","236","2","473","1073","0","44.08","21.90"
"66","000","00","260","0016","0000","430","165","265","6","436","1104","0","39.49","14.95"
"66","000","00","260","0016","0453","430","165","265","6","436","1104","0","39.49","14.95"
"66","000","00","260","0017","0000","1115","441","674","12","1127","2352","0","47.92","18.75"
"66","000","00","260","0017","0454","545","190","355","5","550","1151","0","47.78","16.51"
"66","000","00","260","0017","0455","570","251","319","7","577","1201","0","48.04","20.90"
"66","000","00","260","0018","0000","1074","406","668","14","1088","2284","0","47.64","17.78"
"66","000","00","260","0018","0441","564","247","317","6","570","1132","0","50.35","21.82"
"66","000","00","260","0018","0442","510","159","351","8","518","1152","0","44.97","13.80"
"66","000","00","260","0019","0000","952","534","418","2","954","2071","0","46.06","25.78"
"66","000","00","260","0019","0443","458","259","199","2","460","1018","0","45.19","25.44"
"66","000","00","260","0019","0444","494","275","219","0","494","1053","0","46.91","26.12"
"66","000","00","260","0020","0000","556","265","291","4","560","1307","0","42.85","20.28"
"66","000","00","260","0020","0445","556","265","291","4","560","1307","0","42.85","20.28"
"66","000","00","270","0000","0000","62553","30155","32398","661","63214","162482","195494","38.91","18.56"
"66","000","00","270","0001","0000","2170","937","1233","31","2201","5378","0","40.93","17.42"
"66","000","00","270","0001","1435","548","246","302","8","556","1314","0","42.31","18.72"
"66","000","00","270","0001","1436","567","246","321","9","576","1428","0","40.34","17.23"
"66","000","00","270","0001","1437","521","213","308","7","528","1350","0","39.11","15.78"
"66","000","00","270","0001","1438","534","232","302","7","541","1286","0","42.07","18.04"
"66","000","00","270","0002","0000","2404","1174","1230","31","2435","6193","0","39.32","18.96"
"66","000","00","270","0002","1439","677","297","380","8","685","1545","0","44.34","19.22"
"66","000","00","270","0002","1440","519","246","273","13","532","1378","0","38.61","17.85"
"66","000","00","270","0002","1441","539","286","253","3","542","1555","0","34.86","18.39"
"66","000","00","270","0002","1442","669","345","324","7","676","1715","0","39.42","20.12"
"66","000","00","270","0003","0000","1592","714","878","10","1602","4030","0","39.75","17.72"
"66","000","00","270","0003","1448","578","261","317","6","584","1468","0","39.78","17.78"
"66","000","00","270","0003","1449","517","234","283","0","517","1277","0","40.49","18.32"
"66","000","00","270","0003","1450","497","219","278","4","501","1285","0","38.99","17.04"
"66","000","00","270","0004","0000","1325","560","765","17","1342","3192","0","42.04","17.54"
"66","000","00","270","0004","1456","439","201","238","4","443","993","0","44.61","20.24"
"66","000","00","270","0004","1457","437","185","252","5","442","1124","0","39.32","16.46"
"66","000","00","270","0004","1458","449","174","275","8","457","1075","0","42.51","16.19"
"66","000","00","270","0005","0000","1123","533","590","15","1138","2873","0","39.61","18.55"
"66","000","00","270","0005","1470","480","242","238","9","489","1357","0","36.04","17.83"
"66","000","00","270","0005","1471","643","291","352","6","649","1516","0","42.81","19.20"
"66","000","00","270","0006","0000","1532","684","848","15","1547","4108","0","37.66","16.65"
"66","000","00","270","0006","1462","495","212","283","3","498","1474","0","33.79","14.38"
"66","000","00","270","0006","1463","517","213","304","5","522","1376","0","37.94","15.48"
"66","000","00","270","0006","1464","520","259","261","7","527","1258","0","41.89","20.59"
"66","000","00","270","0007","0000","2311","1035","1276","26","2337","6203","0","37.68","16.69"
"66","000","00","270","0007","1493","668","318","350","5","673","1721","0","39.11","18.48"
"66","000","00","270","0007","1494","556","242","314","7","563","1539","0","36.58","15.72"
"66","000","00","270","0007","1495","565","243","322","10","575","1468","0","39.17","16.55"
"66","000","00","270","0007","1496","522","232","290","4","526","1475","0","35.66","15.73"
"66","000","00","270","0008","0000","1271","715","556","12","1283","3727","0","34.42","19.18"
"66","000","00","270","0008","1488","674","419","255","7","681","1674","0","40.68","25.03"
"66","000","00","270","0008","1489","597","296","301","5","602","2053","0","29.32","14.42"
"66","000","00","270","0009","0000","1440","815","625","19","1459","3294","0","44.29","24.74"
"66","000","00","270","0009","1474","492","271","221","10","502","1128","0","44.50","24.02"
"66","000","00","270","0009","1475","474","259","215","5","479","1071","0","44.72","24.18"
"66","000","00","270","0009","1476","474","285","189","4","478","1095","0","43.65","26.03"
"66","000","00","270","0010","0000","2079","1135","944","24","2103","5188","0","40.54","21.88"
"66","000","00","270","0010","1481","592","308","284","10","602","1345","0","44.76","22.90"
"66","000","00","270","0010","1482","635","387","248","6","641","1550","0","41.35","24.97"
"66","000","00","270","0010","1483","437","195","242","3","440","1139","0","38.63","17.12"
"66","000","00","270","0010","1484","415","245","170","5","420","1154","0","36.40","21.23"
"66","000","00","270","0011","0000","2768","1457","1311","22","2790","7707","0","36.20","18.90"
"66","000","00","270","0011","1504","525","294","231","5","530","1491","0","35.55","19.72"
"66","000","00","270","0011","1505","619","330","289","5","624","1566","0","39.85","21.07"
"66","000","00","270","0011","1506","501","256","245","3","504","1590","0","31.70","16.10"
"66","000","00","270","0011","1507","611","305","306","6","617","1579","0","39.08","19.32"
"66","000","00","270","0011","1508","512","272","240","3","515","1481","0","34.77","18.37"
"66","000","00","270","0012","0000","3081","1470","1611","33","3114","7600","0","40.97","19.34"
"66","000","00","270","0012","1517","560","222","338","2","562","1373","0","40.93","16.17"
"66","000","00","270","0012","1518","603","277","326","7","610","1482","0","41.16","18.69"
"66","000","00","270","0012","1519","603","307","296","6","609","1445","0","42.15","21.25"
"66","000","00","270","0012","1520","663","350","313","8","671","1643","0","40.84","21.30"
"66","000","00","270","0012","1521","652","314","338","10","662","1657","0","39.95","18.95"
"66","000","00","270","0013","0000","2734","1364","1370","26","2760","6669","0","41.39","20.45"
"66","000","00","270","0013","1531","651","344","307","7","658","1433","0","45.92","24.01"
"66","000","00","270","0013","1532","462","193","269","3","465","1223","0","38.02","15.78"
"66","000","00","270","0013","1533","498","258","240","5","503","1184","0","42.48","21.79"
"66","000","00","270","0013","1534","500","269","231","5","505","1376","0","36.70","19.55"
"66","000","00","270","0013","1535","623","300","323","6","629","1453","0","43.29","20.65"
"66","000","00","270","0014","0000","657","318","339","8","665","1767","0","37.63","18.00"
"66","000","00","270","0014","1536","341","169","172","5","346","870","0","39.77","19.43"
"66","000","00","270","0014","1537","316","149","167","3","319","897","0","35.56","16.61"
"66","000","00","270","0015","0000","401","166","235","6","407","1199","0","33.94","13.84"
"66","000","00","270","0015","1539","401","166","235","6","407","1199","0","33.94","13.84"
"66","000","00","270","0016","0000","1183","586","597","13","1196","3227","0","37.06","18.16"
"66","000","00","270","0016","1540","572","310","262","3","575","1651","0","34.83","18.78"
"66","000","00","270","0016","1541","611","276","335","10","621","1576","0","39.40","17.51"
"66","000","00","270","0017","0000","1185","424","761","10","1195","3052","0","39.15","13.89"
"66","000","00","270","0017","1546","592","203","389","3","595","1486","0","40.04","13.66"
"66","000","00","270","0017","1547","593","221","372","7","600","1566","0","38.31","14.11"
"66","000","00","270","0018","0000","1774","751","1023","18","1792","4742","0","37.79","15.84"
"66","000","00","270","0018","1550","447","188","259","6","453","1123","0","40.34","16.74"
"66","000","00","270","0018","1551","426","171","255","3","429","1258","0","34.10","13.59"
"66","000","00","270","0018","1552","474","210","264","4","478","1052","0","45.44","19.96"
"66","000","00","270","0018","1553","427","182","245","5","432","1309","0","33.00","13.90"
"66","000","00","270","0019","0000","248","102","146","5","253","649","0","38.98","15.72"
"66","000","00","270","0019","1545","248","102","146","5","253","649","0","38.98","15.72"
"66","000","00","270","0020","0000","2528","1156","1372","26","2554","6807","0","37.52","16.98"
"66","000","00","270","0020","1443","521","240","281","6","527","1351","0","39.01","17.76"
"66","000","00","270","0020","1444","440","203","237","2","442","1323","0","33.41","15.34"
"66","000","00","270","0020","1445","526","243","283","6","532","1397","0","38.08","17.39"
"66","000","00","270","0020","1446","547","250","297","6","553","1369","0","40.39","18.26"
"66","000","00","270","0020","1447","494","220","274","6","500","1367","0","36.58","16.09"
"66","000","00","270","0021","0000","1534","682","852","9","1543","4018","0","38.40","16.97"
"66","000","00","270","0021","1459","510","241","269","4","514","1387","0","37.06","17.38"
"66","000","00","270","0021","1460","515","209","306","4","519","1279","0","40.58","16.34"
"66","000","00","270","0021","1461","509","232","277","1","510","1352","0","37.72","17.16"
"66","000","00","270","0022","0000","1453","590","863","14","1467","3985","0","36.81","14.81"
"66","000","00","270","0022","1465","454","172","282","5","459","1207","0","38.03","14.25"
"66","000","00","270","0022","1466","505","203","302","3","508","1430","0","35.52","14.20"
"66","000","00","270","0022","1467","494","215","279","6","500","1348","0","37.09","15.95"
"66","000","00","270","0023","0000","1021","475","546","11","1032","2818","0","36.62","16.86"
"66","000","00","270","0023","1468","511","248","263","4","515","1415","0","36.40","17.53"
"66","000","00","270","0023","1469","510","227","283","7","517","1403","0","36.85","16.18"
"66","000","00","270","0024","0000","1389","606","783","15","1404","3701","0","37.94","16.37"
"66","000","00","270","0024","1451","449","195","254","5","454","1168","0","38.87","16.70"
"66","000","00","270","0024","1452","452","189","263","6","458","1191","0","38.46","15.87"
"66","000","00","270","0024","1453","488","222","266","4","492","1342","0","36.66","16.54"
"66","000","00","270","0025","0000","868","367","501","12","880","2204","0","39.93","16.65"
"66","000","00","270","0025","1454","445","179","266","6","451","1190","0","37.90","15.04"
"66","000","00","270","0025","1455","423","188","235","6","429","1014","0","42.31","18.54"
"66","000","00","270","0026","0000","1002","465","537","8","1010","2894","0","34.90","16.07"
"66","000","00","270","0026","1472","520","228","292","5","525","1465","0","35.84","15.56"
"66","000","00","270","0026","1473","482","237","245","3","485","1429","0","33.94","16.59"
"66","000","00","270","0027","0000","2250","1078","1172","15","2265","5508","0","41.12","19.57"
"66","000","00","270","0027","1522","515","232","283","3","518","1237","0","41.88","18.76"
"66","000","00","270","0027","1523","584","296","288","4","588","1351","0","43.52","21.91"
"66","000","00","270","0027","1524","587","282","305","3","590","1470","0","40.14","19.18"
"66","000","00","270","0027","1525","564","268","296","5","569","1450","0","39.24","18.48"
"66","000","00","270","0028","0000","3239","1642","1597","26","3265","8031","0","40.65","20.45"
"66","000","00","270","0028","1526","578","283","295","4","582","1458","0","39.92","19.41"
"66","000","00","270","0028","1527","655","355","300","8","663","1546","0","42.88","22.96"
"66","000","00","270","0028","1528","569","271","298","6","575","1545","0","37.22","17.54"
"66","000","00","270","0028","1529","537","283","254","3","540","1438","0","37.55","19.68"
"66","000","00","270","0028","1530","900","450","450","5","905","2044","0","44.28","22.02"
"66","000","00","270","0029","0000","2203","1154","1049","17","2220","5692","0","39.00","20.27"
"66","000","00","270","0029","1509","596","283","313","2","598","1449","0","41.27","19.53"
"66","000","00","270","0029","1510","482","265","217","3","485","1346","0","36.03","19.69"
"66","000","00","270","0029","1511","476","243","233","4","480","1255","0","38.25","19.36"
"66","000","00","270","0029","1512","649","363","286","8","657","1642","0","40.01","22.11"
"66","000","00","270","0030","0000","1936","1008","928","27","1963","5664","0","34.66","17.80"
"66","000","00","270","0030","1513","475","241","234","9","484","1312","0","36.89","18.37"
"66","000","00","270","0030","1514","512","277","235","5","517","1527","0","33.86","18.14"
"66","000","00","270","0030","1515","416","210","206","6","422","1321","0","31.95","15.90"
"66","000","00","270","0030","1516","533","280","253","7","540","1504","0","35.90","18.62"
"66","000","00","270","0031","0000","2301","1177","1124","23","2324","6055","0","38.38","19.44"
"66","000","00","270","0031","1497","569","311","258","5","574","1587","0","36.17","19.60"
"66","000","00","270","0031","1498","681","354","327","8","689","1573","0","43.80","22.50"
"66","000","00","270","0031","1499","530","253","277","1","531","1417","0","37.47","17.85"
"66","000","00","270","0031","1500","521","259","262","9","530","1478","0","35.86","17.52"
"66","000","00","270","0032","0000","1394","616","778","20","1414","3821","0","37.01","16.12"
"66","000","00","270","0032","1501","623","252","371","14","637","1479","0","43.07","17.04"
"66","000","00","270","0032","1502","408","183","225","3","411","1212","0","33.91","15.10"
"66","000","00","270","0032","1503","363","181","182","3","366","1130","0","32.39","16.02"
"66","000","00","270","0033","0000","1496","862","634","18","1514","3832","0","39.51","22.49"
"66","000","00","270","0033","1485","498","279","219","7","505","1256","0","40.21","22.21"
"66","000","00","270","0033","1486","448","237","211","3","451","1175","0","38.38","20.17"
"66","000","00","270","0033","1487","550","346","204","8","558","1401","0","39.83","24.70"
"66","000","00","270","0034","0000","1905","1025","880","20","1925","4323","0","44.53","23.71"
"66","000","00","270","0034","1490","702","398","304","5","707","1549","0","45.64","25.69"
"66","000","00","270","0034","1491","591","292","299","7","598","1426","0","41.94","20.48"
"66","000","00","270","0034","1492","612","335","277","8","620","1348","0","45.99","24.85"
"66","000","00","270","0035","0000","930","451","479","9","939","2539","0","36.98","17.76"
"66","000","00","270","0035","1477","575","288","287","6","581","1495","0","38.86","19.26"
"66","000","00","270","0035","1478","355","163","192","3","358","1044","0","34.29","15.61"
"66","000","00","270","0036","0000","897","531","366","13","910","2139","0","42.54","24.82"
"66","000","00","270","0036","1479","485","284","201","8","493","1081","0","45.61","26.27"
"66","000","00","270","0036","1480","412","247","165","5","417","1058","0","39.41","23.35"
"66","000","00","270","0037","0000","584","261","323","10","594","1536","0","38.67","16.99"
"66","000","00","270","0037","1538","584","261","323","10","594","1536","0","38.67","16.99"
"66","000","00","270","0038","0000","1451","672","779","14","1465","3631","0","40.35","18.51"
"66","000","00","270","0038","1542","494","213","281","5","499","1249","0","39.95","17.05"
"66","000","00","270","0038","1543","621","302","319","5","626","1501","0","41.71","20.12"
"66","000","00","270","0038","1544","336","157","179","4","340","881","0","38.59","17.82"
"66","000","00","270","0039","0000","894","397","497","13","907","2486","0","36.48","15.97"
"66","000","00","270","0039","1548","421","172","249","5","426","1191","0","35.77","14.44"
"66","000","00","270","0039","1549","473","225","248","8","481","1295","0","37.14","17.37"
"66","000","00","280","0000","0000","70894","32764","38130","656","71550","174651","212710","40.97","18.76"
"66","000","00","280","0001","0000","1533","697","836","20","1553","3731","0","41.62","18.68"
"66","000","00","280","0001","1563","568","250","318","9","577","1381","0","41.78","18.10"
"66","000","00","280","0001","1564","535","256","279","6","541","1231","0","43.95","20.80"
"66","000","00","280","0001","1565","430","191","239","5","435","1119","0","38.87","17.07"
"66","000","00","280","0002","0000","4235","1971","2264","34","4269","10438","0","40.90","18.88"
"66","000","00","280","0002","1566","686","298","388","4","690","1641","0","42.05","18.16"
"66","000","00","280","0002","1567","904","433","471","7","911","2900","0","31.41","14.93"
"66","000","00","280","0002","1568","664","301","363","6","670","1710","0","39.18","17.60"
"66","000","00","280","0002","1569","589","259","330","7","596","1334","0","44.68","19.42"
"66","000","00","280","0002","1570","576","334","242","3","579","1144","0","50.61","29.20"
"66","000","00","280","0002","1571","816","346","470","7","823","1709","0","48.16","20.25"
"66","000","00","280","0003","0000","1557","599","958","14","1571","3621","0","43.39","16.54"
"66","000","00","280","0003","1576","519","186","333","3","522","1172","0","44.54","15.87"
"66","000","00","280","0003","1577","529","224","305","3","532","1317","0","40.39","17.01"
"66","000","00","280","0003","1578","509","189","320","8","517","1132","0","45.67","16.70"
"66","000","00","280","0004","0000","2906","1320","1586","23","2929","6901","0","42.44","19.13"
"66","000","00","280","0004","1619","590","263","327","4","594","1372","0","43.29","19.17"
"66","000","00","280","0004","1620","513","237","276","9","522","1365","0","38.24","17.36"
"66","000","00","280","0004","1621","617","254","363","6","623","1335","0","46.67","19.03"
"66","000","00","280","0004","1622","575","245","330","3","578","1331","0","43.43","18.41"
"66","000","00","280","0004","1623","611","321","290","1","612","1498","0","40.85","21.43"
"66","000","00","280","0005","0000","3091","1360","1731","30","3121","7279","0","42.88","18.68"
"66","000","00","280","0005","1579","712","312","400","3","715","1624","0","44.03","19.21"
"66","000","00","280","0005","1580","528","218","310","4","532","1251","0","42.53","17.43"
"66","000","00","280","0005","1581","656","299","357","9","665","1614","0","41.20","18.53"
"66","000","00","280","0005","1582","677","318","359","10","687","1666","0","41.24","19.09"
"66","000","00","280","0005","1583","518","213","305","4","522","1124","0","46.44","18.95"
"66","000","00","280","0006","0000","1820","889","931","16","1836","4162","0","44.11","21.36"
"66","000","00","280","0006","1633","572","305","267","5","577","1293","0","44.62","23.59"
"66","000","00","280","0006","1634","570","265","305","3","573","1257","0","45.58","21.08"
"66","000","00","280","0006","1635","678","319","359","8","686","1612","0","42.56","19.79"
"66","000","00","280","0007","0000","2198","1000","1198","26","2224","5520","0","40.29","18.12"
"66","000","00","280","0007","1636","543","235","308","6","549","1415","0","38.80","16.61"
"66","000","00","280","0007","1637","552","227","325","4","556","1363","0","40.79","16.65"
"66","000","00","280","0007","1638","541","262","279","6","547","1413","0","38.71","18.54"
"66","000","00","280","0007","1639","562","276","286","10","572","1329","0","43.04","20.77"
"66","000","00","280","0008","0000","3379","1700","1679","28","3407","8350","0","40.80","20.36"
"66","000","00","280","0008","1584","563","282","281","7","570","1350","0","42.22","20.89"
"66","000","00","280","0008","1585","616","315","301","3","619","1476","0","41.94","21.34"
"66","000","00","280","0008","1586","554","264","290","4","558","1368","0","40.79","19.30"
"66","000","00","280","0008","1587","549","281","268","7","556","1395","0","39.86","20.14"
"66","000","00","280","0008","1588","600","306","294","4","604","1452","0","41.60","21.07"
"66","000","00","280","0008","1589","497","252","245","3","500","1309","0","38.20","19.25"
"66","000","00","280","0009","0000","1409","660","749","22","1431","3400","0","42.09","19.41"
"66","000","00","280","0009","1594","701","336","365","10","711","1707","0","41.65","19.68"
"66","000","00","280","0009","1595","708","324","384","12","720","1693","0","42.53","19.14"
"66","000","00","280","0010","0000","1970","858","1112","25","1995","5356","0","37.25","16.02"
"66","000","00","280","0010","1652","521","234","287","7","528","1387","0","38.07","16.87"
"66","000","00","280","0010","1653","449","205","244","4","453","1272","0","35.61","16.12"
"66","000","00","280","0010","1654","507","247","260","6","513","1415","0","36.25","17.46"
"66","000","00","280","0010","1655","493","172","321","8","501","1282","0","39.08","13.42"
"66","000","00","280","0011","0000","3227","1424","1803","36","3263","7841","0","41.61","18.16"
"66","000","00","280","0011","1661","553","252","301","8","561","1424","0","39.40","17.70"
"66","000","00","280","0011","1662","733","322","411","10","743","1644","0","45.19","19.59"
"66","000","00","280","0011","1663","709","315","394","4","713","1727","0","41.29","18.24"
"66","000","00","280","0011","1664","666","273","393","7","673","1522","0","44.22","17.94"
"66","000","00","280","0011","1665","566","262","304","7","573","1524","0","37.60","17.19"
"66","000","00","280","0012","0000","1876","812","1064","17","1893","4167","0","45.43","19.49"
"66","000","00","280","0012","1596","515","227","288","4","519","1129","0","45.97","20.11"
"66","000","00","280","0012","1597","718","275","443","7","725","1539","0","47.11","17.87"
"66","000","00","280","0012","1598","643","310","333","6","649","1499","0","43.30","20.68"
"66","000","00","280","0013","0000","465","167","298","4","469","982","0","47.76","17.01"
"66","000","00","280","0013","1599","465","167","298","4","469","982","0","47.76","17.01"
"66","000","00","280","0014","0000","3121","1346","1775","35","3156","8402","0","37.56","16.02"
"66","000","00","280","0014","1600","552","250","302","2","554","1493","0","37.11","16.74"
"66","000","00","280","0014","1601","475","172","303","7","482","1330","0","36.24","12.93"
"66","000","00","280","0014","1602","501","222","279","6","507","1299","0","39.03","17.09"
"66","000","00","280","0014","1603","521","204","317","6","527","1435","0","36.72","14.22"
"66","000","00","280","0014","1604","539","239","300","8","547","1415","0","38.66","16.89"
"66","000","00","280","0014","1605","533","259","274","6","539","1430","0","37.69","18.11"
"66","000","00","280","0015","0000","1701","748","953","16","1717","4704","0","36.50","15.90"
"66","000","00","280","0015","1610","553","217","336","7","560","1419","0","39.46","15.29"
"66","000","00","280","0015","1611","606","259","347","6","612","1702","0","35.96","15.22"
"66","000","00","280","0015","1612","542","272","270","3","545","1583","0","34.43","17.18"
"66","000","00","280","0016","0000","3197","1374","1823","30","3227","8359","0","38.61","16.44"
"66","000","00","280","0016","1613","506","225","281","4","510","1419","0","35.94","15.86"
"66","000","00","280","0016","1614","566","274","292","8","574","1394","0","41.18","19.66"
"66","000","00","280","0016","1615","585","262","323","2","587","1441","0","40.74","18.18"
"66","000","00","280","0016","1616","478","176","302","5","483","1311","0","36.84","13.42"
"66","000","00","280","0016","1617","481","186","295","2","483","1312","0","36.81","14.18"
"66","000","00","280","0016","1618","581","251","330","9","590","1482","0","39.81","16.94"
"66","000","00","280","0017","0000","4492","2117","2375","27","4519","11593","0","38.98","18.26"
"66","000","00","280","0017","1666","505","218","287","4","509","1354","0","37.59","16.10"
"66","000","00","280","0017","1667","606","309","297","0","606","1445","0","41.94","21.38"
"66","000","00","280","0017","1668","565","267","298","4","569","1521","0","37.41","17.55"
"66","000","00","280","0017","1669","565","256","309","3","568","1441","0","39.42","17.77"
"66","000","00","280","0017","1670","633","334","299","1","634","1485","0","42.69","22.49"
"66","000","00","280","0017","1671","481","253","228","1","482","1486","0","32.44","17.03"
"66","000","00","280","0017","1672","488","201","287","7","495","1364","0","36.29","14.74"
"66","000","00","280","0017","1673","649","279","370","7","656","1497","0","43.82","18.64"
"66","000","00","280","0018","0000","3745","1742","2003","29","3774","9507","0","39.70","18.32"
"66","000","00","280","0018","1646","622","279","343","7","629","1589","0","39.58","17.56"
"66","000","00","280","0018","1647","629","319","310","9","638","1631","0","39.12","19.56"
"66","000","00","280","0018","1648","625","284","341","2","627","1441","0","43.51","19.71"
"66","000","00","280","0018","1649","631","281","350","1","632","1620","0","39.01","17.35"
"66","000","00","280","0018","1650","656","316","340","8","664","1743","0","38.10","18.13"
"66","000","00","280","0018","1651","582","263","319","2","584","1483","0","39.38","17.73"
"66","000","00","280","0019","0000","4018","1829","2189","36","4054","10403","0","38.97","17.58"
"66","000","00","280","0019","1554","605","306","299","6","611","1624","0","37.62","18.84"
"66","000","00","280","0019","1555","584","260","324","7","591","1597","0","37.01","16.28"
"66","000","00","280","0019","1556","551","250","301","4","555","1650","0","33.64","15.15"
"66","000","00","280","0019","1557","543","240","303","5","548","1291","0","42.45","18.59"
"66","000","00","280","0019","1558","588","265","323","2","590","1439","0","41.00","18.42"
"66","000","00","280","0019","1559","490","204","286","10","500","1191","0","41.98","17.13"
"66","000","00","280","0019","1560","657","304","353","2","659","1611","0","40.91","18.87"
"66","000","00","280","0020","0000","1168","498","670","12","1180","2803","0","42.10","17.77"
"66","000","00","280","0020","1561","624","252","372","2","626","1402","0","44.65","17.97"
"66","000","00","280","0020","1562","544","246","298","10","554","1401","0","39.54","17.56"
"66","000","00","280","0021","0000","2452","1276","1176","15","2467","5719","0","43.14","22.31"
"66","000","00","280","0021","1572","623","327","296","0","623","1417","0","43.97","23.08"
"66","000","00","280","0021","1573","552","298","254","5","557","1410","0","39.50","21.13"
"66","000","00","280","0021","1574","714","366","348","9","723","1564","0","46.23","23.40"
"66","000","00","280","0021","1575","563","285","278","1","564","1328","0","42.47","21.46"
"66","000","00","280","0022","0000","1675","779","896","12","1687","4144","0","40.71","18.80"
"66","000","00","280","0022","1624","575","277","298","6","581","1495","0","38.86","18.53"
"66","000","00","280","0022","1625","506","235","271","1","507","1251","0","40.53","18.78"
"66","000","00","280","0022","1626","594","267","327","5","599","1398","0","42.85","19.10"
"66","000","00","280","0023","0000","4411","2241","2170","40","4451","9667","0","46.04","23.18"
"66","000","00","280","0023","1627","773","410","363","4","777","1621","0","47.93","25.29"
"66","000","00","280","0023","1628","695","340","355","10","705","1552","0","45.43","21.91"
"66","000","00","280","0023","1629","781","391","390","8","789","1589","0","49.65","24.61"
"66","000","00","280","0023","1630","727","368","359","7","734","1612","0","45.53","22.83"
"66","000","00","280","0023","1631","706","372","334","8","714","1616","0","44.18","23.02"
"66","000","00","280","0023","1632","729","360","369","3","732","1677","0","43.65","21.47"
"66","000","00","280","0024","0000","3800","1889","1911","42","3842","8636","0","44.49","21.87"
"66","000","00","280","0024","1640","629","308","321","4","633","1498","0","42.26","20.56"
"66","000","00","280","0024","1641","638","339","299","3","641","1387","0","46.21","24.44"
"66","000","00","280","0024","1642","628","321","307","8","636","1387","0","45.85","23.14"
"66","000","00","280","0024","1643","644","284","360","16","660","1351","0","48.85","21.02"
"66","000","00","280","0024","1644","630","303","327","8","638","1486","0","42.93","20.39"
"66","000","00","280","0024","1645","631","334","297","3","634","1527","0","41.52","21.87"
"66","000","00","280","0025","0000","2119","1049","1070","24","2143","5389","0","39.77","19.47"
"66","000","00","280","0025","1590","495","235","260","2","497","1278","0","38.89","18.39"
"66","000","00","280","0025","1591","516","250","266","4","520","1315","0","39.54","19.01"
"66","000","00","280","0025","1592","577","305","272","12","589","1507","0","39.08","20.24"
"66","000","00","280","0025","1593","531","259","272","6","537","1289","0","41.66","20.09"
"66","000","00","280","0026","0000","3020","1382","1638","26","3046","7712","0","39.50","17.92"
"66","000","00","280","0026","1656","628","283","345","4","632","1585","0","39.87","17.85"
"66","000","00","280","0026","1657","623","280","343","7","630","1574","0","40.03","17.79"
"66","000","00","280","0026","1658","561","242","319","4","565","1512","0","37.37","16.01"
"66","000","00","280","0026","1659","635","313","322","7","642","1630","0","39.39","19.20"
"66","000","00","280","0026","1660","573","264","309","4","577","1411","0","40.89","18.71"
"66","000","00","280","0027","0000","2309","1037","1272","17","2326","5865","0","39.66","17.68"
"66","000","00","280","0027","1606","632","252","380","4","636","1566","0","40.61","16.09"
"66","000","00","280","0027","1607","569","279","290","5","574","1464","0","39.21","19.06"
"66","000","00","280","0027","1608","438","192","246","4","442","1161","0","38.07","16.54"
"66","000","00","280","0027","1609","670","314","356","4","674","1674","0","40.26","18.76"
"66","000","00","290","0000","0000","2980","2054","926","47","3027","9436","10841","32.08","21.77"
"66","000","00","290","0001","0000","646","420","226","14","660","1883","0","35.05","22.30"
"66","000","00","290","0001","1856","318","168","150","8","326","936","0","34.83","17.95"
"66","000","00","290","0001","1857","328","252","76","6","334","947","0","35.27","26.61"
"66","000","00","290","0002","0000","141","77","64","4","145","456","0","31.80","16.89"
"66","000","00","290","0002","1858","141","77","64","4","145","456","0","31.80","16.89"
"66","000","00","290","0003","0000","529","382","147","6","535","1641","0","32.60","23.28"
"66","000","00","290","0003","1859","317","232","85","4","321","999","0","32.13","23.22"
"66","000","00","290","0003","1860","212","150","62","2","214","642","0","33.33","23.36"
"66","000","00","290","0004","0000","193","134","59","2","195","461","0","42.30","29.07"
"66","000","00","290","0004","1866","193","134","59","2","195","461","0","42.30","29.07"
"66","000","00","290","0005","0000","415","317","98","10","425","1081","0","39.32","29.32"
"66","000","00","290","0005","1861","97","56","41","4","101","291","0","34.71","19.24"
"66","000","00","290","0005","1862","174","152","22","2","176","459","0","38.34","33.12"
"66","000","00","290","0005","1863","144","109","35","4","148","331","0","44.71","32.93"
"66","000","00","290","0006","0000","420","300","120","2","422","1107","0","38.12","27.10"
"66","000","00","290","0006","1864","289","194","95","2","291","755","0","38.54","25.70"
"66","000","00","290","0006","1865","131","106","25","0","131","352","0","37.22","30.11"
"66","000","00","290","0007","0000","427","268","159","6","433","1939","0","22.33","13.82"
"66","000","00","290","0007","1867","81","39","42","0","81","346","0","23.41","11.27"
"66","000","00","290","0007","1868","158","107","51","3","161","755","0","21.32","14.17"
"66","000","00","290","0007","1869","131","88","43","1","132","566","0","23.32","15.55"
"66","000","00","290","0007","1870","57","34","23","2","59","272","0","21.69","12.50"
"66","000","00","290","0008","0000","209","156","53","3","212","868","0","24.42","17.97"
"66","000","00","290","0008","1871","35","27","8","0","35","149","0","23.49","18.12"
"66","000","00","290","0008","1872","174","129","45","3","177","719","0","24.62","17.94"
"67","000","00","000","0000","0000","648317","232475","415842","5891","654208","1592388","1868739","41.08","14.60"
"67","000","00","010","0000","0000","25147","10290","14857","220","25367","63992","76027","39.64","16.08"
"67","000","00","010","0001","0000","1943","998","945","12","1955","4561","0","42.86","21.88"
"67","000","00","010","0001","0139","499","259","240","1","500","1274","0","39.25","20.33"
"67","000","00","010","0001","0140","444","251","193","4","448","1112","0","40.29","22.57"
"67","000","00","010","0001","0141","476","228","248","3","479","1035","0","46.28","22.03"
"67","000","00","010","0001","0142","524","260","264","4","528","1140","0","46.32","22.81"
"67","000","00","010","0002","0000","912","394","518","5","917","2212","0","41.46","17.81"
"67","000","00","010","0002","0143","482","193","289","3","485","1156","0","41.96","16.70"
"67","000","00","010","0002","0144","430","201","229","2","432","1056","0","40.91","19.03"
"67","000","00","010","0003","0000","1146","469","677","10","1156","2807","0","41.18","16.71"
"67","000","00","010","0003","0145","561","221","340","4","565","1366","0","41.36","16.18"
"67","000","00","010","0003","0146","585","248","337","6","591","1441","0","41.01","17.21"
"67","000","00","010","0007","0000","1165","469","696","14","1179","2795","0","42.18","16.78"
"67","000","00","010","0007","0150","425","175","250","4","429","1014","0","42.31","17.26"
"67","000","00","010","0007","0151","363","148","215","4","367","892","0","41.14","16.59"
"67","000","00","010","0007","0152","377","146","231","6","383","889","0","43.08","16.42"
"67","000","00","010","0008","0000","1573","697","876","16","1589","4010","0","39.63","17.38"
"67","000","00","010","0008","0153","512","223","289","9","521","1314","0","39.65","16.97"
"67","000","00","010","0008","0154","477","228","249","3","480","1311","0","36.61","17.39"
"67","000","00","010","0008","0155","584","246","338","4","588","1385","0","42.45","17.76"
"67","000","00","010","0009","0000","468","188","280","9","477","1131","0","42.18","16.62"
"67","000","00","010","0009","0161","468","188","280","9","477","1131","0","42.18","16.62"
"67","000","00","010","0010","0000","571","172","399","6","577","1430","0","40.35","12.03"
"67","000","00","010","0010","0162","571","172","399","6","577","1430","0","40.35","12.03"
"67","000","00","010","0012","0000","887","390","497","4","891","2371","0","37.58","16.45"
"67","000","00","010","0012","0165","451","178","273","3","454","1166","0","38.94","15.27"
"67","000","00","010","0012","0166","436","212","224","1","437","1205","0","36.27","17.59"
"67","000","00","010","0013","0000","736","336","400","6","742","1734","0","42.79","19.38"
"67","000","00","010","0013","0163","329","168","161","4","333","816","0","40.81","20.59"
"67","000","00","010","0013","0164","407","168","239","2","409","918","0","44.55","18.30"
"67","000","00","010","0014","0000","1202","459","743","10","1212","3194","0","37.95","14.37"
"67","000","00","010","0014","0167","391","150","241","1","392","1000","0","39.20","15.00"
"67","000","00","010","0014","0168","359","134","225","2","361","1000","0","36.10","13.40"
"67","000","00","010","0014","0169","452","175","277","7","459","1194","0","38.44","14.66"
"67","000","00","010","0015","0000","1640","639","1001","21","1661","4405","0","37.71","14.51"
"67","000","00","010","0015","0178","449","191","258","1","450","1256","0","35.83","15.21"
"67","000","00","010","0015","0179","362","132","230","6","368","912","0","40.35","14.47"
"67","000","00","010","0015","0180","375","157","218","8","383","1038","0","36.90","15.13"
"67","000","00","010","0015","0181","454","159","295","6","460","1199","0","38.37","13.26"
"67","000","00","010","0016","0000","642","228","414","12","654","1632","0","40.07","13.97"
"67","000","00","010","0016","0182","372","126","246","6","378","921","0","41.04","13.68"
"67","000","00","010","0016","0183","270","102","168","6","276","711","0","38.82","14.35"
"67","000","00","010","0017","0000","512","169","343","4","516","1333","0","38.71","12.68"
"67","000","00","010","0017","0184","512","169","343","4","516","1333","0","38.71","12.68"
"67","000","00","010","0018","0000","599","151","448","6","605","1724","0","35.09","8.76"
"67","000","00","010","0018","0185","482","114","368","4","486","1456","0","33.38","7.83"
"67","000","00","010","0018","0186","117","37","80","2","119","268","0","44.40","13.81"
"67","000","00","010","0019","0000","657","195","462","5","662","1696","0","39.03","11.50"
"67","000","00","010","0019","0187","383","121","262","3","386","939","0","41.11","12.89"
"67","000","00","010","0019","0188","274","74","200","2","276","757","0","36.46","9.78"
"67","000","00","010","0020","0000","1322","544","778","13","1335","3665","0","36.43","14.84"
"67","000","00","010","0020","0189","432","166","266","3","435","1169","0","37.21","14.20"
"67","000","00","010","0020","0190","481","194","287","7","488","1361","0","35.86","14.25"
"67","000","00","010","0020","0191","409","184","225","3","412","1135","0","36.30","16.21"
"67","000","00","010","0021","0000","660","214","446","5","665","1880","0","35.37","11.38"
"67","000","00","010","0021","0192","357","107","250","3","360","1038","0","34.68","10.31"
"67","000","00","010","0021","0193","303","107","196","2","305","842","0","36.22","12.71"
"67","000","00","010","0025","0000","610","151","459","5","615","1555","0","39.55","9.71"
"67","000","00","010","0025","0196","245","65","180","4","249","670","0","37.16","9.70"
"67","000","00","010","0025","0197","365","86","279","1","366","885","0","41.36","9.72"
"67","000","00","010","0026","0000","341","100","241","6","347","897","0","38.68","11.15"
"67","000","00","010","0026","0194","208","54","154","3","211","507","0","41.62","10.65"
"67","000","00","010","0026","0195","133","46","87","3","136","390","0","34.87","11.79"
"67","000","00","010","0027","0000","1885","840","1045","11","1896","4874","0","38.90","17.23"
"67","000","00","010","0027","0170","496","209","287","3","499","1254","0","39.79","16.67"
"67","000","00","010","0027","0171","453","220","233","3","456","1274","0","35.79","17.27"
"67","000","00","010","0027","0172","426","186","240","5","431","1082","0","39.83","17.19"
"67","000","00","010","0027","0173","510","225","285","0","510","1264","0","40.35","17.80"
"67","000","00","010","0028","0000","2045","854","1191","11","2056","5086","0","40.42","16.79"
"67","000","00","010","0028","0174","559","214","345","1","560","1369","0","40.91","15.63"
"67","000","00","010","0028","0175","507","243","264","3","510","1265","0","40.32","19.21"
"67","000","00","010","0028","0176","457","192","265","2","459","1171","0","39.20","16.40"
"67","000","00","010","0028","0177","522","205","317","5","527","1281","0","41.14","16.00"
"67","000","00","010","0029","0000","2500","1187","1313","19","2519","6401","0","39.35","18.54"
"67","000","00","010","0029","0156","493","210","283","2","495","1252","0","39.54","16.77"
"67","000","00","010","0029","0157","518","274","244","5","523","1310","0","39.92","20.92"
"67","000","00","010","0029","0158","448","193","255","2","450","1215","0","37.04","15.88"
"67","000","00","010","0029","0159","517","251","266","6","523","1294","0","40.42","19.40"
"67","000","00","010","0029","0160","524","259","265","4","528","1330","0","39.70","19.47"
"67","000","00","010","0030","0000","1131","446","685","10","1141","2599","0","43.90","17.16"
"67","000","00","010","0030","0147","399","166","233","0","399","867","0","46.02","19.15"
"67","000","00","010","0030","0148","430","154","276","6","436","1004","0","43.43","15.34"
"67","000","00","010","0030","0149","302","126","176","4","306","728","0","42.03","17.31"
"67","000","00","020","0000","0000","8341","2569","5772","92","8433","21950","24892","38.42","11.70"
"67","000","00","020","0001","0000","592","193","399","2","594","1549","0","38.35","12.46"
"67","000","00","020","0001","0108","406","116","290","1","407","1074","0","37.90","10.80"
"67","000","00","020","0001","0109","186","77","109","1","187","475","0","39.37","16.21"
"67","000","00","020","0008","0000","1294","448","846","15","1309","3724","0","35.15","12.03"
"67","000","00","020","0008","0116","412","123","289","3","415","1093","0","37.97","11.25"
"67","000","00","020","0008","0117","474","177","297","8","482","1366","0","35.29","12.96"
"67","000","00","020","0008","0118","408","148","260","4","412","1265","0","32.57","11.70"
"67","000","00","020","0010","0000","313","41","272","11","324","875","0","37.03","4.69"
"67","000","00","020","0010","0122","313","41","272","11","324","875","0","37.03","4.69"
"67","000","00","020","0011","0000","1445","510","935","18","1463","3815","0","38.35","13.37"
"67","000","00","020","0011","0119","519","189","330","8","527","1434","0","36.75","13.18"
"67","000","00","020","0011","0120","544","182","362","5","549","1289","0","42.59","14.12"
"67","000","00","020","0011","0121","382","139","243","5","387","1092","0","35.44","12.73"
"67","000","00","020","0014","0000","607","173","434","7","614","1621","0","37.88","10.67"
"67","000","00","020","0014","0130","355","115","240","5","360","903","0","39.87","12.74"
"67","000","00","020","0014","0131","252","58","194","2","254","718","0","35.38","8.08"
"67","000","00","020","0026","0000","608","200","408","7","615","1413","0","43.52","14.15"
"67","000","00","020","0026","0110","250","84","166","1","251","626","0","40.10","13.42"
"67","000","00","020","0026","0111","138","48","90","3","141","308","0","45.78","15.58"
"67","000","00","020","0026","0112","220","68","152","3","223","479","0","46.56","14.20"
"67","000","00","020","0027","0000","653","279","374","0","653","1575","0","41.46","17.71"
"67","000","00","020","0027","0113","308","130","178","0","308","761","0","40.47","17.08"
"67","000","00","020","0027","0114","128","51","77","0","128","315","0","40.63","16.19"
"67","000","00","020","0027","0115","217","98","119","0","217","499","0","43.49","19.64"
"67","000","00","020","0028","0000","623","138","485","4","627","1519","0","41.28","9.08"
"67","000","00","020","0028","0125","337","59","278","1","338","770","0","43.90","7.66"
"67","000","00","020","0028","0126","118","31","87","0","118","282","0","41.84","10.99"
"67","000","00","020","0028","0127","168","48","120","3","171","467","0","36.62","10.28"
"67","000","00","020","0029","0000","562","141","421","8","570","1545","0","36.89","9.13"
"67","000","00","020","0029","0123","303","67","236","2","305","817","0","37.33","8.20"
"67","000","00","020","0029","0124","259","74","185","6","265","728","0","36.40","10.16"
"67","000","00","020","0030","0000","367","93","274","2","369","981","0","37.61","9.48"
"67","000","00","020","0030","0128","238","59","179","2","240","597","0","40.20","9.88"
"67","000","00","020","0030","0129","129","34","95","0","129","384","0","33.59","8.85"
"67","000","00","020","0031","0000","438","113","325","6","444","1073","0","41.38","10.53"
"67","000","00","020","0031","0135","306","78","228","4","310","724","0","42.82","10.77"
"67","000","00","020","0031","0136","132","35","97","2","134","349","0","38.40","10.03"
"67","000","00","020","0032","0000","370","107","263","6","376","900","0","41.78","11.89"
"67","000","00","020","0032","0132","108","22","86","2","110","211","0","52.13","10.43"
"67","000","00","020","0032","0133","132","50","82","3","135","382","0","35.34","13.09"
"67","000","00","020","0032","0134","130","35","95","1","131","307","0","42.67","11.40"
"67","000","00","020","0033","0000","469","133","336","6","475","1360","0","34.93","9.78"
"67","000","00","020","0033","0137","323","84","239","0","323","903","0","35.77","9.30"
"67","000","00","020","0033","0138","146","49","97","6","152","457","0","33.26","10.72"
"67","000","00","030","0000","0000","9142","2783","6359","117","9259","24122","26978","38.38","11.54"
"67","000","00","030","0001","0000","672","210","462","2","674","1688","0","39.93","12.44"
"67","000","00","030","0001","0030","374","106","268","0","374","953","0","39.24","11.12"
"67","000","00","030","0001","0031","298","104","194","2","300","735","0","40.82","14.15"
"67","000","00","030","0002","0000","1275","411","864","3","1278","2937","0","43.51","13.99"
"67","000","00","030","0002","0032","395","113","282","1","396","864","0","45.83","13.08"
"67","000","00","030","0002","0033","415","146","269","1","416","966","0","43.06","15.11"
"67","000","00","030","0002","0034","465","152","313","1","466","1107","0","42.10","13.73"
"67","000","00","030","0003","0000","546","187","359","4","550","1364","0","40.32","13.71"
"67","000","00","030","0003","0035","546","187","359","4","550","1364","0","40.32","13.71"
"67","000","00","030","0004","0000","640","201","439","12","652","1596","0","40.85","12.59"
"67","000","00","030","0004","0036","288","87","201","8","296","699","0","42.35","12.45"
"67","000","00","030","0004","0037","352","114","238","4","356","897","0","39.69","12.71"
"67","000","00","030","0005","0000","338","107","231","4","342","874","0","39.13","12.24"
"67","000","00","030","0005","0038","338","107","231","4","342","874","0","39.13","12.24"
"67","000","00","030","0006","0000","544","179","365","10","554","1334","0","41.53","13.42"
"67","000","00","030","0006","0039","342","111","231","6","348","793","0","43.88","14.00"
"67","000","00","030","0006","0040","202","68","134","4","206","541","0","38.08","12.57"
"67","000","00","030","0007","0000","173","58","115","5","178","440","0","40.45","13.18"
"67","000","00","030","0007","0041","173","58","115","5","178","440","0","40.45","13.18"
"67","000","00","030","0008","0000","181","43","138","2","183","560","0","32.68","7.68"
"67","000","00","030","0008","0042","181","43","138","2","183","560","0","32.68","7.68"
"67","000","00","030","0009","0000","121","39","82","2","123","369","0","33.33","10.57"
"67","000","00","030","0009","0043","121","39","82","2","123","369","0","33.33","10.57"
"67","000","00","030","0010","0000","159","35","124","3","162","487","0","33.26","7.19"
"67","000","00","030","0010","0044","159","35","124","3","162","487","0","33.26","7.19"
"67","000","00","030","0011","0000","381","138","243","7","388","1178","0","32.94","11.71"
"67","000","00","030","0011","0047","141","74","67","2","143","431","0","33.18","17.17"
"67","000","00","030","0011","0048","240","64","176","5","245","747","0","32.80","8.57"
"67","000","00","030","0012","0000","333","81","252","4","337","1001","0","33.67","8.09"
"67","000","00","030","0012","0045","210","44","166","3","213","617","0","34.52","7.13"
"67","000","00","030","0012","0046","123","37","86","1","124","384","0","32.29","9.64"
"67","000","00","030","0014","0000","489","150","339","9","498","1380","0","36.09","10.87"
"67","000","00","030","0014","0051","255","77","178","4","259","698","0","37.11","11.03"
"67","000","00","030","0014","0052","234","73","161","5","239","682","0","35.04","10.70"
"67","000","00","030","0018","0000","318","107","211","7","325","836","0","38.88","12.80"
"67","000","00","030","0018","0055","318","107","211","7","325","836","0","38.88","12.80"
"67","000","00","030","0019","0000","191","87","104","3","194","705","0","27.52","12.34"
"67","000","00","030","0019","0056","191","87","104","3","194","705","0","27.52","12.34"
"67","000","00","030","0020","0000","477","134","343","6","483","1303","0","37.07","10.28"
"67","000","00","030","0020","0057","477","134","343","6","483","1303","0","37.07","10.28"
"67","000","00","030","0021","0000","283","69","214","2","285","707","0","40.31","9.76"
"67","000","00","030","0021","0058","283","69","214","2","285","707","0","40.31","9.76"
"67","000","00","030","0022","0000","253","72","181","4","257","657","0","39.12","10.96"
"67","000","00","030","0022","0059","253","72","181","4","257","657","0","39.12","10.96"
"67","000","00","030","0025","0000","743","198","545","11","754","1930","0","39.07","10.26"
"67","000","00","030","0025","0049","322","63","259","2","324","781","0","41.49","8.07"
"67","000","00","030","0025","0050","421","135","286","9","430","1149","0","37.42","11.75"
"67","000","00","030","0026","0000","581","155","426","9","590","1458","0","40.47","10.63"
"67","000","00","030","0026","0053","223","62","161","4","227","620","0","36.61","10.00"
"67","000","00","030","0026","0054","358","93","265","5","363","838","0","43.32","11.10"
"67","000","00","030","0027","0000","444","122","322","8","452","1318","0","34.29","9.26"
"67","000","00","030","0027","0060","289","97","192","4","293","817","0","35.86","11.87"
"67","000","00","030","0027","0061","155","25","130","4","159","501","0","31.74","4.99"
"67","000","00","040","0000","0000","7157","2321","4836","75","7232","18522","20733","39.05","12.53"
"67","000","00","040","0001","0000","712","263","449","9","721","1825","0","39.51","14.41"
"67","000","00","040","0001","0198","439","146","293","5","444","1142","0","38.88","12.78"
"67","000","00","040","0001","0199","273","117","156","4","277","683","0","40.56","17.13"
"67","000","00","040","0002","0000","704","262","442","4","708","1608","0","44.03","16.29"
"67","000","00","040","0002","0200","324","131","193","1","325","731","0","44.46","17.92"
"67","000","00","040","0002","0201","380","131","249","3","383","877","0","43.67","14.94"
"67","000","00","040","0003","0000","451","163","288","2","453","1107","0","40.92","14.72"
"67","000","00","040","0003","0202","451","163","288","2","453","1107","0","40.92","14.72"
"67","000","00","040","0004","0000","1092","388","704","10","1102","2722","0","40.48","14.25"
"67","000","00","040","0004","0203","347","103","244","4","351","880","0","39.89","11.70"
"67","000","00","040","0004","0204","390","141","249","4","394","981","0","40.16","14.37"
"67","000","00","040","0004","0205","355","144","211","2","357","861","0","41.46","16.72"
"67","000","00","040","0005","0000","508","168","340","3","511","1368","0","37.35","12.28"
"67","000","00","040","0005","0206","508","168","340","3","511","1368","0","37.35","12.28"
"67","000","00","040","0006","0000","296","107","189","2","298","727","0","40.99","14.72"
"67","000","00","040","0006","0207","171","64","107","2","173","398","0","43.47","16.08"
"67","000","00","040","0006","0208","125","43","82","0","125","329","0","37.99","13.07"
"67","000","00","040","0007","0000","604","201","403","12","616","1454","0","42.37","13.82"
"67","000","00","040","0007","0209","321","125","196","7","328","701","0","46.79","17.83"
"67","000","00","040","0007","0210","283","76","207","5","288","753","0","38.25","10.09"
"67","000","00","040","0008","0000","647","173","474","5","652","1738","0","37.51","9.95"
"67","000","00","040","0008","0211","258","55","203","4","262","690","0","37.97","7.97"
"67","000","00","040","0008","0212","295","94","201","0","295","768","0","38.41","12.24"
"67","000","00","040","0008","0213","94","24","70","1","95","280","0","33.93","8.57"
"67","000","00","040","0009","0000","469","136","333","6","475","1275","0","37.25","10.67"
"67","000","00","040","0009","0214","222","80","142","4","226","666","0","33.93","12.01"
"67","000","00","040","0009","0215","247","56","191","2","249","609","0","40.89","9.20"
"67","000","00","040","0010","0000","254","54","200","4","258","652","0","39.57","8.28"
"67","000","00","040","0010","0216","254","54","200","4","258","652","0","39.57","8.28"
"67","000","00","040","0011","0000","478","127","351","12","490","1337","0","36.65","9.50"
"67","000","00","040","0011","0217","401","111","290","10","411","1139","0","36.08","9.75"
"67","000","00","040","0011","0218","77","16","61","2","79","198","0","39.90","8.08"
"67","000","00","040","0012","0000","436","121","315","5","441","1192","0","37.00","10.15"
"67","000","00","040","0012","0219","357","91","266","3","360","1033","0","34.85","8.81"
"67","000","00","040","0012","0220","79","30","49","2","81","159","0","50.94","18.87"
"67","000","00","040","0013","0000","506","158","348","1","507","1517","0","33.42","10.42"
"67","000","00","040","0013","0221","266","87","179","1","267","858","0","31.12","10.14"
"67","000","00","040","0013","0222","184","53","131","0","184","491","0","37.47","10.79"
"67","000","00","040","0013","0223","56","18","38","0","56","168","0","33.33","10.71"
"67","000","00","050","0000","0000","8043","2446","5597","111","8154","20265","22532","40.24","12.07"
"67","000","00","050","0001","0000","690","258","432","7","697","1620","0","43.02","15.93"
"67","000","00","050","0001","0001","314","106","208","3","317","717","0","44.21","14.78"
"67","000","00","050","0001","0002","376","152","224","4","380","903","0","42.08","16.83"
"67","000","00","050","0002","0000","504","143","361","7","511","1264","0","40.43","11.31"
"67","000","00","050","0002","0003","303","91","212","6","309","748","0","41.31","12.17"
"67","000","00","050","0002","0004","201","52","149","1","202","516","0","39.15","10.08"
"67","000","00","050","0003","0000","479","147","332","6","485","1275","0","38.04","11.53"
"67","000","00","050","0003","0005","379","121","258","6","385","1039","0","37.05","11.65"
"67","000","00","050","0003","0006","100","26","74","0","100","236","0","42.37","11.02"
"67","000","00","050","0004","0000","526","128","398","6","532","1304","0","40.80","9.82"
"67","000","00","050","0004","0007","197","62","135","2","199","459","0","43.36","13.51"
"67","000","00","050","0004","0008","329","66","263","4","333","845","0","39.41","7.81"
"67","000","00","050","0010","0000","575","113","462","6","581","1336","0","43.49","8.46"
"67","000","00","050","0010","0021","412","74","338","3","415","902","0","46.01","8.20"
"67","000","00","050","0010","0022","163","39","124","3","166","434","0","38.25","8.99"
"67","000","00","050","0011","0000","604","188","416","9","613","1610","0","38.07","11.68"
"67","000","00","050","0011","0023","247","81","166","5","252","639","0","39.44","12.68"
"67","000","00","050","0011","0024","357","107","250","4","361","971","0","37.18","11.02"
"67","000","00","050","0012","0000","483","179","304","8","491","1223","0","40.15","14.64"
"67","000","00","050","0012","0025","483","179","304","8","491","1223","0","40.15","14.64"
"67","000","00","050","0013","0000","507","188","319","6","513","1216","0","42.19","15.46"
"67","000","00","050","0013","0026","267","102","165","3","270","659","0","40.97","15.48"
"67","000","00","050","0013","0027","240","86","154","3","243","557","0","43.63","15.44"
"67","000","00","050","0014","0000","683","226","457","7","690","1753","0","39.36","12.89"
"67","000","00","050","0014","0028","227","54","173","0","227","603","0","37.65","8.96"
"67","000","00","050","0014","0029","456","172","284","7","463","1150","0","40.26","14.96"
"67","000","00","050","0018","0000","564","169","395","7","571","1379","0","41.41","12.26"
"67","000","00","050","0018","0013","141","42","99","2","143","349","0","40.97","12.03"
"67","000","00","050","0018","0014","264","71","193","2","266","636","0","41.82","11.16"
"67","000","00","050","0018","0015","159","56","103","3","162","394","0","41.12","14.21"
"67","000","00","050","0019","0000","302","80","222","5","307","966","0","31.78","8.28"
"67","000","00","050","0019","0016","165","41","124","4","169","515","0","32.82","7.96"
"67","000","00","050","0019","0017","137","39","98","1","138","451","0","30.60","8.65"
"67","000","00","050","0022","0000","815","250","565","19","834","1961","0","42.53","12.75"
"67","000","00","050","0022","0018","365","131","234","12","377","953","0","39.56","13.75"
"67","000","00","050","0022","0019","231","53","178","4","235","476","0","49.37","11.13"
"67","000","00","050","0022","0020","219","66","153","3","222","532","0","41.73","12.41"
"67","000","00","050","0023","0000","861","227","634","12","873","2164","0","40.34","10.49"
"67","000","00","050","0023","0009","426","112","314","10","436","1052","0","41.44","10.65"
"67","000","00","050","0023","0010","435","115","320","2","437","1112","0","39.30","10.34"
"67","000","00","050","0024","0000","450","150","300","6","456","1194","0","38.19","12.56"
"67","000","00","050","0024","0011","288","88","200","5","293","749","0","39.12","11.75"
"67","000","00","050","0024","0012","162","62","100","1","163","445","0","36.63","13.93"
"67","000","00","060","0000","0000","5750","1935","3815","67","5817","17960","19922","32.39","10.77"
"67","000","00","060","0001","0000","476","195","281","6","482","1400","0","34.43","13.93"
"67","000","00","060","0001","0224","476","195","281","6","482","1400","0","34.43","13.93"
"67","000","00","060","0002","0000","870","326","544","5","875","2475","0","35.35","13.17"
"67","000","00","060","0002","0225","446","156","290","1","447","1166","0","38.34","13.38"
"67","000","00","060","0002","0226","424","170","254","4","428","1309","0","32.70","12.99"
"67","000","00","060","0003","0000","470","130","340","2","472","1405","0","33.59","9.25"
"67","000","00","060","0003","0227","227","60","167","1","228","715","0","31.89","8.39"
"67","000","00","060","0003","0228","243","70","173","1","244","690","0","35.36","10.14"
"67","000","00","060","0004","0000","285","84","201","3","288","920","0","31.30","9.13"
"67","000","00","060","0004","0230","285","84","201","3","288","920","0","31.30","9.13"
"67","000","00","060","0005","0000","295","98","197","3","298","1058","0","28.17","9.26"
"67","000","00","060","0005","0229","295","98","197","3","298","1058","0","28.17","9.26"
"67","000","00","060","0006","0000","419","130","289","5","424","1193","0","35.54","10.90"
"67","000","00","060","0006","0231","169","65","104","4","173","633","0","27.33","10.27"
"67","000","00","060","0006","0232","250","65","185","1","251","560","0","44.82","11.61"
"67","000","00","060","0007","0000","292","75","217","8","300","826","0","36.32","9.08"
"67","000","00","060","0007","0233","292","75","217","8","300","826","0","36.32","9.08"
"67","000","00","060","0008","0000","117","31","86","1","118","420","0","28.10","7.38"
"67","000","00","060","0008","0237","117","31","86","1","118","420","0","28.10","7.38"
"67","000","00","060","0009","0000","106","30","76","0","106","376","0","28.19","7.98"
"67","000","00","060","0009","0238","106","30","76","0","106","376","0","28.19","7.98"
"67","000","00","060","0010","0000","136","42","94","4","140","370","0","37.84","11.35"
"67","000","00","060","0010","0239","136","42","94","4","140","370","0","37.84","11.35"
"67","000","00","060","0011","0000","619","230","389","9","628","2040","0","30.78","11.27"
"67","000","00","060","0011","0240","372","120","252","6","378","1181","0","32.01","10.16"
"67","000","00","060","0011","0241","247","110","137","3","250","859","0","29.10","12.81"
"67","000","00","060","0012","0000","147","53","94","1","148","647","0","22.87","8.19"
"67","000","00","060","0012","0242","147","53","94","1","148","647","0","22.87","8.19"
"67","000","00","060","0013","0000","278","83","195","2","280","1054","0","26.57","7.87"
"67","000","00","060","0013","0243","278","83","195","2","280","1054","0","26.57","7.87"
"67","000","00","060","0014","0000","299","109","190","5","304","1052","0","28.90","10.36"
"67","000","00","060","0014","0244","299","109","190","5","304","1052","0","28.90","10.36"
"67","000","00","060","0015","0000","219","108","111","2","221","877","0","25.20","12.31"
"67","000","00","060","0015","0245","219","108","111","2","221","877","0","25.20","12.31"
"67","000","00","060","0016","0000","722","211","511","11","733","1847","0","39.69","11.42"
"67","000","00","060","0016","0234","308","76","232","3","311","756","0","41.14","10.05"
"67","000","00","060","0016","0235","171","48","123","6","177","481","0","36.80","9.98"
"67","000","00","060","0016","0236","243","87","156","2","245","610","0","40.16","14.26"
"67","000","00","070","0000","0000","16415","4191","12224","170","16585","37508","43610","44.22","11.17"
"67","000","00","070","0003","0000","1121","372","749","11","1132","2562","0","44.18","14.52"
"67","000","00","070","0003","0388","394","128","266","6","400","945","0","42.33","13.54"
"67","000","00","070","0003","0389","374","123","251","4","378","800","0","47.25","15.38"
"67","000","00","070","0003","0390","353","121","232","1","354","817","0","43.33","14.81"
"67","000","00","070","0004","0000","1101","297","804","18","1119","2463","0","45.43","12.06"
"67","000","00","070","0004","0391","329","87","242","3","332","737","0","45.05","11.80"
"67","000","00","070","0004","0392","355","103","252","8","363","826","0","43.95","12.47"
"67","000","00","070","0004","0393","417","107","310","7","424","900","0","47.11","11.89"
"67","000","00","070","0005","0000","970","321","649","5","975","2086","0","46.74","15.39"
"67","000","00","070","0005","0386","445","132","313","3","448","915","0","48.96","14.43"
"67","000","00","070","0005","0387","525","189","336","2","527","1171","0","45.00","16.14"
"67","000","00","070","0006","0000","851","263","588","7","858","1936","0","44.32","13.58"
"67","000","00","070","0006","0394","463","149","314","5","468","990","0","47.27","15.05"
"67","000","00","070","0006","0395","388","114","274","2","390","946","0","41.23","12.05"
"67","000","00","070","0007","0000","647","171","476","6","653","1433","0","45.57","11.93"
"67","000","00","070","0007","0396","388","120","268","3","391","768","0","50.91","15.63"
"67","000","00","070","0007","0397","259","51","208","3","262","665","0","39.40","7.67"
"67","000","00","070","0009","0000","1593","400","1193","10","1603","3474","0","46.14","11.51"
"67","000","00","070","0009","0398","532","149","383","2","534","1107","0","48.24","13.46"
"67","000","00","070","0009","0399","563","138","425","2","565","1273","0","44.38","10.84"
"67","000","00","070","0009","0400","498","113","385","6","504","1094","0","46.07","10.33"
"67","000","00","070","0010","0000","458","78","380","3","461","1093","0","42.18","7.14"
"67","000","00","070","0010","0401","458","78","380","3","461","1093","0","42.18","7.14"
"67","000","00","070","0011","0000","1250","336","914","9","1259","2846","0","44.24","11.81"
"67","000","00","070","0011","0402","403","130","273","2","405","852","0","47.54","15.26"
"67","000","00","070","0011","0403","385","75","310","4","389","918","0","42.37","8.17"
"67","000","00","070","0011","0404","462","131","331","3","465","1076","0","43.22","12.17"
"67","000","00","070","0014","0000","989","332","657","11","1000","2315","0","43.20","14.34"
"67","000","00","070","0014","0407","294","105","189","3","297","689","0","43.11","15.24"
"67","000","00","070","0014","0408","334","133","201","6","340","782","0","43.48","17.01"
"67","000","00","070","0014","0409","361","94","267","2","363","844","0","43.01","11.14"
"67","000","00","070","0015","0000","747","152","595","4","751","1645","0","45.65","9.24"
"67","000","00","070","0015","0410","344","69","275","2","346","804","0","43.03","8.58"
"67","000","00","070","0015","0411","403","83","320","2","405","841","0","48.16","9.87"
"67","000","00","070","0017","0000","947","180","767","16","963","2284","0","42.16","7.88"
"67","000","00","070","0017","0412","524","105","419","10","534","1321","0","40.42","7.95"
"67","000","00","070","0017","0413","423","75","348","6","429","963","0","44.55","7.79"
"67","000","00","070","0019","0000","832","188","644","16","848","2089","0","40.59","9.00"
"67","000","00","070","0019","0414","383","98","285","4","387","985","0","39.29","9.95"
"67","000","00","070","0019","0415","275","62","213","11","286","648","0","44.14","9.57"
"67","000","00","070","0019","0416","174","28","146","1","175","456","0","38.38","6.14"
"67","000","00","070","0021","0000","515","125","390","9","524","1232","0","42.53","10.15"
"67","000","00","070","0021","0417","515","125","390","9","524","1232","0","42.53","10.15"
"67","000","00","070","0022","0000","446","88","358","3","449","1171","0","38.34","7.51"
"67","000","00","070","0022","0418","446","88","358","3","449","1171","0","38.34","7.51"
"67","000","00","070","0024","0000","627","128","499","6","633","1297","0","48.80","9.87"
"67","000","00","070","0024","0419","281","64","217","1","282","539","0","52.32","11.87"
"67","000","00","070","0024","0420","346","64","282","5","351","758","0","46.31","8.44"
"67","000","00","070","0028","0000","376","88","288","3","379","925","0","40.97","9.51"
"67","000","00","070","0028","0423","376","88","288","3","379","925","0","40.97","9.51"
"67","000","00","070","0030","0000","795","191","604","10","805","1871","0","43.03","10.21"
"67","000","00","070","0030","0384","502","118","384","6","508","1192","0","42.62","9.90"
"67","000","00","070","0030","0385","293","73","220","4","297","679","0","43.74","10.75"
"67","000","00","070","0031","0000","773","149","624","15","788","1633","0","48.25","9.12"
"67","000","00","070","0031","0421","405","86","319","12","417","844","0","49.41","10.19"
"67","000","00","070","0031","0422","368","63","305","3","371","789","0","47.02","7.98"
"67","000","00","070","0032","0000","756","162","594","4","760","1704","0","44.60","9.51"
"67","000","00","070","0032","0424","488","94","394","4","492","1110","0","44.32","8.47"
"67","000","00","070","0032","0425","268","68","200","0","268","594","0","45.12","11.45"
"67","000","00","070","0033","0000","621","170","451","4","625","1449","0","43.13","11.73"
"67","000","00","070","0033","0405","300","98","202","0","300","691","0","43.42","14.18"
"67","000","00","070","0033","0406","321","72","249","4","325","758","0","42.88","9.50"
"67","000","00","080","0000","0000","7838","2456","5382","82","7920","20418","23214","38.79","12.03"
"67","000","00","080","0001","0000","617","240","377","4","621","1503","0","41.32","15.97"
"67","000","00","080","0001","0270","317","127","190","1","318","759","0","41.90","16.73"
"67","000","00","080","0001","0271","300","113","187","3","303","744","0","40.73","15.19"
"67","000","00","080","0002","0000","701","219","482","6","707","1925","0","36.73","11.38"
"67","000","00","080","0002","0272","322","99","223","3","325","951","0","34.17","10.41"
"67","000","00","080","0002","0273","379","120","259","3","382","974","0","39.22","12.32"
"67","000","00","080","0003","0000","606","224","382","8","614","1601","0","38.35","13.99"
"67","000","00","080","0003","0274","276","94","182","2","278","735","0","37.82","12.79"
"67","000","00","080","0003","0275","330","130","200","6","336","866","0","38.80","15.01"
"67","000","00","080","0004","0000","609","228","381","6","615","1555","0","39.55","14.66"
"67","000","00","080","0004","0276","300","119","181","2","302","730","0","41.37","16.30"
"67","000","00","080","0004","0277","309","109","200","4","313","825","0","37.94","13.21"
"67","000","00","080","0005","0000","681","237","444","5","686","1945","0","35.27","12.19"
"67","000","00","080","0005","0278","345","137","208","2","347","994","0","34.91","13.78"
"67","000","00","080","0005","0279","336","100","236","3","339","951","0","35.65","10.52"
"67","000","00","080","0006","0000","807","266","541","11","818","2079","0","39.35","12.79"
"67","000","00","080","0006","0280","381","107","274","7","388","1036","0","37.45","10.33"
"67","000","00","080","0006","0281","426","159","267","4","430","1043","0","41.23","15.24"
"67","000","00","080","0011","0000","729","197","532","6","735","1817","0","40.45","10.84"
"67","000","00","080","0011","0286","373","96","277","2","375","919","0","40.81","10.45"
"67","000","00","080","0011","0287","356","101","255","4","360","898","0","40.09","11.25"
"67","000","00","080","0012","0000","392","90","302","5","397","866","0","45.84","10.39"
"67","000","00","080","0012","0288","392","90","302","5","397","866","0","45.84","10.39"
"67","000","00","080","0013","0000","424","129","295","3","427","1269","0","33.65","10.17"
"67","000","00","080","0013","0289","226","74","152","2","228","647","0","35.24","11.44"
"67","000","00","080","0013","0290","198","55","143","1","199","622","0","31.99","8.84"
"67","000","00","080","0016","0000","851","224","627","8","859","2146","0","40.03","10.44"
"67","000","00","080","0016","0284","458","120","338","5","463","1099","0","42.13","10.92"
"67","000","00","080","0016","0285","393","104","289","3","396","1047","0","37.82","9.93"
"67","000","00","080","0017","0000","566","205","361","8","574","1539","0","37.30","13.32"
"67","000","00","080","0017","0282","258","82","176","3","261","700","0","37.29","11.71"
"67","000","00","080","0017","0283","308","123","185","5","313","839","0","37.31","14.66"
"67","000","00","080","0018","0000","855","197","658","12","867","2173","0","39.90","9.07"
"67","000","00","080","0018","0291","465","111","354","5","470","1138","0","41.30","9.75"
"67","000","00","080","0018","0292","390","86","304","7","397","1035","0","38.36","8.31"
"67","000","00","090","0000","0000","7015","2150","4865","85","7100","18759","21572","37.85","11.46"
"67","000","00","090","0001","0000","1059","324","735","11","1070","2866","0","37.33","11.30"
"67","000","00","090","0001","0293","303","110","193","2","305","795","0","38.36","13.84"
"67","000","00","090","0001","0294","228","74","154","1","229","627","0","36.52","11.80"
"67","000","00","090","0001","0295","528","140","388","8","536","1444","0","37.12","9.70"
"67","000","00","090","0002","0000","959","279","680","12","971","2601","0","37.33","10.73"
"67","000","00","090","0002","0296","573","177","396","7","580","1483","0","39.11","11.94"
"67","000","00","090","0002","0297","386","102","284","5","391","1118","0","34.97","9.12"
"67","000","00","090","0003","0000","542","182","360","10","552","1327","0","41.60","13.72"
"67","000","00","090","0003","0298","542","182","360","10","552","1327","0","41.60","13.72"
"67","000","00","090","0005","0000","692","194","498","12","704","1910","0","36.86","10.16"
"67","000","00","090","0005","0299","336","101","235","6","342","1014","0","33.73","9.96"
"67","000","00","090","0005","0300","356","93","263","6","362","896","0","40.40","10.38"
"67","000","00","090","0006","0000","1257","390","867","17","1274","3299","0","38.62","11.82"
"67","000","00","090","0006","0301","532","152","380","3","535","1369","0","39.08","11.10"
"67","000","00","090","0006","0302","340","113","227","11","351","938","0","37.42","12.05"
"67","000","00","090","0006","0303","385","125","260","3","388","992","0","39.11","12.60"
"67","000","00","090","0007","0000","771","211","560","5","776","2062","0","37.63","10.23"
"67","000","00","090","0007","0304","439","117","322","2","441","1168","0","37.76","10.02"
"67","000","00","090","0007","0305","332","94","238","3","335","894","0","37.47","10.51"
"67","000","00","090","0008","0000","613","209","404","11","624","1583","0","39.42","13.20"
"67","000","00","090","0008","0306","227","74","153","2","229","603","0","37.98","12.27"
"67","000","00","090","0008","0307","386","135","251","9","395","980","0","40.31","13.78"
"67","000","00","090","0009","0000","477","158","319","3","480","1229","0","39.06","12.86"
"67","000","00","090","0009","0308","477","158","319","3","480","1229","0","39.06","12.86"
"67","000","00","090","0010","0000","265","95","170","3","268","583","0","45.97","16.30"
"67","000","00","090","0010","0309","265","95","170","3","268","583","0","45.97","16.30"
"67","000","00","090","0011","0000","196","53","143","0","196","719","0","27.26","7.37"
"67","000","00","090","0011","0310","196","53","143","0","196","719","0","27.26","7.37"
"67","000","00","090","0012","0000","184","55","129","1","185","580","0","31.90","9.48"
"67","000","00","090","0012","0311","184","55","129","1","185","580","0","31.90","9.48"
"67","000","00","100","0000","0000","7626","2148","5478","101","7727","18603","21123","41.54","11.55"
"67","000","00","100","0001","0000","809","255","554","8","817","2045","0","39.95","12.47"
"67","000","00","100","0001","0426","438","158","280","3","441","1070","0","41.21","14.77"
"67","000","00","100","0001","0427","371","97","274","5","376","975","0","38.56","9.95"
"67","000","00","100","0002","0000","1312","292","1020","18","1330","3141","0","42.34","9.30"
"67","000","00","100","0002","0428","443","110","333","5","448","1017","0","44.05","10.82"
"67","000","00","100","0002","0429","393","83","310","8","401","1037","0","38.67","8.00"
"67","000","00","100","0002","0430","476","99","377","5","481","1087","0","44.25","9.11"
"67","000","00","100","0005","0000","144","48","96","2","146","402","0","36.32","11.94"
"67","000","00","100","0005","0433","144","48","96","2","146","402","0","36.32","11.94"
"67","000","00","100","0006","0000","783","290","493","10","793","1948","0","40.71","14.89"
"67","000","00","100","0006","0434","428","153","275","4","432","934","0","46.25","16.38"
"67","000","00","100","0006","0435","355","137","218","6","361","1014","0","35.60","13.51"
"67","000","00","100","0007","0000","1410","544","866","15","1425","3476","0","41.00","15.65"
"67","000","00","100","0007","0436","328","103","225","4","332","923","0","35.97","11.16"
"67","000","00","100","0007","0437","515","202","313","6","521","1208","0","43.13","16.72"
"67","000","00","100","0007","0438","567","239","328","5","572","1345","0","42.53","17.77"
"67","000","00","100","0008","0000","457","125","332","4","461","1243","0","37.09","10.06"
"67","000","00","100","0008","0439","457","125","332","4","461","1243","0","37.09","10.06"
"67","000","00","100","0013","0000","313","67","246","3","316","855","0","36.96","7.84"
"67","000","00","100","0013","0446","313","67","246","3","316","855","0","36.96","7.84"
"67","000","00","100","0014","0000","521","125","396","4","525","1197","0","43.86","10.44"
"67","000","00","100","0014","0431","402","78","324","3","405","928","0","43.64","8.41"
"67","000","00","100","0014","0432","119","47","72","1","120","269","0","44.61","17.47"
"67","000","00","100","0015","0000","1074","311","763","26","1100","2498","0","44.04","12.45"
"67","000","00","100","0015","0442","230","79","151","3","233","497","0","46.88","15.90"
"67","000","00","100","0015","0443","307","91","216","12","319","706","0","45.18","12.89"
"67","000","00","100","0015","0444","334","87","247","6","340","785","0","43.31","11.08"
"67","000","00","100","0015","0445","203","54","149","5","208","510","0","40.78","10.59"
"67","000","00","100","0016","0000","803","91","712","11","814","1798","0","45.27","5.06"
"67","000","00","100","0016","0440","554","64","490","8","562","1215","0","46.26","5.27"
"67","000","00","100","0016","0441","249","27","222","3","252","583","0","43.22","4.63"
"67","000","00","110","0000","0000","3185","940","2245","43","3228","8312","9096","38.84","11.31"
"67","000","00","110","0001","0000","385","121","264","4","389","992","0","39.21","12.20"
"67","000","00","110","0001","0480","292","68","224","3","295","743","0","39.70","9.15"
"67","000","00","110","0001","0481","93","53","40","1","94","249","0","37.75","21.29"
"67","000","00","110","0002","0000","233","54","179","2","235","619","0","37.96","8.72"
"67","000","00","110","0002","0482","233","54","179","2","235","619","0","37.96","8.72"
"67","000","00","110","0003","0000","522","124","398","6","528","1411","0","37.42","8.79"
"67","000","00","110","0003","0483","522","124","398","6","528","1411","0","37.42","8.79"
"67","000","00","110","0004","0000","326","124","202","4","330","885","0","37.29","14.01"
"67","000","00","110","0004","0484","326","124","202","4","330","885","0","37.29","14.01"
"67","000","00","110","0005","0000","349","113","236","7","356","744","0","47.85","15.19"
"67","000","00","110","0005","0485","349","113","236","7","356","744","0","47.85","15.19"
"67","000","00","110","0006","0000","249","70","179","3","252","598","0","42.14","11.71"
"67","000","00","110","0006","0486","249","70","179","3","252","598","0","42.14","11.71"
"67","000","00","110","0007","0000","337","100","237","3","340","969","0","35.09","10.32"
"67","000","00","110","0007","0487","337","100","237","3","340","969","0","35.09","10.32"
"67","000","00","110","0008","0000","235","69","166","6","241","722","0","33.38","9.56"
"67","000","00","110","0008","0488","235","69","166","6","241","722","0","33.38","9.56"
"67","000","00","110","0009","0000","329","118","211","2","331","822","0","40.27","14.36"
"67","000","00","110","0009","0489","329","118","211","2","331","822","0","40.27","14.36"
"67","000","00","110","0010","0000","220","47","173","6","226","550","0","41.09","8.55"
"67","000","00","110","0010","0490","220","47","173","6","226","550","0","41.09","8.55"
"67","000","00","120","0000","0000","19721","6152","13569","151","19872","49901","58600","39.82","12.33"
"67","000","00","120","0001","0000","1001","337","664","6","1007","2192","0","45.94","15.37"
"67","000","00","120","0001","0337","488","155","333","3","491","1081","0","45.42","14.34"
"67","000","00","120","0001","0338","513","182","331","3","516","1111","0","46.44","16.38"
"67","000","00","120","0002","0000","1080","309","771","9","1089","2827","0","38.52","10.93"
"67","000","00","120","0002","0339","554","159","395","5","559","1371","0","40.77","11.60"
"67","000","00","120","0002","0340","526","150","376","4","530","1456","0","36.40","10.30"
"67","000","00","120","0003","0000","2156","668","1488","13","2169","5534","0","39.19","12.07"
"67","000","00","120","0003","0341","434","136","298","0","434","1083","0","40.07","12.56"
"67","000","00","120","0003","0342","423","137","286","2","425","1102","0","38.57","12.43"
"67","000","00","120","0003","0343","407","144","263","5","412","1066","0","38.65","13.51"
"67","000","00","120","0003","0344","431","146","285","1","432","1127","0","38.33","12.95"
"67","000","00","120","0003","0345","461","105","356","5","466","1156","0","40.31","9.08"
"67","000","00","120","0004","0000","1602","535","1067","13","1615","4239","0","38.10","12.62"
"67","000","00","120","0004","0355","406","119","287","2","408","1034","0","39.46","11.51"
"67","000","00","120","0004","0356","381","130","251","4","385","999","0","38.54","13.01"
"67","000","00","120","0004","0357","424","152","272","3","427","1164","0","36.68","13.06"
"67","000","00","120","0004","0358","391","134","257","4","395","1042","0","37.91","12.86"
"67","000","00","120","0005","0000","2274","745","1529","22","2296","5723","0","40.12","13.02"
"67","000","00","120","0005","0346","429","145","284","4","433","1034","0","41.88","14.02"
"67","000","00","120","0005","0347","454","147","307","3","457","1155","0","39.57","12.73"
"67","000","00","120","0005","0348","415","134","281","5","420","1097","0","38.29","12.22"
"67","000","00","120","0005","0349","522","178","344","2","524","1234","0","42.46","14.42"
"67","000","00","120","0005","0350","454","141","313","8","462","1203","0","38.40","11.72"
"67","000","00","120","0006","0000","1574","582","992","16","1590","3989","0","39.86","14.59"
"67","000","00","120","0006","0363","542","177","365","6","548","1367","0","40.09","12.95"
"67","000","00","120","0006","0364","512","190","322","8","520","1338","0","38.86","14.20"
"67","000","00","120","0006","0365","520","215","305","2","522","1284","0","40.65","16.74"
"67","000","00","120","0007","0000","815","239","576","4","819","2115","0","38.72","11.30"
"67","000","00","120","0007","0366","433","138","295","3","436","1146","0","38.05","12.04"
"67","000","00","120","0007","0367","382","101","281","1","383","969","0","39.53","10.42"
"67","000","00","120","0012","0000","769","238","531","12","781","2153","0","36.27","11.05"
"67","000","00","120","0012","0372","421","139","282","4","425","1148","0","37.02","12.11"
"67","000","00","120","0012","0373","348","99","249","8","356","1005","0","35.42","9.85"
"67","000","00","120","0019","0000","663","154","509","4","667","1660","0","40.18","9.28"
"67","000","00","120","0019","0379","513","121","392","1","514","1290","0","39.84","9.38"
"67","000","00","120","0019","0380","150","33","117","3","153","370","0","41.35","8.92"
"67","000","00","120","0020","0000","989","248","741","9","998","2328","0","42.87","10.65"
"67","000","00","120","0020","0381","289","59","230","2","291","677","0","42.98","8.71"
"67","000","00","120","0020","0382","296","89","207","3","299","739","0","40.46","12.04"
"67","000","00","120","0020","0383","404","100","304","4","408","912","0","44.74","10.96"
"67","000","00","120","0022","0000","401","127","274","7","408","1045","0","39.04","12.15"
"67","000","00","120","0022","0370","266","80","186","6","272","689","0","39.48","11.61"
"67","000","00","120","0022","0371","135","47","88","1","136","356","0","38.20","13.20"
"67","000","00","120","0023","0000","2025","751","1274","4","2029","5063","0","40.08","14.83"
"67","000","00","120","0023","0351","467","167","300","0","467","1180","0","39.58","14.15"
"67","000","00","120","0023","0352","532","198","334","3","535","1337","0","40.01","14.81"
"67","000","00","120","0023","0353","511","169","342","0","511","1309","0","39.04","12.91"
"67","000","00","120","0023","0354","515","217","298","1","516","1237","0","41.71","17.54"
"67","000","00","120","0024","0000","897","239","658","11","908","2103","0","43.18","11.36"
"67","000","00","120","0024","0368","469","115","354","8","477","1162","0","41.05","9.90"
"67","000","00","120","0024","0369","428","124","304","3","431","941","0","45.80","13.18"
"67","000","00","120","0025","0000","723","211","512","2","725","1786","0","40.59","11.81"
"67","000","00","120","0025","0374","373","96","277","1","374","856","0","43.69","11.21"
"67","000","00","120","0025","0375","350","115","235","1","351","930","0","37.74","12.37"
"67","000","00","120","0026","0000","1059","241","818","11","1070","2729","0","39.21","8.83"
"67","000","00","120","0026","0376","439","102","337","3","442","1006","0","43.94","10.14"
"67","000","00","120","0026","0377","319","80","239","5","324","944","0","34.32","8.47"
"67","000","00","120","0026","0378","301","59","242","3","304","779","0","39.02","7.57"
"67","000","00","120","0027","0000","1693","528","1165","8","1701","4415","0","38.53","11.96"
"67","000","00","120","0027","0359","382","135","247","1","383","1070","0","35.79","12.62"
"67","000","00","120","0027","0360","403","97","306","4","407","1131","0","35.99","8.58"
"67","000","00","120","0027","0361","362","118","244","1","363","942","0","38.54","12.53"
"67","000","00","120","0027","0362","546","178","368","2","548","1272","0","43.08","13.99"
"67","000","00","130","0000","0000","8643","2423","6220","88","8731","22220","25121","39.29","10.90"
"67","000","00","130","0001","0000","1581","466","1115","17","1598","3771","0","42.38","12.36"
"67","000","00","130","0001","0088","425","118","307","2","427","953","0","44.81","12.38"
"67","000","00","130","0001","0089","464","144","320","3","467","1083","0","43.12","13.30"
"67","000","00","130","0001","0090","376","96","280","3","379","886","0","42.78","10.84"
"67","000","00","130","0001","0091","316","108","208","9","325","849","0","38.28","12.72"
"67","000","00","130","0002","0000","886","240","646","4","890","2308","0","38.56","10.40"
"67","000","00","130","0002","0095","396","92","304","3","399","1064","0","37.50","8.65"
"67","000","00","130","0002","0096","490","148","342","1","491","1244","0","39.47","11.90"
"67","000","00","130","0003","0000","456","105","351","2","458","1207","0","37.95","8.70"
"67","000","00","130","0003","0101","306","66","240","2","308","821","0","37.52","8.04"
"67","000","00","130","0003","0102","150","39","111","0","150","386","0","38.86","10.10"
"67","000","00","130","0004","0000","286","89","197","1","287","771","0","37.22","11.54"
"67","000","00","130","0004","0103","286","89","197","1","287","771","0","37.22","11.54"
"67","000","00","130","0005","0000","776","258","518","6","782","1967","0","39.76","13.12"
"67","000","00","130","0005","0085","281","96","185","2","283","625","0","45.28","15.36"
"67","000","00","130","0005","0086","319","97","222","2","321","924","0","34.74","10.50"
"67","000","00","130","0005","0087","176","65","111","2","178","418","0","42.58","15.55"
"67","000","00","130","0006","0000","955","272","683","11","966","2463","0","39.22","11.04"
"67","000","00","130","0006","0080","310","89","221","3","313","848","0","36.91","10.50"
"67","000","00","130","0006","0081","251","65","186","2","253","663","0","38.16","9.80"
"67","000","00","130","0006","0082","394","118","276","6","400","952","0","42.02","12.39"
"67","000","00","130","0007","0000","778","184","594","6","784","1887","0","41.55","9.75"
"67","000","00","130","0007","0083","417","73","344","4","421","1058","0","39.79","6.90"
"67","000","00","130","0007","0084","361","111","250","2","363","829","0","43.79","13.39"
"67","000","00","130","0008","0000","447","98","349","4","451","1175","0","38.38","8.34"
"67","000","00","130","0008","0098","447","98","349","4","451","1175","0","38.38","8.34"
"67","000","00","130","0009","0000","373","61","312","4","377","1001","0","37.66","6.09"
"67","000","00","130","0009","0104","373","61","312","4","377","1001","0","37.66","6.09"
"67","000","00","130","0010","0000","784","258","526","13","797","2054","0","38.80","12.56"
"67","000","00","130","0010","0092","294","115","179","8","302","712","0","42.42","16.15"
"67","000","00","130","0010","0093","263","91","172","3","266","743","0","35.80","12.25"
"67","000","00","130","0010","0094","227","52","175","2","229","599","0","38.23","8.68"
"67","000","00","130","0011","0000","378","104","274","7","385","939","0","41.00","11.08"
"67","000","00","130","0011","0097","378","104","274","7","385","939","0","41.00","11.08"
"67","000","00","130","0012","0000","476","141","335","7","483","1310","0","36.87","10.76"
"67","000","00","130","0012","0105","201","58","143","3","204","578","0","35.29","10.03"
"67","000","00","130","0012","0106","137","48","89","1","138","405","0","34.07","11.85"
"67","000","00","130","0012","0107","138","35","103","3","141","327","0","43.12","10.70"
"67","000","00","130","0013","0000","467","147","320","6","473","1367","0","34.60","10.75"
"67","000","00","130","0013","0099","278","91","187","4","282","808","0","34.90","11.26"
"67","000","00","130","0013","0100","189","56","133","2","191","559","0","34.17","10.02"
"67","000","00","140","0000","0000","8084","2152","5932","93","8177","21470","24521","38.09","10.02"
"67","000","00","140","0001","0000","1236","350","886","19","1255","3112","0","40.33","11.25"
"67","000","00","140","0001","0516","388","131","257","5","393","920","0","42.72","14.24"
"67","000","00","140","0001","0517","402","104","298","4","406","884","0","45.93","11.76"
"67","000","00","140","0001","0518","446","115","331","10","456","1308","0","34.86","8.79"
"67","000","00","140","0002","0000","983","241","742","8","991","2413","0","41.07","9.99"
"67","000","00","140","0002","0522","691","192","499","7","698","1682","0","41.50","11.41"
"67","000","00","140","0002","0523","292","49","243","1","293","731","0","40.08","6.70"
"67","000","00","140","0003","0000","601","144","457","2","603","1625","0","37.11","8.86"
"67","000","00","140","0003","0524","442","124","318","0","442","1217","0","36.32","10.19"
"67","000","00","140","0003","0525","159","20","139","2","161","408","0","39.46","4.90"
"67","000","00","140","0004","0000","542","143","399","8","550","1640","0","33.54","8.72"
"67","000","00","140","0004","0526","296","75","221","5","301","778","0","38.69","9.64"
"67","000","00","140","0004","0527","246","68","178","3","249","862","0","28.89","7.89"
"67","000","00","140","0005","0000","498","108","390","9","507","1436","0","35.31","7.52"
"67","000","00","140","0005","0528","498","108","390","9","507","1436","0","35.31","7.52"
"67","000","00","140","0006","0000","473","120","353","3","476","1456","0","32.69","8.24"
"67","000","00","140","0006","0529","473","120","353","3","476","1456","0","32.69","8.24"
"67","000","00","140","0007","0000","315","78","237","4","319","758","0","42.08","10.29"
"67","000","00","140","0007","0530","315","78","237","4","319","758","0","42.08","10.29"
"67","000","00","140","0008","0000","494","131","363","7","501","1338","0","37.44","9.79"
"67","000","00","140","0008","0531","494","131","363","7","501","1338","0","37.44","9.79"
"67","000","00","140","0009","0000","556","124","432","5","561","1342","0","41.80","9.24"
"67","000","00","140","0009","0532","556","124","432","5","561","1342","0","41.80","9.24"
"67","000","00","140","0010","0000","539","134","405","4","543","1352","0","40.16","9.91"
"67","000","00","140","0010","0533","340","85","255","3","343","961","0","35.69","8.84"
"67","000","00","140","0010","0534","199","49","150","1","200","391","0","51.15","12.53"
"67","000","00","140","0011","0000","279","101","178","7","286","805","0","35.53","12.55"
"67","000","00","140","0011","0535","279","101","178","7","286","805","0","35.53","12.55"
"67","000","00","140","0012","0000","1568","478","1090","17","1585","4193","0","37.80","11.40"
"67","000","00","140","0012","0519","485","165","320","5","490","1354","0","36.19","12.19"
"67","000","00","140","0012","0520","563","176","387","5","568","1294","0","43.89","13.60"
"67","000","00","140","0012","0521","520","137","383","7","527","1545","0","34.11","8.87"
"67","000","00","150","0000","0000","7060","1834","5226","83","7143","19595","21996","36.45","9.36"
"67","000","00","150","0001","0000","390","93","297","3","393","998","0","39.38","9.32"
"67","000","00","150","0001","0312","187","52","135","2","189","518","0","36.49","10.04"
"67","000","00","150","0001","0313","203","41","162","1","204","480","0","42.50","8.54"
"67","000","00","150","0002","0000","232","48","184","4","236","648","0","36.42","7.41"
"67","000","00","150","0002","0314","232","48","184","4","236","648","0","36.42","7.41"
"67","000","00","150","0004","0000","307","98","209","1","308","820","0","37.56","11.95"
"67","000","00","150","0004","0315","307","98","209","1","308","820","0","37.56","11.95"
"67","000","00","150","0005","0000","305","95","210","6","311","809","0","38.44","11.74"
"67","000","00","150","0005","0316","305","95","210","6","311","809","0","38.44","11.74"
"67","000","00","150","0006","0000","161","41","120","4","165","444","0","37.16","9.23"
"67","000","00","150","0006","0317","161","41","120","4","165","444","0","37.16","9.23"
"67","000","00","150","0007","0000","154","31","123","1","155","410","0","37.80","7.56"
"67","000","00","150","0007","0318","154","31","123","1","155","410","0","37.80","7.56"
"67","000","00","150","0008","0000","608","111","497","8","616","1608","0","38.31","6.90"
"67","000","00","150","0008","0320","314","68","246","6","320","832","0","38.46","8.17"
"67","000","00","150","0008","0321","294","43","251","2","296","776","0","38.14","5.54"
"67","000","00","150","0009","0000","128","45","83","1","129","343","0","37.61","13.12"
"67","000","00","150","0009","0322","128","45","83","1","129","343","0","37.61","13.12"
"67","000","00","150","0010","0000","346","77","269","1","347","861","0","40.30","8.94"
"67","000","00","150","0010","0323","346","77","269","1","347","861","0","40.30","8.94"
"67","000","00","150","0011","0000","276","76","200","5","281","775","0","36.26","9.81"
"67","000","00","150","0011","0324","276","76","200","5","281","775","0","36.26","9.81"
"67","000","00","150","0012","0000","881","216","665","11","892","2548","0","35.01","8.48"
"67","000","00","150","0012","0325","266","73","193","7","273","856","0","31.89","8.53"
"67","000","00","150","0012","0326","287","70","217","2","289","811","0","35.64","8.63"
"67","000","00","150","0012","0327","328","73","255","2","330","881","0","37.46","8.29"
"67","000","00","150","0015","0000","626","138","488","9","635","1894","0","33.53","7.29"
"67","000","00","150","0015","0328","395","82","313","2","397","1185","0","33.50","6.92"
"67","000","00","150","0015","0329","231","56","175","7","238","709","0","33.57","7.90"
"67","000","00","150","0017","0000","236","60","176","3","239","683","0","34.99","8.78"
"67","000","00","150","0017","0319","236","60","176","3","239","683","0","34.99","8.78"
"67","000","00","150","0018","0000","482","129","353","8","490","1214","0","40.36","10.63"
"67","000","00","150","0018","0330","237","62","175","6","243","605","0","40.17","10.25"
"67","000","00","150","0018","0331","245","67","178","2","247","609","0","40.56","11.00"
"67","000","00","150","0019","0000","709","196","513","8","717","1858","0","38.59","10.55"
"67","000","00","150","0019","0332","427","126","301","4","431","1170","0","36.84","10.77"
"67","000","00","150","0019","0333","282","70","212","4","286","688","0","41.57","10.17"
"67","000","00","150","0021","0000","347","124","223","1","348","992","0","35.08","12.50"
"67","000","00","150","0021","0334","347","124","223","1","348","992","0","35.08","12.50"
"67","000","00","150","0022","0000","443","116","327","3","446","1329","0","33.56","8.73"
"67","000","00","150","0022","0335","443","116","327","3","446","1329","0","33.56","8.73"
"67","000","00","150","0023","0000","429","140","289","6","435","1361","0","31.96","10.29"
"67","000","00","150","0023","0336","429","140","289","6","435","1361","0","31.96","10.29"
"67","000","00","160","0000","0000","6214","1533","4681","76","6290","17313","18966","36.33","8.85"
"67","000","00","160","0001","0000","436","119","317","3","439","1136","0","38.64","10.48"
"67","000","00","160","0001","0246","436","119","317","3","439","1136","0","38.64","10.48"
"67","000","00","160","0013","0000","259","48","211","4","263","821","0","32.03","5.85"
"67","000","00","160","0013","0262","259","48","211","4","263","821","0","32.03","5.85"
"67","000","00","160","0014","0000","182","62","120","5","187","636","0","29.40","9.75"
"67","000","00","160","0014","0263","182","62","120","5","187","636","0","29.40","9.75"
"67","000","00","160","0015","0000","447","100","347","7","454","1312","0","34.60","7.62"
"67","000","00","160","0015","0264","263","53","210","4","267","673","0","39.67","7.88"
"67","000","00","160","0015","0265","184","47","137","3","187","639","0","29.26","7.36"
"67","000","00","160","0016","0000","424","81","343","11","435","1171","0","37.15","6.92"
"67","000","00","160","0016","0266","424","81","343","11","435","1171","0","37.15","6.92"
"67","000","00","160","0017","0000","654","128","526","8","662","1862","0","35.55","6.87"
"67","000","00","160","0017","0267","236","41","195","3","239","800","0","29.88","5.13"
"67","000","00","160","0017","0268","418","87","331","5","423","1062","0","39.83","8.19"
"67","000","00","160","0018","0000","275","57","218","3","278","946","0","29.39","6.03"
"67","000","00","160","0018","0269","275","57","218","3","278","946","0","29.39","6.03"
"67","000","00","160","0019","0000","469","90","379","4","473","1166","0","40.57","7.72"
"67","000","00","160","0019","0257","259","51","208","4","263","614","0","42.83","8.31"
"67","000","00","160","0019","0258","210","39","171","0","210","552","0","38.04","7.07"
"67","000","00","160","0020","0000","914","256","658","6","920","2358","0","39.02","10.86"
"67","000","00","160","0020","0247","560","163","397","4","564","1453","0","38.82","11.22"
"67","000","00","160","0020","0248","354","93","261","2","356","905","0","39.34","10.28"
"67","000","00","160","0021","0000","848","245","603","13","861","2413","0","35.68","10.15"
"67","000","00","160","0021","0249","205","65","140","3","208","490","0","42.45","13.27"
"67","000","00","160","0021","0250","350","94","256","3","353","1065","0","33.15","8.83"
"67","000","00","160","0021","0251","167","43","124","7","174","516","0","33.72","8.33"
"67","000","00","160","0021","0252","126","43","83","0","126","342","0","36.84","12.57"
"67","000","00","160","0022","0000","759","196","563","9","768","1964","0","39.10","9.98"
"67","000","00","160","0022","0253","203","57","146","2","205","556","0","36.87","10.25"
"67","000","00","160","0022","0254","159","35","124","2","161","395","0","40.76","8.86"
"67","000","00","160","0022","0255","216","57","159","4","220","560","0","39.29","10.18"
"67","000","00","160","0022","0256","181","47","134","1","182","453","0","40.18","10.38"
"67","000","00","160","0023","0000","547","151","396","3","550","1528","0","35.99","9.88"
"67","000","00","160","0023","0259","193","45","148","2","195","569","0","34.27","7.91"
"67","000","00","160","0023","0260","197","62","135","1","198","543","0","36.46","11.42"
"67","000","00","160","0023","0261","157","44","113","0","157","416","0","37.74","10.58"
"67","000","00","170","0000","0000","3029","990","2039","37","3066","9549","10460","32.11","10.37"
"67","000","00","170","0001","0000","383","137","246","6","389","1309","0","29.72","10.47"
"67","000","00","170","0001","0068","215","70","145","3","218","711","0","30.66","9.85"
"67","000","00","170","0001","0069","168","67","101","3","171","598","0","28.60","11.20"
"67","000","00","170","0002","0000","146","46","100","3","149","451","0","33.04","10.20"
"67","000","00","170","0002","0073","146","46","100","3","149","451","0","33.04","10.20"
"67","000","00","170","0005","0000","270","105","165","2","272","820","0","33.17","12.80"
"67","000","00","170","0005","0064","168","72","96","0","168","454","0","37.00","15.86"
"67","000","00","170","0005","0065","102","33","69","2","104","366","0","28.42","9.02"
"67","000","00","170","0006","0000","248","87","161","3","251","909","0","27.61","9.57"
"67","000","00","170","0006","0074","248","87","161","3","251","909","0","27.61","9.57"
"67","000","00","170","0007","0000","397","142","255","3","400","1152","0","34.72","12.33"
"67","000","00","170","0007","0076","207","63","144","1","208","647","0","32.15","9.74"
"67","000","00","170","0007","0077","190","79","111","2","192","505","0","38.02","15.64"
"67","000","00","170","0009","0000","243","62","181","4","247","702","0","35.19","8.83"
"67","000","00","170","0009","0066","133","36","97","3","136","344","0","39.53","10.47"
"67","000","00","170","0009","0067","110","26","84","1","111","358","0","31.01","7.26"
"67","000","00","170","0011","0000","200","63","137","1","201","726","0","27.69","8.68"
"67","000","00","170","0011","0075","200","63","137","1","201","726","0","27.69","8.68"
"67","000","00","170","0013","0000","280","104","176","5","285","843","0","33.81","12.34"
"67","000","00","170","0013","0062","163","46","117","1","164","454","0","36.12","10.13"
"67","000","00","170","0013","0063","117","58","59","4","121","389","0","31.11","14.91"
"67","000","00","170","0014","0000","429","132","297","3","432","1415","0","30.53","9.33"
"67","000","00","170","0014","0070","156","47","109","0","156","567","0","27.51","8.29"
"67","000","00","170","0014","0071","176","69","107","2","178","539","0","33.02","12.80"
"67","000","00","170","0014","0072","97","16","81","1","98","309","0","31.72","5.18"
"67","000","00","170","0015","0000","433","112","321","7","440","1222","0","36.01","9.17"
"67","000","00","170","0015","0078","202","42","160","4","206","606","0","33.99","6.93"
"67","000","00","170","0015","0079","231","70","161","3","234","616","0","37.99","11.36"
"67","000","00","180","0000","0000","14696","5390","9306","171","14867","37315","43049","39.84","14.44"
"67","000","00","180","0001","0000","1350","553","797","13","1363","3038","0","44.87","18.20"
"67","000","00","180","0001","1020","331","161","170","3","334","722","0","46.26","22.30"
"67","000","00","180","0001","1021","464","177","287","5","469","1094","0","42.87","16.18"
"67","000","00","180","0001","1022","174","68","106","1","175","334","0","52.40","20.36"
"67","000","00","180","0001","1023","381","147","234","4","385","888","0","43.36","16.55"
"67","000","00","180","0002","0000","1576","609","967","18","1594","3973","0","40.12","15.33"
"67","000","00","180","0002","1024","483","211","272","6","489","1178","0","41.51","17.91"
"67","000","00","180","0002","1025","329","96","233","3","332","822","0","40.39","11.68"
"67","000","00","180","0002","1026","356","130","226","4","360","921","0","39.09","14.12"
"67","000","00","180","0002","1027","408","172","236","5","413","1052","0","39.26","16.35"
"67","000","00","180","0003","0000","1080","419","661","9","1089","2724","0","39.98","15.38"
"67","000","00","180","0003","1028","412","139","273","2","414","912","0","45.39","15.24"
"67","000","00","180","0003","1029","318","148","170","5","323","810","0","39.88","18.27"
"67","000","00","180","0003","1030","350","132","218","2","352","1002","0","35.13","13.17"
"67","000","00","180","0004","0000","1833","662","1171","16","1849","4411","0","41.92","15.01"
"67","000","00","180","0004","1031","565","199","366","10","575","1338","0","42.97","14.87"
"67","000","00","180","0004","1032","404","159","245","1","405","1025","0","39.51","15.51"
"67","000","00","180","0004","1033","492","169","323","2","494","1256","0","39.33","13.46"
"67","000","00","180","0004","1034","372","135","237","3","375","792","0","47.35","17.05"
"67","000","00","180","0009","0000","1284","492","792","16","1300","3203","0","40.59","15.36"
"67","000","00","180","0009","1035","380","115","265","6","386","984","0","39.23","11.69"
"67","000","00","180","0009","1036","386","168","218","3","389","991","0","39.25","16.95"
"67","000","00","180","0009","1037","518","209","309","7","525","1228","0","42.75","17.02"
"67","000","00","180","0010","0000","851","282","569","10","861","2153","0","39.99","13.10"
"67","000","00","180","0010","1038","476","190","286","5","481","1160","0","41.47","16.38"
"67","000","00","180","0010","1039","375","92","283","5","380","993","0","38.27","9.26"
"67","000","00","180","0011","0000","559","189","370","7","566","1482","0","38.19","12.75"
"67","000","00","180","0011","1040","559","189","370","7","566","1482","0","38.19","12.75"
"67","000","00","180","0012","0000","1203","478","725","17","1220","3226","0","37.82","14.82"
"67","000","00","180","0012","1041","454","170","284","7","461","1224","0","37.66","13.89"
"67","000","00","180","0012","1042","437","193","244","4","441","1245","0","35.42","15.50"
"67","000","00","180","0012","1043","312","115","197","6","318","757","0","42.01","15.19"
"67","000","00","180","0013","0000","1090","468","622","15","1105","2804","0","39.41","16.69"
"67","000","00","180","0013","1044","462","184","278","8","470","1366","0","34.41","13.47"
"67","000","00","180","0013","1045","628","284","344","7","635","1438","0","44.16","19.75"
"67","000","00","180","0014","0000","845","250","595","13","858","2123","0","40.41","11.78"
"67","000","00","180","0014","1046","389","111","278","6","395","1011","0","39.07","10.98"
"67","000","00","180","0014","1047","456","139","317","7","463","1112","0","41.64","12.50"
"67","000","00","180","0015","0000","833","295","538","9","842","2155","0","39.07","13.69"
"67","000","00","180","0015","1048","476","156","320","5","481","1177","0","40.87","13.25"
"67","000","00","180","0015","1049","357","139","218","4","361","978","0","36.91","14.21"
"67","000","00","180","0016","0000","567","181","386","5","572","1679","0","34.07","10.78"
"67","000","00","180","0016","1050","338","95","243","4","342","962","0","35.55","9.88"
"67","000","00","180","0016","1051","229","86","143","1","230","717","0","32.08","11.99"
"67","000","00","180","0017","0000","160","36","124","2","162","425","0","38.12","8.47"
"67","000","00","180","0017","1052","160","36","124","2","162","425","0","38.12","8.47"
"67","000","00","180","0018","0000","736","278","458","9","745","2087","0","35.70","13.32"
"67","000","00","180","0018","1053","358","136","222","1","359","1051","0","34.16","12.94"
"67","000","00","180","0018","1054","378","142","236","8","386","1036","0","37.26","13.71"
"67","000","00","180","0019","0000","354","133","221","3","357","899","0","39.71","14.79"
"67","000","00","180","0019","1055","354","133","221","3","357","899","0","39.71","14.79"
"67","000","00","180","0020","0000","375","65","310","9","384","933","0","41.16","6.97"
"67","000","00","180","0020","1056","375","65","310","9","384","933","0","41.16","6.97"
"67","000","00","190","0000","0000","16691","5553","11138","163","16854","41406","51052","40.70","13.41"
"67","000","00","190","0001","0000","436","171","265","8","444","1123","0","39.54","15.23"
"67","000","00","190","0001","0447","436","171","265","8","444","1123","0","39.54","15.23"
"67","000","00","190","0002","0000","1560","638","922","15","1575","3901","0","40.37","16.35"
"67","000","00","190","0002","0448","606","290","316","5","611","1398","0","43.71","20.74"
"67","000","00","190","0002","0449","495","184","311","5","500","1169","0","42.77","15.74"
"67","000","00","190","0002","0450","459","164","295","5","464","1334","0","34.78","12.29"
"67","000","00","190","0003","0000","2207","851","1356","23","2230","5414","0","41.19","15.72"
"67","000","00","190","0003","0451","571","220","351","3","574","1342","0","42.77","16.39"
"67","000","00","190","0003","0452","593","224","369","8","601","1363","0","44.09","16.43"
"67","000","00","190","0003","0453","580","228","352","8","588","1496","0","39.30","15.24"
"67","000","00","190","0003","0454","463","179","284","4","467","1213","0","38.50","14.76"
"67","000","00","190","0004","0000","1017","354","663","5","1022","2685","0","38.06","13.18"
"67","000","00","190","0004","0455","586","208","378","2","588","1531","0","38.41","13.59"
"67","000","00","190","0004","0456","431","146","285","3","434","1154","0","37.61","12.65"
"67","000","00","190","0005","0000","733","225","508","7","740","1791","0","41.32","12.56"
"67","000","00","190","0005","0457","376","111","265","5","381","946","0","40.27","11.73"
"67","000","00","190","0005","0458","357","114","243","2","359","845","0","42.49","13.49"
"67","000","00","190","0008","0000","629","200","429","4","633","1601","0","39.54","12.49"
"67","000","00","190","0008","0460","629","200","429","4","633","1601","0","39.54","12.49"
"67","000","00","190","0009","0000","530","105","425","7","537","1235","0","43.48","8.50"
"67","000","00","190","0009","0461","530","105","425","7","537","1235","0","43.48","8.50"
"67","000","00","190","0010","0000","838","244","594","13","851","2010","0","42.34","12.14"
"67","000","00","190","0010","0462","447","118","329","7","454","1063","0","42.71","11.10"
"67","000","00","190","0010","0463","391","126","265","6","397","947","0","41.92","13.31"
"67","000","00","190","0011","0000","493","145","348","5","498","1226","0","40.62","11.83"
"67","000","00","190","0011","0464","493","145","348","5","498","1226","0","40.62","11.83"
"67","000","00","190","0012","0000","839","278","561","10","849","1944","0","43.67","14.30"
"67","000","00","190","0012","0465","439","146","293","3","442","1018","0","43.42","14.34"
"67","000","00","190","0012","0466","400","132","268","7","407","926","0","43.95","14.25"
"67","000","00","190","0013","0000","283","64","219","3","286","677","0","42.25","9.45"
"67","000","00","190","0013","0467","283","64","219","3","286","677","0","42.25","9.45"
"67","000","00","190","0014","0000","392","90","302","5","397","1041","0","38.14","8.65"
"67","000","00","190","0014","0468","392","90","302","5","397","1041","0","38.14","8.65"
"67","000","00","190","0015","0000","674","192","482","6","680","1684","0","40.38","11.40"
"67","000","00","190","0015","0469","674","192","482","6","680","1684","0","40.38","11.40"
"67","000","00","190","0018","0000","679","220","459","11","690","1608","0","42.91","13.68"
"67","000","00","190","0018","0472","679","220","459","11","690","1608","0","42.91","13.68"
"67","000","00","190","0019","0000","636","185","451","11","647","1587","0","40.77","11.66"
"67","000","00","190","0019","0473","636","185","451","11","647","1587","0","40.77","11.66"
"67","000","00","190","0020","0000","427","107","320","3","430","1068","0","40.26","10.02"
"67","000","00","190","0020","0474","427","107","320","3","430","1068","0","40.26","10.02"
"67","000","00","190","0021","0000","1682","590","1092","13","1695","4425","0","38.31","13.33"
"67","000","00","190","0021","0475","591","185","406","4","595","1414","0","42.08","13.08"
"67","000","00","190","0021","0476","556","196","360","5","561","1410","0","39.79","13.90"
"67","000","00","190","0021","0477","535","209","326","4","539","1601","0","33.67","13.05"
"67","000","00","190","0022","0000","484","186","298","0","484","1117","0","43.33","16.65"
"67","000","00","190","0022","0459","484","186","298","0","484","1117","0","43.33","16.65"
"67","000","00","190","0023","0000","781","210","571","9","790","1945","0","40.62","10.80"
"67","000","00","190","0023","0470","449","114","335","5","454","1083","0","41.92","10.53"
"67","000","00","190","0023","0471","332","96","236","4","336","862","0","38.98","11.14"
"67","000","00","190","0024","0000","1371","498","873","5","1376","3324","0","41.40","14.98"
"67","000","00","190","0024","0478","746","290","456","4","750","1824","0","41.12","15.90"
"67","000","00","190","0024","0479","625","208","417","1","626","1500","0","41.73","13.87"
"67","000","00","200","0000","0000","12208","3973","8235","99","12307","31369","37721","39.23","12.67"
"67","000","00","200","0001","0000","1143","399","744","10","1153","2990","0","38.56","13.34"
"67","000","00","200","0001","0829","360","132","228","0","360","964","0","37.34","13.69"
"67","000","00","200","0001","0830","455","154","301","7","462","1090","0","42.39","14.13"
"67","000","00","200","0001","0831","328","113","215","3","331","936","0","35.36","12.07"
"67","000","00","200","0002","0000","2653","950","1703","24","2677","6488","0","41.26","14.64"
"67","000","00","200","0002","0832","514","158","356","5","519","1253","0","41.42","12.61"
"67","000","00","200","0002","0833","544","197","347","1","545","1258","0","43.32","15.66"
"67","000","00","200","0002","0834","428","176","252","5","433","1056","0","41.00","16.67"
"67","000","00","200","0002","0835","446","168","278","4","450","1082","0","41.59","15.53"
"67","000","00","200","0002","0836","421","149","272","7","428","976","0","43.85","15.27"
"67","000","00","200","0002","0837","300","102","198","2","302","863","0","34.99","11.82"
"67","000","00","200","0003","0000","1115","322","793","5","1120","2768","0","40.46","11.63"
"67","000","00","200","0003","0838","392","111","281","3","395","932","0","42.38","11.91"
"67","000","00","200","0003","0839","401","140","261","2","403","1038","0","38.82","13.49"
"67","000","00","200","0003","0840","322","71","251","0","322","798","0","40.35","8.90"
"67","000","00","200","0004","0000","312","87","225","6","318","714","0","44.54","12.18"
"67","000","00","200","0004","0841","312","87","225","6","318","714","0","44.54","12.18"
"67","000","00","200","0005","0000","316","90","226","4","320","870","0","36.78","10.34"
"67","000","00","200","0005","0842","316","90","226","4","320","870","0","36.78","10.34"
"67","000","00","200","0006","0000","608","178","430","5","613","1563","0","39.22","11.39"
"67","000","00","200","0006","0843","340","94","246","3","343","910","0","37.69","10.33"
"67","000","00","200","0006","0844","268","84","184","2","270","653","0","41.35","12.86"
"67","000","00","200","0007","0000","1253","472","781","7","1260","3380","0","37.28","13.96"
"67","000","00","200","0007","0845","388","164","224","4","392","1124","0","34.88","14.59"
"67","000","00","200","0007","0846","445","166","279","2","447","1131","0","39.52","14.68"
"67","000","00","200","0007","0847","420","142","278","1","421","1125","0","37.42","12.62"
"67","000","00","200","0008","0000","1727","472","1255","13","1740","4530","0","38.41","10.42"
"67","000","00","200","0008","0848","447","151","296","4","451","1195","0","37.74","12.64"
"67","000","00","200","0008","0849","367","99","268","5","372","1048","0","35.50","9.45"
"67","000","00","200","0008","0850","475","130","345","2","477","1237","0","38.56","10.51"
"67","000","00","200","0008","0851","438","92","346","2","440","1050","0","41.90","8.76"
"67","000","00","200","0009","0000","675","203","472","7","682","1790","0","38.10","11.34"
"67","000","00","200","0009","0852","324","96","228","3","327","866","0","37.76","11.09"
"67","000","00","200","0009","0853","351","107","244","4","355","924","0","38.42","11.58"
"67","000","00","200","0010","0000","1169","358","811","11","1180","3330","0","35.44","10.75"
"67","000","00","200","0010","0854","293","123","170","5","298","913","0","32.64","13.47"
"67","000","00","200","0010","0855","435","107","328","3","438","1239","0","35.35","8.64"
"67","000","00","200","0010","0856","441","128","313","3","444","1178","0","37.69","10.87"
"67","000","00","200","0011","0000","1237","442","795","7","1244","2946","0","42.23","15.00"
"67","000","00","200","0011","0857","300","102","198","2","302","700","0","43.14","14.57"
"67","000","00","200","0011","0858","425","152","273","2","427","1056","0","40.44","14.39"
"67","000","00","200","0011","0859","512","188","324","3","515","1190","0","43.28","15.80"
"67","000","00","210","0000","0000","10655","3166","7489","115","10770","26163","30286","41.17","12.10"
"67","000","00","210","0001","0000","904","245","659","20","924","2065","0","44.75","11.86"
"67","000","00","210","0001","0536","543","160","383","11","554","1207","0","45.90","13.26"
"67","000","00","210","0001","0537","361","85","276","9","370","858","0","43.12","9.91"
"67","000","00","210","0002","0000","776","250","526","9","785","2038","0","38.52","12.27"
"67","000","00","210","0002","0538","420","153","267","5","425","1143","0","37.18","13.39"
"67","000","00","210","0002","0539","356","97","259","4","360","895","0","40.22","10.84"
"67","000","00","210","0003","0000","567","167","400","3","570","1381","0","41.27","12.09"
"67","000","00","210","0003","0540","252","76","176","1","253","653","0","38.74","11.64"
"67","000","00","210","0003","0541","315","91","224","2","317","728","0","43.54","12.50"
"67","000","00","210","0004","0000","892","276","616","10","902","2194","0","41.11","12.58"
"67","000","00","210","0004","0542","444","120","324","5","449","1112","0","40.38","10.79"
"67","000","00","210","0004","0543","448","156","292","5","453","1082","0","41.87","14.42"
"67","000","00","210","0006","0000","588","168","420","4","592","1485","0","39.87","11.31"
"67","000","00","210","0006","0544","276","69","207","3","279","726","0","38.43","9.50"
"67","000","00","210","0006","0545","312","99","213","1","313","759","0","41.24","13.04"
"67","000","00","210","0007","0000","718","222","496","7","725","1715","0","42.27","12.94"
"67","000","00","210","0007","0546","344","110","234","2","346","823","0","42.04","13.37"
"67","000","00","210","0007","0547","374","112","262","5","379","892","0","42.49","12.56"
"67","000","00","210","0008","0000","1190","382","808","11","1201","2901","0","41.40","13.17"
"67","000","00","210","0008","0548","485","175","310","4","489","1122","0","43.58","15.60"
"67","000","00","210","0008","0549","417","116","301","4","421","977","0","43.09","11.87"
"67","000","00","210","0008","0550","288","91","197","3","291","802","0","36.28","11.35"
"67","000","00","210","0009","0000","1092","318","774","11","1103","2658","0","41.50","11.96"
"67","000","00","210","0009","0551","530","136","394","6","536","1348","0","39.76","10.09"
"67","000","00","210","0009","0552","562","182","380","5","567","1310","0","43.28","13.89"
"67","000","00","210","0012","0000","315","101","214","2","317","715","0","44.34","14.13"
"67","000","00","210","0012","0555","315","101","214","2","317","715","0","44.34","14.13"
"67","000","00","210","0013","0000","975","278","697","9","984","2448","0","40.20","11.36"
"67","000","00","210","0013","0556","479","146","333","2","481","1260","0","38.17","11.59"
"67","000","00","210","0013","0557","496","132","364","7","503","1188","0","42.34","11.11"
"67","000","00","210","0014","0000","1036","318","718","10","1046","2574","0","40.64","12.35"
"67","000","00","210","0014","0558","510","139","371","6","516","1180","0","43.73","11.78"
"67","000","00","210","0014","0559","526","179","347","4","530","1394","0","38.02","12.84"
"67","000","00","210","0017","0000","680","175","505","4","684","1609","0","42.51","10.88"
"67","000","00","210","0017","0560","406","103","303","1","407","998","0","40.78","10.32"
"67","000","00","210","0017","0561","274","72","202","3","277","611","0","45.34","11.78"
"67","000","00","210","0018","0000","922","266","656","15","937","2380","0","39.37","11.18"
"67","000","00","210","0018","0553","482","122","360","10","492","1168","0","42.12","10.45"
"67","000","00","210","0018","0554","440","144","296","5","445","1212","0","36.72","11.88"
"67","000","00","220","0000","0000","2311","810","1501","37","2348","6378","7053","36.81","12.70"
"67","000","00","220","0001","0000","573","210","363","7","580","1662","0","34.90","12.64"
"67","000","00","220","0001","0562","284","104","180","5","289","848","0","34.08","12.26"
"67","000","00","220","0001","0563","289","106","183","2","291","814","0","35.75","13.02"
"67","000","00","220","0002","0000","642","214","428","9","651","1522","0","42.77","14.06"
"67","000","00","220","0002","0564","320","113","207","5","325","740","0","43.92","15.27"
"67","000","00","220","0002","0565","322","101","221","4","326","782","0","41.69","12.92"
"67","000","00","220","0003","0000","340","128","212","7","347","961","0","36.11","13.32"
"67","000","00","220","0003","0566","340","128","212","7","347","961","0","36.11","13.32"
"67","000","00","220","0004","0000","302","81","221","5","307","930","0","33.01","8.71"
"67","000","00","220","0004","0567","302","81","221","5","307","930","0","33.01","8.71"
"67","000","00","220","0005","0000","198","66","132","1","199","560","0","35.54","11.79"
"67","000","00","220","0005","0568","198","66","132","1","199","560","0","35.54","11.79"
"67","000","00","220","0006","0000","137","69","68","1","138","351","0","39.32","19.66"
"67","000","00","220","0006","0569","137","69","68","1","138","351","0","39.32","19.66"
"67","000","00","220","0007","0000","119","42","77","7","126","392","0","32.14","10.71"
"67","000","00","220","0007","0570","119","42","77","7","126","392","0","32.14","10.71"
"67","000","00","230","0000","0000","4354","2023","2331","66","4420","12025","13483","36.76","16.82"
"67","000","00","230","0001","0000","447","235","212","6","453","1202","0","37.69","19.55"
"67","000","00","230","0001","0491","447","235","212","6","453","1202","0","37.69","19.55"
"67","000","00","230","0002","0000","1266","661","605","14","1280","3556","0","36.00","18.59"
"67","000","00","230","0002","0492","340","191","149","3","343","960","0","35.73","19.90"
"67","000","00","230","0002","0493","289","140","149","4","293","811","0","36.13","17.26"
"67","000","00","230","0002","0494","280","133","147","3","283","822","0","34.43","16.18"
"67","000","00","230","0002","0495","357","197","160","4","361","963","0","37.49","20.46"
"67","000","00","230","0003","0000","485","207","278","6","491","1198","0","40.98","17.28"
"67","000","00","230","0003","0496","226","107","119","3","229","590","0","38.81","18.14"
"67","000","00","230","0003","0497","259","100","159","3","262","608","0","43.09","16.45"
"67","000","00","230","0004","0000","478","214","264","8","486","1398","0","34.76","15.31"
"67","000","00","230","0004","0498","311","140","171","5","316","899","0","35.15","15.57"
"67","000","00","230","0004","0499","167","74","93","3","170","499","0","34.07","14.83"
"67","000","00","230","0005","0000","196","92","104","8","204","497","0","41.05","18.51"
"67","000","00","230","0005","0500","196","92","104","8","204","497","0","41.05","18.51"
"67","000","00","230","0006","0000","176","60","116","1","177","490","0","36.12","12.24"
"67","000","00","230","0006","0501","176","60","116","1","177","490","0","36.12","12.24"
"67","000","00","230","0007","0000","290","115","175","5","295","731","0","40.36","15.73"
"67","000","00","230","0007","0502","290","115","175","5","295","731","0","40.36","15.73"
"67","000","00","230","0008","0000","497","222","275","4","501","1428","0","35.08","15.55"
"67","000","00","230","0008","0503","270","145","125","3","273","651","0","41.94","22.27"
"67","000","00","230","0008","0504","227","77","150","1","228","777","0","29.34","9.91"
"67","000","00","230","0009","0000","205","76","129","3","208","580","0","35.86","13.10"
"67","000","00","230","0009","0505","205","76","129","3","208","580","0","35.86","13.10"
"67","000","00","230","0010","0000","314","141","173","11","325","945","0","34.39","14.92"
"67","000","00","230","0010","0506","314","141","173","11","325","945","0","34.39","14.92"
"67","000","00","240","0000","0000","2629","1323","1306","36","2665","8230","9115","32.38","16.08"
"67","000","00","240","0001","0000","583","324","259","11","594","1779","0","33.39","18.21"
"67","000","00","240","0001","0507","315","174","141","5","320","950","0","33.68","18.32"
"67","000","00","240","0001","0508","268","150","118","6","274","829","0","33.05","18.09"
"67","000","00","240","0002","0000","292","130","162","2","294","1071","0","27.45","12.14"
"67","000","00","240","0002","0509","292","130","162","2","294","1071","0","27.45","12.14"
"67","000","00","240","0003","0000","202","106","96","2","204","681","0","29.96","15.57"
"67","000","00","240","0003","0510","202","106","96","2","204","681","0","29.96","15.57"
"67","000","00","240","0004","0000","305","128","177","3","308","951","0","32.39","13.46"
"67","000","00","240","0004","0511","305","128","177","3","308","951","0","32.39","13.46"
"67","000","00","240","0005","0000","315","183","132","2","317","894","0","35.46","20.47"
"67","000","00","240","0005","0512","315","183","132","2","317","894","0","35.46","20.47"
"67","000","00","240","0006","0000","205","94","111","3","208","639","0","32.55","14.71"
"67","000","00","240","0006","0513","205","94","111","3","208","639","0","32.55","14.71"
"67","000","00","240","0007","0000","727","358","369","13","740","2215","0","33.41","16.16"
"67","000","00","240","0007","0514","383","179","204","11","394","1176","0","33.50","15.22"
"67","000","00","240","0007","0515","344","179","165","2","346","1039","0","33.30","17.23"
"67","000","00","250","0000","0000","2300","1047","1253","23","2323","7508","8305","30.94","13.95"
"67","000","00","250","0001","0000","541","219","322","5","546","1343","0","40.66","16.31"
"67","000","00","250","0001","0581","258","109","149","2","260","664","0","39.16","16.42"
"67","000","00","250","0001","0582","283","110","173","3","286","679","0","42.12","16.20"
"67","000","00","250","0002","0000","216","91","125","3","219","764","0","28.66","11.91"
"67","000","00","250","0002","0583","216","91","125","3","219","764","0","28.66","11.91"
"67","000","00","250","0003","0000","117","57","60","2","119","404","0","29.46","14.11"
"67","000","00","250","0003","0586","117","57","60","2","119","404","0","29.46","14.11"
"67","000","00","250","0004","0000","200","77","123","5","205","547","0","37.48","14.08"
"67","000","00","250","0004","0587","200","77","123","5","205","547","0","37.48","14.08"
"67","000","00","250","0005","0000","177","77","100","0","177","620","0","28.55","12.42"
"67","000","00","250","0005","0584","177","77","100","0","177","620","0","28.55","12.42"
"67","000","00","250","0006","0000","210","101","109","1","211","725","0","29.10","13.93"
"67","000","00","250","0006","0585","210","101","109","1","211","725","0","29.10","13.93"
"67","000","00","250","0007","0000","347","171","176","0","347","1130","0","30.71","15.13"
"67","000","00","250","0007","0588","347","171","176","0","347","1130","0","30.71","15.13"
"67","000","00","250","0008","0000","309","148","161","5","314","1027","0","30.57","14.41"
"67","000","00","250","0008","0589","309","148","161","5","314","1027","0","30.57","14.41"
"67","000","00","250","0009","0000","183","106","77","2","185","948","0","19.51","11.18"
"67","000","00","250","0009","0590","183","106","77","2","185","948","0","19.51","11.18"
"67","000","00","260","0000","0000","1500","529","971","22","1522","4192","4475","36.31","12.62"
"67","000","00","260","0001","0000","125","51","74","1","126","359","0","35.10","14.21"
"67","000","00","260","0001","0571","125","51","74","1","126","359","0","35.10","14.21"
"67","000","00","260","0002","0000","228","72","156","3","231","612","0","37.75","11.76"
"67","000","00","260","0002","0572","228","72","156","3","231","612","0","37.75","11.76"
"67","000","00","260","0003","0000","157","51","106","5","162","456","0","35.53","11.18"
"67","000","00","260","0003","0573","157","51","106","5","162","456","0","35.53","11.18"
"67","000","00","260","0004","0000","234","111","123","2","236","717","0","32.91","15.48"
"67","000","00","260","0004","0574","234","111","123","2","236","717","0","32.91","15.48"
"67","000","00","260","0005","0000","120","52","68","1","121","333","0","36.34","15.62"
"67","000","00","260","0005","0575","120","52","68","1","121","333","0","36.34","15.62"
"67","000","00","260","0006","0000","147","62","85","4","151","355","0","42.54","17.46"
"67","000","00","260","0006","0576","147","62","85","4","151","355","0","42.54","17.46"
"67","000","00","260","0007","0000","168","37","131","2","170","488","0","34.84","7.58"
"67","000","00","260","0007","0580","168","37","131","2","170","488","0","34.84","7.58"
"67","000","00","260","0008","0000","137","40","97","0","137","407","0","33.66","9.83"
"67","000","00","260","0008","0577","137","40","97","0","137","407","0","33.66","9.83"
"67","000","00","260","0009","0000","96","36","60","2","98","286","0","34.27","12.59"
"67","000","00","260","0009","0578","96","36","60","2","98","286","0","34.27","12.59"
"67","000","00","260","0010","0000","88","17","71","2","90","179","0","50.28","9.50"
"67","000","00","260","0010","0579","88","17","71","2","90","179","0","50.28","9.50"
"67","000","00","270","0000","0000","27433","10172","17261","283","27716","65371","76229","42.40","15.56"
"67","000","00","270","0001","0000","2401","694","1707","22","2423","5421","0","44.70","12.80"
"67","000","00","270","0001","1384","608","173","435","7","615","1331","0","46.21","13.00"
"67","000","00","270","0001","1385","606","205","401","6","612","1418","0","43.16","14.46"
"67","000","00","270","0001","1386","631","153","478","3","634","1435","0","44.18","10.66"
"67","000","00","270","0001","1387","556","163","393","6","562","1237","0","45.43","13.18"
"67","000","00","270","0002","0000","1244","315","929","18","1262","2737","0","46.11","11.51"
"67","000","00","270","0002","1388","665","173","492","8","673","1432","0","47.00","12.08"
"67","000","00","270","0002","1389","579","142","437","10","589","1305","0","45.13","10.88"
"67","000","00","270","0003","0000","1114","398","716","10","1124","2570","0","43.74","15.49"
"67","000","00","270","0003","1390","541","200","341","8","549","1318","0","41.65","15.17"
"67","000","00","270","0003","1391","573","198","375","2","575","1252","0","45.93","15.81"
"67","000","00","270","0004","0000","3044","1181","1863","28","3072","7630","0","40.26","15.48"
"67","000","00","270","0004","1392","441","144","297","7","448","1109","0","40.40","12.98"
"67","000","00","270","0004","1393","444","169","275","4","448","1092","0","41.03","15.48"
"67","000","00","270","0004","1394","433","149","284","2","435","1074","0","40.50","13.87"
"67","000","00","270","0004","1395","415","162","253","4","419","1175","0","35.66","13.79"
"67","000","00","270","0004","1396","575","268","307","6","581","1431","0","40.60","18.73"
"67","000","00","270","0004","1397","387","162","225","2","389","949","0","40.99","17.07"
"67","000","00","270","0004","1398","349","127","222","3","352","800","0","44.00","15.88"
"67","000","00","270","0005","0000","3924","1468","2456","28","3952","9033","0","43.75","16.25"
"67","000","00","270","0005","1399","651","250","401","1","652","1441","0","45.25","17.35"
"67","000","00","270","0005","1400","565","191","374","6","571","1347","0","42.39","14.18"
"67","000","00","270","0005","1401","689","300","389","3","692","1477","0","46.85","20.31"
"67","000","00","270","0005","1402","491","174","317","1","492","1208","0","40.73","14.40"
"67","000","00","270","0005","1403","552","235","317","7","559","1348","0","41.47","17.43"
"67","000","00","270","0005","1404","484","165","319","4","488","1067","0","45.74","15.46"
"67","000","00","270","0005","1405","492","153","339","6","498","1145","0","43.49","13.36"
"67","000","00","270","0006","0000","1469","472","997","10","1479","3381","0","43.74","13.96"
"67","000","00","270","0006","1406","521","137","384","4","525","1247","0","42.10","10.99"
"67","000","00","270","0006","1407","447","147","300","4","451","971","0","46.45","15.14"
"67","000","00","270","0006","1408","501","188","313","2","503","1163","0","43.25","16.17"
"67","000","00","270","0007","0000","3789","1362","2427","38","3827","9317","0","41.08","14.62"
"67","000","00","270","0007","1409","564","186","378","6","570","1393","0","40.92","13.35"
"67","000","00","270","0007","1410","636","207","429","3","639","1453","0","43.98","14.25"
"67","000","00","270","0007","1411","571","198","373","7","578","1399","0","41.32","14.15"
"67","000","00","270","0007","1412","534","185","349","7","541","1332","0","40.62","13.89"
"67","000","00","270","0007","1413","446","160","286","7","453","1229","0","36.86","13.02"
"67","000","00","270","0007","1414","367","158","209","2","369","937","0","39.38","16.86"
"67","000","00","270","0007","1415","433","173","260","5","438","1027","0","42.65","16.85"
"67","000","00","270","0007","1416","238","95","143","1","239","547","0","43.69","17.37"
"67","000","00","270","0008","0000","2354","776","1578","27","2381","6025","0","39.52","12.88"
"67","000","00","270","0008","1417","330","112","218","3","333","846","0","39.36","13.24"
"67","000","00","270","0008","1418","313","103","210","2","315","759","0","41.50","13.57"
"67","000","00","270","0008","1419","550","196","354","4","554","1435","0","38.61","13.66"
"67","000","00","270","0008","1420","292","87","205","2","294","764","0","38.48","11.39"
"67","000","00","270","0008","1421","387","105","282","5","392","998","0","39.28","10.52"
"67","000","00","270","0008","1422","482","173","309","11","493","1223","0","40.31","14.15"
"67","000","00","270","0011","0000","1082","370","712","6","1088","2705","0","40.22","13.68"
"67","000","00","270","0011","1425","570","176","394","3","573","1380","0","41.52","12.75"
"67","000","00","270","0011","1426","512","194","318","3","515","1325","0","38.87","14.64"
"67","000","00","270","0012","0000","2113","1065","1048","19","2132","4809","0","44.33","22.15"
"67","000","00","270","0012","1427","631","310","321","4","635","1400","0","45.36","22.14"
"67","000","00","270","0012","1428","606","315","291","9","615","1333","0","46.14","23.63"
"67","000","00","270","0012","1429","589","327","262","6","595","1431","0","41.58","22.85"
"67","000","00","270","0012","1430","287","113","174","0","287","645","0","44.50","17.52"
"67","000","00","270","0013","0000","685","546","139","14","699","1493","0","46.82","36.57"
"67","000","00","270","0013","1431","685","546","139","14","699","1493","0","46.82","36.57"
"67","000","00","270","0014","0000","530","304","226","3","533","1211","0","44.01","25.10"
"67","000","00","270","0014","1432","530","304","226","3","533","1211","0","44.01","25.10"
"67","000","00","270","0015","0000","820","288","532","5","825","2102","0","39.25","13.70"
"67","000","00","270","0015","1433","468","182","286","3","471","1147","0","41.06","15.87"
"67","000","00","270","0015","1434","352","106","246","2","354","955","0","37.07","11.10"
"67","000","00","270","0016","0000","882","269","613","13","895","2110","0","42.42","12.75"
"67","000","00","270","0016","1435","415","117","298","8","423","935","0","45.24","12.51"
"67","000","00","270","0016","1436","467","152","315","5","472","1175","0","40.17","12.94"
"67","000","00","270","0017","0000","1069","350","719","20","1089","2612","0","41.69","13.40"
"67","000","00","270","0017","1437","495","148","347","8","503","1159","0","43.40","12.77"
"67","000","00","270","0017","1438","574","202","372","12","586","1453","0","40.33","13.90"
"67","000","00","270","0019","0000","913","314","599","22","935","2215","0","42.21","14.18"
"67","000","00","270","0019","1423","501","176","325","15","516","1252","0","41.21","14.06"
"67","000","00","270","0019","1424","412","138","274","7","419","963","0","43.51","14.33"
"67","000","00","280","0000","0000","23817","7724","16093","214","24031","57425","68074","41.85","13.45"
"67","000","00","280","0001","0000","2424","799","1625","23","2447","5856","0","41.79","13.64"
"67","000","00","280","0001","1439","484","157","327","3","487","1201","0","40.55","13.07"
"67","000","00","280","0001","1440","501","179","322","8","509","1154","0","44.11","15.51"
"67","000","00","280","0001","1441","429","143","286","2","431","1001","0","43.06","14.29"
"67","000","00","280","0001","1442","513","176","337","5","518","1212","0","42.74","14.52"
"67","000","00","280","0001","1443","497","144","353","5","502","1288","0","38.98","11.18"
"67","000","00","280","0002","0000","1378","407","971","10","1388","3838","0","36.16","10.60"
"67","000","00","280","0002","1448","345","104","241","2","347","967","0","35.88","10.75"
"67","000","00","280","0002","1449","261","82","179","4","265","961","0","27.58","8.53"
"67","000","00","280","0002","1450","379","94","285","3","382","957","0","39.92","9.82"
"67","000","00","280","0002","1451","393","127","266","1","394","953","0","41.34","13.33"
"67","000","00","280","0003","0000","923","350","573","10","933","2285","0","40.83","15.32"
"67","000","00","280","0003","1481","535","187","348","6","541","1255","0","43.11","14.90"
"67","000","00","280","0003","1482","388","163","225","4","392","1030","0","38.06","15.83"
"67","000","00","280","0004","0000","1339","429","910","15","1354","3225","0","41.98","13.30"
"67","000","00","280","0004","1454","457","160","297","6","463","1040","0","44.52","15.38"
"67","000","00","280","0004","1455","411","127","284","4","415","1073","0","38.68","11.84"
"67","000","00","280","0004","1456","471","142","329","5","476","1112","0","42.81","12.77"
"67","000","00","280","0005","0000","1338","490","848","10","1348","3248","0","41.50","15.09"
"67","000","00","280","0005","1460","413","167","246","5","418","1045","0","40.00","15.98"
"67","000","00","280","0005","1461","489","178","311","2","491","1125","0","43.64","15.82"
"67","000","00","280","0005","1462","436","145","291","3","439","1078","0","40.72","13.45"
"67","000","00","280","0006","0000","1317","434","883","19","1336","3254","0","41.06","13.34"
"67","000","00","280","0006","1466","455","164","291","5","460","1142","0","40.28","14.36"
"67","000","00","280","0006","1467","425","120","305","6","431","1040","0","41.44","11.54"
"67","000","00","280","0006","1468","437","150","287","8","445","1072","0","41.51","13.99"
"67","000","00","280","0007","0000","933","276","657","6","939","2155","0","43.57","12.81"
"67","000","00","280","0007","1469","471","144","327","3","474","1081","0","43.85","13.32"
"67","000","00","280","0007","1470","462","132","330","3","465","1074","0","43.30","12.29"
"67","000","00","280","0008","0000","757","266","491","15","772","1781","0","43.35","14.94"
"67","000","00","280","0008","1471","441","144","297","9","450","1012","0","44.47","14.23"
"67","000","00","280","0008","1472","316","122","194","6","322","769","0","41.87","15.86"
"67","000","00","280","0009","0000","1361","400","961","12","1373","3017","0","45.51","13.26"
"67","000","00","280","0009","1473","457","135","322","5","462","1055","0","43.79","12.80"
"67","000","00","280","0009","1474","412","125","287","2","414","917","0","45.15","13.63"
"67","000","00","280","0009","1475","492","140","352","5","497","1045","0","47.56","13.40"
"67","000","00","280","0010","0000","277","92","185","2","279","692","0","40.32","13.29"
"67","000","00","280","0010","1476","277","92","185","2","279","692","0","40.32","13.29"
"67","000","00","280","0011","0000","745","197","548","7","752","1871","0","40.19","10.53"
"67","000","00","280","0011","1477","411","114","297","4","415","995","0","41.71","11.46"
"67","000","00","280","0011","1478","334","83","251","3","337","876","0","38.47","9.47"
"67","000","00","280","0012","0000","645","228","417","6","651","1767","0","36.84","12.90"
"67","000","00","280","0012","1479","353","140","213","3","356","872","0","40.83","16.06"
"67","000","00","280","0012","1480","292","88","204","3","295","895","0","32.96","9.83"
"67","000","00","280","0013","0000","1182","377","805","5","1187","2678","0","44.32","14.08"
"67","000","00","280","0013","1483","395","121","274","1","396","848","0","46.70","14.27"
"67","000","00","280","0013","1484","366","125","241","3","369","862","0","42.81","14.50"
"67","000","00","280","0013","1485","421","131","290","1","422","968","0","43.60","13.53"
"67","000","00","280","0014","0000","1420","468","952","7","1427","3293","0","43.33","14.21"
"67","000","00","280","0014","1486","317","125","192","0","317","742","0","42.72","16.85"
"67","000","00","280","0014","1487","406","130","276","2","408","897","0","45.48","14.49"
"67","000","00","280","0014","1488","381","96","285","3","384","859","0","44.70","11.18"
"67","000","00","280","0014","1489","316","117","199","2","318","795","0","40.00","14.72"
"67","000","00","280","0015","0000","842","234","608","11","853","1938","0","44.01","12.07"
"67","000","00","280","0015","1490","386","124","262","5","391","938","0","41.68","13.22"
"67","000","00","280","0015","1491","456","110","346","6","462","1000","0","46.20","11.00"
"67","000","00","280","0016","0000","738","228","510","7","745","1652","0","45.10","13.80"
"67","000","00","280","0016","1492","421","133","288","5","426","940","0","45.32","14.15"
"67","000","00","280","0016","1493","317","95","222","2","319","712","0","44.80","13.34"
"67","000","00","280","0017","0000","1277","400","877","10","1287","3037","0","42.38","13.17"
"67","000","00","280","0017","1494","392","126","266","6","398","1022","0","38.94","12.33"
"67","000","00","280","0017","1495","437","108","329","1","438","936","0","46.79","11.54"
"67","000","00","280","0017","1496","448","166","282","3","451","1079","0","41.80","15.38"
"67","000","00","280","0018","0000","1767","633","1134","20","1787","4221","0","42.34","15.00"
"67","000","00","280","0018","1444","417","174","243","4","421","1012","0","41.60","17.19"
"67","000","00","280","0018","1445","468","161","307","5","473","1109","0","42.65","14.52"
"67","000","00","280","0018","1446","450","168","282","4","454","1045","0","43.44","16.08"
"67","000","00","280","0018","1447","432","130","302","7","439","1055","0","41.61","12.32"
"67","000","00","280","0019","0000","970","291","679","4","974","2447","0","39.80","11.89"
"67","000","00","280","0019","1463","340","102","238","1","341","883","0","38.62","11.55"
"67","000","00","280","0019","1464","426","140","286","3","429","1020","0","42.06","13.73"
"67","000","00","280","0019","1465","204","49","155","0","204","544","0","37.50","9.01"
"67","000","00","280","0020","0000","962","299","663","4","966","2218","0","43.55","13.48"
"67","000","00","280","0020","1452","481","148","333","2","483","1107","0","43.63","13.37"
"67","000","00","280","0020","1453","481","151","330","2","483","1111","0","43.47","13.59"
"67","000","00","280","0021","0000","1222","426","796","11","1233","2952","0","41.77","14.43"
"67","000","00","280","0021","1457","412","138","274","3","415","959","0","43.27","14.39"
"67","000","00","280","0021","1458","392","153","239","2","394","919","0","42.87","16.65"
"67","000","00","280","0021","1459","418","135","283","6","424","1074","0","39.48","12.57"
"67","000","00","290","0000","0000","12219","3841","8378","133","12352","29940","33986","41.26","12.83"
"67","000","00","290","0001","0000","965","316","649","14","979","2249","0","43.53","14.05"
"67","000","00","290","0001","1497","405","127","278","6","411","961","0","42.77","13.22"
"67","000","00","290","0001","1498","560","189","371","8","568","1288","0","44.10","14.67"
"67","000","00","290","0002","0000","856","264","592","4","860","2011","0","42.76","13.13"
"67","000","00","290","0002","1499","370","131","239","2","372","968","0","38.43","13.53"
"67","000","00","290","0002","1500","486","133","353","2","488","1043","0","46.79","12.75"
"67","000","00","290","0003","0000","1438","510","928","11","1449","3209","0","45.15","15.89"
"67","000","00","290","0003","1501","445","161","284","8","453","953","0","47.53","16.89"
"67","000","00","290","0003","1502","438","148","290","2","440","1001","0","43.96","14.79"
"67","000","00","290","0003","1503","555","201","354","1","556","1255","0","44.30","16.02"
"67","000","00","290","0004","0000","1040","294","746","15","1055","2473","0","42.66","11.89"
"67","000","00","290","0004","1504","555","148","407","11","566","1288","0","43.94","11.49"
"67","000","00","290","0004","1505","485","146","339","4","489","1185","0","41.27","12.32"
"67","000","00","290","0005","0000","369","108","261","6","375","1038","0","36.13","10.40"
"67","000","00","290","0005","1506","369","108","261","6","375","1038","0","36.13","10.40"
"67","000","00","290","0006","0000","283","71","212","3","286","695","0","41.15","10.22"
"67","000","00","290","0006","1507","283","71","212","3","286","695","0","41.15","10.22"
"67","000","00","290","0007","0000","1271","453","818","11","1282","3182","0","40.29","14.24"
"67","000","00","290","0007","1508","451","168","283","6","457","1105","0","41.36","15.20"
"67","000","00","290","0007","1509","439","152","287","1","440","1063","0","41.39","14.30"
"67","000","00","290","0007","1510","381","133","248","4","385","1014","0","37.97","13.12"
"67","000","00","290","0008","0000","1211","389","822","14","1225","3141","0","39.00","12.38"
"67","000","00","290","0008","1511","410","120","290","5","415","1112","0","37.32","10.79"
"67","000","00","290","0008","1512","347","143","204","6","353","981","0","35.98","14.58"
"67","000","00","290","0008","1513","454","126","328","3","457","1048","0","43.61","12.02"
"67","000","00","290","0009","0000","754","226","528","10","764","1949","0","39.20","11.60"
"67","000","00","290","0009","1514","346","103","243","4","350","965","0","36.27","10.67"
"67","000","00","290","0009","1515","408","123","285","6","414","984","0","42.07","12.50"
"67","000","00","290","0012","0000","590","215","375","8","598","1468","0","40.74","14.65"
"67","000","00","290","0012","1520","328","110","218","3","331","772","0","42.88","14.25"
"67","000","00","290","0012","1521","262","105","157","5","267","696","0","38.36","15.09"
"67","000","00","290","0013","0000","474","124","350","7","481","1183","0","40.66","10.48"
"67","000","00","290","0013","1522","330","90","240","5","335","826","0","40.56","10.90"
"67","000","00","290","0013","1523","144","34","110","2","146","357","0","40.90","9.52"
"67","000","00","290","0016","0000","770","227","543","9","779","1936","0","40.24","11.73"
"67","000","00","290","0016","1526","348","110","238","2","350","903","0","38.76","12.18"
"67","000","00","290","0016","1527","422","117","305","7","429","1033","0","41.53","11.33"
"67","000","00","290","0017","0000","205","72","133","4","209","470","0","44.47","15.32"
"67","000","00","290","0017","1528","205","72","133","4","209","470","0","44.47","15.32"
"67","000","00","290","0018","0000","1384","403","981","14","1398","3442","0","40.62","11.71"
"67","000","00","290","0018","1516","333","86","247","4","337","762","0","44.23","11.29"
"67","000","00","290","0018","1517","285","86","199","4","289","623","0","46.39","13.80"
"67","000","00","290","0018","1518","398","118","280","4","402","965","0","41.66","12.23"
"67","000","00","290","0018","1519","368","113","255","2","370","1092","0","33.88","10.35"
"67","000","00","290","0019","0000","609","169","440","3","612","1494","0","40.96","11.31"
"67","000","00","290","0019","1524","334","83","251","2","336","791","0","42.48","10.49"
"67","000","00","290","0019","1525","275","86","189","1","276","703","0","39.26","12.23"
"67","000","00","300","0000","0000","1304","491","813","18","1322","3545","3720","37.29","13.85"
"67","000","00","300","0001","0000","374","118","256","6","380","990","0","38.38","11.92"
"67","000","00","300","0001","1529","374","118","256","6","380","990","0","38.38","11.92"
"67","000","00","300","0002","0000","213","69","144","0","213","601","0","35.44","11.48"
"67","000","00","300","0002","1530","213","69","144","0","213","601","0","35.44","11.48"
"67","000","00","300","0003","0000","52","20","32","1","53","152","0","34.87","13.16"
"67","000","00","300","0003","1531","52","20","32","1","53","152","0","34.87","13.16"
"67","000","00","300","0004","0000","159","56","103","1","160","371","0","43.13","15.09"
"67","000","00","300","0004","1532","159","56","103","1","160","371","0","43.13","15.09"
"67","000","00","300","0005","0000","129","51","78","1","130","300","0","43.33","17.00"
"67","000","00","300","0005","1533","129","51","78","1","130","300","0","43.33","17.00"
"67","000","00","300","0006","0000","124","63","61","2","126","286","0","44.06","22.03"
"67","000","00","300","0006","1534","124","63","61","2","126","286","0","44.06","22.03"
"67","000","00","300","0007","0000","118","64","54","4","122","416","0","29.33","15.38"
"67","000","00","300","0007","1535","118","64","54","4","122","416","0","29.33","15.38"
"67","000","00","300","0008","0000","135","50","85","3","138","429","0","32.17","11.66"
"67","000","00","300","0008","1536","135","50","85","3","138","429","0","32.17","11.66"
"67","000","00","310","0000","0000","78907","30950","47957","650","79557","196894","235327","40.41","15.72"
"67","000","00","310","0001","0000","2206","889","1317","18","2224","5645","0","39.40","15.75"
"67","000","00","310","0001","0860","568","256","312","1","569","1365","0","41.68","18.75"
"67","000","00","310","0001","0861","537","206","331","6","543","1453","0","37.37","14.18"
"67","000","00","310","0001","0862","605","209","396","7","612","1410","0","43.40","14.82"
"67","000","00","310","0001","0863","496","218","278","4","500","1417","0","35.29","15.38"
"67","000","00","310","0002","0000","2740","1043","1697","25","2765","6942","0","39.83","15.02"
"67","000","00","310","0002","0871","573","195","378","9","582","1418","0","41.04","13.75"
"67","000","00","310","0002","0872","494","211","283","5","499","1322","0","37.75","15.96"
"67","000","00","310","0002","0873","547","203","344","2","549","1314","0","41.78","15.45"
"67","000","00","310","0002","0874","520","204","316","4","524","1337","0","39.19","15.26"
"67","000","00","310","0002","0875","606","230","376","5","611","1551","0","39.39","14.83"
"67","000","00","310","0003","0000","3077","1174","1903","19","3096","8806","0","35.16","13.33"
"67","000","00","310","0003","0882","597","233","364","5","602","1412","0","42.63","16.50"
"67","000","00","310","0003","0883","533","201","332","3","536","1364","0","39.30","14.74"
"67","000","00","310","0003","0884","536","188","348","1","537","1409","0","38.11","13.34"
"67","000","00","310","0003","0885","453","177","276","3","456","1318","0","34.60","13.43"
"67","000","00","310","0003","0886","355","137","218","2","357","1784","0","20.01","7.68"
"67","000","00","310","0003","0887","603","238","365","5","608","1519","0","40.03","15.67"
"67","000","00","310","0004","0000","2857","1004","1853","21","2878","7154","0","40.23","14.03"
"67","000","00","310","0004","0888","430","129","301","5","435","1045","0","41.63","12.34"
"67","000","00","310","0004","0889","439","182","257","2","441","1166","0","37.82","15.61"
"67","000","00","310","0004","0890","463","182","281","4","467","1185","0","39.41","15.36"
"67","000","00","310","0004","0891","597","214","383","3","600","1401","0","42.83","15.27"
"67","000","00","310","0004","0892","425","134","291","2","427","1068","0","39.98","12.55"
"67","000","00","310","0004","0893","503","163","340","5","508","1289","0","39.41","12.65"
"67","000","00","310","0005","0000","2330","998","1332","20","2350","5595","0","42.00","17.84"
"67","000","00","310","0005","0903","489","206","283","6","495","1123","0","44.08","18.34"
"67","000","00","310","0005","0904","447","205","242","5","452","1145","0","39.48","17.90"
"67","000","00","310","0005","0905","489","182","307","4","493","1124","0","43.86","16.19"
"67","000","00","310","0005","0906","452","202","250","4","456","1116","0","40.86","18.10"
"67","000","00","310","0005","0907","453","203","250","1","454","1087","0","41.77","18.68"
"67","000","00","310","0006","0000","1002","279","723","12","1014","2455","0","41.30","11.36"
"67","000","00","310","0006","0949","532","129","403","7","539","1247","0","43.22","10.34"
"67","000","00","310","0006","0950","470","150","320","5","475","1208","0","39.32","12.42"
"67","000","00","310","0007","0000","1092","375","717","8","1100","2791","0","39.41","13.44"
"67","000","00","310","0007","0951","540","166","374","5","545","1346","0","40.49","12.33"
"67","000","00","310","0007","0952","552","209","343","3","555","1445","0","38.41","14.46"
"67","000","00","310","0008","0000","709","210","499","4","713","1847","0","38.60","11.37"
"67","000","00","310","0008","0920","347","110","237","0","347","935","0","37.11","11.76"
"67","000","00","310","0008","0921","362","100","262","4","366","912","0","40.13","10.96"
"67","000","00","310","0009","0000","653","240","413","8","661","1503","0","43.98","15.97"
"67","000","00","310","0009","0922","427","179","248","5","432","958","0","45.09","18.68"
"67","000","00","310","0009","0923","226","61","165","3","229","545","0","42.02","11.19"
"67","000","00","310","0010","0000","2062","645","1417","15","2077","4855","0","42.78","13.29"
"67","000","00","310","0010","0924","539","165","374","3","542","1293","0","41.92","12.76"
"67","000","00","310","0010","0925","539","165","374","7","546","1218","0","44.83","13.55"
"67","000","00","310","0010","0926","506","153","353","2","508","1198","0","42.40","12.77"
"67","000","00","310","0010","0927","478","162","316","3","481","1146","0","41.97","14.14"
"67","000","00","310","0011","0000","982","308","674","7","989","2226","0","44.43","13.84"
"67","000","00","310","0011","0936","346","132","214","3","349","887","0","39.35","14.88"
"67","000","00","310","0011","0937","636","176","460","4","640","1339","0","47.80","13.14"
"67","000","00","310","0012","0000","1412","382","1030","12","1424","3408","0","41.78","11.21"
"67","000","00","310","0012","0960","453","111","342","1","454","1147","0","39.58","9.68"
"67","000","00","310","0012","0961","426","122","304","5","431","1014","0","42.50","12.03"
"67","000","00","310","0012","0962","533","149","384","6","539","1247","0","43.22","11.95"
"67","000","00","310","0013","0000","1425","386","1039","20","1445","3440","0","42.01","11.22"
"67","000","00","310","0013","0963","470","136","334","8","478","1124","0","42.53","12.10"
"67","000","00","310","0013","0964","442","105","337","8","450","1154","0","38.99","9.10"
"67","000","00","310","0013","0965","513","145","368","4","517","1162","0","44.49","12.48"
"67","000","00","310","0014","0000","2999","1043","1956","26","3025","7237","0","41.80","14.41"
"67","000","00","310","0014","0966","501","143","358","1","502","1210","0","41.49","11.82"
"67","000","00","310","0014","0967","496","160","336","6","502","1113","0","45.10","14.38"
"67","000","00","310","0014","0968","518","197","321","2","520","1358","0","38.29","14.51"
"67","000","00","310","0014","0969","485","162","323","2","487","1140","0","42.72","14.21"
"67","000","00","310","0014","0970","527","194","333","6","533","1200","0","44.42","16.17"
"67","000","00","310","0014","0971","472","187","285","9","481","1216","0","39.56","15.38"
"67","000","00","310","0015","0000","1568","439","1129","3","1571","3833","0","40.99","11.45"
"67","000","00","310","0015","0972","549","151","398","1","550","1335","0","41.20","11.31"
"67","000","00","310","0015","0973","517","131","386","1","518","1239","0","41.81","10.57"
"67","000","00","310","0015","0974","502","157","345","1","503","1259","0","39.95","12.47"
"67","000","00","310","0016","0000","2517","844","1673","27","2544","5820","0","43.71","14.50"
"67","000","00","310","0016","0975","474","202","272","8","482","1136","0","42.43","17.78"
"67","000","00","310","0016","0976","536","148","388","4","540","1220","0","44.26","12.13"
"67","000","00","310","0016","0977","545","176","369","7","552","1220","0","45.25","14.43"
"67","000","00","310","0016","0978","504","184","320","3","507","1136","0","44.63","16.20"
"67","000","00","310","0016","0979","458","134","324","5","463","1108","0","41.79","12.09"
"67","000","00","310","0017","0000","1655","522","1133","11","1666","4081","0","40.82","12.79"
"67","000","00","310","0017","0980","578","185","393","3","581","1481","0","39.23","12.49"
"67","000","00","310","0017","0981","553","172","381","2","555","1344","0","41.29","12.80"
"67","000","00","310","0017","0982","524","165","359","6","530","1256","0","42.20","13.14"
"67","000","00","310","0018","0000","823","255","568","9","832","2121","0","39.23","12.02"
"67","000","00","310","0018","0958","394","135","259","3","397","1032","0","38.47","13.08"
"67","000","00","310","0018","0959","429","120","309","6","435","1089","0","39.94","11.02"
"67","000","00","310","0019","0000","708","468","240","10","718","1919","0","37.42","24.39"
"67","000","00","310","0019","0987","359","245","114","6","365","1036","0","35.23","23.65"
"67","000","00","310","0019","0988","349","223","126","4","353","883","0","39.98","25.25"
"67","000","00","310","0020","0000","3318","1731","1587","24","3342","8455","0","39.53","20.47"
"67","000","00","310","0020","0992","603","320","283","7","610","1313","0","46.46","24.37"
"67","000","00","310","0020","0993","563","306","257","3","566","1463","0","38.69","20.92"
"67","000","00","310","0020","0994","455","208","247","4","459","1339","0","34.28","15.53"
"67","000","00","310","0020","0995","416","223","193","1","417","1112","0","37.50","20.05"
"67","000","00","310","0020","0996","422","197","225","1","423","1277","0","33.12","15.43"
"67","000","00","310","0020","0997","333","181","152","3","336","812","0","41.38","22.29"
"67","000","00","310","0020","0998","526","296","230","5","531","1139","0","46.62","25.99"
"67","000","00","310","0021","0000","769","442","327","14","783","1905","0","41.10","23.20"
"67","000","00","310","0021","0990","345","228","117","12","357","864","0","41.32","26.39"
"67","000","00","310","0021","0991","424","214","210","2","426","1041","0","40.92","20.56"
"67","000","00","310","0022","0000","467","235","232","4","471","1264","0","37.26","18.59"
"67","000","00","310","0022","1006","467","235","232","4","471","1264","0","37.26","18.59"
"67","000","00","310","0023","0000","2423","811","1612","26","2449","6123","0","40.00","13.25"
"67","000","00","310","0023","0953","465","170","295","7","472","1230","0","38.37","13.82"
"67","000","00","310","0023","0954","466","177","289","6","472","1174","0","40.20","15.08"
"67","000","00","310","0023","0955","503","149","354","3","506","1264","0","40.03","11.79"
"67","000","00","310","0023","0956","508","168","340","4","512","1266","0","40.44","13.27"
"67","000","00","310","0023","0957","481","147","334","6","487","1189","0","40.96","12.36"
"67","000","00","310","0024","0000","834","580","254","14","848","2032","0","41.73","28.54"
"67","000","00","310","0024","1007","440","329","111","7","447","1022","0","43.74","32.19"
"67","000","00","310","0024","1008","394","251","143","7","401","1010","0","39.70","24.85"
"67","000","00","310","0025","0000","1389","694","695","9","1398","3317","0","42.15","20.92"
"67","000","00","310","0025","1011","442","240","202","2","444","1113","0","39.89","21.56"
"67","000","00","310","0025","1012","474","211","263","4","478","1128","0","42.38","18.71"
"67","000","00","310","0025","1013","473","243","230","3","476","1076","0","44.24","22.58"
"67","000","00","310","0026","0000","2960","1452","1508","30","2990","7661","0","39.03","18.95"
"67","000","00","310","0026","1014","555","255","300","2","557","1301","0","42.81","19.60"
"67","000","00","310","0026","1015","462","219","243","5","467","1207","0","38.69","18.14"
"67","000","00","310","0026","1016","411","184","227","2","413","1132","0","36.48","16.25"
"67","000","00","310","0026","1017","476","231","245","7","483","1396","0","34.60","16.55"
"67","000","00","310","0026","1018","521","247","274","4","525","1369","0","38.35","18.04"
"67","000","00","310","0026","1019","535","316","219","10","545","1256","0","43.39","25.16"
"67","000","00","310","0027","0000","2300","687","1613","19","2319","6139","0","37.77","11.19"
"67","000","00","310","0027","0941","480","139","341","2","482","1235","0","39.03","11.26"
"67","000","00","310","0027","0942","485","139","346","8","493","1279","0","38.55","10.87"
"67","000","00","310","0027","0943","460","125","335","2","462","1288","0","35.87","9.70"
"67","000","00","310","0027","0944","483","167","316","5","488","1307","0","37.34","12.78"
"67","000","00","310","0027","0945","392","117","275","2","394","1030","0","38.25","11.36"
"67","000","00","310","0028","0000","195","137","58","2","197","527","0","37.38","26.00"
"67","000","00","310","0028","0989","195","137","58","2","197","527","0","37.38","26.00"
"67","000","00","310","0029","0000","2378","836","1542","21","2399","5686","0","42.19","14.70"
"67","000","00","310","0029","0931","450","150","300","3","453","1175","0","38.55","12.77"
"67","000","00","310","0029","0932","431","126","305","1","432","1010","0","42.77","12.48"
"67","000","00","310","0029","0933","524","203","321","4","528","1201","0","43.96","16.90"
"67","000","00","310","0029","0934","481","192","289","10","491","1121","0","43.80","17.13"
"67","000","00","310","0029","0935","492","165","327","3","495","1179","0","41.98","13.99"
"67","000","00","310","0030","0000","3153","1383","1770","24","3177","7749","0","41.00","17.85"
"67","000","00","310","0030","0876","441","201","240","4","445","1212","0","36.72","16.58"
"67","000","00","310","0030","0877","553","255","298","2","555","1359","0","40.84","18.76"
"67","000","00","310","0030","0878","497","226","271","3","500","1244","0","40.19","18.17"
"67","000","00","310","0030","0879","539","237","302","2","541","1262","0","42.87","18.78"
"67","000","00","310","0030","0880","535","223","312","4","539","1296","0","41.59","17.21"
"67","000","00","310","0030","0881","588","241","347","9","597","1376","0","43.39","17.51"
"67","000","00","310","0031","0000","2252","967","1285","12","2264","5449","0","41.55","17.75"
"67","000","00","310","0031","0867","534","186","348","4","538","1310","0","41.07","14.20"
"67","000","00","310","0031","0868","575","200","375","3","578","1365","0","42.34","14.65"
"67","000","00","310","0031","0869","538","257","281","3","541","1392","0","38.86","18.46"
"67","000","00","310","0031","0870","605","324","281","2","607","1382","0","43.92","23.44"
"67","000","00","310","0032","0000","1399","585","814","9","1408","3456","0","40.74","16.93"
"67","000","00","310","0032","0864","486","217","269","3","489","1139","0","42.93","19.05"
"67","000","00","310","0032","0865","472","204","268","4","476","1146","0","41.54","17.80"
"67","000","00","310","0032","0866","441","164","277","2","443","1171","0","37.83","14.01"
"67","000","00","310","0033","0000","2801","1028","1773","17","2818","7184","0","39.23","14.31"
"67","000","00","310","0033","0908","674","265","409","7","681","1629","0","41.80","16.27"
"67","000","00","310","0033","0909","701","230","471","1","702","1671","0","42.01","13.76"
"67","000","00","310","0033","0910","652","259","393","1","653","1747","0","37.38","14.83"
"67","000","00","310","0033","0911","283","98","185","3","286","667","0","42.88","14.69"
"67","000","00","310","0033","0912","491","176","315","5","496","1470","0","33.74","11.97"
"67","000","00","310","0034","0000","1862","740","1122","18","1880","4806","0","39.12","15.40"
"67","000","00","310","0034","0916","425","179","246","4","429","1106","0","38.79","16.18"
"67","000","00","310","0034","0917","481","189","292","3","484","1356","0","35.69","13.94"
"67","000","00","310","0034","0918","481","183","298","5","486","1217","0","39.93","15.04"
"67","000","00","310","0034","0919","475","189","286","6","481","1127","0","42.68","16.77"
"67","000","00","310","0035","0000","1242","464","778","11","1253","3018","0","41.52","15.37"
"67","000","00","310","0035","0913","387","147","240","3","390","946","0","41.23","15.54"
"67","000","00","310","0035","0914","435","153","282","3","438","1068","0","41.01","14.33"
"67","000","00","310","0035","0915","420","164","256","5","425","1004","0","42.33","16.33"
"67","000","00","310","0036","0000","1645","547","1098","10","1655","3737","0","44.29","14.64"
"67","000","00","310","0036","0938","568","173","395","3","571","1168","0","48.89","14.81"
"67","000","00","310","0036","0939","488","125","363","4","492","1138","0","43.23","10.98"
"67","000","00","310","0036","0940","589","249","340","3","592","1431","0","41.37","17.40"
"67","000","00","310","0037","0000","3645","1790","1855","24","3669","9242","0","39.70","19.37"
"67","000","00","310","0037","0999","567","289","278","7","574","1490","0","38.52","19.40"
"67","000","00","310","0037","1000","490","239","251","2","492","1382","0","35.60","17.29"
"67","000","00","310","0037","1001","486","216","270","4","490","1208","0","40.56","17.88"
"67","000","00","310","0037","1002","558","281","277","2","560","1281","0","43.72","21.94"
"67","000","00","310","0037","1003","561","287","274","4","565","1337","0","42.26","21.47"
"67","000","00","310","0037","1004","545","267","278","2","547","1434","0","38.15","18.62"
"67","000","00","310","0037","1005","438","211","227","3","441","1110","0","39.73","19.01"
"67","000","00","310","0038","0000","3029","1098","1931","21","3050","7578","0","40.25","14.49"
"67","000","00","310","0038","0897","554","181","373","1","555","1295","0","42.86","13.98"
"67","000","00","310","0038","0898","500","194","306","5","505","1159","0","43.57","16.74"
"67","000","00","310","0038","0899","482","166","316","3","485","1189","0","40.79","13.96"
"67","000","00","310","0038","0900","532","160","372","3","535","1283","0","41.70","12.47"
"67","000","00","310","0038","0901","487","190","297","3","490","1326","0","36.95","14.33"
"67","000","00","310","0038","0902","474","207","267","6","480","1326","0","36.20","15.61"
"67","000","00","310","0039","0000","1331","665","666","10","1341","2787","0","48.12","23.86"
"67","000","00","310","0039","1009","704","368","336","8","712","1441","0","49.41","25.54"
"67","000","00","310","0039","1010","627","297","330","2","629","1346","0","46.73","22.07"
"67","000","00","310","0040","0000","2038","738","1300","15","2053","4977","0","41.25","14.83"
"67","000","00","310","0040","0983","542","195","347","4","546","1294","0","42.19","15.07"
"67","000","00","310","0040","0984","474","189","285","5","479","1206","0","39.72","15.67"
"67","000","00","310","0040","0985","562","203","359","1","563","1300","0","43.31","15.62"
"67","000","00","310","0040","0986","460","151","309","5","465","1177","0","39.51","12.83"
"67","000","00","310","0041","0000","1451","520","931","13","1464","3732","0","39.23","13.93"
"67","000","00","310","0041","0894","435","162","273","2","437","1141","0","38.30","14.20"
"67","000","00","310","0041","0895","513","176","337","4","517","1255","0","41.20","14.02"
"67","000","00","310","0041","0896","503","182","321","7","510","1336","0","38.17","13.62"
"67","000","00","310","0042","0000","1858","795","1063","17","1875","4598","0","40.78","17.29"
"67","000","00","310","0042","0946","630","265","365","5","635","1595","0","39.81","16.61"
"67","000","00","310","0042","0947","569","254","315","6","575","1438","0","39.99","17.66"
"67","000","00","310","0042","0948","659","276","383","6","665","1565","0","42.49","17.64"
"67","000","00","310","0043","0000","1351","521","830","11","1362","3794","0","35.90","13.73"
"67","000","00","310","0043","0928","397","141","256","2","399","1118","0","35.69","12.61"
"67","000","00","310","0043","0929","461","190","271","5","466","1410","0","33.05","13.48"
"67","000","00","310","0043","0930","493","190","303","4","497","1266","0","39.26","15.01"
"67","000","00","320","0000","0000","67857","29795","38062","518","68375","151996","183689","44.98","19.60"
"67","000","00","320","0001","0000","964","361","603","7","971","2144","0","45.29","16.84"
"67","000","00","320","0001","1379","489","183","306","0","489","1065","0","45.92","17.18"
"67","000","00","320","0001","1380","475","178","297","7","482","1079","0","44.67","16.50"
"67","000","00","320","0002","0000","1297","537","760","13","1310","2857","0","45.85","18.80"
"67","000","00","320","0002","1374","659","264","395","9","668","1493","0","44.74","17.68"
"67","000","00","320","0002","1375","638","273","365","4","642","1364","0","47.07","20.01"
"67","000","00","320","0003","0000","2799","1372","1427","23","2822","6524","0","43.26","21.03"
"67","000","00","320","0003","1310","508","218","290","4","512","1319","0","38.82","16.53"
"67","000","00","320","0003","1311","647","348","299","6","653","1353","0","48.26","25.72"
"67","000","00","320","0003","1312","555","287","268","5","560","1242","0","45.09","23.11"
"67","000","00","320","0003","1313","543","274","269","6","549","1297","0","42.33","21.13"
"67","000","00","320","0003","1314","546","245","301","2","548","1313","0","41.74","18.66"
"67","000","00","320","0004","0000","1285","531","754","13","1298","2838","0","45.74","18.71"
"67","000","00","320","0004","1256","415","188","227","5","420","897","0","46.82","20.96"
"67","000","00","320","0004","1257","441","169","272","5","446","942","0","47.35","17.94"
"67","000","00","320","0004","1258","429","174","255","3","432","999","0","43.24","17.42"
"67","000","00","320","0005","0000","2063","842","1221","21","2084","4536","0","45.94","18.56"
"67","000","00","320","0005","1280","506","198","308","7","513","1156","0","44.38","17.13"
"67","000","00","320","0005","1281","483","205","278","4","487","1052","0","46.29","19.49"
"67","000","00","320","0005","1282","632","265","367","4","636","1367","0","46.53","19.39"
"67","000","00","320","0005","1283","442","174","268","6","448","961","0","46.62","18.11"
"67","000","00","320","0006","0000","1878","810","1068","12","1890","4489","0","42.10","18.04"
"67","000","00","320","0006","1318","607","268","339","4","611","1451","0","42.11","18.47"
"67","000","00","320","0006","1319","599","286","313","4","603","1463","0","41.22","19.55"
"67","000","00","320","0006","1320","672","256","416","4","676","1575","0","42.92","16.25"
"67","000","00","320","0007","0000","1190","483","707","9","1199","2816","0","42.58","17.15"
"67","000","00","320","0007","1352","353","141","212","2","355","857","0","41.42","16.45"
"67","000","00","320","0007","1353","422","171","251","3","425","965","0","44.04","17.72"
"67","000","00","320","0007","1354","415","171","244","4","419","994","0","42.15","17.20"
"67","000","00","320","0008","0000","2196","1018","1178","14","2210","4731","0","46.71","21.52"
"67","000","00","320","0008","1355","637","271","366","6","643","1332","0","48.27","20.35"
"67","000","00","320","0008","1356","444","196","248","3","447","1033","0","43.27","18.97"
"67","000","00","320","0008","1357","524","281","243","2","526","1208","0","43.54","23.26"
"67","000","00","320","0008","1358","591","270","321","3","594","1158","0","51.30","23.32"
"67","000","00","320","0009","0000","1155","531","624","4","1159","2370","0","48.90","22.41"
"67","000","00","320","0009","1369","528","236","292","1","529","1092","0","48.44","21.61"
"67","000","00","320","0009","1370","627","295","332","3","630","1278","0","49.30","23.08"
"67","000","00","320","0010","0000","1340","603","737","12","1352","2931","0","46.13","20.57"
"67","000","00","320","0010","1266","431","208","223","4","435","978","0","44.48","21.27"
"67","000","00","320","0010","1267","400","182","218","3","403","853","0","47.25","21.34"
"67","000","00","320","0010","1268","509","213","296","5","514","1100","0","46.73","19.36"
"67","000","00","320","0011","0000","537","202","335","4","541","1309","0","41.33","15.43"
"67","000","00","320","0011","1269","537","202","335","4","541","1309","0","41.33","15.43"
"67","000","00","320","0012","0000","1820","872","948","13","1833","3981","0","46.04","21.90"
"67","000","00","320","0012","1381","636","342","294","6","642","1357","0","47.31","25.20"
"67","000","00","320","0012","1382","557","257","300","3","560","1219","0","45.94","21.08"
"67","000","00","320","0012","1383","627","273","354","4","631","1405","0","44.91","19.43"
"67","000","00","320","0013","0000","2177","948","1229","17","2194","5154","0","42.57","18.39"
"67","000","00","320","0013","1336","549","243","306","5","554","1344","0","41.22","18.08"
"67","000","00","320","0013","1337","579","250","329","2","581","1229","0","47.27","20.34"
"67","000","00","320","0013","1338","515","232","283","6","521","1311","0","39.74","17.70"
"67","000","00","320","0013","1339","534","223","311","4","538","1270","0","42.36","17.56"
"67","000","00","320","0014","0000","2112","874","1238","20","2132","5004","0","42.61","17.47"
"67","000","00","320","0014","1321","563","217","346","6","569","1246","0","45.67","17.42"
"67","000","00","320","0014","1322","586","235","351","4","590","1399","0","42.17","16.80"
"67","000","00","320","0014","1323","511","219","292","5","516","1272","0","40.57","17.22"
"67","000","00","320","0014","1324","452","203","249","5","457","1087","0","42.04","18.68"
"67","000","00","320","0015","0000","735","360","375","4","739","1574","0","46.95","22.87"
"67","000","00","320","0015","1276","735","360","375","4","739","1574","0","46.95","22.87"
"67","000","00","320","0016","0000","656","265","391","2","658","1465","0","44.91","18.09"
"67","000","00","320","0016","1275","656","265","391","2","658","1465","0","44.91","18.09"
"67","000","00","320","0017","0000","2074","988","1086","14","2088","4496","0","46.44","21.98"
"67","000","00","320","0017","1342","492","220","272","4","496","1103","0","44.97","19.95"
"67","000","00","320","0017","1343","507","243","264","3","510","1059","0","48.16","22.95"
"67","000","00","320","0017","1344","503","258","245","5","508","1104","0","46.01","23.37"
"67","000","00","320","0017","1345","572","267","305","2","574","1230","0","46.67","21.71"
"67","000","00","320","0018","0000","652","269","383","7","659","1504","0","43.82","17.89"
"67","000","00","320","0018","1373","652","269","383","7","659","1504","0","43.82","17.89"
"67","000","00","320","0019","0000","2197","856","1341","17","2214","4969","0","44.56","17.23"
"67","000","00","320","0019","1295","648","247","401","9","657","1409","0","46.63","17.53"
"67","000","00","320","0019","1296","548","213","335","4","552","1370","0","40.29","15.55"
"67","000","00","320","0019","1297","580","229","351","3","583","1272","0","45.83","18.00"
"67","000","00","320","0019","1298","421","167","254","1","422","918","0","45.97","18.19"
"67","000","00","320","0020","0000","1934","762","1172","17","1951","4395","0","44.39","17.34"
"67","000","00","320","0020","1376","623","233","390","3","626","1416","0","44.21","16.45"
"67","000","00","320","0020","1377","584","237","347","7","591","1415","0","41.77","16.75"
"67","000","00","320","0020","1378","727","292","435","7","734","1564","0","46.93","18.67"
"67","000","00","320","0021","0000","862","351","511","6","868","1797","0","48.30","19.53"
"67","000","00","320","0021","1264","520","212","308","4","524","1038","0","50.48","20.42"
"67","000","00","320","0021","1265","342","139","203","2","344","759","0","45.32","18.31"
"67","000","00","320","0022","0000","1834","885","949","9","1843","4122","0","44.71","21.47"
"67","000","00","320","0022","1365","459","217","242","1","460","1038","0","44.32","20.91"
"67","000","00","320","0022","1366","507","263","244","1","508","1052","0","48.29","25.00"
"67","000","00","320","0022","1367","462","202","260","4","466","1083","0","43.03","18.65"
"67","000","00","320","0022","1368","406","203","203","3","409","949","0","43.10","21.39"
"67","000","00","320","0023","0000","520","236","284","1","521","1038","0","50.19","22.74"
"67","000","00","320","0023","1259","520","236","284","1","521","1038","0","50.19","22.74"
"67","000","00","320","0024","0000","2153","899","1254","11","2164","4589","0","47.16","19.59"
"67","000","00","320","0024","1284","424","157","267","2","426","924","0","46.10","16.99"
"67","000","00","320","0024","1285","602","277","325","3","605","1265","0","47.83","21.90"
"67","000","00","320","0024","1286","412","170","242","3","415","935","0","44.39","18.18"
"67","000","00","320","0024","1287","715","295","420","3","718","1465","0","49.01","20.14"
"67","000","00","320","0025","0000","2271","933","1338","21","2292","5079","0","45.13","18.37"
"67","000","00","320","0025","1325","547","220","327","5","552","1287","0","42.89","17.09"
"67","000","00","320","0025","1326","629","241","388","4","633","1346","0","47.03","17.90"
"67","000","00","320","0025","1327","506","229","277","7","513","1159","0","44.26","19.76"
"67","000","00","320","0025","1328","589","243","346","5","594","1287","0","46.15","18.88"
"67","000","00","320","0026","0000","1416","542","874","10","1426","3195","0","44.63","16.96"
"67","000","00","320","0026","1315","479","183","296","1","480","1083","0","44.32","16.90"
"67","000","00","320","0026","1316","601","212","389","4","605","1339","0","45.18","15.83"
"67","000","00","320","0026","1317","336","147","189","5","341","773","0","44.11","19.02"
"67","000","00","320","0027","0000","1551","703","848","11","1562","3480","0","44.89","20.20"
"67","000","00","320","0027","1362","501","222","279","3","504","1124","0","44.84","19.75"
"67","000","00","320","0027","1363","572","294","278","7","579","1242","0","46.62","23.67"
"67","000","00","320","0027","1364","478","187","291","1","479","1114","0","43.00","16.79"
"67","000","00","320","0028","0000","731","301","430","4","735","1609","0","45.68","18.71"
"67","000","00","320","0028","1274","731","301","430","4","735","1609","0","45.68","18.71"
"67","000","00","320","0029","0000","1936","915","1021","21","1957","4148","0","47.18","22.06"
"67","000","00","320","0029","1270","441","224","217","3","444","975","0","45.54","22.97"
"67","000","00","320","0029","1271","464","184","280","7","471","1025","0","45.95","17.95"
"67","000","00","320","0029","1272","532","257","275","9","541","1086","0","49.82","23.66"
"67","000","00","320","0029","1273","499","250","249","2","501","1062","0","47.18","23.54"
"67","000","00","320","0030","0000","1104","571","533","10","1114","2346","0","47.49","24.34"
"67","000","00","320","0030","1371","491","281","210","5","496","1100","0","45.09","25.55"
"67","000","00","320","0030","1372","613","290","323","5","618","1246","0","49.60","23.27"
"67","000","00","320","0031","0000","1337","610","727","11","1348","2853","0","47.25","21.38"
"67","000","00","320","0031","1359","419","205","214","4","423","883","0","47.90","23.22"
"67","000","00","320","0031","1360","425","190","235","5","430","913","0","47.10","20.81"
"67","000","00","320","0031","1361","493","215","278","2","495","1057","0","46.83","20.34"
"67","000","00","320","0032","0000","2078","961","1117","9","2087","4400","0","47.43","21.84"
"67","000","00","320","0032","1291","591","288","303","5","596","1179","0","50.55","24.43"
"67","000","00","320","0032","1292","540","235","305","2","542","1152","0","47.05","20.40"
"67","000","00","320","0032","1293","501","238","263","1","502","1080","0","46.48","22.04"
"67","000","00","320","0032","1294","446","200","246","1","447","989","0","45.20","20.22"
"67","000","00","320","0033","0000","1199","549","650","14","1213","2747","0","44.16","19.99"
"67","000","00","320","0033","1307","360","167","193","6","366","824","0","44.42","20.27"
"67","000","00","320","0033","1308","437","212","225","4","441","1030","0","42.82","20.58"
"67","000","00","320","0033","1309","402","170","232","4","406","893","0","45.46","19.04"
"67","000","00","320","0034","0000","936","388","548","3","939","2206","0","42.57","17.59"
"67","000","00","320","0034","1340","444","166","278","2","446","1092","0","40.84","15.20"
"67","000","00","320","0034","1341","492","222","270","1","493","1114","0","44.25","19.93"
"67","000","00","320","0035","0000","1269","563","706","10","1279","2925","0","43.73","19.25"
"67","000","00","320","0035","1299","408","180","228","1","409","938","0","43.60","19.19"
"67","000","00","320","0035","1300","474","188","286","6","480","1072","0","44.78","17.54"
"67","000","00","320","0035","1301","387","195","192","3","390","915","0","42.62","21.31"
"67","000","00","320","0036","0000","831","338","493","11","842","1800","0","46.78","18.78"
"67","000","00","320","0036","1262","381","169","212","2","383","865","0","44.28","19.54"
"67","000","00","320","0036","1263","450","169","281","9","459","935","0","49.09","18.07"
"67","000","00","320","0037","0000","833","392","441","7","840","1924","0","43.66","20.37"
"67","000","00","320","0037","1260","446","203","243","5","451","987","0","45.69","20.57"
"67","000","00","320","0037","1261","387","189","198","2","389","937","0","41.52","20.17"
"67","000","00","320","0038","0000","1245","534","711","9","1254","2848","0","44.03","18.75"
"67","000","00","320","0038","1277","328","149","179","2","330","810","0","40.74","18.40"
"67","000","00","320","0038","1278","452","190","262","6","458","969","0","47.27","19.61"
"67","000","00","320","0038","1279","465","195","270","1","466","1069","0","43.59","18.24"
"67","000","00","320","0039","0000","1879","838","1041","12","1891","3861","0","48.98","21.70"
"67","000","00","320","0039","1288","680","291","389","6","686","1363","0","50.33","21.35"
"67","000","00","320","0039","1289","621","279","342","1","622","1219","0","51.03","22.89"
"67","000","00","320","0039","1290","578","268","310","5","583","1279","0","45.58","20.95"
"67","000","00","320","0040","0000","1560","594","966","8","1568","4399","0","35.64","13.50"
"67","000","00","320","0040","1253","561","196","365","1","562","2040","0","27.55","9.61"
"67","000","00","320","0040","1254","585","233","352","4","589","1324","0","44.49","17.60"
"67","000","00","320","0040","1255","414","165","249","3","417","1035","0","40.29","15.94"
"67","000","00","320","0041","0000","2592","1199","1393","14","2606","5808","0","44.87","20.64"
"67","000","00","320","0041","1302","529","237","292","1","530","1097","0","48.31","21.60"
"67","000","00","320","0041","1303","544","243","301","3","547","1301","0","42.04","18.68"
"67","000","00","320","0041","1304","556","249","307","3","559","1279","0","43.71","19.47"
"67","000","00","320","0041","1305","520","270","250","1","521","1169","0","44.57","23.10"
"67","000","00","320","0041","1306","443","200","243","6","449","962","0","46.67","20.79"
"67","000","00","320","0042","0000","1465","533","932","15","1480","3284","0","45.07","16.23"
"67","000","00","320","0042","1333","520","170","350","6","526","1179","0","44.61","14.42"
"67","000","00","320","0042","1334","411","165","246","4","415","1038","0","39.98","15.90"
"67","000","00","320","0042","1335","534","198","336","5","539","1067","0","50.52","18.56"
"67","000","00","320","0043","0000","2110","1050","1060","14","2124","4654","0","45.64","22.56"
"67","000","00","320","0043","1329","565","262","303","2","567","1181","0","48.01","22.18"
"67","000","00","320","0043","1330","540","279","261","5","545","1093","0","49.86","25.53"
"67","000","00","320","0043","1331","510","277","233","4","514","1211","0","42.44","22.87"
"67","000","00","320","0043","1332","495","232","263","3","498","1169","0","42.60","19.85"
"67","000","00","320","0044","0000","1131","534","597","9","1140","2522","0","45.20","21.17"
"67","000","00","320","0044","1346","526","234","292","4","530","1141","0","46.45","20.51"
"67","000","00","320","0044","1347","605","300","305","5","610","1381","0","44.17","21.72"
"67","000","00","320","0045","0000","1953","892","1061","25","1978","4275","0","46.27","20.87"
"67","000","00","320","0045","1348","495","210","285","6","501","1104","0","45.38","19.02"
"67","000","00","320","0045","1349","522","216","306","10","532","1079","0","49.30","20.02"
"67","000","00","320","0045","1350","463","248","215","4","467","1067","0","43.77","23.24"
"67","000","00","320","0045","1351","473","218","255","5","478","1025","0","46.63","21.27"
"67","000","00","330","0000","0000","47446","16752","30694","386","47832","108304","123057","44.16","15.47"
"67","000","00","330","0001","0000","825","387","438","4","829","1623","0","51.08","23.84"
"67","000","00","330","0001","1170","383","190","193","1","384","799","0","48.06","23.78"
"67","000","00","330","0001","1171","442","197","245","3","445","824","0","54.00","23.91"
"67","000","00","330","0003","0000","546","260","286","6","552","1383","0","39.91","18.80"
"67","000","00","330","0003","1172","546","260","286","6","552","1383","0","39.91","18.80"
"67","000","00","330","0004","0000","798","335","463","3","801","1753","0","45.69","19.11"
"67","000","00","330","0004","1173","430","196","234","1","431","985","0","43.76","19.90"
"67","000","00","330","0004","1174","368","139","229","2","370","768","0","48.18","18.10"
"67","000","00","330","0005","0000","1081","356","725","9","1090","2226","0","48.97","15.99"
"67","000","00","330","0005","1183","532","170","362","1","533","1117","0","47.72","15.22"
"67","000","00","330","0005","1184","549","186","363","8","557","1109","0","50.23","16.77"
"67","000","00","330","0006","0000","955","358","597","7","962","2173","0","44.27","16.47"
"67","000","00","330","0006","1185","503","173","330","2","505","1199","0","42.12","14.43"
"67","000","00","330","0006","1186","452","185","267","5","457","974","0","46.92","18.99"
"67","000","00","330","0007","0000","1243","450","793","14","1257","2697","0","46.61","16.69"
"67","000","00","330","0007","1178","423","163","260","2","425","884","0","48.08","18.44"
"67","000","00","330","0007","1179","407","135","272","7","414","889","0","46.57","15.19"
"67","000","00","330","0007","1180","413","152","261","5","418","924","0","45.24","16.45"
"67","000","00","330","0008","0000","1378","547","831","6","1384","3096","0","44.70","17.67"
"67","000","00","330","0008","1175","425","158","267","3","428","953","0","44.91","16.58"
"67","000","00","330","0008","1176","547","243","304","0","547","1173","0","46.63","20.72"
"67","000","00","330","0008","1177","406","146","260","3","409","970","0","42.16","15.05"
"67","000","00","330","0009","0000","1236","412","824","9","1245","2875","0","43.30","14.33"
"67","000","00","330","0009","1198","421","123","298","2","423","964","0","43.88","12.76"
"67","000","00","330","0009","1199","409","133","276","4","413","881","0","46.88","15.10"
"67","000","00","330","0009","1200","406","156","250","3","409","1030","0","39.71","15.15"
"67","000","00","330","0011","0000","1771","548","1223","18","1789","4140","0","43.21","13.24"
"67","000","00","330","0011","1205","414","94","320","5","419","945","0","44.34","9.95"
"67","000","00","330","0011","1206","409","163","246","6","415","947","0","43.82","17.21"
"67","000","00","330","0011","1207","493","130","363","5","498","1179","0","42.24","11.03"
"67","000","00","330","0011","1208","455","161","294","2","457","1069","0","42.75","15.06"
"67","000","00","330","0013","0000","1593","512","1081","8","1601","3510","0","45.61","14.59"
"67","000","00","330","0013","1209","467","147","320","1","468","1060","0","44.15","13.87"
"67","000","00","330","0013","1210","499","163","336","4","503","1099","0","45.77","14.83"
"67","000","00","330","0013","1211","627","202","425","3","630","1351","0","46.63","14.95"
"67","000","00","330","0014","0000","906","217","689","3","909","2071","0","43.89","10.48"
"67","000","00","330","0014","1238","477","134","343","2","479","1131","0","42.35","11.85"
"67","000","00","330","0014","1239","429","83","346","1","430","940","0","45.74","8.83"
"67","000","00","330","0015","0000","955","216","739","7","962","2143","0","44.89","10.08"
"67","000","00","330","0015","1235","453","116","337","2","455","1096","0","41.51","10.58"
"67","000","00","330","0015","1236","502","100","402","5","507","1047","0","48.42","9.55"
"67","000","00","330","0016","0000","541","111","430","5","546","1191","0","45.84","9.32"
"67","000","00","330","0016","1237","541","111","430","5","546","1191","0","45.84","9.32"
"67","000","00","330","0017","0000","1473","377","1096","14","1487","3849","0","38.63","9.79"
"67","000","00","330","0017","1240","547","109","438","5","552","1280","0","43.13","8.52"
"67","000","00","330","0017","1241","450","157","293","3","453","1303","0","34.77","12.05"
"67","000","00","330","0017","1242","476","111","365","6","482","1266","0","38.07","8.77"
"67","000","00","330","0018","0000","1100","293","807","8","1108","2639","0","41.99","11.10"
"67","000","00","330","0018","1251","440","91","349","5","445","1067","0","41.71","8.53"
"67","000","00","330","0018","1252","660","202","458","3","663","1572","0","42.18","12.85"
"67","000","00","330","0019","0000","940","258","682","8","948","2169","0","43.71","11.89"
"67","000","00","330","0019","1249","489","153","336","2","491","1137","0","43.18","13.46"
"67","000","00","330","0019","1250","451","105","346","6","457","1032","0","44.28","10.17"
"67","000","00","330","0020","0000","1060","231","829","4","1064","2471","0","43.06","9.35"
"67","000","00","330","0020","1247","524","105","419","1","525","1136","0","46.21","9.24"
"67","000","00","330","0020","1248","536","126","410","3","539","1335","0","40.37","9.44"
"67","000","00","330","0021","0000","1038","511","527","9","1047","2187","0","47.87","23.37"
"67","000","00","330","0021","1161","506","241","265","5","511","1095","0","46.67","22.01"
"67","000","00","330","0021","1162","532","270","262","4","536","1092","0","49.08","24.73"
"67","000","00","330","0022","0000","2019","881","1138","12","2031","4438","0","45.76","19.85"
"67","000","00","330","0022","1163","539","190","349","3","542","1189","0","45.58","15.98"
"67","000","00","330","0022","1164","492","233","259","0","492","997","0","49.35","23.37"
"67","000","00","330","0022","1165","386","192","194","1","387","955","0","40.52","20.10"
"67","000","00","330","0022","1166","602","266","336","8","610","1297","0","47.03","20.51"
"67","000","00","330","0023","0000","1454","655","799","14","1468","3368","0","43.59","19.45"
"67","000","00","330","0023","1158","412","176","236","4","416","904","0","46.02","19.47"
"67","000","00","330","0023","1159","504","218","286","7","511","1245","0","41.04","17.51"
"67","000","00","330","0023","1160","538","261","277","3","541","1219","0","44.38","21.41"
"67","000","00","330","0024","0000","1502","1046","456","18","1520","3347","0","45.41","31.25"
"67","000","00","330","0024","1167","448","291","157","4","452","1065","0","42.44","27.32"
"67","000","00","330","0024","1168","551","424","127","5","556","1127","0","49.33","37.62"
"67","000","00","330","0024","1169","503","331","172","9","512","1155","0","44.33","28.66"
"67","000","00","330","0025","0000","1052","371","681","7","1059","2222","0","47.66","16.70"
"67","000","00","330","0025","1181","566","205","361","4","570","1195","0","47.70","17.15"
"67","000","00","330","0025","1182","486","166","320","3","489","1027","0","47.61","16.16"
"67","000","00","330","0026","0000","1436","418","1018","9","1445","3277","0","44.10","12.76"
"67","000","00","330","0026","1215","719","205","514","7","726","1567","0","46.33","13.08"
"67","000","00","330","0026","1216","717","213","504","2","719","1710","0","42.05","12.46"
"67","000","00","330","0027","0000","1488","566","922","6","1494","3213","0","46.50","17.62"
"67","000","00","330","0027","1187","490","180","310","2","492","1116","0","44.09","16.13"
"67","000","00","330","0027","1188","481","171","310","4","485","1041","0","46.59","16.43"
"67","000","00","330","0027","1189","517","215","302","0","517","1056","0","48.96","20.36"
"67","000","00","330","0028","0000","2115","776","1339","24","2139","4948","0","43.23","15.68"
"67","000","00","330","0028","1194","528","207","321","3","531","1249","0","42.51","16.57"
"67","000","00","330","0028","1195","514","169","345","11","525","1293","0","40.60","13.07"
"67","000","00","330","0028","1196","504","189","315","6","510","1192","0","42.79","15.86"
"67","000","00","330","0028","1197","569","211","358","4","573","1214","0","47.20","17.38"
"67","000","00","330","0029","0000","929","340","589","14","943","2683","0","35.15","12.67"
"67","000","00","330","0029","1223","503","173","330","8","511","1660","0","30.78","10.42"
"67","000","00","330","0029","1224","426","167","259","6","432","1023","0","42.23","16.32"
"67","000","00","330","0030","0000","2369","830","1539","14","2383","5627","0","42.35","14.75"
"67","000","00","330","0030","1227","680","280","400","4","684","1666","0","41.06","16.81"
"67","000","00","330","0030","1228","482","166","316","2","484","1166","0","41.51","14.24"
"67","000","00","330","0030","1229","548","174","374","3","551","1282","0","42.98","13.57"
"67","000","00","330","0030","1230","659","210","449","5","664","1513","0","43.89","13.88"
"67","000","00","330","0031","0000","656","225","431","5","661","1531","0","43.17","14.70"
"67","000","00","330","0031","1231","353","115","238","1","354","903","0","39.20","12.74"
"67","000","00","330","0031","1232","303","110","193","4","307","628","0","48.89","17.52"
"67","000","00","330","0032","0000","2307","733","1574","19","2326","5014","0","46.39","14.62"
"67","000","00","330","0032","1219","572","182","390","7","579","1210","0","47.85","15.04"
"67","000","00","330","0032","1220","517","181","336","6","523","1114","0","46.95","16.25"
"67","000","00","330","0032","1221","573","177","396","2","575","1241","0","46.33","14.26"
"67","000","00","330","0032","1222","645","193","452","4","649","1449","0","44.79","13.32"
"67","000","00","330","0033","0000","1556","536","1020","20","1576","3483","0","45.25","15.39"
"67","000","00","330","0033","1217","645","207","438","9","654","1472","0","44.43","14.06"
"67","000","00","330","0033","1218","911","329","582","11","922","2011","0","45.85","16.36"
"67","000","00","330","0034","0000","1927","699","1228","19","1946","4744","0","41.02","14.73"
"67","000","00","330","0034","1212","689","264","425","10","699","1720","0","40.64","15.35"
"67","000","00","330","0034","1213","618","230","388","4","622","1543","0","40.31","14.91"
"67","000","00","330","0034","1214","620","205","415","5","625","1481","0","42.20","13.84"
"67","000","00","330","0035","0000","2280","827","1453","12","2292","4978","0","46.04","16.61"
"67","000","00","330","0035","1190","466","168","298","2","468","1139","0","41.09","14.75"
"67","000","00","330","0035","1191","508","209","299","2","510","1152","0","44.27","18.14"
"67","000","00","330","0035","1192","693","253","440","2","695","1353","0","51.37","18.70"
"67","000","00","330","0035","1193","613","197","416","6","619","1334","0","46.40","14.77"
"67","000","00","330","0036","0000","686","230","456","7","693","1717","0","40.36","13.40"
"67","000","00","330","0036","1233","400","129","271","5","405","952","0","42.54","13.55"
"67","000","00","330","0036","1234","286","101","185","2","288","765","0","37.65","13.20"
"67","000","00","330","0037","0000","814","205","609","9","823","1752","0","46.97","11.70"
"67","000","00","330","0037","1245","501","105","396","7","508","1039","0","48.89","10.11"
"67","000","00","330","0037","1246","313","100","213","2","315","713","0","44.18","14.03"
"67","000","00","330","0038","0000","768","195","573","11","779","1700","0","45.82","11.47"
"67","000","00","330","0038","1243","414","99","315","5","419","963","0","43.51","10.28"
"67","000","00","330","0038","1244","354","96","258","6","360","737","0","48.85","13.03"
"67","000","00","330","0039","0000","980","335","645","6","986","2425","0","40.66","13.81"
"67","000","00","330","0039","1225","470","157","313","2","472","1193","0","39.56","13.16"
"67","000","00","330","0039","1226","510","178","332","4","514","1232","0","41.72","14.45"
"67","000","00","330","0040","0000","1669","505","1164","18","1687","3641","0","46.33","13.87"
"67","000","00","330","0040","1201","395","97","298","8","403","896","0","44.98","10.83"
"67","000","00","330","0040","1202","353","116","237","1","354","807","0","43.87","14.37"
"67","000","00","330","0040","1203","512","141","371","6","518","1025","0","50.54","13.76"
"67","000","00","330","0040","1204","409","151","258","3","412","913","0","45.13","16.54"
"67","000","00","340","0000","0000","48064","19691","28373","383","48447","109685","129057","44.17","17.95"
"67","000","00","340","0001","0000","1448","593","855","10","1458","3350","0","43.52","17.70"
"67","000","00","340","0001","0732","461","215","246","5","466","1150","0","40.52","18.70"
"67","000","00","340","0001","0733","511","190","321","4","515","1097","0","46.95","17.32"
"67","000","00","340","0001","0734","476","188","288","1","477","1103","0","43.25","17.04"
"67","000","00","340","0004","0000","935","493","442","6","941","1911","0","49.24","25.80"
"67","000","00","340","0004","0745","461","275","186","4","465","1003","0","46.36","27.42"
"67","000","00","340","0004","0746","474","218","256","2","476","908","0","52.42","24.01"
"67","000","00","340","0005","0000","1091","528","563","10","1101","2358","0","46.69","22.39"
"67","000","00","340","0005","0741","481","223","258","2","483","1160","0","41.64","19.22"
"67","000","00","340","0005","0742","610","305","305","8","618","1198","0","51.59","25.46"
"67","000","00","340","0007","0000","879","345","534","4","883","1929","0","45.78","17.88"
"67","000","00","340","0007","0750","426","165","261","2","428","931","0","45.97","17.72"
"67","000","00","340","0007","0751","453","180","273","2","455","998","0","45.59","18.04"
"67","000","00","340","0008","0000","1087","477","610","11","1098","2173","0","50.53","21.95"
"67","000","00","340","0008","0752","579","254","325","9","588","1135","0","51.81","22.38"
"67","000","00","340","0008","0753","508","223","285","2","510","1038","0","49.13","21.48"
"67","000","00","340","0018","0000","1679","531","1148","13","1692","4183","0","40.45","12.69"
"67","000","00","340","0018","0822","420","132","288","2","422","1018","0","41.45","12.97"
"67","000","00","340","0018","0823","374","100","274","3","377","1012","0","37.25","9.88"
"67","000","00","340","0018","0824","413","152","261","6","419","985","0","42.54","15.43"
"67","000","00","340","0018","0825","472","147","325","2","474","1168","0","40.58","12.59"
"67","000","00","340","0019","0000","879","425","454","8","887","1829","0","48.50","23.24"
"67","000","00","340","0019","0743","483","239","244","5","488","991","0","49.24","24.12"
"67","000","00","340","0019","0744","396","186","210","3","399","838","0","47.61","22.20"
"67","000","00","340","0020","0000","2206","971","1235","9","2215","4751","0","46.62","20.44"
"67","000","00","340","0020","0797","576","262","314","1","577","1250","0","46.16","20.96"
"67","000","00","340","0020","0798","498","288","210","2","500","1089","0","45.91","26.45"
"67","000","00","340","0020","0799","600","238","362","3","603","1298","0","46.46","18.34"
"67","000","00","340","0020","0800","532","183","349","3","535","1114","0","48.03","16.43"
"67","000","00","340","0023","0000","1379","449","930","16","1395","3128","0","44.60","14.35"
"67","000","00","340","0023","0780","497","171","326","3","500","1110","0","45.05","15.41"
"67","000","00","340","0023","0781","417","128","289","3","420","934","0","44.97","13.70"
"67","000","00","340","0023","0782","465","150","315","10","475","1084","0","43.82","13.84"
"67","000","00","340","0024","0000","1933","675","1258","11","1944","4481","0","43.38","15.06"
"67","000","00","340","0024","0783","688","222","466","2","690","1543","0","44.72","14.39"
"67","000","00","340","0024","0784","672","239","433","4","676","1545","0","43.75","15.47"
"67","000","00","340","0024","0785","573","214","359","5","578","1393","0","41.49","15.36"
"67","000","00","340","0025","0000","1439","523","916","15","1454","3391","0","42.88","15.42"
"67","000","00","340","0025","0811","437","151","286","8","445","1036","0","42.95","14.58"
"67","000","00","340","0025","0812","502","179","323","5","507","1277","0","39.70","14.02"
"67","000","00","340","0025","0813","500","193","307","2","502","1078","0","46.57","17.90"
"67","000","00","340","0026","0000","2374","882","1492","13","2387","5281","0","45.20","16.70"
"67","000","00","340","0026","0817","431","126","305","1","432","877","0","49.26","14.37"
"67","000","00","340","0026","0818","408","137","271","2","410","946","0","43.34","14.48"
"67","000","00","340","0026","0819","426","147","279","3","429","1020","0","42.06","14.41"
"67","000","00","340","0026","0820","504","231","273","2","506","1099","0","46.04","21.02"
"67","000","00","340","0026","0821","605","241","364","5","610","1339","0","45.56","18.00"
"67","000","00","340","0032","0000","655","276","379","6","661","1388","0","47.62","19.88"
"67","000","00","340","0032","0754","655","276","379","6","661","1388","0","47.62","19.88"
"67","000","00","340","0033","0000","812","385","427","13","825","1809","0","45.61","21.28"
"67","000","00","340","0033","0769","402","205","197","7","409","856","0","47.78","23.95"
"67","000","00","340","0033","0770","410","180","230","6","416","953","0","43.65","18.89"
"67","000","00","340","0038","0000","1605","705","900","5","1610","4041","0","39.84","17.45"
"67","000","00","340","0038","0735","626","275","351","1","627","1626","0","38.56","16.91"
"67","000","00","340","0038","0736","404","184","220","0","404","1037","0","38.96","17.74"
"67","000","00","340","0038","0737","575","246","329","4","579","1378","0","42.02","17.85"
"67","000","00","340","0039","0000","1357","578","779","13","1370","3012","0","45.48","19.19"
"67","000","00","340","0039","0755","672","318","354","9","681","1498","0","45.46","21.23"
"67","000","00","340","0039","0756","685","260","425","4","689","1514","0","45.51","17.17"
"67","000","00","340","0040","0000","1899","769","1130","19","1918","4329","0","44.31","17.76"
"67","000","00","340","0040","0793","507","189","318","2","509","1159","0","43.92","16.31"
"67","000","00","340","0040","0794","488","190","298","7","495","1121","0","44.16","16.95"
"67","000","00","340","0040","0795","503","219","284","6","509","1141","0","44.61","19.19"
"67","000","00","340","0040","0796","401","171","230","4","405","908","0","44.60","18.83"
"67","000","00","340","0041","0000","1326","489","837","8","1334","2933","0","45.48","16.67"
"67","000","00","340","0041","0805","471","182","289","2","473","1015","0","46.60","17.93"
"67","000","00","340","0041","0806","431","145","286","0","431","938","0","45.95","15.46"
"67","000","00","340","0041","0807","424","162","262","6","430","980","0","43.88","16.53"
"67","000","00","340","0042","0000","1548","471","1077","13","1561","3603","0","43.33","13.07"
"67","000","00","340","0042","0814","553","160","393","4","557","1249","0","44.60","12.81"
"67","000","00","340","0042","0815","540","166","374","4","544","1179","0","46.14","14.08"
"67","000","00","340","0042","0816","455","145","310","5","460","1175","0","39.15","12.34"
"67","000","00","340","0043","0000","1647","578","1069","12","1659","3566","0","46.52","16.21"
"67","000","00","340","0043","0826","546","188","358","4","550","1149","0","47.87","16.36"
"67","000","00","340","0043","0827","554","219","335","1","555","1268","0","43.77","17.27"
"67","000","00","340","0043","0828","547","171","376","7","554","1149","0","48.22","14.88"
"67","000","00","340","0044","0000","1703","1048","655","24","1727","3781","0","45.68","27.72"
"67","000","00","340","0044","0747","534","266","268","6","540","1193","0","45.26","22.30"
"67","000","00","340","0044","0748","580","440","140","12","592","1336","0","44.31","32.93"
"67","000","00","340","0044","0749","589","342","247","6","595","1252","0","47.52","27.32"
"67","000","00","340","0045","0000","1535","622","913","14","1549","3378","0","45.86","18.41"
"67","000","00","340","0045","0738","573","238","335","4","577","1275","0","45.25","18.67"
"67","000","00","340","0045","0739","482","194","288","5","487","1058","0","46.03","18.34"
"67","000","00","340","0045","0740","480","190","290","5","485","1045","0","46.41","18.18"
"67","000","00","340","0046","0000","2190","969","1221","20","2210","5163","0","42.80","18.77"
"67","000","00","340","0046","0757","391","208","183","1","392","989","0","39.64","21.03"
"67","000","00","340","0046","0758","471","260","211","5","476","1047","0","45.46","24.83"
"67","000","00","340","0046","0759","396","149","247","5","401","942","0","42.57","15.82"
"67","000","00","340","0046","0760","453","179","274","2","455","1038","0","43.83","17.24"
"67","000","00","340","0046","0761","479","173","306","7","486","1147","0","42.37","15.08"
"67","000","00","340","0047","0000","1589","601","988","20","1609","3826","0","42.05","15.71"
"67","000","00","340","0047","0776","377","143","234","9","386","924","0","41.77","15.48"
"67","000","00","340","0047","0777","370","127","243","5","375","831","0","45.13","15.28"
"67","000","00","340","0047","0778","401","176","225","0","401","923","0","43.45","19.07"
"67","000","00","340","0047","0779","441","155","286","6","447","1148","0","38.94","13.50"
"67","000","00","340","0048","0000","2036","1203","833","18","2054","4747","0","43.27","25.34"
"67","000","00","340","0048","0762","547","379","168","6","553","1284","0","43.07","29.52"
"67","000","00","340","0048","0763","441","316","125","4","445","1034","0","43.04","30.56"
"67","000","00","340","0048","0764","541","327","214","2","543","1318","0","41.20","24.81"
"67","000","00","340","0048","0765","507","181","326","6","513","1111","0","46.17","16.29"
"67","000","00","340","0049","0000","1260","522","738","14","1274","2929","0","43.50","17.82"
"67","000","00","340","0049","0766","408","152","256","2","410","966","0","42.44","15.73"
"67","000","00","340","0049","0767","454","189","265","6","460","993","0","46.32","19.03"
"67","000","00","340","0049","0768","398","181","217","6","404","970","0","41.65","18.66"
"67","000","00","340","0050","0000","1128","415","713","7","1135","2655","0","42.75","15.63"
"67","000","00","340","0050","0774","558","185","373","5","563","1250","0","45.04","14.80"
"67","000","00","340","0050","0775","570","230","340","2","572","1405","0","40.71","16.37"
"67","000","00","340","0051","0000","1460","525","935","12","1472","3987","0","36.92","13.17"
"67","000","00","340","0051","0771","536","182","354","4","540","1251","0","43.17","14.55"
"67","000","00","340","0051","0772","502","186","316","6","508","1230","0","41.30","15.12"
"67","000","00","340","0051","0773","422","157","265","2","424","1506","0","28.15","10.42"
"67","000","00","340","0052","0000","1566","565","1001","9","1575","3631","0","43.38","15.56"
"67","000","00","340","0052","0786","472","187","285","2","474","1081","0","43.85","17.30"
"67","000","00","340","0052","0787","673","244","429","4","677","1560","0","43.40","15.64"
"67","000","00","340","0052","0788","421","134","287","3","424","990","0","42.83","13.54"
"67","000","00","340","0053","0000","1959","798","1161","7","1966","4418","0","44.50","18.06"
"67","000","00","340","0053","0789","435","184","251","2","437","980","0","44.59","18.78"
"67","000","00","340","0053","0790","481","193","288","2","483","1137","0","42.48","16.97"
"67","000","00","340","0053","0791","511","207","304","1","512","1102","0","46.46","18.78"
"67","000","00","340","0053","0792","532","214","318","2","534","1199","0","44.54","17.85"
"67","000","00","340","0054","0000","1116","372","744","4","1120","2467","0","45.40","15.08"
"67","000","00","340","0054","0801","559","200","359","0","559","1343","0","41.62","14.89"
"67","000","00","340","0054","0802","557","172","385","4","561","1124","0","49.91","15.30"
"67","000","00","340","0055","0000","1016","416","600","8","1024","2258","0","45.35","18.42"
"67","000","00","340","0055","0803","482","216","266","3","485","1060","0","45.75","20.38"
"67","000","00","340","0055","0804","534","200","334","5","539","1198","0","44.99","16.69"
"67","000","00","340","0056","0000","1328","492","836","11","1339","2999","0","44.65","16.41"
"67","000","00","340","0056","0808","489","196","293","4","493","1033","0","47.73","18.97"
"67","000","00","340","0056","0809","399","163","236","5","404","936","0","43.16","17.41"
"67","000","00","340","0056","0810","440","133","307","2","442","1030","0","42.91","12.91"
"67","000","00","350","0000","0000","63598","20126","43472","518","64116","163001","196238","39.33","12.35"
"67","000","00","350","0001","0000","1136","385","751","8","1144","2798","0","40.89","13.76"
"67","000","00","350","0001","0591","549","181","368","5","554","1403","0","39.49","12.90"
"67","000","00","350","0001","0592","587","204","383","3","590","1395","0","42.29","14.62"
"67","000","00","350","0002","0000","1901","665","1236","24","1925","4730","0","40.70","14.06"
"67","000","00","350","0002","0605","446","158","288","12","458","1194","0","38.36","13.23"
"67","000","00","350","0002","0606","464","151","313","5","469","1181","0","39.71","12.79"
"67","000","00","350","0002","0607","525","177","348","3","528","1185","0","44.56","14.94"
"67","000","00","350","0002","0608","466","179","287","4","470","1170","0","40.17","15.30"
"67","000","00","350","0003","0000","1798","583","1215","12","1810","4668","0","38.77","12.49"
"67","000","00","350","0003","0593","450","148","302","6","456","1080","0","42.22","13.70"
"67","000","00","350","0003","0594","505","157","348","3","508","1247","0","40.74","12.59"
"67","000","00","350","0003","0595","408","129","279","1","409","1167","0","35.05","11.05"
"67","000","00","350","0003","0596","435","149","286","2","437","1174","0","37.22","12.69"
"67","000","00","350","0004","0000","1974","647","1327","17","1991","5017","0","39.69","12.90"
"67","000","00","350","0004","0597","491","170","321","2","493","1196","0","41.22","14.21"
"67","000","00","350","0004","0598","556","152","404","2","558","1371","0","40.70","11.09"
"67","000","00","350","0004","0599","506","188","318","10","516","1310","0","39.39","14.35"
"67","000","00","350","0004","0600","421","137","284","3","424","1140","0","37.19","12.02"
"67","000","00","350","0005","0000","1812","582","1230","15","1827","4446","0","41.09","13.09"
"67","000","00","350","0005","0601","464","157","307","4","468","1206","0","38.81","13.02"
"67","000","00","350","0005","0602","442","139","303","3","445","1100","0","40.45","12.64"
"67","000","00","350","0005","0603","475","122","353","2","477","1137","0","41.95","10.73"
"67","000","00","350","0005","0604","431","164","267","6","437","1003","0","43.57","16.35"
"67","000","00","350","0006","0000","1184","370","814","7","1191","2762","0","43.12","13.40"
"67","000","00","350","0006","0634","613","221","392","1","614","1454","0","42.23","15.20"
"67","000","00","350","0006","0635","571","149","422","6","577","1308","0","44.11","11.39"
"67","000","00","350","0007","0000","1439","458","981","13","1452","3488","0","41.63","13.13"
"67","000","00","350","0007","0627","505","138","367","5","510","1159","0","44.00","11.91"
"67","000","00","350","0007","0628","466","146","320","6","472","1197","0","39.43","12.20"
"67","000","00","350","0007","0629","468","174","294","2","470","1132","0","41.52","15.37"
"67","000","00","350","0008","0000","1871","545","1326","17","1888","4518","0","41.79","12.06"
"67","000","00","350","0008","0614","426","138","288","1","427","1187","0","35.97","11.63"
"67","000","00","350","0008","0615","451","152","299","5","456","1057","0","43.14","14.38"
"67","000","00","350","0008","0616","493","90","403","4","497","1141","0","43.56","7.89"
"67","000","00","350","0008","0617","501","165","336","7","508","1133","0","44.84","14.56"
"67","000","00","350","0009","0000","2500","765","1735","21","2521","6006","0","41.97","12.74"
"67","000","00","350","0009","0618","528","142","386","5","533","1198","0","44.49","11.85"
"67","000","00","350","0009","0619","495","140","355","5","500","1327","0","37.68","10.55"
"67","000","00","350","0009","0620","507","154","353","3","510","1258","0","40.54","12.24"
"67","000","00","350","0009","0621","496","175","321","5","501","1103","0","45.42","15.87"
"67","000","00","350","0009","0622","474","154","320","3","477","1120","0","42.59","13.75"
"67","000","00","350","0010","0000","2498","850","1648","15","2513","6119","0","41.07","13.89"
"67","000","00","350","0010","0609","457","161","296","4","461","1230","0","37.48","13.09"
"67","000","00","350","0010","0610","575","191","384","3","578","1421","0","40.68","13.44"
"67","000","00","350","0010","0611","557","207","350","4","561","1297","0","43.25","15.96"
"67","000","00","350","0010","0612","438","126","312","2","440","1090","0","40.37","11.56"
"67","000","00","350","0010","0613","471","165","306","2","473","1081","0","43.76","15.26"
"67","000","00","350","0011","0000","863","295","568","9","872","2171","0","40.17","13.59"
"67","000","00","350","0011","0654","492","170","322","3","495","1193","0","41.49","14.25"
"67","000","00","350","0011","0655","371","125","246","6","377","978","0","38.55","12.78"
"67","000","00","350","0012","0000","741","205","536","4","745","1811","0","41.14","11.32"
"67","000","00","350","0012","0662","373","97","276","3","376","938","0","40.09","10.34"
"67","000","00","350","0012","0663","368","108","260","1","369","873","0","42.27","12.37"
"67","000","00","350","0013","0000","1839","534","1305","8","1847","4706","0","39.25","11.35"
"67","000","00","350","0013","0656","499","153","346","1","500","1373","0","36.42","11.14"
"67","000","00","350","0013","0657","412","109","303","3","415","1040","0","39.90","10.48"
"67","000","00","350","0013","0658","453","131","322","1","454","1106","0","41.05","11.84"
"67","000","00","350","0013","0659","475","141","334","3","478","1187","0","40.27","11.88"
"67","000","00","350","0014","0000","459","127","332","3","462","1148","0","40.24","11.06"
"67","000","00","350","0014","0660","459","127","332","3","462","1148","0","40.24","11.06"
"67","000","00","350","0015","0000","2002","584","1418","10","2012","5528","0","36.40","10.56"
"67","000","00","350","0015","0647","410","112","298","0","410","1307","0","31.37","8.57"
"67","000","00","350","0015","0648","535","146","389","3","538","1446","0","37.21","10.10"
"67","000","00","350","0015","0649","518","165","353","5","523","1356","0","38.57","12.17"
"67","000","00","350","0015","0650","539","161","378","2","541","1419","0","38.13","11.35"
"67","000","00","350","0016","0000","1092","375","717","5","1097","2803","0","39.14","13.38"
"67","000","00","350","0016","0677","607","201","406","4","611","1502","0","40.68","13.38"
"67","000","00","350","0016","0678","485","174","311","1","486","1301","0","37.36","13.37"
"67","000","00","350","0017","0000","1002","311","691","8","1010","2365","0","42.71","13.15"
"67","000","00","350","0017","0712","540","156","384","1","541","1290","0","41.94","12.09"
"67","000","00","350","0017","0713","462","155","307","7","469","1075","0","43.63","14.42"
"67","000","00","350","0018","0000","2673","927","1746","26","2699","7823","0","34.50","11.85"
"67","000","00","350","0018","0679","487","172","315","6","493","1371","0","35.96","12.55"
"67","000","00","350","0018","0680","491","172","319","1","492","1272","0","38.68","13.52"
"67","000","00","350","0018","0681","451","144","307","7","458","1270","0","36.06","11.34"
"67","000","00","350","0018","0682","436","138","298","6","442","1342","0","32.94","10.28"
"67","000","00","350","0018","0683","529","205","324","3","532","1323","0","40.21","15.50"
"67","000","00","350","0018","0684","279","96","183","3","282","1245","0","22.65","7.71"
"67","000","00","350","0019","0000","649","274","375","10","659","1587","0","41.52","17.27"
"67","000","00","350","0019","0730","287","113","174","6","293","796","0","36.81","14.20"
"67","000","00","350","0019","0731","362","161","201","4","366","791","0","46.27","20.35"
"67","000","00","350","0020","0000","1711","520","1191","21","1732","4730","0","36.62","10.99"
"67","000","00","350","0020","0685","417","112","305","5","422","1260","0","33.49","8.89"
"67","000","00","350","0020","0686","392","98","294","6","398","1105","0","36.02","8.87"
"67","000","00","350","0020","0687","446","140","306","3","449","1135","0","39.56","12.33"
"67","000","00","350","0020","0688","456","170","286","7","463","1230","0","37.64","13.82"
"67","000","00","350","0021","0000","1149","361","788","9","1158","3591","0","32.25","10.05"
"67","000","00","350","0021","0674","421","127","294","4","425","1329","0","31.98","9.56"
"67","000","00","350","0021","0675","394","128","266","3","397","1283","0","30.94","9.98"
"67","000","00","350","0021","0676","334","106","228","2","336","979","0","34.32","10.83"
"67","000","00","350","0022","0000","1196","387","809","7","1203","3358","0","35.82","11.52"
"67","000","00","350","0022","0669","341","89","252","1","342","1040","0","32.88","8.56"
"67","000","00","350","0022","0670","367","117","250","4","371","1026","0","36.16","11.40"
"67","000","00","350","0022","0671","488","181","307","2","490","1292","0","37.93","14.01"
"67","000","00","350","0023","0000","717","219","498","4","721","2107","0","34.22","10.39"
"67","000","00","350","0023","0672","307","101","206","1","308","991","0","31.08","10.19"
"67","000","00","350","0023","0673","410","118","292","3","413","1116","0","37.01","10.57"
"67","000","00","350","0024","0000","446","137","309","4","450","1031","0","43.65","13.29"
"67","000","00","350","0024","0668","446","137","309","4","450","1031","0","43.65","13.29"
"67","000","00","350","0025","0000","645","158","487","8","653","1831","0","35.66","8.63"
"67","000","00","350","0025","0664","349","96","253","3","352","866","0","40.65","11.09"
"67","000","00","350","0025","0665","296","62","234","5","301","965","0","31.19","6.42"
"67","000","00","350","0026","0000","796","232","564","7","803","2484","0","32.33","9.34"
"67","000","00","350","0026","0666","370","126","244","3","373","1240","0","30.08","10.16"
"67","000","00","350","0026","0667","426","106","320","4","430","1244","0","34.57","8.52"
"67","000","00","350","0027","0000","524","186","338","5","529","1572","0","33.65","11.83"
"67","000","00","350","0027","0714","279","99","180","3","282","812","0","34.73","12.19"
"67","000","00","350","0027","0715","245","87","158","2","247","760","0","32.50","11.45"
"67","000","00","350","0028","0000","589","161","428","7","596","1569","0","37.99","10.26"
"67","000","00","350","0028","0721","347","88","259","1","348","905","0","38.45","9.72"
"67","000","00","350","0028","0722","242","73","169","6","248","664","0","37.35","10.99"
"67","000","00","350","0029","0000","403","144","259","2","405","1050","0","38.57","13.71"
"67","000","00","350","0029","0723","403","144","259","2","405","1050","0","38.57","13.71"
"67","000","00","350","0030","0000","1135","337","798","16","1151","3209","0","35.87","10.50"
"67","000","00","350","0030","0716","334","67","267","3","337","845","0","39.88","7.93"
"67","000","00","350","0030","0717","329","114","215","5","334","1010","0","33.07","11.29"
"67","000","00","350","0030","0718","472","156","316","8","480","1354","0","35.45","11.52"
"67","000","00","350","0031","0000","504","131","373","7","511","1442","0","35.44","9.08"
"67","000","00","350","0031","0720","504","131","373","7","511","1442","0","35.44","9.08"
"67","000","00","350","0032","0000","452","126","326","4","456","1507","0","30.26","8.36"
"67","000","00","350","0032","0719","452","126","326","4","456","1507","0","30.26","8.36"
"67","000","00","350","0033","0000","508","142","366","4","512","1292","0","39.63","10.99"
"67","000","00","350","0033","0724","237","57","180","3","240","597","0","40.20","9.55"
"67","000","00","350","0033","0725","271","85","186","1","272","695","0","39.14","12.23"
"67","000","00","350","0035","0000","280","114","166","5","285","888","0","32.09","12.84"
"67","000","00","350","0035","0727","280","114","166","5","285","888","0","32.09","12.84"
"67","000","00","350","0036","0000","740","248","492","3","743","1882","0","39.48","13.18"
"67","000","00","350","0036","0728","410","155","255","1","411","1021","0","40.25","15.18"
"67","000","00","350","0036","0729","330","93","237","2","332","861","0","38.56","10.80"
"67","000","00","350","0037","0000","892","254","638","6","898","2122","0","42.32","11.97"
"67","000","00","350","0037","0625","459","133","326","4","463","1145","0","40.44","11.62"
"67","000","00","350","0037","0626","433","121","312","2","435","977","0","44.52","12.38"
"67","000","00","350","0038","0000","1217","407","810","7","1224","2749","0","44.53","14.81"
"67","000","00","350","0038","0623","638","175","463","6","644","1394","0","46.20","12.55"
"67","000","00","350","0038","0624","579","232","347","1","580","1355","0","42.80","17.12"
"67","000","00","350","0039","0000","1879","648","1231","18","1897","4392","0","43.19","14.75"
"67","000","00","350","0039","0630","472","155","317","4","476","1089","0","43.71","14.23"
"67","000","00","350","0039","0631","509","171","338","5","514","1177","0","43.67","14.53"
"67","000","00","350","0039","0632","440","130","310","5","445","1073","0","41.47","12.12"
"67","000","00","350","0039","0633","458","192","266","4","462","1053","0","43.87","18.23"
"67","000","00","350","0040","0000","1240","366","874","10","1250","3015","0","41.46","12.14"
"67","000","00","350","0040","0692","433","139","294","4","437","1013","0","43.14","13.72"
"67","000","00","350","0040","0693","416","111","305","4","420","1038","0","40.46","10.69"
"67","000","00","350","0040","0694","391","116","275","2","393","964","0","40.77","12.03"
"67","000","00","350","0041","0000","1802","501","1301","9","1811","4278","0","42.33","11.71"
"67","000","00","350","0041","0695","592","167","425","3","595","1351","0","44.04","12.36"
"67","000","00","350","0041","0696","584","158","426","0","584","1418","0","41.18","11.14"
"67","000","00","350","0041","0697","626","176","450","6","632","1509","0","41.88","11.66"
"67","000","00","350","0042","0000","1555","425","1130","15","1570","3596","0","43.66","11.82"
"67","000","00","350","0042","0709","505","147","358","5","510","1151","0","44.31","12.77"
"67","000","00","350","0042","0710","516","139","377","7","523","1217","0","42.97","11.42"
"67","000","00","350","0042","0711","534","139","395","3","537","1228","0","43.73","11.32"
"67","000","00","350","0043","0000","1656","575","1081","14","1670","4402","0","37.94","13.06"
"67","000","00","350","0043","0636","624","223","401","6","630","1551","0","40.62","14.38"
"67","000","00","350","0043","0637","524","181","343","7","531","1483","0","35.81","12.20"
"67","000","00","350","0043","0638","508","171","337","1","509","1368","0","37.21","12.50"
"67","000","00","350","0044","0000","1616","546","1070","14","1630","4025","0","40.50","13.57"
"67","000","00","350","0044","0639","417","147","270","4","421","1057","0","39.83","13.91"
"67","000","00","350","0044","0640","476","152","324","2","478","1061","0","45.05","14.33"
"67","000","00","350","0044","0641","303","98","205","5","308","944","0","32.63","10.38"
"67","000","00","350","0044","0642","420","149","271","3","423","963","0","43.93","15.47"
"67","000","00","350","0045","0000","1910","552","1358","10","1920","4467","0","42.98","12.36"
"67","000","00","350","0045","0643","416","108","308","1","417","1115","0","37.40","9.69"
"67","000","00","350","0045","0644","481","134","347","2","483","1098","0","43.99","12.20"
"67","000","00","350","0045","0645","550","164","386","4","554","1253","0","44.21","13.09"
"67","000","00","350","0045","0646","463","146","317","3","466","1001","0","46.55","14.59"
"67","000","00","350","0046","0000","1623","567","1056","10","1633","3943","0","41.42","14.38"
"67","000","00","350","0046","0700","441","134","307","4","445","980","0","45.41","13.67"
"67","000","00","350","0046","0701","394","135","259","1","395","1034","0","38.20","13.06"
"67","000","00","350","0046","0702","406","152","254","4","410","999","0","41.04","15.22"
"67","000","00","350","0046","0703","382","146","236","1","383","930","0","41.18","15.70"
"67","000","00","350","0047","0000","1259","386","873","10","1269","3321","0","38.21","11.62"
"67","000","00","350","0047","0689","378","131","247","6","384","974","0","39.43","13.45"
"67","000","00","350","0047","0690","468","138","330","3","471","1227","0","38.39","11.25"
"67","000","00","350","0047","0691","413","117","296","1","414","1120","0","36.96","10.45"
"67","000","00","350","0048","0000","578","194","384","5","583","1480","0","39.39","13.11"
"67","000","00","350","0048","0661","578","194","384","5","583","1480","0","39.39","13.11"
"67","000","00","350","0049","0000","1142","363","779","14","1156","2718","0","42.53","13.36"
"67","000","00","350","0049","0698","481","134","347","5","486","1182","0","41.12","11.34"
"67","000","00","350","0049","0699","661","229","432","9","670","1536","0","43.62","14.91"
"67","000","00","350","0050","0000","2068","617","1451","15","2083","5393","0","38.62","11.44"
"67","000","00","350","0050","0704","350","73","277","4","354","1006","0","35.19","7.26"
"67","000","00","350","0050","0705","466","135","331","3","469","1235","0","37.98","10.93"
"67","000","00","350","0050","0706","450","164","286","4","454","1138","0","39.89","14.41"
"67","000","00","350","0050","0707","389","118","271","0","389","1094","0","35.56","10.79"
"67","000","00","350","0050","0708","413","127","286","4","417","920","0","45.33","13.80"
"67","000","00","350","0051","0000","1453","456","997","10","1463","3607","0","40.56","12.64"
"67","000","00","350","0051","0651","424","154","270","4","428","1076","0","39.78","14.31"
"67","000","00","350","0051","0652","501","155","346","3","504","1217","0","41.41","12.74"
"67","000","00","350","0051","0653","528","147","381","3","531","1314","0","40.41","11.19"
"67","000","00","350","0052","0000","480","184","296","6","486","1456","0","33.38","12.64"
"67","000","00","350","0052","0726","480","184","296","6","486","1456","0","33.38","12.64"
"67","000","00","360","0000","0000","23023","9143","13880","152","23175","56716","67297","40.86","16.12"
"67","000","00","360","0002","0000","821","344","477","8","829","2012","0","41.20","17.10"
"67","000","00","360","0002","1099","322","117","205","4","326","895","0","36.42","13.07"
"67","000","00","360","0002","1100","499","227","272","4","503","1117","0","45.03","20.32"
"67","000","00","360","0004","0000","197","63","134","3","200","435","0","45.98","14.48"
"67","000","00","360","0004","1091","197","63","134","3","200","435","0","45.98","14.48"
"67","000","00","360","0005","0000","2097","817","1280","12","2109","5116","0","41.22","15.97"
"67","000","00","360","0005","1061","479","207","272","2","481","1243","0","38.70","16.65"
"67","000","00","360","0005","1062","513","193","320","5","518","1165","0","44.46","16.57"
"67","000","00","360","0005","1063","532","193","339","2","534","1312","0","40.70","14.71"
"67","000","00","360","0005","1064","573","224","349","3","576","1396","0","41.26","16.05"
"67","000","00","360","0006","0000","1683","669","1014","6","1689","4196","0","40.25","15.94"
"67","000","00","360","0006","1065","566","236","330","2","568","1458","0","38.96","16.19"
"67","000","00","360","0006","1066","552","215","337","2","554","1385","0","40.00","15.52"
"67","000","00","360","0006","1067","565","218","347","2","567","1353","0","41.91","16.11"
"67","000","00","360","0007","0000","2014","810","1204","13","2027","4827","0","41.99","16.78"
"67","000","00","360","0007","1068","532","228","304","5","537","1199","0","44.79","19.02"
"67","000","00","360","0007","1069","460","172","288","3","463","1233","0","37.55","13.95"
"67","000","00","360","0007","1070","500","216","284","0","500","1210","0","41.32","17.85"
"67","000","00","360","0007","1071","522","194","328","5","527","1185","0","44.47","16.37"
"67","000","00","360","0008","0000","2713","1082","1631","18","2731","7232","0","37.76","14.96"
"67","000","00","360","0008","1072","485","182","303","5","490","1482","0","33.06","12.28"
"67","000","00","360","0008","1073","575","234","341","2","577","1402","0","41.16","16.69"
"67","000","00","360","0008","1074","475","181","294","3","478","1393","0","34.31","12.99"
"67","000","00","360","0008","1075","565","217","348","4","569","1476","0","38.55","14.70"
"67","000","00","360","0008","1076","613","268","345","4","617","1479","0","41.72","18.12"
"67","000","00","360","0009","0000","2255","953","1302","15","2270","5000","0","45.40","19.06"
"67","000","00","360","0009","1057","525","200","325","2","527","1130","0","46.64","17.70"
"67","000","00","360","0009","1058","509","214","295","3","512","1153","0","44.41","18.56"
"67","000","00","360","0009","1059","585","256","329","4","589","1353","0","43.53","18.92"
"67","000","00","360","0009","1060","636","283","353","6","642","1364","0","47.07","20.75"
"67","000","00","360","0010","0000","3062","1264","1798","17","3079","7593","0","40.55","16.65"
"67","000","00","360","0010","1085","607","236","371","2","609","1345","0","45.28","17.55"
"67","000","00","360","0010","1086","567","240","327","1","568","1244","0","45.66","19.29"
"67","000","00","360","0010","1087","505","221","284","4","509","1252","0","40.65","17.65"
"67","000","00","360","0010","1088","556","243","313","3","559","1307","0","42.77","18.59"
"67","000","00","360","0010","1089","452","174","278","4","456","1202","0","37.94","14.48"
"67","000","00","360","0010","1090","375","150","225","3","378","1243","0","30.41","12.07"
"67","000","00","360","0011","0000","2959","1319","1640","24","2983","7951","0","37.52","16.59"
"67","000","00","360","0011","1079","474","193","281","11","485","1364","0","35.56","14.15"
"67","000","00","360","0011","1080","535","252","283","5","540","1300","0","41.54","19.38"
"67","000","00","360","0011","1081","508","240","268","0","508","1333","0","38.11","18.00"
"67","000","00","360","0011","1082","462","210","252","2","464","1286","0","36.08","16.33"
"67","000","00","360","0011","1083","526","223","303","2","528","1379","0","38.29","16.17"
"67","000","00","360","0011","1084","454","201","253","4","458","1289","0","35.53","15.59"
"67","000","00","360","0012","0000","1308","501","807","8","1316","3031","0","43.42","16.53"
"67","000","00","360","0012","1077","654","261","393","5","659","1510","0","43.64","17.28"
"67","000","00","360","0012","1078","654","240","414","3","657","1521","0","43.20","15.78"
"67","000","00","360","0015","0000","1447","497","950","11","1458","3301","0","44.17","15.06"
"67","000","00","360","0015","1092","757","274","483","6","763","1666","0","45.80","16.45"
"67","000","00","360","0015","1093","690","223","467","5","695","1635","0","42.51","13.64"
"67","000","00","360","0016","0000","1384","458","926","11","1395","3261","0","42.78","14.04"
"67","000","00","360","0016","1094","486","191","295","5","491","1105","0","44.43","17.29"
"67","000","00","360","0016","1095","431","133","298","4","435","1093","0","39.80","12.17"
"67","000","00","360","0016","1096","467","134","333","2","469","1063","0","44.12","12.61"
"67","000","00","360","0017","0000","1083","366","717","6","1089","2761","0","39.44","13.26"
"67","000","00","360","0017","1097","557","201","356","4","561","1383","0","40.56","14.53"
"67","000","00","360","0017","1098","526","165","361","2","528","1378","0","38.32","11.97"
"67","000","00","370","0000","0000","28895","10663","18232","213","29108","64466","78163","45.15","16.54"
"67","000","00","370","0005","0000","1659","580","1079","10","1669","3653","0","45.69","15.88"
"67","000","00","370","0005","1101","544","186","358","1","545","1290","0","42.25","14.42"
"67","000","00","370","0005","1102","595","223","372","5","600","1182","0","50.76","18.87"
"67","000","00","370","0005","1103","520","171","349","4","524","1181","0","44.37","14.48"
"67","000","00","370","0007","0000","1325","537","788","12","1337","3036","0","44.04","17.69"
"67","000","00","370","0007","1104","672","293","379","6","678","1552","0","43.69","18.88"
"67","000","00","370","0007","1105","653","244","409","6","659","1484","0","44.41","16.44"
"67","000","00","370","0009","0000","1238","527","711","9","1247","2678","0","46.56","19.68"
"67","000","00","370","0009","1106","600","233","367","5","605","1315","0","46.01","17.72"
"67","000","00","370","0009","1107","638","294","344","4","642","1363","0","47.10","21.57"
"67","000","00","370","0011","0000","1001","321","680","9","1010","2406","0","41.98","13.34"
"67","000","00","370","0011","1108","510","156","354","4","514","1251","0","41.09","12.47"
"67","000","00","370","0011","1109","491","165","326","5","496","1155","0","42.94","14.29"
"67","000","00","370","0016","0000","1132","430","702","12","1144","2516","0","45.47","17.09"
"67","000","00","370","0016","1110","573","226","347","9","582","1280","0","45.47","17.66"
"67","000","00","370","0016","1111","559","204","355","3","562","1236","0","45.47","16.50"
"67","000","00","370","0022","0000","1468","488","980","14","1482","3287","0","45.09","14.85"
"67","000","00","370","0022","1112","329","115","214","4","333","762","0","43.70","15.09"
"67","000","00","370","0022","1113","421","113","308","4","425","936","0","45.41","12.07"
"67","000","00","370","0022","1114","368","136","232","5","373","797","0","46.80","17.06"
"67","000","00","370","0022","1115","350","124","226","1","351","792","0","44.32","15.66"
"67","000","00","370","0025","0000","1624","537","1087","9","1633","3479","0","46.94","15.44"
"67","000","00","370","0025","1116","465","140","325","4","469","1026","0","45.71","13.65"
"67","000","00","370","0025","1117","543","173","370","2","545","1149","0","47.43","15.06"
"67","000","00","370","0025","1118","616","224","392","3","619","1304","0","47.47","17.18"
"67","000","00","370","0031","0000","1122","430","692","11","1133","2515","0","45.05","17.10"
"67","000","00","370","0031","1119","572","212","360","2","574","1289","0","44.53","16.45"
"67","000","00","370","0031","1120","550","218","332","9","559","1226","0","45.60","17.78"
"67","000","00","370","0033","0000","2628","1104","1524","25","2653","5665","0","46.83","19.49"
"67","000","00","370","0033","1121","713","327","386","5","718","1410","0","50.92","23.19"
"67","000","00","370","0033","1122","647","242","405","8","655","1394","0","46.99","17.36"
"67","000","00","370","0033","1123","690","307","383","7","697","1615","0","43.16","19.01"
"67","000","00","370","0033","1124","578","228","350","5","583","1246","0","46.79","18.30"
"67","000","00","370","0034","0000","2326","935","1391","19","2345","4932","0","47.55","18.96"
"67","000","00","370","0034","1125","620","247","373","6","626","1306","0","47.93","18.91"
"67","000","00","370","0034","1126","571","229","342","4","575","1190","0","48.32","19.24"
"67","000","00","370","0034","1127","550","206","344","7","557","1193","0","46.69","17.27"
"67","000","00","370","0034","1128","585","253","332","2","587","1243","0","47.22","20.35"
"67","000","00","370","0039","0000","1652","564","1088","9","1661","3667","0","45.30","15.38"
"67","000","00","370","0039","1129","365","137","228","2","367","870","0","42.18","15.75"
"67","000","00","370","0039","1130","399","116","283","3","402","863","0","46.58","13.44"
"67","000","00","370","0039","1131","453","178","275","0","453","1038","0","43.64","17.15"
"67","000","00","370","0039","1132","435","133","302","4","439","896","0","49.00","14.84"
"67","000","00","370","0040","0000","1374","464","910","3","1377","3143","0","43.81","14.76"
"67","000","00","370","0040","1133","482","163","319","0","482","1100","0","43.82","14.82"
"67","000","00","370","0040","1134","484","165","319","1","485","1073","0","45.20","15.38"
"67","000","00","370","0040","1135","408","136","272","2","410","970","0","42.27","14.02"
"67","000","00","370","0041","0000","1179","522","657","8","1187","2478","0","47.90","21.07"
"67","000","00","370","0041","1136","598","305","293","4","602","1252","0","48.08","24.36"
"67","000","00","370","0041","1137","581","217","364","4","585","1226","0","47.72","17.70"
"67","000","00","370","0042","0000","1347","569","778","8","1355","3070","0","44.14","18.53"
"67","000","00","370","0042","1138","480","221","259","2","482","1116","0","43.19","19.80"
"67","000","00","370","0042","1139","476","200","276","2","478","1067","0","44.80","18.74"
"67","000","00","370","0042","1140","391","148","243","4","395","887","0","44.53","16.69"
"67","000","00","370","0043","0000","874","306","568","6","880","1972","0","44.62","15.52"
"67","000","00","370","0043","1141","436","138","298","1","437","1061","0","41.19","13.01"
"67","000","00","370","0043","1142","438","168","270","5","443","911","0","48.63","18.44"
"67","000","00","370","0044","0000","1570","480","1090","16","1586","3846","0","41.24","12.48"
"67","000","00","370","0044","1143","478","150","328","8","486","1403","0","34.64","10.69"
"67","000","00","370","0044","1144","522","149","373","3","525","1199","0","43.79","12.43"
"67","000","00","370","0044","1145","570","181","389","5","575","1244","0","46.22","14.55"
"67","000","00","370","0045","0000","1071","381","690","2","1073","2485","0","43.18","15.33"
"67","000","00","370","0045","1146","566","177","389","1","567","1274","0","44.51","13.89"
"67","000","00","370","0045","1147","505","204","301","1","506","1211","0","41.78","16.85"
"67","000","00","370","0046","0000","831","273","558","4","835","1878","0","44.46","14.54"
"67","000","00","370","0046","1148","441","121","320","1","442","982","0","45.01","12.32"
"67","000","00","370","0046","1149","390","152","238","3","393","896","0","43.86","16.96"
"67","000","00","370","0047","0000","1701","564","1137","11","1712","3913","0","43.75","14.41"
"67","000","00","370","0047","1150","485","169","316","4","489","1072","0","45.62","15.76"
"67","000","00","370","0047","1151","408","134","274","3","411","855","0","48.07","15.67"
"67","000","00","370","0047","1152","414","140","274","1","415","1021","0","40.65","13.71"
"67","000","00","370","0047","1153","394","121","273","3","397","965","0","41.14","12.54"
"67","000","00","370","0048","0000","1773","651","1122","16","1789","3847","0","46.50","16.92"
"67","000","00","370","0048","1154","394","103","291","6","400","887","0","45.10","11.61"
"67","000","00","370","0048","1155","544","183","361","5","549","1144","0","47.99","16.00"
"67","000","00","370","0048","1156","476","208","268","3","479","1001","0","47.85","20.78"
"67","000","00","370","0048","1157","359","157","202","2","361","815","0","44.29","19.26"
"64","000","00","000","0000","0000","986618","388792","597826","7917","994535","2353773","2755491","42.25","16.52"
"64","000","00","010","0000","0000","9918","3545","6373","80","9998","20951","23272","47.72","16.92"
"64","000","00","010","0001","0000","628","197","431","5","633","1261","0","50.20","15.62"
"64","000","00","010","0001","1297","628","197","431","5","633","1261","0","50.20","15.62"
"64","000","00","010","0002","0000","156","50","106","0","156","321","0","48.60","15.58"
"64","000","00","010","0002","1298","156","50","106","0","156","321","0","48.60","15.58"
"64","000","00","010","0003","0000","326","102","224","5","331","626","0","52.88","16.29"
"64","000","00","010","0003","1299","326","102","224","5","331","626","0","52.88","16.29"
"64","000","00","010","0004","0000","541","237","304","5","546","1222","0","44.68","19.39"
"64","000","00","010","0004","1300","541","237","304","5","546","1222","0","44.68","19.39"
"64","000","00","010","0005","0000","593","244","349","10","603","1240","0","48.63","19.68"
"64","000","00","010","0005","1301","593","244","349","10","603","1240","0","48.63","19.68"
"64","000","00","010","0006","0000","929","357","572","7","936","1941","0","48.22","18.39"
"64","000","00","010","0006","1302","410","167","243","3","413","830","0","49.76","20.12"
"64","000","00","010","0006","1303","519","190","329","4","523","1111","0","47.07","17.10"
"64","000","00","010","0007","0000","415","171","244","0","415","805","0","51.55","21.24"
"64","000","00","010","0007","1304","415","171","244","0","415","805","0","51.55","21.24"
"64","000","00","010","0008","0000","299","97","202","3","302","569","0","53.08","17.05"
"64","000","00","010","0008","1305","299","97","202","3","302","569","0","53.08","17.05"
"64","000","00","010","0009","0000","582","189","393","3","585","1394","0","41.97","13.56"
"64","000","00","010","0009","1306","582","189","393","3","585","1394","0","41.97","13.56"
"64","000","00","010","0010","0000","360","128","232","3","363","733","0","49.52","17.46"
"64","000","00","010","0010","1307","360","128","232","3","363","733","0","49.52","17.46"
"64","000","00","010","0011","0000","782","298","484","9","791","1581","0","50.03","18.85"
"64","000","00","010","0011","1308","370","136","234","5","375","801","0","46.82","16.98"
"64","000","00","010","0011","1309","412","162","250","4","416","780","0","53.33","20.77"
"64","000","00","010","0012","0000","332","97","235","2","334","721","0","46.32","13.45"
"64","000","00","010","0012","1310","332","97","235","2","334","721","0","46.32","13.45"
"64","000","00","010","0013","0000","424","152","272","2","426","935","0","45.56","16.26"
"64","000","00","010","0013","1311","424","152","272","2","426","935","0","45.56","16.26"
"64","000","00","010","0014","0000","499","163","336","5","504","1042","0","48.37","15.64"
"64","000","00","010","0014","1312","499","163","336","5","504","1042","0","48.37","15.64"
"64","000","00","010","0015","0000","487","167","320","3","490","1023","0","47.90","16.32"
"64","000","00","010","0015","1313","487","167","320","3","490","1023","0","47.90","16.32"
"64","000","00","010","0016","0000","377","149","228","4","381","775","0","49.16","19.23"
"64","000","00","010","0016","1314","377","149","228","4","381","775","0","49.16","19.23"
"64","000","00","010","0017","0000","864","322","542","4","868","1989","0","43.64","16.19"
"64","000","00","010","0017","1315","476","180","296","2","478","1046","0","45.70","17.21"
"64","000","00","010","0017","1316","388","142","246","2","390","943","0","41.36","15.06"
"64","000","00","010","0018","0000","513","185","328","3","516","1114","0","46.32","16.61"
"64","000","00","010","0018","1317","513","185","328","3","516","1114","0","46.32","16.61"
"64","000","00","010","0019","0000","278","92","186","1","279","547","0","51.01","16.82"
"64","000","00","010","0019","1318","278","92","186","1","279","547","0","51.01","16.82"
"64","000","00","010","0020","0000","271","100","171","4","275","543","0","50.64","18.42"
"64","000","00","010","0020","1319","271","100","171","4","275","543","0","50.64","18.42"
"64","000","00","010","0021","0000","262","48","214","2","264","569","0","46.40","8.44"
"64","000","00","010","0021","1320","262","48","214","2","264","569","0","46.40","8.44"
"64","000","00","020","0000","0000","50717","21900","28817","336","51053","116097","141101","43.97","18.86"
"64","000","00","020","0001","0000","844","462","382","8","852","1923","0","44.31","24.02"
"64","000","00","020","0001","1214","418","239","179","5","423","953","0","44.39","25.08"
"64","000","00","020","0001","1215","426","223","203","3","429","970","0","44.23","22.99"
"64","000","00","020","0002","0000","821","529","292","10","831","1924","0","43.19","27.49"
"64","000","00","020","0002","1216","359","247","112","7","366","881","0","41.54","28.04"
"64","000","00","020","0002","1217","462","282","180","3","465","1043","0","44.58","27.04"
"64","000","00","020","0003","0000","1951","966","985","11","1962","4040","0","48.56","23.91"
"64","000","00","020","0003","1218","712","296","416","3","715","1453","0","49.21","20.37"
"64","000","00","020","0003","1219","658","333","325","4","662","1382","0","47.90","24.10"
"64","000","00","020","0003","1220","581","337","244","4","585","1205","0","48.55","27.97"
"64","000","00","020","0004","0000","1551","454","1097","17","1568","3318","0","47.26","13.68"
"64","000","00","020","0004","1221","470","133","337","5","475","1026","0","46.30","12.96"
"64","000","00","020","0004","1222","524","163","361","7","531","1149","0","46.21","14.19"
"64","000","00","020","0004","1223","557","158","399","5","562","1143","0","49.17","13.82"
"64","000","00","020","0005","0000","640","233","407","4","644","1257","0","51.23","18.54"
"64","000","00","020","0005","1224","640","233","407","4","644","1257","0","51.23","18.54"
"64","000","00","020","0006","0000","481","148","333","7","488","1072","0","45.52","13.81"
"64","000","00","020","0006","1225","481","148","333","7","488","1072","0","45.52","13.81"
"64","000","00","020","0007","0000","1085","425","660","5","1090","2405","0","45.32","17.67"
"64","000","00","020","0007","1226","548","201","347","2","550","1167","0","47.13","17.22"
"64","000","00","020","0007","1227","537","224","313","3","540","1238","0","43.62","18.09"
"64","000","00","020","0008","0000","1549","617","932","14","1563","3652","0","42.80","16.89"
"64","000","00","020","0008","1228","554","232","322","4","558","1259","0","44.32","18.43"
"64","000","00","020","0008","1229","447","158","289","6","453","1194","0","37.94","13.23"
"64","000","00","020","0008","1230","548","227","321","4","552","1199","0","46.04","18.93"
"64","000","00","020","0009","0000","374","343","31","1","375","703","0","53.34","48.79"
"64","000","00","020","0009","1231","374","343","31","1","375","703","0","53.34","48.79"
"64","000","00","020","0010","0000","519","196","323","3","522","1210","0","43.14","16.20"
"64","000","00","020","0010","1232","519","196","323","3","522","1210","0","43.14","16.20"
"64","000","00","020","0011","0000","860","264","596","5","865","1928","0","44.87","13.69"
"64","000","00","020","0011","1233","860","264","596","5","865","1928","0","44.87","13.69"
"64","000","00","020","0012","0000","1604","533","1071","7","1611","3346","0","48.15","15.93"
"64","000","00","020","0012","1234","797","258","539","3","800","1689","0","47.37","15.28"
"64","000","00","020","0012","1235","807","275","532","4","811","1657","0","48.94","16.60"
"64","000","00","020","0013","0000","1216","419","797","6","1222","2539","0","48.13","16.50"
"64","000","00","020","0013","1236","609","201","408","3","612","1243","0","49.24","16.17"
"64","000","00","020","0013","1237","607","218","389","3","610","1296","0","47.07","16.82"
"64","000","00","020","0014","0000","1359","457","902","8","1367","2970","0","46.03","15.39"
"64","000","00","020","0014","1238","574","213","361","6","580","1219","0","47.58","17.47"
"64","000","00","020","0014","1239","785","244","541","2","787","1751","0","44.95","13.93"
"64","000","00","020","0015","0000","6604","2888","3716","38","6642","15526","0","42.78","18.60"
"64","000","00","020","0015","1240","645","328","317","5","650","1435","0","45.30","22.86"
"64","000","00","020","0015","1241","647","256","391","7","654","1489","0","43.92","17.19"
"64","000","00","020","0015","1242","678","251","427","4","682","1517","0","44.96","16.55"
"64","000","00","020","0015","1243","666","315","351","4","670","1608","0","41.67","19.59"
"64","000","00","020","0015","1244","662","269","393","2","664","1581","0","42.00","17.01"
"64","000","00","020","0015","1245","631","326","305","3","634","1613","0","39.31","20.21"
"64","000","00","020","0015","1246","641","298","343","0","641","1582","0","40.52","18.84"
"64","000","00","020","0015","1247","706","278","428","4","710","1553","0","45.72","17.90"
"64","000","00","020","0015","1248","705","292","413","5","710","1620","0","43.83","18.02"
"64","000","00","020","0015","1249","623","275","348","4","627","1528","0","41.03","18.00"
"64","000","00","020","0016","0000","9776","4466","5310","52","9828","22850","0","43.01","19.54"
"64","000","00","020","0016","1250","670","287","383","2","672","1607","0","41.82","17.86"
"64","000","00","020","0016","1251","755","350","405","2","757","1869","0","40.50","18.73"
"64","000","00","020","0016","1252","879","447","432","2","881","2030","0","43.40","22.02"
"64","000","00","020","0016","1253","704","347","357","3","707","1661","0","42.56","20.89"
"64","000","00","020","0016","1254","760","312","448","8","768","1840","0","41.74","16.96"
"64","000","00","020","0016","1255","801","354","447","1","802","1856","0","43.21","19.07"
"64","000","00","020","0016","1256","721","312","409","4","725","1683","0","43.08","18.54"
"64","000","00","020","0016","1257","742","388","354","2","744","1710","0","43.51","22.69"
"64","000","00","020","0016","1258","824","381","443","7","831","1799","0","46.19","21.18"
"64","000","00","020","0016","1259","800","321","479","6","806","1880","0","42.87","17.07"
"64","000","00","020","0016","1260","727","336","391","3","730","1623","0","44.98","20.70"
"64","000","00","020","0016","1261","694","297","397","9","703","1642","0","42.81","18.09"
"64","000","00","020","0016","1262","699","334","365","3","702","1650","0","42.55","20.24"
"64","000","00","020","0017","0000","6796","3365","3431","27","6823","16357","0","41.71","20.57"
"64","000","00","020","0017","1263","647","327","320","3","650","1658","0","39.20","19.72"
"64","000","00","020","0017","1264","717","338","379","3","720","1699","0","42.38","19.89"
"64","000","00","020","0017","1265","656","346","310","0","656","1621","0","40.47","21.34"
"64","000","00","020","0017","1266","686","338","348","4","690","1733","0","39.82","19.50"
"64","000","00","020","0017","1267","691","340","351","5","696","1643","0","42.36","20.69"
"64","000","00","020","0017","1268","694","284","410","3","697","1562","0","44.62","18.18"
"64","000","00","020","0017","1269","675","328","347","3","678","1672","0","40.55","19.62"
"64","000","00","020","0017","1270","696","349","347","4","700","1574","0","44.47","22.17"
"64","000","00","020","0017","1271","680","390","290","0","680","1590","0","42.77","24.53"
"64","000","00","020","0017","1272","654","325","329","2","656","1605","0","40.87","20.25"
"64","000","00","020","0018","0000","1648","834","814","9","1657","3836","0","43.20","21.74"
"64","000","00","020","0018","1273","769","398","371","6","775","1830","0","42.35","21.75"
"64","000","00","020","0018","1274","879","436","443","3","882","2006","0","43.97","21.73"
"64","000","00","020","0019","0000","1425","740","685","10","1435","3144","0","45.64","23.54"
"64","000","00","020","0019","1275","700","394","306","4","704","1540","0","45.71","25.58"
"64","000","00","020","0019","1276","725","346","379","6","731","1604","0","45.57","21.57"
"64","000","00","020","0020","0000","1141","675","466","10","1151","2453","0","46.92","27.52"
"64","000","00","020","0020","1277","507","281","226","6","513","1102","0","46.55","25.50"
"64","000","00","020","0020","1278","634","394","240","4","638","1351","0","47.22","29.16"
"64","000","00","020","0021","0000","477","155","322","5","482","1125","0","42.84","13.78"
"64","000","00","020","0021","1279","477","155","322","5","482","1125","0","42.84","13.78"
"64","000","00","020","0022","0000","565","170","395","4","569","1113","0","51.12","15.27"
"64","000","00","020","0022","1280","565","170","395","4","569","1113","0","51.12","15.27"
"64","000","00","020","0023","0000","520","183","337","4","524","1920","0","27.29","9.53"
"64","000","00","020","0023","1281","520","183","337","4","524","1920","0","27.29","9.53"
"64","000","00","020","0024","0000","559","203","356","6","565","1241","0","45.53","16.36"
"64","000","00","020","0024","1282","559","203","356","6","565","1241","0","45.53","16.36"
"64","000","00","020","0025","0000","533","211","322","2","535","1207","0","44.32","17.48"
"64","000","00","020","0025","1283","533","211","322","2","535","1207","0","44.32","17.48"
"64","000","00","020","0026","0000","604","260","344","6","610","1306","0","46.71","19.91"
"64","000","00","020","0026","1284","604","260","344","6","610","1306","0","46.71","19.91"
"64","000","00","020","0027","0000","556","220","336","6","562","1301","0","43.20","16.91"
"64","000","00","020","0027","1285","556","220","336","6","562","1301","0","43.20","16.91"
"64","000","00","020","0028","0000","615","204","411","5","620","1361","0","45.55","14.99"
"64","000","00","020","0028","1286","615","204","411","5","620","1361","0","45.55","14.99"
"64","000","00","020","0029","0000","255","97","158","3","258","605","0","42.64","16.03"
"64","000","00","020","0029","1287","255","97","158","3","258","605","0","42.64","16.03"
"64","000","00","020","0030","0000","353","99","254","5","358","778","0","46.02","12.72"
"64","000","00","020","0030","1288","353","99","254","5","358","778","0","46.02","12.72"
"64","000","00","020","0031","0000","415","141","274","9","424","928","0","45.69","15.19"
"64","000","00","020","0031","1289","415","141","274","9","424","928","0","45.69","15.19"
"64","000","00","020","0032","0000","421","112","309","2","423","955","0","44.29","11.73"
"64","000","00","020","0032","1290","421","112","309","2","423","955","0","44.29","11.73"
"64","000","00","020","0033","0000","362","99","263","4","366","715","0","51.19","13.85"
"64","000","00","020","0033","1291","362","99","263","4","366","715","0","51.19","13.85"
"64","000","00","020","0034","0000","576","190","386","5","581","1190","0","48.82","15.97"
"64","000","00","020","0034","1292","576","190","386","5","581","1190","0","48.82","15.97"
"64","000","00","020","0035","0000","473","136","337","4","477","1102","0","43.28","12.34"
"64","000","00","020","0035","1293","473","136","337","4","477","1102","0","43.28","12.34"
"64","000","00","020","0036","0000","527","144","383","5","532","1307","0","40.70","11.02"
"64","000","00","020","0036","1294","527","144","383","5","532","1307","0","40.70","11.02"
"64","000","00","020","0037","0000","428","179","249","4","432","963","0","44.86","18.59"
"64","000","00","020","0037","1295","428","179","249","4","432","963","0","44.86","18.59"
"64","000","00","020","0038","0000","234","83","151","5","239","527","0","45.35","15.75"
"64","000","00","020","0038","1296","234","83","151","5","239","527","0","45.35","15.75"
"64","000","00","030","0000","0000","69524","33481","36043","533","70057","164087","196916","42.70","20.40"
"64","000","00","030","0001","0000","647","315","332","6","653","2636","0","24.77","11.95"
"64","000","00","030","0001","0651","242","127","115","3","245","1669","0","14.68","7.61"
"64","000","00","030","0001","0652","405","188","217","3","408","967","0","42.19","19.44"
"64","000","00","030","0002","0000","476","151","325","5","481","973","0","49.43","15.52"
"64","000","00","030","0002","0653","476","151","325","5","481","973","0","49.43","15.52"
"64","000","00","030","0003","0000","271","98","173","3","274","512","0","53.52","19.14"
"64","000","00","030","0003","0654","271","98","173","3","274","512","0","53.52","19.14"
"64","000","00","030","0004","0000","300","63","237","4","304","603","0","50.41","10.45"
"64","000","00","030","0004","0655","300","63","237","4","304","603","0","50.41","10.45"
"64","000","00","030","0005","0000","244","63","181","1","245","496","0","49.40","12.70"
"64","000","00","030","0005","0656","244","63","181","1","245","496","0","49.40","12.70"
"64","000","00","030","0006","0000","409","87","322","3","412","799","0","51.56","10.89"
"64","000","00","030","0006","0657","409","87","322","3","412","799","0","51.56","10.89"
"64","000","00","030","0007","0000","404","97","307","4","408","839","0","48.63","11.56"
"64","000","00","030","0007","0658","404","97","307","4","408","839","0","48.63","11.56"
"64","000","00","030","0008","0000","326","80","246","2","328","705","0","46.52","11.35"
"64","000","00","030","0008","0659","326","80","246","2","328","705","0","46.52","11.35"
"64","000","00","030","0009","0000","1401","530","871","15","1416","3265","0","43.37","16.23"
"64","000","00","030","0009","0660","644","235","409","9","653","1515","0","43.10","15.51"
"64","000","00","030","0009","0661","757","295","462","6","763","1750","0","43.60","16.86"
"64","000","00","030","0011","0000","638","444","194","14","652","1512","0","43.12","29.37"
"64","000","00","030","0011","0662","638","444","194","14","652","1512","0","43.12","29.37"
"64","000","00","030","0012","0000","148","113","35","0","148","331","0","44.71","34.14"
"64","000","00","030","0012","0663","148","113","35","0","148","331","0","44.71","34.14"
"64","000","00","030","0013","0000","189","133","56","2","191","600","0","31.83","22.17"
"64","000","00","030","0013","0664","189","133","56","2","191","600","0","31.83","22.17"
"64","000","00","030","0015","0000","731","445","286","4","735","1687","0","43.57","26.38"
"64","000","00","030","0015","0665","731","445","286","4","735","1687","0","43.57","26.38"
"64","000","00","030","0016","0000","1032","522","510","6","1038","2403","0","43.20","21.72"
"64","000","00","030","0016","0666","495","272","223","2","497","1166","0","42.62","23.33"
"64","000","00","030","0016","0667","537","250","287","4","541","1237","0","43.73","20.21"
"64","000","00","030","0017","0000","1242","1109","133","13","1255","2489","0","50.42","44.56"
"64","000","00","030","0017","0668","644","573","71","7","651","1259","0","51.71","45.51"
"64","000","00","030","0017","0669","598","536","62","6","604","1230","0","49.11","43.58"
"64","000","00","030","0019","0000","288","200","88","3","291","611","0","47.63","32.73"
"64","000","00","030","0019","0670","288","200","88","3","291","611","0","47.63","32.73"
"64","000","00","030","0021","0000","443","100","343","7","450","907","0","49.61","11.03"
"64","000","00","030","0021","0671","443","100","343","7","450","907","0","49.61","11.03"
"64","000","00","030","0022","0000","367","102","265","1","368","711","0","51.76","14.35"
"64","000","00","030","0022","0672","367","102","265","1","368","711","0","51.76","14.35"
"64","000","00","030","0023","0000","155","46","109","1","156","329","0","47.42","13.98"
"64","000","00","030","0023","0673","155","46","109","1","156","329","0","47.42","13.98"
"64","000","00","030","0024","0000","253","76","177","2","255","522","0","48.85","14.56"
"64","000","00","030","0024","0674","253","76","177","2","255","522","0","48.85","14.56"
"64","000","00","030","0025","0000","241","65","176","2","243","491","0","49.49","13.24"
"64","000","00","030","0025","0675","241","65","176","2","243","491","0","49.49","13.24"
"64","000","00","030","0026","0000","366","114","252","3","369","690","0","53.48","16.52"
"64","000","00","030","0026","0676","366","114","252","3","369","690","0","53.48","16.52"
"64","000","00","030","0027","0000","194","35","159","3","197","391","0","50.38","8.95"
"64","000","00","030","0027","0677","194","35","159","3","197","391","0","50.38","8.95"
"64","000","00","030","0028","0000","293","92","201","3","296","575","0","51.48","16.00"
"64","000","00","030","0028","0678","293","92","201","3","296","575","0","51.48","16.00"
"64","000","00","030","0029","0000","405","154","251","1","406","842","0","48.22","18.29"
"64","000","00","030","0029","0679","405","154","251","1","406","842","0","48.22","18.29"
"64","000","00","030","0030","0000","557","334","223","11","568","1260","0","45.08","26.51"
"64","000","00","030","0030","0680","557","334","223","11","568","1260","0","45.08","26.51"
"64","000","00","030","0031","0000","415","157","258","4","419","920","0","45.54","17.07"
"64","000","00","030","0031","0681","415","157","258","4","419","920","0","45.54","17.07"
"64","000","00","030","0032","0000","2703","2179","524","40","2743","5561","0","49.33","39.18"
"64","000","00","030","0032","0682","704","547","157","5","709","1439","0","49.27","38.01"
"64","000","00","030","0032","0683","507","404","103","11","518","1129","0","45.88","35.78"
"64","000","00","030","0032","0684","372","304","68","10","382","794","0","48.11","38.29"
"64","000","00","030","0032","0685","499","403","96","5","504","969","0","52.01","41.59"
"64","000","00","030","0032","0686","621","521","100","9","630","1230","0","51.22","42.36"
"64","000","00","030","0034","0000","1352","778","574","5","1357","3147","0","43.12","24.72"
"64","000","00","030","0034","0687","731","433","298","1","732","1564","0","46.80","27.69"
"64","000","00","030","0034","0688","621","345","276","4","625","1583","0","39.48","21.79"
"64","000","00","030","0035","0000","366","205","161","1","367","907","0","40.46","22.60"
"64","000","00","030","0035","0689","366","205","161","1","367","907","0","40.46","22.60"
"64","000","00","030","0036","0000","1264","985","279","10","1274","2680","0","47.54","36.75"
"64","000","00","030","0036","0690","725","624","101","7","732","1460","0","50.14","42.74"
"64","000","00","030","0036","0691","539","361","178","3","542","1220","0","44.43","29.59"
"64","000","00","030","0037","0000","695","534","161","6","701","1445","0","48.51","36.96"
"64","000","00","030","0037","0692","695","534","161","6","701","1445","0","48.51","36.96"
"64","000","00","030","0038","0000","662","524","138","7","669","1540","0","43.44","34.03"
"64","000","00","030","0038","0693","662","524","138","7","669","1540","0","43.44","34.03"
"64","000","00","030","0039","0000","5896","2856","3040","47","5943","13601","0","43.70","21.00"
"64","000","00","030","0039","0694","634","292","342","4","638","1476","0","43.22","19.78"
"64","000","00","030","0039","0695","722","334","388","8","730","1538","0","47.46","21.72"
"64","000","00","030","0039","0696","612","317","295","2","614","1363","0","45.05","23.26"
"64","000","00","030","0039","0697","625","293","332","7","632","1529","0","41.33","19.16"
"64","000","00","030","0039","0698","632","316","316","6","638","1512","0","42.20","20.90"
"64","000","00","030","0039","0699","625","318","307","2","627","1518","0","41.30","20.95"
"64","000","00","030","0039","0700","707","312","395","7","714","1562","0","45.71","19.97"
"64","000","00","030","0039","0701","673","358","315","6","679","1535","0","44.23","23.32"
"64","000","00","030","0039","0702","666","316","350","5","671","1568","0","42.79","20.15"
"64","000","00","030","0040","0000","10897","4619","6278","82","10979","25163","0","43.63","18.36"
"64","000","00","030","0040","0703","745","287","458","3","748","1524","0","49.08","18.83"
"64","000","00","030","0040","0704","771","274","497","5","776","1588","0","48.87","17.25"
"64","000","00","030","0040","0705","725","273","452","6","731","1556","0","46.98","17.54"
"64","000","00","030","0040","0706","691","263","428","6","697","1623","0","42.95","16.20"
"64","000","00","030","0040","0707","594","281","313","3","597","1468","0","40.67","19.14"
"64","000","00","030","0040","0708","620","336","284","10","630","1641","0","38.39","20.48"
"64","000","00","030","0040","0709","643","252","391","4","647","1563","0","41.39","16.12"
"64","000","00","030","0040","0710","753","318","435","5","758","1639","0","46.25","19.40"
"64","000","00","030","0040","0711","732","326","406","4","736","1605","0","45.86","20.31"
"64","000","00","030","0040","0712","705","339","366","11","716","1682","0","42.57","20.15"
"64","000","00","030","0040","0713","645","296","349","3","648","1536","0","42.19","19.27"
"64","000","00","030","0040","0714","742","290","452","5","747","1631","0","45.80","17.78"
"64","000","00","030","0040","0715","680","284","396","10","690","1674","0","41.22","16.97"
"64","000","00","030","0040","0716","618","250","368","3","621","1524","0","40.75","16.40"
"64","000","00","030","0040","0717","661","286","375","4","665","1610","0","41.30","17.76"
"64","000","00","030","0040","0718","572","264","308","0","572","1299","0","44.03","20.32"
"64","000","00","030","0041","0000","2179","644","1535","18","2197","4725","0","46.50","13.63"
"64","000","00","030","0041","0719","709","225","484","5","714","1646","0","43.38","13.67"
"64","000","00","030","0041","0720","734","184","550","6","740","1464","0","50.55","12.57"
"64","000","00","030","0041","0721","736","235","501","7","743","1615","0","46.01","14.55"
"64","000","00","030","0042","0000","5755","2620","3135","31","5786","13461","0","42.98","19.46"
"64","000","00","030","0042","0722","610","223","387","3","613","1299","0","47.19","17.17"
"64","000","00","030","0042","0723","680","281","399","5","685","1574","0","43.52","17.85"
"64","000","00","030","0042","0724","583","274","309","4","587","1453","0","40.40","18.86"
"64","000","00","030","0042","0725","644","280","364","5","649","1518","0","42.75","18.45"
"64","000","00","030","0042","0726","653","283","370","3","656","1452","0","45.18","19.49"
"64","000","00","030","0042","0727","735","342","393","4","739","1681","0","43.96","20.35"
"64","000","00","030","0042","0728","631","300","331","4","635","1514","0","41.94","19.82"
"64","000","00","030","0042","0729","581","274","307","1","582","1521","0","38.26","18.01"
"64","000","00","030","0042","0730","638","363","275","2","640","1449","0","44.17","25.05"
"64","000","00","030","0043","0000","11552","5218","6334","79","11631","28382","0","40.98","18.38"
"64","000","00","030","0043","0731","626","254","372","2","628","1523","0","41.23","16.68"
"64","000","00","030","0043","0732","628","265","363","2","630","1529","0","41.20","17.33"
"64","000","00","030","0043","0733","669","274","395","6","675","1588","0","42.51","17.25"
"64","000","00","030","0043","0734","607","215","392","5","612","1466","0","41.75","14.67"
"64","000","00","030","0043","0735","556","215","341","2","558","1463","0","38.14","14.70"
"64","000","00","030","0043","0736","589","269","320","2","591","1450","0","40.76","18.55"
"64","000","00","030","0043","0737","635","294","341","4","639","1603","0","39.86","18.34"
"64","000","00","030","0043","0738","586","248","338","2","588","1516","0","38.79","16.36"
"64","000","00","030","0043","0739","613","278","335","4","617","1505","0","41.00","18.47"
"64","000","00","030","0043","0740","661","304","357","4","665","1533","0","43.38","19.83"
"64","000","00","030","0043","0741","620","306","314","3","623","1429","0","43.60","21.41"
"64","000","00","030","0043","0742","678","318","360","7","685","1661","0","41.24","19.15"
"64","000","00","030","0043","0743","738","347","391","5","743","1778","0","41.79","19.52"
"64","000","00","030","0043","0744","709","335","374","6","715","1674","0","42.71","20.01"
"64","000","00","030","0043","0745","625","289","336","10","635","1721","0","36.90","16.79"
"64","000","00","030","0043","0746","677","340","337","3","680","1739","0","39.10","19.55"
"64","000","00","030","0043","0747","635","267","368","4","639","1566","0","40.80","17.05"
"64","000","00","030","0043","0748","700","400","300","8","708","1638","0","43.22","24.42"
"64","000","00","030","0044","0000","13768","6594","7174","84","13852","35376","0","39.16","18.64"
"64","000","00","030","0044","0749","591","303","288","4","595","1546","0","38.49","19.60"
"64","000","00","030","0044","0750","596","276","320","4","600","1625","0","36.92","16.98"
"64","000","00","030","0044","0751","583","295","288","1","584","1626","0","35.92","18.14"
"64","000","00","030","0044","0752","594","290","304","3","597","1538","0","38.82","18.86"
"64","000","00","030","0044","0753","691","401","290","3","694","1671","0","41.53","24.00"
"64","000","00","030","0044","0754","681","321","360","6","687","1654","0","41.54","19.41"
"64","000","00","030","0044","0755","598","270","328","4","602","1634","0","36.84","16.52"
"64","000","00","030","0044","0756","670","345","325","2","672","1604","0","41.90","21.51"
"64","000","00","030","0044","0757","581","272","309","4","585","1493","0","39.18","18.22"
"64","000","00","030","0044","0758","636","254","382","5","641","1613","0","39.74","15.75"
"64","000","00","030","0044","0759","614","289","325","4","618","1628","0","37.96","17.75"
"64","000","00","030","0044","0760","595","257","338","1","596","1627","0","36.63","15.80"
"64","000","00","030","0044","0761","551","276","275","7","558","1584","0","35.23","17.42"
"64","000","00","030","0044","0762","696","357","339","8","704","1732","0","40.65","20.61"
"64","000","00","030","0044","0763","634","279","355","2","636","1709","0","37.21","16.33"
"64","000","00","030","0044","0764","686","322","364","1","687","1777","0","38.66","18.12"
"64","000","00","030","0044","0765","677","315","362","6","683","1685","0","40.53","18.69"
"64","000","00","030","0044","0766","657","269","388","5","662","1605","0","41.25","16.76"
"64","000","00","030","0044","0767","540","258","282","1","541","1434","0","37.73","17.99"
"64","000","00","030","0044","0768","700","293","407","5","705","1634","0","43.15","17.93"
"64","000","00","030","0044","0769","611","347","264","3","614","1450","0","42.34","23.93"
"64","000","00","030","0044","0770","586","305","281","5","591","1507","0","39.22","20.24"
"64","000","00","040","0000","0000","64579","27025","37554","461","65040","156746","189931","41.49","17.24"
"64","000","00","040","0001","0000","8668","3297","5371","61","8729","21636","0","40.34","15.24"
"64","000","00","040","0001","0523","440","141","299","1","441","1036","0","42.57","13.61"
"64","000","00","040","0001","0524","480","146","334","2","482","1027","0","46.93","14.22"
"64","000","00","040","0001","0525","547","187","360","4","551","1244","0","44.29","15.03"
"64","000","00","040","0001","0526","468","187","281","3","471","1336","0","35.25","14.00"
"64","000","00","040","0001","0527","625","221","404","6","631","1425","0","44.28","15.51"
"64","000","00","040","0001","0528","547","222","325","3","550","1503","0","36.59","14.77"
"64","000","00","040","0001","0529","530","209","321","6","536","1292","0","41.49","16.18"
"64","000","00","040","0001","0530","495","188","307","6","501","1250","0","40.08","15.04"
"64","000","00","040","0001","0531","506","243","263","4","510","1235","0","41.30","19.68"
"64","000","00","040","0001","0532","579","224","355","5","584","1375","0","42.47","16.29"
"64","000","00","040","0001","0533","611","254","357","2","613","1418","0","43.23","17.91"
"64","000","00","040","0001","0534","490","208","282","3","493","1340","0","36.79","15.52"
"64","000","00","040","0001","0535","719","261","458","6","725","1707","0","42.47","15.29"
"64","000","00","040","0001","0536","506","203","303","4","510","1390","0","36.69","14.60"
"64","000","00","040","0001","0537","542","197","345","3","545","1437","0","37.93","13.71"
"64","000","00","040","0001","0538","583","206","377","3","586","1621","0","36.15","12.71"
"64","000","00","040","0002","0000","1757","666","1091","7","1764","4264","0","41.37","15.62"
"64","000","00","040","0002","0539","578","243","335","2","580","1373","0","42.24","17.70"
"64","000","00","040","0002","0540","553","170","383","3","556","1416","0","39.27","12.01"
"64","000","00","040","0002","0541","626","253","373","2","628","1475","0","42.58","17.15"
"64","000","00","040","0003","0000","2358","847","1511","18","2376","6356","0","37.38","13.33"
"64","000","00","040","0003","0542","542","202","340","6","548","1389","0","39.45","14.54"
"64","000","00","040","0003","0543","487","171","316","4","491","1229","0","39.95","13.91"
"64","000","00","040","0003","0544","472","158","314","2","474","1308","0","36.24","12.08"
"64","000","00","040","0003","0545","442","158","284","1","443","1245","0","35.58","12.69"
"64","000","00","040","0003","0546","415","158","257","5","420","1185","0","35.44","13.33"
"64","000","00","040","0004","0000","1273","443","830","3","1276","3150","0","40.51","14.06"
"64","000","00","040","0004","0547","433","129","304","1","434","1008","0","43.06","12.80"
"64","000","00","040","0004","0548","425","155","270","2","427","1075","0","39.72","14.42"
"64","000","00","040","0004","0549","415","159","256","0","415","1067","0","38.89","14.90"
"64","000","00","040","0005","0000","1331","406","925","13","1344","3252","0","41.33","12.48"
"64","000","00","040","0005","0553","658","214","444","7","665","1642","0","40.50","13.03"
"64","000","00","040","0005","0554","673","192","481","6","679","1610","0","42.17","11.93"
"64","000","00","040","0006","0000","1044","388","656","6","1050","3163","0","33.20","12.27"
"64","000","00","040","0006","0550","295","74","221","1","296","1231","0","24.05","6.01"
"64","000","00","040","0006","0551","394","160","234","3","397","977","0","40.63","16.38"
"64","000","00","040","0006","0552","355","154","201","2","357","955","0","37.38","16.13"
"64","000","00","040","0007","0000","1738","674","1064","12","1750","3884","0","45.06","17.35"
"64","000","00","040","0007","0555","606","220","386","3","609","1266","0","48.10","17.38"
"64","000","00","040","0007","0556","578","255","323","7","585","1323","0","44.22","19.27"
"64","000","00","040","0007","0557","554","199","355","2","556","1295","0","42.93","15.37"
"64","000","00","040","0008","0000","2016","991","1025","17","2033","4669","0","43.54","21.23"
"64","000","00","040","0008","0558","475","198","277","3","478","1153","0","41.46","17.17"
"64","000","00","040","0008","0559","485","236","249","6","491","1123","0","43.72","21.02"
"64","000","00","040","0008","0560","465","240","225","5","470","1088","0","43.20","22.06"
"64","000","00","040","0008","0561","591","317","274","3","594","1305","0","45.52","24.29"
"64","000","00","040","0009","0000","1355","340","1015","12","1367","2830","0","48.30","12.01"
"64","000","00","040","0009","0562","382","131","251","6","388","825","0","47.03","15.88"
"64","000","00","040","0009","0563","417","90","327","3","420","851","0","49.35","10.58"
"64","000","00","040","0009","0564","556","119","437","3","559","1154","0","48.44","10.31"
"64","000","00","040","0010","0000","1023","218","805","9","1032","2059","0","50.12","10.59"
"64","000","00","040","0010","0565","466","86","380","3","469","918","0","51.09","9.37"
"64","000","00","040","0010","0566","557","132","425","6","563","1141","0","49.34","11.57"
"64","000","00","040","0011","0000","1669","460","1209","16","1685","3828","0","44.02","12.02"
"64","000","00","040","0011","0567","526","138","388","3","529","1164","0","45.45","11.86"
"64","000","00","040","0011","0568","633","208","425","7","640","1566","0","40.87","13.28"
"64","000","00","040","0011","0569","510","114","396","6","516","1098","0","46.99","10.38"
"64","000","00","040","0012","0000","717","151","566","8","725","1375","0","52.73","10.98"
"64","000","00","040","0012","0570","717","151","566","8","725","1375","0","52.73","10.98"
"64","000","00","040","0013","0000","1399","527","872","11","1410","3487","0","40.44","15.11"
"64","000","00","040","0013","0571","443","148","295","2","445","1061","0","41.94","13.95"
"64","000","00","040","0013","0572","517","197","320","6","523","1268","0","41.25","15.54"
"64","000","00","040","0013","0573","439","182","257","3","442","1158","0","38.17","15.72"
"64","000","00","040","0014","0000","6091","3107","2984","41","6132","16189","0","37.88","19.19"
"64","000","00","040","0014","0574","570","287","283","4","574","1565","0","36.68","18.34"
"64","000","00","040","0014","0575","560","335","225","1","561","1554","0","36.10","21.56"
"64","000","00","040","0014","0576","525","270","255","6","531","1449","0","36.65","18.63"
"64","000","00","040","0014","0577","599","299","300","7","606","1502","0","40.35","19.91"
"64","000","00","040","0014","0578","564","291","273","8","572","1444","0","39.61","20.15"
"64","000","00","040","0014","0579","568","288","280","3","571","1455","0","39.24","19.79"
"64","000","00","040","0014","0580","548","274","274","2","550","1394","0","39.45","19.66"
"64","000","00","040","0014","0581","531","239","292","5","536","1444","0","37.12","16.55"
"64","000","00","040","0014","0582","492","240","252","1","493","1441","0","34.21","16.66"
"64","000","00","040","0014","0583","546","304","242","2","548","1434","0","38.21","21.20"
"64","000","00","040","0014","0584","588","280","308","2","590","1507","0","39.15","18.58"
"64","000","00","040","0015","0000","356","191","165","3","359","657","0","54.64","29.07"
"64","000","00","040","0015","0585","356","191","165","3","359","657","0","54.64","29.07"
"64","000","00","040","0016","0000","1055","465","590","5","1060","2064","0","51.36","22.53"
"64","000","00","040","0016","0586","519","247","272","2","521","1040","0","50.10","23.75"
"64","000","00","040","0016","0587","536","218","318","3","539","1024","0","52.64","21.29"
"64","000","00","040","0017","0000","1082","548","534","4","1086","2417","0","44.93","22.67"
"64","000","00","040","0017","0588","494","229","265","2","496","956","0","51.88","23.95"
"64","000","00","040","0017","0589","588","319","269","2","590","1461","0","40.38","21.83"
"64","000","00","040","0018","0000","1269","569","700","11","1280","2885","0","44.37","19.72"
"64","000","00","040","0018","0590","660","241","419","6","666","1446","0","46.06","16.67"
"64","000","00","040","0018","0591","609","328","281","5","614","1439","0","42.67","22.79"
"64","000","00","040","0019","0000","1065","483","582","8","1073","2765","0","38.81","17.47"
"64","000","00","040","0019","0592","565","267","298","2","567","1487","0","38.13","17.96"
"64","000","00","040","0019","0593","500","216","284","6","506","1278","0","39.59","16.90"
"64","000","00","040","0020","0000","772","346","426","9","781","2046","0","38.17","16.91"
"64","000","00","040","0020","0594","375","155","220","4","379","994","0","38.13","15.59"
"64","000","00","040","0020","0595","397","191","206","5","402","1052","0","38.21","18.16"
"64","000","00","040","0021","0000","962","357","605","9","971","2023","0","48.00","17.65"
"64","000","00","040","0021","0596","439","155","284","1","440","911","0","48.30","17.01"
"64","000","00","040","0021","0597","523","202","321","8","531","1112","0","47.75","18.17"
"64","000","00","040","0022","0000","2316","1128","1188","16","2332","5347","0","43.61","21.10"
"64","000","00","040","0022","0598","615","289","326","3","618","1318","0","46.89","21.93"
"64","000","00","040","0022","0599","573","259","314","4","577","1416","0","40.75","18.29"
"64","000","00","040","0022","0600","546","269","277","4","550","1273","0","43.21","21.13"
"64","000","00","040","0022","0601","582","311","271","5","587","1340","0","43.81","23.21"
"64","000","00","040","0023","0000","564","217","347","4","568","1397","0","40.66","15.53"
"64","000","00","040","0023","0602","564","217","347","4","568","1397","0","40.66","15.53"
"64","000","00","040","0024","0000","1808","732","1076","14","1822","4314","0","42.23","16.97"
"64","000","00","040","0024","0603","424","172","252","5","429","1042","0","41.17","16.51"
"64","000","00","040","0024","0604","477","182","295","0","477","1102","0","43.28","16.52"
"64","000","00","040","0024","0605","416","184","232","5","421","1050","0","40.10","17.52"
"64","000","00","040","0024","0606","491","194","297","4","495","1120","0","44.20","17.32"
"64","000","00","040","0025","0000","1071","491","580","6","1077","2534","0","42.50","19.38"
"64","000","00","040","0025","0607","542","218","324","3","545","1262","0","43.19","17.27"
"64","000","00","040","0025","0608","529","273","256","3","532","1272","0","41.82","21.46"
"64","000","00","040","0026","0000","1394","650","744","7","1401","3221","0","43.50","20.18"
"64","000","00","040","0026","0609","527","252","275","2","529","1156","0","45.76","21.80"
"64","000","00","040","0026","0610","389","154","235","3","392","924","0","42.42","16.67"
"64","000","00","040","0026","0611","478","244","234","2","480","1141","0","42.07","21.38"
"64","000","00","040","0027","0000","888","415","473","5","893","1997","0","44.72","20.78"
"64","000","00","040","0027","0612","447","198","249","4","451","957","0","47.13","20.69"
"64","000","00","040","0027","0613","441","217","224","1","442","1040","0","42.50","20.87"
"64","000","00","040","0028","0000","1533","740","793","10","1543","3122","0","49.42","23.70"
"64","000","00","040","0028","0614","548","287","261","4","552","1112","0","49.64","25.81"
"64","000","00","040","0028","0615","489","257","232","5","494","1000","0","49.40","25.70"
"64","000","00","040","0028","0616","496","196","300","1","497","1010","0","49.21","19.41"
"64","000","00","040","0029","0000","1388","646","742","16","1404","3235","0","43.40","19.97"
"64","000","00","040","0029","0617","463","209","254","3","466","1088","0","42.83","19.21"
"64","000","00","040","0029","0618","449","186","263","12","461","1053","0","43.78","17.66"
"64","000","00","040","0029","0619","476","251","225","1","477","1094","0","43.60","22.94"
"64","000","00","040","0030","0000","949","475","474","3","952","2104","0","45.25","22.58"
"64","000","00","040","0030","0620","456","216","240","2","458","1048","0","43.70","20.61"
"64","000","00","040","0030","0621","493","259","234","1","494","1056","0","46.78","24.53"
"64","000","00","040","0031","0000","1849","768","1081","14","1863","4652","0","40.05","16.51"
"64","000","00","040","0031","0622","490","180","310","6","496","1164","0","42.61","15.46"
"64","000","00","040","0031","0623","409","184","225","1","410","1194","0","34.34","15.41"
"64","000","00","040","0031","0624","460","178","282","6","466","1157","0","40.28","15.38"
"64","000","00","040","0031","0625","490","226","264","1","491","1137","0","43.18","19.88"
"64","000","00","040","0032","0000","1430","603","827","8","1438","3394","0","42.37","17.77"
"64","000","00","040","0032","0626","495","213","282","2","497","1161","0","42.81","18.35"
"64","000","00","040","0032","0627","448","189","259","3","451","1074","0","41.99","17.60"
"64","000","00","040","0032","0628","487","201","286","3","490","1159","0","42.28","17.34"
"64","000","00","040","0033","0000","3350","1715","1635","20","3370","8252","0","40.84","20.78"
"64","000","00","040","0033","0629","393","188","205","3","396","953","0","41.55","19.73"
"64","000","00","040","0033","0630","489","258","231","2","491","1107","0","44.35","23.31"
"64","000","00","040","0033","0631","461","236","225","2","463","1085","0","42.67","21.75"
"64","000","00","040","0033","0632","391","204","187","4","395","988","0","39.98","20.65"
"64","000","00","040","0033","0633","405","199","206","4","409","1028","0","39.79","19.36"
"64","000","00","040","0033","0634","402","217","185","1","403","1059","0","38.05","20.49"
"64","000","00","040","0033","0635","387","205","182","1","388","1026","0","37.82","19.98"
"64","000","00","040","0033","0636","422","208","214","3","425","1006","0","42.25","20.68"
"64","000","00","040","0034","0000","1934","973","961","15","1949","4959","0","39.30","19.62"
"64","000","00","040","0034","0637","501","251","250","4","505","1294","0","39.03","19.40"
"64","000","00","040","0034","0638","512","255","257","6","518","1310","0","39.54","19.47"
"64","000","00","040","0034","0639","468","234","234","2","470","1249","0","37.63","18.73"
"64","000","00","040","0034","0640","453","233","220","3","456","1106","0","41.23","21.07"
"64","000","00","040","0035","0000","2975","1288","1687","23","2998","7507","0","39.94","17.16"
"64","000","00","040","0035","0641","489","219","270","4","493","1201","0","41.05","18.23"
"64","000","00","040","0035","0642","566","253","313","1","567","1287","0","44.06","19.66"
"64","000","00","040","0035","0643","608","276","332","6","614","1375","0","44.65","20.07"
"64","000","00","040","0035","0644","525","207","318","5","530","1418","0","37.38","14.60"
"64","000","00","040","0035","0645","380","164","216","5","385","1112","0","34.62","14.75"
"64","000","00","040","0035","0646","407","169","238","2","409","1114","0","36.71","15.17"
"64","000","00","040","0036","0000","695","217","478","8","703","1558","0","45.12","13.93"
"64","000","00","040","0036","0647","695","217","478","8","703","1558","0","45.12","13.93"
"64","000","00","040","0037","0000","1435","493","942","9","1444","4154","0","34.76","11.87"
"64","000","00","040","0037","0648","481","130","351","3","484","1197","0","40.43","10.86"
"64","000","00","040","0037","0649","458","155","303","3","461","1300","0","35.46","11.92"
"64","000","00","040","0037","0650","496","208","288","3","499","1657","0","30.11","12.55"
"64","000","00","050","0000","0000","124654","47555","77099","842","125496","285944","334725","43.89","16.63"
"64","000","00","050","0001","0000","1548","543","1005","8","1556","3804","0","40.90","14.27"
"64","000","00","050","0001","0998","450","157","293","2","452","1213","0","37.26","12.94"
"64","000","00","050","0001","0999","545","212","333","1","546","1302","0","41.94","16.28"
"64","000","00","050","0001","1000","553","174","379","5","558","1289","0","43.29","13.50"
"64","000","00","050","0002","0000","3017","1196","1821","13","3030","7370","0","41.11","16.23"
"64","000","00","050","0002","1001","681","288","393","1","682","1617","0","42.18","17.81"
"64","000","00","050","0002","1002","655","256","399","1","656","1521","0","43.13","16.83"
"64","000","00","050","0002","1003","593","231","362","4","597","1452","0","41.12","15.91"
"64","000","00","050","0002","1004","567","232","335","3","570","1569","0","36.33","14.79"
"64","000","00","050","0002","1005","521","189","332","4","525","1211","0","43.35","15.61"
"64","000","00","050","0003","0000","1625","569","1056","11","1636","3793","0","43.13","15.00"
"64","000","00","050","0003","1006","585","180","405","4","589","1344","0","43.82","13.39"
"64","000","00","050","0003","1007","544","179","365","6","550","1305","0","42.15","13.72"
"64","000","00","050","0003","1008","496","210","286","1","497","1144","0","43.44","18.36"
"64","000","00","050","0004","0000","1697","639","1058","12","1709","3884","0","44.00","16.45"
"64","000","00","050","0004","1009","574","229","345","8","582","1449","0","40.17","15.80"
"64","000","00","050","0004","1010","668","238","430","3","671","1446","0","46.40","16.46"
"64","000","00","050","0004","1011","455","172","283","1","456","989","0","46.11","17.39"
"64","000","00","050","0005","0000","2840","1022","1818","13","2853","7030","0","40.58","14.54"
"64","000","00","050","0005","1012","599","246","353","4","603","1391","0","43.35","17.69"
"64","000","00","050","0005","1013","555","173","382","2","557","1321","0","42.17","13.10"
"64","000","00","050","0005","1014","556","183","373","2","558","1395","0","40.00","13.12"
"64","000","00","050","0005","1015","604","223","381","3","607","1498","0","40.52","14.89"
"64","000","00","050","0005","1016","526","197","329","2","528","1425","0","37.05","13.82"
"64","000","00","050","0006","0000","1588","499","1089","11","1599","3436","0","46.54","14.52"
"64","000","00","050","0006","1017","481","125","356","4","485","1011","0","47.97","12.36"
"64","000","00","050","0006","1018","524","172","352","5","529","1114","0","47.49","15.44"
"64","000","00","050","0006","1019","583","202","381","2","585","1311","0","44.62","15.41"
"64","000","00","050","0007","0000","9188","4121","5067","60","9248","20899","0","44.25","19.72"
"64","000","00","050","0007","1020","627","207","420","4","631","1480","0","42.64","13.99"
"64","000","00","050","0007","1021","590","277","313","3","593","1474","0","40.23","18.79"
"64","000","00","050","0007","1022","650","313","337","4","654","1497","0","43.69","20.91"
"64","000","00","050","0007","1023","624","282","342","3","627","1399","0","44.82","20.16"
"64","000","00","050","0007","1024","636","205","431","2","638","1469","0","43.43","13.96"
"64","000","00","050","0007","1025","637","209","428","7","644","1494","0","43.11","13.99"
"64","000","00","050","0007","1026","645","259","386","2","647","1509","0","42.88","17.16"
"64","000","00","050","0007","1027","626","260","366","1","627","1509","0","41.55","17.23"
"64","000","00","050","0007","1028","682","336","346","3","685","1517","0","45.15","22.15"
"64","000","00","050","0007","1029","718","377","341","10","728","1501","0","48.50","25.12"
"64","000","00","050","0007","1030","661","320","341","6","667","1516","0","44.00","21.11"
"64","000","00","050","0007","1031","773","382","391","7","780","1510","0","51.66","25.30"
"64","000","00","050","0007","1032","626","339","287","4","630","1490","0","42.28","22.75"
"64","000","00","050","0007","1033","693","355","338","4","697","1534","0","45.44","23.14"
"64","000","00","050","0008","0000","3535","1347","2188","18","3553","8380","0","42.40","16.07"
"64","000","00","050","0008","1034","759","265","494","3","762","1732","0","44.00","15.30"
"64","000","00","050","0008","1035","774","300","474","7","781","1709","0","45.70","17.55"
"64","000","00","050","0008","1036","677","282","395","2","679","1535","0","44.23","18.37"
"64","000","00","050","0008","1037","623","229","394","4","627","1601","0","39.16","14.30"
"64","000","00","050","0008","1038","702","271","431","2","704","1803","0","39.05","15.03"
"64","000","00","050","0009","0000","3030","1185","1845","27","3057","6992","0","43.72","16.95"
"64","000","00","050","0009","1039","636","233","403","8","644","1372","0","46.94","16.98"
"64","000","00","050","0009","1040","628","247","381","8","636","1434","0","44.35","17.22"
"64","000","00","050","0009","1041","616","230","386","3","619","1367","0","45.28","16.83"
"64","000","00","050","0009","1042","553","208","345","4","557","1376","0","40.48","15.12"
"64","000","00","050","0009","1043","597","267","330","4","601","1443","0","41.65","18.50"
"64","000","00","050","0010","0000","867","319","548","8","875","1915","0","45.69","16.66"
"64","000","00","050","0010","1044","424","174","250","5","429","1017","0","42.18","17.11"
"64","000","00","050","0010","1045","443","145","298","3","446","898","0","49.67","16.15"
"64","000","00","050","0011","0000","711","229","482","7","718","1561","0","46.00","14.67"
"64","000","00","050","0011","1046","391","118","273","5","396","858","0","46.15","13.75"
"64","000","00","050","0011","1047","320","111","209","2","322","703","0","45.80","15.79"
"64","000","00","050","0012","0000","2191","864","1327","19","2210","4987","0","44.32","17.33"
"64","000","00","050","0012","1048","544","231","313","13","557","1309","0","42.55","17.65"
"64","000","00","050","0012","1049","540","178","362","0","540","1161","0","46.51","15.33"
"64","000","00","050","0012","1050","578","227","351","5","583","1301","0","44.81","17.45"
"64","000","00","050","0012","1051","529","228","301","1","530","1216","0","43.59","18.75"
"64","000","00","050","0013","0000","1923","810","1113","13","1936","4277","0","45.27","18.94"
"64","000","00","050","0013","1052","642","285","357","2","644","1476","0","43.63","19.31"
"64","000","00","050","0013","1053","622","272","350","4","626","1357","0","46.13","20.04"
"64","000","00","050","0013","1054","659","253","406","7","666","1444","0","46.12","17.52"
"64","000","00","050","0014","0000","1978","866","1112","5","1983","4461","0","44.45","19.41"
"64","000","00","050","0014","1055","643","275","368","3","646","1524","0","42.39","18.04"
"64","000","00","050","0014","1056","645","290","355","1","646","1454","0","44.43","19.94"
"64","000","00","050","0014","1057","690","301","389","1","691","1483","0","46.59","20.30"
"64","000","00","050","0015","0000","3228","1327","1901","18","3246","7143","0","45.44","18.58"
"64","000","00","050","0015","1058","738","281","457","1","739","1488","0","49.66","18.88"
"64","000","00","050","0015","1059","646","297","349","3","649","1521","0","42.67","19.53"
"64","000","00","050","0015","1060","635","253","382","4","639","1403","0","45.55","18.03"
"64","000","00","050","0015","1061","596","254","342","5","601","1308","0","45.95","19.42"
"64","000","00","050","0015","1062","613","242","371","5","618","1423","0","43.43","17.01"
"64","000","00","050","0016","0000","1622","638","984","7","1629","3486","0","46.73","18.30"
"64","000","00","050","0016","1063","433","170","263","2","435","1021","0","42.61","16.65"
"64","000","00","050","0016","1064","626","256","370","2","628","1291","0","48.64","19.83"
"64","000","00","050","0016","1065","563","212","351","3","566","1174","0","48.21","18.06"
"64","000","00","050","0017","0000","2078","774","1304","12","2090","4824","0","43.33","16.04"
"64","000","00","050","0017","1066","569","248","321","2","571","1249","0","45.72","19.86"
"64","000","00","050","0017","1067","451","199","252","3","454","1252","0","36.26","15.89"
"64","000","00","050","0017","1068","549","177","372","4","553","1171","0","47.22","15.12"
"64","000","00","050","0017","1069","509","150","359","3","512","1152","0","44.44","13.02"
"64","000","00","050","0018","0000","1525","552","973","11","1536","3831","0","40.09","14.41"
"64","000","00","050","0018","1070","505","180","325","3","508","1300","0","39.08","13.85"
"64","000","00","050","0018","1071","506","178","328","4","510","1224","0","41.67","14.54"
"64","000","00","050","0018","1072","514","194","320","4","518","1307","0","39.63","14.84"
"64","000","00","050","0019","0000","2737","1022","1715","25","2762","6396","0","43.18","15.98"
"64","000","00","050","0019","1073","650","217","433","8","658","1506","0","43.69","14.41"
"64","000","00","050","0019","1074","693","240","453","8","701","1569","0","44.68","15.30"
"64","000","00","050","0019","1075","703","298","405","3","706","1674","0","42.17","17.80"
"64","000","00","050","0019","1076","691","267","424","6","697","1647","0","42.32","16.21"
"64","000","00","050","0020","0000","1223","435","788","10","1233","2807","0","43.93","15.50"
"64","000","00","050","0020","1077","625","227","398","3","628","1481","0","42.40","15.33"
"64","000","00","050","0020","1078","598","208","390","7","605","1326","0","45.63","15.69"
"64","000","00","050","0021","0000","1351","600","751","7","1358","3089","0","43.96","19.42"
"64","000","00","050","0021","1079","673","313","360","4","677","1507","0","44.92","20.77"
"64","000","00","050","0021","1080","678","287","391","3","681","1582","0","43.05","18.14"
"64","000","00","050","0022","0000","3192","1288","1904","31","3223","7514","0","42.89","17.14"
"64","000","00","050","0022","1081","605","268","337","5","610","1433","0","42.57","18.70"
"64","000","00","050","0022","1082","571","211","360","8","579","1515","0","38.22","13.93"
"64","000","00","050","0022","1083","628","229","399","3","631","1486","0","42.46","15.41"
"64","000","00","050","0022","1084","677","288","389","5","682","1523","0","44.78","18.91"
"64","000","00","050","0022","1085","711","292","419","10","721","1557","0","46.31","18.75"
"64","000","00","050","0023","0000","1224","514","710","9","1233","3030","0","40.69","16.96"
"64","000","00","050","0023","1086","630","252","378","6","636","1554","0","40.93","16.22"
"64","000","00","050","0023","1087","594","262","332","3","597","1476","0","40.45","17.75"
"64","000","00","050","0024","0000","1082","421","661","7","1089","2557","0","42.59","16.46"
"64","000","00","050","0024","1088","544","235","309","4","548","1272","0","43.08","18.47"
"64","000","00","050","0024","1089","538","186","352","3","541","1285","0","42.10","14.47"
"64","000","00","050","0025","0000","2426","1000","1426","15","2441","5630","0","43.36","17.76"
"64","000","00","050","0025","1090","593","218","375","2","595","1406","0","42.32","15.50"
"64","000","00","050","0025","1091","531","197","334","1","532","1245","0","42.73","15.82"
"64","000","00","050","0025","1092","548","239","309","3","551","1245","0","44.26","19.20"
"64","000","00","050","0025","1093","754","346","408","9","763","1734","0","44.00","19.95"
"64","000","00","050","0026","0000","2262","942","1320","19","2281","4748","0","48.04","19.84"
"64","000","00","050","0026","1094","803","309","494","8","811","1605","0","50.53","19.25"
"64","000","00","050","0026","1095","652","262","390","2","654","1432","0","45.67","18.30"
"64","000","00","050","0026","1096","807","371","436","9","816","1711","0","47.69","21.68"
"64","000","00","050","0027","0000","2802","1222","1580","19","2821","6808","0","41.44","17.95"
"64","000","00","050","0027","1097","571","233","338","3","574","1276","0","44.98","18.26"
"64","000","00","050","0027","1098","559","250","309","8","567","1336","0","42.44","18.71"
"64","000","00","050","0027","1099","519","227","292","3","522","1348","0","38.72","16.84"
"64","000","00","050","0027","1100","566","269","297","4","570","1427","0","39.94","18.85"
"64","000","00","050","0027","1101","587","243","344","1","588","1421","0","41.38","17.10"
"64","000","00","050","0028","0000","1888","738","1150","16","1904","3982","0","47.82","18.53"
"64","000","00","050","0028","1102","631","206","425","3","634","1365","0","46.45","15.09"
"64","000","00","050","0028","1103","761","358","403","8","769","1488","0","51.68","24.06"
"64","000","00","050","0028","1104","496","174","322","5","501","1129","0","44.38","15.41"
"64","000","00","050","0029","0000","2259","864","1395","15","2274","6719","0","33.84","12.86"
"64","000","00","050","0029","1105","743","281","462","3","746","3284","0","22.72","8.56"
"64","000","00","050","0029","1106","836","345","491","6","842","1758","0","47.90","19.62"
"64","000","00","050","0029","1107","680","238","442","6","686","1677","0","40.91","14.19"
"64","000","00","050","0030","0000","3287","1348","1939","20","3307","7920","0","41.76","17.02"
"64","000","00","050","0030","1108","696","253","443","3","699","1660","0","42.11","15.24"
"64","000","00","050","0030","1109","666","298","368","5","671","1525","0","44.00","19.54"
"64","000","00","050","0030","1110","590","243","347","4","594","1471","0","40.38","16.52"
"64","000","00","050","0030","1111","700","293","407","6","706","1642","0","43.00","17.84"
"64","000","00","050","0030","1112","635","261","374","2","637","1622","0","39.27","16.09"
"64","000","00","050","0031","0000","1509","603","906","5","1514","3836","0","39.47","15.72"
"64","000","00","050","0031","1113","505","171","334","2","507","1271","0","39.89","13.45"
"64","000","00","050","0031","1114","520","191","329","3","523","1311","0","39.89","14.57"
"64","000","00","050","0031","1115","484","241","243","0","484","1254","0","38.60","19.22"
"64","000","00","050","0032","0000","1012","336","676","14","1026","2898","0","35.40","11.59"
"64","000","00","050","0032","1116","451","144","307","5","456","1388","0","32.85","10.37"
"64","000","00","050","0032","1117","561","192","369","9","570","1510","0","37.75","12.72"
"64","000","00","050","0033","0000","2027","709","1318","11","2038","5297","0","38.47","13.38"
"64","000","00","050","0033","1118","642","207","435","3","645","1708","0","37.76","12.12"
"64","000","00","050","0033","1119","725","251","474","6","731","1817","0","40.23","13.81"
"64","000","00","050","0033","1120","660","251","409","2","662","1772","0","37.36","14.16"
"64","000","00","050","0034","0000","1048","388","660","7","1055","2586","0","40.80","15.00"
"64","000","00","050","0034","1121","462","161","301","6","468","1182","0","39.59","13.62"
"64","000","00","050","0034","1122","586","227","359","1","587","1404","0","41.81","16.17"
"64","000","00","050","0035","0000","770","208","562","9","779","1821","0","42.78","11.42"
"64","000","00","050","0035","1123","343","98","245","3","346","906","0","38.19","10.82"
"64","000","00","050","0035","1124","427","110","317","6","433","915","0","47.32","12.02"
"64","000","00","050","0036","0000","1427","388","1039","7","1434","3021","0","47.47","12.84"
"64","000","00","050","0036","1125","731","236","495","3","734","1594","0","46.05","14.81"
"64","000","00","050","0036","1126","696","152","544","4","700","1427","0","49.05","10.65"
"64","000","00","050","0037","0000","1378","523","855","12","1390","3493","0","39.79","14.97"
"64","000","00","050","0037","1127","419","163","256","1","420","1062","0","39.55","15.35"
"64","000","00","050","0037","1128","515","170","345","8","523","1159","0","45.13","14.67"
"64","000","00","050","0037","1129","444","190","254","3","447","1272","0","35.14","14.94"
"64","000","00","050","0038","0000","4727","1960","2767","25","4752","11804","0","40.26","16.60"
"64","000","00","050","0038","1130","602","218","384","4","606","1476","0","41.06","14.77"
"64","000","00","050","0038","1131","590","207","383","2","592","1544","0","38.34","13.41"
"64","000","00","050","0038","1132","601","266","335","4","605","1495","0","40.47","17.79"
"64","000","00","050","0038","1133","577","182","395","0","577","1385","0","41.66","13.14"
"64","000","00","050","0038","1134","630","295","335","3","633","1572","0","40.27","18.77"
"64","000","00","050","0038","1135","604","275","329","5","609","1501","0","40.57","18.32"
"64","000","00","050","0038","1136","592","273","319","6","598","1468","0","40.74","18.60"
"64","000","00","050","0038","1137","531","244","287","1","532","1363","0","39.03","17.90"
"64","000","00","050","0039","0000","1678","645","1033","5","1683","3743","0","44.96","17.23"
"64","000","00","050","0039","1138","571","216","355","3","574","1273","0","45.09","16.97"
"64","000","00","050","0039","1139","602","238","364","0","602","1306","0","46.09","18.22"
"64","000","00","050","0039","1140","505","191","314","2","507","1164","0","43.56","16.41"
"64","000","00","050","0040","0000","801","264","537","6","807","1778","0","45.39","14.85"
"64","000","00","050","0040","1141","389","145","244","2","391","866","0","45.15","16.74"
"64","000","00","050","0040","1142","412","119","293","4","416","912","0","45.61","13.05"
"64","000","00","050","0041","0000","1013","393","620","9","1022","2499","0","40.90","15.73"
"64","000","00","050","0041","1143","550","238","312","7","557","1330","0","41.88","17.89"
"64","000","00","050","0041","1144","463","155","308","2","465","1169","0","39.78","13.26"
"64","000","00","050","0042","0000","1026","343","683","6","1032","2682","0","38.48","12.79"
"64","000","00","050","0042","1145","501","159","342","4","505","1379","0","36.62","11.53"
"64","000","00","050","0042","1146","525","184","341","2","527","1303","0","40.45","14.12"
"64","000","00","050","0043","0000","771","265","506","13","784","1744","0","44.95","15.19"
"64","000","00","050","0043","1147","371","110","261","6","377","832","0","45.31","13.22"
"64","000","00","050","0043","1148","400","155","245","7","407","912","0","44.63","17.00"
"64","000","00","050","0044","0000","1852","748","1104","13","1865","4294","0","43.43","17.42"
"64","000","00","050","0044","1149","538","251","287","1","539","1315","0","40.99","19.09"
"64","000","00","050","0044","1150","647","252","395","5","652","1454","0","44.84","17.33"
"64","000","00","050","0044","1151","667","245","422","7","674","1525","0","44.20","16.07"
"64","000","00","050","0045","0000","1910","743","1167","13","1923","4233","0","45.43","17.55"
"64","000","00","050","0045","1152","646","271","375","4","650","1414","0","45.97","19.17"
"64","000","00","050","0045","1153","614","232","382","6","620","1348","0","45.99","17.21"
"64","000","00","050","0045","1154","650","240","410","3","653","1471","0","44.39","16.32"
"64","000","00","050","0046","0000","1412","472","940","9","1421","2893","0","49.12","16.32"
"64","000","00","050","0046","1155","694","228","466","4","698","1425","0","48.98","16.00"
"64","000","00","050","0046","1156","718","244","474","5","723","1468","0","49.25","16.62"
"64","000","00","050","0047","0000","1158","363","795","12","1170","2309","0","50.67","15.72"
"64","000","00","050","0047","1157","516","159","357","4","520","1035","0","50.24","15.36"
"64","000","00","050","0047","1158","642","204","438","8","650","1274","0","51.02","16.01"
"64","000","00","050","0048","0000","643","194","449","0","643","1208","0","53.23","16.06"
"64","000","00","050","0048","1159","643","194","449","0","643","1208","0","53.23","16.06"
"64","000","00","050","0049","0000","719","237","482","8","727","1482","0","49.06","15.99"
"64","000","00","050","0049","1160","719","237","482","8","727","1482","0","49.06","15.99"
"64","000","00","050","0050","0000","662","217","445","4","666","1379","0","48.30","15.74"
"64","000","00","050","0050","1161","662","217","445","4","666","1379","0","48.30","15.74"
"64","000","00","050","0051","0000","404","139","265","2","406","882","0","46.03","15.76"
"64","000","00","050","0051","1162","404","139","265","2","406","882","0","46.03","15.76"
"64","000","00","050","0052","0000","1305","479","826","9","1314","2589","0","50.75","18.50"
"64","000","00","050","0052","1163","699","255","444","6","705","1399","0","50.39","18.23"
"64","000","00","050","0052","1164","606","224","382","3","609","1190","0","51.18","18.82"
"64","000","00","050","0053","0000","988","383","605","9","997","2030","0","49.11","18.87"
"64","000","00","050","0053","1165","502","196","306","6","508","966","0","52.59","20.29"
"64","000","00","050","0053","1166","486","187","299","3","489","1064","0","45.96","17.58"
"64","000","00","050","0054","0000","869","312","557","7","876","1812","0","48.34","17.22"
"64","000","00","050","0054","1167","431","157","274","4","435","917","0","47.44","17.12"
"64","000","00","050","0054","1168","438","155","283","3","441","895","0","49.27","17.32"
"64","000","00","050","0055","0000","695","210","485","4","699","1339","0","52.20","15.68"
"64","000","00","050","0055","1169","695","210","485","4","699","1339","0","52.20","15.68"
"64","000","00","050","0056","0000","395","129","266","1","396","748","0","52.94","17.25"
"64","000","00","050","0056","1170","395","129","266","1","396","748","0","52.94","17.25"
"64","000","00","050","0057","0000","570","193","377","3","573","1023","0","56.01","18.87"
"64","000","00","050","0057","1171","570","193","377","3","573","1023","0","56.01","18.87"
"64","000","00","050","0058","0000","697","243","454","4","701","1448","0","48.41","16.78"
"64","000","00","050","0058","1172","697","243","454","4","701","1448","0","48.41","16.78"
"64","000","00","050","0059","0000","1006","333","673","5","1011","1900","0","53.21","17.53"
"64","000","00","050","0059","1173","488","146","342","3","491","946","0","51.90","15.43"
"64","000","00","050","0059","1174","518","187","331","2","520","954","0","54.51","19.60"
"64","000","00","050","0060","0000","1466","482","984","9","1475","2953","0","49.95","16.32"
"64","000","00","050","0060","1175","746","242","504","4","750","1530","0","49.02","15.82"
"64","000","00","050","0060","1176","720","240","480","5","725","1423","0","50.95","16.87"
"64","000","00","050","0061","0000","1655","614","1041","21","1676","3633","0","46.13","16.90"
"64","000","00","050","0061","1177","532","191","341","10","542","1137","0","47.67","16.80"
"64","000","00","050","0061","1178","603","202","401","8","611","1287","0","47.47","15.70"
"64","000","00","050","0061","1179","520","221","299","3","523","1209","0","43.26","18.28"
"64","000","00","050","0062","0000","1721","586","1135","13","1734","3606","0","48.09","16.25"
"64","000","00","050","0062","1180","541","183","358","2","543","1222","0","44.44","14.98"
"64","000","00","050","0062","1181","637","195","442","8","645","1264","0","51.03","15.43"
"64","000","00","050","0062","1182","543","208","335","3","546","1120","0","48.75","18.57"
"64","000","00","050","0063","0000","754","230","524","1","755","1671","0","45.18","13.76"
"64","000","00","050","0063","1183","754","230","524","1","755","1671","0","45.18","13.76"
"64","000","00","050","0064","0000","832","281","551","5","837","1690","0","49.53","16.63"
"64","000","00","050","0064","1184","448","159","289","2","450","907","0","49.61","17.53"
"64","000","00","050","0064","1185","384","122","262","3","387","783","0","49.43","15.58"
"64","000","00","050","0065","0000","933","354","579","5","938","1992","0","47.09","17.77"
"64","000","00","050","0065","1186","534","203","331","2","536","1127","0","47.56","18.01"
"64","000","00","050","0065","1187","399","151","248","3","402","865","0","46.47","17.46"
"64","000","00","050","0066","0000","336","102","234","3","339","659","0","51.44","15.48"
"64","000","00","050","0066","1188","336","102","234","3","339","659","0","51.44","15.48"
"64","000","00","050","0067","0000","384","114","270","2","386","914","0","42.23","12.47"
"64","000","00","050","0067","1189","384","114","270","2","386","914","0","42.23","12.47"
"64","000","00","050","0068","0000","591","192","399","3","594","1341","0","44.30","14.32"
"64","000","00","050","0068","1190","591","192","399","3","594","1341","0","44.30","14.32"
"64","000","00","050","0069","0000","630","249","381","1","631","1337","0","47.20","18.62"
"64","000","00","050","0069","1191","630","249","381","1","631","1337","0","47.20","18.62"
"64","000","00","050","0070","0000","329","122","207","7","336","760","0","44.21","16.05"
"64","000","00","050","0070","1192","329","122","207","7","336","760","0","44.21","16.05"
"64","000","00","050","0072","0000","541","216","325","2","543","1126","0","48.22","19.18"
"64","000","00","050","0072","1193","541","216","325","2","543","1126","0","48.22","19.18"
"64","000","00","050","0073","0000","1835","688","1147","16","1851","3922","0","47.20","17.54"
"64","000","00","050","0073","1194","584","230","354","6","590","1299","0","45.42","17.71"
"64","000","00","050","0073","1195","620","213","407","3","623","1300","0","47.92","16.38"
"64","000","00","050","0073","1196","631","245","386","7","638","1323","0","48.22","18.52"
"64","000","00","050","0074","0000","425","184","241","1","426","1008","0","42.26","18.25"
"64","000","00","050","0074","1197","425","184","241","1","426","1008","0","42.26","18.25"
"64","000","00","050","0075","0000","446","193","253","1","447","1147","0","38.97","16.83"
"64","000","00","050","0075","1198","446","193","253","1","447","1147","0","38.97","16.83"
"64","000","00","050","0076","0000","863","359","504","7","870","1905","0","45.67","18.85"
"64","000","00","050","0076","1199","424","168","256","3","427","915","0","46.67","18.36"
"64","000","00","050","0076","1200","439","191","248","4","443","990","0","44.75","19.29"
"64","000","00","050","0077","0000","456","127","329","7","463","886","0","52.26","14.33"
"64","000","00","050","0077","1201","456","127","329","7","463","886","0","52.26","14.33"
"64","000","00","050","0078","0000","656","209","447","8","664","1307","0","50.80","15.99"
"64","000","00","050","0078","1202","656","209","447","8","664","1307","0","50.80","15.99"
"64","000","00","050","0079","0000","427","163","264","4","431","998","0","43.19","16.33"
"64","000","00","050","0079","1203","427","163","264","4","431","998","0","43.19","16.33"
"64","000","00","050","0081","0000","972","315","657","9","981","2347","0","41.80","13.42"
"64","000","00","050","0081","1204","485","158","327","5","490","1206","0","40.63","13.10"
"64","000","00","050","0081","1205","487","157","330","4","491","1141","0","43.03","13.76"
"64","000","00","050","0082","0000","528","195","333","3","531","1212","0","43.81","16.09"
"64","000","00","050","0082","1206","528","195","333","3","531","1212","0","43.81","16.09"
"64","000","00","050","0083","0000","505","191","314","2","507","1226","0","41.35","15.58"
"64","000","00","050","0083","1207","505","191","314","2","507","1226","0","41.35","15.58"
"64","000","00","050","0084","0000","495","177","318","1","496","1046","0","47.42","16.92"
"64","000","00","050","0084","1208","495","177","318","1","496","1046","0","47.42","16.92"
"64","000","00","050","0085","0000","578","223","355","6","584","1082","0","53.97","20.61"
"64","000","00","050","0085","1209","578","223","355","6","584","1082","0","53.97","20.61"
"64","000","00","050","0086","0000","557","218","339","2","559","1156","0","48.36","18.86"
"64","000","00","050","0086","1210","557","218","339","2","559","1156","0","48.36","18.86"
"64","000","00","050","0087","0000","459","153","306","4","463","1009","0","45.89","15.16"
"64","000","00","050","0087","1211","459","153","306","4","463","1009","0","45.89","15.16"
"64","000","00","050","0088","0000","884","304","580","1","885","1967","0","44.99","15.46"
"64","000","00","050","0088","1212","424","146","278","1","425","925","0","45.95","15.78"
"64","000","00","050","0088","1213","460","158","302","0","460","1042","0","44.15","15.16"
"64","000","00","060","0000","0000","20101","8229","11872","130","20231","43307","49925","46.72","19.00"
"64","000","00","060","0001","0000","834","419","415","6","840","1749","0","48.03","23.96"
"64","000","00","060","0001","1346","389","197","192","3","392","794","0","49.37","24.81"
"64","000","00","060","0001","1347","445","222","223","3","448","955","0","46.91","23.25"
"64","000","00","060","0002","0000","483","214","269","3","486","1026","0","47.37","20.86"
"64","000","00","060","0002","1348","483","214","269","3","486","1026","0","47.37","20.86"
"64","000","00","060","0003","0000","1303","569","734","7","1310","2842","0","46.09","20.02"
"64","000","00","060","0003","1349","666","279","387","3","669","1394","0","47.99","20.01"
"64","000","00","060","0003","1350","637","290","347","4","641","1448","0","44.27","20.03"
"64","000","00","060","0004","0000","494","231","263","2","496","1011","0","49.06","22.85"
"64","000","00","060","0004","1351","494","231","263","2","496","1011","0","49.06","22.85"
"64","000","00","060","0005","0000","647","268","379","3","650","1282","0","50.70","20.90"
"64","000","00","060","0005","1352","647","268","379","3","650","1282","0","50.70","20.90"
"64","000","00","060","0006","0000","303","152","151","4","307","626","0","49.04","24.28"
"64","000","00","060","0006","1353","303","152","151","4","307","626","0","49.04","24.28"
"64","000","00","060","0007","0000","420","176","244","1","421","979","0","43.00","17.98"
"64","000","00","060","0007","1354","420","176","244","1","421","979","0","43.00","17.98"
"64","000","00","060","0008","0000","829","347","482","3","832","1808","0","46.02","19.19"
"64","000","00","060","0008","1355","436","191","245","1","437","883","0","49.49","21.63"
"64","000","00","060","0008","1356","393","156","237","2","395","925","0","42.70","16.86"
"64","000","00","060","0009","0000","407","150","257","3","410","902","0","45.45","16.63"
"64","000","00","060","0009","1357","407","150","257","3","410","902","0","45.45","16.63"
"64","000","00","060","0010","0000","359","143","216","4","363","706","0","51.42","20.25"
"64","000","00","060","0010","1358","359","143","216","4","363","706","0","51.42","20.25"
"64","000","00","060","0011","0000","598","230","368","2","600","1289","0","46.55","17.84"
"64","000","00","060","0011","1359","598","230","368","2","600","1289","0","46.55","17.84"
"64","000","00","060","0012","0000","314","117","197","4","318","736","0","43.21","15.90"
"64","000","00","060","0012","1360","314","117","197","4","318","736","0","43.21","15.90"
"64","000","00","060","0013","0000","857","333","524","0","857","1998","0","42.89","16.67"
"64","000","00","060","0013","1361","461","167","294","0","461","1026","0","44.93","16.28"
"64","000","00","060","0013","1362","396","166","230","0","396","972","0","40.74","17.08"
"64","000","00","060","0014","0000","1325","553","772","4","1329","2739","0","48.52","20.19"
"64","000","00","060","0014","1363","733","299","434","1","734","1469","0","49.97","20.35"
"64","000","00","060","0014","1364","592","254","338","3","595","1270","0","46.85","20.00"
"64","000","00","060","0015","0000","1053","454","599","7","1060","2197","0","48.25","20.66"
"64","000","00","060","0015","1365","538","205","333","3","541","1173","0","46.12","17.48"
"64","000","00","060","0015","1366","515","249","266","4","519","1024","0","50.68","24.32"
"64","000","00","060","0016","0000","783","351","432","8","791","1572","0","50.32","22.33"
"64","000","00","060","0016","1367","362","168","194","2","364","697","0","52.22","24.10"
"64","000","00","060","0016","1368","421","183","238","6","427","875","0","48.80","20.91"
"64","000","00","060","0017","0000","1575","670","905","16","1591","3254","0","48.89","20.59"
"64","000","00","060","0017","1369","493","227","266","5","498","1064","0","46.80","21.33"
"64","000","00","060","0017","1370","504","204","300","6","510","1108","0","46.03","18.41"
"64","000","00","060","0017","1371","578","239","339","5","583","1082","0","53.88","22.09"
"64","000","00","060","0018","0000","585","284","301","5","590","1299","0","45.42","21.86"
"64","000","00","060","0018","1372","585","284","301","5","590","1299","0","45.42","21.86"
"64","000","00","060","0019","0000","456","156","300","4","460","1074","0","42.83","14.53"
"64","000","00","060","0019","1373","456","156","300","4","460","1074","0","42.83","14.53"
"64","000","00","060","0020","0000","386","152","234","2","388","801","0","48.44","18.98"
"64","000","00","060","0020","1374","386","152","234","2","388","801","0","48.44","18.98"
"64","000","00","060","0021","0000","437","166","271","2","439","996","0","44.08","16.67"
"64","000","00","060","0021","1375","437","166","271","2","439","996","0","44.08","16.67"
"64","000","00","060","0022","0000","986","330","656","10","996","1859","0","53.58","17.75"
"64","000","00","060","0022","1376","484","152","332","6","490","901","0","54.38","16.87"
"64","000","00","060","0022","1377","502","178","324","4","506","958","0","52.82","18.58"
"64","000","00","060","0023","0000","1074","474","600","5","1079","2712","0","39.79","17.48"
"64","000","00","060","0023","1378","450","193","257","2","452","1363","0","33.16","14.16"
"64","000","00","060","0023","1379","624","281","343","3","627","1349","0","46.48","20.83"
"64","000","00","060","0024","0000","307","108","199","2","309","692","0","44.65","15.61"
"64","000","00","060","0024","1380","307","108","199","2","309","692","0","44.65","15.61"
"64","000","00","060","0025","0000","474","173","301","5","479","1021","0","46.91","16.94"
"64","000","00","060","0025","1381","474","173","301","5","479","1021","0","46.91","16.94"
"64","000","00","060","0026","0000","417","153","264","2","419","960","0","43.65","15.94"
"64","000","00","060","0026","1382","417","153","264","2","419","960","0","43.65","15.94"
"64","000","00","060","0027","0000","388","154","234","4","392","934","0","41.97","16.49"
"64","000","00","060","0027","1383","388","154","234","4","392","934","0","41.97","16.49"
"64","000","00","060","0028","0000","386","126","260","1","387","919","0","42.11","13.71"
"64","000","00","060","0028","1384","386","126","260","1","387","919","0","42.11","13.71"
"64","000","00","060","0029","0000","390","130","260","1","391","785","0","49.81","16.56"
"64","000","00","060","0029","1385","390","130","260","1","391","785","0","49.81","16.56"
"64","000","00","060","0030","0000","326","119","207","3","329","685","0","48.03","17.37"
"64","000","00","060","0030","1386","326","119","207","3","329","685","0","48.03","17.37"
"64","000","00","060","0031","0000","332","153","179","2","334","702","0","47.58","21.79"
"64","000","00","060","0031","1387","332","153","179","2","334","702","0","47.58","21.79"
"64","000","00","060","0032","0000","573","174","399","5","578","1152","0","50.17","15.10"
"64","000","00","060","0032","1388","573","174","399","5","578","1152","0","50.17","15.10"
"64","000","00","070","0000","0000","11107","4553","6554","75","11182","23787","26498","47.01","19.14"
"64","000","00","070","0001","0000","326","81","245","1","327","658","0","49.70","12.31"
"64","000","00","070","0001","1321","326","81","245","1","327","658","0","49.70","12.31"
"64","000","00","070","0002","0000","487","222","265","4","491","983","0","49.95","22.58"
"64","000","00","070","0002","1322","487","222","265","4","491","983","0","49.95","22.58"
"64","000","00","070","0003","0000","579","191","388","7","586","1310","0","44.73","14.58"
"64","000","00","070","0003","1323","579","191","388","7","586","1310","0","44.73","14.58"
"64","000","00","070","0004","0000","373","134","239","0","373","809","0","46.11","16.56"
"64","000","00","070","0004","1324","373","134","239","0","373","809","0","46.11","16.56"
"64","000","00","070","0005","0000","472","174","298","2","474","957","0","49.53","18.18"
"64","000","00","070","0005","1325","472","174","298","2","474","957","0","49.53","18.18"
"64","000","00","070","0006","0000","1626","740","886","9","1635","3581","0","45.66","20.66"
"64","000","00","070","0006","1326","565","281","284","5","570","1215","0","46.91","23.13"
"64","000","00","070","0006","1327","586","246","340","2","588","1234","0","47.65","19.94"
"64","000","00","070","0006","1328","475","213","262","2","477","1132","0","42.14","18.82"
"64","000","00","070","0007","0000","310","129","181","1","311","662","0","46.98","19.49"
"64","000","00","070","0007","1329","310","129","181","1","311","662","0","46.98","19.49"
"64","000","00","070","0008","0000","531","217","314","4","535","1150","0","46.52","18.87"
"64","000","00","070","0008","1330","531","217","314","4","535","1150","0","46.52","18.87"
"64","000","00","070","0009","0000","813","329","484","11","824","1817","0","45.35","18.11"
"64","000","00","070","0009","1331","413","172","241","6","419","895","0","46.82","19.22"
"64","000","00","070","0009","1332","400","157","243","5","405","922","0","43.93","17.03"
"64","000","00","070","0010","0000","351","159","192","1","352","778","0","45.24","20.44"
"64","000","00","070","0010","1333","351","159","192","1","352","778","0","45.24","20.44"
"64","000","00","070","0011","0000","476","198","278","4","480","992","0","48.39","19.96"
"64","000","00","070","0011","1334","476","198","278","4","480","992","0","48.39","19.96"
"64","000","00","070","0012","0000","404","133","271","2","406","1030","0","39.42","12.91"
"64","000","00","070","0012","1335","404","133","271","2","406","1030","0","39.42","12.91"
"64","000","00","070","0013","0000","410","159","251","5","415","901","0","46.06","17.65"
"64","000","00","070","0013","1336","410","159","251","5","415","901","0","46.06","17.65"
"64","000","00","070","0014","0000","679","306","373","3","682","1424","0","47.89","21.49"
"64","000","00","070","0014","1337","325","157","168","0","325","698","0","46.56","22.49"
"64","000","00","070","0014","1338","354","149","205","3","357","726","0","49.17","20.52"
"64","000","00","070","0015","0000","508","237","271","2","510","1017","0","50.15","23.30"
"64","000","00","070","0015","1339","508","237","271","2","510","1017","0","50.15","23.30"
"64","000","00","070","0016","0000","465","185","280","2","467","986","0","47.36","18.76"
"64","000","00","070","0016","1340","465","185","280","2","467","986","0","47.36","18.76"
"64","000","00","070","0017","0000","820","376","444","6","826","1640","0","50.37","22.93"
"64","000","00","070","0017","1341","423","200","223","3","426","863","0","49.36","23.17"
"64","000","00","070","0017","1342","397","176","221","3","400","777","0","51.48","22.65"
"64","000","00","070","0018","0000","487","199","288","4","491","1043","0","47.08","19.08"
"64","000","00","070","0018","1343","487","199","288","4","491","1043","0","47.08","19.08"
"64","000","00","070","0019","0000","449","161","288","4","453","941","0","48.14","17.11"
"64","000","00","070","0019","1344","449","161","288","4","453","941","0","48.14","17.11"
"64","000","00","070","0020","0000","541","223","318","3","544","1108","0","49.10","20.13"
"64","000","00","070","0020","1345","541","223","318","3","544","1108","0","49.10","20.13"
"64","000","00","080","0000","0000","64806","27019","37787","464","65270","143752","166008","45.40","18.80"
"64","000","00","080","0001","0000","340","162","178","1","341","681","0","50.07","23.79"
"64","000","00","080","0001","1389","340","162","178","1","341","681","0","50.07","23.79"
"64","000","00","080","0002","0000","623","287","336","7","630","1496","0","42.11","19.18"
"64","000","00","080","0002","1390","329","155","174","6","335","785","0","42.68","19.75"
"64","000","00","080","0002","1391","294","132","162","1","295","711","0","41.49","18.57"
"64","000","00","080","0003","0000","506","213","293","2","508","1147","0","44.29","18.57"
"64","000","00","080","0003","1392","506","213","293","2","508","1147","0","44.29","18.57"
"64","000","00","080","0004","0000","702","260","442","12","714","1552","0","46.01","16.75"
"64","000","00","080","0004","1393","328","130","198","7","335","739","0","45.33","17.59"
"64","000","00","080","0004","1394","374","130","244","5","379","813","0","46.62","15.99"
"64","000","00","080","0005","0000","610","276","334","1","611","1384","0","44.15","19.94"
"64","000","00","080","0005","1395","296","141","155","0","296","681","0","43.47","20.70"
"64","000","00","080","0005","1396","314","135","179","1","315","703","0","44.81","19.20"
"64","000","00","080","0006","0000","603","210","393","1","604","1405","0","42.99","14.95"
"64","000","00","080","0006","1397","321","101","220","1","322","720","0","44.72","14.03"
"64","000","00","080","0006","1398","282","109","173","0","282","685","0","41.17","15.91"
"64","000","00","080","0007","0000","657","276","381","5","662","1540","0","42.99","17.92"
"64","000","00","080","0007","1399","313","152","161","2","315","773","0","40.75","19.66"
"64","000","00","080","0007","1400","344","124","220","3","347","767","0","45.24","16.17"
"64","000","00","080","0008","0000","258","96","162","2","260","506","0","51.38","18.97"
"64","000","00","080","0008","1401","258","96","162","2","260","506","0","51.38","18.97"
"64","000","00","080","0009","0000","798","325","473","8","806","1861","0","43.31","17.46"
"64","000","00","080","0009","1402","381","161","220","2","383","919","0","41.68","17.52"
"64","000","00","080","0009","1403","417","164","253","6","423","942","0","44.90","17.41"
"64","000","00","080","0010","0000","1387","650","737","7","1394","3663","0","38.06","17.75"
"64","000","00","080","0010","1404","464","199","265","2","466","1119","0","41.64","17.78"
"64","000","00","080","0010","1405","473","220","253","3","476","1305","0","36.48","16.86"
"64","000","00","080","0010","1406","450","231","219","2","452","1239","0","36.48","18.64"
"64","000","00","080","0011","0000","411","154","257","1","412","878","0","46.92","17.54"
"64","000","00","080","0011","1407","411","154","257","1","412","878","0","46.92","17.54"
"64","000","00","080","0012","0000","608","266","342","5","613","1259","0","48.69","21.13"
"64","000","00","080","0012","1408","608","266","342","5","613","1259","0","48.69","21.13"
"64","000","00","080","0013","0000","717","272","445","10","727","1714","0","42.42","15.87"
"64","000","00","080","0013","1409","366","137","229","5","371","881","0","42.11","15.55"
"64","000","00","080","0013","1410","351","135","216","5","356","833","0","42.74","16.21"
"64","000","00","080","0014","0000","635","287","348","4","639","1191","0","53.65","24.10"
"64","000","00","080","0014","1411","635","287","348","4","639","1191","0","53.65","24.10"
"64","000","00","080","0015","0000","817","281","536","5","822","1686","0","48.75","16.67"
"64","000","00","080","0015","1412","419","150","269","5","424","866","0","48.96","17.32"
"64","000","00","080","0015","1413","398","131","267","0","398","820","0","48.54","15.98"
"64","000","00","080","0016","0000","493","209","284","3","496","1085","0","45.71","19.26"
"64","000","00","080","0016","1414","493","209","284","3","496","1085","0","45.71","19.26"
"64","000","00","080","0017","0000","1374","573","801","9","1383","2948","0","46.91","19.44"
"64","000","00","080","0017","1415","478","188","290","4","482","959","0","50.26","19.60"
"64","000","00","080","0017","1416","469","190","279","3","472","987","0","47.82","19.25"
"64","000","00","080","0017","1417","427","195","232","2","429","1002","0","42.81","19.46"
"64","000","00","080","0018","0000","1002","377","625","3","1005","2080","0","48.32","18.13"
"64","000","00","080","0018","1418","518","169","349","3","521","1045","0","49.86","16.17"
"64","000","00","080","0018","1419","484","208","276","0","484","1035","0","46.76","20.10"
"64","000","00","080","0019","0000","1383","556","827","13","1396","2971","0","46.99","18.71"
"64","000","00","080","0019","1420","483","179","304","2","485","1006","0","48.21","17.79"
"64","000","00","080","0019","1421","441","191","250","3","444","960","0","46.25","19.90"
"64","000","00","080","0019","1422","459","186","273","8","467","1005","0","46.47","18.51"
"64","000","00","080","0020","0000","898","379","519","6","904","1962","0","46.08","19.32"
"64","000","00","080","0020","1423","450","221","229","3","453","971","0","46.65","22.76"
"64","000","00","080","0020","1424","448","158","290","3","451","991","0","45.51","15.94"
"64","000","00","080","0021","0000","754","321","433","4","758","2551","0","29.71","12.58"
"64","000","00","080","0021","1425","566","234","332","4","570","1215","0","46.91","19.26"
"64","000","00","080","0021","1426","188","87","101","0","188","1336","0","14.07","6.51"
"64","000","00","080","0022","0000","1565","675","890","12","1577","3394","0","46.46","19.89"
"64","000","00","080","0022","1427","544","252","292","7","551","1116","0","49.37","22.58"
"64","000","00","080","0022","1428","560","236","324","1","561","1267","0","44.28","18.63"
"64","000","00","080","0022","1429","461","187","274","4","465","1011","0","45.99","18.50"
"64","000","00","080","0023","0000","1029","444","585","7","1036","2101","0","49.31","21.13"
"64","000","00","080","0023","1430","573","213","360","6","579","1182","0","48.98","18.02"
"64","000","00","080","0023","1431","456","231","225","1","457","919","0","49.73","25.14"
"64","000","00","080","0024","0000","1061","507","554","5","1066","2233","0","47.74","22.70"
"64","000","00","080","0024","1432","540","275","265","5","545","1113","0","48.97","24.71"
"64","000","00","080","0024","1433","521","232","289","0","521","1120","0","46.52","20.71"
"64","000","00","080","0025","0000","649","306","343","2","651","1434","0","45.40","21.34"
"64","000","00","080","0025","1434","318","139","179","2","320","702","0","45.58","19.80"
"64","000","00","080","0025","1435","331","167","164","0","331","732","0","45.22","22.81"
"64","000","00","080","0026","0000","319","101","218","4","323","666","0","48.50","15.17"
"64","000","00","080","0026","1436","319","101","218","4","323","666","0","48.50","15.17"
"64","000","00","080","0027","0000","556","162","394","2","558","1226","0","45.51","13.21"
"64","000","00","080","0027","1437","284","88","196","1","285","590","0","48.31","14.92"
"64","000","00","080","0027","1438","272","74","198","1","273","636","0","42.92","11.64"
"64","000","00","080","0028","0000","1214","447","767","7","1221","2632","0","46.39","16.98"
"64","000","00","080","0028","1439","396","133","263","2","398","846","0","47.04","15.72"
"64","000","00","080","0028","1440","426","152","274","3","429","873","0","49.14","17.41"
"64","000","00","080","0028","1441","392","162","230","2","394","913","0","43.15","17.74"
"64","000","00","080","0029","0000","666","278","388","1","667","1516","0","44.00","18.34"
"64","000","00","080","0029","1442","340","139","201","0","340","777","0","43.76","17.89"
"64","000","00","080","0029","1443","326","139","187","1","327","739","0","44.25","18.81"
"64","000","00","080","0030","0000","1254","498","756","5","1259","2734","0","46.05","18.22"
"64","000","00","080","0030","1444","451","175","276","1","452","975","0","46.36","17.95"
"64","000","00","080","0030","1445","406","146","260","4","410","904","0","45.35","16.15"
"64","000","00","080","0030","1446","397","177","220","0","397","855","0","46.43","20.70"
"64","000","00","080","0031","0000","873","418","455","7","880","1845","0","47.70","22.66"
"64","000","00","080","0031","1447","437","197","240","2","439","899","0","48.83","21.91"
"64","000","00","080","0031","1448","436","221","215","5","441","946","0","46.62","23.36"
"64","000","00","080","0032","0000","1308","656","652","6","1314","2771","0","47.42","23.67"
"64","000","00","080","0032","1449","413","212","201","1","414","866","0","47.81","24.48"
"64","000","00","080","0032","1450","444","235","209","2","446","905","0","49.28","25.97"
"64","000","00","080","0032","1451","451","209","242","3","454","1000","0","45.40","20.90"
"64","000","00","080","0033","0000","1266","548","718","11","1277","2724","0","46.88","20.12"
"64","000","00","080","0033","1452","449","202","247","4","453","923","0","49.08","21.89"
"64","000","00","080","0033","1453","400","179","221","1","401","855","0","46.90","20.94"
"64","000","00","080","0033","1454","417","167","250","6","423","946","0","44.71","17.65"
"64","000","00","080","0034","0000","696","298","398","4","700","1480","0","47.30","20.14"
"64","000","00","080","0034","1455","360","150","210","3","363","756","0","48.02","19.84"
"64","000","00","080","0034","1456","336","148","188","1","337","724","0","46.55","20.44"
"64","000","00","080","0035","0000","986","469","517","8","994","2090","0","47.56","22.44"
"64","000","00","080","0035","1457","465","236","229","3","468","1021","0","45.84","23.11"
"64","000","00","080","0035","1458","521","233","288","5","526","1069","0","49.20","21.80"
"64","000","00","080","0036","0000","940","491","449","2","942","2096","0","44.94","23.43"
"64","000","00","080","0036","1459","486","241","245","2","488","1054","0","46.30","22.87"
"64","000","00","080","0036","1460","454","250","204","0","454","1042","0","43.57","23.99"
"64","000","00","080","0037","0000","1105","486","619","7","1112","2380","0","46.72","20.42"
"64","000","00","080","0037","1461","596","248","348","3","599","1274","0","47.02","19.47"
"64","000","00","080","0037","1462","509","238","271","4","513","1106","0","46.38","21.52"
"64","000","00","080","0038","0000","710","315","395","7","717","1489","0","48.15","21.16"
"64","000","00","080","0038","1463","323","138","185","1","324","697","0","46.48","19.80"
"64","000","00","080","0038","1464","387","177","210","6","393","792","0","49.62","22.35"
"64","000","00","080","0039","0000","679","206","473","7","686","1389","0","49.39","14.83"
"64","000","00","080","0039","1465","327","107","220","3","330","705","0","46.81","15.18"
"64","000","00","080","0039","1466","352","99","253","4","356","684","0","52.05","14.47"
"64","000","00","080","0040","0000","787","286","501","10","797","1620","0","49.20","17.65"
"64","000","00","080","0040","1467","370","128","242","6","376","765","0","49.15","16.73"
"64","000","00","080","0040","1468","417","158","259","4","421","855","0","49.24","18.48"
"64","000","00","080","0041","0000","1091","492","599","13","1104","2086","0","52.92","23.59"
"64","000","00","080","0041","1469","588","255","333","5","593","1110","0","53.42","22.97"
"64","000","00","080","0041","1470","503","237","266","8","511","976","0","52.36","24.28"
"64","000","00","080","0042","0000","1731","718","1013","17","1748","3752","0","46.59","19.14"
"64","000","00","080","0042","1471","447","175","272","5","452","914","0","49.45","19.15"
"64","000","00","080","0042","1472","383","150","233","4","387","851","0","45.48","17.63"
"64","000","00","080","0042","1473","413","153","260","4","417","923","0","45.18","16.58"
"64","000","00","080","0042","1474","488","240","248","4","492","1064","0","46.24","22.56"
"64","000","00","080","0043","0000","833","360","473","3","836","1742","0","47.99","20.67"
"64","000","00","080","0043","1475","454","211","243","1","455","931","0","48.87","22.66"
"64","000","00","080","0043","1476","379","149","230","2","381","811","0","46.98","18.37"
"64","000","00","080","0044","0000","776","326","450","4","780","1748","0","44.62","18.65"
"64","000","00","080","0044","1477","396","177","219","2","398","855","0","46.55","20.70"
"64","000","00","080","0044","1478","380","149","231","2","382","893","0","42.78","16.69"
"64","000","00","080","0045","0000","1667","752","915","8","1675","3776","0","44.36","19.92"
"64","000","00","080","0045","1479","560","295","265","2","562","1250","0","44.96","23.60"
"64","000","00","080","0045","1480","608","247","361","2","610","1284","0","47.51","19.24"
"64","000","00","080","0045","1481","499","210","289","4","503","1242","0","40.50","16.91"
"64","000","00","080","0046","0000","816","296","520","6","822","1791","0","45.90","16.53"
"64","000","00","080","0046","1482","404","155","249","1","405","894","0","45.30","17.34"
"64","000","00","080","0046","1483","412","141","271","5","417","897","0","46.49","15.72"
"64","000","00","080","0047","0000","734","400","334","9","743","1489","0","49.90","26.86"
"64","000","00","080","0047","1484","371","177","194","5","376","774","0","48.58","22.87"
"64","000","00","080","0047","1485","363","223","140","4","367","715","0","51.33","31.19"
"64","000","00","080","0048","0000","619","229","390","4","623","1371","0","45.44","16.70"
"64","000","00","080","0048","1486","326","115","211","2","328","714","0","45.94","16.11"
"64","000","00","080","0048","1487","293","114","179","2","295","657","0","44.90","17.35"
"64","000","00","080","0049","0000","1128","391","737","11","1139","2410","0","47.26","16.22"
"64","000","00","080","0049","1488","560","210","350","3","563","1205","0","46.72","17.43"
"64","000","00","080","0049","1489","568","181","387","8","576","1205","0","47.80","15.02"
"64","000","00","080","0050","0000","527","233","294","3","530","1158","0","45.77","20.12"
"64","000","00","080","0050","1490","527","233","294","3","530","1158","0","45.77","20.12"
"64","000","00","080","0051","0000","450","220","230","7","457","1023","0","44.67","21.51"
"64","000","00","080","0051","1491","450","220","230","7","457","1023","0","44.67","21.51"
"64","000","00","080","0052","0000","850","278","572","11","861","1787","0","48.18","15.56"
"64","000","00","080","0052","1492","428","124","304","7","435","907","0","47.96","13.67"
"64","000","00","080","0052","1493","422","154","268","4","426","880","0","48.41","17.50"
"64","000","00","080","0053","0000","818","342","476","11","829","1974","0","42.00","17.33"
"64","000","00","080","0053","1494","444","178","266","7","451","1084","0","41.61","16.42"
"64","000","00","080","0053","1495","374","164","210","4","378","890","0","42.47","18.43"
"64","000","00","080","0054","0000","1067","413","654","13","1080","2537","0","42.57","16.28"
"64","000","00","080","0054","1496","511","174","337","8","519","1276","0","40.67","13.64"
"64","000","00","080","0054","1497","556","239","317","5","561","1261","0","44.49","18.95"
"64","000","00","080","0055","0000","1057","349","708","11","1068","2583","0","41.35","13.51"
"64","000","00","080","0055","1498","479","162","317","5","484","1278","0","37.87","12.68"
"64","000","00","080","0055","1499","578","187","391","6","584","1305","0","44.75","14.33"
"64","000","00","080","0056","0000","1098","455","643","3","1101","2521","0","43.67","18.05"
"64","000","00","080","0056","1500","500","186","314","1","501","1165","0","43.00","15.97"
"64","000","00","080","0056","1501","598","269","329","2","600","1356","0","44.25","19.84"
"64","000","00","080","0057","0000","783","276","507","5","788","1685","0","46.77","16.38"
"64","000","00","080","0057","1502","392","135","257","1","393","809","0","48.58","16.69"
"64","000","00","080","0057","1503","391","141","250","4","395","876","0","45.09","16.10"
"64","000","00","080","0058","0000","985","441","544","4","989","2051","0","48.22","21.50"
"64","000","00","080","0058","1504","531","242","289","2","533","1035","0","51.50","23.38"
"64","000","00","080","0058","1505","454","199","255","2","456","1016","0","44.88","19.59"
"64","000","00","080","0059","0000","993","396","597","4","997","2240","0","44.51","17.68"
"64","000","00","080","0059","1506","485","198","287","3","488","1092","0","44.69","18.13"
"64","000","00","080","0059","1507","508","198","310","1","509","1148","0","44.34","17.25"
"64","000","00","080","0060","0000","1201","510","691","8","1209","2641","0","45.78","19.31"
"64","000","00","080","0060","1508","407","194","213","3","410","872","0","47.02","22.25"
"64","000","00","080","0060","1509","331","143","188","1","332","772","0","43.01","18.52"
"64","000","00","080","0060","1510","463","173","290","4","467","997","0","46.84","17.35"
"64","000","00","080","0061","0000","1995","931","1064","18","2013","4822","0","41.75","19.31"
"64","000","00","080","0061","1511","542","279","263","4","546","1250","0","43.68","22.32"
"64","000","00","080","0061","1512","460","215","245","7","467","1057","0","44.18","20.34"
"64","000","00","080","0061","1513","493","195","298","1","494","1239","0","39.87","15.74"
"64","000","00","080","0061","1514","500","242","258","6","506","1276","0","39.66","18.97"
"64","000","00","080","0062","0000","1637","689","948","11","1648","3581","0","46.02","19.24"
"64","000","00","080","0062","1515","593","286","307","3","596","1189","0","50.13","24.05"
"64","000","00","080","0062","1516","505","199","306","4","509","1167","0","43.62","17.05"
"64","000","00","080","0062","1517","539","204","335","4","543","1225","0","44.33","16.65"
"64","000","00","080","0063","0000","1596","674","922","8","1604","3399","0","47.19","19.83"
"64","000","00","080","0063","1518","536","217","319","3","539","1149","0","46.91","18.89"
"64","000","00","080","0063","1519","507","210","297","2","509","1137","0","44.77","18.47"
"64","000","00","080","0063","1520","553","247","306","3","556","1113","0","49.96","22.19"
"64","000","00","080","0064","0000","1720","721","999","13","1733","4055","0","42.74","17.78"
"64","000","00","080","0064","1521","577","236","341","5","582","1372","0","42.42","17.20"
"64","000","00","080","0064","1522","536","232","304","5","541","1318","0","41.05","17.60"
"64","000","00","080","0064","1523","607","253","354","3","610","1365","0","44.69","18.53"
"64","000","00","080","0065","0000","1160","421","739","4","1164","2329","0","49.98","18.08"
"64","000","00","080","0065","1524","546","191","355","3","549","1155","0","47.53","16.54"
"64","000","00","080","0065","1525","614","230","384","1","615","1174","0","52.39","19.59"
"64","000","00","080","0066","0000","1006","442","564","6","1012","2409","0","42.01","18.35"
"64","000","00","080","0066","1526","485","205","280","2","487","1188","0","40.99","17.26"
"64","000","00","080","0066","1527","521","237","284","4","525","1221","0","43.00","19.41"
"64","000","00","080","0067","0000","1546","561","985","12","1558","3573","0","43.60","15.70"
"64","000","00","080","0067","1528","538","178","360","8","546","1192","0","45.81","14.93"
"64","000","00","080","0067","1529","502","198","304","0","502","1202","0","41.76","16.47"
"64","000","00","080","0067","1530","506","185","321","4","510","1179","0","43.26","15.69"
"64","000","00","080","0068","0000","796","272","524","10","806","1945","0","41.44","13.98"
"64","000","00","080","0068","1531","373","114","259","5","378","920","0","41.09","12.39"
"64","000","00","080","0068","1532","423","158","265","5","428","1025","0","41.76","15.41"
"64","000","00","080","0069","0000","887","410","477","4","891","1894","0","47.04","21.65"
"64","000","00","080","0069","1533","449","202","247","1","450","957","0","47.02","21.11"
"64","000","00","080","0069","1534","438","208","230","3","441","937","0","47.07","22.20"
"64","000","00","090","0000","0000","70121","26987","43134","531","70652","159582","184355","44.27","16.91"
"64","000","00","090","0001","0000","3592","1104","2488","29","3621","9285","0","39.00","11.89"
"64","000","00","090","0001","1787","431","126","305","3","434","956","0","45.40","13.18"
"64","000","00","090","0001","1788","209","70","139","4","213","419","0","50.84","16.71"
"64","000","00","090","0001","1789","491","159","332","6","497","1290","0","38.53","12.33"
"64","000","00","090","0001","1790","515","161","354","5","520","1318","0","39.45","12.22"
"64","000","00","090","0001","1791","459","135","324","4","463","1342","0","34.50","10.06"
"64","000","00","090","0001","1792","440","136","304","3","443","1252","0","35.38","10.86"
"64","000","00","090","0001","1793","501","158","343","1","502","1316","0","38.15","12.01"
"64","000","00","090","0001","1794","546","159","387","3","549","1392","0","39.44","11.42"
"64","000","00","090","0002","0000","980","290","690","8","988","2288","0","43.18","12.67"
"64","000","00","090","0002","1795","371","115","256","7","378","821","0","46.04","14.01"
"64","000","00","090","0002","1796","352","100","252","0","352","831","0","42.36","12.03"
"64","000","00","090","0002","1797","257","75","182","1","258","636","0","40.57","11.79"
"64","000","00","090","0003","0000","2217","691","1526","22","2239","4994","0","44.83","13.84"
"64","000","00","090","0003","1798","500","152","348","7","507","1106","0","45.84","13.74"
"64","000","00","090","0003","1799","442","148","294","5","447","1037","0","43.11","14.27"
"64","000","00","090","0003","1800","480","124","356","6","486","1066","0","45.59","11.63"
"64","000","00","090","0003","1801","340","113","227","2","342","718","0","47.63","15.74"
"64","000","00","090","0003","1802","455","154","301","2","457","1067","0","42.83","14.43"
"64","000","00","090","0004","0000","978","335","643","11","989","2203","0","44.89","15.21"
"64","000","00","090","0004","1803","477","204","273","4","481","1030","0","46.70","19.81"
"64","000","00","090","0004","1804","501","131","370","7","508","1173","0","43.31","11.17"
"64","000","00","090","0005","0000","565","161","404","8","573","1263","0","45.37","12.75"
"64","000","00","090","0005","1805","565","161","404","8","573","1263","0","45.37","12.75"
"64","000","00","090","0006","0000","732","285","447","7","739","1891","0","39.08","15.07"
"64","000","00","090","0006","1806","384","128","256","5","389","914","0","42.56","14.00"
"64","000","00","090","0006","1807","348","157","191","2","350","977","0","35.82","16.07"
"64","000","00","090","0007","0000","855","291","564","8","863","2883","0","29.93","10.09"
"64","000","00","090","0007","1808","478","151","327","7","485","1163","0","41.70","12.98"
"64","000","00","090","0007","1809","377","140","237","1","378","1720","0","21.98","8.14"
"64","000","00","090","0008","0000","241","58","183","6","247","606","0","40.76","9.57"
"64","000","00","090","0008","1810","241","58","183","6","247","606","0","40.76","9.57"
"64","000","00","090","0009","0000","627","163","464","5","632","1420","0","44.51","11.48"
"64","000","00","090","0009","1811","627","163","464","5","632","1420","0","44.51","11.48"
"64","000","00","090","0010","0000","636","169","467","4","640","1365","0","46.89","12.38"
"64","000","00","090","0010","1812","636","169","467","4","640","1365","0","46.89","12.38"
"64","000","00","090","0011","0000","916","307","609","7","923","2203","0","41.90","13.94"
"64","000","00","090","0011","1813","396","124","272","2","398","929","0","42.84","13.35"
"64","000","00","090","0011","1814","520","183","337","5","525","1274","0","41.21","14.36"
"64","000","00","090","0012","0000","446","117","329","3","449","1033","0","43.47","11.33"
"64","000","00","090","0012","1815","446","117","329","3","449","1033","0","43.47","11.33"
"64","000","00","090","0013","0000","313","90","223","4","317","656","0","48.32","13.72"
"64","000","00","090","0013","1816","313","90","223","4","317","656","0","48.32","13.72"
"64","000","00","090","0014","0000","311","70","241","0","311","673","0","46.21","10.40"
"64","000","00","090","0014","1817","311","70","241","0","311","673","0","46.21","10.40"
"64","000","00","090","0015","0000","593","169","424","11","604","1293","0","46.71","13.07"
"64","000","00","090","0015","1818","593","169","424","11","604","1293","0","46.71","13.07"
"64","000","00","090","0016","0000","830","233","597","6","836","1636","0","51.10","14.24"
"64","000","00","090","0016","1819","435","141","294","3","438","827","0","52.96","17.05"
"64","000","00","090","0016","1820","395","92","303","3","398","809","0","49.20","11.37"
"64","000","00","090","0017","0000","910","265","645","11","921","2041","0","45.12","12.98"
"64","000","00","090","0017","1821","466","132","334","8","474","1000","0","47.40","13.20"
"64","000","00","090","0017","1822","444","133","311","3","447","1041","0","42.94","12.78"
"64","000","00","090","0018","0000","856","255","601","8","864","1918","0","45.05","13.30"
"64","000","00","090","0018","1823","445","128","317","5","450","1022","0","44.03","12.52"
"64","000","00","090","0018","1824","411","127","284","3","414","896","0","46.21","14.17"
"64","000","00","090","0019","0000","1755","638","1117","9","1764","3979","0","44.33","16.03"
"64","000","00","090","0019","1825","546","179","367","3","549","1316","0","41.72","13.60"
"64","000","00","090","0019","1826","662","247","415","4","666","1396","0","47.71","17.69"
"64","000","00","090","0019","1827","547","212","335","2","549","1267","0","43.33","16.73"
"64","000","00","090","0020","0000","400","147","253","3","403","902","0","44.68","16.30"
"64","000","00","090","0020","1828","400","147","253","3","403","902","0","44.68","16.30"
"64","000","00","090","0021","0000","1251","543","708","8","1259","2779","0","45.30","19.54"
"64","000","00","090","0021","1829","646","295","351","6","652","1413","0","46.14","20.88"
"64","000","00","090","0021","1830","605","248","357","2","607","1366","0","44.44","18.16"
"64","000","00","090","0022","0000","366","122","244","1","367","802","0","45.76","15.21"
"64","000","00","090","0022","1831","366","122","244","1","367","802","0","45.76","15.21"
"64","000","00","090","0023","0000","497","176","321","8","505","1077","0","46.89","16.34"
"64","000","00","090","0023","1832","497","176","321","8","505","1077","0","46.89","16.34"
"64","000","00","090","0024","0000","2518","1736","782","32","2550","5166","0","49.36","33.60"
"64","000","00","090","0024","1833","616","524","92","13","629","1218","0","51.64","43.02"
"64","000","00","090","0024","1834","696","544","152","10","706","1393","0","50.68","39.05"
"64","000","00","090","0024","1835","544","395","149","4","548","1113","0","49.24","35.49"
"64","000","00","090","0024","1836","662","273","389","5","667","1442","0","46.26","18.93"
"64","000","00","090","0025","0000","981","798","183","17","998","1970","0","50.66","40.51"
"64","000","00","090","0025","1837","562","455","107","13","575","1023","0","56.21","44.48"
"64","000","00","090","0025","1838","419","343","76","4","423","947","0","44.67","36.22"
"64","000","00","090","0028","0000","1464","675","789","11","1475","3261","0","45.23","20.70"
"64","000","00","090","0028","1839","434","175","259","2","436","1006","0","43.34","17.40"
"64","000","00","090","0028","1840","513","235","278","1","514","1105","0","46.52","21.27"
"64","000","00","090","0028","1841","517","265","252","8","525","1150","0","45.65","23.04"
"64","000","00","090","0029","0000","1930","963","967","9","1939","3898","0","49.74","24.70"
"64","000","00","090","0029","1842","663","310","353","5","668","1253","0","53.31","24.74"
"64","000","00","090","0029","1843","693","352","341","1","694","1358","0","51.10","25.92"
"64","000","00","090","0029","1844","574","301","273","3","577","1287","0","44.83","23.39"
"64","000","00","090","0030","0000","585","263","322","7","592","1249","0","47.40","21.06"
"64","000","00","090","0030","1845","585","263","322","7","592","1249","0","47.40","21.06"
"64","000","00","090","0031","0000","1007","464","543","3","1010","2251","0","44.87","20.61"
"64","000","00","090","0031","1846","475","207","268","0","475","1077","0","44.10","19.22"
"64","000","00","090","0031","1847","532","257","275","3","535","1174","0","45.57","21.89"
"64","000","00","090","0032","0000","1358","716","642","4","1362","2750","0","49.53","26.04"
"64","000","00","090","0032","1848","720","359","361","1","721","1426","0","50.56","25.18"
"64","000","00","090","0032","1849","638","357","281","3","641","1324","0","48.41","26.96"
"64","000","00","090","0033","0000","909","330","579","4","913","2053","0","44.47","16.07"
"64","000","00","090","0033","1850","490","171","319","3","493","1007","0","48.96","16.98"
"64","000","00","090","0033","1851","419","159","260","1","420","1046","0","40.15","15.20"
"64","000","00","090","0034","0000","1108","537","571","6","1114","2633","0","42.31","20.39"
"64","000","00","090","0034","1852","588","293","295","3","591","1345","0","43.94","21.78"
"64","000","00","090","0034","1853","520","244","276","3","523","1288","0","40.61","18.94"
"64","000","00","090","0035","0000","1303","505","798","12","1315","2968","0","44.31","17.01"
"64","000","00","090","0035","1854","674","246","428","6","680","1474","0","46.13","16.69"
"64","000","00","090","0035","1855","629","259","370","6","635","1494","0","42.50","17.34"
"64","000","00","090","0036","0000","1296","545","751","14","1310","2985","0","43.89","18.26"
"64","000","00","090","0036","1856","468","212","256","7","475","1047","0","45.37","20.25"
"64","000","00","090","0036","1857","485","193","292","2","487","963","0","50.57","20.04"
"64","000","00","090","0036","1858","343","140","203","5","348","975","0","35.69","14.36"
"64","000","00","090","0037","0000","2486","1075","1411","21","2507","5492","0","45.65","19.57"
"64","000","00","090","0037","1859","596","201","395","6","602","1329","0","45.30","15.12"
"64","000","00","090","0037","1860","583","270","313","7","590","1249","0","47.24","21.62"
"64","000","00","090","0037","1861","629","259","370","2","631","1506","0","41.90","17.20"
"64","000","00","090","0037","1862","678","345","333","6","684","1408","0","48.58","24.50"
"64","000","00","090","0038","0000","1371","651","720","13","1384","2994","0","46.23","21.74"
"64","000","00","090","0038","1863","722","361","361","7","729","1606","0","45.39","22.48"
"64","000","00","090","0038","1864","649","290","359","6","655","1388","0","47.19","20.89"
"64","000","00","090","0039","0000","1176","428","748","10","1186","2585","0","45.88","16.56"
"64","000","00","090","0039","1865","540","164","376","5","545","1299","0","41.96","12.63"
"64","000","00","090","0039","1866","636","264","372","5","641","1286","0","49.84","20.53"
"64","000","00","090","0040","0000","1240","415","825","13","1253","2634","0","47.57","15.76"
"64","000","00","090","0040","1867","596","201","395","9","605","1323","0","45.73","15.19"
"64","000","00","090","0040","1868","644","214","430","4","648","1311","0","49.43","16.32"
"64","000","00","090","0041","0000","925","351","574","2","927","2104","0","44.06","16.68"
"64","000","00","090","0041","1869","434","162","272","1","435","1002","0","43.41","16.17"
"64","000","00","090","0041","1870","491","189","302","1","492","1102","0","44.65","17.15"
"64","000","00","090","0042","0000","2890","1205","1685","17","2907","6665","0","43.62","18.08"
"64","000","00","090","0042","1871","639","210","429","5","644","1470","0","43.81","14.29"
"64","000","00","090","0042","1872","667","253","414","6","673","1512","0","44.51","16.73"
"64","000","00","090","0042","1873","495","211","284","2","497","1038","0","47.88","20.33"
"64","000","00","090","0042","1874","576","271","305","1","577","1401","0","41.18","19.34"
"64","000","00","090","0042","1875","513","260","253","3","516","1244","0","41.48","20.90"
"64","000","00","090","0043","0000","998","397","601","8","1006","2331","0","43.16","17.03"
"64","000","00","090","0043","1876","506","207","299","1","507","1111","0","45.63","18.63"
"64","000","00","090","0043","1877","492","190","302","7","499","1220","0","40.90","15.57"
"64","000","00","090","0044","0000","1832","773","1059","9","1841","3965","0","46.43","19.50"
"64","000","00","090","0044","1878","639","233","406","6","645","1382","0","46.67","16.86"
"64","000","00","090","0044","1879","614","242","372","2","616","1278","0","48.20","18.94"
"64","000","00","090","0044","1880","579","298","281","1","580","1305","0","44.44","22.84"
"64","000","00","090","0045","0000","1534","636","898","8","1542","3340","0","46.17","19.04"
"64","000","00","090","0045","1881","491","226","265","1","492","1172","0","41.98","19.28"
"64","000","00","090","0045","1882","468","192","276","4","472","977","0","48.31","19.65"
"64","000","00","090","0045","1883","575","218","357","3","578","1191","0","48.53","18.30"
"64","000","00","090","0046","0000","644","222","422","6","650","1563","0","41.59","14.20"
"64","000","00","090","0046","1884","361","96","265","5","366","822","0","44.53","11.68"
"64","000","00","090","0046","1885","283","126","157","1","284","741","0","38.33","17.00"
"64","000","00","090","0047","0000","1918","658","1260","10","1928","4567","0","42.22","14.41"
"64","000","00","090","0047","1886","406","119","287","1","407","1080","0","37.69","11.02"
"64","000","00","090","0047","1887","505","151","354","4","509","1224","0","41.58","12.34"
"64","000","00","090","0047","1888","424","155","269","3","427","963","0","44.34","16.10"
"64","000","00","090","0047","1889","583","233","350","2","585","1300","0","45.00","17.92"
"64","000","00","090","0048","0000","1086","385","701","8","1094","2650","0","41.28","14.53"
"64","000","00","090","0048","1890","550","187","363","2","552","1341","0","41.16","13.94"
"64","000","00","090","0048","1891","536","198","338","6","542","1309","0","41.41","15.13"
"64","000","00","090","0049","0000","1892","713","1179","11","1903","4492","0","42.36","15.87"
"64","000","00","090","0049","1892","440","156","284","4","444","1083","0","41.00","14.40"
"64","000","00","090","0049","1893","526","199","327","1","527","1254","0","42.03","15.87"
"64","000","00","090","0049","1894","443","162","281","2","445","1033","0","43.08","15.68"
"64","000","00","090","0049","1895","483","196","287","4","487","1122","0","43.40","17.47"
"64","000","00","090","0050","0000","943","284","659","2","945","2252","0","41.96","12.61"
"64","000","00","090","0050","1896","498","169","329","2","500","1202","0","41.60","14.06"
"64","000","00","090","0050","1897","445","115","330","0","445","1050","0","42.38","10.95"
"64","000","00","090","0051","0000","788","237","551","6","794","1810","0","43.87","13.09"
"64","000","00","090","0051","1898","404","130","274","4","408","933","0","43.73","13.93"
"64","000","00","090","0051","1899","384","107","277","2","386","877","0","44.01","12.20"
"64","000","00","090","0052","0000","1603","563","1040","9","1612","3473","0","46.42","16.21"
"64","000","00","090","0052","1900","556","179","377","2","558","1118","0","49.91","16.01"
"64","000","00","090","0052","1901","513","155","358","4","517","1067","0","48.45","14.53"
"64","000","00","090","0052","1902","534","229","305","3","537","1288","0","41.69","17.78"
"64","000","00","090","0053","0000","1494","511","983","11","1505","3408","0","44.16","14.99"
"64","000","00","090","0053","1903","497","150","347","7","504","1127","0","44.72","13.31"
"64","000","00","090","0053","1904","417","152","265","1","418","958","0","43.63","15.87"
"64","000","00","090","0053","1905","580","209","371","3","583","1323","0","44.07","15.80"
"64","000","00","090","0054","0000","1356","420","936","10","1366","3140","0","43.50","13.38"
"64","000","00","090","0054","1906","661","176","485","7","668","1547","0","43.18","11.38"
"64","000","00","090","0054","1907","695","244","451","3","698","1593","0","43.82","15.32"
"64","000","00","090","0055","0000","1063","291","772","10","1073","2484","0","43.20","11.71"
"64","000","00","090","0055","1908","519","153","366","4","523","1248","0","41.91","12.26"
"64","000","00","090","0055","1909","544","138","406","6","550","1236","0","44.50","11.17"
"64","000","00","090","0056","0000","1142","372","770","4","1146","2474","0","46.32","15.04"
"64","000","00","090","0056","1910","541","192","349","4","545","1138","0","47.89","16.87"
"64","000","00","090","0056","1911","601","180","421","0","601","1336","0","44.99","13.47"
"64","000","00","090","0057","0000","1081","334","747","6","1087","2446","0","44.44","13.65"
"64","000","00","090","0057","1912","538","170","368","4","542","1193","0","45.43","14.25"
"64","000","00","090","0057","1913","543","164","379","2","545","1253","0","43.50","13.09"
"64","000","00","090","0058","0000","1068","400","668","9","1077","2518","0","42.77","15.89"
"64","000","00","090","0058","1914","585","216","369","7","592","1338","0","44.25","16.14"
"64","000","00","090","0058","1915","483","184","299","2","485","1180","0","41.10","15.59"
"64","000","00","090","0059","0000","987","296","691","7","994","2355","0","42.21","12.57"
"64","000","00","090","0059","1916","465","155","310","4","469","1144","0","41.00","13.55"
"64","000","00","090","0059","1917","522","141","381","3","525","1211","0","43.35","11.64"
"64","000","00","090","0060","0000","1962","756","1206","7","1969","4394","0","44.81","17.21"
"64","000","00","090","0060","1918","604","256","348","2","606","1372","0","44.17","18.66"
"64","000","00","090","0060","1919","648","193","455","3","651","1456","0","44.71","13.26"
"64","000","00","090","0060","1920","710","307","403","2","712","1566","0","45.47","19.60"
"64","000","00","090","0061","0000","1316","403","913","8","1324","3072","0","43.10","13.12"
"64","000","00","090","0061","1921","395","128","267","2","397","970","0","40.93","13.20"
"64","000","00","090","0061","1922","407","95","312","3","410","911","0","45.01","10.43"
"64","000","00","090","0061","1923","514","180","334","3","517","1191","0","43.41","15.11"
"64","000","00","100","0000","0000","9208","2722","6486","75","9283","24346","27515","38.13","11.18"
"64","000","00","100","0001","0000","510","131","379","5","515","1181","0","43.61","11.09"
"64","000","00","100","0001","1767","510","131","379","5","515","1181","0","43.61","11.09"
"64","000","00","100","0002","0000","383","127","256","5","388","1056","0","36.74","12.03"
"64","000","00","100","0002","1768","383","127","256","5","388","1056","0","36.74","12.03"
"64","000","00","100","0003","0000","621","172","449","7","628","1544","0","40.67","11.14"
"64","000","00","100","0003","1769","621","172","449","7","628","1544","0","40.67","11.14"
"64","000","00","100","0004","0000","792","218","574","3","795","2240","0","35.49","9.73"
"64","000","00","100","0004","1770","418","134","284","2","420","1157","0","36.30","11.58"
"64","000","00","100","0004","1771","374","84","290","1","375","1083","0","34.63","7.76"
"64","000","00","100","0005","0000","990","392","598","11","1001","2922","0","34.26","13.42"
"64","000","00","100","0005","1772","486","168","318","3","489","1437","0","34.03","11.69"
"64","000","00","100","0005","1773","504","224","280","8","512","1485","0","34.48","15.08"
"64","000","00","100","0006","0000","638","169","469","3","641","1497","0","42.82","11.29"
"64","000","00","100","0006","1774","638","169","469","3","641","1497","0","42.82","11.29"
"64","000","00","100","0007","0000","506","300","206","5","511","1394","0","36.66","21.52"
"64","000","00","100","0007","1775","506","300","206","5","511","1394","0","36.66","21.52"
"64","000","00","100","0008","0000","872","277","595","6","878","2620","0","33.51","10.57"
"64","000","00","100","0008","1776","424","152","272","3","427","1346","0","31.72","11.29"
"64","000","00","100","0008","1777","448","125","323","3","451","1274","0","35.40","9.81"
"64","000","00","100","0009","0000","779","184","595","9","788","2021","0","38.99","9.10"
"64","000","00","100","0009","1778","357","94","263","3","360","952","0","37.82","9.87"
"64","000","00","100","0009","1779","422","90","332","6","428","1069","0","40.04","8.42"
"64","000","00","100","0010","0000","1033","212","821","9","1042","2749","0","37.90","7.71"
"64","000","00","100","0010","1780","430","81","349","4","434","1092","0","39.74","7.42"
"64","000","00","100","0010","1781","603","131","472","5","608","1657","0","36.69","7.91"
"64","000","00","100","0011","0000","742","182","560","3","745","1802","0","41.34","10.10"
"64","000","00","100","0011","1782","444","102","342","1","445","1033","0","43.08","9.87"
"64","000","00","100","0011","1783","298","80","218","2","300","769","0","39.01","10.40"
"64","000","00","100","0012","0000","330","62","268","2","332","863","0","38.47","7.18"
"64","000","00","100","0012","1784","330","62","268","2","332","863","0","38.47","7.18"
"64","000","00","100","0013","0000","1012","296","716","7","1019","2457","0","41.47","12.05"
"64","000","00","100","0013","1785","532","116","416","2","534","1184","0","45.10","9.80"
"64","000","00","100","0013","1786","480","180","300","5","485","1273","0","38.10","14.14"
"64","000","00","110","0000","0000","52882","19155","33727","390","53272","132828","156580","40.11","14.42"
"64","000","00","110","0001","0000","980","344","636","7","987","2204","0","44.78","15.61"
"64","000","00","110","0001","1924","520","224","296","5","525","1075","0","48.84","20.84"
"64","000","00","110","0001","1925","460","120","340","2","462","1129","0","40.92","10.63"
"64","000","00","110","0002","0000","1375","610","765","8","1383","3080","0","44.90","19.81"
"64","000","00","110","0002","1926","720","318","402","3","723","1483","0","48.75","21.44"
"64","000","00","110","0002","1927","655","292","363","5","660","1597","0","41.33","18.28"
"64","000","00","110","0003","0000","998","461","537","5","1003","2455","0","40.86","18.78"
"64","000","00","110","0003","1928","459","241","218","0","459","1061","0","43.26","22.71"
"64","000","00","110","0003","1929","539","220","319","5","544","1394","0","39.02","15.78"
"64","000","00","110","0004","0000","658","251","407","4","662","1658","0","39.93","15.14"
"64","000","00","110","0004","1930","658","251","407","4","662","1658","0","39.93","15.14"
"64","000","00","110","0005","0000","1122","388","734","8","1130","3006","0","37.59","12.91"
"64","000","00","110","0005","1931","592","182","410","4","596","1561","0","38.18","11.66"
"64","000","00","110","0005","1932","530","206","324","4","534","1445","0","36.96","14.26"
"64","000","00","110","0006","0000","1091","393","698","4","1095","2482","0","44.12","15.83"
"64","000","00","110","0006","1933","514","176","338","2","516","1158","0","44.56","15.20"
"64","000","00","110","0006","1934","577","217","360","2","579","1324","0","43.73","16.39"
"64","000","00","110","0007","0000","902","326","576","3","905","2715","0","33.33","12.01"
"64","000","00","110","0007","1935","384","134","250","2","386","1434","0","26.92","9.34"
"64","000","00","110","0007","1936","518","192","326","1","519","1281","0","40.52","14.99"
"64","000","00","110","0008","0000","1010","364","646","10","1020","2209","0","46.17","16.48"
"64","000","00","110","0008","1937","542","196","346","4","546","1146","0","47.64","17.10"
"64","000","00","110","0008","1938","468","168","300","6","474","1063","0","44.59","15.80"
"64","000","00","110","0009","0000","996","334","662","3","999","2601","0","38.41","12.84"
"64","000","00","110","0009","1939","537","192","345","1","538","1405","0","38.29","13.67"
"64","000","00","110","0009","1940","459","142","317","2","461","1196","0","38.55","11.87"
"64","000","00","110","0010","0000","2249","783","1466","16","2265","5620","0","40.30","13.93"
"64","000","00","110","0010","1941","648","210","438","5","653","1560","0","41.86","13.46"
"64","000","00","110","0010","1942","487","167","320","3","490","1215","0","40.33","13.74"
"64","000","00","110","0010","1943","506","190","316","4","510","1422","0","35.86","13.36"
"64","000","00","110","0010","1944","608","216","392","4","612","1423","0","43.01","15.18"
"64","000","00","110","0011","0000","1048","384","664","13","1061","2419","0","43.86","15.87"
"64","000","00","110","0011","1945","508","186","322","2","510","1183","0","43.11","15.72"
"64","000","00","110","0011","1946","540","198","342","11","551","1236","0","44.58","16.02"
"64","000","00","110","0012","0000","1418","442","976","5","1423","3563","0","39.94","12.41"
"64","000","00","110","0012","1947","509","175","334","2","511","1301","0","39.28","13.45"
"64","000","00","110","0012","1948","454","143","311","0","454","1118","0","40.61","12.79"
"64","000","00","110","0012","1949","455","124","331","3","458","1144","0","40.03","10.84"
"64","000","00","110","0013","0000","1185","429","756","10","1195","2779","0","43.00","15.44"
"64","000","00","110","0013","1950","553","195","358","4","557","1394","0","39.96","13.99"
"64","000","00","110","0013","1951","632","234","398","6","638","1385","0","46.06","16.90"
"64","000","00","110","0014","0000","1471","617","854","12","1483","3906","0","37.97","15.80"
"64","000","00","110","0014","1952","505","220","285","3","508","1387","0","36.63","15.86"
"64","000","00","110","0014","1953","473","197","276","5","478","1227","0","38.96","16.06"
"64","000","00","110","0014","1954","493","200","293","4","497","1292","0","38.47","15.48"
"64","000","00","110","0015","0000","1721","658","1063","10","1731","4344","0","39.85","15.15"
"64","000","00","110","0015","1955","594","198","396","4","598","1495","0","40.00","13.24"
"64","000","00","110","0015","1956","565","221","344","0","565","1437","0","39.32","15.38"
"64","000","00","110","0015","1957","562","239","323","6","568","1412","0","40.23","16.93"
"64","000","00","110","0016","0000","1082","390","692","10","1092","2502","0","43.65","15.59"
"64","000","00","110","0016","1958","506","156","350","3","509","1227","0","41.48","12.71"
"64","000","00","110","0016","1959","576","234","342","7","583","1275","0","45.73","18.35"
"64","000","00","110","0017","0000","1210","462","748","8","1218","3165","0","38.48","14.60"
"64","000","00","110","0017","1960","607","258","349","4","611","1609","0","37.97","16.03"
"64","000","00","110","0017","1961","603","204","399","4","607","1556","0","39.01","13.11"
"64","000","00","110","0018","0000","1146","532","614","2","1148","2869","0","40.01","18.54"
"64","000","00","110","0018","1962","576","253","323","1","577","1423","0","40.55","17.78"
"64","000","00","110","0018","1963","570","279","291","1","571","1446","0","39.49","19.29"
"64","000","00","110","0019","0000","1009","598","411","6","1015","2305","0","44.03","25.94"
"64","000","00","110","0019","1964","501","326","175","4","505","1078","0","46.85","30.24"
"64","000","00","110","0019","1965","508","272","236","2","510","1227","0","41.56","22.17"
"64","000","00","110","0020","0000","1660","777","883","16","1676","4066","0","41.22","19.11"
"64","000","00","110","0020","1966","632","302","330","5","637","1441","0","44.21","20.96"
"64","000","00","110","0020","1967","572","278","294","7","579","1435","0","40.35","19.37"
"64","000","00","110","0020","1968","456","197","259","4","460","1190","0","38.66","16.55"
"64","000","00","110","0021","0000","1333","490","843","11","1344","3176","0","42.32","15.43"
"64","000","00","110","0021","1969","668","255","413","3","671","1549","0","43.32","16.46"
"64","000","00","110","0021","1970","665","235","430","8","673","1627","0","41.36","14.44"
"64","000","00","110","0022","0000","4224","1450","2774","35","4259","11217","0","37.97","12.93"
"64","000","00","110","0022","1971","440","137","303","2","442","1297","0","34.08","10.56"
"64","000","00","110","0022","1972","583","209","374","2","585","1352","0","43.27","15.46"
"64","000","00","110","0022","1973","517","174","343","4","521","1327","0","39.26","13.11"
"64","000","00","110","0022","1974","624","211","413","8","632","1605","0","39.38","13.15"
"64","000","00","110","0022","1975","510","166","344","6","516","1266","0","40.76","13.11"
"64","000","00","110","0022","1976","472","190","282","2","474","1322","0","35.85","14.37"
"64","000","00","110","0022","1977","561","163","398","6","567","1404","0","40.38","11.61"
"64","000","00","110","0022","1978","517","200","317","5","522","1644","0","31.75","12.17"
"64","000","00","110","0023","0000","1596","562","1034","10","1606","4154","0","38.66","13.53"
"64","000","00","110","0023","1979","465","164","301","5","470","1296","0","36.27","12.65"
"64","000","00","110","0023","1980","585","197","388","2","587","1467","0","40.01","13.43"
"64","000","00","110","0023","1981","546","201","345","3","549","1391","0","39.47","14.45"
"64","000","00","110","0024","0000","1002","334","668","10","1012","2549","0","39.70","13.10"
"64","000","00","110","0024","1982","477","165","312","4","481","1207","0","39.85","13.67"
"64","000","00","110","0024","1983","525","169","356","6","531","1342","0","39.57","12.59"
"64","000","00","110","0025","0000","1328","506","822","14","1342","3066","0","43.77","16.50"
"64","000","00","110","0025","1984","731","274","457","5","736","1598","0","46.06","17.15"
"64","000","00","110","0025","1985","597","232","365","9","606","1468","0","41.28","15.80"
"64","000","00","110","0026","0000","1118","362","756","10","1128","2844","0","39.66","12.73"
"64","000","00","110","0026","1986","533","156","377","5","538","1262","0","42.63","12.36"
"64","000","00","110","0026","1987","585","206","379","5","590","1582","0","37.29","13.02"
"64","000","00","110","0027","0000","2183","751","1432","15","2198","6006","0","36.60","12.50"
"64","000","00","110","0027","1988","486","152","334","5","491","1214","0","40.44","12.52"
"64","000","00","110","0027","1989","402","141","261","1","403","1201","0","33.56","11.74"
"64","000","00","110","0027","1990","492","163","329","4","496","1181","0","42.00","13.80"
"64","000","00","110","0027","1991","323","113","210","2","325","1036","0","31.37","10.91"
"64","000","00","110","0027","1992","480","182","298","3","483","1374","0","35.15","13.25"
"64","000","00","110","0028","0000","1927","724","1203","21","1948","4655","0","41.85","15.55"
"64","000","00","110","0028","1993","603","198","405","9","612","1210","0","50.58","16.36"
"64","000","00","110","0028","1994","472","171","301","4","476","1209","0","39.37","14.14"
"64","000","00","110","0028","1995","486","224","262","6","492","1244","0","39.55","18.01"
"64","000","00","110","0028","1996","366","131","235","2","368","992","0","37.10","13.21"
"64","000","00","110","0029","0000","1477","571","906","19","1496","3839","0","38.97","14.87"
"64","000","00","110","0029","1997","550","230","320","8","558","1396","0","39.97","16.48"
"64","000","00","110","0029","1998","484","148","336","9","493","1096","0","44.98","13.50"
"64","000","00","110","0029","1999","443","193","250","2","445","1347","0","33.04","14.33"
"64","000","00","110","0030","0000","1147","375","772","4","1151","2569","0","44.80","14.60"
"64","000","00","110","0030","2000","541","172","369","2","543","1179","0","46.06","14.59"
"64","000","00","110","0030","2001","606","203","403","2","608","1390","0","43.74","14.60"
"64","000","00","110","0031","0000","3079","1060","2019","15","3094","7687","0","40.25","13.79"
"64","000","00","110","0031","2002","601","158","443","3","604","1467","0","41.17","10.77"
"64","000","00","110","0031","2003","647","222","425","5","652","1572","0","41.48","14.12"
"64","000","00","110","0031","2004","627","222","405","3","630","1545","0","40.78","14.37"
"64","000","00","110","0031","2005","586","223","363","2","588","1512","0","38.89","14.75"
"64","000","00","110","0031","2006","618","235","383","2","620","1591","0","38.97","14.77"
"64","000","00","110","0032","0000","1360","468","892","11","1371","3630","0","37.77","12.89"
"64","000","00","110","0032","2007","422","146","276","5","427","1076","0","39.68","13.57"
"64","000","00","110","0032","2008","504","162","342","4","508","1356","0","37.46","11.95"
"64","000","00","110","0032","2009","434","160","274","2","436","1198","0","36.39","13.36"
"64","000","00","110","0033","0000","1215","421","794","14","1229","3132","0","39.24","13.44"
"64","000","00","110","0033","2010","563","191","372","8","571","1415","0","40.35","13.50"
"64","000","00","110","0033","2011","652","230","422","6","658","1717","0","38.32","13.40"
"64","000","00","110","0034","0000","1193","392","801","4","1197","3059","0","39.13","12.81"
"64","000","00","110","0034","2012","592","173","419","4","596","1505","0","39.60","11.50"
"64","000","00","110","0034","2013","601","219","382","0","601","1554","0","38.67","14.09"
"64","000","00","110","0035","0000","897","239","658","7","904","2196","0","41.17","10.88"
"64","000","00","110","0035","2014","435","101","334","6","441","1069","0","41.25","9.45"
"64","000","00","110","0035","2015","462","138","324","1","463","1127","0","41.08","12.24"
"64","000","00","110","0036","0000","1205","327","878","9","1214","3013","0","40.29","10.85"
"64","000","00","110","0036","2016","610","155","455","5","615","1475","0","41.69","10.51"
"64","000","00","110","0036","2017","595","172","423","4","599","1538","0","38.95","11.18"
"64","000","00","110","0037","0000","925","267","658","10","935","2483","0","37.66","10.75"
"64","000","00","110","0037","2018","492","153","339","3","495","1249","0","39.63","12.25"
"64","000","00","110","0037","2019","433","114","319","7","440","1234","0","35.66","9.24"
"64","000","00","110","0038","0000","1342","313","1029","11","1353","3605","0","37.53","8.68"
"64","000","00","110","0038","2020","441","110","331","4","445","1067","0","41.71","10.31"
"64","000","00","110","0038","2021","472","107","365","3","475","1292","0","36.76","8.28"
"64","000","00","110","0038","2022","429","96","333","4","433","1246","0","34.75","7.70"
"64","000","00","120","0000","0000","127598","53682","73916","932","128530","302069","358785","42.55","17.77"
"64","000","00","120","0001","0000","173","73","100","3","176","406","0","43.35","17.98"
"64","000","00","120","0001","1587","173","73","100","3","176","406","0","43.35","17.98"
"64","000","00","120","0002","0000","278","101","177","3","281","599","0","46.91","16.86"
"64","000","00","120","0002","1586","278","101","177","3","281","599","0","46.91","16.86"
"64","000","00","120","0003","0000","573","222","351","5","578","1288","0","44.88","17.24"
"64","000","00","120","0003","1588","573","222","351","5","578","1288","0","44.88","17.24"
"64","000","00","120","0004","0000","429","212","217","1","430","847","0","50.77","25.03"
"64","000","00","120","0004","1601","429","212","217","1","430","847","0","50.77","25.03"
"64","000","00","120","0005","0000","413","166","247","2","415","864","0","48.03","19.21"
"64","000","00","120","0005","1594","413","166","247","2","415","864","0","48.03","19.21"
"64","000","00","120","0006","0000","963","440","523","7","970","2199","0","44.11","20.01"
"64","000","00","120","0006","1589","350","156","194","3","353","712","0","49.58","21.91"
"64","000","00","120","0006","1590","613","284","329","4","617","1487","0","41.49","19.10"
"64","000","00","120","0007","0000","491","234","257","3","494","1023","0","48.29","22.87"
"64","000","00","120","0007","1535","491","234","257","3","494","1023","0","48.29","22.87"
"64","000","00","120","0008","0000","1589","795","794","11","1600","3304","0","48.43","24.06"
"64","000","00","120","0008","1614","541","233","308","3","544","1132","0","48.06","20.58"
"64","000","00","120","0008","1615","504","285","219","5","509","1118","0","45.53","25.49"
"64","000","00","120","0008","1616","544","277","267","3","547","1054","0","51.90","26.28"
"64","000","00","120","0009","0000","3720","1448","2272","24","3744","10134","0","36.94","14.29"
"64","000","00","120","0009","1546","613","214","399","7","620","1472","0","42.12","14.54"
"64","000","00","120","0009","1547","445","178","267","3","448","1439","0","31.13","12.37"
"64","000","00","120","0009","1548","637","267","370","1","638","1718","0","37.14","15.54"
"64","000","00","120","0009","1549","413","164","249","4","417","1249","0","33.39","13.13"
"64","000","00","120","0009","1550","518","200","318","4","522","1462","0","35.70","13.68"
"64","000","00","120","0009","1551","444","196","248","2","446","1360","0","32.79","14.41"
"64","000","00","120","0009","1552","650","229","421","3","653","1434","0","45.54","15.97"
"64","000","00","120","0010","0000","358","173","185","3","361","800","0","45.13","21.63"
"64","000","00","120","0010","1536","358","173","185","3","361","800","0","45.13","21.63"
"64","000","00","120","0011","0000","1515","623","892","7","1522","3583","0","42.48","17.39"
"64","000","00","120","0011","1557","560","186","374","1","561","1263","0","44.42","14.73"
"64","000","00","120","0011","1558","470","205","265","1","471","1071","0","43.98","19.14"
"64","000","00","120","0011","1559","485","232","253","5","490","1249","0","39.23","18.57"
"64","000","00","120","0012","0000","2154","899","1255","16","2170","4831","0","44.92","18.61"
"64","000","00","120","0012","1539","539","233","306","4","543","1150","0","47.22","20.26"
"64","000","00","120","0012","1540","527","204","323","3","530","1202","0","44.09","16.97"
"64","000","00","120","0012","1541","566","233","333","7","573","1306","0","43.87","17.84"
"64","000","00","120","0012","1542","522","229","293","2","524","1173","0","44.67","19.52"
"64","000","00","120","0013","0000","955","383","572","4","959","2419","0","39.64","15.83"
"64","000","00","120","0013","1622","476","205","271","3","479","1268","0","37.78","16.17"
"64","000","00","120","0013","1623","479","178","301","1","480","1151","0","41.70","15.46"
"64","000","00","120","0014","0000","2511","1192","1319","13","2524","5862","0","43.06","20.33"
"64","000","00","120","0014","1645","635","245","390","2","637","1501","0","42.44","16.32"
"64","000","00","120","0014","1646","550","219","331","3","553","1355","0","40.81","16.16"
"64","000","00","120","0014","1647","650","350","300","5","655","1511","0","43.35","23.16"
"64","000","00","120","0014","1648","676","378","298","3","679","1495","0","45.42","25.28"
"64","000","00","120","0015","0000","1877","1508","369","15","1892","4101","0","46.14","36.77"
"64","000","00","120","0015","1649","512","340","172","3","515","1178","0","43.72","28.86"
"64","000","00","120","0015","1650","689","564","125","7","696","1617","0","43.04","34.88"
"64","000","00","120","0015","1651","676","604","72","5","681","1306","0","52.14","46.25"
"64","000","00","120","0016","0000","1967","727","1240","20","1987","4690","0","42.37","15.50"
"64","000","00","120","0016","1729","551","210","341","4","555","1243","0","44.65","16.89"
"64","000","00","120","0016","1730","419","168","251","6","425","980","0","43.37","17.14"
"64","000","00","120","0016","1731","511","195","316","4","515","1337","0","38.52","14.58"
"64","000","00","120","0016","1732","486","154","332","6","492","1130","0","43.54","13.63"
"64","000","00","120","0017","0000","2797","906","1891","13","2810","6676","0","42.09","13.57"
"64","000","00","120","0017","1690","551","174","377","1","552","1280","0","43.13","13.59"
"64","000","00","120","0017","1691","677","227","450","3","680","1584","0","42.93","14.33"
"64","000","00","120","0017","1692","684","211","473","5","689","1622","0","42.48","13.01"
"64","000","00","120","0017","1693","448","152","296","1","449","1137","0","39.49","13.37"
"64","000","00","120","0017","1694","437","142","295","3","440","1053","0","41.79","13.49"
"64","000","00","120","0018","0000","2113","980","1133","22","2135","5045","0","42.32","19.43"
"64","000","00","120","0018","1624","514","226","288","7","521","1193","0","43.67","18.94"
"64","000","00","120","0018","1625","506","223","283","5","511","1197","0","42.69","18.63"
"64","000","00","120","0018","1626","523","281","242","4","527","1285","0","41.01","21.87"
"64","000","00","120","0018","1627","570","250","320","6","576","1370","0","42.04","18.25"
"64","000","00","120","0019","0000","2043","953","1090","24","2067","4468","0","46.26","21.33"
"64","000","00","120","0019","1605","425","197","228","4","429","951","0","45.11","20.72"
"64","000","00","120","0019","1606","401","190","211","6","407","939","0","43.34","20.23"
"64","000","00","120","0019","1607","534","303","231","6","540","1243","0","43.44","24.38"
"64","000","00","120","0019","1608","683","263","420","8","691","1335","0","51.76","19.70"
"64","000","00","120","0020","0000","1685","852","833","12","1697","3708","0","45.77","22.98"
"64","000","00","120","0020","1617","538","243","295","3","541","1210","0","44.71","20.08"
"64","000","00","120","0020","1618","612","340","272","2","614","1259","0","48.77","27.01"
"64","000","00","120","0020","1619","535","269","266","7","542","1239","0","43.74","21.71"
"64","000","00","120","0021","0000","714","263","451","5","719","3408","0","21.10","7.72"
"64","000","00","120","0021","1596","508","164","344","5","513","1041","0","49.28","15.75"
"64","000","00","120","0021","1597","206","99","107","0","206","2367","0","8.70","4.18"
"64","000","00","120","0022","0000","1249","716","533","15","1264","2855","0","44.27","25.08"
"64","000","00","120","0022","1652","584","333","251","9","593","1352","0","43.86","24.63"
"64","000","00","120","0022","1653","665","383","282","6","671","1503","0","44.64","25.48"
"64","000","00","120","0024","0000","1494","559","935","9","1503","3386","0","44.39","16.51"
"64","000","00","120","0024","1555","698","239","459","5","703","1628","0","43.18","14.68"
"64","000","00","120","0024","1556","796","320","476","4","800","1758","0","45.51","18.20"
"64","000","00","120","0025","0000","1339","519","820","14","1353","2970","0","45.56","17.47"
"64","000","00","120","0025","1670","692","270","422","5","697","1474","0","47.29","18.32"
"64","000","00","120","0025","1671","647","249","398","9","656","1496","0","43.85","16.64"
"64","000","00","120","0026","0000","2003","742","1261","16","2019","4656","0","43.36","15.94"
"64","000","00","120","0026","1666","419","141","278","9","428","952","0","44.96","14.81"
"64","000","00","120","0026","1667","532","195","337","4","536","1185","0","45.23","16.46"
"64","000","00","120","0026","1668","491","183","308","1","492","1155","0","42.60","15.84"
"64","000","00","120","0026","1669","561","223","338","2","563","1364","0","41.28","16.35"
"64","000","00","120","0027","0000","2608","847","1761","22","2630","6047","0","43.49","14.01"
"64","000","00","120","0027","1711","551","207","344","9","560","1375","0","40.73","15.05"
"64","000","00","120","0027","1712","470","139","331","2","472","1070","0","44.11","12.99"
"64","000","00","120","0027","1713","546","172","374","4","550","1212","0","45.38","14.19"
"64","000","00","120","0027","1714","488","151","337","1","489","1194","0","40.95","12.65"
"64","000","00","120","0027","1715","553","178","375","6","559","1196","0","46.74","14.88"
"64","000","00","120","0028","0000","1262","386","876","7","1269","3158","0","40.18","12.22"
"64","000","00","120","0028","1721","365","99","266","1","366","905","0","40.44","10.94"
"64","000","00","120","0028","1722","475","143","332","5","480","1177","0","40.78","12.15"
"64","000","00","120","0028","1723","422","144","278","1","423","1076","0","39.31","13.38"
"64","000","00","120","0029","0000","2328","751","1577","21","2349","5638","0","41.66","13.32"
"64","000","00","120","0029","1757","438","156","282","3","441","984","0","44.82","15.85"
"64","000","00","120","0029","1758","465","148","317","4","469","1089","0","43.07","13.59"
"64","000","00","120","0029","1759","521","148","373","5","526","1250","0","42.08","11.84"
"64","000","00","120","0029","1760","495","148","347","6","501","1229","0","40.76","12.04"
"64","000","00","120","0029","1761","409","151","258","3","412","1086","0","37.94","13.90"
"64","000","00","120","0030","0000","2224","1226","998","17","2241","5295","0","42.32","23.15"
"64","000","00","120","0030","1631","494","240","254","5","499","1355","0","36.83","17.71"
"64","000","00","120","0030","1632","622","502","120","5","627","1247","0","50.28","40.26"
"64","000","00","120","0030","1633","519","239","280","3","522","1273","0","41.01","18.77"
"64","000","00","120","0030","1634","589","245","344","4","593","1420","0","41.76","17.25"
"64","000","00","120","0031","0000","2017","1004","1013","15","2032","4791","0","42.41","20.96"
"64","000","00","120","0031","1628","636","307","329","4","640","1497","0","42.75","20.51"
"64","000","00","120","0031","1629","600","360","240","5","605","1565","0","38.66","23.00"
"64","000","00","120","0031","1630","781","337","444","6","787","1729","0","45.52","19.49"
"64","000","00","120","0032","0000","1504","524","980","9","1513","3443","0","43.94","15.22"
"64","000","00","120","0032","1749","500","164","336","4","504","1117","0","45.12","14.68"
"64","000","00","120","0032","1750","502","194","308","2","504","1176","0","42.86","16.50"
"64","000","00","120","0032","1751","502","166","336","3","505","1150","0","43.91","14.43"
"64","000","00","120","0033","0000","2311","911","1400","9","2320","5183","0","44.76","17.58"
"64","000","00","120","0033","1680","605","202","403","2","607","1404","0","43.23","14.39"
"64","000","00","120","0033","1681","504","191","313","3","507","1188","0","42.68","16.08"
"64","000","00","120","0033","1682","650","257","393","3","653","1422","0","45.92","18.07"
"64","000","00","120","0033","1683","552","261","291","1","553","1169","0","47.31","22.33"
"64","000","00","120","0034","0000","1593","686","907","10","1603","3682","0","43.54","18.63"
"64","000","00","120","0034","1654","495","203","292","3","498","1162","0","42.86","17.47"
"64","000","00","120","0034","1655","525","236","289","4","529","1201","0","44.05","19.65"
"64","000","00","120","0034","1656","573","247","326","3","576","1319","0","43.67","18.73"
"64","000","00","120","0035","0000","2677","1146","1531","21","2698","6156","0","43.83","18.62"
"64","000","00","120","0035","1641","631","251","380","4","635","1397","0","45.45","17.97"
"64","000","00","120","0035","1642","674","274","400","5","679","1578","0","43.03","17.36"
"64","000","00","120","0035","1643","656","288","368","5","661","1528","0","43.26","18.85"
"64","000","00","120","0035","1644","716","333","383","7","723","1653","0","43.74","20.15"
"64","000","00","120","0036","0000","1645","593","1052","9","1654","3986","0","41.50","14.88"
"64","000","00","120","0036","1687","483","174","309","3","486","1195","0","40.67","14.56"
"64","000","00","120","0036","1688","564","166","398","2","566","1318","0","42.94","12.59"
"64","000","00","120","0036","1689","598","253","345","4","602","1473","0","40.87","17.18"
"64","000","00","120","0037","0000","1476","654","822","12","1488","3202","0","46.47","20.42"
"64","000","00","120","0037","1657","483","216","267","3","486","1074","0","45.25","20.11"
"64","000","00","120","0037","1658","503","209","294","7","510","1110","0","45.95","18.83"
"64","000","00","120","0037","1659","490","229","261","2","492","1018","0","48.33","22.50"
"64","000","00","120","0038","0000","1064","346","718","9","1073","2412","0","44.49","14.34"
"64","000","00","120","0038","1660","536","162","374","4","540","1177","0","45.88","13.76"
"64","000","00","120","0038","1661","528","184","344","5","533","1235","0","43.16","14.90"
"64","000","00","120","0039","0000","3793","1816","1977","19","3812","8807","0","43.28","20.62"
"64","000","00","120","0039","1571","631","301","330","0","631","1397","0","45.17","21.55"
"64","000","00","120","0039","1572","651","375","276","4","655","1414","0","46.32","26.52"
"64","000","00","120","0039","1573","619","267","352","1","620","1444","0","42.94","18.49"
"64","000","00","120","0039","1574","650","315","335","6","656","1536","0","42.71","20.51"
"64","000","00","120","0039","1575","600","260","340","5","605","1525","0","39.67","17.05"
"64","000","00","120","0039","1576","642","298","344","3","645","1491","0","43.26","19.99"
"64","000","00","120","0040","0000","5114","2088","3026","19","5133","13720","0","37.41","15.22"
"64","000","00","120","0040","1703","629","255","374","1","630","1730","0","36.42","14.74"
"64","000","00","120","0040","1704","622","258","364","0","622","1675","0","37.13","15.40"
"64","000","00","120","0040","1705","656","264","392","5","661","1703","0","38.81","15.50"
"64","000","00","120","0040","1706","615","204","411","3","618","1703","0","36.29","11.98"
"64","000","00","120","0040","1707","619","303","316","4","623","1713","0","36.37","17.69"
"64","000","00","120","0040","1708","672","292","380","2","674","1734","0","38.87","16.84"
"64","000","00","120","0040","1709","665","281","384","2","667","1668","0","39.99","16.85"
"64","000","00","120","0040","1710","636","231","405","2","638","1794","0","35.56","12.88"
"64","000","00","120","0041","0000","875","411","464","8","883","1878","0","47.02","21.88"
"64","000","00","120","0041","1537","413","183","230","3","416","845","0","49.23","21.66"
"64","000","00","120","0041","1538","462","228","234","5","467","1033","0","45.21","22.07"
"64","000","00","120","0042","0000","1519","644","875","12","1531","3300","0","46.39","19.52"
"64","000","00","120","0042","1598","480","230","250","1","481","1073","0","44.83","21.44"
"64","000","00","120","0042","1599","525","208","317","7","532","1112","0","47.84","18.71"
"64","000","00","120","0042","1600","514","206","308","4","518","1115","0","46.46","18.48"
"64","000","00","120","0043","0000","1323","459","864","11","1334","2954","0","45.16","15.54"
"64","000","00","120","0043","1755","695","233","462","6","701","1515","0","46.27","15.38"
"64","000","00","120","0043","1756","628","226","402","5","633","1439","0","43.99","15.71"
"64","000","00","120","0044","0000","2442","1144","1298","17","2459","5599","0","43.92","20.43"
"64","000","00","120","0044","1609","470","197","273","5","475","1162","0","40.88","16.95"
"64","000","00","120","0044","1610","439","210","229","1","440","983","0","44.76","21.36"
"64","000","00","120","0044","1611","480","234","246","1","481","1095","0","43.93","21.37"
"64","000","00","120","0044","1612","576","265","311","4","580","1305","0","44.44","20.31"
"64","000","00","120","0044","1613","477","238","239","6","483","1054","0","45.83","22.58"
"64","000","00","120","0045","0000","889","493","396","10","899","1995","0","45.06","24.71"
"64","000","00","120","0045","1620","470","266","204","3","473","1017","0","46.51","26.16"
"64","000","00","120","0045","1621","419","227","192","7","426","978","0","43.56","23.21"
"64","000","00","120","0046","0000","2038","854","1184","18","2056","4606","0","44.64","18.54"
"64","000","00","120","0046","1591","714","302","412","3","717","1536","0","46.68","19.66"
"64","000","00","120","0046","1592","657","264","393","13","670","1542","0","43.45","17.12"
"64","000","00","120","0046","1593","667","288","379","2","669","1528","0","43.78","18.85"
"64","000","00","120","0047","0000","1466","781","685","15","1481","3154","0","46.96","24.76"
"64","000","00","120","0047","1602","464","213","251","5","469","997","0","47.04","21.36"
"64","000","00","120","0047","1603","468","283","185","2","470","1011","0","46.49","27.99"
"64","000","00","120","0047","1604","534","285","249","8","542","1146","0","47.29","24.87"
"64","000","00","120","0048","0000","2715","1013","1702","17","2732","6154","0","44.39","16.46"
"64","000","00","120","0048","1566","531","204","327","2","533","1297","0","41.09","15.73"
"64","000","00","120","0048","1567","661","262","399","2","663","1505","0","44.05","17.41"
"64","000","00","120","0048","1568","469","138","331","4","473","1044","0","45.31","13.22"
"64","000","00","120","0048","1569","554","173","381","3","557","1215","0","45.84","14.24"
"64","000","00","120","0048","1570","500","236","264","6","506","1093","0","46.29","21.59"
"64","000","00","120","0049","0000","1964","699","1265","17","1981","4554","0","43.50","15.35"
"64","000","00","120","0049","1764","642","230","412","5","647","1464","0","44.19","15.71"
"64","000","00","120","0049","1765","667","276","391","3","670","1625","0","41.23","16.98"
"64","000","00","120","0049","1766","655","193","462","9","664","1465","0","45.32","13.17"
"64","000","00","120","0050","0000","1014","564","450","11","1025","2537","0","40.40","22.23"
"64","000","00","120","0050","1635","533","309","224","10","543","1258","0","43.16","24.56"
"64","000","00","120","0050","1636","481","255","226","1","482","1279","0","37.69","19.94"
"64","000","00","120","0051","0000","505","218","287","7","512","1040","0","49.23","20.96"
"64","000","00","120","0051","1595","505","218","287","7","512","1040","0","49.23","20.96"
"64","000","00","120","0053","0000","1665","648","1017","17","1682","3969","0","42.38","16.33"
"64","000","00","120","0053","1543","625","261","364","8","633","1454","0","43.54","17.95"
"64","000","00","120","0053","1544","526","208","318","4","530","1268","0","41.80","16.40"
"64","000","00","120","0053","1545","514","179","335","5","519","1247","0","41.62","14.35"
"64","000","00","120","0054","0000","728","254","474","10","738","1831","0","40.31","13.87"
"64","000","00","120","0054","1733","391","147","244","4","395","950","0","41.58","15.47"
"64","000","00","120","0054","1734","337","107","230","6","343","881","0","38.93","12.15"
"64","000","00","120","0055","0000","3513","1167","2346","30","3543","8197","0","43.22","14.24"
"64","000","00","120","0055","1743","553","165","388","6","559","1298","0","43.07","12.71"
"64","000","00","120","0055","1744","574","186","388","5","579","1256","0","46.10","14.81"
"64","000","00","120","0055","1745","595","207","388","6","601","1626","0","36.96","12.73"
"64","000","00","120","0055","1746","625","225","400","2","627","1405","0","44.63","16.01"
"64","000","00","120","0055","1747","595","195","400","8","603","1399","0","43.10","13.94"
"64","000","00","120","0055","1748","571","189","382","3","574","1213","0","47.32","15.58"
"64","000","00","120","0056","0000","3605","1860","1745","30","3635","8181","0","44.43","22.74"
"64","000","00","120","0056","1560","709","594","115","11","720","1615","0","44.58","36.78"
"64","000","00","120","0056","1561","545","215","330","5","550","1162","0","47.33","18.50"
"64","000","00","120","0056","1562","573","228","345","1","574","1262","0","45.48","18.07"
"64","000","00","120","0056","1563","552","264","288","3","555","1488","0","37.30","17.74"
"64","000","00","120","0056","1564","554","277","277","6","560","1158","0","48.36","23.92"
"64","000","00","120","0056","1565","672","282","390","4","676","1496","0","45.19","18.85"
"64","000","00","120","0057","0000","1705","557","1148","13","1718","4349","0","39.50","12.81"
"64","000","00","120","0057","1752","524","180","344","3","527","1394","0","37.80","12.91"
"64","000","00","120","0057","1753","558","167","391","7","565","1408","0","40.13","11.86"
"64","000","00","120","0057","1754","623","210","413","3","626","1547","0","40.47","13.57"
"64","000","00","120","0058","0000","1048","414","634","5","1053","2612","0","40.31","15.85"
"64","000","00","120","0058","1553","624","257","367","3","627","1420","0","44.15","18.10"
"64","000","00","120","0058","1554","424","157","267","2","426","1192","0","35.74","13.17"
"64","000","00","120","0059","0000","1681","741","940","13","1694","4036","0","41.97","18.36"
"64","000","00","120","0059","1577","481","243","238","3","484","1266","0","38.23","19.19"
"64","000","00","120","0059","1578","608","244","364","7","615","1409","0","43.65","17.32"
"64","000","00","120","0059","1579","592","254","338","3","595","1361","0","43.72","18.66"
"64","000","00","120","0060","0000","4070","1889","2181","29","4099","9452","0","43.37","19.99"
"64","000","00","120","0060","1580","810","398","412","8","818","1790","0","45.70","22.23"
"64","000","00","120","0060","1581","721","311","410","3","724","1681","0","43.07","18.50"
"64","000","00","120","0060","1582","630","299","331","5","635","1565","0","40.58","19.11"
"64","000","00","120","0060","1583","654","283","371","5","659","1445","0","45.61","19.58"
"64","000","00","120","0060","1584","589","290","299","5","594","1353","0","43.90","21.43"
"64","000","00","120","0060","1585","666","308","358","3","669","1618","0","41.35","19.04"
"64","000","00","120","0061","0000","812","526","286","7","819","2046","0","40.03","25.71"
"64","000","00","120","0061","1637","342","180","162","1","343","804","0","42.66","22.39"
"64","000","00","120","0061","1638","470","346","124","6","476","1242","0","38.33","27.86"
"64","000","00","120","0062","0000","1071","593","478","9","1080","2686","0","40.21","22.08"
"64","000","00","120","0062","1639","583","352","231","7","590","1490","0","39.60","23.62"
"64","000","00","120","0062","1640","488","241","247","2","490","1196","0","40.97","20.15"
"64","000","00","120","0063","0000","1178","562","616","8","1186","2531","0","46.86","22.20"
"64","000","00","120","0063","1662","605","283","322","3","608","1330","0","45.71","21.28"
"64","000","00","120","0063","1663","573","279","294","5","578","1201","0","48.13","23.23"
"64","000","00","120","0064","0000","1009","390","619","8","1017","2292","0","44.37","17.02"
"64","000","00","120","0064","1664","507","183","324","5","512","1098","0","46.63","16.67"
"64","000","00","120","0064","1665","502","207","295","3","505","1194","0","42.29","17.34"
"64","000","00","120","0065","0000","1671","674","997","12","1683","3737","0","45.04","18.04"
"64","000","00","120","0065","1684","443","150","293","2","445","1085","0","41.01","13.82"
"64","000","00","120","0065","1685","524","189","335","3","527","1162","0","45.35","16.27"
"64","000","00","120","0065","1686","704","335","369","7","711","1490","0","47.72","22.48"
"64","000","00","120","0066","0000","1043","346","697","10","1053","2353","0","44.75","14.70"
"64","000","00","120","0066","1672","577","196","381","5","582","1271","0","45.79","15.42"
"64","000","00","120","0066","1673","466","150","316","5","471","1082","0","43.53","13.86"
"64","000","00","120","0067","0000","1817","732","1085","4","1821","4273","0","42.62","17.13"
"64","000","00","120","0067","1677","541","210","331","1","542","1334","0","40.63","15.74"
"64","000","00","120","0067","1678","584","221","363","2","586","1382","0","42.40","15.99"
"64","000","00","120","0067","1679","692","301","391","1","693","1557","0","44.51","19.33"
"64","000","00","120","0068","0000","1642","718","924","6","1648","4006","0","41.14","17.92"
"64","000","00","120","0068","1674","582","235","347","2","584","1449","0","40.30","16.22"
"64","000","00","120","0068","1675","556","252","304","2","558","1329","0","41.99","18.96"
"64","000","00","120","0068","1676","504","231","273","2","506","1228","0","41.21","18.81"
"64","000","00","120","0069","0000","1063","461","602","9","1072","2454","0","43.68","18.79"
"64","000","00","120","0069","1698","526","234","292","0","526","1174","0","44.80","19.93"
"64","000","00","120","0069","1699","537","227","310","9","546","1280","0","42.66","17.73"
"64","000","00","120","0070","0000","1744","741","1003","9","1753","4441","0","39.47","16.69"
"64","000","00","120","0070","1700","555","256","299","2","557","1447","0","38.49","17.69"
"64","000","00","120","0070","1701","608","249","359","2","610","1411","0","43.23","17.65"
"64","000","00","120","0070","1702","581","236","345","5","586","1583","0","37.02","14.91"
"64","000","00","120","0071","0000","1830","651","1179","18","1848","4469","0","41.35","14.57"
"64","000","00","120","0071","1695","637","250","387","8","645","1487","0","43.38","16.81"
"64","000","00","120","0071","1696","602","204","398","3","605","1543","0","39.21","13.22"
"64","000","00","120","0071","1697","591","197","394","7","598","1439","0","41.56","13.69"
"64","000","00","120","0072","0000","1918","677","1241","14","1932","4472","0","43.20","15.14"
"64","000","00","120","0072","1724","635","202","433","6","641","1452","0","44.15","13.91"
"64","000","00","120","0072","1725","617","235","382","2","619","1425","0","43.44","16.49"
"64","000","00","120","0072","1726","666","240","426","6","672","1595","0","42.13","15.05"
"64","000","00","120","0073","0000","1133","363","770","5","1138","2740","0","41.53","13.25"
"64","000","00","120","0073","1727","571","191","380","2","573","1336","0","42.89","14.30"
"64","000","00","120","0073","1728","562","172","390","3","565","1404","0","40.24","12.25"
"64","000","00","120","0074","0000","984","376","608","8","992","2367","0","41.91","15.89"
"64","000","00","120","0074","1739","458","159","299","3","461","1058","0","43.57","15.03"
"64","000","00","120","0074","1740","526","217","309","5","531","1309","0","40.57","16.58"
"64","000","00","120","0075","0000","2065","745","1320","13","2078","5524","0","37.62","13.49"
"64","000","00","120","0075","1735","456","187","269","3","459","1280","0","35.86","14.61"
"64","000","00","120","0075","1736","484","186","298","2","486","1368","0","35.53","13.60"
"64","000","00","120","0075","1737","561","176","385","5","566","1454","0","38.93","12.10"
"64","000","00","120","0075","1738","564","196","368","3","567","1422","0","39.87","13.78"
"64","000","00","120","0076","0000","1102","334","768","9","1111","2597","0","42.78","12.86"
"64","000","00","120","0076","1741","582","200","382","8","590","1373","0","42.97","14.57"
"64","000","00","120","0076","1742","520","134","386","1","521","1224","0","42.57","10.95"
"64","000","00","120","0077","0000","1096","322","774","4","1100","2652","0","41.48","12.14"
"64","000","00","120","0077","1762","547","133","414","3","550","1314","0","41.86","10.12"
"64","000","00","120","0077","1763","549","189","360","1","550","1338","0","41.11","14.13"
"64","000","00","120","0078","0000","2636","997","1639","23","2659","6389","0","41.62","15.60"
"64","000","00","120","0078","1716","569","196","373","8","577","1337","0","43.16","14.66"
"64","000","00","120","0078","1717","590","244","346","2","592","1334","0","44.38","18.29"
"64","000","00","120","0078","1718","519","197","322","8","527","1298","0","40.60","15.18"
"64","000","00","120","0078","1719","506","183","323","3","509","1176","0","43.28","15.56"
"64","000","00","120","0078","1720","452","177","275","2","454","1244","0","36.50","14.23"
"64","000","00","130","0000","0000","22956","7153","15803","257","23213","59161","69161","39.24","12.09"
"64","000","00","130","0001","0000","1020","327","693","7","1027","2799","0","36.69","11.68"
"64","000","00","130","0001","0947","503","177","326","5","508","1213","0","41.88","14.59"
"64","000","00","130","0001","0948","517","150","367","2","519","1586","0","32.72","9.46"
"64","000","00","130","0002","0000","1248","432","816","13","1261","3070","0","41.07","14.07"
"64","000","00","130","0002","0949","422","148","274","4","426","1074","0","39.66","13.78"
"64","000","00","130","0002","0950","376","128","248","2","378","981","0","38.53","13.05"
"64","000","00","130","0002","0951","450","156","294","7","457","1015","0","45.02","15.37"
"64","000","00","130","0003","0000","1540","478","1062","14","1554","4129","0","37.64","11.58"
"64","000","00","130","0003","0952","540","157","383","6","546","1369","0","39.88","11.47"
"64","000","00","130","0003","0953","481","158","323","5","486","1244","0","39.07","12.70"
"64","000","00","130","0003","0954","519","163","356","3","522","1516","0","34.43","10.75"
"64","000","00","130","0004","0000","1061","394","667","17","1078","2749","0","39.21","14.33"
"64","000","00","130","0004","0955","584","204","380","11","595","1414","0","42.08","14.43"
"64","000","00","130","0004","0956","477","190","287","6","483","1335","0","36.18","14.23"
"64","000","00","130","0005","0000","1233","478","755","21","1254","2981","0","42.07","16.03"
"64","000","00","130","0005","0957","597","184","413","12","609","1479","0","41.18","12.44"
"64","000","00","130","0005","0958","636","294","342","9","645","1502","0","42.94","19.57"
"64","000","00","130","0006","0000","983","329","654","17","1000","2474","0","40.42","13.30"
"64","000","00","130","0006","0959","474","172","302","9","483","1230","0","39.27","13.98"
"64","000","00","130","0006","0960","509","157","352","8","517","1244","0","41.56","12.62"
"64","000","00","130","0007","0000","1771","528","1243","20","1791","4546","0","39.40","11.61"
"64","000","00","130","0007","0961","438","127","311","3","441","1118","0","39.45","11.36"
"64","000","00","130","0007","0962","515","155","360","5","520","1357","0","38.32","11.42"
"64","000","00","130","0007","0963","370","110","260","4","374","909","0","41.14","12.10"
"64","000","00","130","0007","0964","448","136","312","8","456","1162","0","39.24","11.70"
"64","000","00","130","0008","0000","754","198","556","8","762","1795","0","42.45","11.03"
"64","000","00","130","0008","0965","375","100","275","4","379","939","0","40.36","10.65"
"64","000","00","130","0008","0966","379","98","281","4","383","856","0","44.74","11.45"
"64","000","00","130","0009","0000","1297","294","1003","21","1318","3401","0","38.75","8.64"
"64","000","00","130","0009","0967","392","87","305","5","397","1083","0","36.66","8.03"
"64","000","00","130","0009","0968","426","95","331","9","435","1067","0","40.77","8.90"
"64","000","00","130","0009","0969","479","112","367","7","486","1251","0","38.85","8.95"
"64","000","00","130","0010","0000","708","171","537","5","713","1671","0","42.67","10.23"
"64","000","00","130","0010","0970","708","171","537","5","713","1671","0","42.67","10.23"
"64","000","00","130","0011","0000","526","189","337","4","530","1576","0","33.63","11.99"
"64","000","00","130","0011","0971","196","104","92","4","200","581","0","34.42","17.90"
"64","000","00","130","0011","0972","330","85","245","0","330","995","0","33.17","8.54"
"64","000","00","130","0012","0000","715","312","403","8","723","1960","0","36.89","15.92"
"64","000","00","130","0012","0973","414","146","268","6","420","981","0","42.81","14.88"
"64","000","00","130","0012","0974","301","166","135","2","303","979","0","30.95","16.96"
"64","000","00","130","0013","0000","1615","559","1056","15","1630","4087","0","39.88","13.68"
"64","000","00","130","0013","0975","620","217","403","8","628","1603","0","39.18","13.54"
"64","000","00","130","0013","0976","510","171","339","4","514","1294","0","39.72","13.21"
"64","000","00","130","0013","0977","485","171","314","3","488","1190","0","41.01","14.37"
"64","000","00","130","0014","0000","480","154","326","2","482","1274","0","37.83","12.09"
"64","000","00","130","0014","0978","480","154","326","2","482","1274","0","37.83","12.09"
"64","000","00","130","0015","0000","852","247","605","7","859","1939","0","44.30","12.74"
"64","000","00","130","0015","0979","450","134","316","4","454","1055","0","43.03","12.70"
"64","000","00","130","0015","0980","402","113","289","3","405","884","0","45.81","12.78"
"64","000","00","130","0016","0000","713","164","549","9","722","1726","0","41.83","9.50"
"64","000","00","130","0016","0981","351","60","291","7","358","820","0","43.66","7.32"
"64","000","00","130","0016","0982","362","104","258","2","364","906","0","40.18","11.48"
"64","000","00","130","0017","0000","691","151","540","10","701","1767","0","39.67","8.55"
"64","000","00","130","0017","0983","379","77","302","4","383","998","0","38.38","7.72"
"64","000","00","130","0017","0984","312","74","238","6","318","769","0","41.35","9.62"
"64","000","00","130","0018","0000","318","90","228","3","321","883","0","36.35","10.19"
"64","000","00","130","0018","0985","318","90","228","3","321","883","0","36.35","10.19"
"64","000","00","130","0019","0000","264","55","209","0","264","729","0","36.21","7.54"
"64","000","00","130","0019","0986","264","55","209","0","264","729","0","36.21","7.54"
"64","000","00","130","0020","0000","1202","362","840","10","1212","2918","0","41.54","12.41"
"64","000","00","130","0020","0987","662","206","456","2","664","1445","0","45.95","14.26"
"64","000","00","130","0020","0988","540","156","384","8","548","1473","0","37.20","10.59"
"64","000","00","130","0021","0000","1012","393","619","11","1023","2393","0","42.75","16.42"
"64","000","00","130","0021","0989","565","243","322","7","572","1368","0","41.81","17.76"
"64","000","00","130","0021","0990","447","150","297","4","451","1025","0","44.00","14.63"
"64","000","00","130","0022","0000","1338","429","909","12","1350","3366","0","40.11","12.75"
"64","000","00","130","0022","0991","494","160","334","4","498","1180","0","42.20","13.56"
"64","000","00","130","0022","0992","410","114","296","4","414","1113","0","37.20","10.24"
"64","000","00","130","0022","0993","434","155","279","4","438","1073","0","40.82","14.45"
"64","000","00","130","0023","0000","849","269","580","12","861","2660","0","32.37","10.11"
"64","000","00","130","0023","0994","488","169","319","4","492","1359","0","36.20","12.44"
"64","000","00","130","0023","0995","361","100","261","8","369","1301","0","28.36","7.69"
"64","000","00","130","0024","0000","766","150","616","11","777","2268","0","34.26","6.61"
"64","000","00","130","0024","0996","422","77","345","2","424","1134","0","37.39","6.79"
"64","000","00","130","0024","0997","344","73","271","9","353","1134","0","31.13","6.44"
"64","000","00","140","0000","0000","39105","14197","24908","381","39486","97638","112129","40.44","14.54"
"64","000","00","140","0001","0000","590","154","436","7","597","1391","0","42.92","11.07"
"64","000","00","140","0001","0861","289","66","223","6","295","691","0","42.69","9.55"
"64","000","00","140","0001","0862","301","88","213","1","302","700","0","43.14","12.57"
"64","000","00","140","0002","0000","2103","794","1309","17","2120","5790","0","36.61","13.71"
"64","000","00","140","0002","0863","512","174","338","3","515","1246","0","41.33","13.96"
"64","000","00","140","0002","0864","321","119","202","5","326","909","0","35.86","13.09"
"64","000","00","140","0002","0865","285","92","193","3","288","756","0","38.10","12.17"
"64","000","00","140","0002","0866","174","62","112","1","175","425","0","41.18","14.59"
"64","000","00","140","0002","0867","470","184","286","3","473","1233","0","38.36","14.92"
"64","000","00","140","0002","0868","341","163","178","2","343","1221","0","28.09","13.35"
"64","000","00","140","0003","0000","2386","736","1650","40","2426","6676","0","36.34","11.02"
"64","000","00","140","0003","0869","449","142","307","4","453","1302","0","34.79","10.91"
"64","000","00","140","0003","0870","493","171","322","12","505","1389","0","36.36","12.31"
"64","000","00","140","0003","0871","538","165","373","9","547","1469","0","37.24","11.23"
"64","000","00","140","0003","0872","481","124","357","8","489","1399","0","34.95","8.86"
"64","000","00","140","0003","0873","425","134","291","7","432","1117","0","38.68","12.00"
"64","000","00","140","0004","0000","987","257","730","5","992","2414","0","41.09","10.65"
"64","000","00","140","0004","0874","481","133","348","4","485","1208","0","40.15","11.01"
"64","000","00","140","0004","0875","506","124","382","1","507","1206","0","42.04","10.28"
"64","000","00","140","0005","0000","1871","596","1275","19","1890","4615","0","40.95","12.91"
"64","000","00","140","0005","0876","561","172","389","4","565","1362","0","41.48","12.63"
"64","000","00","140","0005","0877","475","163","312","7","482","1196","0","40.30","13.63"
"64","000","00","140","0005","0878","433","167","266","3","436","1075","0","40.56","15.53"
"64","000","00","140","0005","0879","402","94","308","5","407","982","0","41.45","9.57"
"64","000","00","140","0006","0000","1975","567","1408","13","1988","4639","0","42.85","12.22"
"64","000","00","140","0006","0880","560","173","387","1","561","1307","0","42.92","13.24"
"64","000","00","140","0006","0881","753","216","537","5","758","1733","0","43.74","12.46"
"64","000","00","140","0006","0882","662","178","484","7","669","1599","0","41.84","11.13"
"64","000","00","140","0007","0000","1752","434","1318","16","1768","3885","0","45.51","11.17"
"64","000","00","140","0007","0883","572","145","427","5","577","1235","0","46.72","11.74"
"64","000","00","140","0007","0884","607","147","460","5","612","1382","0","44.28","10.64"
"64","000","00","140","0007","0885","573","142","431","6","579","1268","0","45.66","11.20"
"64","000","00","140","0008","0000","1083","439","644","14","1097","2318","0","47.33","18.94"
"64","000","00","140","0008","0886","597","280","317","5","602","1286","0","46.81","21.77"
"64","000","00","140","0008","0887","486","159","327","9","495","1032","0","47.97","15.41"
"64","000","00","140","0009","0000","4186","1419","2767","33","4219","10756","0","39.22","13.19"
"64","000","00","140","0009","0888","567","171","396","4","571","1357","0","42.08","12.60"
"64","000","00","140","0009","0889","479","173","306","9","488","1287","0","37.92","13.44"
"64","000","00","140","0009","0890","453","160","293","4","457","1283","0","35.62","12.47"
"64","000","00","140","0009","0891","543","182","361","3","546","1421","0","38.42","12.81"
"64","000","00","140","0009","0892","567","195","372","4","571","1381","0","41.35","14.12"
"64","000","00","140","0009","0893","505","178","327","2","507","1283","0","39.52","13.87"
"64","000","00","140","0009","0894","545","219","326","3","548","1365","0","40.15","16.04"
"64","000","00","140","0009","0895","527","141","386","4","531","1379","0","38.51","10.22"
"64","000","00","140","0010","0000","3084","1225","1859","29","3113","7626","0","40.82","16.06"
"64","000","00","140","0010","0896","522","191","331","5","527","1238","0","42.57","15.43"
"64","000","00","140","0010","0897","337","135","202","0","337","910","0","37.03","14.84"
"64","000","00","140","0010","0898","468","197","271","6","474","1127","0","42.06","17.48"
"64","000","00","140","0010","0899","317","117","200","2","319","719","0","44.37","16.27"
"64","000","00","140","0010","0900","368","173","195","2","370","963","0","38.42","17.96"
"64","000","00","140","0010","0901","547","222","325","9","556","1349","0","41.22","16.46"
"64","000","00","140","0010","0902","525","190","335","5","530","1320","0","40.15","14.39"
"64","000","00","140","0011","0000","749","207","542","11","760","1803","0","42.15","11.48"
"64","000","00","140","0011","0903","453","130","323","8","461","1045","0","44.11","12.44"
"64","000","00","140","0011","0904","296","77","219","3","299","758","0","39.45","10.16"
"64","000","00","140","0012","0000","595","175","420","4","599","1666","0","35.95","10.50"
"64","000","00","140","0012","0905","319","110","209","1","320","928","0","34.48","11.85"
"64","000","00","140","0012","0906","276","65","211","3","279","738","0","37.80","8.81"
"64","000","00","140","0013","0000","998","327","671","5","1003","2472","0","40.57","13.23"
"64","000","00","140","0013","0907","473","154","319","2","475","1200","0","39.58","12.83"
"64","000","00","140","0013","0908","525","173","352","3","528","1272","0","41.51","13.60"
"64","000","00","140","0014","0000","1185","308","877","12","1197","2917","0","41.04","10.56"
"64","000","00","140","0014","0909","398","100","298","5","403","988","0","40.79","10.12"
"64","000","00","140","0014","0910","342","75","267","3","345","934","0","36.94","8.03"
"64","000","00","140","0014","0911","445","133","312","4","449","995","0","45.13","13.37"
"64","000","00","140","0015","0000","591","194","397","4","595","1538","0","38.69","12.61"
"64","000","00","140","0015","0912","325","103","222","2","327","826","0","39.59","12.47"
"64","000","00","140","0015","0913","266","91","175","2","268","712","0","37.64","12.78"
"64","000","00","140","0016","0000","2339","987","1352","23","2362","6229","0","37.92","15.85"
"64","000","00","140","0016","0914","433","153","280","2","435","1152","0","37.76","13.28"
"64","000","00","140","0016","0915","498","190","308","7","505","1212","0","41.67","15.68"
"64","000","00","140","0016","0916","467","199","268","3","470","1130","0","41.59","17.61"
"64","000","00","140","0016","0917","367","174","193","3","370","1338","0","27.65","13.00"
"64","000","00","140","0016","0918","574","271","303","8","582","1397","0","41.66","19.40"
"64","000","00","140","0017","0000","2970","1437","1533","24","2994","7455","0","40.16","19.28"
"64","000","00","140","0017","0919","445","136","309","1","446","1061","0","42.04","12.82"
"64","000","00","140","0017","0920","438","196","242","2","440","1236","0","35.60","15.86"
"64","000","00","140","0017","0921","508","273","235","3","511","1159","0","44.09","23.55"
"64","000","00","140","0017","0922","522","289","233","6","528","1271","0","41.54","22.74"
"64","000","00","140","0017","0923","558","277","281","4","562","1518","0","37.02","18.25"
"64","000","00","140","0017","0924","499","266","233","8","507","1210","0","41.90","21.98"
"64","000","00","140","0018","0000","245","152","93","3","248","541","0","45.84","28.10"
"64","000","00","140","0018","0925","245","152","93","3","248","541","0","45.84","28.10"
"64","000","00","140","0019","0000","2766","991","1775","23","2789","6812","0","40.94","14.55"
"64","000","00","140","0019","0926","376","148","228","7","383","1050","0","36.48","14.10"
"64","000","00","140","0019","0927","527","208","319","4","531","1241","0","42.79","16.76"
"64","000","00","140","0019","0928","452","177","275","3","455","1038","0","43.83","17.05"
"64","000","00","140","0019","0929","499","149","350","2","501","1219","0","41.10","12.22"
"64","000","00","140","0019","0930","456","157","299","3","459","1097","0","41.84","14.31"
"64","000","00","140","0019","0931","456","152","304","4","460","1167","0","39.42","13.02"
"64","000","00","140","0020","0000","957","265","692","10","967","2201","0","43.93","12.04"
"64","000","00","140","0020","0932","430","100","330","7","437","972","0","44.96","10.29"
"64","000","00","140","0020","0933","527","165","362","3","530","1229","0","43.12","13.43"
"64","000","00","140","0021","0000","677","216","461","5","682","1545","0","44.14","13.98"
"64","000","00","140","0021","0934","304","93","211","4","308","713","0","43.20","13.04"
"64","000","00","140","0021","0935","373","123","250","1","374","832","0","44.95","14.78"
"64","000","00","140","0022","0000","825","255","570","6","831","1851","0","44.89","13.78"
"64","000","00","140","0022","0936","429","135","294","1","430","930","0","46.24","14.52"
"64","000","00","140","0022","0937","396","120","276","5","401","921","0","43.54","13.03"
"64","000","00","140","0023","0000","1398","393","1005","13","1411","3723","0","37.90","10.56"
"64","000","00","140","0023","0938","491","129","362","4","495","1272","0","38.92","10.14"
"64","000","00","140","0023","0939","438","120","318","8","446","1164","0","38.32","10.31"
"64","000","00","140","0023","0940","469","144","325","1","470","1287","0","36.52","11.19"
"64","000","00","140","0024","0000","42","27","15","4","46","111","0","41.44","24.32"
"64","000","00","140","0024","0941","42","27","15","4","46","111","0","41.44","24.32"
"64","000","00","140","0025","0000","2751","1642","1109","41","2792","6664","0","41.90","24.64"
"64","000","00","140","0025","0942","578","403","175","9","587","1392","0","42.17","28.95"
"64","000","00","140","0025","0943","616","354","262","5","621","1376","0","45.13","25.73"
"64","000","00","140","0025","0944","515","307","208","8","523","1327","0","39.41","23.13"
"64","000","00","140","0025","0945","542","274","268","11","553","1299","0","42.57","21.09"
"64","000","00","140","0025","0946","500","304","196","8","508","1270","0","40.00","23.94"
"64","000","00","150","0000","0000","14964","4901","10063","146","15110","36462","41549","41.44","13.44"
"64","000","00","150","0001","0000","1120","414","706","6","1126","2680","0","42.01","15.45"
"64","000","00","150","0001","0198","543","171","372","5","548","1328","0","41.27","12.88"
"64","000","00","150","0001","0199","577","243","334","1","578","1352","0","42.75","17.97"
"64","000","00","150","0002","0000","1906","729","1177","20","1926","5186","0","37.14","14.06"
"64","000","00","150","0002","0200","433","161","272","3","436","1273","0","34.25","12.65"
"64","000","00","150","0002","0201","415","157","258","6","421","1228","0","34.28","12.79"
"64","000","00","150","0002","0202","545","194","351","5","550","1351","0","40.71","14.36"
"64","000","00","150","0002","0203","513","217","296","6","519","1334","0","38.91","16.27"
"64","000","00","150","0003","0000","1732","657","1075","21","1753","4079","0","42.98","16.11"
"64","000","00","150","0003","0204","587","250","337","4","591","1411","0","41.89","17.72"
"64","000","00","150","0003","0205","576","218","358","9","585","1315","0","44.49","16.58"
"64","000","00","150","0003","0206","569","189","380","8","577","1353","0","42.65","13.97"
"64","000","00","150","0004","0000","1026","314","712","10","1036","2313","0","44.79","13.58"
"64","000","00","150","0004","0207","450","115","335","6","456","1076","0","42.38","10.69"
"64","000","00","150","0004","0208","576","199","377","4","580","1237","0","46.89","16.09"
"64","000","00","150","0005","0000","1013","293","720","8","1021","2219","0","46.01","13.20"
"64","000","00","150","0005","0209","483","143","340","5","488","1113","0","43.85","12.85"
"64","000","00","150","0005","0210","530","150","380","3","533","1106","0","48.19","13.56"
"64","000","00","150","0006","0000","1347","416","931","10","1357","3451","0","39.32","12.05"
"64","000","00","150","0006","0211","473","137","336","6","479","1261","0","37.99","10.86"
"64","000","00","150","0006","0212","427","141","286","2","429","1065","0","40.28","13.24"
"64","000","00","150","0006","0213","447","138","309","2","449","1125","0","39.91","12.27"
"64","000","00","150","0007","0000","418","84","334","3","421","1026","0","41.03","8.19"
"64","000","00","150","0007","0214","418","84","334","3","421","1026","0","41.03","8.19"
"64","000","00","150","0008","0000","406","104","302","0","406","994","0","40.85","10.46"
"64","000","00","150","0008","0215","406","104","302","0","406","994","0","40.85","10.46"
"64","000","00","150","0009","0000","435","332","103","4","439","962","0","45.63","34.51"
"64","000","00","150","0009","0216","435","332","103","4","439","962","0","45.63","34.51"
"64","000","00","150","0010","0000","566","164","402","5","571","1434","0","39.82","11.44"
"64","000","00","150","0010","0217","566","164","402","5","571","1434","0","39.82","11.44"
"64","000","00","150","0011","0000","653","140","513","4","657","1505","0","43.65","9.30"
"64","000","00","150","0011","0218","322","68","254","3","325","741","0","43.86","9.18"
"64","000","00","150","0011","0219","331","72","259","1","332","764","0","43.46","9.42"
"64","000","00","150","0012","0000","562","171","391","12","574","1311","0","43.78","13.04"
"64","000","00","150","0012","0220","562","171","391","12","574","1311","0","43.78","13.04"
"64","000","00","150","0013","0000","763","135","628","12","775","1752","0","44.24","7.71"
"64","000","00","150","0013","0221","433","73","360","9","442","879","0","50.28","8.30"
"64","000","00","150","0013","0222","330","62","268","3","333","873","0","38.14","7.10"
"64","000","00","150","0014","0000","996","257","739","14","1010","2492","0","40.53","10.31"
"64","000","00","150","0014","0223","499","135","364","0","499","1262","0","39.54","10.70"
"64","000","00","150","0014","0224","497","122","375","14","511","1230","0","41.54","9.92"
"64","000","00","150","0015","0000","377","135","242","3","380","994","0","38.23","13.58"
"64","000","00","150","0015","0225","377","135","242","3","380","994","0","38.23","13.58"
"64","000","00","150","0016","0000","626","161","465","7","633","1539","0","41.13","10.46"
"64","000","00","150","0016","0226","313","86","227","1","314","792","0","39.65","10.86"
"64","000","00","150","0016","0227","313","75","238","6","319","747","0","42.70","10.04"
"64","000","00","150","0017","0000","753","311","442","6","759","1855","0","40.92","16.77"
"64","000","00","150","0017","0228","425","108","317","2","427","980","0","43.57","11.02"
"64","000","00","150","0017","0229","328","203","125","4","332","875","0","37.94","23.20"
"64","000","00","150","0018","0000","265","84","181","1","266","670","0","39.70","12.54"
"64","000","00","150","0018","0230","265","84","181","1","266","670","0","39.70","12.54"
"64","000","00","160","0000","0000","12611","4083","8528","130","12741","30109","34208","42.32","13.56"
"64","000","00","160","0001","0000","317","125","192","4","321","899","0","35.71","13.90"
"64","000","00","160","0001","0231","317","125","192","4","321","899","0","35.71","13.90"
"64","000","00","160","0002","0000","1410","501","909","20","1430","3267","0","43.77","15.34"
"64","000","00","160","0002","0232","476","152","324","6","482","1026","0","46.98","14.81"
"64","000","00","160","0002","0233","463","189","274","6","469","1115","0","42.06","16.95"
"64","000","00","160","0002","0234","471","160","311","8","479","1126","0","42.54","14.21"
"64","000","00","160","0003","0000","2044","706","1338","18","2062","4936","0","41.77","14.30"
"64","000","00","160","0003","0235","420","137","283","5","425","1034","0","41.10","13.25"
"64","000","00","160","0003","0236","356","107","249","3","359","1005","0","35.72","10.65"
"64","000","00","160","0003","0237","459","142","317","2","461","1041","0","44.28","13.64"
"64","000","00","160","0003","0238","469","180","289","4","473","1030","0","45.92","17.48"
"64","000","00","160","0003","0239","340","140","200","4","344","826","0","41.65","16.95"
"64","000","00","160","0004","0000","692","197","495","6","698","1648","0","42.35","11.95"
"64","000","00","160","0004","0258","302","62","240","2","304","697","0","43.62","8.90"
"64","000","00","160","0004","0259","390","135","255","4","394","951","0","41.43","14.20"
"64","000","00","160","0005","0000","1170","359","811","18","1188","2706","0","43.90","13.27"
"64","000","00","160","0005","0243","427","148","279","9","436","1062","0","41.05","13.94"
"64","000","00","160","0005","0244","379","116","263","3","382","882","0","43.31","13.15"
"64","000","00","160","0005","0245","364","95","269","6","370","762","0","48.56","12.47"
"64","000","00","160","0006","0000","2419","735","1684","18","2437","5416","0","45.00","13.57"
"64","000","00","160","0006","0246","566","169","397","6","572","1111","0","51.49","15.21"
"64","000","00","160","0006","0247","485","146","339","5","490","1158","0","42.31","12.61"
"64","000","00","160","0006","0248","454","128","326","2","456","1079","0","42.26","11.86"
"64","000","00","160","0006","0249","459","159","300","5","464","1034","0","44.87","15.38"
"64","000","00","160","0006","0250","455","133","322","0","455","1034","0","44.00","12.86"
"64","000","00","160","0007","0000","1918","647","1271","11","1929","4948","0","38.99","13.08"
"64","000","00","160","0007","0251","506","159","347","1","507","1270","0","39.92","12.52"
"64","000","00","160","0007","0252","499","169","330","4","503","1270","0","39.61","13.31"
"64","000","00","160","0007","0253","516","180","336","2","518","1248","0","41.51","14.42"
"64","000","00","160","0007","0254","397","139","258","4","401","1160","0","34.57","11.98"
"64","000","00","160","0008","0000","1330","428","902","18","1348","3171","0","42.51","13.50"
"64","000","00","160","0008","0255","495","143","352","9","504","1108","0","45.49","12.91"
"64","000","00","160","0008","0256","446","155","291","3","449","1153","0","38.94","13.44"
"64","000","00","160","0008","0257","389","130","259","6","395","910","0","43.41","14.29"
"64","000","00","160","0009","0000","1311","385","926","17","1328","3118","0","42.59","12.35"
"64","000","00","160","0009","0240","419","134","285","6","425","1053","0","40.36","12.73"
"64","000","00","160","0009","0241","453","144","309","3","456","1048","0","43.51","13.74"
"64","000","00","160","0009","0242","439","107","332","8","447","1017","0","43.95","10.52"
"64","000","00","170","0000","0000","32173","11540","20633","235","32408","78723","92846","41.17","14.66"
"64","000","00","170","0001","0000","1836","640","1196","9","1845","4416","0","41.78","14.49"
"64","000","00","170","0001","0771","654","218","436","2","656","1456","0","45.05","14.97"
"64","000","00","170","0001","0772","628","219","409","4","632","1568","0","40.31","13.97"
"64","000","00","170","0001","0773","554","203","351","3","557","1392","0","40.01","14.58"
"64","000","00","170","0002","0000","3151","1130","2021","20","3171","7950","0","39.89","14.21"
"64","000","00","170","0002","0774","563","195","368","3","566","1398","0","40.49","13.95"
"64","000","00","170","0002","0775","503","142","361","4","507","1202","0","42.18","11.81"
"64","000","00","170","0002","0776","488","138","350","6","494","1203","0","41.06","11.47"
"64","000","00","170","0002","0777","476","176","300","5","481","1330","0","36.17","13.23"
"64","000","00","170","0002","0778","529","216","313","1","530","1316","0","40.27","16.41"
"64","000","00","170","0002","0779","592","263","329","1","593","1501","0","39.51","17.52"
"64","000","00","170","0003","0000","1216","473","743","8","1224","2625","0","46.63","18.02"
"64","000","00","170","0003","0780","588","219","369","3","591","1319","0","44.81","16.60"
"64","000","00","170","0003","0781","628","254","374","5","633","1306","0","48.47","19.45"
"64","000","00","170","0004","0000","1365","479","886","16","1381","3764","0","36.69","12.73"
"64","000","00","170","0004","0782","450","169","281","5","455","1194","0","38.11","14.15"
"64","000","00","170","0004","0783","371","112","259","5","376","1182","0","31.81","9.48"
"64","000","00","170","0004","0784","544","198","346","6","550","1388","0","39.63","14.27"
"64","000","00","170","0005","0000","328","107","221","4","332","849","0","39.10","12.60"
"64","000","00","170","0005","0785","328","107","221","4","332","849","0","39.10","12.60"
"64","000","00","170","0006","0000","2035","637","1398","20","2055","5452","0","37.69","11.68"
"64","000","00","170","0006","0786","562","168","394","6","568","1372","0","41.40","12.24"
"64","000","00","170","0006","0787","395","150","245","2","397","1387","0","28.62","10.81"
"64","000","00","170","0006","0788","584","151","433","5","589","1364","0","43.18","11.07"
"64","000","00","170","0006","0789","494","168","326","7","501","1329","0","37.70","12.64"
"64","000","00","170","0007","0000","3767","1272","2495","26","3793","9055","0","41.89","14.05"
"64","000","00","170","0007","0790","698","196","502","3","701","1596","0","43.92","12.28"
"64","000","00","170","0007","0791","647","236","411","3","650","1609","0","40.40","14.67"
"64","000","00","170","0007","0792","600","176","424","5","605","1455","0","41.58","12.10"
"64","000","00","170","0007","0793","625","259","366","7","632","1501","0","42.11","17.26"
"64","000","00","170","0007","0794","609","230","379","5","614","1392","0","44.11","16.52"
"64","000","00","170","0007","0795","588","175","413","3","591","1502","0","39.35","11.65"
"64","000","00","170","0008","0000","1019","221","798","6","1025","2172","0","47.19","10.17"
"64","000","00","170","0008","0796","511","100","411","1","512","1031","0","49.66","9.70"
"64","000","00","170","0008","0797","508","121","387","5","513","1141","0","44.96","10.60"
"64","000","00","170","0009","0000","7046","2778","4268","45","7091","17709","0","40.04","15.69"
"64","000","00","170","0009","0798","575","181","394","3","578","1358","0","42.56","13.33"
"64","000","00","170","0009","0799","658","251","407","5","663","1495","0","44.35","16.79"
"64","000","00","170","0009","0800","613","268","345","2","615","1460","0","42.12","18.36"
"64","000","00","170","0009","0801","608","228","380","2","610","1445","0","42.21","15.78"
"64","000","00","170","0009","0802","506","202","304","5","511","1315","0","38.86","15.36"
"64","000","00","170","0009","0803","556","207","349","4","560","1455","0","38.49","14.23"
"64","000","00","170","0009","0804","509","211","298","1","510","1417","0","35.99","14.89"
"64","000","00","170","0009","0805","580","230","350","6","586","1421","0","41.24","16.19"
"64","000","00","170","0009","0806","564","221","343","3","567","1392","0","40.73","15.88"
"64","000","00","170","0009","0807","597","292","305","5","602","1418","0","42.45","20.59"
"64","000","00","170","0009","0808","561","200","361","7","568","1415","0","40.14","14.13"
"64","000","00","170","0009","0809","719","287","432","2","721","2118","0","34.04","13.55"
"64","000","00","170","0010","0000","1089","387","702","12","1101","2610","0","42.18","14.83"
"64","000","00","170","0010","0810","575","184","391","6","581","1363","0","42.63","13.50"
"64","000","00","170","0010","0811","514","203","311","6","520","1247","0","41.70","16.28"
"64","000","00","170","0011","0000","1065","271","794","8","1073","2542","0","42.21","10.66"
"64","000","00","170","0011","0812","536","137","399","5","541","1237","0","43.73","11.08"
"64","000","00","170","0011","0813","529","134","395","3","532","1305","0","40.77","10.27"
"64","000","00","170","0012","0000","646","264","382","4","650","1606","0","40.47","16.44"
"64","000","00","170","0012","0814","646","264","382","4","650","1606","0","40.47","16.44"
"64","000","00","170","0013","0000","1999","709","1290","11","2010","5171","0","38.87","13.71"
"64","000","00","170","0013","0815","458","156","302","3","461","1249","0","36.91","12.49"
"64","000","00","170","0013","0816","492","159","333","3","495","1234","0","40.11","12.88"
"64","000","00","170","0013","0817","499","219","280","2","501","1327","0","37.75","16.50"
"64","000","00","170","0013","0818","550","175","375","3","553","1361","0","40.63","12.86"
"64","000","00","170","0014","0000","1702","643","1059","10","1712","3838","0","44.61","16.75"
"64","000","00","170","0014","0819","576","217","359","5","581","1268","0","45.82","17.11"
"64","000","00","170","0014","0820","546","202","344","3","549","1277","0","42.99","15.82"
"64","000","00","170","0014","0821","580","224","356","2","582","1293","0","45.01","17.32"
"64","000","00","170","0015","0000","2847","1111","1736","25","2872","6762","0","42.47","16.43"
"64","000","00","170","0015","0822","599","213","386","7","606","1390","0","43.60","15.32"
"64","000","00","170","0015","0823","559","204","355","6","565","1341","0","42.13","15.21"
"64","000","00","170","0015","0824","554","249","305","5","559","1330","0","42.03","18.72"
"64","000","00","170","0015","0825","554","227","327","4","558","1318","0","42.34","17.22"
"64","000","00","170","0015","0826","581","218","363","3","584","1383","0","42.23","15.76"
"64","000","00","170","0016","0000","1062","418","644","11","1073","2202","0","48.73","18.98"
"64","000","00","170","0016","0827","518","213","305","7","525","1077","0","48.75","19.78"
"64","000","00","170","0016","0828","544","205","339","4","548","1125","0","48.71","18.22"
"64","000","00","180","0000","0000","17993","6839","11154","122","18115","39800","44727","45.52","17.18"
"64","000","00","180","0001","0000","4422","1739","2683","35","4457","10418","0","42.78","16.69"
"64","000","00","180","0001","0829","532","211","321","3","535","1207","0","44.32","17.48"
"64","000","00","180","0001","0830","589","237","352","2","591","1254","0","47.13","18.90"
"64","000","00","180","0001","0831","548","204","344","3","551","1301","0","42.35","15.68"
"64","000","00","180","0001","0832","616","250","366","8","624","1342","0","46.50","18.63"
"64","000","00","180","0001","0833","541","236","305","1","542","1420","0","38.17","16.62"
"64","000","00","180","0001","0834","535","245","290","2","537","1295","0","41.47","18.92"
"64","000","00","180","0001","0835","521","195","326","7","528","1283","0","41.15","15.20"
"64","000","00","180","0001","0836","540","161","379","9","549","1316","0","41.72","12.23"
"64","000","00","180","0002","0000","2310","935","1375","13","2323","4917","0","47.24","19.02"
"64","000","00","180","0002","0837","684","270","414","3","687","1419","0","48.41","19.03"
"64","000","00","180","0002","0838","579","180","399","3","582","1159","0","50.22","15.53"
"64","000","00","180","0002","0839","464","218","246","4","468","1101","0","42.51","19.80"
"64","000","00","180","0002","0840","583","267","316","3","586","1238","0","47.33","21.57"
"64","000","00","180","0003","0000","4811","2084","2727","28","4839","9866","0","49.05","21.12"
"64","000","00","180","0003","0841","650","229","421","7","657","1243","0","52.86","18.42"
"64","000","00","180","0003","0842","646","306","340","0","646","1337","0","48.32","22.89"
"64","000","00","180","0003","0843","618","263","355","3","621","1285","0","48.33","20.47"
"64","000","00","180","0003","0844","552","235","317","2","554","1156","0","47.92","20.33"
"64","000","00","180","0003","0845","486","239","247","2","488","1070","0","45.61","22.34"
"64","000","00","180","0003","0846","665","298","367","2","667","1319","0","50.57","22.59"
"64","000","00","180","0003","0847","615","217","398","8","623","1207","0","51.62","17.98"
"64","000","00","180","0003","0848","579","297","282","4","583","1249","0","46.68","23.78"
"64","000","00","180","0004","0000","1631","545","1086","12","1643","3551","0","46.27","15.35"
"64","000","00","180","0004","0849","557","175","382","3","560","1211","0","46.24","14.45"
"64","000","00","180","0004","0850","556","223","333","6","562","1213","0","46.33","18.38"
"64","000","00","180","0004","0851","518","147","371","3","521","1127","0","46.23","13.04"
"64","000","00","180","0005","0000","2749","827","1922","24","2773","6496","0","42.69","12.73"
"64","000","00","180","0005","0852","565","136","429","3","568","1245","0","45.62","10.92"
"64","000","00","180","0005","0853","671","203","468","6","677","1502","0","45.07","13.52"
"64","000","00","180","0005","0854","530","153","377","6","536","1387","0","38.64","11.03"
"64","000","00","180","0005","0855","539","195","344","4","543","1313","0","41.36","14.85"
"64","000","00","180","0005","0856","444","140","304","5","449","1049","0","42.80","13.35"
"64","000","00","180","0006","0000","337","95","242","0","337","678","0","49.71","14.01"
"64","000","00","180","0006","0857","337","95","242","0","337","678","0","49.71","14.01"
"64","000","00","180","0007","0000","1733","614","1119","10","1743","3874","0","44.99","15.85"
"64","000","00","180","0007","0858","594","195","399","5","599","1345","0","44.54","14.50"
"64","000","00","180","0007","0859","529","194","335","1","530","1248","0","42.47","15.54"
"64","000","00","180","0007","0860","610","225","385","4","614","1281","0","47.93","17.56"
"64","000","00","190","0000","0000","34581","14532","20049","303","34884","81201","96433","42.96","17.90"
"64","000","00","190","0001","0000","470","194","276","6","476","1073","0","44.36","18.08"
"64","000","00","190","0001","0375","470","194","276","6","476","1073","0","44.36","18.08"
"64","000","00","190","0002","0000","1674","637","1037","8","1682","4363","0","38.55","14.60"
"64","000","00","190","0002","0368","560","257","303","3","563","1338","0","42.08","19.21"
"64","000","00","190","0002","0369","358","108","250","1","359","1084","0","33.12","9.96"
"64","000","00","190","0002","0370","385","153","232","3","388","1056","0","36.74","14.49"
"64","000","00","190","0002","0371","371","119","252","1","372","885","0","42.03","13.45"
"64","000","00","190","0003","0000","1439","651","788","9","1448","3149","0","45.98","20.67"
"64","000","00","190","0003","0372","415","163","252","1","416","893","0","46.58","18.25"
"64","000","00","190","0003","0373","476","208","268","3","479","1063","0","45.06","19.57"
"64","000","00","190","0003","0374","548","280","268","5","553","1193","0","46.35","23.47"
"64","000","00","190","0004","0000","415","144","271","5","420","985","0","42.64","14.62"
"64","000","00","190","0004","0376","415","144","271","5","420","985","0","42.64","14.62"
"64","000","00","190","0005","0000","1694","801","893","17","1711","4134","0","41.39","19.38"
"64","000","00","190","0005","0381","557","195","362","9","566","1346","0","42.05","14.49"
"64","000","00","190","0005","0382","591","262","329","1","592","1369","0","43.24","19.14"
"64","000","00","190","0005","0383","546","344","202","7","553","1419","0","38.97","24.24"
"64","000","00","190","0006","0000","634","165","469","10","644","1366","0","47.14","12.08"
"64","000","00","190","0006","0377","634","165","469","10","644","1366","0","47.14","12.08"
"64","000","00","190","0007","0000","1318","1021","297","19","1337","2810","0","47.58","36.33"
"64","000","00","190","0007","0433","591","475","116","7","598","1316","0","45.44","36.09"
"64","000","00","190","0007","0434","560","473","87","10","570","1163","0","49.01","40.67"
"64","000","00","190","0007","0435","167","73","94","2","169","331","0","51.06","22.05"
"64","000","00","190","0008","0000","152","71","81","2","154","300","0","51.33","23.67"
"64","000","00","190","0008","0440","152","71","81","2","154","300","0","51.33","23.67"
"64","000","00","190","0009","0000","1181","443","738","17","1198","2809","0","42.65","15.77"
"64","000","00","190","0009","0401","560","209","351","9","569","1296","0","43.90","16.13"
"64","000","00","190","0009","0402","621","234","387","8","629","1513","0","41.57","15.47"
"64","000","00","190","0010","0000","706","222","484","8","714","1401","0","50.96","15.85"
"64","000","00","190","0010","0417","706","222","484","8","714","1401","0","50.96","15.85"
"64","000","00","190","0011","0000","1612","669","943","23","1635","3572","0","45.77","18.73"
"64","000","00","190","0011","0412","543","231","312","10","553","1283","0","43.10","18.00"
"64","000","00","190","0011","0413","489","225","264","4","493","1014","0","48.62","22.19"
"64","000","00","190","0011","0414","580","213","367","9","589","1275","0","46.20","16.71"
"64","000","00","190","0012","0000","2223","1040","1183","22","2245","5458","0","41.13","19.05"
"64","000","00","190","0012","0408","520","215","305","5","525","1271","0","41.31","16.92"
"64","000","00","190","0012","0409","596","263","333","9","605","1376","0","43.97","19.11"
"64","000","00","190","0012","0410","580","289","291","3","583","1330","0","43.83","21.73"
"64","000","00","190","0012","0411","527","273","254","5","532","1481","0","35.92","18.43"
"64","000","00","190","0013","0000","658","368","290","3","661","1556","0","42.48","23.65"
"64","000","00","190","0013","0438","357","195","162","2","359","828","0","43.36","23.55"
"64","000","00","190","0013","0439","301","173","128","1","302","728","0","41.48","23.76"
"64","000","00","190","0014","0000","337","83","254","3","340","761","0","44.68","10.91"
"64","000","00","190","0014","0428","337","83","254","3","340","761","0","44.68","10.91"
"64","000","00","190","0015","0000","364","81","283","5","369","867","0","42.56","9.34"
"64","000","00","190","0015","0431","364","81","283","5","369","867","0","42.56","9.34"
"64","000","00","190","0016","0000","1502","630","872","12","1514","3290","0","46.02","19.15"
"64","000","00","190","0016","0405","490","172","318","5","495","1036","0","47.78","16.60"
"64","000","00","190","0016","0406","513","209","304","2","515","1055","0","48.82","19.81"
"64","000","00","190","0016","0407","499","249","250","5","504","1199","0","42.04","20.77"
"64","000","00","190","0017","0000","1542","613","929","11","1553","3822","0","40.63","16.04"
"64","000","00","190","0017","0384","467","191","276","4","471","1258","0","37.44","15.18"
"64","000","00","190","0017","0385","497","192","305","2","499","1199","0","41.62","16.01"
"64","000","00","190","0017","0386","578","230","348","5","583","1365","0","42.71","16.85"
"64","000","00","190","0018","0000","1712","771","941","19","1731","4091","0","42.31","18.85"
"64","000","00","190","0018","0378","540","219","321","5","545","1301","0","41.89","16.83"
"64","000","00","190","0018","0379","597","270","327","5","602","1380","0","43.62","19.57"
"64","000","00","190","0018","0380","575","282","293","9","584","1410","0","41.42","20.00"
"64","000","00","190","0019","0000","2657","1019","1638","15","2672","6810","0","39.24","14.96"
"64","000","00","190","0019","0387","454","191","263","4","458","1257","0","36.44","15.19"
"64","000","00","190","0019","0388","551","186","365","3","554","1310","0","42.29","14.20"
"64","000","00","190","0019","0389","542","229","313","3","545","1341","0","40.64","17.08"
"64","000","00","190","0019","0390","570","217","353","2","572","1421","0","40.25","15.27"
"64","000","00","190","0019","0391","540","196","344","3","543","1481","0","36.66","13.23"
"64","000","00","190","0020","0000","2313","842","1471","12","2325","5811","0","40.01","14.49"
"64","000","00","190","0020","0392","647","233","414","4","651","1569","0","41.49","14.85"
"64","000","00","190","0020","0393","654","238","416","3","657","1647","0","39.89","14.45"
"64","000","00","190","0020","0394","528","209","319","4","532","1423","0","37.39","14.69"
"64","000","00","190","0020","0395","484","162","322","1","485","1172","0","41.38","13.82"
"64","000","00","190","0021","0000","771","273","498","2","773","1862","0","41.51","14.66"
"64","000","00","190","0021","0397","405","146","259","1","406","1000","0","40.60","14.60"
"64","000","00","190","0021","0398","366","127","239","1","367","862","0","42.58","14.73"
"64","000","00","190","0022","0000","784","299","485","4","788","1933","0","40.77","15.47"
"64","000","00","190","0022","0418","386","108","278","2","388","867","0","44.75","12.46"
"64","000","00","190","0022","0419","398","191","207","2","400","1066","0","37.52","17.92"
"64","000","00","190","0023","0000","890","326","564","2","892","1850","0","48.22","17.62"
"64","000","00","190","0023","0420","387","103","284","1","388","845","0","45.92","12.19"
"64","000","00","190","0023","0421","503","223","280","1","504","1005","0","50.15","22.19"
"64","000","00","190","0024","0000","472","176","296","3","475","1048","0","45.32","16.79"
"64","000","00","190","0024","0422","472","176","296","3","475","1048","0","45.32","16.79"
"64","000","00","190","0025","0000","678","219","459","4","682","1683","0","40.52","13.01"
"64","000","00","190","0025","0399","331","103","228","3","334","821","0","40.68","12.55"
"64","000","00","190","0025","0400","347","116","231","1","348","862","0","40.37","13.46"
"64","000","00","190","0026","0000","1395","388","1007","13","1408","3339","0","42.17","11.62"
"64","000","00","190","0026","0423","440","127","313","5","445","1013","0","43.93","12.54"
"64","000","00","190","0026","0424","409","120","289","3","412","996","0","41.37","12.05"
"64","000","00","190","0026","0425","546","141","405","5","551","1330","0","41.43","10.60"
"64","000","00","190","0027","0000","774","284","490","11","785","1747","0","44.93","16.26"
"64","000","00","190","0027","0426","622","236","386","8","630","1442","0","43.69","16.37"
"64","000","00","190","0027","0427","152","48","104","3","155","305","0","50.82","15.74"
"64","000","00","190","0028","0000","750","143","607","6","756","1567","0","48.25","9.13"
"64","000","00","190","0028","0429","342","78","264","2","344","723","0","47.58","10.79"
"64","000","00","190","0028","0430","408","65","343","4","412","844","0","48.82","7.70"
"64","000","00","190","0029","0000","361","134","227","5","366","984","0","37.20","13.62"
"64","000","00","190","0029","0432","361","134","227","5","366","984","0","37.20","13.62"
"64","000","00","190","0030","0000","869","449","420","2","871","2090","0","41.67","21.48"
"64","000","00","190","0030","0415","361","178","183","1","362","875","0","41.37","20.34"
"64","000","00","190","0030","0416","508","271","237","1","509","1215","0","41.89","22.30"
"64","000","00","190","0031","0000","289","89","200","4","293","631","0","46.43","14.10"
"64","000","00","190","0031","0396","289","89","200","4","293","631","0","46.43","14.10"
"64","000","00","190","0032","0000","965","423","542","7","972","2230","0","43.59","18.97"
"64","000","00","190","0032","0403","418","164","254","3","421","954","0","44.13","17.19"
"64","000","00","190","0032","0404","547","259","288","4","551","1276","0","43.18","20.30"
"64","000","00","190","0033","0000","980","864","116","14","994","1809","0","54.95","47.76"
"64","000","00","190","0033","0436","480","434","46","8","488","887","0","55.02","48.93"
"64","000","00","190","0033","0437","500","430","70","6","506","922","0","54.88","46.64"
"64","000","00","200","0000","0000","15849","5034","10815","135","15984","34350","39528","46.53","14.66"
"64","000","00","200","0001","0000","944","344","600","7","951","2052","0","46.35","16.76"
"64","000","00","200","0001","0489","452","158","294","5","457","944","0","48.41","16.74"
"64","000","00","200","0001","0490","492","186","306","2","494","1108","0","44.58","16.79"
"64","000","00","200","0002","0000","540","161","379","6","546","1060","0","51.51","15.19"
"64","000","00","200","0002","0491","540","161","379","6","546","1060","0","51.51","15.19"
"64","000","00","200","0003","0000","1130","339","791","8","1138","2289","0","49.72","14.81"
"64","000","00","200","0003","0492","593","178","415","4","597","1211","0","49.30","14.70"
"64","000","00","200","0003","0493","537","161","376","4","541","1078","0","50.19","14.94"
"64","000","00","200","0004","0000","1252","464","788","10","1262","2597","0","48.59","17.87"
"64","000","00","200","0004","0494","637","241","396","4","641","1338","0","47.91","18.01"
"64","000","00","200","0004","0495","615","223","392","6","621","1259","0","49.32","17.71"
"64","000","00","200","0005","0000","561","169","392","1","562","1196","0","46.99","14.13"
"64","000","00","200","0005","0496","561","169","392","1","562","1196","0","46.99","14.13"
"64","000","00","200","0006","0000","1074","277","797","13","1087","2294","0","47.38","12.07"
"64","000","00","200","0006","0497","479","131","348","7","486","1025","0","47.41","12.78"
"64","000","00","200","0006","0498","595","146","449","6","601","1269","0","47.36","11.51"
"64","000","00","200","0007","0000","651","154","497","5","656","1371","0","47.85","11.23"
"64","000","00","200","0007","0499","334","64","270","3","337","668","0","50.45","9.58"
"64","000","00","200","0007","0500","317","90","227","2","319","703","0","45.38","12.80"
"64","000","00","200","0008","0000","1441","496","945","12","1453","3241","0","44.83","15.30"
"64","000","00","200","0008","0501","532","155","377","3","535","1274","0","41.99","12.17"
"64","000","00","200","0008","0502","553","200","353","4","557","1230","0","45.28","16.26"
"64","000","00","200","0008","0503","356","141","215","5","361","737","0","48.98","19.13"
"64","000","00","200","0009","0000","727","201","526","6","733","1506","0","48.67","13.35"
"64","000","00","200","0009","0504","424","111","313","4","428","918","0","46.62","12.09"
"64","000","00","200","0009","0505","303","90","213","2","305","588","0","51.87","15.31"
"64","000","00","200","0010","0000","1866","707","1159","8","1874","4359","0","42.99","16.22"
"64","000","00","200","0010","0506","409","114","295","2","411","803","0","51.18","14.20"
"64","000","00","200","0010","0507","164","44","120","6","170","334","0","50.90","13.17"
"64","000","00","200","0010","0508","528","219","309","0","528","1367","0","38.62","16.02"
"64","000","00","200","0010","0509","363","158","205","0","363","888","0","40.88","17.79"
"64","000","00","200","0010","0510","402","172","230","0","402","967","0","41.57","17.79"
"64","000","00","200","0011","0000","931","306","625","15","946","2139","0","44.23","14.31"
"64","000","00","200","0011","0511","545","159","386","12","557","1208","0","46.11","13.16"
"64","000","00","200","0011","0512","386","147","239","3","389","931","0","41.78","15.79"
"64","000","00","200","0012","0000","1072","333","739","13","1085","2401","0","45.19","13.87"
"64","000","00","200","0012","0513","523","154","369","8","531","1196","0","44.40","12.88"
"64","000","00","200","0012","0514","549","179","370","5","554","1205","0","45.98","14.85"
"64","000","00","200","0013","0000","593","187","406","4","597","1340","0","44.55","13.96"
"64","000","00","200","0013","0515","593","187","406","4","597","1340","0","44.55","13.96"
"64","000","00","200","0014","0000","283","61","222","2","285","662","0","43.05","9.21"
"64","000","00","200","0014","0516","283","61","222","2","285","662","0","43.05","9.21"
"64","000","00","200","0015","0000","1765","549","1216","14","1779","3625","0","49.08","15.14"
"64","000","00","200","0015","0517","591","175","416","4","595","1212","0","49.09","14.44"
"64","000","00","200","0015","0518","602","178","424","5","607","1234","0","49.19","14.42"
"64","000","00","200","0015","0519","572","196","376","5","577","1179","0","48.94","16.62"
"64","000","00","200","0016","0000","665","209","456","9","674","1442","0","46.74","14.49"
"64","000","00","200","0016","0520","399","121","278","5","404","816","0","49.51","14.83"
"64","000","00","200","0016","0521","266","88","178","4","270","626","0","43.13","14.06"
"64","000","00","200","0017","0000","354","77","277","2","356","776","0","45.88","9.92"
"64","000","00","200","0017","0522","354","77","277","2","356","776","0","45.88","9.92"
"64","000","00","210","0000","0000","10333","3598","6735","117","10450","25855","29312","40.42","13.92"
"64","000","00","210","0001","0000","435","129","306","0","435","1096","0","39.69","11.77"
"64","000","00","210","0001","0173","435","129","306","0","435","1096","0","39.69","11.77"
"64","000","00","210","0002","0000","914","292","622","8","922","2055","0","44.87","14.21"
"64","000","00","210","0002","0174","504","163","341","6","510","1110","0","45.95","14.68"
"64","000","00","210","0002","0175","410","129","281","2","412","945","0","43.60","13.65"
"64","000","00","210","0003","0000","1393","458","935","19","1412","3308","0","42.68","13.85"
"64","000","00","210","0003","0176","456","116","340","4","460","1011","0","45.50","11.47"
"64","000","00","210","0003","0177","424","143","281","1","425","1072","0","39.65","13.34"
"64","000","00","210","0003","0178","409","114","295","6","415","1011","0","41.05","11.28"
"64","000","00","210","0003","0179","104","85","19","8","112","214","0","52.34","39.72"
"64","000","00","210","0004","0000","1142","421","721","16","1158","2690","0","43.05","15.65"
"64","000","00","210","0004","0180","437","178","259","10","447","935","0","47.81","19.04"
"64","000","00","210","0004","0181","269","58","211","3","272","620","0","43.87","9.35"
"64","000","00","210","0004","0182","436","185","251","3","439","1135","0","38.68","16.30"
"64","000","00","210","0005","0000","1048","343","705","11","1059","2471","0","42.86","13.88"
"64","000","00","210","0005","0183","472","121","351","6","478","1097","0","43.57","11.03"
"64","000","00","210","0005","0184","576","222","354","5","581","1374","0","42.29","16.16"
"64","000","00","210","0006","0000","165","79","86","6","171","464","0","36.85","17.03"
"64","000","00","210","0006","0185","165","79","86","6","171","464","0","36.85","17.03"
"64","000","00","210","0007","0000","869","289","580","13","882","2315","0","38.10","12.48"
"64","000","00","210","0007","0186","434","123","311","6","440","1191","0","36.94","10.33"
"64","000","00","210","0007","0187","435","166","269","7","442","1124","0","39.32","14.77"
"64","000","00","210","0008","0000","1500","610","890","13","1513","3871","0","39.09","15.76"
"64","000","00","210","0008","0188","471","165","306","6","477","1131","0","42.18","14.59"
"64","000","00","210","0008","0189","507","230","277","4","511","1389","0","36.79","16.56"
"64","000","00","210","0008","0190","522","215","307","3","525","1351","0","38.86","15.91"
"64","000","00","210","0009","0000","1278","443","835","12","1290","3315","0","38.91","13.36"
"64","000","00","210","0009","0191","411","136","275","6","417","958","0","43.53","14.20"
"64","000","00","210","0009","0192","428","152","276","5","433","1081","0","40.06","14.06"
"64","000","00","210","0009","0193","439","155","284","1","440","1276","0","34.48","12.15"
"64","000","00","210","0010","0000","700","242","458","8","708","1874","0","37.78","12.91"
"64","000","00","210","0010","0194","313","90","223","2","315","763","0","41.28","11.80"
"64","000","00","210","0010","0195","387","152","235","6","393","1111","0","35.37","13.68"
"64","000","00","210","0011","0000","889","292","597","11","900","2396","0","37.56","12.19"
"64","000","00","210","0011","0196","548","176","372","5","553","1371","0","40.34","12.84"
"64","000","00","210","0011","0197","341","116","225","6","347","1025","0","33.85","11.32"
"64","000","00","220","0000","0000","2315","695","1620","42","2357","6357","6860","37.08","10.93"
"64","000","00","220","0001","0000","141","52","89","1","142","347","0","40.92","14.99"
"64","000","00","220","0001","0161","141","52","89","1","142","347","0","40.92","14.99"
"64","000","00","220","0002","0000","360","104","256","14","374","1016","0","36.81","10.24"
"64","000","00","220","0002","0162","212","74","138","7","219","637","0","34.38","11.62"
"64","000","00","220","0002","0163","148","30","118","7","155","379","0","40.90","7.92"
"64","000","00","220","0003","0000","142","27","115","1","143","364","0","39.29","7.42"
"64","000","00","220","0003","0164","142","27","115","1","143","364","0","39.29","7.42"
"64","000","00","220","0004","0000","128","28","100","1","129","364","0","35.44","7.69"
"64","000","00","220","0004","0165","128","28","100","1","129","364","0","35.44","7.69"
"64","000","00","220","0005","0000","223","54","169","4","227","594","0","38.22","9.09"
"64","000","00","220","0005","0166","223","54","169","4","227","594","0","38.22","9.09"
"64","000","00","220","0006","0000","343","142","201","5","348","914","0","38.07","15.54"
"64","000","00","220","0006","0167","343","142","201","5","348","914","0","38.07","15.54"
"64","000","00","220","0007","0000","254","90","164","7","261","777","0","33.59","11.58"
"64","000","00","220","0007","0168","254","90","164","7","261","777","0","33.59","11.58"
"64","000","00","220","0008","0000","111","45","66","1","112","333","0","33.63","13.51"
"64","000","00","220","0008","0169","111","45","66","1","112","333","0","33.63","13.51"
"64","000","00","220","0009","0000","160","41","119","2","162","484","0","33.47","8.47"
"64","000","00","220","0009","0170","160","41","119","2","162","484","0","33.47","8.47"
"64","000","00","220","0010","0000","453","112","341","6","459","1164","0","39.43","9.62"
"64","000","00","220","0010","0171","219","44","175","2","221","574","0","38.50","7.67"
"64","000","00","220","0010","0172","234","68","166","4","238","590","0","40.34","11.53"
"64","000","00","230","0000","0000","9367","2933","6434","92","9459","24309","28170","38.91","12.07"
"64","000","00","230","0001","0000","486","127","359","3","489","1283","0","38.11","9.90"
"64","000","00","230","0001","0137","486","127","359","3","489","1283","0","38.11","9.90"
"64","000","00","230","0002","0000","825","170","655","10","835","1973","0","42.32","8.62"
"64","000","00","230","0002","0138","454","92","362","3","457","1086","0","42.08","8.47"
"64","000","00","230","0002","0139","371","78","293","7","378","887","0","42.62","8.79"
"64","000","00","230","0003","0000","463","119","344","3","466","1209","0","38.54","9.84"
"64","000","00","230","0003","0140","463","119","344","3","466","1209","0","38.54","9.84"
"64","000","00","230","0004","0000","870","339","531","7","877","2122","0","41.33","15.98"
"64","000","00","230","0004","0141","289","115","174","1","290","682","0","42.52","16.86"
"64","000","00","230","0004","0142","340","135","205","5","345","876","0","39.38","15.41"
"64","000","00","230","0004","0143","241","89","152","1","242","564","0","42.91","15.78"
"64","000","00","230","0005","0000","274","101","173","5","279","761","0","36.66","13.27"
"64","000","00","230","0005","0144","274","101","173","5","279","761","0","36.66","13.27"
"64","000","00","230","0006","0000","1791","572","1219","17","1808","4888","0","36.99","11.70"
"64","000","00","230","0006","0145","456","129","327","5","461","1226","0","37.60","10.52"
"64","000","00","230","0006","0146","442","155","287","4","446","1153","0","38.68","13.44"
"64","000","00","230","0006","0147","413","128","285","1","414","1222","0","33.88","10.47"
"64","000","00","230","0006","0148","480","160","320","7","487","1287","0","37.84","12.43"
"64","000","00","230","0007","0000","955","281","674","9","964","2590","0","37.22","10.85"
"64","000","00","230","0007","0149","307","78","229","2","309","893","0","34.60","8.73"
"64","000","00","230","0007","0150","311","89","222","3","314","831","0","37.79","10.71"
"64","000","00","230","0007","0151","337","114","223","4","341","866","0","39.38","13.16"
"64","000","00","230","0008","0000","918","266","652","10","928","2291","0","40.51","11.61"
"64","000","00","230","0008","0152","427","126","301","2","429","1057","0","40.59","11.92"
"64","000","00","230","0008","0153","491","140","351","8","499","1234","0","40.44","11.35"
"64","000","00","230","0009","0000","566","208","358","1","567","1541","0","36.79","13.50"
"64","000","00","230","0009","0154","566","208","358","1","567","1541","0","36.79","13.50"
"64","000","00","230","0010","0000","630","209","421","10","640","1648","0","38.83","12.68"
"64","000","00","230","0010","0155","327","81","246","2","329","852","0","38.62","9.51"
"64","000","00","230","0010","0156","303","128","175","8","311","796","0","39.07","16.08"
"64","000","00","230","0011","0000","457","102","355","9","466","1043","0","44.68","9.78"
"64","000","00","230","0011","0157","457","102","355","9","466","1043","0","44.68","9.78"
"64","000","00","230","0012","0000","1132","439","693","8","1140","2960","0","38.51","14.83"
"64","000","00","230","0012","0158","410","141","269","1","411","1082","0","37.99","13.03"
"64","000","00","230","0012","0159","371","159","212","5","376","1054","0","35.67","15.09"
"64","000","00","230","0012","0160","351","139","212","2","353","824","0","42.84","16.87"
"64","000","00","240","0000","0000","17120","6232","10888","180","17300","43320","51490","39.94","14.39"
"64","000","00","240","0001","0000","1152","410","742","8","1160","3254","0","35.65","12.60"
"64","000","00","240","0001","0311","382","134","248","3","385","1004","0","38.35","13.35"
"64","000","00","240","0001","0312","356","95","261","4","360","1055","0","34.12","9.00"
"64","000","00","240","0001","0313","414","181","233","1","415","1195","0","34.73","15.15"
"64","000","00","240","0002","0000","469","173","296","6","475","1144","0","41.52","15.12"
"64","000","00","240","0002","0314","469","173","296","6","475","1144","0","41.52","15.12"
"64","000","00","240","0003","0000","440","158","282","9","449","1195","0","37.57","13.22"
"64","000","00","240","0003","0315","440","158","282","9","449","1195","0","37.57","13.22"
"64","000","00","240","0004","0000","433","145","288","4","437","1098","0","39.80","13.21"
"64","000","00","240","0004","0316","433","145","288","4","437","1098","0","39.80","13.21"
"64","000","00","240","0005","0000","567","195","372","7","574","1220","0","47.05","15.98"
"64","000","00","240","0005","0317","567","195","372","7","574","1220","0","47.05","15.98"
"64","000","00","240","0006","0000","898","340","558","11","909","2211","0","41.11","15.38"
"64","000","00","240","0006","0318","418","164","254","4","422","1120","0","37.68","14.64"
"64","000","00","240","0006","0319","480","176","304","7","487","1091","0","44.64","16.13"
"64","000","00","240","0007","0000","818","277","541","9","827","2084","0","39.68","13.29"
"64","000","00","240","0007","0320","409","147","262","3","412","942","0","43.74","15.61"
"64","000","00","240","0007","0321","409","130","279","6","415","1142","0","36.34","11.38"
"64","000","00","240","0008","0000","1199","502","697","12","1211","3276","0","36.97","15.32"
"64","000","00","240","0008","0322","389","159","230","2","391","1014","0","38.56","15.68"
"64","000","00","240","0008","0323","403","191","212","4","407","996","0","40.86","19.18"
"64","000","00","240","0008","0324","407","152","255","6","413","1266","0","32.62","12.01"
"64","000","00","240","0009","0000","966","295","671","10","976","2623","0","37.21","11.25"
"64","000","00","240","0009","0325","322","106","216","4","326","854","0","38.17","12.41"
"64","000","00","240","0009","0326","304","107","197","3","307","827","0","37.12","12.94"
"64","000","00","240","0009","0327","340","82","258","3","343","942","0","36.41","8.70"
"64","000","00","240","0010","0000","652","190","462","10","662","1825","0","36.27","10.41"
"64","000","00","240","0010","0328","280","95","185","3","283","787","0","35.96","12.07"
"64","000","00","240","0010","0329","372","95","277","7","379","1038","0","36.51","9.15"
"64","000","00","240","0011","0000","1377","530","847","17","1394","3439","0","40.54","15.41"
"64","000","00","240","0011","0330","368","136","232","5","373","912","0","40.90","14.91"
"64","000","00","240","0011","0331","323","136","187","4","327","717","0","45.61","18.97"
"64","000","00","240","0011","0332","328","123","205","5","333","914","0","36.43","13.46"
"64","000","00","240","0011","0333","358","135","223","3","361","896","0","40.29","15.07"
"64","000","00","240","0012","0000","869","332","537","7","876","2163","0","40.50","15.35"
"64","000","00","240","0012","0334","392","142","250","4","396","1026","0","38.60","13.84"
"64","000","00","240","0012","0335","477","190","287","3","480","1137","0","42.22","16.71"
"64","000","00","240","0013","0000","1148","412","736","9","1157","2976","0","38.88","13.84"
"64","000","00","240","0013","0336","378","131","247","0","378","952","0","39.71","13.76"
"64","000","00","240","0013","0337","418","169","249","5","423","1036","0","40.83","16.31"
"64","000","00","240","0013","0338","352","112","240","4","356","988","0","36.03","11.34"
"64","000","00","240","0014","0000","1012","398","614","11","1023","2337","0","43.77","17.03"
"64","000","00","240","0014","0339","508","190","318","8","516","1234","0","41.82","15.40"
"64","000","00","240","0014","0340","504","208","296","3","507","1103","0","45.97","18.86"
"64","000","00","240","0015","0000","357","114","243","3","360","841","0","42.81","13.56"
"64","000","00","240","0015","0341","357","114","243","3","360","841","0","42.81","13.56"
"64","000","00","240","0016","0000","771","281","490","8","779","1908","0","40.83","14.73"
"64","000","00","240","0016","0342","429","156","273","5","434","971","0","44.70","16.07"
"64","000","00","240","0016","0343","342","125","217","3","345","937","0","36.82","13.34"
"64","000","00","240","0017","0000","683","210","473","6","689","1711","0","40.27","12.27"
"64","000","00","240","0017","0344","304","92","212","0","304","823","0","36.94","11.18"
"64","000","00","240","0017","0345","379","118","261","6","385","888","0","43.36","13.29"
"64","000","00","240","0018","0000","331","103","228","2","333","846","0","39.36","12.17"
"64","000","00","240","0018","0346","331","103","228","2","333","846","0","39.36","12.17"
"64","000","00","240","0019","0000","1165","452","713","11","1176","2643","0","44.49","17.10"
"64","000","00","240","0019","0347","417","156","261","1","418","921","0","45.39","16.94"
"64","000","00","240","0019","0348","384","156","228","4","388","849","0","45.70","18.37"
"64","000","00","240","0019","0349","364","140","224","6","370","873","0","42.38","16.04"
"64","000","00","240","0020","0000","1813","715","1098","20","1833","4526","0","40.50","15.80"
"64","000","00","240","0020","0350","382","125","257","7","389","902","0","43.13","13.86"
"64","000","00","240","0020","0351","367","137","230","6","373","858","0","43.47","15.97"
"64","000","00","240","0020","0352","311","115","196","3","314","913","0","34.39","12.60"
"64","000","00","240","0020","0353","351","152","199","1","352","894","0","39.37","17.00"
"64","000","00","240","0020","0354","402","186","216","3","405","959","0","42.23","19.40"
"64","000","00","250","0000","0000","10021","3315","6706","86","10107","25813","29772","39.15","12.84"
"64","000","00","250","0001","0000","477","162","315","3","480","1070","0","44.86","15.14"
"64","000","00","250","0001","0284","477","162","315","3","480","1070","0","44.86","15.14"
"64","000","00","250","0002","0000","393","121","272","2","395","981","0","40.27","12.33"
"64","000","00","250","0002","0285","393","121","272","2","395","981","0","40.27","12.33"
"64","000","00","250","0003","0000","354","96","258","6","360","768","0","46.88","12.50"
"64","000","00","250","0003","0286","354","96","258","6","360","768","0","46.88","12.50"
"64","000","00","250","0004","0000","854","303","551","8","862","2214","0","38.93","13.69"
"64","000","00","250","0004","0287","419","142","277","5","424","1104","0","38.41","12.86"
"64","000","00","250","0004","0288","435","161","274","3","438","1110","0","39.46","14.50"
"64","000","00","250","0005","0000","1024","270","754","10","1034","2648","0","39.05","10.20"
"64","000","00","250","0005","0289","351","84","267","1","352","889","0","39.60","9.45"
"64","000","00","250","0005","0290","336","86","250","6","342","876","0","39.04","9.82"
"64","000","00","250","0005","0291","337","100","237","3","340","883","0","38.51","11.33"
"64","000","00","250","0006","0000","1439","538","901","12","1451","3677","0","39.46","14.63"
"64","000","00","250","0006","0292","320","117","203","3","323","882","0","36.62","13.27"
"64","000","00","250","0006","0293","386","121","265","4","390","914","0","42.67","13.24"
"64","000","00","250","0006","0294","380","162","218","2","382","930","0","41.08","17.42"
"64","000","00","250","0006","0295","353","138","215","3","356","951","0","37.43","14.51"
"64","000","00","250","0007","0000","399","145","254","4","403","997","0","40.42","14.54"
"64","000","00","250","0007","0296","399","145","254","4","403","997","0","40.42","14.54"
"64","000","00","250","0008","0000","1478","561","917","9","1487","3781","0","39.33","14.84"
"64","000","00","250","0008","0297","323","126","197","2","325","795","0","40.88","15.85"
"64","000","00","250","0008","0298","358","103","255","5","363","778","0","46.66","13.24"
"64","000","00","250","0008","0299","379","168","211","1","380","1059","0","35.88","15.86"
"64","000","00","250","0008","0300","418","164","254","1","419","1149","0","36.47","14.27"
"64","000","00","250","0009","0000","716","191","525","8","724","1752","0","41.32","10.90"
"64","000","00","250","0009","0301","412","105","307","2","414","913","0","45.35","11.50"
"64","000","00","250","0009","0302","304","86","218","6","310","839","0","36.95","10.25"
"64","000","00","250","0010","0000","482","144","338","3","485","1198","0","40.48","12.02"
"64","000","00","250","0010","0303","482","144","338","3","485","1198","0","40.48","12.02"
"64","000","00","250","0011","0000","766","203","563","6","772","2155","0","35.82","9.42"
"64","000","00","250","0011","0304","368","91","277","1","369","1074","0","34.36","8.47"
"64","000","00","250","0011","0305","398","112","286","5","403","1081","0","37.28","10.36"
"64","000","00","250","0012","0000","427","117","310","3","430","1133","0","37.95","10.33"
"64","000","00","250","0012","0306","427","117","310","3","430","1133","0","37.95","10.33"
"64","000","00","250","0013","0000","275","87","188","2","277","700","0","39.57","12.43"
"64","000","00","250","0013","0307","275","87","188","2","277","700","0","39.57","12.43"
"64","000","00","250","0014","0000","937","377","560","10","947","2739","0","34.57","13.76"
"64","000","00","250","0014","0308","341","138","203","7","348","935","0","37.22","14.76"
"64","000","00","250","0014","0309","330","144","186","2","332","961","0","34.55","14.98"
"64","000","00","250","0014","0310","266","95","171","1","267","843","0","31.67","11.27"
"64","000","00","260","0000","0000","9743","3101","6642","87","9830","26119","29883","37.64","11.87"
"64","000","00","260","0001","0000","419","100","319","5","424","955","0","44.40","10.47"
"64","000","00","260","0001","0260","419","100","319","5","424","955","0","44.40","10.47"
"64","000","00","260","0002","0000","334","104","230","3","337","854","0","39.46","12.18"
"64","000","00","260","0002","0261","334","104","230","3","337","854","0","39.46","12.18"
"64","000","00","260","0003","0000","681","248","433","8","689","1718","0","40.10","14.44"
"64","000","00","260","0003","0262","373","141","232","5","378","899","0","42.05","15.68"
"64","000","00","260","0003","0263","308","107","201","3","311","819","0","37.97","13.06"
"64","000","00","260","0004","0000","1451","442","1009","10","1461","3784","0","38.61","11.68"
"64","000","00","260","0004","0264","412","132","280","3","415","1247","0","33.28","10.59"
"64","000","00","260","0004","0265","540","160","380","4","544","1323","0","41.12","12.09"
"64","000","00","260","0004","0266","499","150","349","3","502","1214","0","41.35","12.36"
"64","000","00","260","0005","0000","668","228","440","3","671","1771","0","37.89","12.87"
"64","000","00","260","0005","0267","339","131","208","1","340","945","0","35.98","13.86"
"64","000","00","260","0005","0268","329","97","232","2","331","826","0","40.07","11.74"
"64","000","00","260","0006","0000","419","102","317","4","423","1100","0","38.45","9.27"
"64","000","00","260","0006","0274","419","102","317","4","423","1100","0","38.45","9.27"
"64","000","00","260","0007","0000","1118","326","792","3","1121","2955","0","37.94","11.03"
"64","000","00","260","0007","0275","522","147","375","2","524","1303","0","40.21","11.28"
"64","000","00","260","0007","0276","596","179","417","1","597","1652","0","36.14","10.84"
"64","000","00","260","0008","0000","304","101","203","4","308","919","0","33.51","10.99"
"64","000","00","260","0008","0278","304","101","203","4","308","919","0","33.51","10.99"
"64","000","00","260","0009","0000","341","119","222","3","344","1060","0","32.45","11.23"
"64","000","00","260","0009","0277","341","119","222","3","344","1060","0","32.45","11.23"
"64","000","00","260","0010","0000","434","110","324","4","438","1114","0","39.32","9.87"
"64","000","00","260","0010","0279","434","110","324","4","438","1114","0","39.32","9.87"
"64","000","00","260","0011","0000","764","257","507","5","769","2061","0","37.31","12.47"
"64","000","00","260","0011","0269","302","105","197","3","305","823","0","37.06","12.76"
"64","000","00","260","0011","0270","462","152","310","2","464","1238","0","37.48","12.28"
"64","000","00","260","0012","0000","381","100","281","3","384","1067","0","35.99","9.37"
"64","000","00","260","0012","0271","381","100","281","3","384","1067","0","35.99","9.37"
"64","000","00","260","0013","0000","313","106","207","3","316","966","0","32.71","10.97"
"64","000","00","260","0013","0272","313","106","207","3","316","966","0","32.71","10.97"
"64","000","00","260","0014","0000","458","136","322","3","461","1116","0","41.31","12.19"
"64","000","00","260","0014","0273","458","136","322","3","461","1116","0","41.31","12.19"
"64","000","00","260","0015","0000","1658","622","1036","26","1684","4679","0","35.99","13.29"
"64","000","00","260","0015","0280","422","176","246","12","434","1073","0","40.45","16.40"
"64","000","00","260","0015","0281","425","149","276","9","434","1133","0","38.31","13.15"
"64","000","00","260","0015","0282","371","140","231","2","373","1135","0","32.86","12.33"
"64","000","00","260","0015","0283","440","157","283","3","443","1338","0","33.11","11.73"
"64","000","00","270","0000","0000","4599","1637","2962","37","4636","11982","13609","38.69","13.66"
"64","000","00","270","0001","0000","637","252","385","5","642","1558","0","41.21","16.17"
"64","000","00","270","0001","0355","333","129","204","5","338","751","0","45.01","17.18"
"64","000","00","270","0001","0356","304","123","181","0","304","807","0","37.67","15.24"
"64","000","00","270","0002","0000","737","271","466","4","741","1799","0","41.19","15.06"
"64","000","00","270","0002","0357","378","138","240","3","381","849","0","44.88","16.25"
"64","000","00","270","0002","0358","359","133","226","1","360","950","0","37.89","14.00"
"64","000","00","270","0003","0000","883","285","598","9","892","2291","0","38.93","12.44"
"64","000","00","270","0003","0359","319","102","217","3","322","818","0","39.36","12.47"
"64","000","00","270","0003","0360","313","91","222","4","317","832","0","38.10","10.94"
"64","000","00","270","0003","0361","251","92","159","2","253","641","0","39.47","14.35"
"64","000","00","270","0004","0000","139","37","102","3","142","374","0","37.97","9.89"
"64","000","00","270","0004","0362","139","37","102","3","142","374","0","37.97","9.89"
"64","000","00","270","0005","0000","949","377","572","4","953","2564","0","37.17","14.70"
"64","000","00","270","0005","0363","495","201","294","2","497","1343","0","37.01","14.97"
"64","000","00","270","0005","0364","454","176","278","2","456","1221","0","37.35","14.41"
"64","000","00","270","0006","0000","1254","415","839","12","1266","3396","0","37.28","12.22"
"64","000","00","270","0006","0365","442","114","328","6","448","1137","0","39.40","10.03"
"64","000","00","270","0006","0366","403","126","277","2","405","1085","0","37.33","11.61"
"64","000","00","270","0006","0367","409","175","234","4","413","1174","0","35.18","14.91"
"64","000","00","280","0000","0000","6560","2545","4015","84","6644","16271","18759","40.83","15.64"
"64","000","00","280","0001","0000","500","165","335","5","505","1250","0","40.40","13.20"
"64","000","00","280","0001","0441","500","165","335","5","505","1250","0","40.40","13.20"
"64","000","00","280","0002","0000","779","293","486","8","787","1846","0","42.63","15.87"
"64","000","00","280","0002","0442","399","151","248","2","401","893","0","44.90","16.91"
"64","000","00","280","0002","0443","380","142","238","6","386","953","0","40.50","14.90"
"64","000","00","280","0003","0000","210","97","113","5","215","533","0","40.34","18.20"
"64","000","00","280","0003","0444","210","97","113","5","215","533","0","40.34","18.20"
"64","000","00","280","0004","0000","341","152","189","4","345","738","0","46.75","20.60"
"64","000","00","280","0004","0445","341","152","189","4","345","738","0","46.75","20.60"
"64","000","00","280","0005","0000","737","310","427","6","743","1710","0","43.45","18.13"
"64","000","00","280","0005","0446","363","172","191","2","365","815","0","44.79","21.10"
"64","000","00","280","0005","0447","374","138","236","4","378","895","0","42.23","15.42"
"64","000","00","280","0006","0000","621","250","371","8","629","1565","0","40.19","15.97"
"64","000","00","280","0006","0448","300","109","191","3","303","761","0","39.82","14.32"
"64","000","00","280","0006","0449","321","141","180","5","326","804","0","40.55","17.54"
"64","000","00","280","0007","0000","668","226","442","13","681","1681","0","40.51","13.44"
"64","000","00","280","0007","0450","340","119","221","2","342","858","0","39.86","13.87"
"64","000","00","280","0007","0451","328","107","221","11","339","823","0","41.19","13.00"
"64","000","00","280","0008","0000","803","297","506","7","810","2007","0","40.36","14.80"
"64","000","00","280","0008","0453","402","132","270","4","406","1000","0","40.60","13.20"
"64","000","00","280","0008","0454","401","165","236","3","404","1007","0","40.12","16.39"
"64","000","00","280","0009","0000","356","136","220","8","364","918","0","39.65","14.81"
"64","000","00","280","0009","0452","356","136","220","8","364","918","0","39.65","14.81"
"64","000","00","280","0010","0000","295","120","175","2","297","804","0","36.94","14.93"
"64","000","00","280","0010","0455","295","120","175","2","297","804","0","36.94","14.93"
"64","000","00","280","0011","0000","452","203","249","6","458","1134","0","40.39","17.90"
"64","000","00","280","0011","0456","452","203","249","6","458","1134","0","40.39","17.90"
"64","000","00","280","0012","0000","798","296","502","12","810","2085","0","38.85","14.20"
"64","000","00","280","0012","0457","478","188","290","7","485","1228","0","39.50","15.31"
"64","000","00","280","0012","0458","320","108","212","5","325","857","0","37.92","12.60"
"64","000","00","290","0000","0000","12976","3996","8980","114","13090","30908","35292","42.35","12.93"
"64","000","00","290","0001","0000","912","252","660","4","916","2095","0","43.72","12.03"
"64","000","00","290","0001","0459","439","118","321","3","442","1053","0","41.98","11.21"
"64","000","00","290","0001","0460","473","134","339","1","474","1042","0","45.49","12.86"
"64","000","00","290","0002","0000","828","255","573","2","830","2030","0","40.89","12.56"
"64","000","00","290","0002","0461","402","114","288","0","402","942","0","42.68","12.10"
"64","000","00","290","0002","0462","426","141","285","2","428","1088","0","39.34","12.96"
"64","000","00","290","0003","0000","1092","322","770","7","1099","2213","0","49.66","14.55"
"64","000","00","290","0003","0463","386","117","269","4","390","814","0","47.91","14.37"
"64","000","00","290","0003","0464","309","84","225","1","310","632","0","49.05","13.29"
"64","000","00","290","0003","0465","397","121","276","2","399","767","0","52.02","15.78"
"64","000","00","290","0004","0000","658","183","475","12","670","1476","0","45.39","12.40"
"64","000","00","290","0004","0466","658","183","475","12","670","1476","0","45.39","12.40"
"64","000","00","290","0005","0000","560","180","380","3","563","1154","0","48.79","15.60"
"64","000","00","290","0005","0467","560","180","380","3","563","1154","0","48.79","15.60"
"64","000","00","290","0006","0000","762","218","544","12","774","1791","0","43.22","12.17"
"64","000","00","290","0006","0472","467","142","325","6","473","1102","0","42.92","12.89"
"64","000","00","290","0006","0473","295","76","219","6","301","689","0","43.69","11.03"
"64","000","00","290","0007","0000","797","196","601","9","806","2055","0","39.22","9.54"
"64","000","00","290","0007","0477","409","92","317","4","413","1033","0","39.98","8.91"
"64","000","00","290","0007","0478","388","104","284","5","393","1022","0","38.45","10.18"
"64","000","00","290","0008","0000","1122","363","759","8","1130","2858","0","39.54","12.70"
"64","000","00","290","0008","0479","443","106","337","2","445","1216","0","36.60","8.72"
"64","000","00","290","0008","0480","312","96","216","5","317","787","0","40.28","12.20"
"64","000","00","290","0008","0481","367","161","206","1","368","855","0","43.04","18.83"
"64","000","00","290","0009","0000","873","309","564","9","882","2313","0","38.13","13.36"
"64","000","00","290","0009","0482","281","104","177","3","284","814","0","34.89","12.78"
"64","000","00","290","0009","0483","592","205","387","6","598","1499","0","39.89","13.68"
"64","000","00","290","0010","0000","387","117","270","2","389","970","0","40.10","12.06"
"64","000","00","290","0010","0468","387","117","270","2","389","970","0","40.10","12.06"
"64","000","00","290","0011","0000","1527","460","1067","15","1542","3701","0","41.66","12.43"
"64","000","00","290","0011","0469","581","157","424","9","590","1353","0","43.61","11.60"
"64","000","00","290","0011","0470","520","163","357","2","522","1270","0","41.10","12.83"
"64","000","00","290","0011","0471","426","140","286","4","430","1078","0","39.89","12.99"
"64","000","00","290","0012","0000","911","238","673","6","917","2221","0","41.29","10.72"
"64","000","00","290","0012","0474","508","125","383","3","511","1290","0","39.61","9.69"
"64","000","00","290","0012","0475","403","113","290","3","406","931","0","43.61","12.14"
"64","000","00","290","0013","0000","341","122","219","5","346","801","0","43.20","15.23"
"64","000","00","290","0013","0476","341","122","219","5","346","801","0","43.20","15.23"
"64","000","00","290","0014","0000","910","309","601","5","915","2258","0","40.52","13.68"
"64","000","00","290","0014","0484","518","178","340","1","519","1142","0","45.45","15.59"
"64","000","00","290","0014","0485","392","131","261","4","396","1116","0","35.48","11.74"
"64","000","00","290","0015","0000","1296","472","824","15","1311","2972","0","44.11","15.88"
"64","000","00","290","0015","0486","539","162","377","5","544","1230","0","44.23","13.17"
"64","000","00","290","0015","0487","314","78","236","3","317","764","0","41.49","10.21"
"64","000","00","290","0015","0488","443","232","211","7","450","978","0","46.01","23.72"
"64","000","00","300","0000","0000","11731","4320","7411","144","11875","31152","35449","38.12","13.87"
"64","000","00","300","0001","0000","832","340","492","9","841","2165","0","38.85","15.70"
"64","000","00","300","0001","0064","457","182","275","2","459","1066","0","43.06","17.07"
"64","000","00","300","0001","0065","375","158","217","7","382","1099","0","34.76","14.38"
"64","000","00","300","0002","0000","917","409","508","14","931","2273","0","40.96","17.99"
"64","000","00","300","0002","0066","412","190","222","3","415","1071","0","38.75","17.74"
"64","000","00","300","0002","0067","505","219","286","11","516","1202","0","42.93","18.22"
"64","000","00","300","0003","0000","581","219","362","4","585","1578","0","37.07","13.88"
"64","000","00","300","0003","0068","306","124","182","2","308","874","0","35.24","14.19"
"64","000","00","300","0003","0069","275","95","180","2","277","704","0","39.35","13.49"
"64","000","00","300","0004","0000","586","217","369","9","595","1802","0","33.02","12.04"
"64","000","00","300","0004","0070","359","127","232","7","366","1071","0","34.17","11.86"
"64","000","00","300","0004","0071","227","90","137","2","229","731","0","31.33","12.31"
"64","000","00","300","0005","0000","455","216","239","5","460","1418","0","32.44","15.23"
"64","000","00","300","0005","0072","338","133","205","4","342","1075","0","31.81","12.37"
"64","000","00","300","0005","0073","117","83","34","1","118","343","0","34.40","24.20"
"64","000","00","300","0006","0000","415","176","239","6","421","1338","0","31.46","13.15"
"64","000","00","300","0006","0074","255","86","169","5","260","840","0","30.95","10.24"
"64","000","00","300","0006","0075","160","90","70","1","161","498","0","32.33","18.07"
"64","000","00","300","0007","0000","385","88","297","2","387","1008","0","38.39","8.73"
"64","000","00","300","0007","0076","385","88","297","2","387","1008","0","38.39","8.73"
"64","000","00","300","0008","0000","319","119","200","7","326","759","0","42.95","15.68"
"64","000","00","300","0008","0077","319","119","200","7","326","759","0","42.95","15.68"
"64","000","00","300","0009","0000","839","234","605","15","854","2092","0","40.82","11.19"
"64","000","00","300","0009","0078","396","110","286","7","403","917","0","43.95","12.00"
"64","000","00","300","0009","0079","443","124","319","8","451","1175","0","38.38","10.55"
"64","000","00","300","0010","0000","67","22","45","1","68","179","0","37.99","12.29"
"64","000","00","300","0010","0080","67","22","45","1","68","179","0","37.99","12.29"
"64","000","00","300","0011","0000","806","306","500","11","817","1924","0","42.46","15.90"
"64","000","00","300","0011","0082","400","171","229","4","404","926","0","43.63","18.47"
"64","000","00","300","0011","0083","406","135","271","7","413","998","0","41.38","13.53"
"64","000","00","300","0012","0000","390","172","218","2","392","983","0","39.88","17.50"
"64","000","00","300","0012","0081","390","172","218","2","392","983","0","39.88","17.50"
"64","000","00","300","0013","0000","567","247","320","10","577","1544","0","37.37","16.00"
"64","000","00","300","0013","0084","334","140","194","6","340","876","0","38.81","15.98"
"64","000","00","300","0013","0085","233","107","126","4","237","668","0","35.48","16.02"
"64","000","00","300","0014","0000","755","283","472","6","761","1999","0","38.07","14.16"
"64","000","00","300","0014","0086","365","120","245","1","366","943","0","38.81","12.73"
"64","000","00","300","0014","0087","390","163","227","5","395","1056","0","37.41","15.44"
"64","000","00","300","0015","0000","1108","397","711","12","1120","3245","0","34.51","12.23"
"64","000","00","300","0015","0088","420","143","277","5","425","1085","0","39.17","13.18"
"64","000","00","300","0015","0089","310","130","180","5","315","1056","0","29.83","12.31"
"64","000","00","300","0015","0090","378","124","254","2","380","1104","0","34.42","11.23"
"64","000","00","300","0016","0000","833","311","522","6","839","2216","0","37.86","14.03"
"64","000","00","300","0016","0091","346","149","197","3","349","949","0","36.78","15.70"
"64","000","00","300","0016","0092","240","99","141","1","241","608","0","39.64","16.28"
"64","000","00","300","0016","0093","247","63","184","2","249","659","0","37.78","9.56"
"64","000","00","300","0017","0000","326","61","265","2","328","705","0","46.52","8.65"
"64","000","00","300","0017","0094","326","61","265","2","328","705","0","46.52","8.65"
"64","000","00","300","0018","0000","482","140","342","5","487","1254","0","38.84","11.16"
"64","000","00","300","0018","0095","482","140","342","5","487","1254","0","38.84","11.16"
"64","000","00","300","0019","0000","324","81","243","6","330","797","0","41.41","10.16"
"64","000","00","300","0019","0096","324","81","243","6","330","797","0","41.41","10.16"
"64","000","00","300","0020","0000","523","166","357","7","530","1262","0","42.00","13.15"
"64","000","00","300","0020","0097","523","166","357","7","530","1262","0","42.00","13.15"
"64","000","00","300","0021","0000","221","116","105","5","226","611","0","36.99","18.99"
"64","000","00","300","0021","0098","221","116","105","5","226","611","0","36.99","18.99"
"64","000","00","310","0000","0000","12614","6006","6608","150","12764","34303","38209","37.21","17.51"
"64","000","00","310","0001","0000","984","451","533","10","994","2547","0","39.03","17.71"
"64","000","00","310","0001","0099","465","221","244","4","469","1141","0","41.10","19.37"
"64","000","00","310","0001","0100","231","110","121","4","235","689","0","34.11","15.97"
"64","000","00","310","0001","0101","288","120","168","2","290","717","0","40.45","16.74"
"64","000","00","310","0002","0000","832","445","387","10","842","2321","0","36.28","19.17"
"64","000","00","310","0002","0102","358","183","175","3","361","958","0","37.68","19.10"
"64","000","00","310","0002","0103","240","125","115","1","241","655","0","36.79","19.08"
"64","000","00","310","0002","0104","234","137","97","6","240","708","0","33.90","19.35"
"64","000","00","310","0003","0000","972","499","473","10","982","2552","0","38.48","19.55"
"64","000","00","310","0003","0105","482","238","244","5","487","1295","0","37.61","18.38"
"64","000","00","310","0003","0106","490","261","229","5","495","1257","0","39.38","20.76"
"64","000","00","310","0004","0000","699","373","326","7","706","1978","0","35.69","18.86"
"64","000","00","310","0004","0107","346","191","155","1","347","968","0","35.85","19.73"
"64","000","00","310","0004","0108","353","182","171","6","359","1010","0","35.54","18.02"
"64","000","00","310","0005","0000","537","311","226","9","546","1462","0","37.35","21.27"
"64","000","00","310","0005","0109","537","311","226","9","546","1462","0","37.35","21.27"
"64","000","00","310","0006","0000","685","334","351","14","699","2113","0","33.08","15.81"
"64","000","00","310","0006","0110","355","171","184","9","364","1105","0","32.94","15.48"
"64","000","00","310","0006","0111","330","163","167","5","335","1008","0","33.23","16.17"
"64","000","00","310","0007","0000","954","402","552","15","969","2433","0","39.83","16.52"
"64","000","00","310","0007","0112","539","207","332","10","549","1428","0","38.45","14.50"
"64","000","00","310","0007","0113","415","195","220","5","420","1005","0","41.79","19.40"
"64","000","00","310","0008","0000","534","244","290","3","537","1382","0","38.86","17.66"
"64","000","00","310","0008","0114","275","133","142","2","277","646","0","42.88","20.59"
"64","000","00","310","0008","0115","259","111","148","1","260","736","0","35.33","15.08"
"64","000","00","310","0009","0000","469","203","266","4","473","1299","0","36.41","15.63"
"64","000","00","310","0009","0116","469","203","266","4","473","1299","0","36.41","15.63"
"64","000","00","310","0010","0000","428","180","248","4","432","1158","0","37.31","15.54"
"64","000","00","310","0010","0117","428","180","248","4","432","1158","0","37.31","15.54"
"64","000","00","310","0011","0000","756","385","371","8","764","2066","0","36.98","18.64"
"64","000","00","310","0011","0118","343","149","194","4","347","880","0","39.43","16.93"
"64","000","00","310","0011","0119","413","236","177","4","417","1186","0","35.16","19.90"
"64","000","00","310","0012","0000","424","181","243","7","431","1184","0","36.40","15.29"
"64","000","00","310","0012","0120","424","181","243","7","431","1184","0","36.40","15.29"
"64","000","00","310","0013","0000","610","310","300","5","615","1527","0","40.28","20.30"
"64","000","00","310","0013","0121","276","125","151","3","279","718","0","38.86","17.41"
"64","000","00","310","0013","0122","334","185","149","2","336","809","0","41.53","22.87"
"64","000","00","310","0014","0000","792","358","434","4","796","2186","0","36.41","16.38"
"64","000","00","310","0014","0123","368","160","208","0","368","1066","0","34.52","15.01"
"64","000","00","310","0014","0124","424","198","226","4","428","1120","0","38.21","17.68"
"64","000","00","310","0015","0000","661","324","337","4","665","1720","0","38.66","18.84"
"64","000","00","310","0015","0125","334","165","169","4","338","944","0","35.81","17.48"
"64","000","00","310","0015","0126","327","159","168","0","327","776","0","42.14","20.49"
"64","000","00","310","0016","0000","682","302","380","9","691","1826","0","37.84","16.54"
"64","000","00","310","0016","0127","319","145","174","7","326","918","0","35.51","15.80"
"64","000","00","310","0016","0128","363","157","206","2","365","908","0","40.20","17.29"
"64","000","00","310","0017","0000","493","258","235","9","502","1334","0","37.63","19.34"
"64","000","00","310","0017","0129","493","258","235","9","502","1334","0","37.63","19.34"
"64","000","00","310","0018","0000","590","212","378","8","598","1779","0","33.61","11.92"
"64","000","00","310","0018","0130","311","123","188","1","312","903","0","34.55","13.62"
"64","000","00","310","0018","0131","279","89","190","7","286","876","0","32.65","10.16"
"64","000","00","310","0019","0000","512","234","278","10","522","1436","0","36.35","16.30"
"64","000","00","310","0019","0132","298","142","156","7","305","782","0","39.00","18.16"
"64","000","00","310","0019","0133","214","92","122","3","217","654","0","33.18","14.07"
"64","000","00","320","0000","0000","3219","1244","1975","53","3272","10933","12236","29.93","11.38"
"64","000","00","320","0001","0000","227","75","152","5","232","714","0","32.49","10.50"
"64","000","00","320","0001","0021","227","75","152","5","232","714","0","32.49","10.50"
"64","000","00","320","0002","0000","193","63","130","2","195","649","0","30.05","9.71"
"64","000","00","320","0002","0022","193","63","130","2","195","649","0","30.05","9.71"
"64","000","00","320","0003","0000","238","85","153","4","242","626","0","38.66","13.58"
"64","000","00","320","0003","0023","238","85","153","4","242","626","0","38.66","13.58"
"64","000","00","320","0004","0000","224","82","142","2","226","926","0","24.41","8.86"
"64","000","00","320","0004","0024","224","82","142","2","226","926","0","24.41","8.86"
"64","000","00","320","0005","0000","332","120","212","2","334","1359","0","24.58","8.83"
"64","000","00","320","0005","0025","332","120","212","2","334","1359","0","24.58","8.83"
"64","000","00","320","0006","0000","235","81","154","7","242","942","0","25.69","8.60"
"64","000","00","320","0006","0026","235","81","154","7","242","942","0","25.69","8.60"
"64","000","00","320","0007","0000","353","155","198","2","355","1029","0","34.50","15.06"
"64","000","00","320","0007","0027","353","155","198","2","355","1029","0","34.50","15.06"
"64","000","00","320","0008","0000","221","63","158","6","227","785","0","28.92","8.03"
"64","000","00","320","0008","0028","221","63","158","6","227","785","0","28.92","8.03"
"64","000","00","320","0009","0000","460","244","216","10","470","1363","0","34.48","17.90"
"64","000","00","320","0009","0029","460","244","216","10","470","1363","0","34.48","17.90"
"64","000","00","320","0010","0000","240","89","151","7","247","858","0","28.79","10.37"
"64","000","00","320","0010","0030","240","89","151","7","247","858","0","28.79","10.37"
"64","000","00","320","0011","0000","374","146","228","2","376","1379","0","27.27","10.59"
"64","000","00","320","0011","0031","374","146","228","2","376","1379","0","27.27","10.59"
"64","000","00","320","0012","0000","122","41","81","4","126","303","0","41.58","13.53"
"64","000","00","320","0012","0032","122","41","81","4","126","303","0","41.58","13.53"
"64","000","00","330","0000","0000","1683","835","848","27","1710","5257","5798","32.53","15.88"
"64","000","00","330","0001","0000","109","55","54","3","112","445","0","25.17","12.36"
"64","000","00","330","0001","0013","109","55","54","3","112","445","0","25.17","12.36"
"64","000","00","330","0002","0000","354","228","126","2","356","835","0","42.63","27.31"
"64","000","00","330","0002","0014","354","228","126","2","356","835","0","42.63","27.31"
"64","000","00","330","0003","0000","232","134","98","2","234","668","0","35.03","20.06"
"64","000","00","330","0003","0015","232","134","98","2","234","668","0","35.03","20.06"
"64","000","00","330","0004","0000","437","206","231","11","448","1557","0","28.77","13.23"
"64","000","00","330","0004","0016","169","61","108","4","173","657","0","26.33","9.28"
"64","000","00","330","0004","0017","268","145","123","7","275","900","0","30.56","16.11"
"64","000","00","330","0005","0000","221","73","148","3","224","651","0","34.41","11.21"
"64","000","00","330","0005","0018","221","73","148","3","224","651","0","34.41","11.21"
"64","000","00","330","0006","0000","200","80","120","4","204","587","0","34.75","13.63"
"64","000","00","330","0006","0019","200","80","120","4","204","587","0","34.75","13.63"
"64","000","00","330","0007","0000","130","59","71","2","132","514","0","25.68","11.48"
"64","000","00","330","0007","0020","130","59","71","2","132","514","0","25.68","11.48"
"64","000","00","340","0000","0000","3042","1280","1762","48","3090","10258","11365","30.12","12.48"
"64","000","00","340","0001","0000","166","53","113","3","169","597","0","28.31","8.88"
"64","000","00","340","0001","0033","166","53","113","3","169","597","0","28.31","8.88"
"64","000","00","340","0002","0000","156","49","107","2","158","655","0","24.12","7.48"
"64","000","00","340","0002","0034","156","49","107","2","158","655","0","24.12","7.48"
"64","000","00","340","0003","0000","326","103","223","3","329","1230","0","26.75","8.37"
"64","000","00","340","0003","0035","326","103","223","3","329","1230","0","26.75","8.37"
"64","000","00","340","0004","0000","477","227","250","12","489","1464","0","33.40","15.51"
"64","000","00","340","0004","0036","298","175","123","4","302","984","0","30.69","17.78"
"64","000","00","340","0004","0037","179","52","127","8","187","480","0","38.96","10.83"
"64","000","00","340","0005","0000","468","220","248","4","472","1537","0","30.71","14.31"
"64","000","00","340","0005","0038","315","164","151","2","317","975","0","32.51","16.82"
"64","000","00","340","0005","0039","153","56","97","2","155","562","0","27.58","9.96"
"64","000","00","340","0006","0000","549","275","274","9","558","1603","0","34.81","17.16"
"64","000","00","340","0006","0040","366","213","153","7","373","996","0","37.45","21.39"
"64","000","00","340","0006","0041","183","62","121","2","185","607","0","30.48","10.21"
"64","000","00","340","0007","0000","381","148","233","11","392","1207","0","32.48","12.26"
"64","000","00","340","0007","0044","381","148","233","11","392","1207","0","32.48","12.26"
"64","000","00","340","0008","0000","519","205","314","4","523","1965","0","26.62","10.43"
"64","000","00","340","0008","0042","309","94","215","2","311","979","0","31.77","9.60"
"64","000","00","340","0008","0043","210","111","99","2","212","986","0","21.50","11.26"
"64","000","00","350","0000","0000","3934","1509","2425","69","4003","12595","13870","31.78","11.98"
"64","000","00","350","0001","0000","242","91","151","7","249","931","0","26.75","9.77"
"64","000","00","350","0001","0045","242","91","151","7","249","931","0","26.75","9.77"
"64","000","00","350","0002","0000","203","63","140","6","209","627","0","33.33","10.05"
"64","000","00","350","0002","0046","203","63","140","6","209","627","0","33.33","10.05"
"64","000","00","350","0003","0000","285","115","170","7","292","955","0","30.58","12.04"
"64","000","00","350","0003","0047","285","115","170","7","292","955","0","30.58","12.04"
"64","000","00","350","0004","0000","118","56","62","2","120","413","0","29.06","13.56"
"64","000","00","350","0004","0048","118","56","62","2","120","413","0","29.06","13.56"
"64","000","00","350","0005","0000","119","45","74","2","121","384","0","31.51","11.72"
"64","000","00","350","0005","0049","119","45","74","2","121","384","0","31.51","11.72"
"64","000","00","350","0006","0000","118","43","75","0","118","493","0","23.94","8.72"
"64","000","00","350","0006","0050","118","43","75","0","118","493","0","23.94","8.72"
"64","000","00","350","0007","0000","363","151","212","5","368","963","0","38.21","15.68"
"64","000","00","350","0007","0051","363","151","212","5","368","963","0","38.21","15.68"
"64","000","00","350","0008","0000","366","137","229","3","369","1176","0","31.38","11.65"
"64","000","00","350","0008","0052","366","137","229","3","369","1176","0","31.38","11.65"
"64","000","00","350","0009","0000","560","243","317","7","567","1682","0","33.71","14.45"
"64","000","00","350","0009","0053","268","107","161","2","270","822","0","32.85","13.02"
"64","000","00","350","0009","0054","292","136","156","5","297","860","0","34.53","15.81"
"64","000","00","350","0010","0000","175","97","78","2","177","537","0","32.96","18.06"
"64","000","00","350","0010","0055","175","97","78","2","177","537","0","32.96","18.06"
"64","000","00","350","0011","0000","279","98","181","6","285","765","0","37.25","12.81"
"64","000","00","350","0011","0056","279","98","181","6","285","765","0","37.25","12.81"
"64","000","00","350","0012","0000","100","46","54","3","103","403","0","25.56","11.41"
"64","000","00","350","0012","0057","100","46","54","3","103","403","0","25.56","11.41"
"64","000","00","350","0013","0000","151","51","100","1","152","474","0","32.07","10.76"
"64","000","00","350","0013","0058","151","51","100","1","152","474","0","32.07","10.76"
"64","000","00","350","0014","0000","196","64","132","5","201","638","0","31.50","10.03"
"64","000","00","350","0014","0059","196","64","132","5","201","638","0","31.50","10.03"
"64","000","00","350","0015","0000","185","48","137","3","188","589","0","31.92","8.15"
"64","000","00","350","0015","0060","185","48","137","3","188","589","0","31.92","8.15"
"64","000","00","350","0016","0000","164","23","141","4","168","602","0","27.91","3.82"
"64","000","00","350","0016","0061","164","23","141","4","168","602","0","27.91","3.82"
"64","000","00","350","0017","0000","117","58","59","5","122","318","0","38.36","18.24"
"64","000","00","350","0017","0062","117","58","59","5","122","318","0","38.36","18.24"
"64","000","00","350","0018","0000","193","80","113","1","194","645","0","30.08","12.40"
"64","000","00","350","0018","0063","193","80","113","1","194","645","0","30.08","12.40"
"64","000","00","360","0000","0000","503","379","124","10","513","1559","1879","32.91","24.31"
"64","000","00","360","0001","0000","226","173","53","1","227","712","0","31.88","24.30"
"64","000","00","360","0001","0136","226","173","53","1","227","712","0","31.88","24.30"
"64","000","00","360","0002","0000","132","93","39","4","136","356","0","38.20","26.12"
"64","000","00","360","0002","0135","132","93","39","4","136","356","0","38.20","26.12"
"64","000","00","360","0003","0000","145","113","32","5","150","491","0","30.55","23.01"
"64","000","00","360","0003","0134","145","113","32","5","150","491","0","30.55","23.01"
"64","000","00","370","0000","0000","723","532","191","13","736","3415","4205","21.55","15.58"
"64","000","00","370","0001","0000","143","116","27","3","146","766","0","19.06","15.14"
"64","000","00","370","0001","0005","143","116","27","3","146","766","0","19.06","15.14"
"64","000","00","370","0002","0000","102","79","23","3","105","458","0","22.93","17.25"
"64","000","00","370","0002","0008","102","79","23","3","105","458","0","22.93","17.25"
"64","000","00","370","0003","0000","99","71","28","1","100","587","0","17.04","12.10"
"64","000","00","370","0003","0007","99","71","28","1","100","587","0","17.04","12.10"
"64","000","00","370","0004","0000","133","102","31","0","133","620","0","21.45","16.45"
"64","000","00","370","0004","0006","133","102","31","0","133","620","0","21.45","16.45"
"64","000","00","370","0005","0000","45","26","19","1","46","212","0","21.70","12.26"
"64","000","00","370","0005","0004","45","26","19","1","46","212","0","21.70","12.26"
"64","000","00","370","0006","0000","61","54","7","1","62","287","0","21.60","18.82"
"64","000","00","370","0006","0003","61","54","7","1","62","287","0","21.60","18.82"
"64","000","00","370","0007","0000","69","35","34","3","72","230","0","31.30","15.22"
"64","000","00","370","0007","0002","69","35","34","3","72","230","0","31.30","15.22"
"64","000","00","370","0008","0000","71","49","22","1","72","255","0","28.24","19.22"
"64","000","00","370","0008","0001","71","49","22","1","72","255","0","28.24","19.22"
"64","000","00","380","0000","0000","688","503","185","6","694","2427","3141","28.59","20.73"
"64","000","00","380","0001","0000","334","265","69","5","339","1343","0","25.24","19.73"
"64","000","00","380","0001","0009","177","148","29","2","179","747","0","23.96","19.81"
"64","000","00","380","0001","0010","157","117","40","3","160","596","0","26.85","19.63"
"64","000","00","380","0002","0000","202","172","30","0","202","602","0","33.55","28.57"
"64","000","00","380","0002","0011","202","172","30","0","202","602","0","33.55","28.57"
"64","000","00","380","0003","0000","152","66","86","1","153","482","0","31.74","13.69"
"64","000","00","380","0003","0012","152","66","86","1","153","482","0","31.74","13.69"
"10","004","00","000","0000","0000","178110","108925","69185","1797","179907","461638","573385","38.97","23.60"
"10","004","00","010","0000","0000","62553","34348","28205","545","63098","150431","203904","41.94","22.83"
"10","004","00","010","0001","0000","2994","1658","1336","19","3013","6791","0","44.37","24.41"
"10","004","00","010","0001","0053","595","322","273","2","597","1344","0","44.42","23.96"
"10","004","00","010","0001","0054","552","305","247","2","554","1272","0","43.55","23.98"
"10","004","00","010","0001","0055","607","355","252","4","611","1269","0","48.15","27.97"
"10","004","00","010","0001","0056","582","332","250","5","587","1290","0","45.50","25.74"
"10","004","00","010","0001","0057","658","344","314","6","664","1616","0","41.09","21.29"
"10","004","00","010","0002","0000","4845","2667","2178","39","4884","10611","0","46.03","25.13"
"10","004","00","010","0002","0001","587","319","268","7","594","1244","0","47.75","25.64"
"10","004","00","010","0002","0002","564","315","249","5","569","1275","0","44.63","24.71"
"10","004","00","010","0002","0003","563","344","219","5","568","1289","0","44.07","26.69"
"10","004","00","010","0002","0004","630","344","286","0","630","1292","0","48.76","26.63"
"10","004","00","010","0002","0005","566","324","242","3","569","1324","0","42.98","24.47"
"10","004","00","010","0002","0006","619","349","270","5","624","1357","0","45.98","25.72"
"10","004","00","010","0002","0007","721","356","365","8","729","1480","0","49.26","24.05"
"10","004","00","010","0002","0008","595","316","279","6","601","1350","0","44.52","23.41"
"10","004","00","010","0003","0000","5431","2676","2755","47","5478","11738","0","46.67","22.80"
"10","004","00","010","0003","0009","513","255","258","6","519","1107","0","46.88","23.04"
"10","004","00","010","0003","0010","564","292","272","6","570","1201","0","47.46","24.31"
"10","004","00","010","0003","0011","542","268","274","3","545","1187","0","45.91","22.58"
"10","004","00","010","0003","0012","498","242","256","3","501","1133","0","44.22","21.36"
"10","004","00","010","0003","0013","534","277","257","8","542","1215","0","44.61","22.80"
"10","004","00","010","0003","0014","623","312","311","4","627","1324","0","47.36","23.56"
"10","004","00","010","0003","0015","577","274","303","5","582","1205","0","48.30","22.74"
"10","004","00","010","0003","0016","587","283","304","3","590","1193","0","49.46","23.72"
"10","004","00","010","0003","0017","481","234","247","5","486","1023","0","47.51","22.87"
"10","004","00","010","0003","0018","512","239","273","4","516","1150","0","44.87","20.78"
"10","004","00","010","0004","0000","3799","2001","1798","28","3827","8015","0","47.75","24.97"
"10","004","00","010","0004","0019","666","331","335","7","673","1490","0","45.17","22.21"
"10","004","00","010","0004","0020","614","323","291","3","617","1251","0","49.32","25.82"
"10","004","00","010","0004","0021","698","365","333","6","704","1430","0","49.23","25.52"
"10","004","00","010","0004","0022","682","351","331","3","685","1373","0","49.89","25.56"
"10","004","00","010","0004","0023","639","317","322","8","647","1249","0","51.80","25.38"
"10","004","00","010","0004","0024","500","314","186","1","501","1222","0","41.00","25.70"
"10","004","00","010","0005","0000","1311","725","586","10","1321","2974","0","44.42","24.38"
"10","004","00","010","0005","0025","483","283","200","1","484","1086","0","44.57","26.06"
"10","004","00","010","0005","0026","456","246","210","6","462","1022","0","45.21","24.07"
"10","004","00","010","0005","0027","372","196","176","3","375","866","0","43.30","22.63"
"10","004","00","010","0006","0000","1100","735","365","12","1112","2997","0","37.10","24.52"
"10","004","00","010","0006","0028","362","237","125","6","368","1019","0","36.11","23.26"
"10","004","00","010","0006","0029","399","267","132","2","401","1061","0","37.79","25.16"
"10","004","00","010","0006","0030","339","231","108","4","343","917","0","37.40","25.19"
"10","004","00","010","0007","0000","2899","1725","1174","16","2915","7661","0","38.05","22.52"
"10","004","00","010","0007","0071","528","287","241","2","530","1255","0","42.23","22.87"
"10","004","00","010","0007","0072","441","284","157","5","446","1309","0","34.07","21.70"
"10","004","00","010","0007","0073","548","316","232","2","550","1605","0","34.27","19.69"
"10","004","00","010","0007","0074","420","258","162","1","421","1190","0","35.38","21.68"
"10","004","00","010","0007","0075","496","294","202","3","499","1112","0","44.87","26.44"
"10","004","00","010","0007","0076","466","286","180","3","469","1190","0","39.41","24.03"
"10","004","00","010","0008","0000","3522","2185","1337","34","3556","8745","0","40.66","24.99"
"10","004","00","010","0008","0077","388","254","134","8","396","1040","0","38.08","24.42"
"10","004","00","010","0008","0078","403","252","151","4","407","1068","0","38.11","23.60"
"10","004","00","010","0008","0079","428","271","157","2","430","1151","0","37.36","23.54"
"10","004","00","010","0008","0080","453","283","170","3","456","1101","0","41.42","25.70"
"10","004","00","010","0008","0081","484","251","233","4","488","1090","0","44.77","23.03"
"10","004","00","010","0008","0082","537","349","188","5","542","1185","0","45.74","29.45"
"10","004","00","010","0008","0083","415","252","163","4","419","1064","0","39.38","23.68"
"10","004","00","010","0008","0084","414","273","141","4","418","1046","0","39.96","26.10"
"10","004","00","010","0009","0000","2078","1226","852","16","2094","5860","0","35.73","20.92"
"10","004","00","010","0009","0088","529","310","219","4","533","1331","0","40.05","23.29"
"10","004","00","010","0009","0089","379","214","165","4","383","1088","0","35.20","19.67"
"10","004","00","010","0009","0090","478","306","172","1","479","1163","0","41.19","26.31"
"10","004","00","010","0009","0091","428","248","180","5","433","1129","0","38.35","21.97"
"10","004","00","010","0009","0092","264","148","116","2","266","1149","0","23.15","12.88"
"10","004","00","010","0010","0000","2236","1367","869","17","2253","5932","0","37.98","23.04"
"10","004","00","010","0010","0093","510","299","211","4","514","1336","0","38.47","22.38"
"10","004","00","010","0010","0094","507","309","198","5","512","1260","0","40.63","24.52"
"10","004","00","010","0010","0095","389","245","144","3","392","1078","0","36.36","22.73"
"10","004","00","010","0010","0096","433","278","155","2","435","1222","0","35.60","22.75"
"10","004","00","010","0010","0097","397","236","161","3","400","1036","0","38.61","22.78"
"10","004","00","010","0011","0000","2689","1595","1094","25","2714","7074","0","38.37","22.55"
"10","004","00","010","0011","0098","481","301","180","6","487","1191","0","40.89","25.27"
"10","004","00","010","0011","0099","479","291","188","4","483","1166","0","41.42","24.96"
"10","004","00","010","0011","0100","430","254","176","6","436","1151","0","37.88","22.07"
"10","004","00","010","0011","0101","387","220","167","0","387","1022","0","37.87","21.53"
"10","004","00","010","0011","0102","414","263","151","7","421","1171","0","35.95","22.46"
"10","004","00","010","0011","0103","498","266","232","2","500","1373","0","36.42","19.37"
"10","004","00","010","0012","0000","1766","1034","732","27","1793","4441","0","40.37","23.28"
"10","004","00","010","0012","0109","392","232","160","11","403","1092","0","36.90","21.25"
"10","004","00","010","0012","0110","348","202","146","6","354","862","0","41.07","23.43"
"10","004","00","010","0012","0111","524","293","231","5","529","1259","0","42.02","23.27"
"10","004","00","010","0012","0112","502","307","195","5","507","1228","0","41.29","25.00"
"10","004","00","010","0013","0000","753","389","364","4","757","1986","0","38.12","19.59"
"10","004","00","010","0013","0113","342","173","169","1","343","859","0","39.93","20.14"
"10","004","00","010","0013","0114","411","216","195","3","414","1127","0","36.73","19.17"
"10","004","00","010","0014","0000","1031","519","512","15","1046","2468","0","42.38","21.03"
"10","004","00","010","0014","0115","476","250","226","1","477","1097","0","43.48","22.79"
"10","004","00","010","0014","0116","555","269","286","14","569","1371","0","41.50","19.62"
"10","004","00","010","0015","0000","800","408","392","13","813","2202","0","36.92","18.53"
"10","004","00","010","0015","0118","341","181","160","10","351","984","0","35.67","18.39"
"10","004","00","010","0015","0119","459","227","232","3","462","1218","0","37.93","18.64"
"10","004","00","010","0016","0000","496","181","315","7","503","1218","0","41.30","14.86"
"10","004","00","010","0016","0120","496","181","315","7","503","1218","0","41.30","14.86"
"10","004","00","010","0017","0000","638","245","393","6","644","1607","0","40.07","15.25"
"10","004","00","010","0017","0123","383","151","232","2","385","940","0","40.96","16.06"
"10","004","00","010","0017","0124","255","94","161","4","259","667","0","38.83","14.09"
"10","004","00","010","0018","0000","751","280","471","5","756","1914","0","39.50","14.63"
"10","004","00","010","0018","0127","391","147","244","4","395","966","0","40.89","15.22"
"10","004","00","010","0018","0128","360","133","227","1","361","948","0","38.08","14.03"
"10","004","00","010","0019","0000","692","375","317","8","700","1741","0","40.21","21.54"
"10","004","00","010","0019","0121","369","191","178","4","373","935","0","39.89","20.43"
"10","004","00","010","0019","0122","323","184","139","4","327","806","0","40.57","22.83"
"10","004","00","010","0020","0000","620","226","394","9","629","1683","0","37.37","13.43"
"10","004","00","010","0020","0125","325","108","217","3","328","832","0","39.42","12.98"
"10","004","00","010","0020","0126","295","118","177","6","301","851","0","35.37","13.87"
"10","004","00","010","0021","0000","3046","1597","1449","26","3072","6632","0","46.32","24.08"
"10","004","00","010","0021","0041","576","285","291","4","580","1203","0","48.21","23.69"
"10","004","00","010","0021","0042","541","291","250","5","546","1095","0","49.86","26.58"
"10","004","00","010","0021","0043","509","272","237","6","515","1102","0","46.73","24.68"
"10","004","00","010","0021","0044","596","300","296","5","601","1257","0","47.81","23.87"
"10","004","00","010","0021","0045","433","227","206","4","437","1009","0","43.31","22.50"
"10","004","00","010","0021","0046","391","222","169","2","393","966","0","40.68","22.98"
"10","004","00","010","0022","0000","2318","1257","1061","15","2333","6000","0","38.88","20.95"
"10","004","00","010","0022","0104","456","269","187","3","459","1110","0","41.35","24.23"
"10","004","00","010","0022","0105","448","234","214","0","448","1209","0","37.06","19.35"
"10","004","00","010","0022","0106","415","215","200","6","421","1165","0","36.14","18.45"
"10","004","00","010","0022","0107","483","238","245","3","486","1295","0","37.53","18.38"
"10","004","00","010","0022","0108","516","301","215","3","519","1221","0","42.51","24.65"
"10","004","00","010","0023","0000","394","230","164","10","404","1064","0","37.97","21.62"
"10","004","00","010","0023","0117","394","230","164","10","404","1064","0","37.97","21.62"
"10","004","00","010","0024","0000","1650","1017","633","15","1665","3833","0","43.44","26.53"
"10","004","00","010","0024","0063","521","315","206","7","528","1196","0","44.15","26.34"
"10","004","00","010","0024","0064","605","365","240","3","608","1366","0","44.51","26.72"
"10","004","00","010","0024","0065","524","337","187","5","529","1271","0","41.62","26.51"
"10","004","00","010","0025","0000","2519","1397","1122","28","2547","6255","0","40.72","22.33"
"10","004","00","010","0025","0066","454","276","178","5","459","1187","0","38.67","23.25"
"10","004","00","010","0025","0067","558","305","253","5","563","1312","0","42.91","23.25"
"10","004","00","010","0025","0068","498","277","221","8","506","1191","0","42.49","23.26"
"10","004","00","010","0025","0069","549","301","248","6","555","1239","0","44.79","24.29"
"10","004","00","010","0025","0070","460","238","222","4","464","1326","0","34.99","17.95"
"10","004","00","010","0026","0000","1348","817","531","10","1358","3262","0","41.63","25.05"
"10","004","00","010","0026","0085","431","276","155","2","433","1027","0","42.16","26.87"
"10","004","00","010","0026","0086","505","297","208","4","509","1130","0","45.04","26.28"
"10","004","00","010","0026","0087","412","244","168","4","416","1105","0","37.65","22.08"
"10","004","00","010","0027","0000","2845","1413","1432","28","2873","7126","0","40.32","19.83"
"10","004","00","010","0027","0031","467","231","236","4","471","1182","0","39.85","19.54"
"10","004","00","010","0027","0032","489","286","203","5","494","1198","0","41.24","23.87"
"10","004","00","010","0027","0033","512","210","302","0","512","1202","0","42.60","17.47"
"10","004","00","010","0027","0034","489","219","270","3","492","1285","0","38.29","17.04"
"10","004","00","010","0027","0035","477","230","247","12","489","1123","0","43.54","20.48"
"10","004","00","010","0027","0036","411","237","174","4","415","1136","0","36.53","20.86"
"10","004","00","010","0028","0000","2184","1094","1090","16","2200","5571","0","39.49","19.64"
"10","004","00","010","0028","0037","580","303","277","4","584","1430","0","40.84","21.19"
"10","004","00","010","0028","0038","515","255","260","3","518","1361","0","38.06","18.74"
"10","004","00","010","0028","0039","537","263","274","3","540","1427","0","37.84","18.43"
"10","004","00","010","0028","0040","552","273","279","6","558","1353","0","41.24","20.18"
"10","004","00","010","0029","0000","1473","896","577","13","1486","3538","0","42.00","25.33"
"10","004","00","010","0029","0047","488","299","189","4","492","1202","0","40.93","24.88"
"10","004","00","010","0029","0048","494","305","189","4","498","1125","0","44.27","27.11"
"10","004","00","010","0029","0049","491","292","199","5","496","1211","0","40.96","24.11"
"10","004","00","010","0030","0000","1498","775","723","16","1514","3337","0","45.37","23.22"
"10","004","00","010","0030","0050","518","309","209","8","526","1136","0","46.30","27.20"
"10","004","00","010","0030","0051","471","294","177","6","477","1041","0","45.82","28.24"
"10","004","00","010","0030","0052","509","172","337","2","511","1160","0","44.05","14.83"
"10","004","00","010","0031","0000","2827","1638","1189","11","2838","6155","0","46.11","26.61"
"10","004","00","010","0031","0058","600","384","216","2","602","1221","0","49.30","31.45"
"10","004","00","010","0031","0059","556","322","234","1","557","1176","0","47.36","27.38"
"10","004","00","010","0031","0060","497","253","244","2","499","1201","0","41.55","21.07"
"10","004","00","010","0031","0061","540","322","218","2","542","1200","0","45.17","26.83"
"10","004","00","010","0031","0062","634","357","277","4","638","1357","0","47.02","26.31"
"10","004","00","020","0000","0000","29945","20075","9870","290","30235","80187","96850","37.71","25.04"
"10","004","00","020","0001","0000","100","72","28","0","100","303","0","33.00","23.76"
"10","004","00","020","0001","0129","100","72","28","0","100","303","0","33.00","23.76"
"10","004","00","020","0002","0000","136","84","52","1","137","402","0","34.08","20.90"
"10","004","00","020","0002","0130","136","84","52","1","137","402","0","34.08","20.90"
"10","004","00","020","0003","0000","131","87","44","3","134","369","0","36.31","23.58"
"10","004","00","020","0003","0131","131","87","44","3","134","369","0","36.31","23.58"
"10","004","00","020","0004","0000","831","592","239","8","839","2251","0","37.27","26.30"
"10","004","00","020","0004","0132","373","264","109","5","378","1092","0","34.62","24.18"
"10","004","00","020","0004","0133","458","328","130","3","461","1159","0","39.78","28.30"
"10","004","00","020","0005","0000","1257","886","371","7","1264","3227","0","39.17","27.46"
"10","004","00","020","0005","0142","381","288","93","3","384","995","0","38.59","28.94"
"10","004","00","020","0005","0143","408","285","123","3","411","1185","0","34.68","24.05"
"10","004","00","020","0005","0144","468","313","155","1","469","1047","0","44.79","29.89"
"10","004","00","020","0006","0000","3271","2338","933","31","3302","9255","0","35.68","25.26"
"10","004","00","020","0006","0134","426","308","118","6","432","1189","0","36.33","25.90"
"10","004","00","020","0006","0135","486","337","149","1","487","1217","0","40.02","27.69"
"10","004","00","020","0006","0136","476","345","131","7","483","1278","0","37.79","27.00"
"10","004","00","020","0006","0137","337","239","98","1","338","1345","0","25.13","17.77"
"10","004","00","020","0006","0138","412","311","101","5","417","1204","0","34.63","25.83"
"10","004","00","020","0006","0139","388","285","103","1","389","917","0","42.42","31.08"
"10","004","00","020","0006","0140","326","201","125","5","331","939","0","35.25","21.41"
"10","004","00","020","0006","0141","420","312","108","5","425","1166","0","36.45","26.76"
"10","004","00","020","0007","0000","1596","1120","476","23","1619","4597","0","35.22","24.36"
"10","004","00","020","0007","0147","357","225","132","4","361","1125","0","32.09","20.00"
"10","004","00","020","0007","0148","342","242","100","7","349","1044","0","33.43","23.18"
"10","004","00","020","0007","0149","472","335","137","9","481","1266","0","37.99","26.46"
"10","004","00","020","0007","0150","425","318","107","3","428","1162","0","36.83","27.37"
"10","004","00","020","0008","0000","309","206","103","2","311","643","0","48.37","32.04"
"10","004","00","020","0008","0154","309","206","103","2","311","643","0","48.37","32.04"
"10","004","00","020","0009","0000","984","716","268","10","994","3051","0","32.58","23.47"
"10","004","00","020","0009","0155","278","201","77","2","280","984","0","28.46","20.43"
"10","004","00","020","0009","0156","398","299","99","5","403","969","0","41.59","30.86"
"10","004","00","020","0009","0157","308","216","92","3","311","1098","0","28.32","19.67"
"10","004","00","020","0010","0000","579","338","241","9","588","1321","0","44.51","25.59"
"10","004","00","020","0010","0158","276","161","115","4","280","579","0","48.36","27.81"
"10","004","00","020","0010","0159","303","177","126","5","308","742","0","41.51","23.85"
"10","004","00","020","0011","0000","596","411","185","2","598","1352","0","44.23","30.40"
"10","004","00","020","0011","0169","305","214","91","2","307","693","0","44.30","30.88"
"10","004","00","020","0011","0170","291","197","94","0","291","659","0","44.16","29.89"
"10","004","00","020","0012","0000","1362","925","437","12","1374","3726","0","36.88","24.83"
"10","004","00","020","0012","0162","321","215","106","1","322","923","0","34.89","23.29"
"10","004","00","020","0012","0163","299","206","93","4","303","949","0","31.93","21.71"
"10","004","00","020","0012","0164","326","243","83","5","331","901","0","36.74","26.97"
"10","004","00","020","0012","0165","416","261","155","2","418","953","0","43.86","27.39"
"10","004","00","020","0013","0000","1272","845","427","10","1282","3284","0","39.04","25.73"
"10","004","00","020","0013","0166","381","267","114","5","386","962","0","40.12","27.75"
"10","004","00","020","0013","0167","438","294","144","2","440","1159","0","37.96","25.37"
"10","004","00","020","0013","0168","453","284","169","3","456","1163","0","39.21","24.42"
"10","004","00","020","0014","0000","2415","1604","811","18","2433","7516","0","32.37","21.34"
"10","004","00","020","0014","0177","378","246","132","5","383","1248","0","30.69","19.71"
"10","004","00","020","0014","0178","299","182","117","1","300","1254","0","23.92","14.51"
"10","004","00","020","0014","0179","416","284","132","3","419","1219","0","34.37","23.30"
"10","004","00","020","0014","0180","330","217","113","1","331","1139","0","29.06","19.05"
"10","004","00","020","0014","0181","589","398","191","5","594","1554","0","38.22","25.61"
"10","004","00","020","0014","0182","403","277","126","3","406","1102","0","36.84","25.14"
"10","004","00","020","0015","0000","2372","1539","833","22","2394","6371","0","37.58","24.16"
"10","004","00","020","0015","0184","381","234","147","5","386","1078","0","35.81","21.71"
"10","004","00","020","0015","0185","314","208","106","2","316","1061","0","29.78","19.60"
"10","004","00","020","0015","0186","381","241","140","3","384","977","0","39.30","24.67"
"10","004","00","020","0015","0187","394","262","132","2","396","1090","0","36.33","24.04"
"10","004","00","020","0015","0188","443","277","166","5","448","1086","0","41.25","25.51"
"10","004","00","020","0015","0189","459","317","142","5","464","1079","0","43.00","29.38"
"10","004","00","020","0016","0000","1890","1218","672","21","1911","4492","0","42.54","27.11"
"10","004","00","020","0016","0200","479","300","179","4","483","1108","0","43.59","27.08"
"10","004","00","020","0016","0201","496","333","163","6","502","1181","0","42.51","28.20"
"10","004","00","020","0016","0202","471","297","174","6","477","1124","0","42.44","26.42"
"10","004","00","020","0016","0203","444","288","156","5","449","1079","0","41.61","26.69"
"10","004","00","020","0017","0000","771","465","306","11","782","1905","0","41.05","24.41"
"10","004","00","020","0017","0204","371","213","158","7","378","989","0","38.22","21.54"
"10","004","00","020","0017","0205","400","252","148","4","404","916","0","44.10","27.51"
"10","004","00","020","0018","0000","232","141","91","3","235","585","0","40.17","24.10"
"10","004","00","020","0018","0206","232","141","91","3","235","585","0","40.17","24.10"
"10","004","00","020","0019","0000","4413","2736","1677","32","4445","11579","0","38.39","23.63"
"10","004","00","020","0019","0190","509","327","182","4","513","1184","0","43.33","27.62"
"10","004","00","020","0019","0191","320","196","124","3","323","907","0","35.61","21.61"
"10","004","00","020","0019","0192","809","487","322","5","814","1559","0","52.21","31.24"
"10","004","00","020","0019","0193","268","128","140","0","268","847","0","31.64","15.11"
"10","004","00","020","0019","0194","315","163","152","1","316","946","0","33.40","17.23"
"10","004","00","020","0019","0195","484","256","228","5","489","1282","0","38.14","19.97"
"10","004","00","020","0019","0196","425","273","152","3","428","1186","0","36.09","23.02"
"10","004","00","020","0019","0197","334","214","120","0","334","1228","0","27.20","17.43"
"10","004","00","020","0019","0198","443","287","156","2","445","1202","0","37.02","23.88"
"10","004","00","020","0019","0199","506","405","101","9","515","1238","0","41.60","32.71"
"10","004","00","020","0020","0000","638","460","178","13","651","1672","0","38.94","27.51"
"10","004","00","020","0020","0151","284","214","70","10","294","812","0","36.21","26.35"
"10","004","00","020","0020","0152","354","246","108","3","357","860","0","41.51","28.60"
"10","004","00","020","0021","0000","833","548","285","14","847","2198","0","38.54","24.93"
"10","004","00","020","0021","0145","350","239","111","5","355","895","0","39.66","26.70"
"10","004","00","020","0021","0146","483","309","174","9","492","1303","0","37.76","23.71"
"10","004","00","020","0022","0000","435","294","141","1","436","1002","0","43.51","29.34"
"10","004","00","020","0022","0153","435","294","141","1","436","1002","0","43.51","29.34"
"10","004","00","020","0023","0000","2717","1918","799","28","2745","6974","0","39.36","27.50"
"10","004","00","020","0023","0171","445","329","116","6","451","1165","0","38.71","28.24"
"10","004","00","020","0023","0172","465","327","138","4","469","1119","0","41.91","29.22"
"10","004","00","020","0023","0173","449","315","134","4","453","1135","0","39.91","27.75"
"10","004","00","020","0023","0174","485","336","149","5","490","1219","0","40.20","27.56"
"10","004","00","020","0023","0175","450","320","130","6","456","1213","0","37.59","26.38"
"10","004","00","020","0023","0176","423","291","132","3","426","1123","0","37.93","25.91"
"10","004","00","020","0024","0000","559","373","186","7","566","1533","0","36.92","24.33"
"10","004","00","020","0024","0160","273","177","96","4","277","730","0","37.95","24.25"
"10","004","00","020","0024","0161","286","196","90","3","289","803","0","35.99","24.41"
"10","004","00","020","0025","0000","246","159","87","2","248","579","0","42.83","27.46"
"10","004","00","020","0025","0183","246","159","87","2","248","579","0","42.83","27.46"
"10","004","00","030","0000","0000","11862","7035","4827","125","11987","29144","32991","41.13","24.14"
"10","004","00","030","0001","0000","408","224","184","9","417","1106","0","37.70","20.25"
"10","004","00","030","0001","0227","408","224","184","9","417","1106","0","37.70","20.25"
"10","004","00","030","0002","0000","368","229","139","5","373","857","0","43.52","26.72"
"10","004","00","030","0002","0228","368","229","139","5","373","857","0","43.52","26.72"
"10","004","00","030","0003","0000","1812","1130","682","17","1829","4469","0","40.93","25.29"
"10","004","00","030","0003","0229","376","234","142","7","383","1052","0","36.41","22.24"
"10","004","00","030","0003","0230","429","267","162","5","434","1008","0","43.06","26.49"
"10","004","00","030","0003","0231","390","274","116","2","392","1010","0","38.81","27.13"
"10","004","00","030","0003","0232","617","355","262","3","620","1399","0","44.32","25.38"
"10","004","00","030","0004","0000","726","462","264","5","731","1976","0","36.99","23.38"
"10","004","00","030","0004","0216","376","242","134","3","379","979","0","38.71","24.72"
"10","004","00","030","0004","0217","350","220","130","2","352","997","0","35.31","22.07"
"10","004","00","030","0005","0000","1380","765","615","13","1393","3266","0","42.65","23.42"
"10","004","00","030","0005","0218","542","314","228","6","548","1174","0","46.68","26.75"
"10","004","00","030","0005","0219","454","261","193","5","459","1110","0","41.35","23.51"
"10","004","00","030","0005","0220","384","190","194","2","386","982","0","39.31","19.35"
"10","004","00","030","0006","0000","686","414","272","3","689","1753","0","39.30","23.62"
"10","004","00","030","0006","0214","348","227","121","1","349","894","0","39.04","25.39"
"10","004","00","030","0006","0215","338","187","151","2","340","859","0","39.58","21.77"
"10","004","00","030","0007","0000","1260","802","458","7","1267","3147","0","40.26","25.48"
"10","004","00","030","0007","0210","366","243","123","2","368","908","0","40.53","26.76"
"10","004","00","030","0007","0211","278","185","93","2","280","707","0","39.60","26.17"
"10","004","00","030","0007","0212","404","237","167","2","406","1025","0","39.61","23.12"
"10","004","00","030","0007","0213","212","137","75","1","213","507","0","42.01","27.02"
"10","004","00","030","0008","0000","400","256","144","7","407","964","0","42.22","26.56"
"10","004","00","030","0008","0207","400","256","144","7","407","964","0","42.22","26.56"
"10","004","00","030","0009","0000","251","134","117","2","253","558","0","45.34","24.01"
"10","004","00","030","0009","0208","251","134","117","2","253","558","0","45.34","24.01"
"10","004","00","030","0010","0000","454","313","141","3","457","1011","0","45.20","30.96"
"10","004","00","030","0010","0209","454","313","141","3","457","1011","0","45.20","30.96"
"10","004","00","030","0011","0000","703","420","283","12","715","1823","0","39.22","23.04"
"10","004","00","030","0011","0233","389","216","173","5","394","960","0","41.04","22.50"
"10","004","00","030","0011","0234","314","204","110","7","321","863","0","37.20","23.64"
"10","004","00","030","0012","0000","1048","615","433","15","1063","2507","0","42.40","24.53"
"10","004","00","030","0012","0235","368","206","162","3","371","828","0","44.81","24.88"
"10","004","00","030","0012","0236","351","210","141","3","354","807","0","43.87","26.02"
"10","004","00","030","0012","0237","329","199","130","9","338","872","0","38.76","22.82"
"10","004","00","030","0013","0000","431","246","185","5","436","977","0","44.63","25.18"
"10","004","00","030","0013","0238","431","246","185","5","436","977","0","44.63","25.18"
"10","004","00","030","0014","0000","256","139","117","4","260","642","0","40.50","21.65"
"10","004","00","030","0014","0239","256","139","117","4","260","642","0","40.50","21.65"
"10","004","00","030","0015","0000","491","240","251","6","497","1082","0","45.93","22.18"
"10","004","00","030","0015","0226","491","240","251","6","497","1082","0","45.93","22.18"
"10","004","00","030","0016","0000","480","282","198","6","486","1332","0","36.49","21.17"
"10","004","00","030","0016","0221","240","122","118","3","243","730","0","33.29","16.71"
"10","004","00","030","0016","0222","240","160","80","3","243","602","0","40.37","26.58"
"10","004","00","030","0017","0000","189","96","93","1","190","403","0","47.15","23.82"
"10","004","00","030","0017","0223","189","96","93","1","190","403","0","47.15","23.82"
"10","004","00","030","0018","0000","278","129","149","2","280","701","0","39.94","18.40"
"10","004","00","030","0018","0224","278","129","149","2","280","701","0","39.94","18.40"
"10","004","00","030","0019","0000","241","139","102","3","244","570","0","42.81","24.39"
"10","004","00","030","0019","0225","241","139","102","3","244","570","0","42.81","24.39"
"10","004","00","040","0000","0000","9222","5792","3430","139","9361","24047","27521","38.93","24.09"
"10","004","00","040","0001","0000","220","162","58","4","224","472","0","47.46","34.32"
"10","004","00","040","0001","0240","220","162","58","4","224","472","0","47.46","34.32"
"10","004","00","040","0002","0000","761","541","220","10","771","1896","0","40.66","28.53"
"10","004","00","040","0002","0241","357","260","97","7","364","896","0","40.63","29.02"
"10","004","00","040","0002","0242","404","281","123","3","407","1000","0","40.70","28.10"
"10","004","00","040","0003","0000","289","195","94","5","294","677","0","43.43","28.80"
"10","004","00","040","0003","0243","289","195","94","5","294","677","0","43.43","28.80"
"10","004","00","040","0004","0000","1440","922","518","24","1464","3579","0","40.91","25.76"
"10","004","00","040","0004","0244","510","323","187","8","518","1144","0","45.28","28.23"
"10","004","00","040","0004","0245","484","307","177","8","492","1170","0","42.05","26.24"
"10","004","00","040","0004","0246","446","292","154","8","454","1265","0","35.89","23.08"
"10","004","00","040","0005","0000","400","242","158","7","407","960","0","42.40","25.21"
"10","004","00","040","0005","0248","400","242","158","7","407","960","0","42.40","25.21"
"10","004","00","040","0006","0000","319","182","137","5","324","756","0","42.86","24.07"
"10","004","00","040","0006","0247","319","182","137","5","324","756","0","42.86","24.07"
"10","004","00","040","0007","0000","350","203","147","9","359","1025","0","35.02","19.80"
"10","004","00","040","0007","0249","350","203","147","9","359","1025","0","35.02","19.80"
"10","004","00","040","0008","0000","1308","833","475","13","1321","3726","0","35.45","22.36"
"10","004","00","040","0008","0250","418","272","146","5","423","1200","0","35.25","22.67"
"10","004","00","040","0008","0251","469","300","169","4","473","1290","0","36.67","23.26"
"10","004","00","040","0008","0252","421","261","160","4","425","1236","0","34.39","21.12"
"10","004","00","040","0009","0000","449","278","171","4","453","1248","0","36.30","22.28"
"10","004","00","040","0009","0254","449","278","171","4","453","1248","0","36.30","22.28"
"10","004","00","040","0010","0000","171","96","75","2","173","529","0","32.70","18.15"
"10","004","00","040","0010","0256","171","96","75","2","173","529","0","32.70","18.15"
"10","004","00","040","0011","0000","208","135","73","1","209","549","0","38.07","24.59"
"10","004","00","040","0011","0258","208","135","73","1","209","549","0","38.07","24.59"
"10","004","00","040","0012","0000","284","202","82","4","288","904","0","31.86","22.35"
"10","004","00","040","0012","0259","284","202","82","4","288","904","0","31.86","22.35"
"10","004","00","040","0013","0000","130","69","61","2","132","431","0","30.63","16.01"
"10","004","00","040","0013","0257","130","69","61","2","132","431","0","30.63","16.01"
"10","004","00","040","0014","0000","346","167","179","4","350","787","0","44.47","21.22"
"10","004","00","040","0014","0260","346","167","179","4","350","787","0","44.47","21.22"
"10","004","00","040","0015","0000","655","394","261","7","662","1735","0","38.16","22.71"
"10","004","00","040","0015","0261","354","228","126","3","357","861","0","41.46","26.48"
"10","004","00","040","0015","0262","301","166","135","4","305","874","0","34.90","18.99"
"10","004","00","040","0016","0000","326","205","121","5","331","798","0","41.48","25.69"
"10","004","00","040","0016","0264","326","205","121","5","331","798","0","41.48","25.69"
"10","004","00","040","0017","0000","214","150","64","3","217","537","0","40.41","27.93"
"10","004","00","040","0017","0265","214","150","64","3","217","537","0","40.41","27.93"
"10","004","00","040","0018","0000","310","179","131","10","320","799","0","40.05","22.40"
"10","004","00","040","0018","0266","310","179","131","10","320","799","0","40.05","22.40"
"10","004","00","040","0019","0000","326","183","143","4","330","824","0","40.05","22.21"
"10","004","00","040","0019","0253","326","183","143","4","330","824","0","40.05","22.21"
"10","004","00","040","0020","0000","311","202","109","8","319","889","0","35.88","22.72"
"10","004","00","040","0020","0255","311","202","109","8","319","889","0","35.88","22.72"
"10","004","00","040","0021","0000","405","252","153","8","413","926","0","44.60","27.21"
"10","004","00","040","0021","0263","405","252","153","8","413","926","0","44.60","27.21"
"10","004","00","050","0000","0000","23506","15290","8216","235","23741","65720","79420","36.12","23.27"
"10","004","00","050","0001","0000","517","346","171","6","523","1181","0","44.28","29.30"
"10","004","00","050","0001","0280","517","346","171","6","523","1181","0","44.28","29.30"
"10","004","00","050","0002","0000","378","230","148","4","382","855","0","44.68","26.90"
"10","004","00","050","0002","0279","378","230","148","4","382","855","0","44.68","26.90"
"10","004","00","050","0003","0000","1557","998","559","24","1581","3959","0","39.93","25.21"
"10","004","00","050","0003","0276","496","295","201","9","505","1347","0","37.49","21.90"
"10","004","00","050","0003","0277","550","389","161","9","559","1295","0","43.17","30.04"
"10","004","00","050","0003","0278","511","314","197","6","517","1317","0","39.26","23.84"
"10","004","00","050","0004","0000","1940","1231","709","22","1962","5246","0","37.40","23.47"
"10","004","00","050","0004","0285","498","313","185","9","507","1441","0","35.18","21.72"
"10","004","00","050","0004","0286","467","299","168","2","469","1148","0","40.85","26.05"
"10","004","00","050","0004","0287","452","278","174","5","457","1367","0","33.43","20.34"
"10","004","00","050","0004","0288","523","341","182","6","529","1290","0","41.01","26.43"
"10","004","00","050","0005","0000","1247","805","442","11","1258","3221","0","39.06","24.99"
"10","004","00","050","0005","0281","722","478","244","8","730","1946","0","37.51","24.56"
"10","004","00","050","0005","0282","525","327","198","3","528","1275","0","41.41","25.65"
"10","004","00","050","0006","0000","1674","1055","619","12","1686","4921","0","34.26","21.44"
"10","004","00","050","0006","0272","406","265","141","4","410","1124","0","36.48","23.58"
"10","004","00","050","0006","0273","485","291","194","1","486","1307","0","37.18","22.26"
"10","004","00","050","0006","0274","372","245","127","2","374","1200","0","31.17","20.42"
"10","004","00","050","0006","0275","411","254","157","5","416","1290","0","32.25","19.69"
"10","004","00","050","0007","0000","1021","584","437","7","1028","2816","0","36.51","20.74"
"10","004","00","050","0007","0267","465","243","222","1","466","1317","0","35.38","18.45"
"10","004","00","050","0007","0268","556","341","215","6","562","1499","0","37.49","22.75"
"10","004","00","050","0008","0000","1116","720","396","11","1127","3163","0","35.63","22.76"
"10","004","00","050","0008","0294","426","283","143","5","431","1177","0","36.62","24.04"
"10","004","00","050","0008","0295","308","201","107","5","313","785","0","39.87","25.61"
"10","004","00","050","0008","0296","382","236","146","1","383","1201","0","31.89","19.65"
"10","004","00","050","0009","0000","371","219","152","1","372","1045","0","35.60","20.96"
"10","004","00","050","0009","0297","371","219","152","1","372","1045","0","35.60","20.96"
"10","004","00","050","0010","0000","1063","658","405","11","1074","2753","0","39.01","23.90"
"10","004","00","050","0010","0298","473","309","164","6","479","1302","0","36.79","23.73"
"10","004","00","050","0010","0299","590","349","241","5","595","1451","0","41.01","24.05"
"10","004","00","050","0011","0000","1002","734","268","15","1017","2452","0","41.48","29.93"
"10","004","00","050","0011","0300","518","383","135","8","526","1227","0","42.87","31.21"
"10","004","00","050","0011","0301","484","351","133","7","491","1225","0","40.08","28.65"
"10","004","00","050","0012","0000","606","418","188","6","612","1495","0","40.94","27.96"
"10","004","00","050","0012","0302","606","418","188","6","612","1495","0","40.94","27.96"
"10","004","00","050","0013","0000","746","459","287","6","752","2217","0","33.92","20.70"
"10","004","00","050","0013","0292","358","198","160","5","363","1088","0","33.36","18.20"
"10","004","00","050","0013","0293","388","261","127","1","389","1129","0","34.46","23.12"
"10","004","00","050","0014","0000","1617","1064","553","23","1640","5086","0","32.25","20.92"
"10","004","00","050","0014","0308","338","245","93","3","341","1050","0","32.48","23.33"
"10","004","00","050","0014","0309","368","223","145","10","378","1289","0","29.33","17.30"
"10","004","00","050","0014","0310","446","304","142","5","451","1279","0","35.26","23.77"
"10","004","00","050","0014","0311","465","292","173","5","470","1468","0","32.02","19.89"
"10","004","00","050","0015","0000","1171","848","323","11","1182","3248","0","36.39","26.11"
"10","004","00","050","0015","0315","344","231","113","3","347","1076","0","32.25","21.47"
"10","004","00","050","0015","0316","481","375","106","5","486","1196","0","40.64","31.35"
"10","004","00","050","0015","0317","346","242","104","3","349","976","0","35.76","24.80"
"10","004","00","050","0016","0000","1886","1339","547","18","1904","6149","0","30.96","21.78"
"10","004","00","050","0016","0303","433","341","92","6","439","1387","0","31.65","24.59"
"10","004","00","050","0016","0304","338","265","73","2","340","1016","0","33.46","26.08"
"10","004","00","050","0016","0305","371","235","136","6","377","1196","0","31.52","19.65"
"10","004","00","050","0016","0306","404","285","119","2","406","1403","0","28.94","20.31"
"10","004","00","050","0016","0307","340","213","127","2","342","1147","0","29.82","18.57"
"10","004","00","050","0017","0000","1416","880","536","12","1428","3854","0","37.05","22.83"
"10","004","00","050","0017","0289","390","230","160","3","393","966","0","40.68","23.81"
"10","004","00","050","0017","0290","389","234","155","4","393","1164","0","33.76","20.10"
"10","004","00","050","0017","0291","637","416","221","5","642","1724","0","37.24","24.13"
"10","004","00","050","0018","0000","1348","843","505","10","1358","3485","0","38.97","24.19"
"10","004","00","050","0018","0283","613","362","251","4","617","1458","0","42.32","24.83"
"10","004","00","050","0018","0284","735","481","254","6","741","2027","0","36.56","23.73"
"10","004","00","050","0019","0000","1464","909","555","13","1477","4375","0","33.76","20.78"
"10","004","00","050","0019","0269","396","241","155","3","399","1220","0","32.70","19.75"
"10","004","00","050","0019","0270","483","299","184","7","490","1551","0","31.59","19.28"
"10","004","00","050","0019","0271","585","369","216","3","588","1604","0","36.66","23.00"
"10","004","00","050","0020","0000","1366","950","416","12","1378","4199","0","32.82","22.62"
"10","004","00","050","0020","0312","513","329","184","2","515","1475","0","34.92","22.31"
"10","004","00","050","0020","0313","433","298","135","2","435","1439","0","30.23","20.71"
"10","004","00","050","0020","0314","420","323","97","8","428","1285","0","33.31","25.14"
"10","004","00","060","0000","0000","16880","10205","6675","182","17062","46779","57654","36.47","21.82"
"10","004","00","060","0001","0000","400","237","163","9","409","1086","0","37.66","21.82"
"10","004","00","060","0001","0318","400","237","163","9","409","1086","0","37.66","21.82"
"10","004","00","060","0002","0000","626","351","275","10","636","1798","0","35.37","19.52"
"10","004","00","060","0002","0326","267","141","126","4","271","795","0","34.09","17.74"
"10","004","00","060","0002","0327","359","210","149","6","365","1003","0","36.39","20.94"
"10","004","00","060","0003","0000","646","387","259","12","658","1867","0","35.24","20.73"
"10","004","00","060","0003","0319","289","175","114","5","294","883","0","33.30","19.82"
"10","004","00","060","0003","0320","357","212","145","7","364","984","0","36.99","21.54"
"10","004","00","060","0004","0000","1014","434","580","10","1024","2772","0","36.94","15.66"
"10","004","00","060","0004","0329","332","153","179","4","336","995","0","33.77","15.38"
"10","004","00","060","0004","0330","329","132","197","5","334","858","0","38.93","15.38"
"10","004","00","060","0004","0331","353","149","204","1","354","919","0","38.52","16.21"
"10","004","00","060","0005","0000","575","349","226","4","579","1847","0","31.35","18.90"
"10","004","00","060","0005","0324","332","201","131","1","333","956","0","34.83","21.03"
"10","004","00","060","0005","0325","243","148","95","3","246","891","0","27.61","16.61"
"10","004","00","060","0006","0000","310","123","187","3","313","833","0","37.58","14.77"
"10","004","00","060","0006","0328","310","123","187","3","313","833","0","37.58","14.77"
"10","004","00","060","0007","0000","1093","687","406","12","1105","3202","0","34.51","21.46"
"10","004","00","060","0007","0321","376","242","134","3","379","990","0","38.28","24.44"
"10","004","00","060","0007","0322","368","236","132","5","373","1123","0","33.21","21.02"
"10","004","00","060","0007","0323","349","209","140","4","353","1089","0","32.42","19.19"
"10","004","00","060","0008","0000","1757","1088","669","21","1778","5247","0","33.89","20.74"
"10","004","00","060","0008","0346","365","229","136","4","369","977","0","37.77","23.44"
"10","004","00","060","0008","0347","406","260","146","4","410","1054","0","38.90","24.67"
"10","004","00","060","0008","0348","301","191","110","3","304","1062","0","28.63","17.98"
"10","004","00","060","0008","0349","314","205","109","7","321","1013","0","31.69","20.24"
"10","004","00","060","0008","0350","371","203","168","3","374","1141","0","32.78","17.79"
"10","004","00","060","0009","0000","728","340","388","5","733","2073","0","35.36","16.40"
"10","004","00","060","0009","0332","330","134","196","3","333","1022","0","32.58","13.11"
"10","004","00","060","0009","0333","398","206","192","2","400","1051","0","38.06","19.60"
"10","004","00","060","0010","0000","983","651","332","9","992","2634","0","37.66","24.72"
"10","004","00","060","0010","0334","503","350","153","7","510","1352","0","37.72","25.89"
"10","004","00","060","0010","0335","480","301","179","2","482","1282","0","37.60","23.48"
"10","004","00","060","0011","0000","1703","1092","611","20","1723","4372","0","39.41","24.98"
"10","004","00","060","0011","0354","447","303","144","9","456","1117","0","40.82","27.13"
"10","004","00","060","0011","0355","391","255","136","2","393","1052","0","37.36","24.24"
"10","004","00","060","0011","0356","449","288","161","3","452","1201","0","37.64","23.98"
"10","004","00","060","0011","0357","416","246","170","6","422","1002","0","42.12","24.55"
"10","004","00","060","0012","0000","571","364","207","12","583","1508","0","38.66","24.14"
"10","004","00","060","0012","0343","279","168","111","3","282","758","0","37.20","22.16"
"10","004","00","060","0012","0344","292","196","96","9","301","750","0","40.13","26.13"
"10","004","00","060","0013","0000","399","246","153","4","403","1044","0","38.60","23.56"
"10","004","00","060","0013","0345","399","246","153","4","403","1044","0","38.60","23.56"
"10","004","00","060","0014","0000","1345","866","479","11","1356","3558","0","38.11","24.34"
"10","004","00","060","0014","0336","474","309","165","1","475","1308","0","36.31","23.62"
"10","004","00","060","0014","0337","454","285","169","3","457","1124","0","40.66","25.36"
"10","004","00","060","0014","0338","417","272","145","7","424","1126","0","37.66","24.16"
"10","004","00","060","0015","0000","1709","1095","614","14","1723","4427","0","38.92","24.73"
"10","004","00","060","0015","0339","390","250","140","5","395","1114","0","35.46","22.44"
"10","004","00","060","0015","0340","388","260","128","1","389","1007","0","38.63","25.82"
"10","004","00","060","0015","0341","429","264","165","3","432","1065","0","40.56","24.79"
"10","004","00","060","0015","0342","502","321","181","5","507","1241","0","40.85","25.87"
"10","004","00","060","0016","0000","2027","1275","752","11","2038","5803","0","35.12","21.97"
"10","004","00","060","0016","0358","431","276","155","2","433","1107","0","39.11","24.93"
"10","004","00","060","0016","0359","427","256","171","3","430","1175","0","36.60","21.79"
"10","004","00","060","0016","0360","419","276","143","1","420","1184","0","35.47","23.31"
"10","004","00","060","0016","0361","346","222","124","2","348","1016","0","34.25","21.85"
"10","004","00","060","0016","0362","404","245","159","3","407","1321","0","30.81","18.55"
"10","004","00","060","0017","0000","994","620","374","15","1009","2708","0","37.26","22.90"
"10","004","00","060","0017","0351","308","203","105","2","310","926","0","33.48","21.92"
"10","004","00","060","0017","0352","282","175","107","5","287","820","0","35.00","21.34"
"10","004","00","060","0017","0353","404","242","162","8","412","962","0","42.83","25.16"
"10","004","00","070","0000","0000","7096","4649","2447","74","7170","17504","19888","40.96","26.56"
"10","004","00","070","0001","0000","200","139","61","0","200","491","0","40.73","28.31"
"10","004","00","070","0001","0364","200","139","61","0","200","491","0","40.73","28.31"
"10","004","00","070","0002","0000","167","118","49","2","169","384","0","44.01","30.73"
"10","004","00","070","0002","0363","167","118","49","2","169","384","0","44.01","30.73"
"10","004","00","070","0003","0000","362","267","95","6","368","934","0","39.40","28.59"
"10","004","00","070","0003","0365","362","267","95","6","368","934","0","39.40","28.59"
"10","004","00","070","0004","0000","156","118","38","3","159","409","0","38.88","28.85"
"10","004","00","070","0004","0366","156","118","38","3","159","409","0","38.88","28.85"
"10","004","00","070","0005","0000","1020","687","333","6","1026","2655","0","38.64","25.88"
"10","004","00","070","0005","0367","510","361","149","0","510","1267","0","40.25","28.49"
"10","004","00","070","0005","0368","510","326","184","6","516","1388","0","37.18","23.49"
"10","004","00","070","0006","0000","588","378","210","9","597","1577","0","37.86","23.97"
"10","004","00","070","0006","0369","301","184","117","5","306","787","0","38.88","23.38"
"10","004","00","070","0006","0370","287","194","93","4","291","790","0","36.84","24.56"
"10","004","00","070","0007","0000","239","176","63","4","243","626","0","38.82","28.12"
"10","004","00","070","0007","0371","239","176","63","4","243","626","0","38.82","28.12"
"10","004","00","070","0008","0000","309","192","117","5","314","779","0","40.31","24.65"
"10","004","00","070","0008","0372","309","192","117","5","314","779","0","40.31","24.65"
"10","004","00","070","0009","0000","924","655","269","12","936","2349","0","39.85","27.88"
"10","004","00","070","0009","0373","444","294","150","7","451","1261","0","35.77","23.31"
"10","004","00","070","0009","0374","480","361","119","5","485","1088","0","44.58","33.18"
"10","004","00","070","0010","0000","658","406","252","7","665","1559","0","42.66","26.04"
"10","004","00","070","0010","0375","290","175","115","7","297","681","0","43.61","25.70"
"10","004","00","070","0010","0376","368","231","137","0","368","878","0","41.91","26.31"
"10","004","00","070","0011","0000","1990","1213","777","16","2006","4643","0","43.20","26.13"
"10","004","00","070","0011","0377","511","319","192","3","514","1165","0","44.12","27.38"
"10","004","00","070","0011","0378","576","361","215","4","580","1366","0","42.46","26.43"
"10","004","00","070","0011","0379","520","289","231","6","526","1047","0","50.24","27.60"
"10","004","00","070","0011","0380","383","244","139","3","386","1065","0","36.24","22.91"
"10","004","00","070","0012","0000","483","300","183","4","487","1098","0","44.35","27.32"
"10","004","00","070","0012","0381","483","300","183","4","487","1098","0","44.35","27.32"
"10","004","00","080","0000","0000","4312","2987","1325","74","4386","11007","12408","39.85","27.14"
"10","004","00","080","0001","0000","1216","833","383","22","1238","3300","0","37.52","25.24"
"10","004","00","080","0001","0382","479","325","154","7","486","1176","0","41.33","27.64"
"10","004","00","080","0001","0383","365","253","112","11","376","1021","0","36.83","24.78"
"10","004","00","080","0001","0384","372","255","117","4","376","1103","0","34.09","23.12"
"10","004","00","080","0002","0000","344","213","131","3","347","847","0","40.97","25.15"
"10","004","00","080","0002","0385","344","213","131","3","347","847","0","40.97","25.15"
"10","004","00","080","0003","0000","80","57","23","0","80","180","0","44.44","31.67"
"10","004","00","080","0003","0386","80","57","23","0","80","180","0","44.44","31.67"
"10","004","00","080","0004","0000","75","41","34","2","77","203","0","37.93","20.20"
"10","004","00","080","0004","0387","75","41","34","2","77","203","0","37.93","20.20"
"10","004","00","080","0005","0000","121","79","42","1","122","320","0","38.13","24.69"
"10","004","00","080","0005","0388","121","79","42","1","122","320","0","38.13","24.69"
"10","004","00","080","0006","0000","338","229","109","12","350","882","0","39.68","25.96"
"10","004","00","080","0006","0389","338","229","109","12","350","882","0","39.68","25.96"
"10","004","00","080","0007","0000","161","103","58","5","166","419","0","39.62","24.58"
"10","004","00","080","0007","0392","161","103","58","5","166","419","0","39.62","24.58"
"10","004","00","080","0008","0000","407","266","141","11","418","938","0","44.56","28.36"
"10","004","00","080","0008","0393","290","193","97","10","300","675","0","44.44","28.59"
"10","004","00","080","0008","0394","117","73","44","1","118","263","0","44.87","27.76"
"10","004","00","080","0009","0000","626","466","160","8","634","1488","0","42.61","31.32"
"10","004","00","080","0009","0395","271","209","62","4","275","661","0","41.60","31.62"
"10","004","00","080","0009","0396","355","257","98","4","359","827","0","43.41","31.08"
"10","004","00","080","0010","0000","605","452","153","7","612","1628","0","37.59","27.76"
"10","004","00","080","0010","0397","314","241","73","4","318","832","0","38.22","28.97"
"10","004","00","080","0010","0398","291","211","80","3","294","796","0","36.93","26.51"
"10","004","00","080","0011","0000","339","248","91","3","342","802","0","42.64","30.92"
"10","004","00","080","0011","0390","141","102","39","1","142","273","0","52.01","37.36"
"10","004","00","080","0011","0391","198","146","52","2","200","529","0","37.81","27.60"
"10","004","00","090","0000","0000","2939","1979","960","29","2968","7870","8864","37.71","25.15"
"10","004","00","090","0001","0000","413","274","139","2","415","1117","0","37.15","24.53"
"10","004","00","090","0001","0399","413","274","139","2","415","1117","0","37.15","24.53"
"10","004","00","090","0002","0000","415","291","124","7","422","1142","0","36.95","25.48"
"10","004","00","090","0002","0400","415","291","124","7","422","1142","0","36.95","25.48"
"10","004","00","090","0003","0000","933","624","309","10","943","2547","0","37.02","24.50"
"10","004","00","090","0003","0402","356","237","119","5","361","918","0","39.32","25.82"
"10","004","00","090","0003","0403","286","191","95","3","289","793","0","36.44","24.09"
"10","004","00","090","0003","0404","291","196","95","2","293","836","0","35.05","23.44"
"10","004","00","090","0004","0000","281","167","114","1","282","818","0","34.47","20.42"
"10","004","00","090","0004","0405","281","167","114","1","282","818","0","34.47","20.42"
"10","004","00","090","0005","0000","178","129","49","3","181","363","0","49.86","35.54"
"10","004","00","090","0005","0406","178","129","49","3","181","363","0","49.86","35.54"
"10","004","00","090","0006","0000","271","196","75","1","272","720","0","37.78","27.22"
"10","004","00","090","0006","0407","271","196","75","1","272","720","0","37.78","27.22"
"10","004","00","090","0007","0000","185","128","57","2","187","541","0","34.57","23.66"
"10","004","00","090","0007","0401","185","128","57","2","187","541","0","34.57","23.66"
"10","004","00","090","0008","0000","142","97","45","2","144","325","0","44.31","29.85"
"10","004","00","090","0008","0408","142","97","45","2","144","325","0","44.31","29.85"
"10","004","00","090","0009","0000","121","73","48","1","122","297","0","41.08","24.58"
"10","004","00","090","0009","0409","121","73","48","1","122","297","0","41.08","24.58"
"10","004","00","100","0000","0000","5139","3237","1902","44","5183","13015","14570","39.82","24.87"
"10","004","00","100","0001","0000","1016","605","411","6","1022","2659","0","38.44","22.75"
"10","004","00","100","0001","0410","393","230","163","0","393","1101","0","35.69","20.89"
"10","004","00","100","0001","0411","623","375","248","6","629","1558","0","40.37","24.07"
"10","004","00","100","0002","0000","877","559","318","2","879","2006","0","43.82","27.87"
"10","004","00","100","0002","0414","462","306","156","0","462","975","0","47.38","31.38"
"10","004","00","100","0002","0415","415","253","162","2","417","1031","0","40.45","24.54"
"10","004","00","100","0003","0000","394","240","154","9","403","1015","0","39.70","23.65"
"10","004","00","100","0003","0416","394","240","154","9","403","1015","0","39.70","23.65"
"10","004","00","100","0004","0000","425","255","170","5","430","1168","0","36.82","21.83"
"10","004","00","100","0004","0417","425","255","170","5","430","1168","0","36.82","21.83"
"10","004","00","100","0005","0000","327","210","117","0","327","794","0","41.18","26.45"
"10","004","00","100","0005","0419","327","210","117","0","327","794","0","41.18","26.45"
"10","004","00","100","0006","0000","229","155","74","4","233","731","0","31.87","21.20"
"10","004","00","100","0006","0418","229","155","74","4","233","731","0","31.87","21.20"
"10","004","00","100","0007","0000","249","159","90","0","249","541","0","46.03","29.39"
"10","004","00","100","0007","0422","249","159","90","0","249","541","0","46.03","29.39"
"10","004","00","100","0008","0000","342","229","113","5","347","847","0","40.97","27.04"
"10","004","00","100","0008","0420","342","229","113","5","347","847","0","40.97","27.04"
"10","004","00","100","0009","0000","250","164","86","2","252","578","0","43.60","28.37"
"10","004","00","100","0009","0421","250","164","86","2","252","578","0","43.60","28.37"
"10","004","00","100","0010","0000","1030","661","369","11","1041","2676","0","38.90","24.70"
"10","004","00","100","0010","0412","583","357","226","7","590","1507","0","39.15","23.69"
"10","004","00","100","0010","0413","447","304","143","4","451","1169","0","38.58","26.01"
"10","004","00","110","0000","0000","1946","1241","705","22","1968","4838","5323","40.68","25.65"
"10","004","00","110","0001","0000","366","265","101","9","375","815","0","46.01","32.52"
"10","004","00","110","0001","0423","366","265","101","9","375","815","0","46.01","32.52"
"10","004","00","110","0002","0000","269","154","115","4","273","665","0","41.05","23.16"
"10","004","00","110","0002","0424","269","154","115","4","273","665","0","41.05","23.16"
"10","004","00","110","0003","0000","242","160","82","0","242","563","0","42.98","28.42"
"10","004","00","110","0003","0425","242","160","82","0","242","563","0","42.98","28.42"
"10","004","00","110","0004","0000","494","323","171","2","496","1340","0","37.01","24.10"
"10","004","00","110","0004","0428","241","169","72","1","242","646","0","37.46","26.16"
"10","004","00","110","0004","0429","253","154","99","1","254","694","0","36.60","22.19"
"10","004","00","110","0005","0000","248","154","94","1","249","605","0","41.16","25.45"
"10","004","00","110","0005","0426","142","89","53","1","143","343","0","41.69","25.95"
"10","004","00","110","0005","0427","106","65","41","0","106","262","0","40.46","24.81"
"10","004","00","110","0006","0000","327","185","142","6","333","850","0","39.18","21.76"
"10","004","00","110","0006","0430","186","108","78","1","187","448","0","41.74","24.11"
"10","004","00","110","0006","0431","141","77","64","5","146","402","0","36.32","19.15"
"10","004","00","120","0000","0000","1705","1311","394","24","1729","7360","9561","23.49","17.81"
"10","004","00","120","0001","0000","168","123","45","1","169","587","0","28.79","20.95"
"10","004","00","120","0001","0434","69","47","22","0","69","217","0","31.80","21.66"
"10","004","00","120","0001","0435","99","76","23","1","100","370","0","27.03","20.54"
"10","004","00","120","0002","0000","267","205","62","4","271","818","0","33.13","25.06"
"10","004","00","120","0002","0432","144","115","29","3","147","457","0","32.17","25.16"
"10","004","00","120","0002","0433","123","90","33","1","124","361","0","34.35","24.93"
"10","004","00","120","0003","0000","310","262","48","8","318","1210","0","26.28","21.65"
"10","004","00","120","0003","0436","204","168","36","6","210","734","0","28.61","22.89"
"10","004","00","120","0003","0437","106","94","12","2","108","476","0","22.69","19.75"
"10","004","00","120","0004","0000","201","165","36","3","204","626","0","32.59","26.36"
"10","004","00","120","0004","0440","201","165","36","3","204","626","0","32.59","26.36"
"10","004","00","120","0005","0000","257","204","53","1","258","1161","0","22.22","17.57"
"10","004","00","120","0005","0438","110","88","22","1","111","532","0","20.86","16.54"
"10","004","00","120","0005","0439","147","116","31","0","147","629","0","23.37","18.44"
"10","004","00","120","0006","0000","242","159","83","2","244","1329","0","18.36","11.96"
"10","004","00","120","0006","0441","111","81","30","0","111","613","0","18.11","13.21"
"10","004","00","120","0006","0442","84","60","24","2","86","589","0","14.60","10.19"
"10","004","00","120","0006","0443","47","18","29","0","47","127","0","37.01","14.17"
"10","004","00","120","0007","0000","260","193","67","5","265","1629","0","16.27","11.85"
"10","004","00","120","0007","0444","92","79","13","1","93","488","0","19.06","16.19"
"10","004","00","120","0007","0445","109","87","22","3","112","825","0","13.58","10.55"
"10","004","00","120","0007","0446","59","27","32","1","60","316","0","18.99","8.54"
"10","004","00","130","0000","0000","1005","776","229","14","1019","3736","4431","27.28","20.77"
"10","004","00","130","0001","0000","344","302","42","6","350","1281","0","27.32","23.58"
"10","004","00","130","0001","0447","172","158","14","2","174","632","0","27.53","25.00"
"10","004","00","130","0001","0448","172","144","28","4","176","649","0","27.12","22.19"
"10","004","00","130","0002","0000","204","148","56","2","206","711","0","28.97","20.82"
"10","004","00","130","0002","0451","204","148","56","2","206","711","0","28.97","20.82"
"10","004","00","130","0003","0000","100","77","23","0","100","377","0","26.53","20.42"
"10","004","00","130","0003","0452","100","77","23","0","100","377","0","26.53","20.42"
"10","004","00","130","0004","0000","357","249","108","6","363","1367","0","26.55","18.22"
"10","004","00","130","0004","0449","142","102","40","3","145","535","0","27.10","19.07"
"10","004","00","130","0004","0450","215","147","68","3","218","832","0","26.20","17.67"
"10","005","00","000","0000","0000","169858","104362","65496","1687","171545","457991","540312","37.46","22.79"
"10","005","00","010","0000","0000","29518","20436","9082","267","29785","73644","87384","40.44","27.75"
"10","005","00","010","0001","0000","478","332","146","1","479","1116","0","42.92","29.75"
"10","005","00","010","0001","0001","478","332","146","1","479","1116","0","42.92","29.75"
"10","005","00","010","0002","0000","1695","1210","485","11","1706","4048","0","42.14","29.89"
"10","005","00","010","0002","0049","410","282","128","0","410","1004","0","40.84","28.09"
"10","005","00","010","0002","0050","452","301","151","1","453","997","0","45.44","30.19"
"10","005","00","010","0002","0051","390","291","99","7","397","1050","0","37.81","27.71"
"10","005","00","010","0002","0052","443","336","107","3","446","997","0","44.73","33.70"
"10","005","00","010","0003","0000","359","237","122","6","365","1005","0","36.32","23.58"
"10","005","00","010","0003","0002","359","237","122","6","365","1005","0","36.32","23.58"
"10","005","00","010","0004","0000","1033","765","268","6","1039","2166","0","47.97","35.32"
"10","005","00","010","0004","0009","523","386","137","3","526","1082","0","48.61","35.67"
"10","005","00","010","0004","0010","510","379","131","3","513","1084","0","47.32","34.96"
"10","005","00","010","0005","0000","1528","1110","418","18","1546","3579","0","43.20","31.01"
"10","005","00","010","0005","0011","434","289","145","5","439","1096","0","40.05","26.37"
"10","005","00","010","0005","0012","523","396","127","10","533","1248","0","42.71","31.73"
"10","005","00","010","0005","0013","571","425","146","3","574","1235","0","46.48","34.41"
"10","005","00","010","0006","0000","1498","1064","434","13","1511","3590","0","42.09","29.64"
"10","005","00","010","0006","0006","527","380","147","5","532","1189","0","44.74","31.96"
"10","005","00","010","0006","0007","520","387","133","2","522","1272","0","41.04","30.42"
"10","005","00","010","0006","0008","451","297","154","6","457","1129","0","40.48","26.31"
"10","005","00","010","0007","0000","1224","870","354","12","1236","3260","0","37.91","26.69"
"10","005","00","010","0007","0003","411","309","102","3","414","1093","0","37.88","28.27"
"10","005","00","010","0007","0004","410","291","119","6","416","1088","0","38.24","26.75"
"10","005","00","010","0007","0005","403","270","133","3","406","1079","0","37.63","25.02"
"10","005","00","010","0008","0000","320","222","98","3","323","805","0","40.12","27.58"
"10","005","00","010","0008","0014","320","222","98","3","323","805","0","40.12","27.58"
"10","005","00","010","0009","0000","1207","847","360","5","1212","3216","0","37.69","26.34"
"10","005","00","010","0009","0015","352","243","109","1","353","963","0","36.66","25.23"
"10","005","00","010","0009","0016","410","282","128","3","413","1117","0","36.97","25.25"
"10","005","00","010","0009","0017","445","322","123","1","446","1136","0","39.26","28.35"
"10","005","00","010","0010","0000","364","222","142","4","368","856","0","42.99","25.93"
"10","005","00","010","0010","0019","364","222","142","4","368","856","0","42.99","25.93"
"10","005","00","010","0011","0000","231","152","79","3","234","497","0","47.08","30.58"
"10","005","00","010","0011","0020","231","152","79","3","234","497","0","47.08","30.58"
"10","005","00","010","0012","0000","353","214","139","4","357","841","0","42.45","25.45"
"10","005","00","010","0012","0018","353","214","139","4","357","841","0","42.45","25.45"
"10","005","00","010","0013","0000","1642","1127","515","15","1657","3843","0","43.12","29.33"
"10","005","00","010","0013","0024","504","335","169","4","508","1203","0","42.23","27.85"
"10","005","00","010","0013","0025","478","343","135","6","484","1112","0","43.53","30.85"
"10","005","00","010","0013","0026","360","268","92","1","361","772","0","46.76","34.72"
"10","005","00","010","0013","0027","300","181","119","4","304","756","0","40.21","23.94"
"10","005","00","010","0014","0000","501","325","176","7","508","1333","0","38.11","24.38"
"10","005","00","010","0014","0021","501","325","176","7","508","1333","0","38.11","24.38"
"10","005","00","010","0015","0000","668","431","237","11","679","1503","0","45.18","28.68"
"10","005","00","010","0015","0031","273","191","82","5","278","574","0","48.43","33.28"
"10","005","00","010","0015","0032","395","240","155","6","401","929","0","43.16","25.83"
"10","005","00","010","0016","0000","2075","1421","654","16","2091","5025","0","41.61","28.28"
"10","005","00","010","0016","0033","513","342","171","0","513","1192","0","43.04","28.69"
"10","005","00","010","0016","0034","550","373","177","6","556","1433","0","38.80","26.03"
"10","005","00","010","0016","0035","487","339","148","5","492","1165","0","42.23","29.10"
"10","005","00","010","0016","0036","525","367","158","5","530","1235","0","42.91","29.72"
"10","005","00","010","0017","0000","1388","941","447","10","1398","3087","0","45.29","30.48"
"10","005","00","010","0017","0028","417","271","146","2","419","1000","0","41.90","27.10"
"10","005","00","010","0017","0029","514","362","152","6","520","1128","0","46.10","32.09"
"10","005","00","010","0017","0030","457","308","149","2","459","959","0","47.86","32.12"
"10","005","00","010","0018","0000","1379","948","431","14","1393","3365","0","41.40","28.17"
"10","005","00","010","0018","0037","489","346","143","7","496","1177","0","42.14","29.40"
"10","005","00","010","0018","0038","432","290","142","3","435","1042","0","41.75","27.83"
"10","005","00","010","0018","0039","458","312","146","4","462","1146","0","40.31","27.23"
"10","005","00","010","0019","0000","1570","1052","518","17","1587","4152","0","38.22","25.34"
"10","005","00","010","0019","0040","547","378","169","4","551","1409","0","39.11","26.83"
"10","005","00","010","0019","0041","502","332","170","4","506","1342","0","37.70","24.74"
"10","005","00","010","0019","0042","521","342","179","9","530","1401","0","37.83","24.41"
"10","005","00","010","0020","0000","442","300","142","5","447","1166","0","38.34","25.73"
"10","005","00","010","0020","0063","442","300","142","5","447","1166","0","38.34","25.73"
"10","005","00","010","0021","0000","1601","1107","494","12","1613","4041","0","39.92","27.39"
"10","005","00","010","0021","0057","526","360","166","7","533","1307","0","40.78","27.54"
"10","005","00","010","0021","0058","517","348","169","2","519","1350","0","38.44","25.78"
"10","005","00","010","0021","0059","558","399","159","3","561","1384","0","40.53","28.83"
"10","005","00","010","0022","0000","2051","1466","585","14","2065","5344","0","38.64","27.43"
"10","005","00","010","0022","0053","414","289","125","0","414","1079","0","38.37","26.78"
"10","005","00","010","0022","0054","462","342","120","2","464","1165","0","39.83","29.36"
"10","005","00","010","0022","0055","627","450","177","7","634","1484","0","42.72","30.32"
"10","005","00","010","0022","0056","548","385","163","5","553","1616","0","34.22","23.82"
"10","005","00","010","0023","0000","938","642","296","10","948","2448","0","38.73","26.23"
"10","005","00","010","0023","0022","519","346","173","4","523","1382","0","37.84","25.04"
"10","005","00","010","0023","0023","419","296","123","6","425","1066","0","39.87","27.77"
"10","005","00","010","0024","0000","566","376","190","10","576","1664","0","34.62","22.60"
"10","005","00","010","0024","0066","262","192","70","7","269","793","0","33.92","24.21"
"10","005","00","010","0024","0067","304","184","120","3","307","871","0","35.25","21.13"
"10","005","00","010","0025","0000","1258","863","395","10","1268","3443","0","36.83","25.07"
"10","005","00","010","0025","0043","467","306","161","3","470","1250","0","37.60","24.48"
"10","005","00","010","0025","0044","390","268","122","6","396","984","0","40.24","27.24"
"10","005","00","010","0025","0045","401","289","112","1","402","1209","0","33.25","23.90"
"10","005","00","010","0026","0000","1241","882","359","13","1254","2769","0","45.29","31.85"
"10","005","00","010","0026","0046","397","283","114","2","399","998","0","39.98","28.36"
"10","005","00","010","0026","0047","401","291","110","7","408","835","0","48.86","34.85"
"10","005","00","010","0026","0048","443","308","135","4","447","936","0","47.76","32.91"
"10","005","00","010","0027","0000","645","450","195","5","650","1926","0","33.75","23.36"
"10","005","00","010","0027","0064","348","234","114","3","351","1039","0","33.78","22.52"
"10","005","00","010","0027","0065","297","216","81","2","299","887","0","33.71","24.35"
"10","005","00","010","0028","0000","1263","860","403","12","1275","3556","0","35.85","24.18"
"10","005","00","010","0028","0060","491","354","137","5","496","1274","0","38.93","27.79"
"10","005","00","010","0028","0061","471","313","158","5","476","1390","0","34.24","22.52"
"10","005","00","010","0028","0062","301","193","108","2","303","892","0","33.97","21.64"
"10","005","00","020","0000","0000","13646","5868","7778","120","13766","38502","44437","35.75","15.24"
"10","005","00","020","0001","0000","820","387","433","7","827","2145","0","38.55","18.04"
"10","005","00","020","0001","0068","358","168","190","3","361","847","0","42.62","19.83"
"10","005","00","020","0001","0069","462","219","243","4","466","1298","0","35.90","16.87"
"10","005","00","020","0002","0000","604","255","349","2","606","1435","0","42.23","17.77"
"10","005","00","020","0002","0070","354","158","196","2","356","754","0","47.21","20.95"
"10","005","00","020","0002","0071","250","97","153","0","250","681","0","36.71","14.24"
"10","005","00","020","0003","0000","360","144","216","7","367","878","0","41.80","16.40"
"10","005","00","020","0003","0072","360","144","216","7","367","878","0","41.80","16.40"
"10","005","00","020","0004","0000","575","227","348","3","578","1612","0","35.86","14.08"
"10","005","00","020","0004","0073","296","138","158","1","297","832","0","35.70","16.59"
"10","005","00","020","0004","0074","279","89","190","2","281","780","0","36.03","11.41"
"10","005","00","020","0005","0000","420","125","295","3","423","1191","0","35.52","10.50"
"10","005","00","020","0005","0075","420","125","295","3","423","1191","0","35.52","10.50"
"10","005","00","020","0006","0000","709","291","418","6","715","1961","0","36.46","14.84"
"10","005","00","020","0006","0076","424","180","244","2","426","1130","0","37.70","15.93"
"10","005","00","020","0006","0077","285","111","174","4","289","831","0","34.78","13.36"
"10","005","00","020","0007","0000","342","143","199","4","346","1037","0","33.37","13.79"
"10","005","00","020","0007","0078","342","143","199","4","346","1037","0","33.37","13.79"
"10","005","00","020","0008","0000","774","341","433","3","777","2186","0","35.54","15.60"
"10","005","00","020","0008","0079","391","178","213","0","391","1098","0","35.61","16.21"
"10","005","00","020","0008","0080","383","163","220","3","386","1088","0","35.48","14.98"
"10","005","00","020","0009","0000","1518","680","838","11","1529","3952","0","38.69","17.21"
"10","005","00","020","0009","0081","519","230","289","3","522","1415","0","36.89","16.25"
"10","005","00","020","0009","0082","481","216","265","3","484","1285","0","37.67","16.81"
"10","005","00","020","0009","0083","518","234","284","5","523","1252","0","41.77","18.69"
"10","005","00","020","0010","0000","710","308","402","7","717","2128","0","33.69","14.47"
"10","005","00","020","0010","0084","357","152","205","5","362","1054","0","34.35","14.42"
"10","005","00","020","0010","0085","353","156","197","2","355","1074","0","33.05","14.53"
"10","005","00","020","0011","0000","285","101","184","0","285","912","0","31.25","11.07"
"10","005","00","020","0011","0086","285","101","184","0","285","912","0","31.25","11.07"
"10","005","00","020","0012","0000","224","72","152","0","224","628","0","35.67","11.46"
"10","005","00","020","0012","0087","224","72","152","0","224","628","0","35.67","11.46"
"10","005","00","020","0013","0000","535","251","284","6","541","1353","0","39.99","18.55"
"10","005","00","020","0013","0088","535","251","284","6","541","1353","0","39.99","18.55"
"10","005","00","020","0014","0000","483","214","269","2","485","1350","0","35.93","15.85"
"10","005","00","020","0014","0089","241","78","163","1","242","665","0","36.39","11.73"
"10","005","00","020","0014","0090","242","136","106","1","243","685","0","35.47","19.85"
"10","005","00","020","0015","0000","624","291","333","9","633","1788","0","35.40","16.28"
"10","005","00","020","0015","0091","322","145","177","5","327","893","0","36.62","16.24"
"10","005","00","020","0015","0092","302","146","156","4","306","895","0","34.19","16.31"
"10","005","00","020","0016","0000","426","197","229","4","430","1235","0","34.82","15.95"
"10","005","00","020","0016","0093","426","197","229","4","430","1235","0","34.82","15.95"
"10","005","00","020","0017","0000","186","86","100","1","187","546","0","34.25","15.75"
"10","005","00","020","0017","0094","186","86","100","1","187","546","0","34.25","15.75"
"10","005","00","020","0018","0000","277","146","131","0","277","770","0","35.97","18.96"
"10","005","00","020","0018","0095","277","146","131","0","277","770","0","35.97","18.96"
"10","005","00","020","0019","0000","775","315","460","5","780","2413","0","32.32","13.05"
"10","005","00","020","0019","0103","364","162","202","3","367","1137","0","32.28","14.25"
"10","005","00","020","0019","0104","411","153","258","2","413","1276","0","32.37","11.99"
"10","005","00","020","0020","0000","568","200","368","6","574","1649","0","34.81","12.13"
"10","005","00","020","0020","0097","298","108","190","2","300","881","0","34.05","12.26"
"10","005","00","020","0020","0098","270","92","178","4","274","768","0","35.68","11.98"
"10","005","00","020","0021","0000","555","251","304","15","570","1604","0","35.54","15.65"
"10","005","00","020","0021","0099","270","156","114","4","274","781","0","35.08","19.97"
"10","005","00","020","0021","0100","285","95","190","11","296","823","0","35.97","11.54"
"10","005","00","020","0022","0000","556","239","317","6","562","1758","0","31.97","13.59"
"10","005","00","020","0022","0101","273","103","170","1","274","827","0","33.13","12.45"
"10","005","00","020","0022","0102","283","136","147","5","288","931","0","30.93","14.61"
"10","005","00","020","0023","0000","221","84","137","4","225","680","0","33.09","12.35"
"10","005","00","020","0023","0096","221","84","137","4","225","680","0","33.09","12.35"
"10","005","00","020","0024","0000","438","219","219","5","443","1419","0","31.22","15.43"
"10","005","00","020","0024","0105","438","219","219","5","443","1419","0","31.22","15.43"
"10","005","00","020","0025","0000","661","301","360","4","665","1872","0","35.52","16.08"
"10","005","00","020","0025","0106","353","172","181","4","357","987","0","36.17","17.43"
"10","005","00","020","0025","0107","308","129","179","0","308","885","0","34.80","14.58"
"10","005","00","030","0000","0000","9720","4480","5240","116","9836","28819","32701","34.13","15.55"
"10","005","00","030","0001","0000","407","179","228","4","411","1064","0","38.63","16.82"
"10","005","00","030","0001","0108","407","179","228","4","411","1064","0","38.63","16.82"
"10","005","00","030","0002","0000","791","361","430","7","798","1916","0","41.65","18.84"
"10","005","00","030","0002","0109","382","159","223","5","387","864","0","44.79","18.40"
"10","005","00","030","0002","0110","409","202","207","2","411","1052","0","39.07","19.20"
"10","005","00","030","0003","0000","720","313","407","8","728","1805","0","40.33","17.34"
"10","005","00","030","0003","0111","367","148","219","2","369","973","0","37.92","15.21"
"10","005","00","030","0003","0112","353","165","188","6","359","832","0","43.15","19.83"
"10","005","00","030","0004","0000","516","201","315","7","523","1531","0","34.16","13.13"
"10","005","00","030","0004","0116","262","119","143","4","266","737","0","36.09","16.15"
"10","005","00","030","0004","0117","254","82","172","3","257","794","0","32.37","10.33"
"10","005","00","030","0005","0000","247","112","135","3","250","676","0","36.98","16.57"
"10","005","00","030","0005","0115","247","112","135","3","250","676","0","36.98","16.57"
"10","005","00","030","0006","0000","872","397","475","9","881","2637","0","33.41","15.05"
"10","005","00","030","0006","0118","341","160","181","4","345","929","0","37.14","17.22"
"10","005","00","030","0006","0119","305","136","169","3","308","938","0","32.84","14.50"
"10","005","00","030","0006","0120","226","101","125","2","228","770","0","29.61","13.12"
"10","005","00","030","0007","0000","225","107","118","2","227","658","0","34.50","16.26"
"10","005","00","030","0007","0127","225","107","118","2","227","658","0","34.50","16.26"
"10","005","00","030","0008","0000","313","142","171","9","322","903","0","35.66","15.73"
"10","005","00","030","0008","0128","313","142","171","9","322","903","0","35.66","15.73"
"10","005","00","030","0009","0000","290","114","176","4","294","769","0","38.23","14.82"
"10","005","00","030","0009","0129","290","114","176","4","294","769","0","38.23","14.82"
"10","005","00","030","0010","0000","224","110","114","5","229","622","0","36.82","17.68"
"10","005","00","030","0010","0130","224","110","114","5","229","622","0","36.82","17.68"
"10","005","00","030","0011","0000","394","210","184","6","400","1189","0","33.64","17.66"
"10","005","00","030","0011","0131","394","210","184","6","400","1189","0","33.64","17.66"
"10","005","00","030","0012","0000","441","215","226","5","446","1325","0","33.66","16.23"
"10","005","00","030","0012","0132","441","215","226","5","446","1325","0","33.66","16.23"
"10","005","00","030","0013","0000","457","184","273","5","462","1379","0","33.50","13.34"
"10","005","00","030","0013","0133","244","114","130","2","246","628","0","39.17","18.15"
"10","005","00","030","0013","0134","213","70","143","3","216","751","0","28.76","9.32"
"10","005","00","030","0014","0000","529","246","283","3","532","1822","0","29.20","13.50"
"10","005","00","030","0014","0121","204","94","110","2","206","734","0","28.07","12.81"
"10","005","00","030","0014","0122","325","152","173","1","326","1088","0","29.96","13.97"
"10","005","00","030","0015","0000","145","79","66","0","145","415","0","34.94","19.04"
"10","005","00","030","0015","0123","145","79","66","0","145","415","0","34.94","19.04"
"10","005","00","030","0016","0000","289","186","103","7","296","856","0","34.58","21.73"
"10","005","00","030","0016","0124","289","186","103","7","296","856","0","34.58","21.73"
"10","005","00","030","0017","0000","122","80","42","2","124","385","0","32.21","20.78"
"10","005","00","030","0017","0125","122","80","42","2","124","385","0","32.21","20.78"
"10","005","00","030","0018","0000","223","114","109","6","229","770","0","29.74","14.81"
"10","005","00","030","0018","0126","223","114","109","6","229","770","0","29.74","14.81"
"10","005","00","030","0019","0000","628","301","327","4","632","2187","0","28.90","13.76"
"10","005","00","030","0019","0135","320","130","190","3","323","1075","0","30.05","12.09"
"10","005","00","030","0019","0136","308","171","137","1","309","1112","0","27.79","15.38"
"10","005","00","030","0020","0000","335","110","225","5","340","1078","0","31.54","10.20"
"10","005","00","030","0020","0137","335","110","225","5","340","1078","0","31.54","10.20"
"10","005","00","030","0021","0000","220","91","129","3","223","709","0","31.45","12.83"
"10","005","00","030","0021","0138","220","91","129","3","223","709","0","31.45","12.83"
"10","005","00","030","0022","0000","427","221","206","3","430","1405","0","30.60","15.73"
"10","005","00","030","0022","0139","225","113","112","2","227","607","0","37.40","18.62"
"10","005","00","030","0022","0140","202","108","94","1","203","798","0","25.44","13.53"
"10","005","00","030","0023","0000","226","107","119","3","229","709","0","32.30","15.09"
"10","005","00","030","0023","0141","226","107","119","3","229","709","0","32.30","15.09"
"10","005","00","030","0024","0000","679","300","379","6","685","2009","0","34.10","14.93"
"10","005","00","030","0024","0113","356","156","200","1","357","1023","0","34.90","15.25"
"10","005","00","030","0024","0114","323","144","179","5","328","986","0","33.27","14.60"
"10","005","00","040","0000","0000","26342","14510","11832","242","26584","70266","87307","37.83","20.65"
"10","005","00","040","0001","0000","811","475","336","4","815","1893","0","43.05","25.09"
"10","005","00","040","0001","0142","429","241","188","2","431","987","0","43.67","24.42"
"10","005","00","040","0001","0143","382","234","148","2","384","906","0","42.38","25.83"
"10","005","00","040","0002","0000","1440","763","677","14","1454","3293","0","44.15","23.17"
"10","005","00","040","0002","0144","415","213","202","2","417","998","0","41.78","21.34"
"10","005","00","040","0002","0145","586","342","244","6","592","1310","0","45.19","26.11"
"10","005","00","040","0002","0146","439","208","231","6","445","985","0","45.18","21.12"
"10","005","00","040","0003","0000","966","486","480","9","975","2715","0","35.91","17.90"
"10","005","00","040","0003","0147","535","277","258","7","542","1453","0","37.30","19.06"
"10","005","00","040","0003","0148","431","209","222","2","433","1262","0","34.31","16.56"
"10","005","00","040","0004","0000","2002","1078","924","19","2021","4759","0","42.47","22.65"
"10","005","00","040","0004","0149","472","263","209","3","475","1184","0","40.12","22.21"
"10","005","00","040","0004","0150","476","269","207","4","480","1125","0","42.67","23.91"
"10","005","00","040","0004","0151","495","262","233","3","498","1162","0","42.86","22.55"
"10","005","00","040","0004","0152","559","284","275","9","568","1288","0","44.10","22.05"
"10","005","00","040","0005","0000","2106","1248","858","16","2122","5205","0","40.77","23.98"
"10","005","00","040","0005","0153","523","286","237","3","526","1227","0","42.87","23.31"
"10","005","00","040","0005","0154","469","280","189","2","471","1235","0","38.14","22.67"
"10","005","00","040","0005","0155","320","188","132","4","324","667","0","48.58","28.19"
"10","005","00","040","0005","0156","440","266","174","5","445","1123","0","39.63","23.69"
"10","005","00","040","0005","0157","354","228","126","2","356","953","0","37.36","23.92"
"10","005","00","040","0006","0000","1324","669","655","16","1340","3484","0","38.46","19.20"
"10","005","00","040","0006","0158","389","178","211","3","392","1039","0","37.73","17.13"
"10","005","00","040","0006","0159","469","248","221","6","475","1134","0","41.89","21.87"
"10","005","00","040","0006","0160","466","243","223","7","473","1311","0","36.08","18.54"
"10","005","00","040","0007","0000","1365","778","587","9","1374","3366","0","40.82","23.11"
"10","005","00","040","0007","0161","472","266","206","2","474","1179","0","40.20","22.56"
"10","005","00","040","0007","0162","412","249","163","4","416","1066","0","39.02","23.36"
"10","005","00","040","0007","0163","481","263","218","3","484","1121","0","43.18","23.46"
"10","005","00","040","0008","0000","1049","568","481","7","1056","3259","0","32.40","17.43"
"10","005","00","040","0008","0164","408","246","162","4","412","1246","0","33.07","19.74"
"10","005","00","040","0008","0165","301","160","141","2","303","956","0","31.69","16.74"
"10","005","00","040","0008","0166","340","162","178","1","341","1057","0","32.26","15.33"
"10","005","00","040","0009","0000","751","410","341","5","756","2041","0","37.04","20.09"
"10","005","00","040","0009","0171","365","205","160","2","367","1040","0","35.29","19.71"
"10","005","00","040","0009","0172","386","205","181","3","389","1001","0","38.86","20.48"
"10","005","00","040","0010","0000","1661","995","666","12","1673","4916","0","34.03","20.24"
"10","005","00","040","0010","0173","380","212","168","3","383","1238","0","30.94","17.12"
"10","005","00","040","0010","0174","431","262","169","6","437","1034","0","42.26","25.34"
"10","005","00","040","0010","0175","405","261","144","1","406","1376","0","29.51","18.97"
"10","005","00","040","0010","0176","445","260","185","2","447","1268","0","35.25","20.50"
"10","005","00","040","0011","0000","404","223","181","4","408","1080","0","37.78","20.65"
"10","005","00","040","0011","0180","404","223","181","4","408","1080","0","37.78","20.65"
"10","005","00","040","0012","0000","1155","644","511","11","1166","2759","0","42.26","23.34"
"10","005","00","040","0012","0181","332","169","163","1","333","817","0","40.76","20.69"
"10","005","00","040","0012","0182","291","180","111","7","298","795","0","37.48","22.64"
"10","005","00","040","0012","0183","532","295","237","3","535","1147","0","46.64","25.72"
"10","005","00","040","0013","0000","537","305","232","2","539","1520","0","35.46","20.07"
"10","005","00","040","0013","0184","293","162","131","2","295","820","0","35.98","19.76"
"10","005","00","040","0013","0185","244","143","101","0","244","700","0","34.86","20.43"
"10","005","00","040","0014","0000","721","405","316","4","725","1941","0","37.35","20.87"
"10","005","00","040","0014","0186","377","211","166","0","377","973","0","38.75","21.69"
"10","005","00","040","0014","0187","344","194","150","4","348","968","0","35.95","20.04"
"10","005","00","040","0015","0000","438","230","208","4","442","1207","0","36.62","19.06"
"10","005","00","040","0015","0188","438","230","208","4","442","1207","0","36.62","19.06"
"10","005","00","040","0016","0000","1356","739","617","6","1362","4107","0","33.16","17.99"
"10","005","00","040","0016","0189","501","264","237","2","503","1463","0","34.38","18.05"
"10","005","00","040","0016","0190","443","249","194","2","445","1404","0","31.70","17.74"
"10","005","00","040","0016","0191","412","226","186","2","414","1240","0","33.39","18.23"
"10","005","00","040","0017","0000","823","440","383","11","834","2198","0","37.94","20.02"
"10","005","00","040","0017","0192","310","184","126","2","312","892","0","34.98","20.63"
"10","005","00","040","0017","0193","307","165","142","5","312","767","0","40.68","21.51"
"10","005","00","040","0017","0194","206","91","115","4","210","539","0","38.96","16.88"
"10","005","00","040","0018","0000","374","254","120","7","381","1138","0","33.48","22.32"
"10","005","00","040","0018","0195","374","254","120","7","381","1138","0","33.48","22.32"
"10","005","00","040","0019","0000","1554","845","709","16","1570","4771","0","32.91","17.71"
"10","005","00","040","0019","0196","700","399","301","8","708","2138","0","33.12","18.66"
"10","005","00","040","0019","0197","469","267","202","3","472","1483","0","31.83","18.00"
"10","005","00","040","0019","0198","385","179","206","5","390","1150","0","33.91","15.57"
"10","005","00","040","0020","0000","797","404","393","13","810","2066","0","39.21","19.55"
"10","005","00","040","0020","0199","417","195","222","7","424","1091","0","38.86","17.87"
"10","005","00","040","0020","0200","380","209","171","6","386","975","0","39.59","21.44"
"10","005","00","040","0021","0000","1399","763","636","18","1417","3817","0","37.12","19.99"
"10","005","00","040","0021","0201","210","117","93","4","214","529","0","40.45","22.12"
"10","005","00","040","0021","0202","389","226","163","6","395","1074","0","36.78","21.04"
"10","005","00","040","0021","0203","329","137","192","1","330","845","0","39.05","16.21"
"10","005","00","040","0021","0204","471","283","188","7","478","1369","0","34.92","20.67"
"10","005","00","040","0022","0000","365","193","172","4","369","1009","0","36.57","19.13"
"10","005","00","040","0022","0205","365","193","172","4","369","1009","0","36.57","19.13"
"10","005","00","040","0023","0000","1192","624","568","20","1212","3241","0","37.40","19.25"
"10","005","00","040","0023","0177","443","231","212","5","448","1141","0","39.26","20.25"
"10","005","00","040","0023","0178","391","214","177","10","401","1104","0","36.32","19.38"
"10","005","00","040","0023","0179","358","179","179","5","363","996","0","36.45","17.97"
"10","005","00","040","0024","0000","844","512","332","1","845","2154","0","39.23","23.77"
"10","005","00","040","0024","0169","496","315","181","0","496","1297","0","38.24","24.29"
"10","005","00","040","0024","0170","348","197","151","1","349","857","0","40.72","22.99"
"10","005","00","040","0025","0000","908","459","449","10","918","2327","0","39.45","19.72"
"10","005","00","040","0025","0167","460","237","223","4","464","1178","0","39.39","20.12"
"10","005","00","040","0025","0168","448","222","226","6","454","1149","0","39.51","19.32"
"10","005","00","050","0000","0000","31898","21342","10556","270","32168","85736","104902","37.52","24.89"
"10","005","00","050","0001","0000","709","480","229","8","717","2182","0","32.86","22.00"
"10","005","00","050","0001","0206","361","228","133","2","363","1109","0","32.73","20.56"
"10","005","00","050","0001","0207","348","252","96","6","354","1073","0","32.99","23.49"
"10","005","00","050","0002","0000","620","426","194","4","624","1710","0","36.49","24.91"
"10","005","00","050","0002","0208","316","236","80","3","319","886","0","36.00","26.64"
"10","005","00","050","0002","0209","304","190","114","1","305","824","0","37.01","23.06"
"10","005","00","050","0003","0000","1081","784","297","12","1093","2890","0","37.82","27.13"
"10","005","00","050","0003","0210","396","289","107","4","400","1058","0","37.81","27.32"
"10","005","00","050","0003","0211","367","278","89","3","370","934","0","39.61","29.76"
"10","005","00","050","0003","0212","318","217","101","5","323","898","0","35.97","24.16"
"10","005","00","050","0004","0000","1417","1041","376","11","1428","3743","0","38.15","27.81"
"10","005","00","050","0004","0213","474","343","131","6","480","1160","0","41.38","29.57"
"10","005","00","050","0004","0214","338","252","86","2","340","1030","0","33.01","24.47"
"10","005","00","050","0004","0215","605","446","159","3","608","1553","0","39.15","28.72"
"10","005","00","050","0005","0000","1631","1108","523","11","1642","4464","0","36.78","24.82"
"10","005","00","050","0005","0216","337","232","105","2","339","915","0","37.05","25.36"
"10","005","00","050","0005","0217","389","247","142","2","391","1209","0","32.34","20.43"
"10","005","00","050","0005","0218","536","386","150","6","542","1474","0","36.77","26.19"
"10","005","00","050","0005","0219","369","243","126","1","370","866","0","42.73","28.06"
"10","005","00","050","0006","0000","920","660","260","8","928","2565","0","36.18","25.73"
"10","005","00","050","0006","0220","547","406","141","3","550","1360","0","40.44","29.85"
"10","005","00","050","0006","0221","373","254","119","5","378","1205","0","31.37","21.08"
"10","005","00","050","0007","0000","370","228","142","3","373","1018","0","36.64","22.40"
"10","005","00","050","0007","0222","370","228","142","3","373","1018","0","36.64","22.40"
"10","005","00","050","0008","0000","1179","797","382","12","1191","3264","0","36.49","24.42"
"10","005","00","050","0008","0223","356","222","134","3","359","1061","0","33.84","20.92"
"10","005","00","050","0008","0224","416","317","99","6","422","1049","0","40.23","30.22"
"10","005","00","050","0008","0225","407","258","149","3","410","1154","0","35.53","22.36"
"10","005","00","050","0009","0000","1289","906","383","12","1301","3066","0","42.43","29.55"
"10","005","00","050","0009","0226","472","340","132","6","478","1018","0","46.95","33.40"
"10","005","00","050","0009","0227","422","288","134","3","425","1043","0","40.75","27.61"
"10","005","00","050","0009","0228","395","278","117","3","398","1005","0","39.60","27.66"
"10","005","00","050","0010","0000","578","382","196","2","580","1574","0","36.85","24.27"
"10","005","00","050","0010","0232","268","178","90","0","268","773","0","34.67","23.03"
"10","005","00","050","0010","0233","310","204","106","2","312","801","0","38.95","25.47"
"10","005","00","050","0011","0000","337","226","111","4","341","977","0","34.90","23.13"
"10","005","00","050","0011","0231","337","226","111","4","341","977","0","34.90","23.13"
"10","005","00","050","0012","0000","487","291","196","6","493","1036","0","47.59","28.09"
"10","005","00","050","0012","0238","487","291","196","6","493","1036","0","47.59","28.09"
"10","005","00","050","0013","0000","790","551","239","10","800","2007","0","39.86","27.45"
"10","005","00","050","0013","0261","392","284","108","6","398","998","0","39.88","28.46"
"10","005","00","050","0013","0262","398","267","131","4","402","1009","0","39.84","26.46"
"10","005","00","050","0014","0000","1541","1029","512","9","1550","4392","0","35.29","23.43"
"10","005","00","050","0014","0265","545","384","161","4","549","1497","0","36.67","25.65"
"10","005","00","050","0014","0266","491","334","157","3","494","1434","0","34.45","23.29"
"10","005","00","050","0014","0267","505","311","194","2","507","1461","0","34.70","21.29"
"10","005","00","050","0015","0000","1725","1061","664","8","1733","4339","0","39.94","24.45"
"10","005","00","050","0015","0242","570","348","222","1","571","1356","0","42.11","25.66"
"10","005","00","050","0015","0243","570","363","207","1","571","1486","0","38.43","24.43"
"10","005","00","050","0015","0244","585","350","235","6","591","1497","0","39.48","23.38"
"10","005","00","050","0016","0000","1537","1017","520","16","1553","4022","0","38.61","25.29"
"10","005","00","050","0016","0239","559","379","180","4","563","1294","0","43.51","29.29"
"10","005","00","050","0016","0240","504","322","182","5","509","1424","0","35.74","22.61"
"10","005","00","050","0016","0241","474","316","158","7","481","1304","0","36.89","24.23"
"10","005","00","050","0017","0000","1180","780","400","7","1187","3306","0","35.90","23.59"
"10","005","00","050","0017","0252","436","271","165","2","438","1129","0","38.80","24.00"
"10","005","00","050","0017","0253","415","304","111","1","416","1152","0","36.11","26.39"
"10","005","00","050","0017","0254","329","205","124","4","333","1025","0","32.49","20.00"
"10","005","00","050","0018","0000","1413","911","502","5","1418","3987","0","35.57","22.85"
"10","005","00","050","0018","0268","450","306","144","1","451","1266","0","35.62","24.17"
"10","005","00","050","0018","0269","481","298","183","3","484","1341","0","36.09","22.22"
"10","005","00","050","0018","0270","482","307","175","1","483","1380","0","35.00","22.25"
"10","005","00","050","0019","0000","503","293","210","4","507","1289","0","39.33","22.73"
"10","005","00","050","0019","0273","503","293","210","4","507","1289","0","39.33","22.73"
"10","005","00","050","0020","0000","646","406","240","8","654","2144","0","30.50","18.94"
"10","005","00","050","0020","0234","355","238","117","5","360","938","0","38.38","25.37"
"10","005","00","050","0020","0235","291","168","123","3","294","1206","0","24.38","13.93"
"10","005","00","050","0021","0000","888","595","293","7","895","2511","0","35.64","23.70"
"10","005","00","050","0021","0236","407","281","126","6","413","1185","0","34.85","23.71"
"10","005","00","050","0021","0237","481","314","167","1","482","1326","0","36.35","23.68"
"10","005","00","050","0022","0000","522","362","160","5","527","1295","0","40.69","27.95"
"10","005","00","050","0022","0274","522","362","160","5","527","1295","0","40.69","27.95"
"10","005","00","050","0023","0000","917","639","278","5","922","2511","0","36.72","25.45"
"10","005","00","050","0023","0276","473","345","128","3","476","1278","0","37.25","27.00"
"10","005","00","050","0023","0277","444","294","150","2","446","1233","0","36.17","23.84"
"10","005","00","050","0024","0000","365","263","102","7","372","878","0","42.37","29.95"
"10","005","00","050","0024","0275","365","263","102","7","372","878","0","42.37","29.95"
"10","005","00","050","0025","0000","825","588","237","12","837","2216","0","37.77","26.53"
"10","005","00","050","0025","0278","399","295","104","6","405","1068","0","37.92","27.62"
"10","005","00","050","0025","0279","426","293","133","6","432","1148","0","37.63","25.52"
"10","005","00","050","0026","0000","862","521","341","5","867","2277","0","38.08","22.88"
"10","005","00","050","0026","0263","446","276","170","1","447","1137","0","39.31","24.27"
"10","005","00","050","0026","0264","416","245","171","4","420","1140","0","36.84","21.49"
"10","005","00","050","0027","0000","824","544","280","9","833","2362","0","35.27","23.03"
"10","005","00","050","0027","0271","393","268","125","7","400","1222","0","32.73","21.93"
"10","005","00","050","0027","0272","431","276","155","2","433","1140","0","37.98","24.21"
"10","005","00","050","0028","0000","1381","932","449","10","1391","3387","0","41.07","27.52"
"10","005","00","050","0028","0255","488","322","166","1","489","1261","0","38.78","25.54"
"10","005","00","050","0028","0256","457","314","143","2","459","1115","0","41.17","28.16"
"10","005","00","050","0028","0257","436","296","140","7","443","1011","0","43.82","29.28"
"10","005","00","050","0029","0000","1316","920","396","16","1332","3570","0","37.31","25.77"
"10","005","00","050","0029","0258","452","326","126","3","455","1144","0","39.77","28.50"
"10","005","00","050","0029","0259","464","307","157","5","469","1278","0","36.70","24.02"
"10","005","00","050","0029","0260","400","287","113","8","408","1148","0","35.54","25.00"
"10","005","00","050","0030","0000","778","501","277","6","784","1951","0","40.18","25.68"
"10","005","00","050","0030","0229","411","257","154","2","413","948","0","43.57","27.11"
"10","005","00","050","0030","0230","367","244","123","4","371","1003","0","36.99","24.33"
"10","005","00","050","0031","0000","915","604","311","11","926","2514","0","36.83","24.03"
"10","005","00","050","0031","0245","418","277","141","4","422","1206","0","34.99","22.97"
"10","005","00","050","0031","0246","497","327","170","7","504","1308","0","38.53","25.00"
"10","005","00","050","0032","0000","1342","817","525","11","1353","3515","0","38.49","23.24"
"10","005","00","050","0032","0247","400","253","147","2","402","1115","0","36.05","22.69"
"10","005","00","050","0032","0248","475","280","195","2","477","1131","0","42.18","24.76"
"10","005","00","050","0032","0249","467","284","183","7","474","1269","0","37.35","22.38"
"10","005","00","050","0033","0000","1010","679","331","6","1016","2774","0","36.63","24.48"
"10","005","00","050","0033","0250","526","380","146","3","529","1400","0","37.79","27.14"
"10","005","00","050","0033","0251","484","299","185","3","487","1374","0","35.44","21.76"
"10","005","00","060","0000","0000","10190","5349","4841","120","10310","30244","34941","34.09","17.69"
"10","005","00","060","0001","0000","461","246","215","5","466","1399","0","33.31","17.58"
"10","005","00","060","0001","0280","176","104","72","2","178","573","0","31.06","18.15"
"10","005","00","060","0001","0281","285","142","143","3","288","826","0","34.87","17.19"
"10","005","00","060","0002","0000","315","152","163","3","318","731","0","43.50","20.79"
"10","005","00","060","0002","0282","315","152","163","3","318","731","0","43.50","20.79"
"10","005","00","060","0003","0000","499","237","262","5","504","1248","0","40.38","18.99"
"10","005","00","060","0003","0283","248","105","143","3","251","623","0","40.29","16.85"
"10","005","00","060","0003","0284","251","132","119","2","253","625","0","40.48","21.12"
"10","005","00","060","0004","0000","1477","814","663","5","1482","4216","0","35.15","19.31"
"10","005","00","060","0004","0285","383","212","171","1","384","1108","0","34.66","19.13"
"10","005","00","060","0004","0286","434","234","200","1","435","1258","0","34.58","18.60"
"10","005","00","060","0004","0287","350","190","160","3","353","983","0","35.91","19.33"
"10","005","00","060","0004","0288","310","178","132","0","310","867","0","35.76","20.53"
"10","005","00","060","0005","0000","691","393","298","10","701","2258","0","31.05","17.40"
"10","005","00","060","0005","0303","328","189","139","5","333","1062","0","31.36","17.80"
"10","005","00","060","0005","0304","363","204","159","5","368","1196","0","30.77","17.06"
"10","005","00","060","0006","0000","512","346","166","3","515","1219","0","42.25","28.38"
"10","005","00","060","0006","0293","512","346","166","3","515","1219","0","42.25","28.38"
"10","005","00","060","0007","0000","393","262","131","5","398","1026","0","38.79","25.54"
"10","005","00","060","0007","0294","393","262","131","5","398","1026","0","38.79","25.54"
"10","005","00","060","0008","0000","844","440","404","17","861","2669","0","32.26","16.49"
"10","005","00","060","0008","0295","296","147","149","5","301","936","0","32.16","15.71"
"10","005","00","060","0008","0296","304","150","154","7","311","899","0","34.59","16.69"
"10","005","00","060","0008","0297","244","143","101","5","249","834","0","29.86","17.15"
"10","005","00","060","0009","0000","492","278","214","4","496","1304","0","38.04","21.32"
"10","005","00","060","0009","0298","264","150","114","2","266","685","0","38.83","21.90"
"10","005","00","060","0009","0299","228","128","100","2","230","619","0","37.16","20.68"
"10","005","00","060","0010","0000","241","120","121","2","243","679","0","35.79","17.67"
"10","005","00","060","0010","0300","241","120","121","2","243","679","0","35.79","17.67"
"10","005","00","060","0011","0000","445","207","238","4","449","1462","0","30.71","14.16"
"10","005","00","060","0011","0289","197","80","117","3","200","649","0","30.82","12.33"
"10","005","00","060","0011","0290","248","127","121","1","249","813","0","30.63","15.62"
"10","005","00","060","0012","0000","494","236","258","6","500","1503","0","33.27","15.70"
"10","005","00","060","0012","0301","244","117","127","4","248","723","0","34.30","16.18"
"10","005","00","060","0012","0302","250","119","131","2","252","780","0","32.31","15.26"
"10","005","00","060","0013","0000","379","171","208","9","388","1231","0","31.52","13.89"
"10","005","00","060","0013","0291","379","171","208","9","388","1231","0","31.52","13.89"
"10","005","00","060","0014","0000","307","147","160","4","311","957","0","32.50","15.36"
"10","005","00","060","0014","0292","307","147","160","4","311","957","0","32.50","15.36"
"10","005","00","060","0015","0000","302","176","126","3","305","982","0","31.06","17.92"
"10","005","00","060","0015","0305","302","176","126","3","305","982","0","31.06","17.92"
"10","005","00","060","0016","0000","268","122","146","6","274","897","0","30.55","13.60"
"10","005","00","060","0016","0306","268","122","146","6","274","897","0","30.55","13.60"
"10","005","00","060","0017","0000","240","111","129","3","243","682","0","35.63","16.28"
"10","005","00","060","0017","0307","240","111","129","3","243","682","0","35.63","16.28"
"10","005","00","060","0018","0000","338","166","172","5","343","1023","0","33.53","16.23"
"10","005","00","060","0018","0308","338","166","172","5","343","1023","0","33.53","16.23"
"10","005","00","060","0019","0000","209","109","100","4","213","591","0","36.04","18.44"
"10","005","00","060","0019","0309","209","109","100","4","213","591","0","36.04","18.44"
"10","005","00","060","0020","0000","409","169","240","4","413","1251","0","33.01","13.51"
"10","005","00","060","0020","0310","409","169","240","4","413","1251","0","33.01","13.51"
"10","005","00","060","0021","0000","213","107","106","3","216","718","0","30.08","14.90"
"10","005","00","060","0021","0311","213","107","106","3","216","718","0","30.08","14.90"
"10","005","00","060","0022","0000","304","170","134","6","310","1010","0","30.69","16.83"
"10","005","00","060","0022","0312","117","62","55","2","119","405","0","29.38","15.31"
"10","005","00","060","0022","0313","187","108","79","4","191","605","0","31.57","17.85"
"10","005","00","060","0023","0000","357","170","187","4","361","1188","0","30.39","14.31"
"10","005","00","060","0023","0314","218","124","94","4","222","720","0","30.83","17.22"
"10","005","00","060","0023","0315","139","46","93","0","139","468","0","29.70","9.83"
"10","005","00","070","0000","0000","5299","2679","2620","57","5356","14189","16007","37.75","18.88"
"10","005","00","070","0001","0000","316","168","148","2","318","698","0","45.56","24.07"
"10","005","00","070","0001","0319","316","168","148","2","318","698","0","45.56","24.07"
"10","005","00","070","0002","0000","599","322","277","8","607","1479","0","41.04","21.77"
"10","005","00","070","0002","0320","310","180","130","3","313","765","0","40.92","23.53"
"10","005","00","070","0002","0321","289","142","147","5","294","714","0","41.18","19.89"
"10","005","00","070","0003","0000","755","353","402","6","761","1991","0","38.22","17.73"
"10","005","00","070","0003","0325","296","134","162","3","299","842","0","35.51","15.91"
"10","005","00","070","0003","0326","299","126","173","1","300","787","0","38.12","16.01"
"10","005","00","070","0003","0327","160","93","67","2","162","362","0","44.75","25.69"
"10","005","00","070","0004","0000","351","165","186","6","357","937","0","38.10","17.61"
"10","005","00","070","0004","0322","351","165","186","6","357","937","0","38.10","17.61"
"10","005","00","070","0005","0000","238","137","101","1","239","674","0","35.46","20.33"
"10","005","00","070","0005","0323","238","137","101","1","239","674","0","35.46","20.33"
"10","005","00","070","0006","0000","273","148","125","2","275","923","0","29.79","16.03"
"10","005","00","070","0006","0333","273","148","125","2","275","923","0","29.79","16.03"
"10","005","00","070","0007","0000","744","370","374","6","750","1876","0","39.98","19.72"
"10","005","00","070","0007","0316","373","179","194","4","377","895","0","42.12","20.00"
"10","005","00","070","0007","0317","371","191","180","2","373","981","0","38.02","19.47"
"10","005","00","070","0008","0000","423","184","239","6","429","1056","0","40.63","17.42"
"10","005","00","070","0008","0318","423","184","239","6","429","1056","0","40.63","17.42"
"10","005","00","070","0009","0000","741","357","384","3","744","2071","0","35.92","17.24"
"10","005","00","070","0009","0328","237","104","133","1","238","640","0","37.19","16.25"
"10","005","00","070","0009","0329","256","107","149","1","257","746","0","34.45","14.34"
"10","005","00","070","0009","0330","248","146","102","1","249","685","0","36.35","21.31"
"10","005","00","070","0010","0000","265","128","137","5","270","702","0","38.46","18.23"
"10","005","00","070","0010","0324","265","128","137","5","270","702","0","38.46","18.23"
"10","005","00","070","0011","0000","343","187","156","6","349","1067","0","32.71","17.53"
"10","005","00","070","0011","0331","343","187","156","6","349","1067","0","32.71","17.53"
"10","005","00","070","0012","0000","251","160","91","6","257","715","0","35.94","22.38"
"10","005","00","070","0012","0332","251","160","91","6","257","715","0","35.94","22.38"
"10","005","00","080","0000","0000","4108","2799","1309","52","4160","12068","13686","34.47","23.19"
"10","005","00","080","0001","0000","633","450","183","5","638","1539","0","41.46","29.24"
"10","005","00","080","0001","0334","307","216","91","2","309","696","0","44.40","31.03"
"10","005","00","080","0001","0335","326","234","92","3","329","843","0","39.03","27.76"
"10","005","00","080","0002","0000","256","201","55","1","257","557","0","46.14","36.09"
"10","005","00","080","0002","0336","256","201","55","1","257","557","0","46.14","36.09"
"10","005","00","080","0003","0000","593","434","159","10","603","1714","0","35.18","25.32"
"10","005","00","080","0003","0338","260","197","63","7","267","840","0","31.79","23.45"
"10","005","00","080","0003","0339","333","237","96","3","336","874","0","38.44","27.12"
"10","005","00","080","0004","0000","390","238","152","6","396","1323","0","29.93","17.99"
"10","005","00","080","0004","0340","390","238","152","6","396","1323","0","29.93","17.99"
"10","005","00","080","0005","0000","172","129","43","3","175","529","0","33.08","24.39"
"10","005","00","080","0005","0341","172","129","43","3","175","529","0","33.08","24.39"
"10","005","00","080","0006","0000","423","285","138","4","427","1155","0","36.97","24.68"
"10","005","00","080","0006","0337","423","285","138","4","427","1155","0","36.97","24.68"
"10","005","00","080","0007","0000","221","146","75","1","222","599","0","37.06","24.37"
"10","005","00","080","0007","0342","221","146","75","1","222","599","0","37.06","24.37"
"10","005","00","080","0008","0000","428","270","158","8","436","1448","0","30.11","18.65"
"10","005","00","080","0008","0345","184","110","74","2","186","621","0","29.95","17.71"
"10","005","00","080","0008","0346","244","160","84","6","250","827","0","30.23","19.35"
"10","005","00","080","0009","0000","234","158","76","3","237","739","0","32.07","21.38"
"10","005","00","080","0009","0343","234","158","76","3","237","739","0","32.07","21.38"
"10","005","00","080","0010","0000","182","131","51","2","184","484","0","38.02","27.07"
"10","005","00","080","0010","0344","182","131","51","2","184","484","0","38.02","27.07"
"10","005","00","080","0011","0000","278","183","95","4","282","988","0","28.54","18.52"
"10","005","00","080","0011","0347","278","183","95","4","282","988","0","28.54","18.52"
"10","005","00","080","0012","0000","298","174","124","5","303","993","0","30.51","17.52"
"10","005","00","080","0012","0348","298","174","124","5","303","993","0","30.51","17.52"
"10","005","00","090","0000","0000","10603","7051","3552","121","10724","27661","32119","38.77","25.49"
"10","005","00","090","0001","0000","645","393","252","3","648","1507","0","43.00","26.08"
"10","005","00","090","0001","0349","338","195","143","1","339","751","0","45.14","25.97"
"10","005","00","090","0001","0350","307","198","109","2","309","756","0","40.87","26.19"
"10","005","00","090","0002","0000","930","648","282","9","939","2286","0","41.08","28.35"
"10","005","00","090","0002","0351","425","310","115","5","430","1064","0","40.41","29.14"
"10","005","00","090","0002","0352","505","338","167","4","509","1222","0","41.65","27.66"
"10","005","00","090","0003","0000","1257","848","409","17","1274","3412","0","37.34","24.85"
"10","005","00","090","0003","0353","434","304","130","6","440","1142","0","38.53","26.62"
"10","005","00","090","0003","0354","420","276","144","5","425","1176","0","36.14","23.47"
"10","005","00","090","0003","0355","403","268","135","6","409","1094","0","37.39","24.50"
"10","005","00","090","0004","0000","349","212","137","5","354","921","0","38.44","23.02"
"10","005","00","090","0004","0360","349","212","137","5","354","921","0","38.44","23.02"
"10","005","00","090","0005","0000","763","500","263","12","775","2259","0","34.31","22.13"
"10","005","00","090","0005","0356","416","291","125","8","424","1175","0","36.09","24.77"
"10","005","00","090","0005","0357","347","209","138","4","351","1084","0","32.38","19.28"
"10","005","00","090","0006","0000","923","606","317","4","927","2296","0","40.37","26.39"
"10","005","00","090","0006","0358","510","335","175","1","511","1248","0","40.95","26.84"
"10","005","00","090","0006","0359","413","271","142","3","416","1048","0","39.69","25.86"
"10","005","00","090","0007","0000","521","372","149","3","524","1448","0","36.19","25.69"
"10","005","00","090","0007","0365","273","192","81","0","273","684","0","39.91","28.07"
"10","005","00","090","0007","0366","248","180","68","3","251","764","0","32.85","23.56"
"10","005","00","090","0008","0000","390","284","106","7","397","995","0","39.90","28.54"
"10","005","00","090","0008","0361","390","284","106","7","397","995","0","39.90","28.54"
"10","005","00","090","0009","0000","784","527","257","13","797","2019","0","39.47","26.10"
"10","005","00","090","0009","0363","323","218","105","6","329","820","0","40.12","26.59"
"10","005","00","090","0009","0364","461","309","152","7","468","1199","0","39.03","25.77"
"10","005","00","090","0010","0000","105","82","23","1","106","280","0","37.86","29.29"
"10","005","00","090","0010","0367","105","82","23","1","106","280","0","37.86","29.29"
"10","005","00","090","0011","0000","160","91","69","2","162","339","0","47.79","26.84"
"10","005","00","090","0011","0362","160","91","69","2","162","339","0","47.79","26.84"
"10","005","00","090","0012","0000","857","533","324","17","874","2213","0","39.49","24.08"
"10","005","00","090","0012","0368","506","318","188","12","518","1304","0","39.72","24.39"
"10","005","00","090","0012","0369","351","215","136","5","356","909","0","39.16","23.65"
"10","005","00","090","0013","0000","532","357","175","8","540","1453","0","37.16","24.57"
"10","005","00","090","0013","0370","302","208","94","6","308","731","0","42.13","28.45"
"10","005","00","090","0013","0371","230","149","81","2","232","722","0","32.13","20.64"
"10","005","00","090","0014","0000","643","445","198","7","650","1579","0","41.17","28.18"
"10","005","00","090","0014","0372","335","228","107","4","339","871","0","38.92","26.18"
"10","005","00","090","0014","0373","308","217","91","3","311","708","0","43.93","30.65"
"10","005","00","090","0015","0000","537","358","179","3","540","1427","0","37.84","25.09"
"10","005","00","090","0015","0374","223","151","72","2","225","678","0","33.19","22.27"
"10","005","00","090","0015","0375","314","207","107","1","315","749","0","42.06","27.64"
"10","005","00","090","0016","0000","480","325","155","2","482","1270","0","37.95","25.59"
"10","005","00","090","0016","0378","480","325","155","2","482","1270","0","37.95","25.59"
"10","005","00","090","0017","0000","536","333","203","6","542","1415","0","38.30","23.53"
"10","005","00","090","0017","0376","273","167","106","2","275","705","0","39.01","23.69"
"10","005","00","090","0017","0377","263","166","97","4","267","710","0","37.61","23.38"
"10","005","00","090","0018","0000","87","71","16","2","89","213","0","41.78","33.33"
"10","005","00","090","0018","0379","87","71","16","2","89","213","0","41.78","33.33"
"10","005","00","090","0019","0000","104","66","38","0","104","329","0","31.61","20.06"
"10","005","00","090","0019","0380","104","66","38","0","104","329","0","31.61","20.06"
"10","005","00","100","0000","0000","5634","3965","1669","49","5683","14892","17039","38.16","26.63"
"10","005","00","100","0001","0000","410","347","63","2","412","940","0","43.83","36.91"
"10","005","00","100","0001","0387","410","347","63","2","412","940","0","43.83","36.91"
"10","005","00","100","0002","0000","1723","1211","512","15","1738","4334","0","40.10","27.94"
"10","005","00","100","0002","0381","384","273","111","5","389","850","0","45.76","32.12"
"10","005","00","100","0002","0382","453","307","146","1","454","1006","0","45.13","30.52"
"10","005","00","100","0002","0383","487","350","137","3","490","1293","0","37.90","27.07"
"10","005","00","100","0002","0384","399","281","118","6","405","1185","0","34.18","23.71"
"10","005","00","100","0003","0000","681","489","192","5","686","1617","0","42.42","30.24"
"10","005","00","100","0003","0388","379","282","97","3","382","909","0","42.02","31.02"
"10","005","00","100","0003","0389","302","207","95","2","304","708","0","42.94","29.24"
"10","005","00","100","0004","0000","404","273","131","9","413","1247","0","33.12","21.89"
"10","005","00","100","0004","0385","404","273","131","9","413","1247","0","33.12","21.89"
"10","005","00","100","0005","0000","418","295","123","4","422","1142","0","36.95","25.83"
"10","005","00","100","0005","0386","418","295","123","4","422","1142","0","36.95","25.83"
"10","005","00","100","0006","0000","331","244","87","0","331","1021","0","32.42","23.90"
"10","005","00","100","0006","0390","331","244","87","0","331","1021","0","32.42","23.90"
"10","005","00","100","0007","0000","1109","735","374","6","1115","3115","0","35.79","23.60"
"10","005","00","100","0007","0391","423","272","151","2","425","1070","0","39.72","25.42"
"10","005","00","100","0007","0392","279","189","90","1","280","830","0","33.73","22.77"
"10","005","00","100","0007","0393","407","274","133","3","410","1215","0","33.74","22.55"
"10","005","00","100","0008","0000","188","123","65","3","191","540","0","35.37","22.78"
"10","005","00","100","0008","0394","188","123","65","3","191","540","0","35.37","22.78"
"10","005","00","100","0009","0000","143","92","51","2","145","411","0","35.28","22.38"
"10","005","00","100","0009","0395","143","92","51","2","145","411","0","35.28","22.38"
"10","005","00","100","0010","0000","227","156","71","3","230","525","0","43.81","29.71"
"10","005","00","100","0010","0396","227","156","71","3","230","525","0","43.81","29.71"
"10","005","00","110","0000","0000","2850","2076","774","38","2888","8353","9430","34.57","24.85"
"10","005","00","110","0001","0000","417","312","105","4","421","1102","0","38.20","28.31"
"10","005","00","110","0001","0397","417","312","105","4","421","1102","0","38.20","28.31"
"10","005","00","110","0002","0000","223","156","67","2","225","609","0","36.95","25.62"
"10","005","00","110","0002","0398","223","156","67","2","225","609","0","36.95","25.62"
"10","005","00","110","0003","0000","369","279","90","5","374","1283","0","29.15","21.75"
"10","005","00","110","0003","0399","369","279","90","5","374","1283","0","29.15","21.75"
"10","005","00","110","0004","0000","274","189","85","3","277","793","0","34.93","23.83"
"10","005","00","110","0004","0400","274","189","85","3","277","793","0","34.93","23.83"
"10","005","00","110","0005","0000","264","184","80","4","268","793","0","33.80","23.20"
"10","005","00","110","0005","0401","264","184","80","4","268","793","0","33.80","23.20"
"10","005","00","110","0006","0000","464","328","136","8","472","1037","0","45.52","31.63"
"10","005","00","110","0006","0402","464","328","136","8","472","1037","0","45.52","31.63"
"10","005","00","110","0007","0000","383","259","124","2","385","986","0","39.05","26.27"
"10","005","00","110","0007","0403","383","259","124","2","385","986","0","39.05","26.27"
"10","005","00","110","0008","0000","231","185","46","3","234","838","0","27.92","22.08"
"10","005","00","110","0008","0404","231","185","46","3","234","838","0","27.92","22.08"
"10","005","00","110","0009","0000","225","184","41","7","232","912","0","25.44","20.18"
"10","005","00","110","0009","0405","225","184","41","7","232","912","0","25.44","20.18"
"10","005","00","120","0000","0000","3676","2544","1132","33","3709","9023","10112","41.11","28.19"
"10","005","00","120","0001","0000","983","700","283","5","988","2420","0","40.83","28.93"
"10","005","00","120","0001","0406","477","337","140","3","480","1287","0","37.30","26.18"
"10","005","00","120","0001","0407","506","363","143","2","508","1133","0","44.84","32.04"
"10","005","00","120","0002","0000","686","454","232","7","693","1786","0","38.80","25.42"
"10","005","00","120","0002","0413","305","200","105","1","306","817","0","37.45","24.48"
"10","005","00","120","0002","0414","381","254","127","6","387","969","0","39.94","26.21"
"10","005","00","120","0003","0000","244","184","60","2","246","687","0","35.81","26.78"
"10","005","00","120","0003","0410","244","184","60","2","246","687","0","35.81","26.78"
"10","005","00","120","0004","0000","651","455","196","9","660","1635","0","40.37","27.83"
"10","005","00","120","0004","0408","308","217","91","4","312","756","0","41.27","28.70"
"10","005","00","120","0004","0409","343","238","105","5","348","879","0","39.59","27.08"
"10","005","00","120","0005","0000","398","268","130","1","399","848","0","47.05","31.60"
"10","005","00","120","0005","0411","398","268","130","1","399","848","0","47.05","31.60"
"10","005","00","120","0006","0000","164","114","50","1","165","377","0","43.77","30.24"
"10","005","00","120","0006","0412","164","114","50","1","165","377","0","43.77","30.24"
"10","005","00","120","0007","0000","424","291","133","6","430","968","0","44.42","30.06"
"10","005","00","120","0007","0415","328","234","94","4","332","758","0","43.80","30.87"
"10","005","00","120","0007","0416","96","57","39","2","98","210","0","46.67","27.14"
"10","005","00","120","0008","0000","126","78","48","2","128","302","0","42.38","25.83"
"10","005","00","120","0008","0417","126","78","48","2","128","302","0","42.38","25.83"
"10","005","00","130","0000","0000","5293","3490","1803","59","5352","13373","15480","40.02","26.10"
"10","005","00","130","0001","0000","1588","1082","506","18","1606","3909","0","41.08","27.68"
"10","005","00","130","0001","0418","314","229","85","1","315","793","0","39.72","28.88"
"10","005","00","130","0001","0419","400","280","120","4","404","935","0","43.21","29.95"
"10","005","00","130","0001","0420","402","252","150","8","410","1024","0","40.04","24.61"
"10","005","00","130","0001","0421","472","321","151","5","477","1157","0","41.23","27.74"
"10","005","00","130","0002","0000","691","474","217","4","695","1787","0","38.89","26.52"
"10","005","00","130","0002","0427","364","247","117","3","367","979","0","37.49","25.23"
"10","005","00","130","0002","0428","327","227","100","1","328","808","0","40.59","28.09"
"10","005","00","130","0003","0000","487","336","151","3","490","1321","0","37.09","25.44"
"10","005","00","130","0003","0425","269","182","87","2","271","727","0","37.28","25.03"
"10","005","00","130","0003","0426","218","154","64","1","219","594","0","36.87","25.93"
"10","005","00","130","0004","0000","1325","836","489","17","1342","3286","0","40.84","25.44"
"10","005","00","130","0004","0422","359","242","117","10","369","994","0","37.12","24.35"
"10","005","00","130","0004","0423","454","273","181","1","455","1094","0","41.59","24.95"
"10","005","00","130","0004","0424","512","321","191","6","518","1198","0","43.24","26.79"
"10","005","00","130","0005","0000","566","419","147","11","577","1427","0","40.43","29.36"
"10","005","00","130","0005","0429","286","214","72","6","292","684","0","42.69","31.29"
"10","005","00","130","0005","0430","280","205","75","5","285","743","0","38.36","27.59"
"10","005","00","130","0006","0000","170","123","47","0","170","402","0","42.29","30.60"
"10","005","00","130","0006","0431","170","123","47","0","170","402","0","42.29","30.60"
"10","005","00","130","0007","0000","466","220","246","6","472","1241","0","38.03","17.73"
"10","005","00","130","0007","0432","220","111","109","1","221","619","0","35.70","17.93"
"10","005","00","130","0007","0433","246","109","137","5","251","622","0","40.35","17.52"
"10","005","00","140","0000","0000","2107","1513","594","28","2135","6133","6635","34.81","24.67"
"10","005","00","140","0001","0000","230","185","45","4","234","595","0","39.33","31.09"
"10","005","00","140","0001","0434","230","185","45","4","234","595","0","39.33","31.09"
"10","005","00","140","0002","0000","194","152","42","4","198","564","0","35.11","26.95"
"10","005","00","140","0002","0435","194","152","42","4","198","564","0","35.11","26.95"
"10","005","00","140","0003","0000","279","198","81","4","283","790","0","35.82","25.06"
"10","005","00","140","0003","0436","279","198","81","4","283","790","0","35.82","25.06"
"10","005","00","140","0004","0000","205","152","53","2","207","627","0","33.01","24.24"
"10","005","00","140","0004","0437","205","152","53","2","207","627","0","33.01","24.24"
"10","005","00","140","0005","0000","181","130","51","1","182","482","0","37.76","26.97"
"10","005","00","140","0005","0440","181","130","51","1","182","482","0","37.76","26.97"
"10","005","00","140","0006","0000","150","91","59","3","153","446","0","34.30","20.40"
"10","005","00","140","0006","0439","150","91","59","3","153","446","0","34.30","20.40"
"10","005","00","140","0007","0000","314","218","96","4","318","871","0","36.51","25.03"
"10","005","00","140","0007","0438","314","218","96","4","318","871","0","36.51","25.03"
"10","005","00","140","0008","0000","340","242","98","3","343","1112","0","30.85","21.76"
"10","005","00","140","0008","0441","340","242","98","3","343","1112","0","30.85","21.76"
"10","005","00","140","0009","0000","214","145","69","3","217","646","0","33.59","22.45"
"10","005","00","140","0009","0442","214","145","69","3","217","646","0","33.59","22.45"
"10","005","00","150","0000","0000","3910","2518","1392","34","3944","10732","12084","36.75","23.46"
"10","005","00","150","0001","0000","754","524","230","8","762","2010","0","37.91","26.07"
"10","005","00","150","0001","0443","424","292","132","5","429","1135","0","37.80","25.73"
"10","005","00","150","0001","0444","330","232","98","3","333","875","0","38.06","26.51"
"10","005","00","150","0002","0000","175","126","49","1","176","442","0","39.82","28.51"
"10","005","00","150","0002","0445","175","126","49","1","176","442","0","39.82","28.51"
"10","005","00","150","0003","0000","376","251","125","5","381","969","0","39.32","25.90"
"10","005","00","150","0003","0446","376","251","125","5","381","969","0","39.32","25.90"
"10","005","00","150","0004","0000","1204","792","412","8","1212","3315","0","36.56","23.89"
"10","005","00","150","0004","0447","417","243","174","4","421","1163","0","36.20","20.89"
"10","005","00","150","0004","0448","406","305","101","2","408","1043","0","39.12","29.24"
"10","005","00","150","0004","0449","381","244","137","2","383","1109","0","34.54","22.00"
"10","005","00","150","0005","0000","182","124","58","3","185","479","0","38.62","25.89"
"10","005","00","150","0005","0450","182","124","58","3","185","479","0","38.62","25.89"
"10","005","00","150","0006","0000","192","126","66","0","192","485","0","39.59","25.98"
"10","005","00","150","0006","0451","192","126","66","0","192","485","0","39.59","25.98"
"10","005","00","150","0007","0000","435","246","189","5","440","1252","0","35.14","19.65"
"10","005","00","150","0007","0452","435","246","189","5","440","1252","0","35.14","19.65"
"10","005","00","150","0008","0000","291","181","110","2","293","837","0","35.01","21.62"
"10","005","00","150","0008","0453","291","181","110","2","293","837","0","35.01","21.62"
"10","005","00","150","0009","0000","301","148","153","2","303","943","0","32.13","15.69"
"10","005","00","150","0009","0454","301","148","153","2","303","943","0","32.13","15.69"
"10","005","00","160","0000","0000","2135","1466","669","30","2165","5579","6259","38.81","26.28"
"10","005","00","160","0001","0000","772","522","250","3","775","2118","0","36.59","24.65"
"10","005","00","160","0001","0455","390","263","127","1","391","965","0","40.52","27.25"
"10","005","00","160","0001","0456","382","259","123","2","384","1153","0","33.30","22.46"
"10","005","00","160","0002","0000","267","183","84","6","273","613","0","44.54","29.85"
"10","005","00","160","0002","0457","267","183","84","6","273","613","0","44.54","29.85"
"10","005","00","160","0003","0000","320","237","83","5","325","822","0","39.54","28.83"
"10","005","00","160","0003","0458","320","237","83","5","325","822","0","39.54","28.83"
"10","005","00","160","0004","0000","73","46","27","1","74","227","0","32.60","20.26"
"10","005","00","160","0004","0459","73","46","27","1","74","227","0","32.60","20.26"
"10","005","00","160","0005","0000","160","100","60","6","166","517","0","32.11","19.34"
"10","005","00","160","0005","0460","160","100","60","6","166","517","0","32.11","19.34"
"10","005","00","160","0006","0000","201","136","65","3","204","523","0","39.01","26.00"
"10","005","00","160","0006","0461","201","136","65","3","204","523","0","39.01","26.00"
"10","005","00","160","0007","0000","181","121","60","3","184","391","0","47.06","30.95"
"10","005","00","160","0007","0462","181","121","60","3","184","391","0","47.06","30.95"
"10","005","00","160","0008","0000","161","121","40","3","164","368","0","44.57","32.88"
"10","005","00","160","0008","0463","161","121","40","3","164","368","0","44.57","32.88"
"10","005","00","170","0000","0000","1414","1026","388","25","1439","3782","4094","38.05","27.13"
"10","005","00","170","0001","0000","93","82","11","2","95","322","0","29.50","25.47"
"10","005","00","170","0001","0464","93","82","11","2","95","322","0","29.50","25.47"
"10","005","00","170","0002","0000","203","145","58","5","208","531","0","39.17","27.31"
"10","005","00","170","0002","0465","203","145","58","5","208","531","0","39.17","27.31"
"10","005","00","170","0003","0000","318","224","94","6","324","869","0","37.28","25.78"
"10","005","00","170","0003","0466","318","224","94","6","324","869","0","37.28","25.78"
"10","005","00","170","0004","0000","199","134","65","1","200","539","0","37.11","24.86"
"10","005","00","170","0004","0467","199","134","65","1","200","539","0","37.11","24.86"
"10","005","00","170","0005","0000","200","150","50","5","205","548","0","37.41","27.37"
"10","005","00","170","0005","0468","200","150","50","5","205","548","0","37.41","27.37"
"10","005","00","170","0006","0000","123","88","35","3","126","323","0","39.01","27.24"
"10","005","00","170","0006","0469","123","88","35","3","126","323","0","39.01","27.24"
"10","005","00","170","0007","0000","278","203","75","3","281","650","0","43.23","31.23"
"10","005","00","170","0007","0470","278","203","75","3","281","650","0","43.23","31.23"
"10","005","00","180","0000","0000","1515","1250","265","26","1541","4995","5695","30.85","25.03"
"10","005","00","180","0001","0000","84","64","20","2","86","336","0","25.60","19.05"
"10","005","00","180","0001","0471","84","64","20","2","86","336","0","25.60","19.05"
"10","005","00","180","0002","0000","313","256","57","3","316","1070","0","29.53","23.93"
"10","005","00","180","0002","0472","108","92","16","1","109","455","0","23.96","20.22"
"10","005","00","180","0002","0473","205","164","41","2","207","615","0","33.66","26.67"
"10","005","00","180","0003","0000","289","228","61","4","293","871","0","33.64","26.18"
"10","005","00","180","0003","0474","197","153","44","3","200","567","0","35.27","26.98"
"10","005","00","180","0003","0475","92","75","17","1","93","304","0","30.59","24.67"
"10","005","00","180","0004","0000","190","161","29","2","192","480","0","40.00","33.54"
"10","005","00","180","0004","0476","190","161","29","2","192","480","0","40.00","33.54"
"10","005","00","180","0005","0000","130","109","21","1","131","501","0","26.15","21.76"
"10","005","00","180","0005","0477","130","109","21","1","131","501","0","26.15","21.76"
"10","005","00","180","0006","0000","133","107","26","4","137","481","0","28.48","22.25"
"10","005","00","180","0006","0478","133","107","26","4","137","481","0","28.48","22.25"
"10","005","00","180","0007","0000","179","147","32","4","183","666","0","27.48","22.07"
"10","005","00","180","0007","0479","179","147","32","4","183","666","0","27.48","22.07"
"10","005","00","180","0008","0000","197","178","19","6","203","590","0","34.41","30.17"
"10","005","00","180","0008","0480","197","178","19","6","203","590","0","34.41","30.17"
"10","007","00","000","0000","0000","390290","184623","205667","4265","394555","1061571","1260388","37.17","17.39"
"10","007","00","010","0000","0000","79698","38916","40782","690","80388","189909","229765","42.33","20.49"
"10","007","00","010","0001","0000","530","255","275","6","536","1253","0","42.78","20.35"
"10","007","00","010","0001","0119","295","147","148","3","298","666","0","44.74","22.07"
"10","007","00","010","0001","0120","235","108","127","3","238","587","0","40.55","18.40"
"10","007","00","010","0002","0000","2122","1064","1058","16","2138","4972","0","43.00","21.40"
"10","007","00","010","0002","0127","432","219","213","1","433","1101","0","39.33","19.89"
"10","007","00","010","0002","0128","412","209","203","3","415","1020","0","40.69","20.49"
"10","007","00","010","0002","0129","451","225","226","4","455","1012","0","44.96","22.23"
"10","007","00","010","0002","0130","389","201","188","3","392","898","0","43.65","22.38"
"10","007","00","010","0002","0131","438","210","228","5","443","941","0","47.08","22.32"
"10","007","00","010","0003","0000","678","306","372","4","682","1603","0","42.55","19.09"
"10","007","00","010","0003","0114","328","150","178","2","330","753","0","43.82","19.92"
"10","007","00","010","0003","0115","350","156","194","2","352","850","0","41.41","18.35"
"10","007","00","010","0004","0000","376","177","199","4","380","760","0","50.00","23.29"
"10","007","00","010","0004","0116","376","177","199","4","380","760","0","50.00","23.29"
"10","007","00","010","0005","0000","574","295","279","5","579","1331","0","43.50","22.16"
"10","007","00","010","0005","0117","283","131","152","3","286","639","0","44.76","20.50"
"10","007","00","010","0005","0118","291","164","127","2","293","692","0","42.34","23.70"
"10","007","00","010","0006","0000","745","346","399","8","753","1723","0","43.70","20.08"
"10","007","00","010","0006","0121","382","174","208","6","388","906","0","42.83","19.21"
"10","007","00","010","0006","0122","363","172","191","2","365","817","0","44.68","21.05"
"10","007","00","010","0007","0000","1720","808","912","12","1732","3835","0","45.16","21.07"
"10","007","00","010","0007","0123","449","202","247","1","450","976","0","46.11","20.70"
"10","007","00","010","0007","0124","438","222","216","5","443","944","0","46.93","23.52"
"10","007","00","010","0007","0125","380","169","211","2","382","827","0","46.19","20.44"
"10","007","00","010","0007","0126","453","215","238","4","457","1088","0","42.00","19.76"
"10","007","00","010","0008","0000","2267","1044","1223","16","2283","5212","0","43.80","20.03"
"10","007","00","010","0008","0107","522","220","302","7","529","1170","0","45.21","18.80"
"10","007","00","010","0008","0108","395","177","218","3","398","919","0","43.31","19.26"
"10","007","00","010","0008","0109","400","155","245","3","403","943","0","42.74","16.44"
"10","007","00","010","0008","0110","399","203","196","2","401","965","0","41.55","21.04"
"10","007","00","010","0008","0111","551","289","262","1","552","1215","0","45.43","23.79"
"10","007","00","010","0009","0000","763","381","382","11","774","1718","0","45.05","22.18"
"10","007","00","010","0009","0112","360","168","192","6","366","849","0","43.11","19.79"
"10","007","00","010","0009","0113","403","213","190","5","408","869","0","46.95","24.51"
"10","007","00","010","0010","0000","831","390","441","4","835","1895","0","44.06","20.58"
"10","007","00","010","0010","0105","432","211","221","2","434","1001","0","43.36","21.08"
"10","007","00","010","0010","0106","399","179","220","2","401","894","0","44.85","20.02"
"10","007","00","010","0011","0000","345","197","148","2","347","762","0","45.54","25.85"
"10","007","00","010","0011","0104","345","197","148","2","347","762","0","45.54","25.85"
"10","007","00","010","0012","0000","641","330","311","8","649","1377","0","47.13","23.97"
"10","007","00","010","0012","0102","315","147","168","3","318","646","0","49.23","22.76"
"10","007","00","010","0012","0103","326","183","143","5","331","731","0","45.28","25.03"
"10","007","00","010","0013","0000","396","162","234","2","398","862","0","46.17","18.79"
"10","007","00","010","0013","0100","396","162","234","2","398","862","0","46.17","18.79"
"10","007","00","010","0014","0000","262","91","171","4","266","642","0","41.43","14.17"
"10","007","00","010","0014","0099","262","91","171","4","266","642","0","41.43","14.17"
"10","007","00","010","0015","0000","361","158","203","1","362","706","0","51.27","22.38"
"10","007","00","010","0015","0101","361","158","203","1","362","706","0","51.27","22.38"
"10","007","00","010","0016","0000","383","133","250","1","384","864","0","44.44","15.39"
"10","007","00","010","0016","0054","383","133","250","1","384","864","0","44.44","15.39"
"10","007","00","010","0017","0000","374","153","221","3","377","748","0","50.40","20.45"
"10","007","00","010","0017","0051","374","153","221","3","377","748","0","50.40","20.45"
"10","007","00","010","0018","0000","387","143","244","6","393","863","0","45.54","16.57"
"10","007","00","010","0018","0052","387","143","244","6","393","863","0","45.54","16.57"
"10","007","00","010","0019","0000","465","215","250","5","470","1067","0","44.05","20.15"
"10","007","00","010","0019","0053","465","215","250","5","470","1067","0","44.05","20.15"
"10","007","00","010","0020","0000","1470","703","767","9","1479","3304","0","44.76","21.28"
"10","007","00","010","0020","0056","464","205","259","3","467","1035","0","45.12","19.81"
"10","007","00","010","0020","0057","571","283","288","2","573","1251","0","45.80","22.62"
"10","007","00","010","0020","0058","435","215","220","4","439","1018","0","43.12","21.12"
"10","007","00","010","0021","0000","1555","812","743","14","1569","3585","0","43.77","22.65"
"10","007","00","010","0021","0059","535","285","250","2","537","1147","0","46.82","24.85"
"10","007","00","010","0021","0060","501","245","256","7","508","1260","0","40.32","19.44"
"10","007","00","010","0021","0061","519","282","237","5","524","1178","0","44.48","23.94"
"10","007","00","010","0022","0000","528","257","271","4","532","1129","0","47.12","22.76"
"10","007","00","010","0022","0065","528","257","271","4","532","1129","0","47.12","22.76"
"10","007","00","010","0023","0000","1328","675","653","16","1344","3158","0","42.56","21.37"
"10","007","00","010","0023","0062","457","213","244","6","463","1037","0","44.65","20.54"
"10","007","00","010","0023","0063","475","240","235","6","481","1078","0","44.62","22.26"
"10","007","00","010","0023","0064","396","222","174","4","400","1043","0","38.35","21.28"
"10","007","00","010","0024","0000","1525","767","758","18","1543","4175","0","36.96","18.37"
"10","007","00","010","0024","0066","378","189","189","6","384","1010","0","38.02","18.71"
"10","007","00","010","0024","0067","388","187","201","3","391","1081","0","36.17","17.30"
"10","007","00","010","0024","0068","352","181","171","2","354","943","0","37.54","19.19"
"10","007","00","010","0024","0069","407","210","197","7","414","1141","0","36.28","18.40"
"10","007","00","010","0025","0000","458","184","274","2","460","930","0","49.46","19.78"
"10","007","00","010","0025","0055","458","184","274","2","460","930","0","49.46","19.78"
"10","007","00","010","0026","0000","1390","634","756","13","1403","3505","0","40.03","18.09"
"10","007","00","010","0026","0091","421","182","239","1","422","1182","0","35.70","15.40"
"10","007","00","010","0026","0092","469","205","264","6","475","1074","0","44.23","19.09"
"10","007","00","010","0026","0093","500","247","253","6","506","1249","0","40.51","19.78"
"10","007","00","010","0027","0000","884","440","444","9","893","2137","0","41.79","20.59"
"10","007","00","010","0027","0089","465","236","229","5","470","1166","0","40.31","20.24"
"10","007","00","010","0027","0090","419","204","215","4","423","971","0","43.56","21.01"
"10","007","00","010","0028","0000","734","333","401","5","739","1884","0","39.23","17.68"
"10","007","00","010","0028","0087","323","126","197","1","324","839","0","38.62","15.02"
"10","007","00","010","0028","0088","411","207","204","4","415","1045","0","39.71","19.81"
"10","007","00","010","0029","0000","1321","632","689","14","1335","3079","0","43.36","20.53"
"10","007","00","010","0029","0084","370","170","200","2","372","885","0","42.03","19.21"
"10","007","00","010","0029","0085","484","241","243","8","492","1109","0","44.36","21.73"
"10","007","00","010","0029","0086","467","221","246","4","471","1085","0","43.41","20.37"
"10","007","00","010","0030","0000","1268","628","640","8","1276","3285","0","38.84","19.12"
"10","007","00","010","0030","0094","438","213","225","1","439","1190","0","36.89","17.90"
"10","007","00","010","0030","0095","444","228","216","3","447","1024","0","43.65","22.27"
"10","007","00","010","0030","0096","386","187","199","4","390","1071","0","36.41","17.46"
"10","007","00","010","0031","0000","1679","827","852","18","1697","4235","0","40.07","19.53"
"10","007","00","010","0031","0070","393","200","193","4","397","973","0","40.80","20.55"
"10","007","00","010","0031","0071","443","189","254","6","449","1136","0","39.52","16.64"
"10","007","00","010","0031","0072","428","233","195","3","431","1079","0","39.94","21.59"
"10","007","00","010","0031","0073","415","205","210","5","420","1047","0","40.11","19.58"
"10","007","00","010","0032","0000","961","466","495","7","968","2424","0","39.93","19.22"
"10","007","00","010","0032","0001","386","199","187","2","388","881","0","44.04","22.59"
"10","007","00","010","0032","0002","202","98","104","3","205","663","0","30.92","14.78"
"10","007","00","010","0032","0003","373","169","204","2","375","880","0","42.61","19.20"
"10","007","00","010","0033","0000","1090","581","509","12","1102","2437","0","45.22","23.84"
"10","007","00","010","0033","0097","515","260","255","7","522","1196","0","43.65","21.74"
"10","007","00","010","0033","0098","575","321","254","5","580","1241","0","46.74","25.87"
"10","007","00","010","0034","0000","676","317","359","7","683","1511","0","45.20","20.98"
"10","007","00","010","0034","0004","328","145","183","7","335","751","0","44.61","19.31"
"10","007","00","010","0034","0005","348","172","176","0","348","760","0","45.79","22.63"
"10","007","00","010","0035","0000","454","208","246","4","458","974","0","47.02","21.36"
"10","007","00","010","0035","0010","454","208","246","4","458","974","0","47.02","21.36"
"10","007","00","010","0036","0000","544","266","278","3","547","1169","0","46.79","22.75"
"10","007","00","010","0036","0011","544","266","278","3","547","1169","0","46.79","22.75"
"10","007","00","010","0037","0000","746","407","339","6","752","1770","0","42.49","22.99"
"10","007","00","010","0037","0008","315","182","133","1","316","741","0","42.65","24.56"
"10","007","00","010","0037","0009","431","225","206","5","436","1029","0","42.37","21.87"
"10","007","00","010","0038","0000","634","323","311","5","639","1426","0","44.81","22.65"
"10","007","00","010","0038","0006","300","167","133","2","302","699","0","43.20","23.89"
"10","007","00","010","0038","0007","334","156","178","3","337","727","0","46.35","21.46"
"10","007","00","010","0039","0000","3237","1580","1657","18","3255","7458","0","43.64","21.19"
"10","007","00","010","0039","0035","402","203","199","1","403","1022","0","39.43","19.86"
"10","007","00","010","0039","0036","490","248","242","2","492","1090","0","45.14","22.75"
"10","007","00","010","0039","0037","536","264","272","4","540","1193","0","45.26","22.13"
"10","007","00","010","0039","0038","487","220","267","1","488","1094","0","44.61","20.11"
"10","007","00","010","0039","0039","487","256","231","2","489","1105","0","44.25","23.17"
"10","007","00","010","0039","0040","403","185","218","1","404","1013","0","39.88","18.26"
"10","007","00","010","0039","0041","432","204","228","7","439","941","0","46.65","21.68"
"10","007","00","010","0040","0000","656","320","336","4","660","1470","0","44.90","21.77"
"10","007","00","010","0040","0042","330","156","174","3","333","694","0","47.98","22.48"
"10","007","00","010","0040","0043","326","164","162","1","327","776","0","42.14","21.13"
"10","007","00","010","0041","0000","2084","1020","1064","19","2103","4938","0","42.59","20.66"
"10","007","00","010","0041","0025","461","244","217","2","463","1173","0","39.47","20.80"
"10","007","00","010","0041","0026","418","213","205","1","419","1040","0","40.29","20.48"
"10","007","00","010","0041","0027","584","243","341","8","592","1350","0","43.85","18.00"
"10","007","00","010","0041","0028","621","320","301","8","629","1375","0","45.75","23.27"
"10","007","00","010","0042","0000","3128","1487","1641","26","3154","7515","0","41.97","19.79"
"10","007","00","010","0042","0029","584","250","334","9","593","1363","0","43.51","18.34"
"10","007","00","010","0042","0030","423","192","231","0","423","1063","0","39.79","18.06"
"10","007","00","010","0042","0031","486","236","250","1","487","1222","0","39.85","19.31"
"10","007","00","010","0042","0032","576","271","305","6","582","1267","0","45.94","21.39"
"10","007","00","010","0042","0033","534","275","259","4","538","1323","0","40.67","20.79"
"10","007","00","010","0042","0034","525","263","262","6","531","1277","0","41.58","20.60"
"10","007","00","010","0043","0000","1224","582","642","7","1231","2775","0","44.36","20.97"
"10","007","00","010","0043","0045","379","180","199","3","382","835","0","45.75","21.56"
"10","007","00","010","0043","0046","401","191","210","2","403","899","0","44.83","21.25"
"10","007","00","010","0043","0047","444","211","233","2","446","1041","0","42.84","20.27"
"10","007","00","010","0044","0000","1252","583","669","16","1268","2845","0","44.57","20.49"
"10","007","00","010","0044","0048","419","195","224","6","425","1011","0","42.04","19.29"
"10","007","00","010","0044","0049","376","154","222","6","382","855","0","44.68","18.01"
"10","007","00","010","0044","0050","457","234","223","4","461","979","0","47.09","23.90"
"10","007","00","010","0045","0000","638","317","321","3","641","1419","0","45.17","22.34"
"10","007","00","010","0045","0014","349","175","174","2","351","797","0","44.04","21.96"
"10","007","00","010","0045","0015","289","142","147","1","290","622","0","46.62","22.83"
"10","007","00","010","0046","0000","960","565","395","4","964","2598","0","37.11","21.75"
"10","007","00","010","0046","0016","576","370","206","2","578","1206","0","47.93","30.68"
"10","007","00","010","0046","0017","384","195","189","2","386","1392","0","27.73","14.01"
"10","007","00","010","0047","0000","3773","1906","1867","25","3798","8962","0","42.38","21.27"
"10","007","00","010","0047","0018","536","283","253","5","541","1315","0","41.14","21.52"
"10","007","00","010","0047","0019","523","266","257","4","527","1214","0","43.41","21.91"
"10","007","00","010","0047","0020","474","244","230","4","478","1157","0","41.31","21.09"
"10","007","00","010","0047","0021","493","212","281","3","496","1274","0","38.93","16.64"
"10","007","00","010","0047","0022","683","347","336","7","690","1518","0","45.45","22.86"
"10","007","00","010","0047","0023","511","261","250","1","512","1167","0","43.87","22.37"
"10","007","00","010","0047","0024","553","293","260","1","554","1317","0","42.07","22.25"
"10","007","00","010","0048","0000","1019","550","469","9","1028","2240","0","45.89","24.55"
"10","007","00","010","0048","0012","495","259","236","5","500","1082","0","46.21","23.94"
"10","007","00","010","0048","0013","524","291","233","4","528","1158","0","45.60","25.13"
"10","007","00","010","0049","0000","449","212","237","9","458","981","0","46.69","21.61"
"10","007","00","010","0049","0044","449","212","237","9","458","981","0","46.69","21.61"
"10","007","00","010","0050","0000","1315","635","680","9","1324","3193","0","41.47","19.89"
"10","007","00","010","0050","0180","421","188","233","3","424","994","0","42.66","18.91"
"10","007","00","010","0050","0181","455","249","206","5","460","1095","0","42.01","22.74"
"10","007","00","010","0050","0182","439","198","241","1","440","1104","0","39.86","17.93"
"10","007","00","010","0051","0000","634","329","305","10","644","1653","0","38.96","19.90"
"10","007","00","010","0051","0156","315","184","131","1","316","782","0","40.41","23.53"
"10","007","00","010","0051","0157","319","145","174","9","328","871","0","37.66","16.65"
"10","007","00","010","0052","0000","787","386","401","8","795","1899","0","41.86","20.33"
"10","007","00","010","0052","0177","363","186","177","4","367","930","0","39.46","20.00"
"10","007","00","010","0052","0178","424","200","224","4","428","969","0","44.17","20.64"
"10","007","00","010","0053","0000","1308","603","705","14","1322","3295","0","40.12","18.30"
"10","007","00","010","0053","0158","401","181","220","8","409","972","0","42.08","18.62"
"10","007","00","010","0053","0159","458","191","267","4","462","1172","0","39.42","16.30"
"10","007","00","010","0053","0160","449","231","218","2","451","1151","0","39.18","20.07"
"10","007","00","010","0054","0000","1239","545","694","16","1255","2951","0","42.53","18.47"
"10","007","00","010","0054","0161","392","163","229","5","397","889","0","44.66","18.34"
"10","007","00","010","0054","0162","450","216","234","5","455","1071","0","42.48","20.17"
"10","007","00","010","0054","0163","397","166","231","6","403","991","0","40.67","16.75"
"10","007","00","010","0055","0000","2712","1230","1482","32","2744","6731","0","40.77","18.27"
"10","007","00","010","0055","0171","437","211","226","3","440","1123","0","39.18","18.79"
"10","007","00","010","0055","0172","444","234","210","9","453","1253","0","36.15","18.68"
"10","007","00","010","0055","0173","488","209","279","2","490","1155","0","42.42","18.10"
"10","007","00","010","0055","0174","484","201","283","7","491","1188","0","41.33","16.92"
"10","007","00","010","0055","0175","474","204","270","7","481","1091","0","44.09","18.70"
"10","007","00","010","0055","0176","385","171","214","4","389","921","0","42.24","18.57"
"10","007","00","010","0056","0000","961","436","525","11","972","2426","0","40.07","17.97"
"10","007","00","010","0056","0154","457","232","225","6","463","1331","0","34.79","17.43"
"10","007","00","010","0056","0155","504","204","300","5","509","1095","0","46.48","18.63"
"10","007","00","010","0057","0000","436","209","227","3","439","1183","0","37.11","17.67"
"10","007","00","010","0057","0179","436","209","227","3","439","1183","0","37.11","17.67"
"10","007","00","010","0058","0000","1016","453","563","13","1029","2414","0","42.63","18.77"
"10","007","00","010","0058","0168","326","138","188","6","332","754","0","44.03","18.30"
"10","007","00","010","0058","0169","378","169","209","4","382","881","0","43.36","19.18"
"10","007","00","010","0058","0170","312","146","166","3","315","779","0","40.44","18.74"
"10","007","00","010","0059","0000","480","217","263","8","488","1222","0","39.93","17.76"
"10","007","00","010","0059","0136","480","217","263","8","488","1222","0","39.93","17.76"
"10","007","00","010","0060","0000","381","190","191","7","388","936","0","41.45","20.30"
"10","007","00","010","0060","0132","381","190","191","7","388","936","0","41.45","20.30"
"10","007","00","010","0061","0000","1239","613","626","16","1255","2915","0","43.05","21.03"
"10","007","00","010","0061","0133","407","208","199","6","413","941","0","43.89","22.10"
"10","007","00","010","0061","0134","396","177","219","6","402","956","0","42.05","18.51"
"10","007","00","010","0061","0135","436","228","208","4","440","1018","0","43.22","22.40"
"10","007","00","010","0062","0000","3345","1746","1599","24","3369","8423","0","40.00","20.73"
"10","007","00","010","0062","0140","518","280","238","2","520","1160","0","44.83","24.14"
"10","007","00","010","0062","0141","455","242","213","4","459","1317","0","34.85","18.38"
"10","007","00","010","0062","0142","466","240","226","2","468","1191","0","39.29","20.15"
"10","007","00","010","0062","0143","458","256","202","0","458","1123","0","40.78","22.80"
"10","007","00","010","0062","0144","492","274","218","6","498","1278","0","38.97","21.44"
"10","007","00","010","0062","0145","431","209","222","5","436","1157","0","37.68","18.06"
"10","007","00","010","0062","0146","525","245","280","5","530","1197","0","44.28","20.47"
"10","007","00","010","0063","0000","929","419","510","6","935","2377","0","39.34","17.63"
"10","007","00","010","0063","0137","345","158","187","4","349","799","0","43.68","19.77"
"10","007","00","010","0063","0138","328","147","181","2","330","878","0","37.59","16.74"
"10","007","00","010","0063","0139","256","114","142","0","256","700","0","36.57","16.29"
"10","007","00","010","0064","0000","1773","909","864","21","1794","4046","0","44.34","22.47"
"10","007","00","010","0064","0150","410","196","214","9","419","969","0","43.24","20.23"
"10","007","00","010","0064","0151","419","211","208","4","423","920","0","45.98","22.93"
"10","007","00","010","0064","0152","462","260","202","3","465","1095","0","42.47","23.74"
"10","007","00","010","0064","0153","482","242","240","5","487","1062","0","45.86","22.79"
"10","007","00","010","0065","0000","1126","562","564","6","1132","2634","0","42.98","21.34"
"10","007","00","010","0065","0147","403","184","219","0","403","855","0","47.13","21.52"
"10","007","00","010","0065","0148","343","176","167","3","346","851","0","40.66","20.68"
"10","007","00","010","0065","0149","380","202","178","3","383","928","0","41.27","21.77"
"10","007","00","010","0066","0000","416","201","215","7","423","1132","0","37.37","17.76"
"10","007","00","010","0066","0187","416","201","215","7","423","1132","0","37.37","17.76"
"10","007","00","010","0067","0000","469","223","246","5","474","1249","0","37.95","17.85"
"10","007","00","010","0067","0186","469","223","246","5","474","1249","0","37.95","17.85"
"10","007","00","010","0068","0000","322","134","188","2","324","840","0","38.57","15.95"
"10","007","00","010","0068","0185","322","134","188","2","324","840","0","38.57","15.95"
"10","007","00","010","0069","0000","360","182","178","0","360","885","0","40.68","20.56"
"10","007","00","010","0069","0183","360","182","178","0","360","885","0","40.68","20.56"
"10","007","00","010","0070","0000","459","211","248","2","461","1114","0","41.38","18.94"
"10","007","00","010","0070","0184","459","211","248","2","461","1114","0","41.38","18.94"
"10","007","00","010","0071","0000","1667","912","755","9","1676","4349","0","38.54","20.97"
"10","007","00","010","0071","0164","416","234","182","2","418","1032","0","40.50","22.67"
"10","007","00","010","0071","0165","401","210","191","1","402","1129","0","35.61","18.60"
"10","007","00","010","0071","0166","428","240","188","4","432","1123","0","38.47","21.37"
"10","007","00","010","0071","0167","422","228","194","2","424","1065","0","39.81","21.41"
"10","007","00","010","0072","0000","2255","1153","1102","15","2270","5297","0","42.85","21.77"
"10","007","00","010","0072","0074","520","281","239","4","524","1231","0","42.57","22.83"
"10","007","00","010","0072","0075","471","236","235","2","473","1067","0","44.33","22.12"
"10","007","00","010","0072","0076","428","226","202","3","431","1025","0","42.05","22.05"
"10","007","00","010","0072","0077","420","193","227","2","422","969","0","43.55","19.92"
"10","007","00","010","0072","0078","416","217","199","4","420","1005","0","41.79","21.59"
"10","007","00","010","0073","0000","2184","1188","996","14","2198","5234","0","41.99","22.70"
"10","007","00","010","0073","0079","512","306","206","3","515","1147","0","44.90","26.68"
"10","007","00","010","0073","0080","368","184","184","3","371","933","0","39.76","19.72"
"10","007","00","010","0073","0081","417","199","218","1","418","988","0","42.31","20.14"
"10","007","00","010","0073","0082","439","250","189","4","443","1012","0","43.77","24.70"
"10","007","00","010","0073","0083","448","249","199","3","451","1154","0","39.08","21.58"
"10","007","00","020","0000","0000","25930","11089","14841","278","26208","70613","86115","37.11","15.70"
"10","007","00","020","0001","0000","466","175","291","3","469","1109","0","42.29","15.78"
"10","007","00","020","0001","0247","466","175","291","3","469","1109","0","42.29","15.78"
"10","007","00","020","0002","0000","220","74","146","1","221","506","0","43.68","14.62"
"10","007","00","020","0002","0248","220","74","146","1","221","506","0","43.68","14.62"
"10","007","00","020","0003","0000","315","124","191","0","315","847","0","37.19","14.64"
"10","007","00","020","0003","0249","315","124","191","0","315","847","0","37.19","14.64"
"10","007","00","020","0004","0000","377","138","239","2","379","906","0","41.83","15.23"
"10","007","00","020","0004","0250","377","138","239","2","379","906","0","41.83","15.23"
"10","007","00","020","0005","0000","2876","1183","1693","28","2904","7832","0","37.08","15.10"
"10","007","00","020","0005","0308","471","167","304","5","476","1330","0","35.79","12.56"
"10","007","00","020","0005","0309","523","222","301","4","527","1348","0","39.09","16.47"
"10","007","00","020","0005","0310","499","215","284","8","507","1535","0","33.03","14.01"
"10","007","00","020","0005","0311","478","193","285","4","482","1129","0","42.69","17.09"
"10","007","00","020","0005","0312","437","182","255","2","439","1209","0","36.31","15.05"
"10","007","00","020","0005","0313","468","204","264","5","473","1281","0","36.92","15.93"
"10","007","00","020","0006","0000","1813","760","1053","18","1831","5195","0","35.25","14.63"
"10","007","00","020","0006","0304","392","201","191","3","395","1207","0","32.73","16.65"
"10","007","00","020","0006","0305","443","181","262","9","452","1192","0","37.92","15.18"
"10","007","00","020","0006","0306","452","149","303","3","455","1297","0","35.08","11.49"
"10","007","00","020","0006","0307","526","229","297","3","529","1499","0","35.29","15.28"
"10","007","00","020","0007","0000","1920","695","1225","27","1947","5046","0","38.59","13.77"
"10","007","00","020","0007","0251","360","117","243","3","363","973","0","37.31","12.02"
"10","007","00","020","0007","0252","462","158","304","5","467","1104","0","42.30","14.31"
"10","007","00","020","0007","0253","288","112","176","4","292","829","0","35.22","13.51"
"10","007","00","020","0007","0254","281","125","156","5","286","731","0","39.12","17.10"
"10","007","00","020","0007","0255","529","183","346","10","539","1409","0","38.25","12.99"
"10","007","00","020","0008","0000","1596","529","1067","16","1612","4391","0","36.71","12.05"
"10","007","00","020","0008","0258","391","108","283","4","395","1033","0","38.24","10.45"
"10","007","00","020","0008","0259","451","133","318","4","455","1098","0","41.44","12.11"
"10","007","00","020","0008","0260","359","119","240","4","363","1072","0","33.86","11.10"
"10","007","00","020","0008","0261","395","169","226","4","399","1188","0","33.59","14.23"
"10","007","00","020","0009","0000","216","79","137","2","218","521","0","41.84","15.16"
"10","007","00","020","0009","0262","216","79","137","2","218","521","0","41.84","15.16"
"10","007","00","020","0010","0000","399","140","259","1","400","837","0","47.79","16.73"
"10","007","00","020","0010","0256","399","140","259","1","400","837","0","47.79","16.73"
"10","007","00","020","0011","0000","447","155","292","5","452","1126","0","40.14","13.77"
"10","007","00","020","0011","0257","447","155","292","5","452","1126","0","40.14","13.77"
"10","007","00","020","0012","0000","470","210","260","5","475","1084","0","43.82","19.37"
"10","007","00","020","0012","0267","470","210","260","5","475","1084","0","43.82","19.37"
"10","007","00","020","0013","0000","495","206","289","4","499","1130","0","44.16","18.23"
"10","007","00","020","0013","0268","495","206","289","4","499","1130","0","44.16","18.23"
"10","007","00","020","0014","0000","123","56","67","1","124","267","0","46.44","20.97"
"10","007","00","020","0014","0269","123","56","67","1","124","267","0","46.44","20.97"
"10","007","00","020","0015","0000","280","110","170","4","284","618","0","45.95","17.80"
"10","007","00","020","0015","0271","280","110","170","4","284","618","0","45.95","17.80"
"10","007","00","020","0016","0000","248","106","142","3","251","574","0","43.73","18.47"
"10","007","00","020","0016","0270","248","106","142","3","251","574","0","43.73","18.47"
"10","007","00","020","0017","0000","409","116","293","4","413","877","0","47.09","13.23"
"10","007","00","020","0017","0272","409","116","293","4","413","877","0","47.09","13.23"
"10","007","00","020","0018","0000","996","394","602","13","1009","2170","0","46.50","18.16"
"10","007","00","020","0018","0273","504","168","336","7","511","1047","0","48.81","16.05"
"10","007","00","020","0018","0274","492","226","266","6","498","1123","0","44.35","20.12"
"10","007","00","020","0019","0000","1328","700","628","12","1340","3879","0","34.54","18.05"
"10","007","00","020","0019","0291","497","251","246","4","501","1529","0","32.77","16.42"
"10","007","00","020","0019","0292","429","230","199","6","435","1101","0","39.51","20.89"
"10","007","00","020","0019","0293","402","219","183","2","404","1249","0","32.35","17.53"
"10","007","00","020","0020","0000","901","441","460","15","916","2598","0","35.26","16.97"
"10","007","00","020","0020","0294","259","120","139","5","264","858","0","30.77","13.99"
"10","007","00","020","0020","0295","258","159","99","4","262","704","0","37.22","22.59"
"10","007","00","020","0020","0296","384","162","222","6","390","1036","0","37.64","15.64"
"10","007","00","020","0021","0000","1326","683","643","13","1339","4105","0","32.62","16.64"
"10","007","00","020","0021","0301","483","249","234","7","490","1431","0","34.24","17.40"
"10","007","00","020","0021","0302","376","206","170","4","380","1223","0","31.07","16.84"
"10","007","00","020","0021","0303","467","228","239","2","469","1451","0","32.32","15.71"
"10","007","00","020","0022","0000","1454","758","696","17","1471","4124","0","35.67","18.38"
"10","007","00","020","0022","0297","323","191","132","7","330","928","0","35.56","20.58"
"10","007","00","020","0022","0298","369","165","204","5","374","1102","0","33.94","14.97"
"10","007","00","020","0022","0299","358","212","146","2","360","882","0","40.82","24.04"
"10","007","00","020","0022","0300","404","190","214","3","407","1212","0","33.58","15.68"
"10","007","00","020","0023","0000","1169","621","548","8","1177","3189","0","36.91","19.47"
"10","007","00","020","0023","0283","381","211","170","2","383","1006","0","38.07","20.97"
"10","007","00","020","0023","0284","383","206","177","2","385","1026","0","37.52","20.08"
"10","007","00","020","0023","0285","405","204","201","4","409","1157","0","35.35","17.63"
"10","007","00","020","0024","0000","716","389","327","12","728","2191","0","33.23","17.75"
"10","007","00","020","0024","0286","339","194","145","7","346","1181","0","29.30","16.43"
"10","007","00","020","0024","0287","377","195","182","5","382","1010","0","37.82","19.31"
"10","007","00","020","0025","0000","1059","467","592","9","1068","3032","0","35.22","15.40"
"10","007","00","020","0025","0288","371","146","225","2","373","1051","0","35.49","13.89"
"10","007","00","020","0025","0289","353","155","198","5","358","1006","0","35.59","15.41"
"10","007","00","020","0025","0290","335","166","169","2","337","975","0","34.56","17.03"
"10","007","00","020","0026","0000","1180","471","709","14","1194","3575","0","33.40","13.17"
"10","007","00","020","0026","0277","426","168","258","8","434","1154","0","37.61","14.56"
"10","007","00","020","0026","0278","402","171","231","2","404","1208","0","33.44","14.16"
"10","007","00","020","0026","0279","352","132","220","4","356","1213","0","29.35","10.88"
"10","007","00","020","0027","0000","670","284","386","2","672","2076","0","32.37","13.68"
"10","007","00","020","0027","0275","417","185","232","0","417","1326","0","31.45","13.95"
"10","007","00","020","0027","0276","253","99","154","2","255","750","0","34.00","13.20"
"10","007","00","020","0028","0000","893","379","514","22","915","2425","0","37.73","15.63"
"10","007","00","020","0028","0280","307","174","133","6","313","950","0","32.95","18.32"
"10","007","00","020","0028","0281","298","111","187","12","310","735","0","42.18","15.10"
"10","007","00","020","0028","0282","288","94","194","4","292","740","0","39.46","12.70"
"10","007","00","020","0029","0000","1568","646","922","17","1585","4383","0","36.16","14.74"
"10","007","00","020","0029","0263","402","180","222","5","407","1153","0","35.30","15.61"
"10","007","00","020","0029","0264","406","154","252","5","411","1138","0","36.12","13.53"
"10","007","00","020","0029","0265","389","178","211","2","391","1066","0","36.68","16.70"
"10","007","00","020","0029","0266","371","134","237","5","376","1026","0","36.65","13.06"
"10","007","00","030","0000","0000","27347","12969","14378","289","27636","75185","89825","36.76","17.25"
"10","007","00","030","0001","0000","2140","1075","1065","20","2160","6113","0","35.33","17.59"
"10","007","00","030","0001","0386","397","183","214","2","399","1157","0","34.49","15.82"
"10","007","00","030","0001","0387","422","185","237","5","427","1327","0","32.18","13.94"
"10","007","00","030","0001","0388","474","264","210","0","474","1318","0","35.96","20.03"
"10","007","00","030","0001","0389","481","273","208","5","486","1301","0","37.36","20.98"
"10","007","00","030","0001","0390","366","170","196","8","374","1010","0","37.03","16.83"
"10","007","00","030","0002","0000","1646","789","857","12","1658","4323","0","38.35","18.25"
"10","007","00","030","0002","0391","361","160","201","5","366","1064","0","34.40","15.04"
"10","007","00","030","0002","0392","399","197","202","1","400","1007","0","39.72","19.56"
"10","007","00","030","0002","0393","397","188","209","4","401","1004","0","39.94","18.73"
"10","007","00","030","0002","0394","489","244","245","2","491","1248","0","39.34","19.55"
"10","007","00","030","0003","0000","181","99","82","0","181","398","0","45.48","24.87"
"10","007","00","030","0003","0395","181","99","82","0","181","398","0","45.48","24.87"
"10","007","00","030","0004","0000","625","292","333","5","630","1796","0","35.08","16.26"
"10","007","00","030","0004","0396","320","145","175","0","320","816","0","39.22","17.77"
"10","007","00","030","0004","0397","305","147","158","5","310","980","0","31.63","15.00"
"10","007","00","030","0005","0000","1215","589","626","14","1229","3164","0","38.84","18.62"
"10","007","00","030","0005","0398","423","212","211","5","428","1035","0","41.35","20.48"
"10","007","00","030","0005","0399","400","190","210","5","405","1094","0","37.02","17.37"
"10","007","00","030","0005","0400","392","187","205","4","396","1035","0","38.26","18.07"
"10","007","00","030","0006","0000","1017","461","556","9","1026","2785","0","36.84","16.55"
"10","007","00","030","0006","0401","523","202","321","5","528","1406","0","37.55","14.37"
"10","007","00","030","0006","0402","494","259","235","4","498","1379","0","36.11","18.78"
"10","007","00","030","0007","0000","540","276","264","10","550","1672","0","32.89","16.51"
"10","007","00","030","0007","0403","263","134","129","5","268","816","0","32.84","16.42"
"10","007","00","030","0007","0404","277","142","135","5","282","856","0","32.94","16.59"
"10","007","00","030","0008","0000","339","176","163","4","343","847","0","40.50","20.78"
"10","007","00","030","0008","0444","339","176","163","4","343","847","0","40.50","20.78"
"10","007","00","030","0009","0000","802","349","453","8","810","2119","0","38.23","16.47"
"10","007","00","030","0009","0405","503","199","304","6","509","1351","0","37.68","14.73"
"10","007","00","030","0009","0406","299","150","149","2","301","768","0","39.19","19.53"
"10","007","00","030","0010","0000","1058","524","534","12","1070","2869","0","37.30","18.26"
"10","007","00","030","0010","0407","498","245","253","8","506","1457","0","34.73","16.82"
"10","007","00","030","0010","0408","560","279","281","4","564","1412","0","39.94","19.76"
"10","007","00","030","0011","0000","466","236","230","2","468","1464","0","31.97","16.12"
"10","007","00","030","0011","0409","209","89","120","1","210","673","0","31.20","13.22"
"10","007","00","030","0011","0410","257","147","110","1","258","791","0","32.62","18.58"
"10","007","00","030","0012","0000","613","290","323","12","625","1857","0","33.66","15.62"
"10","007","00","030","0012","0411","325","160","165","4","329","970","0","33.92","16.49"
"10","007","00","030","0012","0412","288","130","158","8","296","887","0","33.37","14.66"
"10","007","00","030","0013","0000","810","379","431","8","818","2204","0","37.11","17.20"
"10","007","00","030","0013","0413","424","182","242","5","429","1151","0","37.27","15.81"
"10","007","00","030","0013","0414","386","197","189","3","389","1053","0","36.94","18.71"
"10","007","00","030","0014","0000","457","201","256","6","463","1318","0","35.13","15.25"
"10","007","00","030","0014","0415","457","201","256","6","463","1318","0","35.13","15.25"
"10","007","00","030","0015","0000","2006","981","1025","10","2016","5228","0","38.56","18.76"
"10","007","00","030","0015","0416","450","233","217","1","451","1162","0","38.81","20.05"
"10","007","00","030","0015","0417","491","225","266","4","495","1285","0","38.52","17.51"
"10","007","00","030","0015","0418","491","237","254","2","493","1248","0","39.50","18.99"
"10","007","00","030","0015","0419","574","286","288","3","577","1533","0","37.64","18.66"
"10","007","00","030","0016","0000","726","350","376","6","732","1959","0","37.37","17.87"
"10","007","00","030","0016","0422","413","194","219","3","416","1029","0","40.43","18.85"
"10","007","00","030","0016","0423","313","156","157","3","316","930","0","33.98","16.77"
"10","007","00","030","0017","0000","1060","492","568","13","1073","2669","0","40.20","18.43"
"10","007","00","030","0017","0426","518","234","284","11","529","1322","0","40.02","17.70"
"10","007","00","030","0017","0427","542","258","284","2","544","1347","0","40.39","19.15"
"10","007","00","030","0018","0000","767","371","396","6","773","2034","0","38.00","18.24"
"10","007","00","030","0018","0424","399","177","222","4","403","1016","0","39.67","17.42"
"10","007","00","030","0018","0425","368","194","174","2","370","1018","0","36.35","19.06"
"10","007","00","030","0019","0000","1185","526","659","16","1201","3450","0","34.81","15.25"
"10","007","00","030","0019","0428","398","182","216","7","405","1157","0","35.00","15.73"
"10","007","00","030","0019","0429","389","158","231","4","393","1105","0","35.57","14.30"
"10","007","00","030","0019","0430","398","186","212","5","403","1188","0","33.92","15.66"
"10","007","00","030","0020","0000","357","140","217","7","364","868","0","41.94","16.13"
"10","007","00","030","0020","0431","357","140","217","7","364","868","0","41.94","16.13"
"10","007","00","030","0021","0000","964","471","493","19","983","2388","0","41.16","19.72"
"10","007","00","030","0021","0432","442","199","243","7","449","1115","0","40.27","17.85"
"10","007","00","030","0021","0433","522","272","250","12","534","1273","0","41.95","21.37"
"10","007","00","030","0022","0000","915","399","516","13","928","2277","0","40.76","17.52"
"10","007","00","030","0022","0434","425","187","238","8","433","1077","0","40.20","17.36"
"10","007","00","030","0022","0435","490","212","278","5","495","1200","0","41.25","17.67"
"10","007","00","030","0023","0000","363","155","208","5","368","1109","0","33.18","13.98"
"10","007","00","030","0023","0436","363","155","208","5","368","1109","0","33.18","13.98"
"10","007","00","030","0024","0000","1052","478","574","13","1065","2845","0","37.43","16.80"
"10","007","00","030","0024","0437","341","164","177","5","346","914","0","37.86","17.94"
"10","007","00","030","0024","0438","359","153","206","3","362","972","0","37.24","15.74"
"10","007","00","030","0024","0439","352","161","191","5","357","959","0","37.23","16.79"
"10","007","00","030","0025","0000","1556","812","744","14","1570","4308","0","36.44","18.85"
"10","007","00","030","0025","0440","361","198","163","5","366","985","0","37.16","20.10"
"10","007","00","030","0025","0441","420","243","177","6","426","1054","0","40.42","23.06"
"10","007","00","030","0025","0442","404","194","210","1","405","1160","0","34.91","16.72"
"10","007","00","030","0025","0443","371","177","194","2","373","1109","0","33.63","15.96"
"10","007","00","030","0026","0000","589","311","278","6","595","1748","0","34.04","17.79"
"10","007","00","030","0026","0445","289","150","139","1","290","865","0","33.53","17.34"
"10","007","00","030","0026","0446","300","161","139","5","305","883","0","34.54","18.23"
"10","007","00","030","0027","0000","244","135","109","3","247","842","0","29.33","16.03"
"10","007","00","030","0027","0447","244","135","109","3","247","842","0","29.33","16.03"
"10","007","00","030","0028","0000","446","173","273","6","452","1196","0","37.79","14.46"
"10","007","00","030","0028","0448","446","173","273","6","452","1196","0","37.79","14.46"
"10","007","00","030","0029","0000","627","283","344","5","632","2038","0","31.01","13.89"
"10","007","00","030","0029","0449","377","171","206","3","380","1088","0","34.93","15.72"
"10","007","00","030","0029","0450","250","112","138","2","252","950","0","26.53","11.79"
"10","007","00","030","0030","0000","1124","490","634","13","1137","3033","0","37.49","16.16"
"10","007","00","030","0030","0451","370","161","209","5","375","1022","0","36.69","15.75"
"10","007","00","030","0030","0452","403","174","229","5","408","1006","0","40.56","17.30"
"10","007","00","030","0030","0453","351","155","196","3","354","1005","0","35.22","15.42"
"10","007","00","030","0031","0000","565","246","319","5","570","1548","0","36.82","15.89"
"10","007","00","030","0031","0454","238","108","130","1","239","684","0","34.94","15.79"
"10","007","00","030","0031","0455","327","138","189","4","331","864","0","38.31","15.97"
"10","007","00","030","0032","0000","892","420","472","7","899","2716","0","33.10","15.46"
"10","007","00","030","0032","0420","458","194","264","0","458","1363","0","33.60","14.23"
"10","007","00","030","0032","0421","434","226","208","7","441","1353","0","32.59","16.70"
"10","007","00","040","0000","0000","4844","2631","2213","51","4895","14031","16573","34.89","18.75"
"10","007","00","040","0001","0000","435","270","165","1","436","1187","0","36.73","22.75"
"10","007","00","040","0001","0485","435","270","165","1","436","1187","0","36.73","22.75"
"10","007","00","040","0002","0000","826","500","326","13","839","2276","0","36.86","21.97"
"10","007","00","040","0002","0484","386","210","176","7","393","1042","0","37.72","20.15"
"10","007","00","040","0002","0486","440","290","150","6","446","1234","0","36.14","23.50"
"10","007","00","040","0003","0000","779","420","359","9","788","2324","0","33.91","18.07"
"10","007","00","040","0003","0487","386","215","171","1","387","1195","0","32.38","17.99"
"10","007","00","040","0003","0488","393","205","188","8","401","1129","0","35.52","18.16"
"10","007","00","040","0004","0000","442","221","221","1","443","1240","0","35.73","17.82"
"10","007","00","040","0004","0489","442","221","221","1","443","1240","0","35.73","17.82"
"10","007","00","040","0005","0000","383","200","183","3","386","1223","0","31.56","16.35"
"10","007","00","040","0005","0490","383","200","183","3","386","1223","0","31.56","16.35"
"10","007","00","040","0006","0000","680","323","357","9","689","1914","0","36.00","16.88"
"10","007","00","040","0006","0491","345","155","190","4","349","966","0","36.13","16.05"
"10","007","00","040","0006","0492","335","168","167","5","340","948","0","35.86","17.72"
"10","007","00","040","0007","0000","797","434","363","6","803","2519","0","31.88","17.23"
"10","007","00","040","0007","0493","419","247","172","1","420","1233","0","34.06","20.03"
"10","007","00","040","0007","0494","378","187","191","5","383","1286","0","29.78","14.54"
"10","007","00","040","0008","0000","502","263","239","9","511","1348","0","37.91","19.51"
"10","007","00","040","0008","0495","502","263","239","9","511","1348","0","37.91","19.51"
"10","007","00","050","0000","0000","10262","5042","5220","93","10355","31273","37802","33.11","16.12"
"10","007","00","050","0001","0000","528","249","279","8","536","1748","0","30.66","14.24"
"10","007","00","050","0001","0471","294","111","183","7","301","883","0","34.09","12.57"
"10","007","00","050","0001","0472","234","138","96","1","235","865","0","27.17","15.95"
"10","007","00","050","0002","0000","416","126","290","5","421","1157","0","36.39","10.89"
"10","007","00","050","0002","0473","416","126","290","5","421","1157","0","36.39","10.89"
"10","007","00","050","0003","0000","478","231","247","8","486","1484","0","32.75","15.57"
"10","007","00","050","0003","0478","478","231","247","8","486","1484","0","32.75","15.57"
"10","007","00","050","0004","0000","695","295","400","2","697","2048","0","34.03","14.40"
"10","007","00","050","0004","0462","285","114","171","1","286","927","0","30.85","12.30"
"10","007","00","050","0004","0463","410","181","229","1","411","1121","0","36.66","16.15"
"10","007","00","050","0005","0000","677","355","322","4","681","1990","0","34.22","17.84"
"10","007","00","050","0005","0468","354","175","179","3","357","1078","0","33.12","16.23"
"10","007","00","050","0005","0469","323","180","143","1","324","912","0","35.53","19.74"
"10","007","00","050","0006","0000","458","231","227","3","461","1273","0","36.21","18.15"
"10","007","00","050","0006","0470","458","231","227","3","461","1273","0","36.21","18.15"
"10","007","00","050","0007","0000","663","334","329","8","671","1826","0","36.75","18.29"
"10","007","00","050","0007","0458","364","201","163","4","368","948","0","38.82","21.20"
"10","007","00","050","0007","0459","299","133","166","4","303","878","0","34.51","15.15"
"10","007","00","050","0008","0000","500","322","178","6","506","1714","0","29.52","18.79"
"10","007","00","050","0008","0460","251","165","86","3","254","818","0","31.05","20.17"
"10","007","00","050","0008","0461","249","157","92","3","252","896","0","28.13","17.52"
"10","007","00","050","0009","0000","845","436","409","12","857","2652","0","32.32","16.44"
"10","007","00","050","0009","0464","480","252","228","7","487","1365","0","35.68","18.46"
"10","007","00","050","0009","0465","365","184","181","5","370","1287","0","28.75","14.30"
"10","007","00","050","0010","0000","1719","815","904","7","1726","5173","0","33.37","15.75"
"10","007","00","050","0010","0474","502","237","265","0","502","1359","0","36.94","17.44"
"10","007","00","050","0010","0475","428","207","221","1","429","1345","0","31.90","15.39"
"10","007","00","050","0010","0476","372","160","212","3","375","1170","0","32.05","13.68"
"10","007","00","050","0010","0477","417","211","206","3","420","1299","0","32.33","16.24"
"10","007","00","050","0011","0000","621","368","253","5","626","2344","0","26.71","15.70"
"10","007","00","050","0011","0466","302","191","111","3","305","1101","0","27.70","17.35"
"10","007","00","050","0011","0467","319","177","142","2","321","1243","0","25.82","14.24"
"10","007","00","050","0012","0000","953","430","523","9","962","2622","0","36.69","16.40"
"10","007","00","050","0012","0456","482","222","260","6","488","1194","0","40.87","18.59"
"10","007","00","050","0012","0457","471","208","263","3","474","1428","0","33.19","14.57"
"10","007","00","050","0013","0000","984","489","495","5","989","3002","0","32.94","16.29"
"10","007","00","050","0013","0479","346","166","180","3","349","992","0","35.18","16.73"
"10","007","00","050","0013","0480","328","184","144","2","330","1008","0","32.74","18.25"
"10","007","00","050","0013","0481","310","139","171","0","310","1002","0","30.94","13.87"
"10","007","00","050","0014","0000","725","361","364","11","736","2240","0","32.86","16.12"
"10","007","00","050","0014","0482","342","164","178","7","349","1098","0","31.79","14.94"
"10","007","00","050","0014","0483","383","197","186","4","387","1142","0","33.89","17.25"
"10","007","00","060","0000","0000","13182","5771","7411","140","13322","39495","46114","33.73","14.61"
"10","007","00","060","0001","0000","531","169","362","3","534","1480","0","36.08","11.42"
"10","007","00","060","0001","0326","531","169","362","3","534","1480","0","36.08","11.42"
"10","007","00","060","0002","0000","491","198","293","4","495","1453","0","34.07","13.63"
"10","007","00","060","0002","0325","491","198","293","4","495","1453","0","34.07","13.63"
"10","007","00","060","0003","0000","447","195","252","8","455","1237","0","36.78","15.76"
"10","007","00","060","0003","0320","447","195","252","8","455","1237","0","36.78","15.76"
"10","007","00","060","0004","0000","508","194","314","5","513","1505","0","34.09","12.89"
"10","007","00","060","0004","0318","230","89","141","2","232","708","0","32.77","12.57"
"10","007","00","060","0004","0319","278","105","173","3","281","797","0","35.26","13.17"
"10","007","00","060","0005","0000","421","147","274","5","426","1168","0","36.47","12.59"
"10","007","00","060","0005","0317","421","147","274","5","426","1168","0","36.47","12.59"
"10","007","00","060","0006","0000","453","196","257","2","455","1273","0","35.74","15.40"
"10","007","00","060","0006","0316","453","196","257","2","455","1273","0","35.74","15.40"
"10","007","00","060","0007","0000","538","214","324","5","543","1360","0","39.93","15.74"
"10","007","00","060","0007","0314","538","214","324","5","543","1360","0","39.93","15.74"
"10","007","00","060","0008","0000","367","140","227","2","369","832","0","44.35","16.83"
"10","007","00","060","0008","0315","367","140","227","2","369","832","0","44.35","16.83"
"10","007","00","060","0009","0000","724","548","176","8","732","2397","0","30.54","22.86"
"10","007","00","060","0009","0321","451","410","41","4","455","1453","0","31.31","28.22"
"10","007","00","060","0009","0322","273","138","135","4","277","944","0","29.34","14.62"
"10","007","00","060","0010","0000","938","413","525","5","943","2653","0","35.54","15.57"
"10","007","00","060","0010","0323","450","199","251","2","452","1302","0","34.72","15.28"
"10","007","00","060","0010","0324","488","214","274","3","491","1351","0","36.34","15.84"
"10","007","00","060","0011","0000","810","325","485","13","823","2550","0","32.27","12.75"
"10","007","00","060","0011","0331","328","131","197","5","333","1082","0","30.78","12.11"
"10","007","00","060","0011","0332","482","194","288","8","490","1468","0","33.38","13.22"
"10","007","00","060","0012","0000","370","186","184","3","373","1172","0","31.83","15.87"
"10","007","00","060","0012","0338","370","186","184","3","373","1172","0","31.83","15.87"
"10","007","00","060","0013","0000","381","109","272","6","387","1047","0","36.96","10.41"
"10","007","00","060","0013","0339","381","109","272","6","387","1047","0","36.96","10.41"
"10","007","00","060","0014","0000","631","239","392","13","644","2180","0","29.54","10.96"
"10","007","00","060","0014","0346","311","108","203","4","315","1041","0","30.26","10.37"
"10","007","00","060","0014","0347","320","131","189","9","329","1139","0","28.88","11.50"
"10","007","00","060","0015","0000","588","295","293","5","593","1856","0","31.95","15.89"
"10","007","00","060","0015","0344","299","137","162","2","301","891","0","33.78","15.38"
"10","007","00","060","0015","0345","289","158","131","3","292","965","0","30.26","16.37"
"10","007","00","060","0016","0000","648","334","314","7","655","2276","0","28.78","14.67"
"10","007","00","060","0016","0342","298","150","148","3","301","992","0","30.34","15.12"
"10","007","00","060","0016","0343","350","184","166","4","354","1284","0","27.57","14.33"
"10","007","00","060","0017","0000","331","181","150","5","336","1276","0","26.33","14.18"
"10","007","00","060","0017","0341","331","181","150","5","336","1276","0","26.33","14.18"
"10","007","00","060","0018","0000","456","182","274","5","461","1275","0","36.16","14.27"
"10","007","00","060","0018","0340","456","182","274","5","461","1275","0","36.16","14.27"
"10","007","00","060","0019","0000","1294","510","784","9","1303","3643","0","35.77","14.00"
"10","007","00","060","0019","0333","464","178","286","4","468","1255","0","37.29","14.18"
"10","007","00","060","0019","0334","446","195","251","5","451","1273","0","35.43","15.32"
"10","007","00","060","0019","0335","384","137","247","0","384","1115","0","34.44","12.29"
"10","007","00","060","0020","0000","818","369","449","11","829","2581","0","32.12","14.30"
"10","007","00","060","0020","0336","358","158","200","6","364","1154","0","31.54","13.69"
"10","007","00","060","0020","0337","460","211","249","5","465","1427","0","32.59","14.79"
"10","007","00","060","0021","0000","748","318","430","5","753","2364","0","31.85","13.45"
"10","007","00","060","0021","0329","303","130","173","2","305","1038","0","29.38","12.52"
"10","007","00","060","0021","0330","445","188","257","3","448","1326","0","33.79","14.18"
"10","007","00","060","0022","0000","689","309","380","11","700","1917","0","36.52","16.12"
"10","007","00","060","0022","0327","298","119","179","2","300","886","0","33.86","13.43"
"10","007","00","060","0022","0328","391","190","201","9","400","1031","0","38.80","18.43"
"10","007","00","070","0000","0000","12471","5756","6715","117","12588","32451","38830","38.79","17.74"
"10","007","00","070","0001","0000","687","275","412","4","691","1676","0","41.23","16.41"
"10","007","00","070","0001","0348","315","135","180","2","317","810","0","39.14","16.67"
"10","007","00","070","0001","0349","372","140","232","2","374","866","0","43.19","16.17"
"10","007","00","070","0002","0000","851","364","487","9","860","2038","0","42.20","17.86"
"10","007","00","070","0002","0350","428","183","245","3","431","1028","0","41.93","17.80"
"10","007","00","070","0002","0351","423","181","242","6","429","1010","0","42.48","17.92"
"10","007","00","070","0003","0000","1040","550","490","7","1047","2642","0","39.63","20.82"
"10","007","00","070","0003","0352","380","191","189","5","385","981","0","39.25","19.47"
"10","007","00","070","0003","0353","303","166","137","1","304","802","0","37.91","20.70"
"10","007","00","070","0003","0354","357","193","164","1","358","859","0","41.68","22.47"
"10","007","00","070","0004","0000","636","330","306","8","644","1828","0","35.23","18.05"
"10","007","00","070","0004","0357","323","174","149","1","324","930","0","34.84","18.71"
"10","007","00","070","0004","0358","313","156","157","7","320","898","0","35.63","17.37"
"10","007","00","070","0005","0000","503","268","235","5","508","1438","0","35.33","18.64"
"10","007","00","070","0005","0355","240","117","123","3","243","680","0","35.74","17.21"
"10","007","00","070","0005","0356","263","151","112","2","265","758","0","34.96","19.92"
"10","007","00","070","0006","0000","1484","729","755","16","1500","3871","0","38.75","18.83"
"10","007","00","070","0006","0359","358","179","179","5","363","861","0","42.16","20.79"
"10","007","00","070","0006","0360","329","179","150","0","329","857","0","38.39","20.89"
"10","007","00","070","0006","0361","406","177","229","6","412","1050","0","39.24","16.86"
"10","007","00","070","0006","0362","391","194","197","5","396","1103","0","35.90","17.59"
"10","007","00","070","0007","0000","1273","585","688","6","1279","3154","0","40.55","18.55"
"10","007","00","070","0007","0363","302","142","160","1","303","717","0","42.26","19.80"
"10","007","00","070","0007","0364","400","148","252","0","400","1011","0","39.56","14.64"
"10","007","00","070","0007","0365","318","165","153","2","320","783","0","40.87","21.07"
"10","007","00","070","0007","0366","253","130","123","3","256","643","0","39.81","20.22"
"10","007","00","070","0008","0000","895","386","509","9","904","2279","0","39.67","16.94"
"10","007","00","070","0008","0367","286","126","160","3","289","732","0","39.48","17.21"
"10","007","00","070","0008","0368","259","120","139","1","260","661","0","39.33","18.15"
"10","007","00","070","0008","0369","350","140","210","5","355","886","0","40.07","15.80"
"10","007","00","070","0009","0000","504","238","266","10","514","1479","0","34.75","16.09"
"10","007","00","070","0009","0370","228","102","126","8","236","723","0","32.64","14.11"
"10","007","00","070","0009","0371","276","136","140","2","278","756","0","36.77","17.99"
"10","007","00","070","0010","0000","1685","791","894","12","1697","4523","0","37.52","17.49"
"10","007","00","070","0010","0372","322","141","181","3","325","907","0","35.83","15.55"
"10","007","00","070","0010","0373","292","135","157","4","296","827","0","35.79","16.32"
"10","007","00","070","0010","0374","298","158","140","2","300","842","0","35.63","18.76"
"10","007","00","070","0010","0375","392","185","207","2","394","1004","0","39.24","18.43"
"10","007","00","070","0010","0376","381","172","209","1","382","943","0","40.51","18.24"
"10","007","00","070","0011","0000","840","375","465","12","852","1939","0","43.94","19.34"
"10","007","00","070","0011","0377","354","152","202","4","358","855","0","41.87","17.78"
"10","007","00","070","0011","0378","486","223","263","8","494","1084","0","45.57","20.57"
"10","007","00","070","0012","0000","634","293","341","6","640","1677","0","38.16","17.47"
"10","007","00","070","0012","0379","321","137","184","3","324","892","0","36.32","15.36"
"10","007","00","070","0012","0380","313","156","157","3","316","785","0","40.25","19.87"
"10","007","00","070","0013","0000","667","264","403","6","673","1737","0","38.74","15.20"
"10","007","00","070","0013","0381","326","138","188","1","327","810","0","40.37","17.04"
"10","007","00","070","0013","0382","341","126","215","5","346","927","0","37.32","13.59"
"10","007","00","070","0014","0000","772","308","464","7","779","2170","0","35.90","14.19"
"10","007","00","070","0014","0383","229","117","112","1","230","672","0","34.23","17.41"
"10","007","00","070","0014","0384","233","117","116","2","235","660","0","35.61","17.73"
"10","007","00","070","0014","0385","310","74","236","4","314","838","0","37.47","8.83"
"10","007","00","080","0000","0000","14490","7265","7225","170","14660","38651","45018","37.93","18.80"
"10","007","00","080","0001","0000","1325","663","662","12","1337","3179","0","42.06","20.86"
"10","007","00","080","0001","0188","352","169","183","6","358","895","0","40.00","18.88"
"10","007","00","080","0001","0189","405","222","183","3","408","964","0","42.32","23.03"
"10","007","00","080","0001","0190","568","272","296","3","571","1320","0","43.26","20.61"
"10","007","00","080","0002","0000","676","317","359","13","689","1758","0","39.19","18.03"
"10","007","00","080","0002","0191","304","140","164","8","312","783","0","39.85","17.88"
"10","007","00","080","0002","0192","372","177","195","5","377","975","0","38.67","18.15"
"10","007","00","080","0003","0000","922","463","459","5","927","2329","0","39.80","19.88"
"10","007","00","080","0003","0193","436","204","232","3","439","1108","0","39.62","18.41"
"10","007","00","080","0003","0194","486","259","227","2","488","1221","0","39.97","21.21"
"10","007","00","080","0004","0000","456","189","267","10","466","1069","0","43.59","17.68"
"10","007","00","080","0004","0196","456","189","267","10","466","1069","0","43.59","17.68"
"10","007","00","080","0005","0000","558","239","319","6","564","1419","0","39.75","16.84"
"10","007","00","080","0005","0195","558","239","319","6","564","1419","0","39.75","16.84"
"10","007","00","080","0006","0000","747","369","378","16","763","1892","0","40.33","19.50"
"10","007","00","080","0006","0197","334","152","182","6","340","901","0","37.74","16.87"
"10","007","00","080","0006","0198","413","217","196","10","423","991","0","42.68","21.90"
"10","007","00","080","0007","0000","294","129","165","3","297","721","0","41.19","17.89"
"10","007","00","080","0007","0201","294","129","165","3","297","721","0","41.19","17.89"
"10","007","00","080","0008","0000","730","362","368","7","737","1803","0","40.88","20.08"
"10","007","00","080","0008","0199","478","253","225","3","481","1114","0","43.18","22.71"
"10","007","00","080","0008","0200","252","109","143","4","256","689","0","37.16","15.82"
"10","007","00","080","0009","0000","1881","1000","881","27","1908","4928","0","38.72","20.29"
"10","007","00","080","0009","0210","437","246","191","5","442","1127","0","39.22","21.83"
"10","007","00","080","0009","0211","493","237","256","7","500","1291","0","38.73","18.36"
"10","007","00","080","0009","0212","504","286","218","9","513","1279","0","40.11","22.36"
"10","007","00","080","0009","0213","447","231","216","6","453","1231","0","36.80","18.77"
"10","007","00","080","0010","0000","1138","560","578","10","1148","3092","0","37.13","18.11"
"10","007","00","080","0010","0202","372","181","191","2","374","980","0","38.16","18.47"
"10","007","00","080","0010","0203","344","174","170","1","345","956","0","36.09","18.20"
"10","007","00","080","0010","0204","422","205","217","7","429","1156","0","37.11","17.73"
"10","007","00","080","0011","0000","1707","896","811","20","1727","4602","0","37.53","19.47"
"10","007","00","080","0011","0205","406","229","177","4","410","1129","0","36.32","20.28"
"10","007","00","080","0011","0206","373","207","166","6","379","1118","0","33.90","18.52"
"10","007","00","080","0011","0207","468","218","250","7","475","1237","0","38.40","17.62"
"10","007","00","080","0011","0208","460","242","218","3","463","1118","0","41.41","21.65"
"10","007","00","080","0012","0000","519","207","312","4","523","1340","0","39.03","15.45"
"10","007","00","080","0012","0209","519","207","312","4","523","1340","0","39.03","15.45"
"10","007","00","080","0013","0000","1153","604","549","14","1167","3298","0","35.39","18.31"
"10","007","00","080","0013","0214","365","196","169","4","369","1153","0","32.00","17.00"
"10","007","00","080","0013","0215","370","191","179","1","371","1019","0","36.41","18.74"
"10","007","00","080","0013","0216","418","217","201","9","427","1126","0","37.92","19.27"
"10","007","00","080","0014","0000","310","177","133","2","312","890","0","35.06","19.89"
"10","007","00","080","0014","0217","310","177","133","2","312","890","0","35.06","19.89"
"10","007","00","080","0015","0000","339","158","181","3","342","932","0","36.70","16.95"
"10","007","00","080","0015","0218","339","158","181","3","342","932","0","36.70","16.95"
"10","007","00","080","0016","0000","664","346","318","6","670","1906","0","35.15","18.15"
"10","007","00","080","0016","0219","354","197","157","2","356","967","0","36.81","20.37"
"10","007","00","080","0016","0220","310","149","161","4","314","939","0","33.44","15.87"
"10","007","00","080","0017","0000","580","314","266","3","583","1888","0","30.88","16.63"
"10","007","00","080","0017","0221","419","218","201","3","422","1369","0","30.83","15.92"
"10","007","00","080","0017","0222","161","96","65","0","161","519","0","31.02","18.50"
"10","007","00","080","0018","0000","491","272","219","9","500","1605","0","31.15","16.95"
"10","007","00","080","0018","0223","279","167","112","6","285","891","0","31.99","18.74"
"10","007","00","080","0018","0224","212","105","107","3","215","714","0","30.11","14.71"
"10","007","00","090","0000","0000","7215","3238","3977","97","7312","20114","22927","36.35","16.10"
"10","007","00","090","0001","0000","587","283","304","9","596","1743","0","34.19","16.24"
"10","007","00","090","0001","0225","319","160","159","5","324","945","0","34.29","16.93"
"10","007","00","090","0001","0226","268","123","145","4","272","798","0","34.09","15.41"
"10","007","00","090","0002","0000","471","222","249","5","476","1387","0","34.32","16.01"
"10","007","00","090","0002","0227","229","110","119","3","232","678","0","34.22","16.22"
"10","007","00","090","0002","0228","242","112","130","2","244","709","0","34.41","15.80"
"10","007","00","090","0003","0000","677","336","341","7","684","1754","0","39.00","19.16"
"10","007","00","090","0003","0229","396","190","206","3","399","920","0","43.37","20.65"
"10","007","00","090","0003","0230","281","146","135","4","285","834","0","34.17","17.51"
"10","007","00","090","0004","0000","858","395","463","13","871","2452","0","35.52","16.11"
"10","007","00","090","0004","0232","425","190","235","7","432","1210","0","35.70","15.70"
"10","007","00","090","0004","0233","433","205","228","6","439","1242","0","35.35","16.51"
"10","007","00","090","0005","0000","892","380","512","10","902","2344","0","38.48","16.21"
"10","007","00","090","0005","0234","413","193","220","6","419","1186","0","35.33","16.27"
"10","007","00","090","0005","0235","479","187","292","4","483","1158","0","41.71","16.15"
"10","007","00","090","0006","0000","660","356","304","7","667","1622","0","41.12","21.95"
"10","007","00","090","0006","0236","419","204","215","3","422","1045","0","40.38","19.52"
"10","007","00","090","0006","0237","241","152","89","4","245","577","0","42.46","26.34"
"10","007","00","090","0007","0000","301","130","171","3","304","877","0","34.66","14.82"
"10","007","00","090","0007","0238","301","130","171","3","304","877","0","34.66","14.82"
"10","007","00","090","0008","0000","412","166","246","5","417","1142","0","36.51","14.54"
"10","007","00","090","0008","0239","412","166","246","5","417","1142","0","36.51","14.54"
"10","007","00","090","0009","0000","218","88","130","5","223","647","0","34.47","13.60"
"10","007","00","090","0009","0240","218","88","130","5","223","647","0","34.47","13.60"
"10","007","00","090","0010","0000","630","263","367","6","636","1646","0","38.64","15.98"
"10","007","00","090","0010","0241","301","123","178","2","303","807","0","37.55","15.24"
"10","007","00","090","0010","0242","329","140","189","4","333","839","0","39.69","16.69"
"10","007","00","090","0011","0000","346","169","177","3","349","965","0","36.17","17.51"
"10","007","00","090","0011","0243","346","169","177","3","349","965","0","36.17","17.51"
"10","007","00","090","0012","0000","382","143","239","7","389","1139","0","34.15","12.55"
"10","007","00","090","0012","0244","382","143","239","7","389","1139","0","34.15","12.55"
"10","007","00","090","0013","0000","256","101","155","7","263","854","0","30.80","11.83"
"10","007","00","090","0013","0245","256","101","155","7","263","854","0","30.80","11.83"
"10","007","00","090","0014","0000","324","105","219","5","329","966","0","34.06","10.87"
"10","007","00","090","0014","0246","324","105","219","5","329","966","0","34.06","10.87"
"10","007","00","090","0015","0000","201","101","100","5","206","576","0","35.76","17.53"
"10","007","00","090","0015","0231","201","101","100","5","206","576","0","35.76","17.53"
"10","007","00","100","0000","0000","40136","19710","20426","395","40531","101543","123460","39.92","19.41"
"10","007","00","100","0001","0000","409","228","181","5","414","1051","0","39.39","21.69"
"10","007","00","100","0001","0519","409","228","181","5","414","1051","0","39.39","21.69"
"10","007","00","100","0002","0000","1081","547","534","10","1091","2683","0","40.66","20.39"
"10","007","00","100","0002","0520","358","187","171","6","364","894","0","40.72","20.92"
"10","007","00","100","0002","0521","351","162","189","1","352","910","0","38.68","17.80"
"10","007","00","100","0002","0522","372","198","174","3","375","879","0","42.66","22.53"
"10","007","00","100","0003","0000","1305","677","628","11","1316","3068","0","42.89","22.07"
"10","007","00","100","0003","0543","362","198","164","4","366","835","0","43.83","23.71"
"10","007","00","100","0003","0544","491","263","228","4","495","1166","0","42.45","22.56"
"10","007","00","100","0003","0545","452","216","236","3","455","1067","0","42.64","20.24"
"10","007","00","100","0004","0000","1096","555","541","11","1107","2540","0","43.58","21.85"
"10","007","00","100","0004","0546","353","170","183","4","357","834","0","42.81","20.38"
"10","007","00","100","0004","0547","396","203","193","1","397","887","0","44.76","22.89"
"10","007","00","100","0004","0548","347","182","165","6","353","819","0","43.10","22.22"
"10","007","00","100","0005","0000","336","152","184","3","339","695","0","48.78","21.87"
"10","007","00","100","0005","0549","336","152","184","3","339","695","0","48.78","21.87"
"10","007","00","100","0006","0000","1104","555","549","9","1113","2785","0","39.96","19.93"
"10","007","00","100","0006","0550","363","194","169","2","365","860","0","42.44","22.56"
"10","007","00","100","0006","0551","358","178","180","5","363","872","0","41.63","20.41"
"10","007","00","100","0006","0552","383","183","200","2","385","1053","0","36.56","17.38"
"10","007","00","100","0007","0000","349","173","176","2","351","754","0","46.55","22.94"
"10","007","00","100","0007","0553","349","173","176","2","351","754","0","46.55","22.94"
"10","007","00","100","0008","0000","287","136","151","1","288","571","0","50.44","23.82"
"10","007","00","100","0008","0554","287","136","151","1","288","571","0","50.44","23.82"
"10","007","00","100","0009","0000","681","331","350","8","689","1808","0","38.11","18.31"
"10","007","00","100","0009","0523","307","152","155","4","311","844","0","36.85","18.01"
"10","007","00","100","0009","0524","374","179","195","4","378","964","0","39.21","18.57"
"10","007","00","100","0010","0000","2264","1058","1206","27","2291","5571","0","41.12","18.99"
"10","007","00","100","0010","0525","395","162","233","3","398","1075","0","37.02","15.07"
"10","007","00","100","0010","0526","460","221","239","8","468","1084","0","43.17","20.39"
"10","007","00","100","0010","0527","419","190","229","5","424","1048","0","40.46","18.13"
"10","007","00","100","0010","0528","533","259","274","6","539","1261","0","42.74","20.54"
"10","007","00","100","0010","0529","457","226","231","5","462","1103","0","41.89","20.49"
"10","007","00","100","0011","0000","952","496","456","10","962","2460","0","39.11","20.16"
"10","007","00","100","0011","0577","457","245","212","5","462","1206","0","38.31","20.32"
"10","007","00","100","0011","0578","495","251","244","5","500","1254","0","39.87","20.02"
"10","007","00","100","0012","0000","1747","842","905","15","1762","4122","0","42.75","20.43"
"10","007","00","100","0012","0579","561","252","309","5","566","1347","0","42.02","18.71"
"10","007","00","100","0012","0580","465","231","234","6","471","1083","0","43.49","21.33"
"10","007","00","100","0012","0581","363","182","181","1","364","802","0","45.39","22.69"
"10","007","00","100","0012","0582","358","177","181","3","361","890","0","40.56","19.89"
"10","007","00","100","0013","0000","2118","1044","1074","18","2136","5313","0","40.20","19.65"
"10","007","00","100","0013","0583","667","344","323","5","672","1640","0","40.98","20.98"
"10","007","00","100","0013","0584","493","242","251","8","501","1297","0","38.63","18.66"
"10","007","00","100","0013","0585","475","233","242","2","477","1323","0","36.05","17.61"
"10","007","00","100","0013","0586","483","225","258","3","486","1053","0","46.15","21.37"
"10","007","00","100","0014","0000","1824","937","887","18","1842","4646","0","39.65","20.17"
"10","007","00","100","0014","0587","353","141","212","2","355","835","0","42.51","16.89"
"10","007","00","100","0014","0588","319","163","156","1","320","802","0","39.90","20.32"
"10","007","00","100","0014","0589","371","201","170","6","377","931","0","40.49","21.59"
"10","007","00","100","0014","0590","363","216","147","8","371","981","0","37.82","22.02"
"10","007","00","100","0014","0591","418","216","202","1","419","1097","0","38.20","19.69"
"10","007","00","100","0015","0000","574","235","339","4","578","1675","0","34.51","14.03"
"10","007","00","100","0015","0592","312","123","189","2","314","868","0","36.18","14.17"
"10","007","00","100","0015","0593","262","112","150","2","264","807","0","32.71","13.88"
"10","007","00","100","0016","0000","739","349","390","12","751","2088","0","35.97","16.71"
"10","007","00","100","0016","0594","454","208","246","6","460","1207","0","38.11","17.23"
"10","007","00","100","0016","0595","285","141","144","6","291","881","0","33.03","16.00"
"10","007","00","100","0017","0000","1058","509","549","12","1070","2693","0","39.73","18.90"
"10","007","00","100","0017","0555","493","240","253","3","496","1307","0","37.95","18.36"
"10","007","00","100","0017","0556","565","269","296","9","574","1386","0","41.41","19.41"
"10","007","00","100","0018","0000","2366","1206","1160","21","2387","6107","0","39.09","19.75"
"10","007","00","100","0018","0561","510","263","247","3","513","1118","0","45.89","23.52"
"10","007","00","100","0018","0562","291","161","130","1","292","843","0","34.64","19.10"
"10","007","00","100","0018","0563","416","204","212","6","422","1115","0","37.85","18.30"
"10","007","00","100","0018","0564","411","213","198","6","417","1186","0","35.16","17.96"
"10","007","00","100","0018","0565","388","211","177","2","390","953","0","40.92","22.14"
"10","007","00","100","0018","0566","350","154","196","3","353","892","0","39.57","17.26"
"10","007","00","100","0019","0000","1187","616","571","12","1199","2880","0","41.63","21.39"
"10","007","00","100","0019","0567","404","187","217","3","407","952","0","42.75","19.64"
"10","007","00","100","0019","0568","423","239","184","4","427","984","0","43.39","24.29"
"10","007","00","100","0019","0569","360","190","170","5","365","944","0","38.67","20.13"
"10","007","00","100","0020","0000","687","301","386","13","700","1929","0","36.29","15.60"
"10","007","00","100","0020","0530","360","196","164","6","366","1067","0","34.30","18.37"
"10","007","00","100","0020","0531","327","105","222","7","334","862","0","38.75","12.18"
"10","007","00","100","0021","0000","1052","497","555","15","1067","2485","0","42.94","20.00"
"10","007","00","100","0021","0532","525","224","301","6","531","1303","0","40.75","17.19"
"10","007","00","100","0021","0533","527","273","254","9","536","1182","0","45.35","23.10"
"10","007","00","100","0022","0000","1376","686","690","11","1387","3290","0","42.16","20.85"
"10","007","00","100","0022","0534","415","203","212","0","415","1028","0","40.37","19.75"
"10","007","00","100","0022","0535","442","225","217","4","446","1030","0","43.30","21.84"
"10","007","00","100","0022","0536","519","258","261","7","526","1232","0","42.69","20.94"
"10","007","00","100","0023","0000","893","384","509","10","903","2363","0","38.21","16.25"
"10","007","00","100","0023","0537","507","207","300","6","513","1280","0","40.08","16.17"
"10","007","00","100","0023","0538","386","177","209","4","390","1083","0","36.01","16.34"
"10","007","00","100","0024","0000","1527","819","708","12","1539","3631","0","42.39","22.56"
"10","007","00","100","0024","0539","300","145","155","4","304","847","0","35.89","17.12"
"10","007","00","100","0024","0540","457","262","195","1","458","1097","0","41.75","23.88"
"10","007","00","100","0024","0541","387","190","197","5","392","818","0","47.92","23.23"
"10","007","00","100","0024","0542","383","222","161","2","385","869","0","44.30","25.55"
"10","007","00","100","0025","0000","876","463","413","8","884","2304","0","38.37","20.10"
"10","007","00","100","0025","0496","387","245","142","4","391","1018","0","38.41","24.07"
"10","007","00","100","0025","0497","489","218","271","4","493","1286","0","38.34","16.95"
"10","007","00","100","0026","0000","1025","560","465","2","1027","2698","0","38.07","20.76"
"10","007","00","100","0026","0498","529","262","267","2","531","1375","0","38.62","19.05"
"10","007","00","100","0026","0499","496","298","198","0","496","1323","0","37.49","22.52"
"10","007","00","100","0027","0000","967","442","525","17","984","2788","0","35.29","15.85"
"10","007","00","100","0027","0500","354","165","189","7","361","1061","0","34.02","15.55"
"10","007","00","100","0027","0501","320","158","162","6","326","955","0","34.14","16.54"
"10","007","00","100","0027","0502","293","119","174","4","297","772","0","38.47","15.41"
"10","007","00","100","0028","0000","582","211","371","7","589","1640","0","35.91","12.87"
"10","007","00","100","0028","0503","298","120","178","1","299","826","0","36.20","14.53"
"10","007","00","100","0028","0504","284","91","193","6","290","814","0","35.63","11.18"
"10","007","00","100","0029","0000","429","160","269","6","435","1187","0","36.65","13.48"
"10","007","00","100","0029","0505","429","160","269","6","435","1187","0","36.65","13.48"
"10","007","00","100","0030","0000","279","161","118","2","281","713","0","39.41","22.58"
"10","007","00","100","0030","0506","279","161","118","2","281","713","0","39.41","22.58"
"10","007","00","100","0031","0000","714","337","377","6","720","1974","0","36.47","17.07"
"10","007","00","100","0031","0507","409","211","198","3","412","1122","0","36.72","18.81"
"10","007","00","100","0031","0508","305","126","179","3","308","852","0","36.15","14.79"
"10","007","00","100","0032","0000","770","366","404","10","780","2175","0","35.86","16.83"
"10","007","00","100","0032","0509","404","200","204","3","407","1083","0","37.58","18.47"
"10","007","00","100","0032","0510","366","166","200","7","373","1092","0","34.16","15.20"
"10","007","00","100","0033","0000","713","285","428","10","723","1938","0","37.31","14.71"
"10","007","00","100","0033","0511","329","125","204","3","332","961","0","34.55","13.01"
"10","007","00","100","0033","0512","384","160","224","7","391","977","0","40.02","16.38"
"10","007","00","100","0034","0000","611","284","327","3","614","1738","0","35.33","16.34"
"10","007","00","100","0034","0513","343","167","176","3","346","980","0","35.31","17.04"
"10","007","00","100","0034","0514","268","117","151","0","268","758","0","35.36","15.44"
"10","007","00","100","0035","0000","606","314","292","7","613","1748","0","35.07","17.96"
"10","007","00","100","0035","0515","299","168","131","4","303","871","0","34.79","19.29"
"10","007","00","100","0035","0516","307","146","161","3","310","877","0","35.35","16.65"
"10","007","00","100","0036","0000","834","401","433","9","843","2262","0","37.27","17.73"
"10","007","00","100","0036","0517","404","190","214","5","409","1044","0","39.18","18.20"
"10","007","00","100","0036","0518","430","211","219","4","434","1218","0","35.63","17.32"
"10","007","00","100","0037","0000","1239","620","619","13","1252","2953","0","42.40","21.00"
"10","007","00","100","0037","0570","365","186","179","7","372","961","0","38.71","19.35"
"10","007","00","100","0037","0571","407","208","199","2","409","880","0","46.48","23.64"
"10","007","00","100","0037","0572","467","226","241","4","471","1112","0","42.36","20.32"
"10","007","00","100","0038","0000","988","547","441","8","996","2262","0","44.03","24.18"
"10","007","00","100","0038","0573","511","312","199","4","515","1213","0","42.46","25.72"
"10","007","00","100","0038","0574","477","235","242","4","481","1049","0","45.85","22.40"
"10","007","00","100","0039","0000","1108","525","583","7","1115","2449","0","45.53","21.44"
"10","007","00","100","0039","0575","557","281","276","2","559","1294","0","43.20","21.72"
"10","007","00","100","0039","0576","551","244","307","5","556","1155","0","48.14","21.13"
"10","007","00","100","0040","0000","564","281","283","2","566","1328","0","42.62","21.16"
"10","007","00","100","0040","0559","300","154","146","1","301","721","0","41.75","21.36"
"10","007","00","100","0040","0560","264","127","137","1","265","607","0","43.66","20.92"
"10","007","00","100","0041","0000","819","420","399","8","827","2178","0","37.97","19.28"
"10","007","00","100","0041","0557","497","253","244","6","503","1289","0","39.02","19.63"
"10","007","00","100","0041","0558","322","167","155","2","324","889","0","36.45","18.79"
"10","007","00","110","0000","0000","15707","7686","8021","150","15857","44726","54577","35.45","17.18"
"10","007","00","110","0001","0000","488","215","273","5","493","1156","0","42.65","18.60"
"10","007","00","110","0001","0661","488","215","273","5","493","1156","0","42.65","18.60"
"10","007","00","110","0002","0000","295","147","148","1","296","623","0","47.51","23.60"
"10","007","00","110","0002","0662","295","147","148","1","296","623","0","47.51","23.60"
"10","007","00","110","0003","0000","644","344","300","2","646","1780","0","36.29","19.33"
"10","007","00","110","0003","0663","303","148","155","1","304","801","0","37.95","18.48"
"10","007","00","110","0003","0664","341","196","145","1","342","979","0","34.93","20.02"
"10","007","00","110","0004","0000","174","101","73","4","178","420","0","42.38","24.05"
"10","007","00","110","0004","0665","174","101","73","4","178","420","0","42.38","24.05"
"10","007","00","110","0005","0000","1191","643","548","8","1199","3356","0","35.73","19.16"
"10","007","00","110","0005","0675","383","191","192","3","386","1111","0","34.74","17.19"
"10","007","00","110","0005","0676","408","227","181","2","410","1128","0","36.35","20.12"
"10","007","00","110","0005","0677","400","225","175","3","403","1117","0","36.08","20.14"
"10","007","00","110","0006","0000","841","441","400","12","853","2176","0","39.20","20.27"
"10","007","00","110","0006","0678","459","245","214","7","466","1193","0","39.06","20.54"
"10","007","00","110","0006","0679","382","196","186","5","387","983","0","39.37","19.94"
"10","007","00","110","0007","0000","1179","663","516","7","1186","3446","0","34.42","19.24"
"10","007","00","110","0007","0680","386","219","167","1","387","1189","0","32.55","18.42"
"10","007","00","110","0007","0681","343","179","164","3","346","1021","0","33.89","17.53"
"10","007","00","110","0007","0682","450","265","185","3","453","1236","0","36.65","21.44"
"10","007","00","110","0008","0000","446","182","264","9","455","1421","0","32.02","12.81"
"10","007","00","110","0008","0683","446","182","264","9","455","1421","0","32.02","12.81"
"10","007","00","110","0009","0000","992","465","527","14","1006","3018","0","33.33","15.41"
"10","007","00","110","0009","0684","328","132","196","5","333","1025","0","32.49","12.88"
"10","007","00","110","0009","0685","330","161","169","5","335","998","0","33.57","16.13"
"10","007","00","110","0009","0686","334","172","162","4","338","995","0","33.97","17.29"
"10","007","00","110","0010","0000","903","469","434","12","915","2433","0","37.61","19.28"
"10","007","00","110","0010","0687","497","256","241","6","503","1280","0","39.30","20.00"
"10","007","00","110","0010","0688","406","213","193","6","412","1153","0","35.73","18.47"
"10","007","00","110","0011","0000","825","425","400","8","833","2297","0","36.26","18.50"
"10","007","00","110","0011","0689","489","248","241","6","495","1327","0","37.30","18.69"
"10","007","00","110","0011","0690","336","177","159","2","338","970","0","34.85","18.25"
"10","007","00","110","0012","0000","286","114","172","4","290","814","0","35.63","14.00"
"10","007","00","110","0012","0691","286","114","172","4","290","814","0","35.63","14.00"
"10","007","00","110","0013","0000","610","279","331","2","612","1829","0","33.46","15.25"
"10","007","00","110","0013","0692","274","125","149","1","275","920","0","29.89","13.59"
"10","007","00","110","0013","0693","336","154","182","1","337","909","0","37.07","16.94"
"10","007","00","110","0014","0000","756","389","367","7","763","2278","0","33.49","17.08"
"10","007","00","110","0014","0670","395","210","185","2","397","1107","0","35.86","18.97"
"10","007","00","110","0014","0671","361","179","182","5","366","1171","0","31.26","15.29"
"10","007","00","110","0015","0000","300","124","176","0","300","817","0","36.72","15.18"
"10","007","00","110","0015","0674","300","124","176","0","300","817","0","36.72","15.18"
"10","007","00","110","0016","0000","458","174","284","2","460","1353","0","34.00","12.86"
"10","007","00","110","0016","0703","458","174","284","2","460","1353","0","34.00","12.86"
"10","007","00","110","0017","0000","702","336","366","6","708","1836","0","38.56","18.30"
"10","007","00","110","0017","0672","300","144","156","3","303","920","0","32.93","15.65"
"10","007","00","110","0017","0673","402","192","210","3","405","916","0","44.21","20.96"
"10","007","00","110","0018","0000","1597","777","820","19","1616","4595","0","35.17","16.91"
"10","007","00","110","0018","0666","343","146","197","6","349","1065","0","32.77","13.71"
"10","007","00","110","0018","0667","386","197","189","4","390","1129","0","34.54","17.45"
"10","007","00","110","0018","0668","413","212","201","8","421","1160","0","36.29","18.28"
"10","007","00","110","0018","0669","455","222","233","1","456","1241","0","36.74","17.89"
"10","007","00","110","0019","0000","206","104","102","1","207","641","0","32.29","16.22"
"10","007","00","110","0019","0694","206","104","102","1","207","641","0","32.29","16.22"
"10","007","00","110","0020","0000","474","256","218","4","478","1250","0","38.24","20.48"
"10","007","00","110","0020","0695","474","256","218","4","478","1250","0","38.24","20.48"
"10","007","00","110","0021","0000","236","110","126","4","240","694","0","34.58","15.85"
"10","007","00","110","0021","0696","236","110","126","4","240","694","0","34.58","15.85"
"10","007","00","110","0022","0000","444","234","210","5","449","1362","0","32.97","17.18"
"10","007","00","110","0022","0697","444","234","210","5","449","1362","0","32.97","17.18"
"10","007","00","110","0023","0000","386","145","241","4","390","1250","0","31.20","11.60"
"10","007","00","110","0023","0698","386","145","241","4","390","1250","0","31.20","11.60"
"10","007","00","110","0024","0000","708","296","412","6","714","2168","0","32.93","13.65"
"10","007","00","110","0024","0701","344","138","206","3","347","1074","0","32.31","12.85"
"10","007","00","110","0024","0702","364","158","206","3","367","1094","0","33.55","14.44"
"10","007","00","110","0025","0000","566","253","313","4","570","1713","0","33.27","14.77"
"10","007","00","110","0025","0699","326","136","190","2","328","956","0","34.31","14.23"
"10","007","00","110","0025","0700","240","117","123","2","242","757","0","31.97","15.46"
"10","007","00","120","0000","0000","12923","6197","6726","145","13068","34682","40379","37.68","17.87"
"10","007","00","120","0001","0000","269","123","146","1","270","816","0","33.09","15.07"
"10","007","00","120","0001","0766","269","123","146","1","270","816","0","33.09","15.07"
"10","007","00","120","0002","0000","366","217","149","5","371","1037","0","35.78","20.93"
"10","007","00","120","0002","0767","366","217","149","5","371","1037","0","35.78","20.93"
"10","007","00","120","0003","0000","277","138","139","5","282","748","0","37.70","18.45"
"10","007","00","120","0003","0768","277","138","139","5","282","748","0","37.70","18.45"
"10","007","00","120","0004","0000","533","288","245","8","541","1496","0","36.16","19.25"
"10","007","00","120","0004","0769","254","122","132","3","257","757","0","33.95","16.12"
"10","007","00","120","0004","0770","279","166","113","5","284","739","0","38.43","22.46"
"10","007","00","120","0005","0000","522","283","239","8","530","1448","0","36.60","19.54"
"10","007","00","120","0005","0771","261","149","112","6","267","717","0","37.24","20.78"
"10","007","00","120","0005","0772","261","134","127","2","263","731","0","35.98","18.33"
"10","007","00","120","0006","0000","463","212","251","7","470","1226","0","38.34","17.29"
"10","007","00","120","0006","0773","463","212","251","7","470","1226","0","38.34","17.29"
"10","007","00","120","0007","0000","644","279","365","4","648","1756","0","36.90","15.89"
"10","007","00","120","0007","0776","313","134","179","2","315","835","0","37.72","16.05"
"10","007","00","120","0007","0777","331","145","186","2","333","921","0","36.16","15.74"
"10","007","00","120","0008","0000","254","103","151","2","256","580","0","44.14","17.76"
"10","007","00","120","0008","0778","254","103","151","2","256","580","0","44.14","17.76"
"10","007","00","120","0009","0000","1304","684","620","13","1317","3269","0","40.29","20.92"
"10","007","00","120","0009","0779","388","193","195","3","391","1047","0","37.34","18.43"
"10","007","00","120","0009","0780","460","241","219","5","465","1116","0","41.67","21.59"
"10","007","00","120","0009","0781","456","250","206","5","461","1106","0","41.68","22.60"
"10","007","00","120","0010","0000","926","430","496","10","936","2363","0","39.61","18.20"
"10","007","00","120","0010","0782","503","231","272","3","506","1270","0","39.84","18.19"
"10","007","00","120","0010","0783","423","199","224","7","430","1093","0","39.34","18.21"
"10","007","00","120","0011","0000","404","182","222","2","406","1041","0","39.00","17.48"
"10","007","00","120","0011","0784","404","182","222","2","406","1041","0","39.00","17.48"
"10","007","00","120","0012","0000","451","190","261","3","454","1106","0","41.05","17.18"
"10","007","00","120","0012","0785","451","190","261","3","454","1106","0","41.05","17.18"
"10","007","00","120","0013","0000","806","408","398","7","813","1942","0","41.86","21.01"
"10","007","00","120","0013","0786","398","203","195","1","399","938","0","42.54","21.64"
"10","007","00","120","0013","0787","408","205","203","6","414","1004","0","41.24","20.42"
"10","007","00","120","0014","0000","937","461","476","6","943","2399","0","39.31","19.22"
"10","007","00","120","0014","0774","388","193","195","4","392","1055","0","37.16","18.29"
"10","007","00","120","0014","0775","549","268","281","2","551","1344","0","41.00","19.94"
"10","007","00","120","0015","0000","572","204","368","4","576","1560","0","36.92","13.08"
"10","007","00","120","0015","0789","312","116","196","3","315","797","0","39.52","14.55"
"10","007","00","120","0015","0790","260","88","172","1","261","763","0","34.21","11.53"
"10","007","00","120","0016","0000","443","209","234","5","448","1292","0","34.67","16.18"
"10","007","00","120","0016","0791","443","209","234","5","448","1292","0","34.67","16.18"
"10","007","00","120","0017","0000","628","325","303","14","642","1814","0","35.39","17.92"
"10","007","00","120","0017","0792","304","145","159","10","314","879","0","35.72","16.50"
"10","007","00","120","0017","0793","324","180","144","4","328","935","0","35.08","19.25"
"10","007","00","120","0018","0000","1528","743","785","16","1544","4178","0","36.96","17.78"
"10","007","00","120","0018","0794","378","200","178","4","382","1049","0","36.42","19.07"
"10","007","00","120","0018","0795","355","153","202","2","357","996","0","35.84","15.36"
"10","007","00","120","0018","0796","371","180","191","4","375","1058","0","35.44","17.01"
"10","007","00","120","0018","0797","424","210","214","6","430","1075","0","40.00","19.53"
"10","007","00","120","0019","0000","432","189","243","11","443","1271","0","34.85","14.87"
"10","007","00","120","0019","0788","432","189","243","11","443","1271","0","34.85","14.87"
"10","007","00","120","0020","0000","514","263","251","4","518","1561","0","33.18","16.85"
"10","007","00","120","0020","0798","245","122","123","2","247","766","0","32.25","15.93"
"10","007","00","120","0020","0799","269","141","128","2","271","795","0","34.09","17.74"
"10","007","00","120","0021","0000","324","137","187","5","329","913","0","36.04","15.01"
"10","007","00","120","0021","0800","324","137","187","5","329","913","0","36.04","15.01"
"10","007","00","120","0022","0000","326","129","197","5","331","866","0","38.22","14.90"
"10","007","00","120","0022","0801","326","129","197","5","331","866","0","38.22","14.90"
"10","007","00","130","0000","0000","11812","5558","6254","123","11935","33111","39085","36.05","16.79"
"10","007","00","130","0001","0000","1258","619","639","12","1270","3428","0","37.05","18.06"
"10","007","00","130","0001","0596","366","184","182","4","370","1055","0","35.07","17.44"
"10","007","00","130","0001","0597","410","201","209","1","411","1063","0","38.66","18.91"
"10","007","00","130","0001","0598","482","234","248","7","489","1310","0","37.33","17.86"
"10","007","00","130","0002","0000","583","274","309","1","584","1546","0","37.77","17.72"
"10","007","00","130","0002","0599","289","140","149","0","289","816","0","35.42","17.16"
"10","007","00","130","0002","0600","294","134","160","1","295","730","0","40.41","18.36"
"10","007","00","130","0003","0000","524","229","295","4","528","1493","0","35.37","15.34"
"10","007","00","130","0003","0604","524","229","295","4","528","1493","0","35.37","15.34"
"10","007","00","130","0004","0000","434","221","213","6","440","1209","0","36.39","18.28"
"10","007","00","130","0004","0601","434","221","213","6","440","1209","0","36.39","18.28"
"10","007","00","130","0005","0000","381","149","232","7","388","1172","0","33.11","12.71"
"10","007","00","130","0005","0611","381","149","232","7","388","1172","0","33.11","12.71"
"10","007","00","130","0006","0000","1585","814","771","17","1602","4186","0","38.27","19.45"
"10","007","00","130","0006","0614","467","271","196","5","472","1144","0","41.26","23.69"
"10","007","00","130","0006","0615","296","127","169","3","299","875","0","34.17","14.51"
"10","007","00","130","0006","0616","414","224","190","5","419","1139","0","36.79","19.67"
"10","007","00","130","0006","0618","408","192","216","4","412","1028","0","40.08","18.68"
"10","007","00","130","0007","0000","755","378","377","8","763","2092","0","36.47","18.07"
"10","007","00","130","0007","0619","432","215","217","3","435","1078","0","40.35","19.94"
"10","007","00","130","0007","0620","323","163","160","5","328","1014","0","32.35","16.07"
"10","007","00","130","0008","0000","862","397","465","13","875","2569","0","34.06","15.45"
"10","007","00","130","0008","0625","443","195","248","8","451","1232","0","36.61","15.83"
"10","007","00","130","0008","0626","419","202","217","5","424","1337","0","31.71","15.11"
"10","007","00","130","0009","0000","577","268","309","7","584","1569","0","37.22","17.08"
"10","007","00","130","0009","0602","264","117","147","5","269","692","0","38.87","16.91"
"10","007","00","130","0009","0603","313","151","162","2","315","877","0","35.92","17.22"
"10","007","00","130","0010","0000","533","242","291","8","541","1528","0","35.41","15.84"
"10","007","00","130","0010","0607","273","132","141","4","277","718","0","38.58","18.38"
"10","007","00","130","0010","0608","260","110","150","4","264","810","0","32.59","13.58"
"10","007","00","130","0011","0000","544","268","276","2","546","1420","0","38.45","18.87"
"10","007","00","130","0011","0617","544","268","276","2","546","1420","0","38.45","18.87"
"10","007","00","130","0012","0000","700","359","341","7","707","2033","0","34.78","17.66"
"10","007","00","130","0012","0605","313","188","125","3","316","832","0","37.98","22.60"
"10","007","00","130","0012","0606","387","171","216","4","391","1201","0","32.56","14.24"
"10","007","00","130","0013","0000","559","241","318","5","564","1624","0","34.73","14.84"
"10","007","00","130","0013","0609","296","145","151","3","299","806","0","37.10","17.99"
"10","007","00","130","0013","0610","263","96","167","2","265","818","0","32.40","11.74"
"10","007","00","130","0014","0000","973","450","523","11","984","2635","0","37.34","17.08"
"10","007","00","130","0014","0612","508","255","253","4","512","1353","0","37.84","18.85"
"10","007","00","130","0014","0613","465","195","270","7","472","1282","0","36.82","15.21"
"10","007","00","130","0015","0000","788","349","439","7","795","2428","0","32.74","14.37"
"10","007","00","130","0015","0621","358","153","205","5","363","1096","0","33.12","13.96"
"10","007","00","130","0015","0622","430","196","234","2","432","1332","0","32.43","14.71"
"10","007","00","130","0016","0000","756","300","456","8","764","2179","0","35.06","13.77"
"10","007","00","130","0016","0623","386","145","241","3","389","1054","0","36.91","13.76"
"10","007","00","130","0016","0624","370","155","215","5","375","1125","0","33.33","13.78"
"10","007","00","140","0000","0000","9447","5102","4345","125","9572","27733","31833","34.51","18.40"
"10","007","00","140","0001","0000","668","350","318","10","678","1664","0","40.75","21.03"
"10","007","00","140","0001","0704","355","172","183","7","362","906","0","39.96","18.98"
"10","007","00","140","0001","0705","313","178","135","3","316","758","0","41.69","23.48"
"10","007","00","140","0002","0000","549","280","269","4","553","1536","0","36.00","18.23"
"10","007","00","140","0002","0706","282","148","134","2","284","746","0","38.07","19.84"
"10","007","00","140","0002","0707","267","132","135","2","269","790","0","34.05","16.71"
"10","007","00","140","0003","0000","452","257","195","7","459","1251","0","36.69","20.54"
"10","007","00","140","0003","0708","452","257","195","7","459","1251","0","36.69","20.54"
"10","007","00","140","0004","0000","334","191","143","7","341","889","0","38.36","21.48"
"10","007","00","140","0004","0709","334","191","143","7","341","889","0","38.36","21.48"
"10","007","00","140","0005","0000","608","326","282","4","612","1750","0","34.97","18.63"
"10","007","00","140","0005","0710","320","180","140","0","320","882","0","36.28","20.41"
"10","007","00","140","0005","0711","288","146","142","4","292","868","0","33.64","16.82"
"10","007","00","140","0006","0000","329","152","177","5","334","939","0","35.57","16.19"
"10","007","00","140","0006","0712","329","152","177","5","334","939","0","35.57","16.19"
"10","007","00","140","0007","0000","450","213","237","7","457","1306","0","34.99","16.31"
"10","007","00","140","0007","0713","450","213","237","7","457","1306","0","34.99","16.31"
"10","007","00","140","0008","0000","384","194","190","3","387","1086","0","35.64","17.86"
"10","007","00","140","0008","0714","384","194","190","3","387","1086","0","35.64","17.86"
"10","007","00","140","0009","0000","273","161","112","3","276","656","0","42.07","24.54"
"10","007","00","140","0009","0715","273","161","112","3","276","656","0","42.07","24.54"
"10","007","00","140","0010","0000","420","208","212","6","426","1199","0","35.53","17.35"
"10","007","00","140","0010","0716","420","208","212","6","426","1199","0","35.53","17.35"
"10","007","00","140","0011","0000","555","305","250","3","558","1781","0","31.33","17.13"
"10","007","00","140","0011","0717","288","151","137","1","289","870","0","33.22","17.36"
"10","007","00","140","0011","0718","267","154","113","2","269","911","0","29.53","16.90"
"10","007","00","140","0012","0000","640","340","300","6","646","2059","0","31.37","16.51"
"10","007","00","140","0012","0719","304","136","168","3","307","1001","0","30.67","13.59"
"10","007","00","140","0012","0720","336","204","132","3","339","1058","0","32.04","19.28"
"10","007","00","140","0013","0000","394","183","211","6","400","1194","0","33.50","15.33"
"10","007","00","140","0013","0721","394","183","211","6","400","1194","0","33.50","15.33"
"10","007","00","140","0014","0000","185","113","72","3","188","456","0","41.23","24.78"
"10","007","00","140","0014","0722","185","113","72","3","188","456","0","41.23","24.78"
"10","007","00","140","0015","0000","375","210","165","4","379","1101","0","34.42","19.07"
"10","007","00","140","0015","0723","375","210","165","4","379","1101","0","34.42","19.07"
"10","007","00","140","0016","0000","308","155","153","8","316","848","0","37.26","18.28"
"10","007","00","140","0016","0724","308","155","153","8","316","848","0","37.26","18.28"
"10","007","00","140","0017","0000","392","183","209","7","399","1437","0","27.77","12.73"
"10","007","00","140","0017","0725","195","84","111","5","200","753","0","26.56","11.16"
"10","007","00","140","0017","0726","197","99","98","2","199","684","0","29.09","14.47"
"10","007","00","140","0018","0000","255","154","101","5","260","838","0","31.03","18.38"
"10","007","00","140","0018","0727","255","154","101","5","260","838","0","31.03","18.38"
"10","007","00","140","0019","0000","472","261","211","10","482","1538","0","31.34","16.97"
"10","007","00","140","0019","0728","230","129","101","5","235","813","0","28.91","15.87"
"10","007","00","140","0019","0729","242","132","110","5","247","725","0","34.07","18.21"
"10","007","00","140","0020","0000","507","339","168","7","514","1523","0","33.75","22.26"
"10","007","00","140","0020","0730","244","166","78","3","247","735","0","33.61","22.59"
"10","007","00","140","0020","0731","263","173","90","4","267","788","0","33.88","21.95"
"10","007","00","140","0021","0000","449","243","206","7","456","1368","0","33.33","17.76"
"10","007","00","140","0021","0732","254","137","117","3","257","709","0","36.25","19.32"
"10","007","00","140","0021","0733","195","106","89","4","199","659","0","30.20","16.08"
"10","007","00","140","0022","0000","448","284","164","3","451","1314","0","34.32","21.61"
"10","007","00","140","0022","0734","448","284","164","3","451","1314","0","34.32","21.61"
"10","007","00","150","0000","0000","10855","4713","6142","115","10970","29651","34223","37.00","15.89"
"10","007","00","150","0001","0000","1363","619","744","9","1372","3555","0","38.59","17.41"
"10","007","00","150","0001","0735","428","190","238","2","430","1109","0","38.77","17.13"
"10","007","00","150","0001","0736","447","190","257","2","449","1176","0","38.18","16.16"
"10","007","00","150","0001","0737","488","239","249","5","493","1270","0","38.82","18.82"
"10","007","00","150","0002","0000","462","184","278","5","467","1250","0","37.36","14.72"
"10","007","00","150","0002","0738","462","184","278","5","467","1250","0","37.36","14.72"
"10","007","00","150","0003","0000","615","310","305","3","618","1556","0","39.72","19.92"
"10","007","00","150","0003","0739","335","165","170","2","337","903","0","37.32","18.27"
"10","007","00","150","0003","0740","280","145","135","1","281","653","0","43.03","22.21"
"10","007","00","150","0004","0000","447","224","223","8","455","1258","0","36.17","17.81"
"10","007","00","150","0004","0741","447","224","223","8","455","1258","0","36.17","17.81"
"10","007","00","150","0005","0000","658","259","399","3","661","1740","0","37.99","14.89"
"10","007","00","150","0005","0742","216","92","124","1","217","610","0","35.57","15.08"
"10","007","00","150","0005","0743","442","167","275","2","444","1130","0","39.29","14.78"
"10","007","00","150","0006","0000","766","329","437","6","772","1976","0","39.07","16.65"
"10","007","00","150","0006","0744","419","179","240","3","422","1065","0","39.62","16.81"
"10","007","00","150","0006","0745","347","150","197","3","350","911","0","38.42","16.47"
"10","007","00","150","0007","0000","560","229","331","6","566","1422","0","39.80","16.10"
"10","007","00","150","0007","0746","292","100","192","1","293","762","0","38.45","13.12"
"10","007","00","150","0007","0747","268","129","139","5","273","660","0","41.36","19.55"
"10","007","00","150","0008","0000","658","298","360","3","661","1976","0","33.45","15.08"
"10","007","00","150","0008","0750","294","128","166","1","295","950","0","31.05","13.47"
"10","007","00","150","0008","0751","364","170","194","2","366","1026","0","35.67","16.57"
"10","007","00","150","0009","0000","885","373","512","14","899","2348","0","38.29","15.89"
"10","007","00","150","0009","0748","481","222","259","9","490","1354","0","36.19","16.40"
"10","007","00","150","0009","0749","404","151","253","5","409","994","0","41.15","15.19"
"10","007","00","150","0010","0000","227","95","132","2","229","658","0","34.80","14.44"
"10","007","00","150","0010","0752","227","95","132","2","229","658","0","34.80","14.44"
"10","007","00","150","0011","0000","435","195","240","8","443","1265","0","35.02","15.42"
"10","007","00","150","0011","0753","435","195","240","8","443","1265","0","35.02","15.42"
"10","007","00","150","0012","0000","574","248","326","3","577","1491","0","38.70","16.63"
"10","007","00","150","0012","0754","290","111","179","3","293","754","0","38.86","14.72"
"10","007","00","150","0012","0755","284","137","147","0","284","737","0","38.53","18.59"
"10","007","00","150","0013","0000","363","145","218","7","370","1065","0","34.74","13.62"
"10","007","00","150","0013","0756","363","145","218","7","370","1065","0","34.74","13.62"
"10","007","00","150","0014","0000","337","159","178","4","341","963","0","35.41","16.51"
"10","007","00","150","0014","0757","337","159","178","4","341","963","0","35.41","16.51"
"10","007","00","150","0015","0000","433","154","279","1","434","1305","0","33.26","11.80"
"10","007","00","150","0015","0760","227","81","146","1","228","667","0","34.18","12.14"
"10","007","00","150","0015","0761","206","73","133","0","206","638","0","32.29","11.44"
"10","007","00","150","0016","0000","664","256","408","7","671","1842","0","36.43","13.90"
"10","007","00","150","0016","0758","325","117","208","2","327","909","0","35.97","12.87"
"10","007","00","150","0016","0759","339","139","200","5","344","933","0","36.87","14.90"
"10","007","00","150","0017","0000","521","212","309","10","531","1436","0","36.98","14.76"
"10","007","00","150","0017","0763","521","212","309","10","531","1436","0","36.98","14.76"
"10","007","00","150","0018","0000","317","135","182","5","322","893","0","36.06","15.12"
"10","007","00","150","0018","0762","317","135","182","5","322","893","0","36.06","15.12"
"10","007","00","150","0019","0000","251","116","135","1","252","736","0","34.24","15.76"
"10","007","00","150","0019","0764","251","116","135","1","252","736","0","34.24","15.76"
"10","007","00","150","0020","0000","319","173","146","10","329","916","0","35.92","18.89"
"10","007","00","150","0020","0765","319","173","146","10","329","916","0","35.92","18.89"
"10","007","00","160","0000","0000","11383","5168","6215","136","11519","30808","36061","37.39","16.77"
"10","007","00","160","0001","0000","326","180","146","3","329","761","0","43.23","23.65"
"10","007","00","160","0001","0637","326","180","146","3","329","761","0","43.23","23.65"
"10","007","00","160","0002","0000","605","271","334","1","606","1503","0","40.32","18.03"
"10","007","00","160","0002","0638","285","118","167","0","285","695","0","41.01","16.98"
"10","007","00","160","0002","0639","320","153","167","1","321","808","0","39.73","18.94"
"10","007","00","160","0003","0000","730","359","371","8","738","1800","0","41.00","19.94"
"10","007","00","160","0003","0640","417","193","224","6","423","994","0","42.56","19.42"
"10","007","00","160","0003","0641","313","166","147","2","315","806","0","39.08","20.60"
"10","007","00","160","0004","0000","783","371","412","6","789","2147","0","36.75","17.28"
"10","007","00","160","0004","0642","416","198","218","1","417","1095","0","38.08","18.08"
"10","007","00","160","0004","0643","367","173","194","5","372","1052","0","35.36","16.44"
"10","007","00","160","0005","0000","661","294","367","7","668","1704","0","39.20","17.25"
"10","007","00","160","0005","0644","368","160","208","3","371","914","0","40.59","17.51"
"10","007","00","160","0005","0645","293","134","159","4","297","790","0","37.59","16.96"
"10","007","00","160","0006","0000","534","255","279","6","540","1438","0","37.55","17.73"
"10","007","00","160","0006","0646","312","158","154","2","314","813","0","38.62","19.43"
"10","007","00","160","0006","0647","222","97","125","4","226","625","0","36.16","15.52"
"10","007","00","160","0007","0000","380","118","262","8","388","1059","0","36.64","11.14"
"10","007","00","160","0007","0648","380","118","262","8","388","1059","0","36.64","11.14"
"10","007","00","160","0008","0000","354","203","151","7","361","1065","0","33.90","19.06"
"10","007","00","160","0008","0649","354","203","151","7","361","1065","0","33.90","19.06"
"10","007","00","160","0009","0000","974","470","504","15","989","2670","0","37.04","17.60"
"10","007","00","160","0009","0650","538","258","280","10","548","1429","0","38.35","18.05"
"10","007","00","160","0009","0651","436","212","224","5","441","1241","0","35.54","17.08"
"10","007","00","160","0010","0000","562","198","364","9","571","1368","0","41.74","14.47"
"10","007","00","160","0010","0632","250","82","168","7","257","653","0","39.36","12.56"
"10","007","00","160","0010","0633","312","116","196","2","314","715","0","43.92","16.22"
"10","007","00","160","0011","0000","364","166","198","1","365","1220","0","29.92","13.61"
"10","007","00","160","0011","0627","364","166","198","1","365","1220","0","29.92","13.61"
"10","007","00","160","0012","0000","552","224","328","9","561","1624","0","34.54","13.79"
"10","007","00","160","0012","0630","227","90","137","5","232","700","0","33.14","12.86"
"10","007","00","160","0012","0631","325","134","191","4","329","924","0","35.61","14.50"
"10","007","00","160","0013","0000","669","299","370","6","675","1908","0","35.38","15.67"
"10","007","00","160","0013","0628","324","146","178","3","327","883","0","37.03","16.53"
"10","007","00","160","0013","0629","345","153","192","3","348","1025","0","33.95","14.93"
"10","007","00","160","0014","0000","607","308","299","9","616","1558","0","39.54","19.77"
"10","007","00","160","0014","0634","269","108","161","5","274","742","0","36.93","14.56"
"10","007","00","160","0014","0635","338","200","138","4","342","816","0","41.91","24.51"
"10","007","00","160","0015","0000","514","230","284","7","521","1400","0","37.21","16.43"
"10","007","00","160","0015","0636","514","230","284","7","521","1400","0","37.21","16.43"
"10","007","00","160","0016","0000","260","129","131","2","262","825","0","31.76","15.64"
"10","007","00","160","0016","0652","260","129","131","2","262","825","0","31.76","15.64"
"10","007","00","160","0017","0000","246","112","134","0","246","710","0","34.65","15.77"
"10","007","00","160","0017","0653","246","112","134","0","246","710","0","34.65","15.77"
"10","007","00","160","0018","0000","305","111","194","4","309","736","0","41.98","15.08"
"10","007","00","160","0018","0654","305","111","194","4","309","736","0","41.98","15.08"
"10","007","00","160","0019","0000","253","105","148","3","256","654","0","39.14","16.06"
"10","007","00","160","0019","0655","253","105","148","3","256","654","0","39.14","16.06"
"10","007","00","160","0020","0000","310","148","162","5","315","847","0","37.19","17.47"
"10","007","00","160","0020","0656","310","148","162","5","315","847","0","37.19","17.47"
"10","007","00","160","0021","0000","293","136","157","6","299","809","0","36.96","16.81"
"10","007","00","160","0021","0657","293","136","157","6","299","809","0","36.96","16.81"
"10","007","00","160","0022","0000","241","130","111","5","246","637","0","38.62","20.41"
"10","007","00","160","0022","0658","241","130","111","5","246","637","0","38.62","20.41"
"10","007","00","160","0023","0000","356","188","168","3","359","1075","0","33.40","17.49"
"10","007","00","160","0023","0659","356","188","168","3","359","1075","0","33.40","17.49"
"10","007","00","160","0024","0000","504","163","341","6","510","1290","0","39.53","12.64"
"10","007","00","160","0024","0660","504","163","341","6","510","1290","0","39.53","12.64"
"10","007","00","170","0000","0000","13029","5680","7349","147","13176","35988","42279","36.61","15.78"
"10","007","00","170","0001","0000","1039","421","618","5","1044","2749","0","37.98","15.31"
"10","007","00","170","0001","0802","302","112","190","1","303","783","0","38.70","14.30"
"10","007","00","170","0001","0803","400","177","223","4","404","994","0","40.64","17.81"
"10","007","00","170","0001","0804","337","132","205","0","337","972","0","34.67","13.58"
"10","007","00","170","0002","0000","504","244","260","7","511","1460","0","35.00","16.71"
"10","007","00","170","0002","0809","269","137","132","2","271","765","0","35.42","17.91"
"10","007","00","170","0002","0810","235","107","128","5","240","695","0","34.53","15.40"
"10","007","00","170","0003","0000","426","154","272","3","429","1121","0","38.27","13.74"
"10","007","00","170","0003","0829","426","154","272","3","429","1121","0","38.27","13.74"
"10","007","00","170","0004","0000","1575","648","927","15","1590","4439","0","35.82","14.60"
"10","007","00","170","0004","0805","355","140","215","5","360","1002","0","35.93","13.97"
"10","007","00","170","0004","0806","349","159","190","1","350","1078","0","32.47","14.75"
"10","007","00","170","0004","0807","451","179","272","6","457","1191","0","38.37","15.03"
"10","007","00","170","0004","0808","420","170","250","3","423","1168","0","36.22","14.55"
"10","007","00","170","0005","0000","343","138","205","4","347","914","0","37.96","15.10"
"10","007","00","170","0005","0814","343","138","205","4","347","914","0","37.96","15.10"
"10","007","00","170","0006","0000","424","193","231","5","429","1096","0","39.14","17.61"
"10","007","00","170","0006","0836","424","193","231","5","429","1096","0","39.14","17.61"
"10","007","00","170","0007","0000","1042","500","542","10","1052","2717","0","38.72","18.40"
"10","007","00","170","0007","0822","307","160","147","3","310","704","0","44.03","22.73"
"10","007","00","170","0007","0823","330","152","178","4","334","901","0","37.07","16.87"
"10","007","00","170","0007","0824","405","188","217","3","408","1112","0","36.69","16.91"
"10","007","00","170","0008","0000","761","328","433","9","770","2068","0","37.23","15.86"
"10","007","00","170","0008","0815","395","161","234","3","398","996","0","39.96","16.16"
"10","007","00","170","0008","0816","366","167","199","6","372","1072","0","34.70","15.58"
"10","007","00","170","0009","0000","234","119","115","4","238","754","0","31.56","15.78"
"10","007","00","170","0009","0831","234","119","115","4","238","754","0","31.56","15.78"
"10","007","00","170","0010","0000","335","162","173","4","339","905","0","37.46","17.90"
"10","007","00","170","0010","0827","335","162","173","4","339","905","0","37.46","17.90"
"10","007","00","170","0011","0000","565","227","338","9","574","1712","0","33.53","13.26"
"10","007","00","170","0011","0820","264","92","172","4","268","728","0","36.81","12.64"
"10","007","00","170","0011","0821","301","135","166","5","306","984","0","31.10","13.72"
"10","007","00","170","0012","0000","298","156","142","6","304","968","0","31.40","16.12"
"10","007","00","170","0012","0835","298","156","142","6","304","968","0","31.40","16.12"
"10","007","00","170","0013","0000","459","207","252","5","464","1252","0","37.06","16.53"
"10","007","00","170","0013","0826","459","207","252","5","464","1252","0","37.06","16.53"
"10","007","00","170","0014","0000","545","240","305","6","551","1401","0","39.33","17.13"
"10","007","00","170","0014","0817","282","137","145","4","286","730","0","39.18","18.77"
"10","007","00","170","0014","0818","263","103","160","2","265","671","0","39.49","15.35"
"10","007","00","170","0015","0000","360","167","193","2","362","961","0","37.67","17.38"
"10","007","00","170","0015","0832","360","167","193","2","362","961","0","37.67","17.38"
"10","007","00","170","0016","0000","376","187","189","3","379","980","0","38.67","19.08"
"10","007","00","170","0016","0825","376","187","189","3","379","980","0","38.67","19.08"
"10","007","00","170","0017","0000","458","207","251","13","471","1204","0","39.12","17.19"
"10","007","00","170","0017","0819","458","207","251","13","471","1204","0","39.12","17.19"
"10","007","00","170","0018","0000","271","103","168","1","272","806","0","33.75","12.78"
"10","007","00","170","0018","0837","271","103","168","1","272","806","0","33.75","12.78"
"10","007","00","170","0019","0000","627","267","360","7","634","1581","0","40.10","16.89"
"10","007","00","170","0019","0812","352","135","217","5","357","867","0","41.18","15.57"
"10","007","00","170","0019","0813","275","132","143","2","277","714","0","38.80","18.49"
"10","007","00","170","0020","0000","337","125","212","6","343","977","0","35.11","12.79"
"10","007","00","170","0020","0830","337","125","212","6","343","977","0","35.11","12.79"
"10","007","00","170","0021","0000","512","201","311","4","516","1487","0","34.70","13.52"
"10","007","00","170","0021","0838","281","114","167","0","281","759","0","37.02","15.02"
"10","007","00","170","0021","0839","231","87","144","4","235","728","0","32.28","11.95"
"10","007","00","170","0022","0000","380","155","225","4","384","1028","0","37.35","15.08"
"10","007","00","170","0022","0811","380","155","225","4","384","1028","0","37.35","15.08"
"10","007","00","170","0023","0000","418","223","195","7","425","1260","0","33.73","17.70"
"10","007","00","170","0023","0828","418","223","195","7","425","1260","0","33.73","17.70"
"10","007","00","170","0024","0000","740","308","432","8","748","2148","0","34.82","14.34"
"10","007","00","170","0024","0833","387","172","215","6","393","1096","0","35.86","15.69"
"10","007","00","170","0024","0834","353","136","217","2","355","1052","0","33.75","12.93"
"10","007","00","180","0000","0000","5040","2302","2738","69","5109","12827","14488","39.83","17.95"
"10","007","00","180","0001","0000","311","143","168","0","311","821","0","37.88","17.42"
"10","007","00","180","0001","0842","311","143","168","0","311","821","0","37.88","17.42"
"10","007","00","180","0002","0000","371","148","223","7","378","916","0","41.27","16.16"
"10","007","00","180","0002","0843","371","148","223","7","378","916","0","41.27","16.16"
"10","007","00","180","0003","0000","238","115","123","3","241","610","0","39.51","18.85"
"10","007","00","180","0003","0844","238","115","123","3","241","610","0","39.51","18.85"
"10","007","00","180","0004","0000","254","122","132","1","255","609","0","41.87","20.03"
"10","007","00","180","0004","0845","254","122","132","1","255","609","0","41.87","20.03"
"10","007","00","180","0005","0000","378","177","201","3","381","883","0","43.15","20.05"
"10","007","00","180","0005","0847","378","177","201","3","381","883","0","43.15","20.05"
"10","007","00","180","0006","0000","363","185","178","3","366","933","0","39.23","19.83"
"10","007","00","180","0006","0846","363","185","178","3","366","933","0","39.23","19.83"
"10","007","00","180","0007","0000","317","143","174","6","323","776","0","41.62","18.43"
"10","007","00","180","0007","0849","317","143","174","6","323","776","0","41.62","18.43"
"10","007","00","180","0008","0000","194","117","77","6","200","438","0","45.66","26.71"
"10","007","00","180","0008","0848","194","117","77","6","200","438","0","45.66","26.71"
"10","007","00","180","0009","0000","369","171","198","3","372","996","0","37.35","17.17"
"10","007","00","180","0009","0851","369","171","198","3","372","996","0","37.35","17.17"
"10","007","00","180","0010","0000","336","142","194","4","340","801","0","42.45","17.73"
"10","007","00","180","0010","0850","336","142","194","4","340","801","0","42.45","17.73"
"10","007","00","180","0011","0000","265","94","171","2","267","776","0","34.41","12.11"
"10","007","00","180","0011","0852","265","94","171","2","267","776","0","34.41","12.11"
"10","007","00","180","0012","0000","288","153","135","3","291","779","0","37.36","19.64"
"10","007","00","180","0012","0853","288","153","135","3","291","779","0","37.36","19.64"
"10","007","00","180","0013","0000","264","102","162","4","268","665","0","40.30","15.34"
"10","007","00","180","0013","0854","264","102","162","4","268","665","0","40.30","15.34"
"10","007","00","180","0014","0000","233","117","116","6","239","597","0","40.03","19.60"
"10","007","00","180","0014","0855","233","117","116","6","239","597","0","40.03","19.60"
"10","007","00","180","0015","0000","218","110","108","1","219","562","0","38.97","19.57"
"10","007","00","180","0015","0856","218","110","108","1","219","562","0","38.97","19.57"
"10","007","00","180","0016","0000","375","152","223","12","387","1000","0","38.70","15.20"
"10","007","00","180","0016","0840","375","152","223","12","387","1000","0","38.70","15.20"
"10","007","00","180","0017","0000","266","111","155","5","271","665","0","40.75","16.69"
"10","007","00","180","0017","0841","266","111","155","5","271","665","0","40.75","16.69"
"10","007","00","190","0000","0000","10031","4695","5336","91","10122","27801","33351","36.41","16.89"
"10","007","00","190","0001","0000","684","325","359","3","687","1771","0","38.79","18.35"
"10","007","00","190","0001","0868","334","144","190","2","336","799","0","42.05","18.02"
"10","007","00","190","0001","0869","350","181","169","1","351","972","0","36.11","18.62"
"10","007","00","190","0002","0000","300","156","144","4","304","770","0","39.48","20.26"
"10","007","00","190","0002","0870","300","156","144","4","304","770","0","39.48","20.26"
"10","007","00","190","0003","0000","227","80","147","0","227","535","0","42.43","14.95"
"10","007","00","190","0003","0871","227","80","147","0","227","535","0","42.43","14.95"
"10","007","00","190","0004","0000","278","126","152","4","282","656","0","42.99","19.21"
"10","007","00","190","0004","0872","278","126","152","4","282","656","0","42.99","19.21"
"10","007","00","190","0005","0000","521","217","304","3","524","1406","0","37.27","15.43"
"10","007","00","190","0005","0873","272","109","163","2","274","648","0","42.28","16.82"
"10","007","00","190","0005","0874","249","108","141","1","250","758","0","32.98","14.25"
"10","007","00","190","0006","0000","536","313","223","4","540","1257","0","42.96","24.90"
"10","007","00","190","0006","0875","271","155","116","1","272","624","0","43.59","24.84"
"10","007","00","190","0006","0876","265","158","107","3","268","633","0","42.34","24.96"
"10","007","00","190","0007","0000","829","362","467","6","835","2278","0","36.65","15.89"
"10","007","00","190","0007","0877","409","171","238","3","412","1131","0","36.43","15.12"
"10","007","00","190","0007","0878","420","191","229","3","423","1147","0","36.88","16.65"
"10","007","00","190","0008","0000","1121","548","573","12","1133","3114","0","36.38","17.60"
"10","007","00","190","0008","0879","380","194","186","6","386","989","0","39.03","19.62"
"10","007","00","190","0008","0880","387","202","185","2","389","1068","0","36.42","18.91"
"10","007","00","190","0008","0881","354","152","202","4","358","1057","0","33.87","14.38"
"10","007","00","190","0009","0000","411","184","227","4","415","1307","0","31.75","14.08"
"10","007","00","190","0009","0882","411","184","227","4","415","1307","0","31.75","14.08"
"10","007","00","190","0010","0000","1740","822","918","18","1758","4588","0","38.32","17.92"
"10","007","00","190","0010","0862","413","231","182","4","417","1109","0","37.60","20.83"
"10","007","00","190","0010","0863","467","228","239","2","469","1080","0","43.43","21.11"
"10","007","00","190","0010","0864","465","197","268","7","472","1195","0","39.50","16.49"
"10","007","00","190","0010","0865","395","166","229","5","400","1204","0","33.22","13.79"
"10","007","00","190","0011","0000","551","279","272","5","556","1694","0","32.82","16.47"
"10","007","00","190","0011","0866","226","112","114","1","227","750","0","30.27","14.93"
"10","007","00","190","0011","0867","325","167","158","4","329","944","0","34.85","17.69"
"10","007","00","190","0012","0000","949","404","545","9","958","2702","0","35.46","14.95"
"10","007","00","190","0012","0857","332","139","193","4","336","915","0","36.72","15.19"
"10","007","00","190","0012","0858","303","123","180","4","307","918","0","33.44","13.40"
"10","007","00","190","0012","0859","314","142","172","1","315","869","0","36.25","16.34"
"10","007","00","190","0013","0000","704","278","426","4","708","1904","0","37.18","14.60"
"10","007","00","190","0013","0860","403","181","222","2","405","1103","0","36.72","16.41"
"10","007","00","190","0013","0861","301","97","204","2","303","801","0","37.83","12.11"
"10","007","00","190","0014","0000","591","293","298","7","598","2028","0","29.49","14.45"
"10","007","00","190","0014","0883","301","146","155","6","307","1086","0","28.27","13.44"
"10","007","00","190","0014","0884","290","147","143","1","291","942","0","30.89","15.61"
"10","007","00","190","0015","0000","589","308","281","8","597","1791","0","33.33","17.20"
"10","007","00","190","0015","0885","281","152","129","2","283","841","0","33.65","18.07"
"10","007","00","190","0015","0886","308","156","152","6","314","950","0","33.05","16.42"
"10","007","00","200","0000","0000","13329","6965","6364","226","13555","42339","49337","32.02","16.45"
"10","007","00","200","0001","0000","675","311","364","8","683","2094","0","32.62","14.85"
"10","007","00","200","0001","0971","286","132","154","2","288","838","0","34.37","15.75"
"10","007","00","200","0001","0972","389","179","210","6","395","1256","0","31.45","14.25"
"10","007","00","200","0002","0000","1113","636","477","14","1127","3227","0","34.92","19.71"
"10","007","00","200","0002","0973","369","204","165","5","374","1020","0","36.67","20.00"
"10","007","00","200","0002","0974","398","241","157","4","402","1125","0","35.73","21.42"
"10","007","00","200","0002","0975","346","191","155","5","351","1082","0","32.44","17.65"
"10","007","00","200","0003","0000","485","250","235","4","489","1498","0","32.64","16.69"
"10","007","00","200","0003","0976","485","250","235","4","489","1498","0","32.64","16.69"
"10","007","00","200","0004","0000","949","437","512","20","969","2966","0","32.67","14.73"
"10","007","00","200","0004","0977","320","147","173","10","330","985","0","33.50","14.92"
"10","007","00","200","0004","0978","300","119","181","5","305","1016","0","30.02","11.71"
"10","007","00","200","0004","0979","329","171","158","5","334","965","0","34.61","17.72"
"10","007","00","200","0005","0000","440","266","174","12","452","1610","0","28.07","16.52"
"10","007","00","200","0005","0980","202","124","78","4","206","660","0","31.21","18.79"
"10","007","00","200","0005","0981","238","142","96","8","246","950","0","25.89","14.95"
"10","007","00","200","0006","0000","382","197","185","11","393","1341","0","29.31","14.69"
"10","007","00","200","0006","0982","382","197","185","11","393","1341","0","29.31","14.69"
"10","007","00","200","0007","0000","300","129","171","2","302","1010","0","29.90","12.77"
"10","007","00","200","0007","0983","300","129","171","2","302","1010","0","29.90","12.77"
"10","007","00","200","0008","0000","271","147","124","4","275","976","0","28.18","15.06"
"10","007","00","200","0008","0984","271","147","124","4","275","976","0","28.18","15.06"
"10","007","00","200","0009","0000","390","223","167","7","397","1145","0","34.67","19.48"
"10","007","00","200","0009","0985","390","223","167","7","397","1145","0","34.67","19.48"
"10","007","00","200","0010","0000","518","281","237","9","527","1598","0","32.98","17.58"
"10","007","00","200","0010","0986","233","118","115","2","235","779","0","30.17","15.15"
"10","007","00","200","0010","0987","285","163","122","7","292","819","0","35.65","19.90"
"10","007","00","200","0011","0000","1118","631","487","18","1136","3312","0","34.30","19.05"
"10","007","00","200","0011","0988","296","155","141","9","305","987","0","30.90","15.70"
"10","007","00","200","0011","0989","375","230","145","4","379","1053","0","35.99","21.84"
"10","007","00","200","0011","0990","447","246","201","5","452","1272","0","35.53","19.34"
"10","007","00","200","0012","0000","743","379","364","5","748","2497","0","29.96","15.18"
"10","007","00","200","0012","0968","194","87","107","1","195","721","0","27.05","12.07"
"10","007","00","200","0012","0969","278","145","133","3","281","1003","0","28.02","14.46"
"10","007","00","200","0012","0970","271","147","124","1","272","773","0","35.19","19.02"
"10","007","00","200","0013","0000","362","196","166","10","372","1309","0","28.42","14.97"
"10","007","00","200","0013","0991","362","196","166","10","372","1309","0","28.42","14.97"
"10","007","00","200","0014","0000","467","254","213","14","481","1557","0","30.89","16.31"
"10","007","00","200","0014","0992","229","116","113","5","234","720","0","32.50","16.11"
"10","007","00","200","0014","0993","238","138","100","9","247","837","0","29.51","16.49"
"10","007","00","200","0015","0000","331","168","163","8","339","1180","0","28.73","14.24"
"10","007","00","200","0015","0994","331","168","163","8","339","1180","0","28.73","14.24"
"10","007","00","200","0016","0000","260","138","122","5","265","770","0","34.42","17.92"
"10","007","00","200","0016","0995","260","138","122","5","265","770","0","34.42","17.92"
"10","007","00","200","0017","0000","504","255","249","5","509","1485","0","34.28","17.17"
"10","007","00","200","0017","0996","320","158","162","0","320","837","0","38.23","18.88"
"10","007","00","200","0017","0997","184","97","87","5","189","648","0","29.17","14.97"
"10","007","00","200","0018","0000","352","152","200","5","357","1259","0","28.36","12.07"
"10","007","00","200","0018","0998","352","152","200","5","357","1259","0","28.36","12.07"
"10","007","00","200","0019","0000","334","171","163","6","340","1071","0","31.75","15.97"
"10","007","00","200","0019","0999","334","171","163","6","340","1071","0","31.75","15.97"
"10","007","00","200","0020","0000","1119","668","451","20","1139","3551","0","32.08","18.81"
"10","007","00","200","0020","1000","344","214","130","14","358","1171","0","30.57","18.27"
"10","007","00","200","0020","1001","442","264","178","1","443","1323","0","33.48","19.95"
"10","007","00","200","0020","1002","333","190","143","5","338","1057","0","31.98","17.98"
"10","007","00","200","0021","0000","297","146","151","6","303","958","0","31.63","15.24"
"10","007","00","200","0021","1004","297","146","151","6","303","958","0","31.63","15.24"
"10","007","00","200","0022","0000","288","170","118","11","299","1107","0","27.01","15.36"
"10","007","00","200","0022","1003","288","170","118","11","299","1107","0","27.01","15.36"
"10","007","00","200","0023","0000","247","120","127","3","250","886","0","28.22","13.54"
"10","007","00","200","0023","1005","247","120","127","3","250","886","0","28.22","13.54"
"10","007","00","200","0024","0000","484","233","251","6","490","1220","0","40.16","19.10"
"10","007","00","200","0024","1006","484","233","251","6","490","1220","0","40.16","19.10"
"10","007","00","200","0025","0000","337","172","165","3","340","1041","0","32.66","16.52"
"10","007","00","200","0025","1007","337","172","165","3","340","1041","0","32.66","16.52"
"10","007","00","200","0026","0000","361","144","217","6","367","967","0","37.95","14.89"
"10","007","00","200","0026","1008","361","144","217","6","367","967","0","37.95","14.89"
"10","007","00","200","0027","0000","202","91","111","4","206","704","0","29.26","12.93"
"10","007","00","200","0027","1009","202","91","111","4","206","704","0","29.26","12.93"
"10","007","00","210","0000","0000","8370","3826","4544","115","8485","22884","26569","37.08","16.72"
"10","007","00","210","0001","0000","490","233","257","10","500","1279","0","39.09","18.22"
"10","007","00","210","0001","0887","490","233","257","10","500","1279","0","39.09","18.22"
"10","007","00","210","0002","0000","269","139","130","4","273","793","0","34.43","17.53"
"10","007","00","210","0002","0897","269","139","130","4","273","793","0","34.43","17.53"
"10","007","00","210","0003","0000","957","503","454","11","968","2570","0","37.67","19.57"
"10","007","00","210","0003","0895","554","298","256","7","561","1396","0","40.19","21.35"
"10","007","00","210","0003","0896","403","205","198","4","407","1174","0","34.67","17.46"
"10","007","00","210","0004","0000","358","159","199","6","364","1054","0","34.54","15.09"
"10","007","00","210","0004","0906","358","159","199","6","364","1054","0","34.54","15.09"
"10","007","00","210","0005","0000","281","125","156","7","288","751","0","38.35","16.64"
"10","007","00","210","0005","0910","281","125","156","7","288","751","0","38.35","16.64"
"10","007","00","210","0006","0000","415","173","242","7","422","1022","0","41.29","16.93"
"10","007","00","210","0006","0911","415","173","242","7","422","1022","0","41.29","16.93"
"10","007","00","210","0007","0000","372","182","190","3","375","1202","0","31.20","15.14"
"10","007","00","210","0007","0908","372","182","190","3","375","1202","0","31.20","15.14"
"10","007","00","210","0008","0000","227","89","138","0","227","613","0","37.03","14.52"
"10","007","00","210","0008","0909","227","89","138","0","227","613","0","37.03","14.52"
"10","007","00","210","0009","0000","479","198","281","8","487","1329","0","36.64","14.90"
"10","007","00","210","0009","0907","479","198","281","8","487","1329","0","36.64","14.90"
"10","007","00","210","0010","0000","457","185","272","7","464","1280","0","36.25","14.45"
"10","007","00","210","0010","0894","457","185","272","7","464","1280","0","36.25","14.45"
"10","007","00","210","0011","0000","579","232","347","11","590","1535","0","38.44","15.11"
"10","007","00","210","0011","0892","248","108","140","6","254","658","0","38.60","16.41"
"10","007","00","210","0011","0893","331","124","207","5","336","877","0","38.31","14.14"
"10","007","00","210","0012","0000","440","192","248","4","444","1216","0","36.51","15.79"
"10","007","00","210","0012","0888","440","192","248","4","444","1216","0","36.51","15.79"
"10","007","00","210","0013","0000","668","307","361","10","678","1724","0","39.33","17.81"
"10","007","00","210","0013","0889","409","172","237","4","413","1027","0","40.21","16.75"
"10","007","00","210","0013","0890","259","135","124","6","265","697","0","38.02","19.37"
"10","007","00","210","0014","0000","417","213","204","4","421","941","0","44.74","22.64"
"10","007","00","210","0014","0902","417","213","204","4","421","941","0","44.74","22.64"
"10","007","00","210","0015","0000","297","140","157","6","303","870","0","34.83","16.09"
"10","007","00","210","0015","0903","297","140","157","6","303","870","0","34.83","16.09"
"10","007","00","210","0016","0000","455","203","252","3","458","1365","0","33.55","14.87"
"10","007","00","210","0016","0904","267","120","147","1","268","790","0","33.92","15.19"
"10","007","00","210","0016","0905","188","83","105","2","190","575","0","33.04","14.43"
"10","007","00","210","0017","0000","548","256","292","9","557","1594","0","34.94","16.06"
"10","007","00","210","0017","0898","222","123","99","4","226","635","0","35.59","19.37"
"10","007","00","210","0017","0899","326","133","193","5","331","959","0","34.52","13.87"
"10","007","00","210","0018","0000","93","41","52","1","94","258","0","36.43","15.89"
"10","007","00","210","0018","0900","93","41","52","1","94","258","0","36.43","15.89"
"10","007","00","210","0019","0000","224","90","134","2","226","613","0","36.87","14.68"
"10","007","00","210","0019","0901","224","90","134","2","226","613","0","36.87","14.68"
"10","007","00","210","0020","0000","344","166","178","2","346","875","0","39.54","18.97"
"10","007","00","210","0020","0891","344","166","178","2","346","875","0","39.54","18.97"
"10","007","00","220","0000","0000","8391","3840","4551","128","8519","25354","29860","33.60","15.15"
"10","007","00","220","0001","0000","768","356","412","14","782","2433","0","32.14","14.63"
"10","007","00","220","0001","0912","399","154","245","3","402","1127","0","35.67","13.66"
"10","007","00","220","0001","0913","369","202","167","11","380","1306","0","29.10","15.47"
"10","007","00","220","0002","0000","578","271","307","6","584","1785","0","32.72","15.18"
"10","007","00","220","0002","0914","331","166","165","4","335","973","0","34.43","17.06"
"10","007","00","220","0002","0915","247","105","142","2","249","812","0","30.67","12.93"
"10","007","00","220","0003","0000","580","233","347","4","584","1565","0","37.32","14.89"
"10","007","00","220","0003","0916","261","99","162","3","264","693","0","38.10","14.29"
"10","007","00","220","0003","0917","319","134","185","1","320","872","0","36.70","15.37"
"10","007","00","220","0004","0000","641","381","260","15","656","2256","0","29.08","16.89"
"10","007","00","220","0004","0918","287","166","121","3","290","1110","0","26.13","14.95"
"10","007","00","220","0004","0919","354","215","139","12","366","1146","0","31.94","18.76"
"10","007","00","220","0005","0000","411","199","212","0","411","1230","0","33.41","16.18"
"10","007","00","220","0005","0920","411","199","212","0","411","1230","0","33.41","16.18"
"10","007","00","220","0006","0000","519","223","296","12","531","1561","0","34.02","14.29"
"10","007","00","220","0006","0921","276","121","155","9","285","888","0","32.09","13.63"
"10","007","00","220","0006","0922","243","102","141","3","246","673","0","36.55","15.16"
"10","007","00","220","0007","0000","1176","641","535","9","1185","3254","0","36.42","19.70"
"10","007","00","220","0007","0923","411","209","202","2","413","1034","0","39.94","20.21"
"10","007","00","220","0007","0924","432","260","172","4","436","1319","0","33.06","19.71"
"10","007","00","220","0007","0925","333","172","161","3","336","901","0","37.29","19.09"
"10","007","00","220","0008","0000","671","343","328","15","686","2210","0","31.04","15.52"
"10","007","00","220","0008","0926","287","148","139","4","291","995","0","29.25","14.87"
"10","007","00","220","0008","0927","384","195","189","11","395","1215","0","32.51","16.05"
"10","007","00","220","0009","0000","233","92","141","7","240","710","0","33.80","12.96"
"10","007","00","220","0009","0928","233","92","141","7","240","710","0","33.80","12.96"
"10","007","00","220","0010","0000","206","87","119","0","206","558","0","36.92","15.59"
"10","007","00","220","0010","0929","206","87","119","0","206","558","0","36.92","15.59"
"10","007","00","220","0011","0000","491","255","236","6","497","1486","0","33.45","17.16"
"10","007","00","220","0011","0930","231","128","103","2","233","750","0","31.07","17.07"
"10","007","00","220","0011","0931","260","127","133","4","264","736","0","35.87","17.26"
"10","007","00","220","0012","0000","337","102","235","4","341","1021","0","33.40","9.99"
"10","007","00","220","0012","0932","337","102","235","4","341","1021","0","33.40","9.99"
"10","007","00","220","0013","0000","246","91","155","4","250","807","0","30.98","11.28"
"10","007","00","220","0013","0933","246","91","155","4","250","807","0","30.98","11.28"
"10","007","00","220","0014","0000","355","129","226","5","360","1052","0","34.22","12.26"
"10","007","00","220","0014","0934","355","129","226","5","360","1052","0","34.22","12.26"
"10","007","00","220","0015","0000","509","209","300","4","513","1457","0","35.21","14.34"
"10","007","00","220","0015","0935","254","100","154","1","255","729","0","34.98","13.72"
"10","007","00","220","0015","0936","255","109","146","3","258","728","0","35.44","14.97"
"10","007","00","220","0016","0000","331","114","217","12","343","1056","0","32.48","10.80"
"10","007","00","220","0016","0937","331","114","217","12","343","1056","0","32.48","10.80"
"10","007","00","220","0017","0000","339","114","225","11","350","913","0","38.34","12.49"
"10","007","00","220","0017","0938","339","114","225","11","350","913","0","38.34","12.49"
"10","007","00","230","0000","0000","8269","3503","4766","129","8398","28593","32372","29.37","12.25"
"10","007","00","230","0001","0000","248","84","164","9","257","928","0","27.69","9.05"
"10","007","00","230","0001","1027","248","84","164","9","257","928","0","27.69","9.05"
"10","007","00","230","0002","0000","146","65","81","3","149","395","0","37.72","16.46"
"10","007","00","230","0002","1028","146","65","81","3","149","395","0","37.72","16.46"
"10","007","00","230","0003","0000","221","116","105","5","226","735","0","30.75","15.78"
"10","007","00","230","0003","1029","221","116","105","5","226","735","0","30.75","15.78"
"10","007","00","230","0004","0000","133","58","75","1","134","522","0","25.67","11.11"
"10","007","00","230","0004","1030","133","58","75","1","134","522","0","25.67","11.11"
"10","007","00","230","0005","0000","229","122","107","5","234","949","0","24.66","12.86"
"10","007","00","230","0005","1031","229","122","107","5","234","949","0","24.66","12.86"
"10","007","00","230","0006","0000","671","296","375","10","681","2090","0","32.58","14.16"
"10","007","00","230","0006","1032","396","172","224","6","402","1248","0","32.21","13.78"
"10","007","00","230","0006","1033","275","124","151","4","279","842","0","33.14","14.73"
"10","007","00","230","0007","0000","407","200","207","3","410","1329","0","30.85","15.05"
"10","007","00","230","0007","1034","196","110","86","0","196","696","0","28.16","15.80"
"10","007","00","230","0007","1035","211","90","121","3","214","633","0","33.81","14.22"
"10","007","00","230","0008","0000","103","47","56","1","104","475","0","21.89","9.89"
"10","007","00","230","0008","1051","103","47","56","1","104","475","0","21.89","9.89"
"10","007","00","230","0009","0000","175","88","87","6","181","630","0","28.73","13.97"
"10","007","00","230","0009","1037","175","88","87","6","181","630","0","28.73","13.97"
"10","007","00","230","0010","0000","219","127","92","2","221","785","0","28.15","16.18"
"10","007","00","230","0010","1038","219","127","92","2","221","785","0","28.15","16.18"
"10","007","00","230","0011","0000","226","100","126","7","233","973","0","23.95","10.28"
"10","007","00","230","0011","1039","226","100","126","7","233","973","0","23.95","10.28"
"10","007","00","230","0012","0000","181","77","104","3","184","575","0","32.00","13.39"
"10","007","00","230","0012","1040","181","77","104","3","184","575","0","32.00","13.39"
"10","007","00","230","0013","0000","172","74","98","2","174","557","0","31.24","13.29"
"10","007","00","230","0013","1041","172","74","98","2","174","557","0","31.24","13.29"
"10","007","00","230","0014","0000","196","68","128","6","202","769","0","26.27","8.84"
"10","007","00","230","0014","1036","196","68","128","6","202","769","0","26.27","8.84"
"10","007","00","230","0015","0000","639","193","446","11","650","2116","0","30.72","9.12"
"10","007","00","230","0015","1042","341","88","253","6","347","1068","0","32.49","8.24"
"10","007","00","230","0015","1043","298","105","193","5","303","1048","0","28.91","10.02"
"10","007","00","230","0016","0000","245","65","180","3","248","673","0","36.85","9.66"
"10","007","00","230","0016","1044","245","65","180","3","248","673","0","36.85","9.66"
"10","007","00","230","0017","0000","211","88","123","4","215","727","0","29.57","12.10"
"10","007","00","230","0017","1045","211","88","123","4","215","727","0","29.57","12.10"
"10","007","00","230","0018","0000","213","68","145","3","216","665","0","32.48","10.23"
"10","007","00","230","0018","1048","213","68","145","3","216","665","0","32.48","10.23"
"10","007","00","230","0019","0000","375","115","260","4","379","1278","0","29.66","9.00"
"10","007","00","230","0019","1046","158","55","103","1","159","572","0","27.80","9.62"
"10","007","00","230","0019","1047","217","60","157","3","220","706","0","31.16","8.50"
"10","007","00","230","0020","0000","488","179","309","7","495","1656","0","29.89","10.81"
"10","007","00","230","0020","1049","226","101","125","3","229","897","0","25.53","11.26"
"10","007","00","230","0020","1050","262","78","184","4","266","759","0","35.05","10.28"
"10","007","00","230","0021","0000","450","219","231","0","450","1420","0","31.69","15.42"
"10","007","00","230","0021","1052","350","159","191","0","350","1103","0","31.73","14.42"
"10","007","00","230","0021","1053","100","60","40","0","100","317","0","31.55","18.93"
"10","007","00","230","0022","0000","235","114","121","2","237","1062","0","22.32","10.73"
"10","007","00","230","0022","1057","235","114","121","2","237","1062","0","22.32","10.73"
"10","007","00","230","0023","0000","589","259","330","3","592","2059","0","28.75","12.58"
"10","007","00","230","0023","1054","300","137","163","1","301","1100","0","27.36","12.45"
"10","007","00","230","0023","1055","289","122","167","2","291","959","0","30.34","12.72"
"10","007","00","230","0024","0000","214","109","105","8","222","762","0","29.13","14.30"
"10","007","00","230","0024","1056","214","109","105","8","222","762","0","29.13","14.30"
"10","007","00","230","0025","0000","328","142","186","11","339","1304","0","26.00","10.89"
"10","007","00","230","0025","1058","158","82","76","5","163","558","0","29.21","14.70"
"10","007","00","230","0025","1059","170","60","110","6","176","746","0","23.59","8.04"
"10","007","00","230","0026","0000","955","430","525","10","965","3159","0","30.55","13.61"
"10","007","00","230","0026","1060","272","119","153","1","273","865","0","31.56","13.76"
"10","007","00","230","0026","1061","375","163","212","6","381","1194","0","31.91","13.65"
"10","007","00","230","0026","1062","308","148","160","3","311","1100","0","28.27","13.45"
"10","007","00","240","0000","0000","3812","2076","1736","75","3887","14194","15893","27.38","14.63"
"10","007","00","240","0001","0000","313","127","186","5","318","1065","0","29.86","11.92"
"10","007","00","240","0001","1011","313","127","186","5","318","1065","0","29.86","11.92"
"10","007","00","240","0002","0000","314","183","131","7","321","1069","0","30.03","17.12"
"10","007","00","240","0002","1015","137","84","53","5","142","516","0","27.52","16.28"
"10","007","00","240","0002","1016","177","99","78","2","179","553","0","32.37","17.90"
"10","007","00","240","0003","0000","377","204","173","6","383","1296","0","29.55","15.74"
"10","007","00","240","0003","1013","377","204","173","6","383","1296","0","29.55","15.74"
"10","007","00","240","0004","0000","221","124","97","5","226","798","0","28.32","15.54"
"10","007","00","240","0004","1014","221","124","97","5","226","798","0","28.32","15.54"
"10","007","00","240","0005","0000","337","189","148","4","341","929","0","36.71","20.34"
"10","007","00","240","0005","1012","337","189","148","4","341","929","0","36.71","20.34"
"10","007","00","240","0006","0000","227","139","88","4","231","1048","0","22.04","13.26"
"10","007","00","240","0006","1022","227","139","88","4","231","1048","0","22.04","13.26"
"10","007","00","240","0007","0000","314","160","154","4","318","1256","0","25.32","12.74"
"10","007","00","240","0007","1010","314","160","154","4","318","1256","0","25.32","12.74"
"10","007","00","240","0008","0000","164","94","70","5","169","662","0","25.53","14.20"
"10","007","00","240","0008","1017","164","94","70","5","169","662","0","25.53","14.20"
"10","007","00","240","0009","0000","182","92","90","1","183","663","0","27.60","13.88"
"10","007","00","240","0009","1025","182","92","90","1","183","663","0","27.60","13.88"
"10","007","00","240","0010","0000","303","181","122","7","310","1045","0","29.67","17.32"
"10","007","00","240","0010","1018","110","69","41","0","110","373","0","29.49","18.50"
"10","007","00","240","0010","1019","193","112","81","7","200","672","0","29.76","16.67"
"10","007","00","240","0011","0000","222","114","108","8","230","861","0","26.71","13.24"
"10","007","00","240","0011","1026","222","114","108","8","230","861","0","26.71","13.24"
"10","007","00","240","0012","0000","274","168","106","4","278","1164","0","23.88","14.43"
"10","007","00","240","0012","1023","274","168","106","4","278","1164","0","23.88","14.43"
"10","007","00","240","0013","0000","239","152","87","5","244","867","0","28.14","17.53"
"10","007","00","240","0013","1024","239","152","87","5","244","867","0","28.14","17.53"
"10","007","00","240","0014","0000","215","86","129","5","220","845","0","26.04","10.18"
"10","007","00","240","0014","1020","215","86","129","5","220","845","0","26.04","10.18"
"10","007","00","240","0015","0000","110","63","47","5","115","626","0","18.37","10.06"
"10","007","00","240","0015","1021","110","63","47","5","115","626","0","18.37","10.06"
"10","007","00","250","0000","0000","4029","1699","2330","49","4078","12543","14669","32.51","13.55"
"10","007","00","250","0001","0000","384","195","189","6","390","1148","0","33.97","16.99"
"10","007","00","250","0001","1063","384","195","189","6","390","1148","0","33.97","16.99"
"10","007","00","250","0002","0000","646","339","307","2","648","1936","0","33.47","17.51"
"10","007","00","250","0002","1064","314","159","155","1","315","968","0","32.54","16.43"
"10","007","00","250","0002","1065","332","180","152","1","333","968","0","34.40","18.60"
"10","007","00","250","0003","0000","228","113","115","9","237","699","0","33.91","16.17"
"10","007","00","250","0003","1066","228","113","115","9","237","699","0","33.91","16.17"
"10","007","00","250","0004","0000","220","119","101","1","221","753","0","29.35","15.80"
"10","007","00","250","0004","1067","220","119","101","1","221","753","0","29.35","15.80"
"10","007","00","250","0005","0000","463","147","316","8","471","1527","0","30.84","9.63"
"10","007","00","250","0005","1068","233","72","161","3","236","771","0","30.61","9.34"
"10","007","00","250","0005","1069","230","75","155","5","235","756","0","31.08","9.92"
"10","007","00","250","0006","0000","207","69","138","4","211","641","0","32.92","10.76"
"10","007","00","250","0006","1070","207","69","138","4","211","641","0","32.92","10.76"
"10","007","00","250","0007","0000","326","145","181","2","328","1052","0","31.18","13.78"
"10","007","00","250","0007","1071","326","145","181","2","328","1052","0","31.18","13.78"
"10","007","00","250","0008","0000","349","136","213","3","352","1083","0","32.50","12.56"
"10","007","00","250","0008","1072","349","136","213","3","352","1083","0","32.50","12.56"
"10","007","00","250","0009","0000","172","63","109","2","174","471","0","36.94","13.38"
"10","007","00","250","0009","1073","172","63","109","2","174","471","0","36.94","13.38"
"10","007","00","250","0010","0000","237","108","129","1","238","785","0","30.32","13.76"
"10","007","00","250","0010","1074","237","108","129","1","238","785","0","30.32","13.76"
"10","007","00","250","0011","0000","218","91","127","2","220","626","0","35.14","14.54"
"10","007","00","250","0011","1075","218","91","127","2","220","626","0","35.14","14.54"
"10","007","00","250","0012","0000","186","51","135","3","189","536","0","35.26","9.51"
"10","007","00","250","0012","1076","186","51","135","3","189","536","0","35.26","9.51"
"10","007","00","250","0013","0000","248","80","168","3","251","750","0","33.47","10.67"
"10","007","00","250","0013","1077","248","80","168","3","251","750","0","33.47","10.67"
"10","007","00","250","0014","0000","145","43","102","3","148","536","0","27.61","8.02"
"10","007","00","250","0014","1078","145","43","102","3","148","536","0","27.61","8.02"
"10","007","00","260","0000","0000","8288","3226","5062","122","8410","25072","28983","33.54","12.87"
"10","007","00","260","0001","0000","598","237","361","6","604","1828","0","33.04","12.96"
"10","007","00","260","0001","0939","280","112","168","4","284","777","0","36.55","14.41"
"10","007","00","260","0001","0940","318","125","193","2","320","1051","0","30.45","11.89"
"10","007","00","260","0002","0000","493","197","296","11","504","1430","0","35.24","13.78"
"10","007","00","260","0002","0949","269","116","153","5","274","702","0","39.03","16.52"
"10","007","00","260","0002","0950","224","81","143","6","230","728","0","31.59","11.13"
"10","007","00","260","0003","0000","298","154","144","4","302","1131","0","26.70","13.62"
"10","007","00","260","0003","0955","298","154","144","4","302","1131","0","26.70","13.62"
"10","007","00","260","0004","0000","490","121","369","4","494","1499","0","32.96","8.07"
"10","007","00","260","0004","0966","194","48","146","1","195","675","0","28.89","7.11"
"10","007","00","260","0004","0967","296","73","223","3","299","824","0","36.29","8.86"
"10","007","00","260","0005","0000","246","86","160","7","253","699","0","36.19","12.30"
"10","007","00","260","0005","0941","246","86","160","7","253","699","0","36.19","12.30"
"10","007","00","260","0006","0000","464","197","267","5","469","1461","0","32.10","13.48"
"10","007","00","260","0006","0951","254","121","133","1","255","786","0","32.44","15.39"
"10","007","00","260","0006","0952","210","76","134","4","214","675","0","31.70","11.26"
"10","007","00","260","0007","0000","250","109","141","4","254","813","0","31.24","13.41"
"10","007","00","260","0007","0961","250","109","141","4","254","813","0","31.24","13.41"
"10","007","00","260","0008","0000","364","121","243","0","364","839","0","43.38","14.42"
"10","007","00","260","0008","0942","364","121","243","0","364","839","0","43.38","14.42"
"10","007","00","260","0009","0000","574","212","362","11","585","1977","0","29.59","10.72"
"10","007","00","260","0009","0953","330","119","211","5","335","1065","0","31.46","11.17"
"10","007","00","260","0009","0954","244","93","151","6","250","912","0","27.41","10.20"
"10","007","00","260","0010","0000","194","65","129","7","201","693","0","29.00","9.38"
"10","007","00","260","0010","0962","194","65","129","7","201","693","0","29.00","9.38"
"10","007","00","260","0011","0000","584","261","323","8","592","1516","0","39.05","17.22"
"10","007","00","260","0011","0943","259","108","151","3","262","632","0","41.46","17.09"
"10","007","00","260","0011","0944","325","153","172","5","330","884","0","37.33","17.31"
"10","007","00","260","0012","0000","510","211","299","4","514","1799","0","28.57","11.73"
"10","007","00","260","0012","0956","241","91","150","2","243","937","0","25.93","9.71"
"10","007","00","260","0012","0957","269","120","149","2","271","862","0","31.44","13.92"
"10","007","00","260","0013","0000","252","98","154","5","257","831","0","30.93","11.79"
"10","007","00","260","0013","0963","252","98","154","5","257","831","0","30.93","11.79"
"10","007","00","260","0014","0000","663","298","365","6","669","1827","0","36.62","16.31"
"10","007","00","260","0014","0945","341","158","183","4","345","959","0","35.97","16.48"
"10","007","00","260","0014","0946","322","140","182","2","324","868","0","37.33","16.13"
"10","007","00","260","0015","0000","546","169","377","13","559","1863","0","30.01","9.07"
"10","007","00","260","0015","0958","261","85","176","9","270","852","0","31.69","9.98"
"10","007","00","260","0015","0959","285","84","201","4","289","1011","0","28.59","8.31"
"10","007","00","260","0016","0000","436","179","257","10","446","1255","0","35.54","14.26"
"10","007","00","260","0016","0965","436","179","257","10","446","1255","0","35.54","14.26"
"10","007","00","260","0017","0000","716","297","419","9","725","1915","0","37.86","15.51"
"10","007","00","260","0017","0947","388","152","236","3","391","1077","0","36.30","14.11"
"10","007","00","260","0017","0948","328","145","183","6","334","838","0","39.86","17.30"
"10","007","00","260","0018","0000","282","147","135","5","287","850","0","33.76","17.29"
"10","007","00","260","0018","0960","282","147","135","5","287","850","0","33.76","17.29"
"10","007","00","260","0019","0000","328","67","261","3","331","846","0","39.13","7.92"
"10","007","00","260","0019","0964","328","67","261","3","331","846","0","39.13","7.92"
"10","008","00","000","0000","0000","155836","82471","73365","1727","157563","420687","487743","37.45","19.60"
"10","008","00","010","0000","0000","34675","19018","15657","317","34992","83549","98736","41.88","22.76"
"10","008","00","010","0001","0000","379","183","196","2","381","910","0","41.87","20.11"
"10","008","00","010","0001","0001","379","183","196","2","381","910","0","41.87","20.11"
"10","008","00","010","0002","0000","638","322","316","3","641","1370","0","46.79","23.50"
"10","008","00","010","0002","0002","312","167","145","1","313","624","0","50.16","26.76"
"10","008","00","010","0002","0003","326","155","171","2","328","746","0","43.97","20.78"
"10","008","00","010","0003","0000","331","166","165","2","333","772","0","43.13","21.50"
"10","008","00","010","0003","0004","331","166","165","2","333","772","0","43.13","21.50"
"10","008","00","010","0004","0000","259","101","158","1","260","486","0","53.50","20.78"
"10","008","00","010","0004","0005","259","101","158","1","260","486","0","53.50","20.78"
"10","008","00","010","0005","0000","262","116","146","1","263","574","0","45.82","20.21"
"10","008","00","010","0005","0006","262","116","146","1","263","574","0","45.82","20.21"
"10","008","00","010","0006","0000","193","79","114","3","196","366","0","53.55","21.58"
"10","008","00","010","0006","0007","193","79","114","3","196","366","0","53.55","21.58"
"10","008","00","010","0007","0000","424","217","207","4","428","933","0","45.87","23.26"
"10","008","00","010","0007","0008","424","217","207","4","428","933","0","45.87","23.26"
"10","008","00","010","0008","0000","1091","529","562","6","1097","2566","0","42.75","20.62"
"10","008","00","010","0008","0058","563","261","302","3","566","1347","0","42.02","19.38"
"10","008","00","010","0008","0059","528","268","260","3","531","1219","0","43.56","21.99"
"10","008","00","010","0009","0000","2823","1516","1307","28","2851","7006","0","40.69","21.64"
"10","008","00","010","0009","0060","511","298","213","5","516","1201","0","42.96","24.81"
"10","008","00","010","0009","0061","484","252","232","3","487","1305","0","37.32","19.31"
"10","008","00","010","0009","0062","426","202","224","8","434","1047","0","41.45","19.29"
"10","008","00","010","0009","0063","419","223","196","5","424","1029","0","41.21","21.67"
"10","008","00","010","0009","0064","506","299","207","6","512","1311","0","39.05","22.81"
"10","008","00","010","0009","0065","477","242","235","1","478","1113","0","42.95","21.74"
"10","008","00","010","0010","0000","1711","907","804","14","1725","4577","0","37.69","19.82"
"10","008","00","010","0010","0032","487","251","236","2","489","1326","0","36.88","18.93"
"10","008","00","010","0010","0033","542","289","253","9","551","1402","0","39.30","20.61"
"10","008","00","010","0010","0034","539","283","256","3","542","1497","0","36.21","18.90"
"10","008","00","010","0010","0035","143","84","59","0","143","352","0","40.63","23.86"
"10","008","00","010","0011","0000","146","67","79","4","150","376","0","39.89","17.82"
"10","008","00","010","0011","0036","146","67","79","4","150","376","0","39.89","17.82"
"10","008","00","010","0012","0000","2435","1312","1123","21","2456","6024","0","40.77","21.78"
"10","008","00","010","0012","0022","361","174","187","8","369","983","0","37.54","17.70"
"10","008","00","010","0012","0023","338","204","134","3","341","843","0","40.45","24.20"
"10","008","00","010","0012","0024","407","219","188","1","408","931","0","43.82","23.52"
"10","008","00","010","0012","0025","463","236","227","1","464","1121","0","41.39","21.05"
"10","008","00","010","0012","0026","426","229","197","4","430","980","0","43.88","23.37"
"10","008","00","010","0012","0027","440","250","190","4","444","1166","0","38.08","21.44"
"10","008","00","010","0013","0000","851","362","489","10","861","2053","0","41.94","17.63"
"10","008","00","010","0013","0028","242","110","132","3","245","597","0","41.04","18.43"
"10","008","00","010","0013","0029","301","118","183","6","307","745","0","41.21","15.84"
"10","008","00","010","0013","0030","308","134","174","1","309","711","0","43.46","18.85"
"10","008","00","010","0014","0000","403","187","216","6","409","1008","0","40.58","18.55"
"10","008","00","010","0014","0031","403","187","216","6","409","1008","0","40.58","18.55"
"10","008","00","010","0015","0000","2209","1253","956","25","2234","5330","0","41.91","23.51"
"10","008","00","010","0015","0009","500","245","255","5","505","1174","0","43.02","20.87"
"10","008","00","010","0015","0010","601","353","248","7","608","1511","0","40.24","23.36"
"10","008","00","010","0015","0011","487","287","200","3","490","1193","0","41.07","24.06"
"10","008","00","010","0015","0012","621","368","253","10","631","1452","0","43.46","25.34"
"10","008","00","010","0016","0000","1245","674","571","14","1259","2691","0","46.79","25.05"
"10","008","00","010","0016","0013","444","246","198","8","452","1023","0","44.18","24.05"
"10","008","00","010","0016","0014","298","171","127","3","301","653","0","46.09","26.19"
"10","008","00","010","0016","0015","503","257","246","3","506","1015","0","49.85","25.32"
"10","008","00","010","0017","0000","794","319","475","5","799","2109","0","37.89","15.13"
"10","008","00","010","0017","0016","424","158","266","1","425","1134","0","37.48","13.93"
"10","008","00","010","0017","0017","370","161","209","4","374","975","0","38.36","16.51"
"10","008","00","010","0018","0000","1665","871","794","20","1685","4405","0","38.25","19.77"
"10","008","00","010","0018","0018","501","291","210","7","508","1080","0","47.04","26.94"
"10","008","00","010","0018","0019","364","203","161","4","368","992","0","37.10","20.46"
"10","008","00","010","0018","0020","418","184","234","3","421","1115","0","37.76","16.50"
"10","008","00","010","0018","0021","382","193","189","6","388","1218","0","31.86","15.85"
"10","008","00","010","0019","0000","675","346","329","10","685","1866","0","36.71","18.54"
"10","008","00","010","0019","0083","331","149","182","7","338","977","0","34.60","15.25"
"10","008","00","010","0019","0084","344","197","147","3","347","889","0","39.03","22.16"
"10","008","00","010","0020","0000","254","116","138","7","261","779","0","33.50","14.89"
"10","008","00","010","0020","0081","254","116","138","7","261","779","0","33.50","14.89"
"10","008","00","010","0021","0000","197","60","137","5","202","606","0","33.33","9.90"
"10","008","00","010","0021","0082","197","60","137","5","202","606","0","33.33","9.90"
"10","008","00","010","0022","0000","340","114","226","5","345","1073","0","32.15","10.62"
"10","008","00","010","0022","0080","340","114","226","5","345","1073","0","32.15","10.62"
"10","008","00","010","0023","0000","2035","1057","978","17","2052","5387","0","38.09","19.62"
"10","008","00","010","0023","0066","568","305","263","2","570","1398","0","40.77","21.82"
"10","008","00","010","0023","0067","421","212","209","2","423","1058","0","39.98","20.04"
"10","008","00","010","0023","0068","592","311","281","6","598","1529","0","39.11","20.34"
"10","008","00","010","0023","0069","454","229","225","7","461","1402","0","32.88","16.33"
"10","008","00","010","0024","0000","1779","923","856","16","1795","4997","0","35.92","18.47"
"10","008","00","010","0024","0070","414","204","210","4","418","1057","0","39.55","19.30"
"10","008","00","010","0024","0071","455","217","238","5","460","1248","0","36.86","17.39"
"10","008","00","010","0024","0072","369","194","175","5","374","1272","0","29.40","15.25"
"10","008","00","010","0024","0073","541","308","233","2","543","1420","0","38.24","21.69"
"10","008","00","010","0025","0000","1100","554","546","4","1104","2815","0","39.22","19.68"
"10","008","00","010","0025","0074","345","190","155","2","347","823","0","42.16","23.09"
"10","008","00","010","0025","0075","377","189","188","0","377","973","0","38.75","19.42"
"10","008","00","010","0025","0076","378","175","203","2","380","1019","0","37.29","17.17"
"10","008","00","010","0026","0000","1136","544","592","6","1142","3015","0","37.88","18.04"
"10","008","00","010","0026","0077","366","179","187","0","366","957","0","38.24","18.70"
"10","008","00","010","0026","0078","389","179","210","4","393","997","0","39.42","17.95"
"10","008","00","010","0026","0079","381","186","195","2","383","1061","0","36.10","17.53"
"10","008","00","010","0027","0000","3080","2086","994","25","3105","5877","0","52.83","35.49"
"10","008","00","010","0027","0039","455","281","174","5","460","926","0","49.68","30.35"
"10","008","00","010","0027","0040","482","308","174","3","485","944","0","51.38","32.63"
"10","008","00","010","0027","0041","542","381","161","5","547","1015","0","53.89","37.54"
"10","008","00","010","0027","0042","575","413","162","3","578","1058","0","54.63","39.04"
"10","008","00","010","0027","0043","576","399","177","5","581","1079","0","53.85","36.98"
"10","008","00","010","0027","0044","450","304","146","4","454","855","0","53.10","35.56"
"10","008","00","010","0028","0000","1076","629","447","8","1084","2381","0","45.53","26.42"
"10","008","00","010","0028","0037","514","301","213","5","519","1124","0","46.17","26.78"
"10","008","00","010","0028","0038","562","328","234","3","565","1257","0","44.95","26.09"
"10","008","00","010","0029","0000","2958","1862","1096","25","2983","6642","0","44.91","28.03"
"10","008","00","010","0029","0045","490","272","218","3","493","1203","0","40.98","22.61"
"10","008","00","010","0029","0046","503","308","195","11","514","1115","0","46.10","27.62"
"10","008","00","010","0029","0047","585","345","240","5","590","1266","0","46.60","27.25"
"10","008","00","010","0029","0048","474","322","152","3","477","1095","0","43.56","29.41"
"10","008","00","010","0029","0049","625","455","170","1","626","1318","0","47.50","34.52"
"10","008","00","010","0029","0050","281","160","121","2","283","645","0","43.88","24.81"
"10","008","00","010","0030","0000","565","283","282","9","574","1402","0","40.94","20.19"
"10","008","00","010","0030","0051","277","125","152","4","281","688","0","40.84","18.17"
"10","008","00","010","0030","0052","288","158","130","5","293","714","0","41.04","22.13"
"10","008","00","010","0031","0000","362","283","79","1","363","738","0","49.19","38.35"
"10","008","00","010","0031","0057","362","283","79","1","363","738","0","49.19","38.35"
"10","008","00","010","0032","0000","503","412","91","6","509","993","0","51.26","41.49"
"10","008","00","010","0032","0054","224","186","38","2","226","469","0","48.19","39.66"
"10","008","00","010","0032","0055","279","226","53","4","283","524","0","54.01","43.13"
"10","008","00","010","0033","0000","470","390","80","0","470","908","0","51.76","42.95"
"10","008","00","010","0033","0056","470","390","80","0","470","908","0","51.76","42.95"
"10","008","00","010","0034","0000","286","178","108","4","290","514","0","56.42","34.63"
"10","008","00","010","0034","0053","286","178","108","4","290","514","0","56.42","34.63"
"10","008","00","020","0000","0000","24634","13621","11013","281","24915","67679","78732","36.81","20.13"
"10","008","00","020","0001","0000","1094","593","501","11","1105","2573","0","42.95","23.05"
"10","008","00","020","0001","0085","319","170","149","4","323","788","0","40.99","21.57"
"10","008","00","020","0001","0086","331","191","140","3","334","757","0","44.12","25.23"
"10","008","00","020","0001","0087","444","232","212","4","448","1028","0","43.58","22.57"
"10","008","00","020","0002","0000","406","203","203","2","408","785","0","51.97","25.86"
"10","008","00","020","0002","0106","406","203","203","2","408","785","0","51.97","25.86"
"10","008","00","020","0003","0000","1102","596","506","6","1108","2927","0","37.85","20.36"
"10","008","00","020","0003","0103","357","182","175","2","359","840","0","42.74","21.67"
"10","008","00","020","0003","0104","319","157","162","1","320","957","0","33.44","16.41"
"10","008","00","020","0003","0105","426","257","169","3","429","1130","0","37.96","22.74"
"10","008","00","020","0004","0000","831","497","334","8","839","2457","0","34.15","20.23"
"10","008","00","020","0004","0107","372","221","151","5","377","1216","0","31.00","18.17"
"10","008","00","020","0004","0108","459","276","183","3","462","1241","0","37.23","22.24"
"10","008","00","020","0005","0000","800","444","356","17","817","2163","0","37.77","20.53"
"10","008","00","020","0005","0122","411","213","198","10","421","1106","0","38.07","19.26"
"10","008","00","020","0005","0123","389","231","158","7","396","1057","0","37.46","21.85"
"10","008","00","020","0006","0000","474","268","206","1","475","997","0","47.64","26.88"
"10","008","00","020","0006","0127","474","268","206","1","475","997","0","47.64","26.88"
"10","008","00","020","0007","0000","1264","731","533","12","1276","3608","0","35.37","20.26"
"10","008","00","020","0007","0124","439","266","173","1","440","1103","0","39.89","24.12"
"10","008","00","020","0007","0125","457","277","180","7","464","1244","0","37.30","22.27"
"10","008","00","020","0007","0126","368","188","180","4","372","1261","0","29.50","14.91"
"10","008","00","020","0008","0000","2122","1206","916","26","2148","5729","0","37.49","21.05"
"10","008","00","020","0008","0128","295","162","133","5","300","927","0","32.36","17.48"
"10","008","00","020","0008","0129","340","189","151","3","343","955","0","35.92","19.79"
"10","008","00","020","0008","0130","426","261","165","7","433","1008","0","42.96","25.89"
"10","008","00","020","0008","0131","334","170","164","2","336","859","0","39.12","19.79"
"10","008","00","020","0008","0132","367","218","149","4","371","972","0","38.17","22.43"
"10","008","00","020","0008","0133","360","206","154","5","365","1008","0","36.21","20.44"
"10","008","00","020","0009","0000","400","177","223","4","404","931","0","43.39","19.01"
"10","008","00","020","0009","0134","400","177","223","4","404","931","0","43.39","19.01"
"10","008","00","020","0010","0000","2602","1556","1046","35","2637","7501","0","35.16","20.74"
"10","008","00","020","0010","0090","445","272","173","4","449","1276","0","35.19","21.32"
"10","008","00","020","0010","0091","330","214","116","3","333","864","0","38.54","24.77"
"10","008","00","020","0010","0092","414","220","194","9","423","1323","0","31.97","16.63"
"10","008","00","020","0010","0093","520","330","190","5","525","1310","0","40.08","25.19"
"10","008","00","020","0010","0094","449","274","175","5","454","1424","0","31.88","19.24"
"10","008","00","020","0010","0095","444","246","198","9","453","1304","0","34.74","18.87"
"10","008","00","020","0011","0000","1121","597","524","11","1132","3785","0","29.91","15.77"
"10","008","00","020","0011","0096","319","166","153","2","321","1138","0","28.21","14.59"
"10","008","00","020","0011","0097","343","182","161","6","349","1195","0","29.21","15.23"
"10","008","00","020","0011","0098","177","99","78","2","179","522","0","34.29","18.97"
"10","008","00","020","0011","0099","282","150","132","1","283","930","0","30.43","16.13"
"10","008","00","020","0012","0000","326","153","173","3","329","1019","0","32.29","15.01"
"10","008","00","020","0012","0100","326","153","173","3","329","1019","0","32.29","15.01"
"10","008","00","020","0013","0000","372","189","183","9","381","1106","0","34.45","17.09"
"10","008","00","020","0013","0101","372","189","183","9","381","1106","0","34.45","17.09"
"10","008","00","020","0014","0000","392","220","172","7","399","1116","0","35.75","19.71"
"10","008","00","020","0014","0102","392","220","172","7","399","1116","0","35.75","19.71"
"10","008","00","020","0015","0000","351","202","149","5","356","1007","0","35.35","20.06"
"10","008","00","020","0015","0135","351","202","149","5","356","1007","0","35.35","20.06"
"10","008","00","020","0016","0000","111","59","52","0","111","298","0","37.25","19.80"
"10","008","00","020","0016","0136","111","59","52","0","111","298","0","37.25","19.80"
"10","008","00","020","0017","0000","411","228","183","4","415","1324","0","31.34","17.22"
"10","008","00","020","0017","0137","411","228","183","4","415","1324","0","31.34","17.22"
"10","008","00","020","0018","0000","491","290","201","5","496","1412","0","35.13","20.54"
"10","008","00","020","0018","0138","248","149","99","3","251","691","0","36.32","21.56"
"10","008","00","020","0018","0139","243","141","102","2","245","721","0","33.98","19.56"
"10","008","00","020","0019","0000","602","330","272","9","611","1701","0","35.92","19.40"
"10","008","00","020","0019","0140","282","145","137","4","286","769","0","37.19","18.86"
"10","008","00","020","0019","0141","320","185","135","5","325","932","0","34.87","19.85"
"10","008","00","020","0020","0000","457","265","192","2","459","1348","0","34.05","19.66"
"10","008","00","020","0020","0142","322","187","135","0","322","952","0","33.82","19.64"
"10","008","00","020","0020","0143","135","78","57","2","137","396","0","34.60","19.70"
"10","008","00","020","0021","0000","260","134","126","5","265","661","0","40.09","20.27"
"10","008","00","020","0021","0144","260","134","126","5","265","661","0","40.09","20.27"
"10","008","00","020","0022","0000","393","253","140","5","398","988","0","40.28","25.61"
"10","008","00","020","0022","0145","393","253","140","5","398","988","0","40.28","25.61"
"10","008","00","020","0023","0000","362","198","164","4","366","1132","0","32.33","17.49"
"10","008","00","020","0023","0148","362","198","164","4","366","1132","0","32.33","17.49"
"10","008","00","020","0024","0000","220","135","85","2","222","580","0","38.28","23.28"
"10","008","00","020","0024","0149","220","135","85","2","222","580","0","38.28","23.28"
"10","008","00","020","0025","0000","334","135","199","5","339","962","0","35.24","14.03"
"10","008","00","020","0025","0150","334","135","199","5","339","962","0","35.24","14.03"
"10","008","00","020","0026","0000","1008","477","531","11","1019","2818","0","36.16","16.93"
"10","008","00","020","0026","0151","343","169","174","6","349","924","0","37.77","18.29"
"10","008","00","020","0026","0152","315","151","164","3","318","898","0","35.41","16.82"
"10","008","00","020","0026","0153","350","157","193","2","352","996","0","35.34","15.76"
"10","008","00","020","0027","0000","618","314","304","5","623","1661","0","37.51","18.90"
"10","008","00","020","0027","0117","267","115","152","3","270","734","0","36.78","15.67"
"10","008","00","020","0027","0118","351","199","152","2","353","927","0","38.08","21.47"
"10","008","00","020","0028","0000","866","469","397","9","875","2570","0","34.05","18.25"
"10","008","00","020","0028","0119","401","245","156","6","407","1185","0","34.35","20.68"
"10","008","00","020","0028","0120","313","158","155","2","315","938","0","33.58","16.84"
"10","008","00","020","0028","0121","152","66","86","1","153","447","0","34.23","14.77"
"10","008","00","020","0029","0000","573","247","326","6","579","1597","0","36.26","15.47"
"10","008","00","020","0029","0146","462","204","258","5","467","1300","0","35.92","15.69"
"10","008","00","020","0029","0147","111","43","68","1","112","297","0","37.71","14.48"
"10","008","00","020","0030","0000","1296","744","552","18","1314","3098","0","42.41","24.02"
"10","008","00","020","0030","0109","402","234","168","4","406","972","0","41.77","24.07"
"10","008","00","020","0030","0110","458","262","196","3","461","1099","0","41.95","23.84"
"10","008","00","020","0030","0111","436","248","188","11","447","1027","0","43.52","24.15"
"10","008","00","020","0031","0000","1005","549","456","9","1014","2585","0","39.23","21.24"
"10","008","00","020","0031","0088","536","279","257","4","540","1326","0","40.72","21.04"
"10","008","00","020","0031","0089","469","270","199","5","474","1259","0","37.65","21.45"
"10","008","00","020","0032","0000","1115","657","458","16","1131","3170","0","35.68","20.73"
"10","008","00","020","0032","0112","378","234","144","9","387","1003","0","38.58","23.33"
"10","008","00","020","0032","0113","359","214","145","3","362","1062","0","34.09","20.15"
"10","008","00","020","0032","0114","378","209","169","4","382","1105","0","34.57","18.91"
"10","008","00","020","0033","0000","855","505","350","9","864","2070","0","41.74","24.40"
"10","008","00","020","0033","0115","418","254","164","3","421","1065","0","39.53","23.85"
"10","008","00","020","0033","0116","437","251","186","6","443","1005","0","44.08","24.98"
"10","008","00","030","0000","0000","33852","17310","16542","299","34151","83201","97262","41.05","20.81"
"10","008","00","030","0001","0000","902","499","403","9","911","2084","0","43.71","23.94"
"10","008","00","030","0001","0154","415","205","210","4","419","974","0","43.02","21.05"
"10","008","00","030","0001","0155","487","294","193","5","492","1110","0","44.32","26.49"
"10","008","00","030","0002","0000","922","484","438","6","928","2059","0","45.07","23.51"
"10","008","00","030","0002","0159","458","243","215","2","460","1055","0","43.60","23.03"
"10","008","00","030","0002","0160","464","241","223","4","468","1004","0","46.61","24.00"
"10","008","00","030","0003","0000","505","244","261","7","512","1084","0","47.23","22.51"
"10","008","00","030","0003","0162","505","244","261","7","512","1084","0","47.23","22.51"
"10","008","00","030","0004","0000","2495","1342","1153","19","2514","6414","0","39.20","20.92"
"10","008","00","030","0004","0165","477","255","222","7","484","1243","0","38.94","20.51"
"10","008","00","030","0004","0166","413","248","165","2","415","1222","0","33.96","20.29"
"10","008","00","030","0004","0167","485","236","249","3","488","1232","0","39.61","19.16"
"10","008","00","030","0004","0168","562","294","268","5","567","1456","0","38.94","20.19"
"10","008","00","030","0004","0169","558","309","249","2","560","1261","0","44.41","24.50"
"10","008","00","030","0005","0000","3345","1975","1370","22","3367","7515","0","44.80","26.28"
"10","008","00","030","0005","0170","595","324","271","6","601","1196","0","50.25","27.09"
"10","008","00","030","0005","0171","470","289","181","4","474","1226","0","38.66","23.57"
"10","008","00","030","0005","0172","534","316","218","6","540","1186","0","45.53","26.64"
"10","008","00","030","0005","0173","502","314","188","1","503","1172","0","42.92","26.79"
"10","008","00","030","0005","0174","637","389","248","2","639","1373","0","46.54","28.33"
"10","008","00","030","0005","0175","607","343","264","3","610","1362","0","44.79","25.18"
"10","008","00","030","0006","0000","2533","1257","1276","20","2553","6652","0","38.38","18.90"
"10","008","00","030","0006","0209","556","271","285","1","557","1568","0","35.52","17.28"
"10","008","00","030","0006","0210","493","255","238","5","498","1229","0","40.52","20.75"
"10","008","00","030","0006","0211","395","185","210","2","397","1022","0","38.85","18.10"
"10","008","00","030","0006","0212","335","155","180","3","338","1036","0","32.63","14.96"
"10","008","00","030","0006","0213","482","258","224","6","488","1141","0","42.77","22.61"
"10","008","00","030","0006","0214","272","133","139","3","275","656","0","41.92","20.27"
"10","008","00","030","0007","0000","2393","1179","1214","22","2415","6108","0","39.54","19.30"
"10","008","00","030","0007","0191","553","301","252","6","559","1372","0","40.74","21.94"
"10","008","00","030","0007","0192","494","254","240","3","497","1157","0","42.96","21.95"
"10","008","00","030","0007","0193","538","272","266","6","544","1334","0","40.78","20.39"
"10","008","00","030","0007","0194","325","149","176","0","325","868","0","37.44","17.17"
"10","008","00","030","0007","0195","483","203","280","7","490","1377","0","35.58","14.74"
"10","008","00","030","0008","0000","1592","793","799","27","1619","4032","0","40.15","19.67"
"10","008","00","030","0008","0196","417","238","179","8","425","1000","0","42.50","23.80"
"10","008","00","030","0008","0197","435","248","187","2","437","1068","0","40.92","23.22"
"10","008","00","030","0008","0198","344","143","201","8","352","1002","0","35.13","14.27"
"10","008","00","030","0008","0199","396","164","232","9","405","962","0","42.10","17.05"
"10","008","00","030","0009","0000","1673","805","868","20","1693","4524","0","37.42","17.79"
"10","008","00","030","0009","0182","380","188","192","5","385","1062","0","36.25","17.70"
"10","008","00","030","0009","0183","437","208","229","5","442","1070","0","41.31","19.44"
"10","008","00","030","0009","0184","413","198","215","1","414","1149","0","36.03","17.23"
"10","008","00","030","0009","0185","443","211","232","9","452","1243","0","36.36","16.98"
"10","008","00","030","0010","0000","1039","594","445","10","1049","2446","0","42.89","24.28"
"10","008","00","030","0010","0186","619","352","267","5","624","1415","0","44.10","24.88"
"10","008","00","030","0010","0187","420","242","178","5","425","1031","0","41.22","23.47"
"10","008","00","030","0011","0000","1215","607","608","7","1222","2862","0","42.70","21.21"
"10","008","00","030","0011","0188","479","229","250","3","482","1057","0","45.60","21.67"
"10","008","00","030","0011","0189","357","175","182","2","359","856","0","41.94","20.44"
"10","008","00","030","0011","0190","379","203","176","2","381","949","0","40.15","21.39"
"10","008","00","030","0012","0000","1428","800","628","8","1436","3175","0","45.23","25.20"
"10","008","00","030","0012","0179","532","303","229","4","536","1141","0","46.98","26.56"
"10","008","00","030","0012","0180","433","252","181","2","435","1011","0","43.03","24.93"
"10","008","00","030","0012","0181","463","245","218","2","465","1023","0","45.45","23.95"
"10","008","00","030","0013","0000","1449","773","676","10","1459","3702","0","39.41","20.88"
"10","008","00","030","0013","0200","441","214","227","2","443","1183","0","37.45","18.09"
"10","008","00","030","0013","0201","501","300","201","3","504","1114","0","45.24","26.93"
"10","008","00","030","0013","0202","507","259","248","5","512","1405","0","36.44","18.43"
"10","008","00","030","0014","0000","1180","491","689","19","1199","2951","0","40.63","16.64"
"10","008","00","030","0014","0206","406","172","234","6","412","950","0","43.37","18.11"
"10","008","00","030","0014","0207","322","149","173","3","325","965","0","33.68","15.44"
"10","008","00","030","0014","0208","452","170","282","10","462","1036","0","44.59","16.41"
"10","008","00","030","0015","0000","582","233","349","4","586","1502","0","39.01","15.51"
"10","008","00","030","0015","0205","582","233","349","4","586","1502","0","39.01","15.51"
"10","008","00","030","0016","0000","941","398","543","3","944","2217","0","42.58","17.95"
"10","008","00","030","0016","0203","390","166","224","1","391","919","0","42.55","18.06"
"10","008","00","030","0016","0204","551","232","319","2","553","1298","0","42.60","17.87"
"10","008","00","030","0017","0000","727","329","398","8","735","1858","0","39.56","17.71"
"10","008","00","030","0017","0215","285","139","146","3","288","689","0","41.80","20.17"
"10","008","00","030","0017","0216","259","100","159","2","261","668","0","39.07","14.97"
"10","008","00","030","0017","0217","183","90","93","3","186","501","0","37.13","17.96"
"10","008","00","030","0018","0000","895","350","545","9","904","2029","0","44.55","17.25"
"10","008","00","030","0018","0218","469","179","290","6","475","1159","0","40.98","15.44"
"10","008","00","030","0018","0219","426","171","255","3","429","870","0","49.31","19.66"
"10","008","00","030","0019","0000","1555","712","843","5","1560","4072","0","38.31","17.49"
"10","008","00","030","0019","0220","419","201","218","1","420","1100","0","38.18","18.27"
"10","008","00","030","0019","0221","373","164","209","1","374","933","0","40.09","17.58"
"10","008","00","030","0019","0222","352","175","177","2","354","956","0","37.03","18.31"
"10","008","00","030","0019","0223","411","172","239","1","412","1083","0","38.04","15.88"
"10","008","00","030","0020","0000","596","342","254","8","604","1658","0","36.43","20.63"
"10","008","00","030","0020","0225","238","146","92","7","245","641","0","38.22","22.78"
"10","008","00","030","0020","0226","358","196","162","1","359","1017","0","35.30","19.27"
"10","008","00","030","0021","0000","396","197","199","3","399","1017","0","39.23","19.37"
"10","008","00","030","0021","0224","396","197","199","3","399","1017","0","39.23","19.37"
"10","008","00","030","0022","0000","691","338","353","14","705","2247","0","31.38","15.04"
"10","008","00","030","0022","0228","357","166","191","10","367","1160","0","31.64","14.31"
"10","008","00","030","0022","0229","334","172","162","4","338","1087","0","31.09","15.82"
"10","008","00","030","0023","0000","408","215","193","3","411","1070","0","38.41","20.09"
"10","008","00","030","0023","0227","408","215","193","3","411","1070","0","38.41","20.09"
"10","008","00","030","0024","0000","309","161","148","3","312","664","0","46.99","24.25"
"10","008","00","030","0024","0161","309","161","148","3","312","664","0","46.99","24.25"
"10","008","00","030","0025","0000","1094","527","567","10","1104","2330","0","47.38","22.62"
"10","008","00","030","0025","0163","461","247","214","2","463","939","0","49.31","26.30"
"10","008","00","030","0025","0164","633","280","353","8","641","1391","0","46.08","20.13"
"10","008","00","030","0026","0000","1558","832","726","13","1571","3714","0","42.30","22.40"
"10","008","00","030","0026","0156","632","325","307","6","638","1402","0","45.51","23.18"
"10","008","00","030","0026","0157","401","187","214","4","405","1071","0","37.82","17.46"
"10","008","00","030","0026","0158","525","320","205","3","528","1241","0","42.55","25.79"
"10","008","00","030","0027","0000","1429","833","596","10","1439","3215","0","44.76","25.91"
"10","008","00","030","0027","0176","435","237","198","3","438","974","0","44.97","24.33"
"10","008","00","030","0027","0177","588","384","204","4","592","1331","0","44.48","28.85"
"10","008","00","030","0027","0178","406","212","194","3","409","910","0","44.95","23.30"
"10","008","00","040","0000","0000","16486","8039","8447","203","16689","46058","53033","36.23","17.45"
"10","008","00","040","0001","0000","846","431","415","10","856","1957","0","43.74","22.02"
"10","008","00","040","0001","0230","483","258","225","6","489","1155","0","42.34","22.34"
"10","008","00","040","0001","0231","363","173","190","4","367","802","0","45.76","21.57"
"10","008","00","040","0002","0000","230","112","118","3","233","614","0","37.95","18.24"
"10","008","00","040","0002","0232","230","112","118","3","233","614","0","37.95","18.24"
"10","008","00","040","0003","0000","1678","836","842","22","1700","4553","0","37.34","18.36"
"10","008","00","040","0003","0233","353","159","194","6","359","884","0","40.61","17.99"
"10","008","00","040","0003","0234","389","191","198","4","393","1127","0","34.87","16.95"
"10","008","00","040","0003","0235","418","229","189","9","427","1196","0","35.70","19.15"
"10","008","00","040","0003","0236","518","257","261","3","521","1346","0","38.71","19.09"
"10","008","00","040","0004","0000","1331","703","628","9","1340","3463","0","38.69","20.30"
"10","008","00","040","0004","0237","448","248","200","4","452","1131","0","39.96","21.93"
"10","008","00","040","0004","0238","413","202","211","3","416","1073","0","38.77","18.83"
"10","008","00","040","0004","0239","470","253","217","2","472","1259","0","37.49","20.10"
"10","008","00","040","0005","0000","643","313","330","9","652","1752","0","37.21","17.87"
"10","008","00","040","0005","0271","289","141","148","2","291","790","0","36.84","17.85"
"10","008","00","040","0005","0272","354","172","182","7","361","962","0","37.53","17.88"
"10","008","00","040","0006","0000","459","239","220","13","472","1189","0","39.70","20.10"
"10","008","00","040","0006","0245","200","92","108","5","205","490","0","41.84","18.78"
"10","008","00","040","0006","0246","259","147","112","8","267","699","0","38.20","21.03"
"10","008","00","040","0007","0000","1268","623","645","18","1286","3652","0","35.21","17.06"
"10","008","00","040","0007","0242","459","239","220","7","466","1279","0","36.43","18.69"
"10","008","00","040","0007","0243","442","229","213","8","450","1324","0","33.99","17.30"
"10","008","00","040","0007","0244","367","155","212","3","370","1049","0","35.27","14.78"
"10","008","00","040","0008","0000","326","97","229","3","329","894","0","36.80","10.85"
"10","008","00","040","0008","0247","326","97","229","3","329","894","0","36.80","10.85"
"10","008","00","040","0009","0000","449","225","224","6","455","1401","0","32.48","16.06"
"10","008","00","040","0009","0248","449","225","224","6","455","1401","0","32.48","16.06"
"10","008","00","040","0010","0000","332","163","169","7","339","878","0","38.61","18.56"
"10","008","00","040","0010","0273","140","58","82","5","145","367","0","39.51","15.80"
"10","008","00","040","0010","0274","192","105","87","2","194","511","0","37.96","20.55"
"10","008","00","040","0011","0000","954","414","540","15","969","2802","0","34.58","14.78"
"10","008","00","040","0011","0261","400","187","213","3","403","1293","0","31.17","14.46"
"10","008","00","040","0011","0262","354","166","188","8","362","944","0","38.35","17.58"
"10","008","00","040","0011","0263","200","61","139","4","204","565","0","36.11","10.80"
"10","008","00","040","0012","0000","534","247","287","9","543","1678","0","32.36","14.72"
"10","008","00","040","0012","0259","270","129","141","4","274","891","0","30.75","14.48"
"10","008","00","040","0012","0260","264","118","146","5","269","787","0","34.18","14.99"
"10","008","00","040","0013","0000","316","148","168","4","320","839","0","38.14","17.64"
"10","008","00","040","0013","0264","316","148","168","4","320","839","0","38.14","17.64"
"10","008","00","040","0014","0000","1714","830","884","18","1732","4860","0","35.64","17.08"
"10","008","00","040","0014","0252","479","246","233","3","482","1435","0","33.59","17.14"
"10","008","00","040","0014","0253","456","229","227","3","459","1289","0","35.61","17.77"
"10","008","00","040","0014","0254","391","194","197","8","399","1085","0","36.77","17.88"
"10","008","00","040","0014","0255","388","161","227","4","392","1051","0","37.30","15.32"
"10","008","00","040","0015","0000","597","271","326","4","601","1818","0","33.06","14.91"
"10","008","00","040","0015","0265","391","168","223","2","393","1171","0","33.56","14.35"
"10","008","00","040","0015","0266","206","103","103","2","208","647","0","32.15","15.92"
"10","008","00","040","0016","0000","469","219","250","9","478","1312","0","36.43","16.69"
"10","008","00","040","0016","0267","469","219","250","9","478","1312","0","36.43","16.69"
"10","008","00","040","0017","0000","380","179","201","4","384","1132","0","33.92","15.81"
"10","008","00","040","0017","0268","380","179","201","4","384","1132","0","33.92","15.81"
"10","008","00","040","0018","0000","232","120","112","3","235","595","0","39.50","20.17"
"10","008","00","040","0018","0269","232","120","112","3","235","595","0","39.50","20.17"
"10","008","00","040","0019","0000","131","75","56","1","132","422","0","31.28","17.77"
"10","008","00","040","0019","0251","131","75","56","1","132","422","0","31.28","17.77"
"10","008","00","040","0020","0000","182","87","95","1","183","577","0","31.72","15.08"
"10","008","00","040","0020","0270","182","87","95","1","183","577","0","31.72","15.08"
"10","008","00","040","0021","0000","221","137","84","2","223","591","0","37.73","23.18"
"10","008","00","040","0021","0275","77","60","17","0","77","194","0","39.69","30.93"
"10","008","00","040","0021","0276","144","77","67","2","146","397","0","36.78","19.40"
"10","008","00","040","0022","0000","214","109","105","2","216","733","0","29.47","14.87"
"10","008","00","040","0022","0277","133","71","62","0","133","454","0","29.30","15.64"
"10","008","00","040","0022","0278","81","38","43","2","83","279","0","29.75","13.62"
"10","008","00","040","0023","0000","179","89","90","1","180","562","0","32.03","15.84"
"10","008","00","040","0023","0280","179","89","90","1","180","562","0","32.03","15.84"
"10","008","00","040","0024","0000","162","82","80","0","162","446","0","36.32","18.39"
"10","008","00","040","0024","0279","162","82","80","0","162","446","0","36.32","18.39"
"10","008","00","040","0025","0000","224","99","125","9","233","865","0","26.94","11.45"
"10","008","00","040","0025","0281","128","55","73","8","136","486","0","27.98","11.32"
"10","008","00","040","0025","0282","96","44","52","1","97","379","0","25.59","11.61"
"10","008","00","040","0026","0000","264","121","143","2","266","674","0","39.47","17.95"
"10","008","00","040","0026","0249","80","40","40","0","80","217","0","36.87","18.43"
"10","008","00","040","0026","0250","184","81","103","2","186","457","0","40.70","17.72"
"10","008","00","040","0027","0000","1323","645","678","8","1331","3551","0","37.48","18.16"
"10","008","00","040","0027","0256","471","230","241","2","473","1284","0","36.84","17.91"
"10","008","00","040","0027","0257","378","170","208","2","380","1034","0","36.75","16.44"
"10","008","00","040","0027","0258","474","245","229","4","478","1233","0","38.77","19.87"
"10","008","00","040","0028","0000","828","425","403","11","839","2248","0","37.32","18.91"
"10","008","00","040","0028","0240","426","226","200","4","430","1079","0","39.85","20.95"
"10","008","00","040","0028","0241","402","199","203","7","409","1169","0","34.99","17.02"
"10","008","00","050","0000","0000","3388","1782","1606","50","3438","9241","10350","37.20","19.28"
"10","008","00","050","0001","0000","445","262","183","8","453","1076","0","42.10","24.35"
"10","008","00","050","0001","0283","445","262","183","8","453","1076","0","42.10","24.35"
"10","008","00","050","0002","0000","330","177","153","7","337","872","0","38.65","20.30"
"10","008","00","050","0002","0284","330","177","153","7","337","872","0","38.65","20.30"
"10","008","00","050","0003","0000","197","89","108","2","199","549","0","36.25","16.21"
"10","008","00","050","0003","0285","197","89","108","2","199","549","0","36.25","16.21"
"10","008","00","050","0004","0000","386","184","202","6","392","1141","0","34.36","16.13"
"10","008","00","050","0004","0286","207","98","109","4","211","611","0","34.53","16.04"
"10","008","00","050","0004","0287","179","86","93","2","181","530","0","34.15","16.23"
"10","008","00","050","0005","0000","163","71","92","1","164","463","0","35.42","15.33"
"10","008","00","050","0005","0288","163","71","92","1","164","463","0","35.42","15.33"
"10","008","00","050","0006","0000","174","91","83","0","174","472","0","36.86","19.28"
"10","008","00","050","0006","0289","174","91","83","0","174","472","0","36.86","19.28"
"10","008","00","050","0007","0000","340","198","142","6","346","877","0","39.45","22.58"
"10","008","00","050","0007","0290","340","198","142","6","346","877","0","39.45","22.58"
"10","008","00","050","0008","0000","518","270","248","7","525","1415","0","37.10","19.08"
"10","008","00","050","0008","0291","305","170","135","3","308","756","0","40.74","22.49"
"10","008","00","050","0008","0292","213","100","113","4","217","659","0","32.93","15.17"
"10","008","00","050","0009","0000","350","163","187","7","357","943","0","37.86","17.29"
"10","008","00","050","0009","0293","350","163","187","7","357","943","0","37.86","17.29"
"10","008","00","050","0010","0000","191","103","88","3","194","544","0","35.66","18.93"
"10","008","00","050","0010","0296","191","103","88","3","194","544","0","35.66","18.93"
"10","008","00","050","0011","0000","294","174","120","3","297","889","0","33.41","19.57"
"10","008","00","050","0011","0294","170","100","70","3","173","489","0","35.38","20.45"
"10","008","00","050","0011","0295","124","74","50","0","124","400","0","31.00","18.50"
"10","008","00","060","0000","0000","12235","5282","6953","173","12408","32758","37230","37.88","16.12"
"10","008","00","060","0001","0000","420","207","213","3","423","1008","0","41.96","20.54"
"10","008","00","060","0001","0297","420","207","213","3","423","1008","0","41.96","20.54"
"10","008","00","060","0002","0000","1320","621","699","14","1334","3391","0","39.34","18.31"
"10","008","00","060","0002","0298","366","165","201","3","369","906","0","40.73","18.21"
"10","008","00","060","0002","0299","283","125","158","6","289","701","0","41.23","17.83"
"10","008","00","060","0002","0300","331","161","170","5","336","862","0","38.98","18.68"
"10","008","00","060","0002","0301","340","170","170","0","340","922","0","36.88","18.44"
"10","008","00","060","0003","0000","766","369","397","9","775","2202","0","35.20","16.76"
"10","008","00","060","0003","0302","342","178","164","5","347","1043","0","33.27","17.07"
"10","008","00","060","0003","0303","424","191","233","4","428","1159","0","36.93","16.48"
"10","008","00","060","0004","0000","609","282","327","5","614","1540","0","39.87","18.31"
"10","008","00","060","0004","0304","299","138","161","3","302","788","0","38.32","17.51"
"10","008","00","060","0004","0305","310","144","166","2","312","752","0","41.49","19.15"
"10","008","00","060","0005","0000","319","129","190","3","322","978","0","32.92","13.19"
"10","008","00","060","0005","0307","319","129","190","3","322","978","0","32.92","13.19"
"10","008","00","060","0006","0000","370","150","220","8","378","957","0","39.50","15.67"
"10","008","00","060","0006","0306","370","150","220","8","378","957","0","39.50","15.67"
"10","008","00","060","0007","0000","1588","686","902","21","1609","4169","0","38.59","16.45"
"10","008","00","060","0007","0308","330","144","186","4","334","896","0","37.28","16.07"
"10","008","00","060","0007","0309","396","176","220","4","400","1011","0","39.56","17.41"
"10","008","00","060","0007","0310","382","148","234","4","386","1003","0","38.48","14.76"
"10","008","00","060","0007","0311","480","218","262","9","489","1259","0","38.84","17.32"
"10","008","00","060","0008","0000","590","259","331","12","602","1625","0","37.05","15.94"
"10","008","00","060","0008","0312","280","111","169","5","285","734","0","38.83","15.12"
"10","008","00","060","0008","0313","310","148","162","7","317","891","0","35.58","16.61"
"10","008","00","060","0009","0000","364","131","233","8","372","922","0","40.35","14.21"
"10","008","00","060","0009","0315","364","131","233","8","372","922","0","40.35","14.21"
"10","008","00","060","0010","0000","437","162","275","2","439","1233","0","35.60","13.14"
"10","008","00","060","0010","0316","437","162","275","2","439","1233","0","35.60","13.14"
"10","008","00","060","0011","0000","706","230","476","18","724","1828","0","39.61","12.58"
"10","008","00","060","0011","0318","352","108","244","11","363","949","0","38.25","11.38"
"10","008","00","060","0011","0319","354","122","232","7","361","879","0","41.07","13.88"
"10","008","00","060","0012","0000","307","116","191","3","310","900","0","34.44","12.89"
"10","008","00","060","0012","0320","307","116","191","3","310","900","0","34.44","12.89"
"10","008","00","060","0013","0000","249","85","164","2","251","729","0","34.43","11.66"
"10","008","00","060","0013","0317","249","85","164","2","251","729","0","34.43","11.66"
"10","008","00","060","0014","0000","341","130","211","7","348","911","0","38.20","14.27"
"10","008","00","060","0014","0323","341","130","211","7","348","911","0","38.20","14.27"
"10","008","00","060","0015","0000","453","183","270","7","460","1160","0","39.66","15.78"
"10","008","00","060","0015","0321","277","121","156","5","282","641","0","43.99","18.88"
"10","008","00","060","0015","0322","176","62","114","2","178","519","0","34.30","11.95"
"10","008","00","060","0016","0000","534","224","310","5","539","1538","0","35.05","14.56"
"10","008","00","060","0016","0324","372","170","202","4","376","1102","0","34.12","15.43"
"10","008","00","060","0016","0325","162","54","108","1","163","436","0","37.39","12.39"
"10","008","00","060","0017","0000","569","205","364","7","576","1468","0","39.24","13.96"
"10","008","00","060","0017","0326","348","121","227","3","351","868","0","40.44","13.94"
"10","008","00","060","0017","0327","221","84","137","4","225","600","0","37.50","14.00"
"10","008","00","060","0018","0000","416","167","249","10","426","1137","0","37.47","14.69"
"10","008","00","060","0018","0328","416","167","249","10","426","1137","0","37.47","14.69"
"10","008","00","060","0019","0000","323","137","186","5","328","845","0","38.82","16.21"
"10","008","00","060","0019","0330","323","137","186","5","328","845","0","38.82","16.21"
"10","008","00","060","0020","0000","319","194","125","2","321","874","0","36.73","22.20"
"10","008","00","060","0020","0329","319","194","125","2","321","874","0","36.73","22.20"
"10","008","00","060","0021","0000","297","153","144","6","303","739","0","41.00","20.70"
"10","008","00","060","0021","0331","297","153","144","6","303","739","0","41.00","20.70"
"10","008","00","060","0022","0000","607","269","338","11","618","1737","0","35.58","15.49"
"10","008","00","060","0022","0332","284","119","165","3","287","761","0","37.71","15.64"
"10","008","00","060","0022","0333","323","150","173","8","331","976","0","33.91","15.37"
"10","008","00","060","0023","0000","331","193","138","5","336","867","0","38.75","22.26"
"10","008","00","060","0023","0314","331","193","138","5","336","867","0","38.75","22.26"
"10","008","00","070","0000","0000","5311","2836","2475","74","5385","15417","16983","34.93","18.40"
"10","008","00","070","0001","0000","655","341","314","8","663","1813","0","36.57","18.81"
"10","008","00","070","0001","0334","333","198","135","3","336","910","0","36.92","21.76"
"10","008","00","070","0001","0335","322","143","179","5","327","903","0","36.21","15.84"
"10","008","00","070","0002","0000","491","267","224","7","498","1402","0","35.52","19.04"
"10","008","00","070","0002","0350","237","129","108","3","240","709","0","33.85","18.19"
"10","008","00","070","0002","0351","254","138","116","4","258","693","0","37.23","19.91"
"10","008","00","070","0003","0000","465","278","187","5","470","1294","0","36.32","21.48"
"10","008","00","070","0003","0336","319","200","119","3","322","854","0","37.70","23.42"
"10","008","00","070","0003","0337","146","78","68","2","148","440","0","33.64","17.73"
"10","008","00","070","0004","0000","681","381","300","13","694","1909","0","36.35","19.96"
"10","008","00","070","0004","0338","308","179","129","3","311","807","0","38.54","22.18"
"10","008","00","070","0004","0339","373","202","171","10","383","1102","0","34.75","18.33"
"10","008","00","070","0005","0000","330","182","148","6","336","997","0","33.70","18.25"
"10","008","00","070","0005","0344","169","92","77","3","172","559","0","30.77","16.46"
"10","008","00","070","0005","0345","161","90","71","3","164","438","0","37.44","20.55"
"10","008","00","070","0006","0000","465","250","215","5","470","1463","0","32.13","17.09"
"10","008","00","070","0006","0347","206","101","105","4","210","700","0","30.00","14.43"
"10","008","00","070","0006","0348","259","149","110","1","260","763","0","34.08","19.53"
"10","008","00","070","0007","0000","329","207","122","4","333","902","0","36.92","22.95"
"10","008","00","070","0007","0349","329","207","122","4","333","902","0","36.92","22.95"
"10","008","00","070","0008","0000","221","150","71","4","225","620","0","36.29","24.19"
"10","008","00","070","0008","0346","221","150","71","4","225","620","0","36.29","24.19"
"10","008","00","070","0009","0000","462","208","254","4","466","1309","0","35.60","15.89"
"10","008","00","070","0009","0342","288","138","150","1","289","769","0","37.58","17.95"
"10","008","00","070","0009","0343","174","70","104","3","177","540","0","32.78","12.96"
"10","008","00","070","0010","0000","547","297","250","5","552","1562","0","35.34","19.01"
"10","008","00","070","0010","0340","262","155","107","3","265","726","0","36.50","21.35"
"10","008","00","070","0010","0341","285","142","143","2","287","836","0","34.33","16.99"
"10","008","00","070","0011","0000","214","86","128","6","220","747","0","29.45","11.51"
"10","008","00","070","0011","0352","214","86","128","6","220","747","0","29.45","11.51"
"10","008","00","070","0012","0000","254","112","142","3","257","689","0","37.30","16.26"
"10","008","00","070","0012","0353","254","112","142","3","257","689","0","37.30","16.26"
"10","008","00","070","0013","0000","197","77","120","4","201","710","0","28.31","10.85"
"10","008","00","070","0013","0354","197","77","120","4","201","710","0","28.31","10.85"
"10","008","00","080","0000","0000","4271","2069","2202","67","4338","12820","14137","33.84","16.14"
"10","008","00","080","0001","0000","258","90","168","4","262","773","0","33.89","11.64"
"10","008","00","080","0001","0355","258","90","168","4","262","773","0","33.89","11.64"
"10","008","00","080","0002","0000","169","88","81","5","174","470","0","37.02","18.72"
"10","008","00","080","0002","0356","93","42","51","3","96","251","0","38.25","16.73"
"10","008","00","080","0002","0357","76","46","30","2","78","219","0","35.62","21.00"
"10","008","00","080","0003","0000","265","134","131","5","270","773","0","34.93","17.34"
"10","008","00","080","0003","0358","139","71","68","4","143","344","0","41.57","20.64"
"10","008","00","080","0003","0359","126","63","63","1","127","429","0","29.60","14.69"
"10","008","00","080","0004","0000","197","95","102","2","199","639","0","31.14","14.87"
"10","008","00","080","0004","0362","197","95","102","2","199","639","0","31.14","14.87"
"10","008","00","080","0005","0000","218","110","108","5","223","683","0","32.65","16.11"
"10","008","00","080","0005","0360","114","59","55","0","114","373","0","30.56","15.82"
"10","008","00","080","0005","0361","104","51","53","5","109","310","0","35.16","16.45"
"10","008","00","080","0006","0000","547","285","262","6","553","1678","0","32.96","16.98"
"10","008","00","080","0006","0364","295","153","142","5","300","948","0","31.65","16.14"
"10","008","00","080","0006","0365","252","132","120","1","253","730","0","34.66","18.08"
"10","008","00","080","0007","0000","103","52","51","1","104","287","0","36.24","18.12"
"10","008","00","080","0007","0363","103","52","51","1","104","287","0","36.24","18.12"
"10","008","00","080","0008","0000","215","122","93","4","219","624","0","35.10","19.55"
"10","008","00","080","0008","0366","215","122","93","4","219","624","0","35.10","19.55"
"10","008","00","080","0009","0000","153","55","98","0","153","491","0","31.16","11.20"
"10","008","00","080","0009","0367","153","55","98","0","153","491","0","31.16","11.20"
"10","008","00","080","0010","0000","417","234","183","8","425","1319","0","32.22","17.74"
"10","008","00","080","0010","0368","101","52","49","3","104","325","0","32.00","16.00"
"10","008","00","080","0010","0369","316","182","134","5","321","994","0","32.29","18.31"
"10","008","00","080","0011","0000","369","163","206","4","373","1049","0","35.56","15.54"
"10","008","00","080","0011","0370","156","61","95","1","157","442","0","35.52","13.80"
"10","008","00","080","0011","0371","213","102","111","3","216","607","0","35.58","16.80"
"10","008","00","080","0012","0000","239","113","126","11","250","847","0","29.52","13.34"
"10","008","00","080","0012","0372","239","113","126","11","250","847","0","29.52","13.34"
"10","008","00","080","0013","0000","236","82","154","4","240","666","0","36.04","12.31"
"10","008","00","080","0013","0374","236","82","154","4","240","666","0","36.04","12.31"
"10","008","00","080","0014","0000","222","111","111","1","223","637","0","35.01","17.43"
"10","008","00","080","0014","0376","222","111","111","1","223","637","0","35.01","17.43"
"10","008","00","080","0015","0000","171","90","81","2","173","499","0","34.67","18.04"
"10","008","00","080","0015","0378","171","90","81","2","173","499","0","34.67","18.04"
"10","008","00","080","0016","0000","164","81","83","1","165","454","0","36.34","17.84"
"10","008","00","080","0016","0373","164","81","83","1","165","454","0","36.34","17.84"
"10","008","00","080","0017","0000","152","76","76","3","155","454","0","34.14","16.74"
"10","008","00","080","0017","0377","152","76","76","3","155","454","0","34.14","16.74"
"10","008","00","080","0018","0000","176","88","88","1","177","477","0","37.11","18.45"
"10","008","00","080","0018","0375","176","88","88","1","177","477","0","37.11","18.45"
"10","008","00","090","0000","0000","4478","2276","2202","46","4524","13636","15251","33.18","16.69"
"10","008","00","090","0001","0000","547","287","260","3","550","1550","0","35.48","18.52"
"10","008","00","090","0001","0381","230","130","100","2","232","724","0","32.04","17.96"
"10","008","00","090","0001","0382","317","157","160","1","318","826","0","38.50","19.01"
"10","008","00","090","0002","0000","666","347","319","4","670","1908","0","35.12","18.19"
"10","008","00","090","0002","0379","293","153","140","1","294","893","0","32.92","17.13"
"10","008","00","090","0002","0380","373","194","179","3","376","1015","0","37.04","19.11"
"10","008","00","090","0003","0000","307","142","165","4","311","994","0","31.29","14.29"
"10","008","00","090","0003","0397","160","75","85","2","162","573","0","28.27","13.09"
"10","008","00","090","0003","0398","147","67","80","2","149","421","0","35.39","15.91"
"10","008","00","090","0004","0000","451","210","241","4","455","1333","0","34.13","15.75"
"10","008","00","090","0004","0390","257","123","134","2","259","784","0","33.04","15.69"
"10","008","00","090","0004","0391","94","37","57","1","95","282","0","33.69","13.12"
"10","008","00","090","0004","0392","100","50","50","1","101","267","0","37.83","18.73"
"10","008","00","090","0005","0000","342","148","194","7","349","1061","0","32.89","13.95"
"10","008","00","090","0005","0383","168","67","101","5","173","485","0","35.67","13.81"
"10","008","00","090","0005","0384","174","81","93","2","176","576","0","30.56","14.06"
"10","008","00","090","0006","0000","332","157","175","3","335","1242","0","26.97","12.64"
"10","008","00","090","0006","0385","144","62","82","2","146","603","0","24.21","10.28"
"10","008","00","090","0006","0386","188","95","93","1","189","639","0","29.58","14.87"
"10","008","00","090","0007","0000","153","58","95","2","155","501","0","30.94","11.58"
"10","008","00","090","0007","0387","97","27","70","2","99","299","0","33.11","9.03"
"10","008","00","090","0007","0389","56","31","25","0","56","202","0","27.72","15.35"
"10","008","00","090","0008","0000","205","107","98","2","207","625","0","33.12","17.12"
"10","008","00","090","0008","0393","87","40","47","2","89","268","0","33.21","14.93"
"10","008","00","090","0008","0394","118","67","51","0","118","357","0","33.05","18.77"
"10","008","00","090","0009","0000","232","123","109","3","235","718","0","32.73","17.13"
"10","008","00","090","0009","0395","153","83","70","3","156","546","0","28.57","15.20"
"10","008","00","090","0009","0396","79","40","39","0","79","172","0","45.93","23.26"
"10","008","00","090","0010","0000","301","195","106","1","302","823","0","36.70","23.69"
"10","008","00","090","0010","0399","301","195","106","1","302","823","0","36.70","23.69"
"10","008","00","090","0011","0000","256","121","135","5","261","917","0","28.46","13.20"
"10","008","00","090","0011","0401","108","56","52","0","108","396","0","27.27","14.14"
"10","008","00","090","0011","0402","148","65","83","5","153","521","0","29.37","12.48"
"10","008","00","090","0012","0000","186","115","71","5","191","574","0","33.28","20.03"
"10","008","00","090","0012","0403","104","67","37","4","108","335","0","32.24","20.00"
"10","008","00","090","0012","0404","82","48","34","1","83","239","0","34.73","20.08"
"10","008","00","090","0013","0000","310","166","144","1","311","849","0","36.63","19.55"
"10","008","00","090","0013","0400","310","166","144","1","311","849","0","36.63","19.55"
"10","008","00","090","0014","0000","190","100","90","2","192","541","0","35.49","18.48"
"10","008","00","090","0014","0388","190","100","90","2","192","541","0","35.49","18.48"
"10","008","00","100","0000","0000","4980","2792","2188","86","5066","15914","17685","31.83","17.54"
"10","008","00","100","0001","0000","548","277","271","14","562","1641","0","34.25","16.88"
"10","008","00","100","0001","0405","304","148","156","10","314","942","0","33.33","15.71"
"10","008","00","100","0001","0406","244","129","115","4","248","699","0","35.48","18.45"
"10","008","00","100","0002","0000","553","334","219","7","560","1676","0","33.41","19.93"
"10","008","00","100","0002","0407","256","148","108","4","260","777","0","33.46","19.05"
"10","008","00","100","0002","0408","297","186","111","3","300","899","0","33.37","20.69"
"10","008","00","100","0003","0000","185","91","94","1","186","641","0","29.02","14.20"
"10","008","00","100","0003","0409","185","91","94","1","186","641","0","29.02","14.20"
"10","008","00","100","0004","0000","524","253","271","8","532","1823","0","29.18","13.88"
"10","008","00","100","0004","0414","292","142","150","4","296","987","0","29.99","14.39"
"10","008","00","100","0004","0415","232","111","121","4","236","836","0","28.23","13.28"
"10","008","00","100","0005","0000","370","234","136","5","375","1346","0","27.86","17.38"
"10","008","00","100","0005","0410","181","110","71","2","183","645","0","28.37","17.05"
"10","008","00","100","0005","0411","189","124","65","3","192","701","0","27.39","17.69"
"10","008","00","100","0006","0000","217","125","92","1","218","688","0","31.69","18.17"
"10","008","00","100","0006","0413","217","125","92","1","218","688","0","31.69","18.17"
"10","008","00","100","0007","0000","608","337","271","7","615","1766","0","34.82","19.08"
"10","008","00","100","0007","0416","315","181","134","5","320","877","0","36.49","20.64"
"10","008","00","100","0007","0417","293","156","137","2","295","889","0","33.18","17.55"
"10","008","00","100","0008","0000","248","129","119","8","256","789","0","32.45","16.35"
"10","008","00","100","0008","0418","248","129","119","8","256","789","0","32.45","16.35"
"10","008","00","100","0009","0000","368","234","134","4","372","1117","0","33.30","20.95"
"10","008","00","100","0009","0419","368","234","134","4","372","1117","0","33.30","20.95"
"10","008","00","100","0010","0000","493","239","254","16","509","1459","0","34.89","16.38"
"10","008","00","100","0010","0421","345","174","171","12","357","1056","0","33.81","16.48"
"10","008","00","100","0010","0422","148","65","83","4","152","403","0","37.72","16.13"
"10","008","00","100","0011","0000","476","290","186","10","486","1547","0","31.42","18.75"
"10","008","00","100","0011","0423","318","199","119","8","326","1002","0","32.53","19.86"
"10","008","00","100","0011","0424","158","91","67","2","160","545","0","29.36","16.70"
"10","008","00","100","0012","0000","208","124","84","2","210","691","0","30.39","17.95"
"10","008","00","100","0012","0420","208","124","84","2","210","691","0","30.39","17.95"
"10","008","00","100","0013","0000","182","125","57","3","185","730","0","25.34","17.12"
"10","008","00","100","0013","0412","182","125","57","3","185","730","0","25.34","17.12"
"10","008","00","110","0000","0000","5079","2739","2340","49","5128","14915","16810","34.38","18.36"
"10","008","00","110","0001","0000","221","126","95","0","221","726","0","30.44","17.36"
"10","008","00","110","0001","0425","221","126","95","0","221","726","0","30.44","17.36"
"10","008","00","110","0002","0000","187","87","100","0","187","420","0","44.52","20.71"
"10","008","00","110","0002","0430","187","87","100","0","187","420","0","44.52","20.71"
"10","008","00","110","0003","0000","450","223","227","4","454","1475","0","30.78","15.12"
"10","008","00","110","0003","0426","176","77","99","1","177","518","0","34.17","14.86"
"10","008","00","110","0003","0427","274","146","128","3","277","957","0","28.94","15.26"
"10","008","00","110","0004","0000","234","143","91","1","235","596","0","39.43","23.99"
"10","008","00","110","0004","0428","234","143","91","1","235","596","0","39.43","23.99"
"10","008","00","110","0005","0000","343","207","136","2","345","839","0","41.12","24.67"
"10","008","00","110","0005","0429","343","207","136","2","345","839","0","41.12","24.67"
"10","008","00","110","0006","0000","368","203","165","2","370","1004","0","36.85","20.22"
"10","008","00","110","0006","0433","368","203","165","2","370","1004","0","36.85","20.22"
"10","008","00","110","0007","0000","365","202","163","2","367","922","0","39.80","21.91"
"10","008","00","110","0007","0436","365","202","163","2","367","922","0","39.80","21.91"
"10","008","00","110","0008","0000","435","227","208","7","442","1346","0","32.84","16.86"
"10","008","00","110","0008","0437","239","103","136","3","242","759","0","31.88","13.57"
"10","008","00","110","0008","0438","196","124","72","4","200","587","0","34.07","21.12"
"10","008","00","110","0009","0000","376","195","181","5","381","1172","0","32.51","16.64"
"10","008","00","110","0009","0440","376","195","181","5","381","1172","0","32.51","16.64"
"10","008","00","110","0010","0000","165","103","62","4","169","436","0","38.76","23.62"
"10","008","00","110","0010","0431","165","103","62","4","169","436","0","38.76","23.62"
"10","008","00","110","0011","0000","155","107","48","3","158","621","0","25.44","17.23"
"10","008","00","110","0011","0432","155","107","48","3","158","621","0","25.44","17.23"
"10","008","00","110","0012","0000","73","36","37","0","73","203","0","35.96","17.73"
"10","008","00","110","0012","0441","73","36","37","0","73","203","0","35.96","17.73"
"10","008","00","110","0013","0000","127","79","48","1","128","318","0","40.25","24.84"
"10","008","00","110","0013","0442","127","79","48","1","128","318","0","40.25","24.84"
"10","008","00","110","0014","0000","344","211","133","6","350","1065","0","32.86","19.81"
"10","008","00","110","0014","0443","344","211","133","6","350","1065","0","32.86","19.81"
"10","008","00","110","0015","0000","249","111","138","4","253","841","0","30.08","13.20"
"10","008","00","110","0015","0439","249","111","138","4","253","841","0","30.08","13.20"
"10","008","00","110","0016","0000","125","48","77","2","127","313","0","40.58","15.34"
"10","008","00","110","0016","0445","125","48","77","2","127","313","0","40.58","15.34"
"10","008","00","110","0017","0000","251","101","150","3","254","813","0","31.24","12.42"
"10","008","00","110","0017","0446","251","101","150","3","254","813","0","31.24","12.42"
"10","008","00","110","0018","0000","96","52","44","1","97","278","0","34.89","18.71"
"10","008","00","110","0018","0444","96","52","44","1","97","278","0","34.89","18.71"
"10","008","00","110","0019","0000","515","278","237","2","517","1527","0","33.86","18.21"
"10","008","00","110","0019","0434","241","132","109","2","243","725","0","33.52","18.21"
"10","008","00","110","0019","0435","274","146","128","0","274","802","0","34.16","18.20"
"10","008","00","120","0000","0000","3292","2150","1142","49","3341","13002","15798","25.70","16.54"
"10","008","00","120","0001","0000","228","173","55","4","232","1166","0","19.90","14.84"
"10","008","00","120","0001","0464","169","137","32","3","172","906","0","18.98","15.12"
"10","008","00","120","0001","0465","59","36","23","1","60","260","0","23.08","13.85"
"10","008","00","120","0002","0000","252","203","49","6","258","920","0","28.04","22.07"
"10","008","00","120","0002","0466","252","203","49","6","258","920","0","28.04","22.07"
"10","008","00","120","0003","0000","123","107","16","2","125","558","0","22.40","19.18"
"10","008","00","120","0003","0468","123","107","16","2","125","558","0","22.40","19.18"
"10","008","00","120","0004","0000","505","333","172","4","509","1469","0","34.65","22.67"
"10","008","00","120","0004","0447","190","136","54","3","193","548","0","35.22","24.82"
"10","008","00","120","0004","0448","212","133","79","0","212","607","0","34.93","21.91"
"10","008","00","120","0004","0449","103","64","39","1","104","314","0","33.12","20.38"
"10","008","00","120","0005","0000","140","82","58","0","140","481","0","29.11","17.05"
"10","008","00","120","0005","0450","140","82","58","0","140","481","0","29.11","17.05"
"10","008","00","120","0006","0000","205","98","107","9","214","713","0","30.01","13.74"
"10","008","00","120","0006","0451","109","56","53","8","117","408","0","28.68","13.73"
"10","008","00","120","0006","0452","96","42","54","1","97","305","0","31.80","13.77"
"10","008","00","120","0007","0000","341","251","90","1","342","1338","0","25.56","18.76"
"10","008","00","120","0007","0455","146","93","53","1","147","658","0","22.34","14.13"
"10","008","00","120","0007","0456","195","158","37","0","195","680","0","28.68","23.24"
"10","008","00","120","0008","0000","325","195","130","5","330","1516","0","21.77","12.86"
"10","008","00","120","0008","0457","223","142","81","3","226","981","0","23.04","14.48"
"10","008","00","120","0008","0458","102","53","49","2","104","535","0","19.44","9.91"
"10","008","00","120","0009","0000","411","215","196","6","417","1399","0","29.81","15.37"
"10","008","00","120","0009","0459","296","153","143","3","299","925","0","32.32","16.54"
"10","008","00","120","0009","0460","115","62","53","3","118","474","0","24.89","13.08"
"10","008","00","120","0010","0000","160","96","64","5","165","629","0","26.23","15.26"
"10","008","00","120","0010","0461","108","58","50","4","112","484","0","23.14","11.98"
"10","008","00","120","0010","0462","52","38","14","1","53","145","0","36.55","26.21"
"10","008","00","120","0011","0000","218","149","69","2","220","988","0","22.27","15.08"
"10","008","00","120","0011","0463","218","149","69","2","220","988","0","22.27","15.08"
"10","008","00","120","0012","0000","77","56","21","2","79","610","0","12.95","9.18"
"10","008","00","120","0012","0467","77","56","21","2","79","610","0","12.95","9.18"
"10","008","00","120","0013","0000","149","113","36","2","151","587","0","25.72","19.25"
"10","008","00","120","0013","0454","149","113","36","2","151","587","0","25.72","19.25"
"10","008","00","120","0014","0000","158","79","79","1","159","628","0","25.32","12.58"
"10","008","00","120","0014","0453","158","79","79","1","159","628","0","25.32","12.58"
"10","008","00","130","0000","0000","3155","2557","598","33","3188","12497","15736","25.51","20.46"
"10","008","00","130","0001","0000","168","133","35","3","171","801","0","21.35","16.60"
"10","008","00","130","0001","0488","168","133","35","3","171","801","0","21.35","16.60"
"10","008","00","130","0002","0000","213","175","38","3","216","907","0","23.81","19.29"
"10","008","00","130","0002","0489","213","175","38","3","216","907","0","23.81","19.29"
"10","008","00","130","0003","0000","355","311","44","3","358","1143","0","31.32","27.21"
"10","008","00","130","0003","0490","199","177","22","2","201","693","0","29.00","25.54"
"10","008","00","130","0003","0491","156","134","22","1","157","450","0","34.89","29.78"
"10","008","00","130","0004","0000","163","150","13","0","163","398","0","40.95","37.69"
"10","008","00","130","0004","0492","163","150","13","0","163","398","0","40.95","37.69"
"10","008","00","130","0005","0000","98","83","15","2","100","504","0","19.84","16.47"
"10","008","00","130","0005","0481","98","83","15","2","100","504","0","19.84","16.47"
"10","008","00","130","0006","0000","140","109","31","3","143","749","0","19.09","14.55"
"10","008","00","130","0006","0479","97","74","23","2","99","376","0","26.33","19.68"
"10","008","00","130","0006","0480","43","35","8","1","44","373","0","11.80","9.38"
"10","008","00","130","0008","0000","248","202","46","2","250","1118","0","22.36","18.07"
"10","008","00","130","0008","0484","142","114","28","0","142","595","0","23.87","19.16"
"10","008","00","130","0008","0485","55","44","11","2","57","387","0","14.73","11.37"
"10","008","00","130","0008","0486","51","44","7","0","51","136","0","37.50","32.35"
"10","008","00","130","0009","0000","544","418","126","5","549","1616","0","33.97","25.87"
"10","008","00","130","0009","0471","232","177","55","3","235","838","0","28.04","21.12"
"10","008","00","130","0009","0472","177","139","38","1","178","470","0","37.87","29.57"
"10","008","00","130","0009","0473","135","102","33","1","136","308","0","44.16","33.12"
"10","008","00","130","0010","0000","376","288","88","5","381","1223","0","31.15","23.55"
"10","008","00","130","0010","0469","269","225","44","2","271","856","0","31.66","26.29"
"10","008","00","130","0010","0470","107","63","44","3","110","367","0","29.97","17.17"
"10","008","00","130","0011","0000","242","203","39","1","243","955","0","25.45","21.26"
"10","008","00","130","0011","0475","242","203","39","1","243","955","0","25.45","21.26"
"10","008","00","130","0012","0000","166","134","32","1","167","647","0","25.81","20.71"
"10","008","00","130","0012","0476","166","134","32","1","167","647","0","25.81","20.71"
"10","008","00","130","0013","0000","110","83","27","1","111","633","0","17.54","13.11"
"10","008","00","130","0013","0487","110","83","27","1","111","633","0","17.54","13.11"
"10","008","00","130","0014","0000","21","20","1","1","22","55","0","40.00","36.36"
"10","008","00","130","0014","0474","21","20","1","1","22","55","0","40.00","36.36"
"10","008","00","130","0015","0000","107","77","30","1","108","507","0","21.30","15.19"
"10","008","00","130","0015","0482","61","51","10","1","62","331","0","18.73","15.41"
"10","008","00","130","0015","0483","46","26","20","0","46","176","0","26.14","14.77"
"10","008","00","130","0016","0000","111","98","13","2","113","627","0","18.02","15.63"
"10","008","00","130","0016","0477","111","98","13","2","113","627","0","18.02","15.63"
"10","008","00","130","0017","0000","93","73","20","0","93","614","0","15.15","11.89"
"10","008","00","130","0017","0478","93","73","20","0","93","614","0","15.15","11.89"
"10","009","00","000","0000","0000","201124","83626","117498","2477","203601","577564","673309","35.25","14.48"
"10","009","00","010","0000","0000","36316","17878","18438","365","36681","90244","108508","40.65","19.81"
"10","009","00","010","0001","0000","631","324","307","4","635","1390","0","45.68","23.31"
"10","009","00","010","0001","0470","631","324","307","4","635","1390","0","45.68","23.31"
"10","009","00","010","0002","0000","478","202","276","3","481","1065","0","45.16","18.97"
"10","009","00","010","0002","0471","478","202","276","3","481","1065","0","45.16","18.97"
"10","009","00","010","0003","0000","307","138","169","2","309","609","0","50.74","22.66"
"10","009","00","010","0003","0445","307","138","169","2","309","609","0","50.74","22.66"
"10","009","00","010","0004","0000","276","128","148","5","281","599","0","46.91","21.37"
"10","009","00","010","0004","0446","276","128","148","5","281","599","0","46.91","21.37"
"10","009","00","010","0005","0000","339","176","163","2","341","756","0","45.11","23.28"
"10","009","00","010","0005","0447","339","176","163","2","341","756","0","45.11","23.28"
"10","009","00","010","0006","0000","339","137","202","4","343","767","0","44.72","17.86"
"10","009","00","010","0006","0448","339","137","202","4","343","767","0","44.72","17.86"
"10","009","00","010","0007","0000","309","148","161","5","314","707","0","44.41","20.93"
"10","009","00","010","0007","0449","309","148","161","5","314","707","0","44.41","20.93"
"10","009","00","010","0008","0000","1995","1086","909","14","2009","4843","0","41.48","22.42"
"10","009","00","010","0008","0458","514","284","230","5","519","1194","0","43.47","23.79"
"10","009","00","010","0008","0459","574","310","264","5","579","1309","0","44.23","23.68"
"10","009","00","010","0008","0460","482","282","200","3","485","1284","0","37.77","21.96"
"10","009","00","010","0008","0461","425","210","215","1","426","1056","0","40.34","19.89"
"10","009","00","010","0009","0000","1241","625","616","25","1266","3154","0","40.14","19.82"
"10","009","00","010","0009","0472","371","202","169","17","388","855","0","45.38","23.63"
"10","009","00","010","0009","0473","468","228","240","5","473","1272","0","37.19","17.92"
"10","009","00","010","0009","0474","402","195","207","3","405","1027","0","39.44","18.99"
"10","009","00","010","0010","0000","1161","623","538","13","1174","2723","0","43.11","22.88"
"10","009","00","010","0010","0465","502","243","259","9","511","1183","0","43.20","20.54"
"10","009","00","010","0010","0466","374","202","172","1","375","895","0","41.90","22.57"
"10","009","00","010","0010","0467","285","178","107","3","288","645","0","44.65","27.60"
"10","009","00","010","0011","0000","775","390","385","4","779","1734","0","44.93","22.49"
"10","009","00","010","0011","0489","366","180","186","2","368","804","0","45.77","22.39"
"10","009","00","010","0011","0490","409","210","199","2","411","930","0","44.19","22.58"
"10","009","00","010","0012","0000","1505","820","685","11","1516","3444","0","44.02","23.81"
"10","009","00","010","0012","0484","505","269","236","3","508","1061","0","47.88","25.35"
"10","009","00","010","0012","0485","530","303","227","4","534","1249","0","42.75","24.26"
"10","009","00","010","0012","0486","470","248","222","4","474","1134","0","41.80","21.87"
"10","009","00","010","0013","0000","1569","813","756","15","1584","4187","0","37.83","19.42"
"10","009","00","010","0013","0479","589","291","298","4","593","1461","0","40.59","19.92"
"10","009","00","010","0013","0480","477","255","222","4","481","1314","0","36.61","19.41"
"10","009","00","010","0013","0481","503","267","236","7","510","1412","0","36.12","18.91"
"10","009","00","010","0014","0000","824","355","469","3","827","2303","0","35.91","15.41"
"10","009","00","010","0014","0477","445","201","244","3","448","1153","0","38.86","17.43"
"10","009","00","010","0014","0478","379","154","225","0","379","1150","0","32.96","13.39"
"10","009","00","010","0015","0000","302","164","138","4","306","657","0","46.58","24.96"
"10","009","00","010","0015","0494","302","164","138","4","306","657","0","46.58","24.96"
"10","009","00","010","0016","0000","806","350","456","7","813","2185","0","37.21","16.02"
"10","009","00","010","0016","0495","291","123","168","3","294","750","0","39.20","16.40"
"10","009","00","010","0016","0496","515","227","288","4","519","1435","0","36.17","15.82"
"10","009","00","010","0017","0000","210","87","123","3","213","538","0","39.59","16.17"
"10","009","00","010","0017","0497","210","87","123","3","213","538","0","39.59","16.17"
"10","009","00","010","0018","0000","987","564","423","6","993","2450","0","40.53","23.02"
"10","009","00","010","0018","0492","444","256","188","2","446","1135","0","39.30","22.56"
"10","009","00","010","0018","0493","543","308","235","4","547","1315","0","41.60","23.42"
"10","009","00","010","0019","0000","572","246","326","6","578","1451","0","39.83","16.95"
"10","009","00","010","0019","0491","572","246","326","6","578","1451","0","39.83","16.95"
"10","009","00","010","0020","0000","980","516","464","10","990","2391","0","41.41","21.58"
"10","009","00","010","0020","0498","565","295","270","6","571","1426","0","40.04","20.69"
"10","009","00","010","0020","0499","415","221","194","4","419","965","0","43.42","22.90"
"10","009","00","010","0021","0000","728","316","412","14","742","1873","0","39.62","16.87"
"10","009","00","010","0021","0508","516","210","306","12","528","1363","0","38.74","15.41"
"10","009","00","010","0021","0509","212","106","106","2","214","510","0","41.96","20.78"
"10","009","00","010","0022","0000","2270","1121","1149","17","2287","5409","0","42.28","20.72"
"10","009","00","010","0022","0504","572","308","264","4","576","1447","0","39.81","21.29"
"10","009","00","010","0022","0505","635","297","338","2","637","1399","0","45.53","21.23"
"10","009","00","010","0022","0506","525","256","269","5","530","1246","0","42.54","20.55"
"10","009","00","010","0022","0507","538","260","278","6","544","1317","0","41.31","19.74"
"10","009","00","010","0023","0000","1244","564","680","9","1253","3399","0","36.86","16.59"
"10","009","00","010","0023","0502","631","311","320","4","635","1734","0","36.62","17.94"
"10","009","00","010","0023","0503","613","253","360","5","618","1665","0","37.12","15.20"
"10","009","00","010","0024","0000","712","294","418","14","726","1849","0","39.26","15.90"
"10","009","00","010","0024","0517","267","103","164","8","275","698","0","39.40","14.76"
"10","009","00","010","0024","0518","445","191","254","6","451","1151","0","39.18","16.59"
"10","009","00","010","0025","0000","412","167","245","6","418","1112","0","37.59","15.02"
"10","009","00","010","0025","0519","412","167","245","6","418","1112","0","37.59","15.02"
"10","009","00","010","0026","0000","1677","757","920","27","1704","4461","0","38.20","16.97"
"10","009","00","010","0026","0510","458","208","250","10","468","1232","0","37.99","16.88"
"10","009","00","010","0026","0511","435","167","268","5","440","1110","0","39.64","15.05"
"10","009","00","010","0026","0512","428","204","224","9","437","1132","0","38.60","18.02"
"10","009","00","010","0026","0513","356","178","178","3","359","987","0","36.37","18.03"
"10","009","00","010","0027","0000","375","150","225","5","380","1076","0","35.32","13.94"
"10","009","00","010","0027","0514","375","150","225","5","380","1076","0","35.32","13.94"
"10","009","00","010","0028","0000","692","317","375","6","698","2144","0","32.56","14.79"
"10","009","00","010","0028","0515","324","153","171","4","328","910","0","36.04","16.81"
"10","009","00","010","0028","0516","368","164","204","2","370","1234","0","29.98","13.29"
"10","009","00","010","0029","0000","1186","578","608","10","1196","3219","0","37.15","17.96"
"10","009","00","010","0029","0523","420","190","230","3","423","1089","0","38.84","17.45"
"10","009","00","010","0029","0524","273","109","164","5","278","818","0","33.99","13.33"
"10","009","00","010","0029","0525","493","279","214","2","495","1312","0","37.73","21.27"
"10","009","00","010","0030","0000","1110","469","641","12","1122","3070","0","36.55","15.28"
"10","009","00","010","0030","0520","515","216","299","4","519","1317","0","39.41","16.40"
"10","009","00","010","0030","0521","352","160","192","4","356","1062","0","33.52","15.07"
"10","009","00","010","0030","0522","243","93","150","4","247","691","0","35.75","13.46"
"10","009","00","010","0031","0000","424","151","273","7","431","1106","0","38.97","13.65"
"10","009","00","010","0031","0526","424","151","273","7","431","1106","0","38.97","13.65"
"10","009","00","010","0032","0000","1026","571","455","6","1032","2279","0","45.28","25.05"
"10","009","00","010","0032","0454","567","309","258","2","569","1217","0","46.75","25.39"
"10","009","00","010","0032","0455","459","262","197","4","463","1062","0","43.60","24.67"
"10","009","00","010","0033","0000","1433","709","724","13","1446","3722","0","38.85","19.05"
"10","009","00","010","0033","0450","468","256","212","4","472","1132","0","41.70","22.61"
"10","009","00","010","0033","0451","311","151","160","4","315","766","0","41.12","19.71"
"10","009","00","010","0033","0452","373","183","190","3","376","846","0","44.44","21.63"
"10","009","00","010","0033","0453","281","119","162","2","283","978","0","28.94","12.17"
"10","009","00","010","0034","0000","1154","614","540","17","1171","2734","0","42.83","22.46"
"10","009","00","010","0034","0475","571","322","249","10","581","1359","0","42.75","23.69"
"10","009","00","010","0034","0476","583","292","291","7","590","1375","0","42.91","21.24"
"10","009","00","010","0035","0000","955","520","435","16","971","2247","0","43.21","23.14"
"10","009","00","010","0035","0487","358","184","174","8","366","840","0","43.57","21.90"
"10","009","00","010","0035","0488","597","336","261","8","605","1407","0","43.00","23.88"
"10","009","00","010","0036","0000","860","458","402","7","867","2111","0","41.07","21.70"
"10","009","00","010","0036","0468","395","195","200","3","398","974","0","40.86","20.02"
"10","009","00","010","0036","0469","465","263","202","4","469","1137","0","41.25","23.13"
"10","009","00","010","0037","0000","1483","703","780","14","1497","3620","0","41.35","19.42"
"10","009","00","010","0037","0462","567","281","286","6","573","1302","0","44.01","21.58"
"10","009","00","010","0037","0463","432","217","215","5","437","1094","0","39.95","19.84"
"10","009","00","010","0037","0464","484","205","279","3","487","1224","0","39.79","16.75"
"10","009","00","010","0038","0000","1187","609","578","4","1191","2596","0","45.88","23.46"
"10","009","00","010","0038","0482","554","293","261","2","556","1189","0","46.76","24.64"
"10","009","00","010","0038","0483","633","316","317","2","635","1407","0","45.13","22.46"
"10","009","00","010","0039","0000","962","514","448","8","970","2294","0","42.28","22.41"
"10","009","00","010","0039","0456","474","237","237","3","477","1140","0","41.84","20.79"
"10","009","00","010","0039","0457","488","277","211","5","493","1154","0","42.72","24.00"
"10","009","00","010","0040","0000","820","404","416","7","827","1970","0","41.98","20.51"
"10","009","00","010","0040","0500","453","220","233","1","454","1040","0","43.65","21.15"
"10","009","00","010","0040","0501","367","184","183","6","373","930","0","40.11","19.78"
"10","009","00","020","0000","0000","14541","6372","8169","162","14703","37622","43841","39.08","16.94"
"10","009","00","020","0001","0000","507","231","276","6","513","1125","0","45.60","20.53"
"10","009","00","020","0001","0547","507","231","276","6","513","1125","0","45.60","20.53"
"10","009","00","020","0002","0000","886","450","436","7","893","2068","0","43.18","21.76"
"10","009","00","020","0002","0548","502","270","232","4","506","1100","0","46.00","24.55"
"10","009","00","020","0002","0549","384","180","204","3","387","968","0","39.98","18.60"
"10","009","00","020","0003","0000","817","351","466","9","826","2193","0","37.67","16.01"
"10","009","00","020","0003","0553","405","177","228","3","408","1177","0","34.66","15.04"
"10","009","00","020","0003","0554","412","174","238","6","418","1016","0","41.14","17.13"
"10","009","00","020","0004","0000","614","307","307","4","618","1430","0","43.22","21.47"
"10","009","00","020","0004","0555","614","307","307","4","618","1430","0","43.22","21.47"
"10","009","00","020","0005","0000","499","219","280","2","501","1217","0","41.17","18.00"
"10","009","00","020","0005","0556","499","219","280","2","501","1217","0","41.17","18.00"
"10","009","00","020","0006","0000","1015","437","578","6","1021","2651","0","38.51","16.48"
"10","009","00","020","0006","0565","529","237","292","3","532","1310","0","40.61","18.09"
"10","009","00","020","0006","0566","486","200","286","3","489","1341","0","36.47","14.91"
"10","009","00","020","0007","0000","501","205","296","8","509","1321","0","38.53","15.52"
"10","009","00","020","0007","0557","501","205","296","8","509","1321","0","38.53","15.52"
"10","009","00","020","0008","0000","314","120","194","7","321","738","0","43.50","16.26"
"10","009","00","020","0008","0558","314","120","194","7","321","738","0","43.50","16.26"
"10","009","00","020","0009","0000","282","130","152","4","286","860","0","33.26","15.12"
"10","009","00","020","0009","0560","282","130","152","4","286","860","0","33.26","15.12"
"10","009","00","020","0010","0000","262","107","155","4","266","705","0","37.73","15.18"
"10","009","00","020","0010","0561","262","107","155","4","266","705","0","37.73","15.18"
"10","009","00","020","0011","0000","386","157","229","7","393","1113","0","35.31","14.11"
"10","009","00","020","0011","0562","386","157","229","7","393","1113","0","35.31","14.11"
"10","009","00","020","0012","0000","622","238","384","8","630","1683","0","37.43","14.14"
"10","009","00","020","0012","0563","337","127","210","5","342","833","0","41.06","15.25"
"10","009","00","020","0012","0564","285","111","174","3","288","850","0","33.88","13.06"
"10","009","00","020","0013","0000","386","151","235","3","389","970","0","40.10","15.57"
"10","009","00","020","0013","0577","386","151","235","3","389","970","0","40.10","15.57"
"10","009","00","020","0014","0000","1050","389","661","14","1064","2768","0","38.44","14.05"
"10","009","00","020","0014","0578","533","191","342","8","541","1355","0","39.93","14.10"
"10","009","00","020","0014","0579","517","198","319","6","523","1413","0","37.01","14.01"
"10","009","00","020","0015","0000","796","332","464","7","803","2175","0","36.92","15.26"
"10","009","00","020","0015","0580","460","185","275","6","466","1212","0","38.45","15.26"
"10","009","00","020","0015","0581","336","147","189","1","337","963","0","34.99","15.26"
"10","009","00","020","0016","0000","1291","610","681","10","1301","3315","0","39.25","18.40"
"10","009","00","020","0016","0567","441","227","214","4","445","1065","0","41.78","21.31"
"10","009","00","020","0016","0568","429","213","216","1","430","1142","0","37.65","18.65"
"10","009","00","020","0016","0569","421","170","251","5","426","1108","0","38.45","15.34"
"10","009","00","020","0017","0000","321","143","178","4","325","854","0","38.06","16.74"
"10","009","00","020","0017","0572","321","143","178","4","325","854","0","38.06","16.74"
"10","009","00","020","0018","0000","304","163","141","6","310","792","0","39.14","20.58"
"10","009","00","020","0018","0573","304","163","141","6","310","792","0","39.14","20.58"
"10","009","00","020","0019","0000","310","168","142","2","312","823","0","37.91","20.41"
"10","009","00","020","0019","0574","310","168","142","2","312","823","0","37.91","20.41"
"10","009","00","020","0020","0000","522","204","318","8","530","1470","0","36.05","13.88"
"10","009","00","020","0020","0575","290","121","169","4","294","827","0","35.55","14.63"
"10","009","00","020","0020","0576","232","83","149","4","236","643","0","36.70","12.91"
"10","009","00","020","0021","0000","560","178","382","9","569","1433","0","39.71","12.42"
"10","009","00","020","0021","0582","560","178","382","9","569","1433","0","39.71","12.42"
"10","009","00","020","0022","0000","327","120","207","10","337","851","0","39.60","14.10"
"10","009","00","020","0022","0559","327","120","207","10","337","851","0","39.60","14.10"
"10","009","00","020","0023","0000","1135","570","565","10","1145","2831","0","40.45","20.13"
"10","009","00","020","0023","0550","360","196","164","3","363","933","0","38.91","21.01"
"10","009","00","020","0023","0551","367","165","202","4","371","963","0","38.53","17.13"
"10","009","00","020","0023","0552","408","209","199","3","411","935","0","43.96","22.35"
"10","009","00","020","0024","0000","834","392","442","7","841","2236","0","37.61","17.53"
"10","009","00","020","0024","0570","333","135","198","0","333","918","0","36.27","14.71"
"10","009","00","020","0024","0571","501","257","244","7","508","1318","0","38.54","19.50"
"10","009","00","030","0000","0000","21351","10119","11232","192","21543","58416","70772","36.88","17.32"
"10","009","00","030","0001","0000","366","172","194","2","368","914","0","40.26","18.82"
"10","009","00","030","0001","0129","366","172","194","2","368","914","0","40.26","18.82"
"10","009","00","030","0002","0000","646","331","315","4","650","1655","0","39.27","20.00"
"10","009","00","030","0002","0123","343","172","171","2","345","756","0","45.63","22.75"
"10","009","00","030","0002","0124","303","159","144","2","305","899","0","33.93","17.69"
"10","009","00","030","0003","0000","1020","516","504","8","1028","2525","0","40.71","20.44"
"10","009","00","030","0003","0121","520","264","256","6","526","1301","0","40.43","20.29"
"10","009","00","030","0003","0122","500","252","248","2","502","1224","0","41.01","20.59"
"10","009","00","030","0004","0000","1183","593","590","8","1191","2771","0","42.98","21.40"
"10","009","00","030","0004","0125","612","291","321","3","615","1400","0","43.93","20.79"
"10","009","00","030","0004","0126","571","302","269","5","576","1371","0","42.01","22.03"
"10","009","00","030","0005","0000","937","511","426","13","950","2473","0","38.41","20.66"
"10","009","00","030","0005","0127","451","229","222","6","457","1209","0","37.80","18.94"
"10","009","00","030","0005","0128","486","282","204","7","493","1264","0","39.00","22.31"
"10","009","00","030","0006","0000","1192","638","554","5","1197","3168","0","37.78","20.14"
"10","009","00","030","0006","0130","411","230","181","2","413","1002","0","41.22","22.95"
"10","009","00","030","0006","0131","402","221","181","2","404","1051","0","38.44","21.03"
"10","009","00","030","0006","0132","379","187","192","1","380","1115","0","34.08","16.77"
"10","009","00","030","0007","0000","612","325","287","5","617","1361","0","45.33","23.88"
"10","009","00","030","0007","0136","612","325","287","5","617","1361","0","45.33","23.88"
"10","009","00","030","0008","0000","1622","847","775","10","1632","4499","0","36.27","18.83"
"10","009","00","030","0008","0137","460","251","209","3","463","1396","0","33.17","17.98"
"10","009","00","030","0008","0138","497","253","244","4","501","1487","0","33.69","17.01"
"10","009","00","030","0008","0139","665","343","322","3","668","1616","0","41.34","21.23"
"10","009","00","030","0009","0000","870","434","436","8","878","2323","0","37.80","18.68"
"10","009","00","030","0009","0140","526","268","258","4","530","1305","0","40.61","20.54"
"10","009","00","030","0009","0141","344","166","178","4","348","1018","0","34.18","16.31"
"10","009","00","030","0010","0000","1443","681","762","13","1456","3807","0","38.25","17.89"
"10","009","00","030","0010","0142","499","215","284","5","504","1319","0","38.21","16.30"
"10","009","00","030","0010","0143","483","253","230","2","485","1333","0","36.38","18.98"
"10","009","00","030","0010","0144","461","213","248","6","467","1155","0","40.43","18.44"
"10","009","00","030","0011","0000","776","387","389","5","781","2017","0","38.72","19.19"
"10","009","00","030","0011","0145","406","199","207","4","410","1112","0","36.87","17.90"
"10","009","00","030","0011","0146","370","188","182","1","371","905","0","40.99","20.77"
"10","009","00","030","0012","0000","418","208","210","3","421","1123","0","37.49","18.52"
"10","009","00","030","0012","0147","418","208","210","3","421","1123","0","37.49","18.52"
"10","009","00","030","0013","0000","477","238","239","5","482","1313","0","36.71","18.13"
"10","009","00","030","0013","0170","477","238","239","5","482","1313","0","36.71","18.13"
"10","009","00","030","0014","0000","298","147","151","5","303","828","0","36.59","17.75"
"10","009","00","030","0014","0169","298","147","151","5","303","828","0","36.59","17.75"
"10","009","00","030","0015","0000","584","222","362","4","588","1952","0","30.12","11.37"
"10","009","00","030","0015","0168","584","222","362","4","588","1952","0","30.12","11.37"
"10","009","00","030","0016","0000","506","200","306","2","508","1478","0","34.37","13.53"
"10","009","00","030","0016","0166","506","200","306","2","508","1478","0","34.37","13.53"
"10","009","00","030","0017","0000","263","73","190","0","263","872","0","30.16","8.37"
"10","009","00","030","0017","0167","263","73","190","0","263","872","0","30.16","8.37"
"10","009","00","030","0018","0000","932","364","568","6","938","2607","0","35.98","13.96"
"10","009","00","030","0018","0149","506","221","285","1","507","1365","0","37.14","16.19"
"10","009","00","030","0018","0150","426","143","283","5","431","1242","0","34.70","11.51"
"10","009","00","030","0019","0000","297","156","141","4","301","844","0","35.66","18.48"
"10","009","00","030","0019","0151","297","156","141","4","301","844","0","35.66","18.48"
"10","009","00","030","0020","0000","576","227","349","15","591","1767","0","33.45","12.85"
"10","009","00","030","0020","0152","277","104","173","8","285","870","0","32.76","11.95"
"10","009","00","030","0020","0153","299","123","176","7","306","897","0","34.11","13.71"
"10","009","00","030","0021","0000","584","264","320","10","594","1633","0","36.37","16.17"
"10","009","00","030","0021","0154","306","156","150","6","312","848","0","36.79","18.40"
"10","009","00","030","0021","0155","278","108","170","4","282","785","0","35.92","13.76"
"10","009","00","030","0022","0000","1195","467","728","10","1205","3437","0","35.06","13.59"
"10","009","00","030","0022","0156","420","169","251","5","425","1271","0","33.44","13.30"
"10","009","00","030","0022","0157","343","110","233","3","346","958","0","36.12","11.48"
"10","009","00","030","0022","0158","432","188","244","2","434","1208","0","35.93","15.56"
"10","009","00","030","0023","0000","757","320","437","15","772","2304","0","33.51","13.89"
"10","009","00","030","0023","0159","380","177","203","9","389","1247","0","31.19","14.19"
"10","009","00","030","0023","0160","377","143","234","6","383","1057","0","36.23","13.53"
"10","009","00","030","0024","0000","825","320","505","12","837","2528","0","33.11","12.66"
"10","009","00","030","0024","0161","407","156","251","5","412","1281","0","32.16","12.18"
"10","009","00","030","0024","0162","418","164","254","7","425","1247","0","34.08","13.15"
"10","009","00","030","0025","0000","484","197","287","3","487","1339","0","36.37","14.71"
"10","009","00","030","0025","0163","484","197","287","3","487","1339","0","36.37","14.71"
"10","009","00","030","0026","0000","549","256","293","5","554","1501","0","36.91","17.06"
"10","009","00","030","0026","0164","549","256","293","5","554","1501","0","36.91","17.06"
"10","009","00","030","0027","0000","165","96","69","4","169","515","0","32.82","18.64"
"10","009","00","030","0027","0148","165","96","69","4","169","515","0","32.82","18.64"
"10","009","00","030","0028","0000","1396","762","634","4","1400","3651","0","38.35","20.87"
"10","009","00","030","0028","0133","447","272","175","3","450","1145","0","39.30","23.76"
"10","009","00","030","0028","0134","485","233","252","1","486","1254","0","38.76","18.58"
"10","009","00","030","0028","0135","464","257","207","0","464","1252","0","37.06","20.53"
"10","009","00","030","0029","0000","378","167","211","4","382","1211","0","31.54","13.79"
"10","009","00","030","0029","0165","378","167","211","4","382","1211","0","31.54","13.79"
"10","009","00","040","0000","0000","13631","4746","8885","149","13780","37855","45246","36.40","12.54"
"10","009","00","040","0001","0000","532","166","366","6","538","1509","0","35.65","11.00"
"10","009","00","040","0001","0364","267","65","202","2","269","760","0","35.39","8.55"
"10","009","00","040","0001","0365","265","101","164","4","269","749","0","35.91","13.48"
"10","009","00","040","0002","0000","654","270","384","8","662","1720","0","38.49","15.70"
"10","009","00","040","0002","0366","323","138","185","6","329","823","0","39.98","16.77"
"10","009","00","040","0002","0367","331","132","199","2","333","897","0","37.12","14.72"
"10","009","00","040","0003","0000","755","342","413","3","758","2061","0","36.78","16.59"
"10","009","00","040","0003","0368","384","166","218","1","385","1041","0","36.98","15.95"
"10","009","00","040","0003","0369","371","176","195","2","373","1020","0","36.57","17.25"
"10","009","00","040","0004","0000","1109","496","613","8","1117","2893","0","38.61","17.14"
"10","009","00","040","0004","0370","376","167","209","2","378","967","0","39.09","17.27"
"10","009","00","040","0004","0371","344","126","218","1","345","844","0","40.88","14.93"
"10","009","00","040","0004","0372","389","203","186","5","394","1082","0","36.41","18.76"
"10","009","00","040","0005","0000","149","53","96","2","151","325","0","46.46","16.31"
"10","009","00","040","0005","0373","149","53","96","2","151","325","0","46.46","16.31"
"10","009","00","040","0006","0000","233","87","146","3","236","549","0","42.99","15.85"
"10","009","00","040","0006","0374","233","87","146","3","236","549","0","42.99","15.85"
"10","009","00","040","0007","0000","224","91","133","2","226","568","0","39.79","16.02"
"10","009","00","040","0007","0375","224","91","133","2","226","568","0","39.79","16.02"
"10","009","00","040","0008","0000","372","150","222","7","379","1004","0","37.75","14.94"
"10","009","00","040","0008","0376","372","150","222","7","379","1004","0","37.75","14.94"
"10","009","00","040","0009","0000","1070","412","658","4","1074","2870","0","37.42","14.36"
"10","009","00","040","0009","0377","581","232","349","3","584","1447","0","40.36","16.03"
"10","009","00","040","0009","0378","489","180","309","1","490","1423","0","34.43","12.65"
"10","009","00","040","0010","0000","1593","579","1014","17","1610","4547","0","35.41","12.73"
"10","009","00","040","0010","0379","409","150","259","2","411","1080","0","38.06","13.89"
"10","009","00","040","0010","0380","344","135","209","4","348","1110","0","31.35","12.16"
"10","009","00","040","0010","0381","417","143","274","7","424","1098","0","38.62","13.02"
"10","009","00","040","0010","0382","423","151","272","4","427","1259","0","33.92","11.99"
"10","009","00","040","0011","0000","457","105","352","6","463","1277","0","36.26","8.22"
"10","009","00","040","0011","0383","457","105","352","6","463","1277","0","36.26","8.22"
"10","009","00","040","0012","0000","527","132","395","6","533","1475","0","36.14","8.95"
"10","009","00","040","0012","0384","527","132","395","6","533","1475","0","36.14","8.95"
"10","009","00","040","0013","0000","373","153","220","7","380","972","0","39.09","15.74"
"10","009","00","040","0013","0397","373","153","220","7","380","972","0","39.09","15.74"
"10","009","00","040","0014","0000","344","116","228","4","348","1105","0","31.49","10.50"
"10","009","00","040","0014","0398","344","116","228","4","348","1105","0","31.49","10.50"
"10","009","00","040","0015","0000","553","157","396","4","557","1776","0","31.36","8.84"
"10","009","00","040","0015","0399","274","80","194","1","275","909","0","30.25","8.80"
"10","009","00","040","0015","0400","279","77","202","3","282","867","0","32.53","8.88"
"10","009","00","040","0016","0000","503","125","378","11","514","1499","0","34.29","8.34"
"10","009","00","040","0016","0401","503","125","378","11","514","1499","0","34.29","8.34"
"10","009","00","040","0017","0000","561","176","385","7","568","1573","0","36.11","11.19"
"10","009","00","040","0017","0385","267","84","183","3","270","807","0","33.46","10.41"
"10","009","00","040","0017","0386","294","92","202","4","298","766","0","38.90","12.01"
"10","009","00","040","0018","0000","321","81","240","5","326","872","0","37.39","9.29"
"10","009","00","040","0018","0387","321","81","240","5","326","872","0","37.39","9.29"
"10","009","00","040","0019","0000","390","92","298","3","393","935","0","42.03","9.84"
"10","009","00","040","0019","0388","390","92","298","3","393","935","0","42.03","9.84"
"10","009","00","040","0020","0000","330","143","187","1","331","854","0","38.76","16.74"
"10","009","00","040","0020","0390","330","143","187","1","331","854","0","38.76","16.74"
"10","009","00","040","0021","0000","529","148","381","3","532","1477","0","36.02","10.02"
"10","009","00","040","0021","0389","529","148","381","3","532","1477","0","36.02","10.02"
"10","009","00","040","0022","0000","382","110","272","7","389","963","0","40.39","11.42"
"10","009","00","040","0022","0391","382","110","272","7","389","963","0","40.39","11.42"
"10","009","00","040","0023","0000","243","143","100","3","246","809","0","30.41","17.68"
"10","009","00","040","0023","0394","243","143","100","3","246","809","0","30.41","17.68"
"10","009","00","040","0024","0000","277","84","193","3","280","727","0","38.51","11.55"
"10","009","00","040","0024","0393","277","84","193","3","280","727","0","38.51","11.55"
"10","009","00","040","0025","0000","385","124","261","3","388","1287","0","30.15","9.63"
"10","009","00","040","0025","0392","385","124","261","3","388","1287","0","30.15","9.63"
"10","009","00","040","0026","0000","307","88","219","8","315","862","0","36.54","10.21"
"10","009","00","040","0026","0395","307","88","219","8","315","862","0","36.54","10.21"
"10","009","00","040","0027","0000","458","123","335","8","466","1346","0","34.62","9.14"
"10","009","00","040","0027","0396","458","123","335","8","466","1346","0","34.62","9.14"
"10","009","00","050","0000","0000","8224","3265","4959","97","8321","24096","28137","34.53","13.55"
"10","009","00","050","0001","0000","317","136","181","3","320","765","0","41.83","17.78"
"10","009","00","050","0001","0091","317","136","181","3","320","765","0","41.83","17.78"
"10","009","00","050","0002","0000","328","130","198","3","331","868","0","38.13","14.98"
"10","009","00","050","0002","0092","328","130","198","3","331","868","0","38.13","14.98"
"10","009","00","050","0003","0000","566","262","304","7","573","1345","0","42.60","19.48"
"10","009","00","050","0003","0093","262","104","158","4","266","649","0","40.99","16.02"
"10","009","00","050","0003","0094","304","158","146","3","307","696","0","44.11","22.70"
"10","009","00","050","0004","0000","448","222","226","3","451","1052","0","42.87","21.10"
"10","009","00","050","0004","0095","448","222","226","3","451","1052","0","42.87","21.10"
"10","009","00","050","0005","0000","338","132","206","6","344","1083","0","31.76","12.19"
"10","009","00","050","0005","0096","198","67","131","4","202","664","0","30.42","10.09"
"10","009","00","050","0005","0097","140","65","75","2","142","419","0","33.89","15.51"
"10","009","00","050","0006","0000","497","188","309","5","502","1401","0","35.83","13.42"
"10","009","00","050","0006","0101","212","80","132","4","216","629","0","34.34","12.72"
"10","009","00","050","0006","0102","285","108","177","1","286","772","0","37.05","13.99"
"10","009","00","050","0007","0000","400","165","235","10","410","1267","0","32.36","13.02"
"10","009","00","050","0007","0103","213","66","147","6","219","716","0","30.59","9.22"
"10","009","00","050","0007","0104","187","99","88","4","191","551","0","34.66","17.97"
"10","009","00","050","0008","0000","422","177","245","3","425","1221","0","34.81","14.50"
"10","009","00","050","0008","0105","248","89","159","3","251","707","0","35.50","12.59"
"10","009","00","050","0008","0106","174","88","86","0","174","514","0","33.85","17.12"
"10","009","00","050","0009","0000","310","116","194","5","315","854","0","36.89","13.58"
"10","009","00","050","0009","0111","310","116","194","5","315","854","0","36.89","13.58"
"10","009","00","050","0010","0000","912","400","512","8","920","2844","0","32.35","14.06"
"10","009","00","050","0010","0098","275","122","153","2","277","901","0","30.74","13.54"
"10","009","00","050","0010","0099","319","155","164","5","324","988","0","32.79","15.69"
"10","009","00","050","0010","0100","318","123","195","1","319","955","0","33.40","12.88"
"10","009","00","050","0011","0000","638","201","437","8","646","1845","0","35.01","10.89"
"10","009","00","050","0011","0112","295","97","198","5","300","886","0","33.86","10.95"
"10","009","00","050","0011","0113","343","104","239","3","346","959","0","36.08","10.84"
"10","009","00","050","0012","0000","613","249","364","8","621","1750","0","35.49","14.23"
"10","009","00","050","0012","0114","342","135","207","5","347","884","0","39.25","15.27"
"10","009","00","050","0012","0115","271","114","157","3","274","866","0","31.64","13.16"
"10","009","00","050","0013","0000","283","93","190","4","287","830","0","34.58","11.20"
"10","009","00","050","0013","0118","283","93","190","4","287","830","0","34.58","11.20"
"10","009","00","050","0014","0000","575","196","379","7","582","1773","0","32.83","11.05"
"10","009","00","050","0014","0116","303","104","199","5","308","890","0","34.61","11.69"
"10","009","00","050","0014","0117","272","92","180","2","274","883","0","31.03","10.42"
"10","009","00","050","0015","0000","680","261","419","8","688","2272","0","30.28","11.49"
"10","009","00","050","0015","0107","348","132","216","3","351","1177","0","29.82","11.21"
"10","009","00","050","0015","0108","332","129","203","5","337","1095","0","30.78","11.78"
"10","009","00","050","0016","0000","440","171","269","6","446","1501","0","29.71","11.39"
"10","009","00","050","0016","0109","257","97","160","4","261","811","0","32.18","11.96"
"10","009","00","050","0016","0110","183","74","109","2","185","690","0","26.81","10.72"
"10","009","00","050","0017","0000","457","166","291","3","460","1425","0","32.28","11.65"
"10","009","00","050","0017","0119","251","83","168","0","251","751","0","33.42","11.05"
"10","009","00","050","0017","0120","206","83","123","3","209","674","0","31.01","12.31"
"10","009","00","060","0000","0000","12536","4541","7995","143","12679","33096","38748","38.31","13.72"
"10","009","00","060","0001","0000","308","108","200","5","313","692","0","45.23","15.61"
"10","009","00","060","0001","0274","308","108","200","5","313","692","0","45.23","15.61"
"10","009","00","060","0002","0000","278","78","200","0","278","655","0","42.44","11.91"
"10","009","00","060","0002","0275","278","78","200","0","278","655","0","42.44","11.91"
"10","009","00","060","0003","0000","180","76","104","2","182","437","0","41.65","17.39"
"10","009","00","060","0003","0276","180","76","104","2","182","437","0","41.65","17.39"
"10","009","00","060","0004","0000","374","135","239","5","379","831","0","45.61","16.25"
"10","009","00","060","0004","0277","374","135","239","5","379","831","0","45.61","16.25"
"10","009","00","060","0005","0000","147","48","99","2","149","329","0","45.29","14.59"
"10","009","00","060","0005","0278","147","48","99","2","149","329","0","45.29","14.59"
"10","009","00","060","0006","0000","157","63","94","0","157","385","0","40.78","16.36"
"10","009","00","060","0006","0279","157","63","94","0","157","385","0","40.78","16.36"
"10","009","00","060","0007","0000","152","40","112","2","154","355","0","43.38","11.27"
"10","009","00","060","0007","0280","152","40","112","2","154","355","0","43.38","11.27"
"10","009","00","060","0008","0000","364","136","228","6","370","907","0","40.79","14.99"
"10","009","00","060","0008","0281","364","136","228","6","370","907","0","40.79","14.99"
"10","009","00","060","0009","0000","200","76","124","2","202","469","0","43.07","16.20"
"10","009","00","060","0009","0282","200","76","124","2","202","469","0","43.07","16.20"
"10","009","00","060","0010","0000","142","58","84","2","144","312","0","46.15","18.59"
"10","009","00","060","0010","0283","142","58","84","2","144","312","0","46.15","18.59"
"10","009","00","060","0011","0000","202","79","123","4","206","525","0","39.24","15.05"
"10","009","00","060","0011","0284","202","79","123","4","206","525","0","39.24","15.05"
"10","009","00","060","0012","0000","435","154","281","5","440","1132","0","38.87","13.60"
"10","009","00","060","0012","0285","188","68","120","2","190","415","0","45.78","16.39"
"10","009","00","060","0012","0286","247","86","161","3","250","717","0","34.87","11.99"
"10","009","00","060","0013","0000","204","87","117","3","207","425","0","48.71","20.47"
"10","009","00","060","0013","0287","204","87","117","3","207","425","0","48.71","20.47"
"10","009","00","060","0014","0000","1915","740","1175","18","1933","4762","0","40.59","15.54"
"10","009","00","060","0014","0288","451","181","270","6","457","1131","0","40.41","16.00"
"10","009","00","060","0014","0289","489","190","299","2","491","1181","0","41.57","16.09"
"10","009","00","060","0014","0290","410","155","255","4","414","1161","0","35.66","13.35"
"10","009","00","060","0014","0291","565","214","351","6","571","1289","0","44.30","16.60"
"10","009","00","060","0015","0000","630","294","336","5","635","1679","0","37.82","17.51"
"10","009","00","060","0015","0292","280","129","151","2","282","708","0","39.83","18.22"
"10","009","00","060","0015","0293","350","165","185","3","353","971","0","36.35","16.99"
"10","009","00","060","0016","0000","2360","1014","1346","18","2378","6248","0","38.06","16.23"
"10","009","00","060","0016","0296","509","215","294","5","514","1328","0","38.70","16.19"
"10","009","00","060","0016","0297","409","154","255","5","414","1075","0","38.51","14.33"
"10","009","00","060","0016","0298","606","304","302","4","610","1553","0","39.28","19.58"
"10","009","00","060","0016","0299","444","185","259","0","444","1144","0","38.81","16.17"
"10","009","00","060","0016","0300","392","156","236","4","396","1148","0","34.49","13.59"
"10","009","00","060","0017","0000","397","108","289","6","403","1122","0","35.92","9.63"
"10","009","00","060","0017","0301","397","108","289","6","403","1122","0","35.92","9.63"
"10","009","00","060","0018","0000","232","106","126","3","235","794","0","29.60","13.35"
"10","009","00","060","0018","0305","232","106","126","3","235","794","0","29.60","13.35"
"10","009","00","060","0019","0000","396","104","292","5","401","1344","0","29.84","7.74"
"10","009","00","060","0019","0306","192","54","138","3","195","614","0","31.76","8.79"
"10","009","00","060","0019","0307","204","50","154","2","206","730","0","28.22","6.85"
"10","009","00","060","0020","0000","381","120","261","7","388","1120","0","34.64","10.71"
"10","009","00","060","0020","0308","381","120","261","7","388","1120","0","34.64","10.71"
"10","009","00","060","0021","0000","337","96","241","6","343","969","0","35.40","9.91"
"10","009","00","060","0021","0302","144","43","101","5","149","541","0","27.54","7.95"
"10","009","00","060","0021","0303","193","53","140","1","194","428","0","45.33","12.38"
"10","009","00","060","0022","0000","231","67","164","6","237","760","0","31.18","8.82"
"10","009","00","060","0022","0309","231","67","164","6","237","760","0","31.18","8.82"
"10","009","00","060","0023","0000","170","38","132","7","177","537","0","32.96","7.08"
"10","009","00","060","0023","0310","170","38","132","7","177","537","0","32.96","7.08"
"10","009","00","060","0024","0000","535","180","355","8","543","1571","0","34.56","11.46"
"10","009","00","060","0024","0311","326","102","224","4","330","1009","0","32.71","10.11"
"10","009","00","060","0024","0312","209","78","131","4","213","562","0","37.90","13.88"
"10","009","00","060","0025","0000","1106","387","719","12","1118","2928","0","38.18","13.22"
"10","009","00","060","0025","0313","350","72","278","2","352","895","0","39.33","8.04"
"10","009","00","060","0025","0314","357","154","203","8","365","1007","0","36.25","15.29"
"10","009","00","060","0025","0315","399","161","238","2","401","1026","0","39.08","15.69"
"10","009","00","060","0026","0000","419","68","351","2","421","958","0","43.95","7.10"
"10","009","00","060","0026","0294","419","68","351","2","421","958","0","43.95","7.10"
"10","009","00","060","0027","0000","153","41","112","0","153","470","0","32.55","8.72"
"10","009","00","060","0027","0295","153","41","112","0","153","470","0","32.55","8.72"
"10","009","00","060","0028","0000","131","40","91","2","133","380","0","35.00","10.53"
"10","009","00","060","0028","0304","131","40","91","2","133","380","0","35.00","10.53"
"10","009","00","070","0000","0000","9519","3992","5527","126","9645","27042","30632","35.67","14.76"
"10","009","00","070","0001","0000","429","184","245","7","436","1190","0","36.64","15.46"
"10","009","00","070","0001","0593","429","184","245","7","436","1190","0","36.64","15.46"
"10","009","00","070","0002","0000","418","221","197","3","421","1080","0","38.98","20.46"
"10","009","00","070","0002","0594","418","221","197","3","421","1080","0","38.98","20.46"
"10","009","00","070","0003","0000","397","148","249","7","404","1106","0","36.53","13.38"
"10","009","00","070","0003","0592","397","148","249","7","404","1106","0","36.53","13.38"
"10","009","00","070","0004","0000","494","222","272","5","499","1397","0","35.72","15.89"
"10","009","00","070","0004","0590","398","170","228","5","403","1086","0","37.11","15.65"
"10","009","00","070","0004","0591","96","52","44","0","96","311","0","30.87","16.72"
"10","009","00","070","0005","0000","1047","430","617","12","1059","3146","0","33.66","13.67"
"10","009","00","070","0005","0587","353","153","200","4","357","938","0","38.06","16.31"
"10","009","00","070","0005","0588","380","159","221","5","385","1150","0","33.48","13.83"
"10","009","00","070","0005","0589","314","118","196","3","317","1058","0","29.96","11.15"
"10","009","00","070","0006","0000","580","210","370","13","593","1472","0","40.29","14.27"
"10","009","00","070","0006","0585","332","124","208","8","340","863","0","39.40","14.37"
"10","009","00","070","0006","0586","248","86","162","5","253","609","0","41.54","14.12"
"10","009","00","070","0007","0000","697","254","443","12","709","2048","0","34.62","12.40"
"10","009","00","070","0007","0583","361","142","219","5","366","1080","0","33.89","13.15"
"10","009","00","070","0007","0584","336","112","224","7","343","968","0","35.43","11.57"
"10","009","00","070","0008","0000","217","79","138","1","218","708","0","30.79","11.16"
"10","009","00","070","0008","0608","217","79","138","1","218","708","0","30.79","11.16"
"10","009","00","070","0009","0000","105","29","76","0","105","278","0","37.77","10.43"
"10","009","00","070","0009","0607","105","29","76","0","105","278","0","37.77","10.43"
"10","009","00","070","0010","0000","684","290","394","9","693","2109","0","32.86","13.75"
"10","009","00","070","0010","0601","331","145","186","3","334","976","0","34.22","14.86"
"10","009","00","070","0010","0602","353","145","208","6","359","1133","0","31.69","12.80"
"10","009","00","070","0011","0000","342","99","243","2","344","1061","0","32.42","9.33"
"10","009","00","070","0011","0609","342","99","243","2","344","1061","0","32.42","9.33"
"10","009","00","070","0012","0000","358","176","182","8","366","1155","0","31.69","15.24"
"10","009","00","070","0012","0606","358","176","182","8","366","1155","0","31.69","15.24"
"10","009","00","070","0013","0000","100","43","57","5","105","429","0","24.48","10.02"
"10","009","00","070","0013","0610","100","43","57","5","105","429","0","24.48","10.02"
"10","009","00","070","0014","0000","198","76","122","1","199","543","0","36.65","14.00"
"10","009","00","070","0014","0611","198","76","122","1","199","543","0","36.65","14.00"
"10","009","00","070","0015","0000","751","325","426","9","760","2065","0","36.80","15.74"
"10","009","00","070","0015","0603","404","167","237","6","410","1116","0","36.74","14.96"
"10","009","00","070","0015","0604","347","158","189","3","350","949","0","36.88","16.65"
"10","009","00","070","0016","0000","329","107","222","6","335","761","0","44.02","14.06"
"10","009","00","070","0016","0605","329","107","222","6","335","761","0","44.02","14.06"
"10","009","00","070","0017","0000","780","371","409","8","788","2241","0","35.16","16.56"
"10","009","00","070","0017","0595","406","194","212","5","411","1131","0","36.34","17.15"
"10","009","00","070","0017","0596","374","177","197","3","377","1110","0","33.96","15.95"
"10","009","00","070","0018","0000","763","362","401","13","776","2080","0","37.31","17.40"
"10","009","00","070","0018","0597","345","168","177","4","349","948","0","36.81","17.72"
"10","009","00","070","0018","0598","418","194","224","9","427","1132","0","37.72","17.14"
"10","009","00","070","0019","0000","582","251","331","2","584","1501","0","38.91","16.72"
"10","009","00","070","0019","0599","582","251","331","2","584","1501","0","38.91","16.72"
"10","009","00","070","0020","0000","248","115","133","3","251","672","0","37.35","17.11"
"10","009","00","070","0020","0600","248","115","133","3","251","672","0","37.35","17.11"
"10","009","00","080","0000","0000","5813","2183","3630","82","5895","16313","18555","36.14","13.38"
"10","009","00","080","0001","0000","289","122","167","2","291","737","0","39.48","16.55"
"10","009","00","080","0001","0527","289","122","167","2","291","737","0","39.48","16.55"
"10","009","00","080","0002","0000","801","301","500","16","817","2148","0","38.04","14.01"
"10","009","00","080","0002","0531","374","162","212","7","381","957","0","39.81","16.93"
"10","009","00","080","0002","0532","206","69","137","6","212","593","0","35.75","11.64"
"10","009","00","080","0002","0533","221","70","151","3","224","598","0","37.46","11.71"
"10","009","00","080","0003","0000","351","155","196","4","355","959","0","37.02","16.16"
"10","009","00","080","0003","0534","351","155","196","4","355","959","0","37.02","16.16"
"10","009","00","080","0004","0000","326","85","241","4","330","908","0","36.34","9.36"
"10","009","00","080","0004","0535","326","85","241","4","330","908","0","36.34","9.36"
"10","009","00","080","0005","0000","661","237","424","15","676","1893","0","35.71","12.52"
"10","009","00","080","0005","0538","500","169","331","10","510","1443","0","35.34","11.71"
"10","009","00","080","0005","0539","161","68","93","5","166","450","0","36.89","15.11"
"10","009","00","080","0006","0000","684","292","392","7","691","1830","0","37.76","15.96"
"10","009","00","080","0006","0540","490","221","269","5","495","1321","0","37.47","16.73"
"10","009","00","080","0006","0541","194","71","123","2","196","509","0","38.51","13.95"
"10","009","00","080","0007","0000","576","228","348","9","585","1532","0","38.19","14.88"
"10","009","00","080","0007","0536","239","77","162","5","244","555","0","43.96","13.87"
"10","009","00","080","0007","0537","337","151","186","4","341","977","0","34.90","15.46"
"10","009","00","080","0008","0000","385","127","258","5","390","1179","0","33.08","10.77"
"10","009","00","080","0008","0542","385","127","258","5","390","1179","0","33.08","10.77"
"10","009","00","080","0009","0000","239","72","167","4","243","716","0","33.94","10.06"
"10","009","00","080","0009","0528","239","72","167","4","243","716","0","33.94","10.06"
"10","009","00","080","0010","0000","199","86","113","1","200","583","0","34.31","14.75"
"10","009","00","080","0010","0529","199","86","113","1","200","583","0","34.31","14.75"
"10","009","00","080","0011","0000","325","121","204","4","329","1045","0","31.48","11.58"
"10","009","00","080","0011","0530","325","121","204","4","329","1045","0","31.48","11.58"
"10","009","00","080","0012","0000","273","106","167","3","276","743","0","37.15","14.27"
"10","009","00","080","0012","0543","273","106","167","3","276","743","0","37.15","14.27"
"10","009","00","080","0013","0000","245","88","157","3","248","670","0","37.01","13.13"
"10","009","00","080","0013","0544","245","88","157","3","248","670","0","37.01","13.13"
"10","009","00","080","0014","0000","238","75","163","1","239","669","0","35.72","11.21"
"10","009","00","080","0014","0545","238","75","163","1","239","669","0","35.72","11.21"
"10","009","00","080","0015","0000","221","88","133","4","225","701","0","32.10","12.55"
"10","009","00","080","0015","0546","221","88","133","4","225","701","0","32.10","12.55"
"10","009","00","090","0000","0000","9285","3336","5949","116","9401","24348","28143","38.61","13.70"
"10","009","00","090","0001","0000","1675","640","1035","13","1688","4116","0","41.01","15.55"
"10","009","00","090","0001","0402","378","163","215","5","383","989","0","38.73","16.48"
"10","009","00","090","0001","0403","315","111","204","3","318","895","0","35.53","12.40"
"10","009","00","090","0001","0404","434","165","269","0","434","943","0","46.02","17.50"
"10","009","00","090","0001","0405","548","201","347","5","553","1289","0","42.90","15.59"
"10","009","00","090","0002","0000","333","90","243","6","339","864","0","39.24","10.42"
"10","009","00","090","0002","0406","333","90","243","6","339","864","0","39.24","10.42"
"10","009","00","090","0003","0000","592","173","419","4","596","1530","0","38.95","11.31"
"10","009","00","090","0003","0407","335","83","252","3","338","774","0","43.67","10.72"
"10","009","00","090","0003","0408","257","90","167","1","258","756","0","34.13","11.90"
"10","009","00","090","0004","0000","501","183","318","6","507","1177","0","43.08","15.55"
"10","009","00","090","0004","0409","233","84","149","3","236","572","0","41.26","14.69"
"10","009","00","090","0004","0410","268","99","169","3","271","605","0","44.79","16.36"
"10","009","00","090","0005","0000","378","124","254","5","383","1068","0","35.86","11.61"
"10","009","00","090","0005","0411","378","124","254","5","383","1068","0","35.86","11.61"
"10","009","00","090","0006","0000","748","224","524","10","758","2015","0","37.62","11.12"
"10","009","00","090","0006","0412","383","128","255","5","388","1023","0","37.93","12.51"
"10","009","00","090","0006","0413","365","96","269","5","370","992","0","37.30","9.68"
"10","009","00","090","0007","0000","1186","507","679","13","1199","3053","0","39.27","16.61"
"10","009","00","090","0007","0414","419","197","222","4","423","1071","0","39.50","18.39"
"10","009","00","090","0007","0415","345","141","204","3","348","925","0","37.62","15.24"
"10","009","00","090","0007","0416","422","169","253","6","428","1057","0","40.49","15.99"
"10","009","00","090","0008","0000","524","191","333","6","530","1250","0","42.40","15.28"
"10","009","00","090","0008","0417","524","191","333","6","530","1250","0","42.40","15.28"
"10","009","00","090","0009","0000","392","140","252","9","401","1135","0","35.33","12.33"
"10","009","00","090","0009","0420","392","140","252","9","401","1135","0","35.33","12.33"
"10","009","00","090","0010","0000","686","249","437","11","697","1882","0","37.04","13.23"
"10","009","00","090","0010","0418","295","143","152","7","302","875","0","34.51","16.34"
"10","009","00","090","0010","0419","391","106","285","4","395","1007","0","39.23","10.53"
"10","009","00","090","0011","0000","630","253","377","5","635","1725","0","36.81","14.67"
"10","009","00","090","0011","0421","304","113","191","2","306","852","0","35.92","13.26"
"10","009","00","090","0011","0422","326","140","186","3","329","873","0","37.69","16.04"
"10","009","00","090","0012","0000","498","193","305","10","508","1453","0","34.96","13.28"
"10","009","00","090","0012","0423","300","108","192","6","306","932","0","32.83","11.59"
"10","009","00","090","0012","0424","198","85","113","4","202","521","0","38.77","16.31"
"10","009","00","090","0013","0000","466","159","307","6","472","1313","0","35.95","12.11"
"10","009","00","090","0013","0425","184","48","136","2","186","448","0","41.52","10.71"
"10","009","00","090","0013","0426","282","111","171","4","286","865","0","33.06","12.83"
"10","009","00","090","0014","0000","676","210","466","12","688","1767","0","38.94","11.88"
"10","009","00","090","0014","0427","436","112","324","6","442","1133","0","39.01","9.89"
"10","009","00","090","0014","0428","240","98","142","6","246","634","0","38.80","15.46"
"10","009","00","100","0000","0000","5288","2264","3024","82","5370","15106","17408","35.55","14.99"
"10","009","00","100","0001","0000","358","171","187","6","364","1004","0","36.25","17.03"
"10","009","00","100","0001","0429","358","171","187","6","364","1004","0","36.25","17.03"
"10","009","00","100","0002","0000","1295","574","721","18","1313","3548","0","37.01","16.18"
"10","009","00","100","0002","0430","455","182","273","11","466","1210","0","38.51","15.04"
"10","009","00","100","0002","0431","294","139","155","4","298","836","0","35.65","16.63"
"10","009","00","100","0002","0432","286","139","147","1","287","835","0","34.37","16.65"
"10","009","00","100","0002","0433","260","114","146","2","262","667","0","39.28","17.09"
"10","009","00","100","0003","0000","761","295","466","12","773","2097","0","36.86","14.07"
"10","009","00","100","0003","0434","485","228","257","7","492","1377","0","35.73","16.56"
"10","009","00","100","0003","0435","276","67","209","5","281","720","0","39.03","9.31"
"10","009","00","100","0004","0000","172","92","80","3","175","505","0","34.65","18.22"
"10","009","00","100","0004","0436","172","92","80","3","175","505","0","34.65","18.22"
"10","009","00","100","0005","0000","287","131","156","3","290","802","0","36.16","16.33"
"10","009","00","100","0005","0437","287","131","156","3","290","802","0","36.16","16.33"
"10","009","00","100","0006","0000","822","345","477","17","839","2594","0","32.34","13.30"
"10","009","00","100","0006","0438","414","179","235","10","424","1305","0","32.49","13.72"
"10","009","00","100","0006","0439","408","166","242","7","415","1289","0","32.20","12.88"
"10","009","00","100","0007","0000","226","88","138","2","228","627","0","36.36","14.04"
"10","009","00","100","0007","0440","226","88","138","2","228","627","0","36.36","14.04"
"10","009","00","100","0008","0000","381","167","214","10","391","1115","0","35.07","14.98"
"10","009","00","100","0008","0441","381","167","214","10","391","1115","0","35.07","14.98"
"10","009","00","100","0009","0000","345","187","158","4","349","1016","0","34.35","18.41"
"10","009","00","100","0009","0442","345","187","158","4","349","1016","0","34.35","18.41"
"10","009","00","100","0010","0000","641","214","427","7","648","1798","0","36.04","11.90"
"10","009","00","100","0010","0443","344","108","236","4","348","950","0","36.63","11.37"
"10","009","00","100","0010","0444","297","106","191","3","300","848","0","35.38","12.50"
"10","009","00","110","0000","0000","7892","2491","5401","104","7996","22786","25808","35.09","10.93"
"10","009","00","110","0001","0000","527","206","321","5","532","1442","0","36.89","14.29"
"10","009","00","110","0001","0337","292","118","174","2","294","838","0","35.08","14.08"
"10","009","00","110","0001","0338","235","88","147","3","238","604","0","39.40","14.57"
"10","009","00","110","0002","0000","625","243","382","8","633","1698","0","37.28","14.31"
"10","009","00","110","0002","0339","350","140","210","5","355","922","0","38.50","15.18"
"10","009","00","110","0002","0340","275","103","172","3","278","776","0","35.82","13.27"
"10","009","00","110","0003","0000","523","164","359","7","530","1596","0","33.21","10.28"
"10","009","00","110","0003","0341","161","52","109","1","162","603","0","26.87","8.62"
"10","009","00","110","0003","0342","362","112","250","6","368","993","0","37.06","11.28"
"10","009","00","110","0004","0000","503","146","357","11","514","1474","0","34.87","9.91"
"10","009","00","110","0004","0343","160","50","110","1","161","441","0","36.51","11.34"
"10","009","00","110","0004","0344","343","96","247","10","353","1033","0","34.17","9.29"
"10","009","00","110","0005","0000","410","183","227","8","418","1126","0","37.12","16.25"
"10","009","00","110","0005","0345","410","183","227","8","418","1126","0","37.12","16.25"
"10","009","00","110","0006","0000","650","209","441","1","651","1839","0","35.40","11.36"
"10","009","00","110","0006","0346","356","108","248","1","357","1019","0","35.03","10.60"
"10","009","00","110","0006","0347","294","101","193","0","294","820","0","35.85","12.32"
"10","009","00","110","0007","0000","301","88","213","6","307","861","0","35.66","10.22"
"10","009","00","110","0007","0348","301","88","213","6","307","861","0","35.66","10.22"
"10","009","00","110","0008","0000","342","91","251","2","344","873","0","39.40","10.42"
"10","009","00","110","0008","0351","342","91","251","2","344","873","0","39.40","10.42"
"10","009","00","110","0009","0000","281","51","230","2","283","748","0","37.83","6.82"
"10","009","00","110","0009","0352","281","51","230","2","283","748","0","37.83","6.82"
"10","009","00","110","0010","0000","454","113","341","9","463","1464","0","31.63","7.72"
"10","009","00","110","0010","0353","212","66","146","5","217","652","0","33.28","10.12"
"10","009","00","110","0010","0354","242","47","195","4","246","812","0","30.30","5.79"
"10","009","00","110","0011","0000","606","163","443","19","625","1782","0","35.07","9.15"
"10","009","00","110","0011","0355","364","77","287","11","375","1127","0","33.27","6.83"
"10","009","00","110","0011","0356","242","86","156","8","250","655","0","38.17","13.13"
"10","009","00","110","0012","0000","273","77","196","3","276","821","0","33.62","9.38"
"10","009","00","110","0012","0357","273","77","196","3","276","821","0","33.62","9.38"
"10","009","00","110","0013","0000","653","229","424","5","658","1719","0","38.28","13.32"
"10","009","00","110","0013","0358","438","182","256","4","442","1042","0","42.42","17.47"
"10","009","00","110","0013","0359","215","47","168","1","216","677","0","31.91","6.94"
"10","009","00","110","0014","0000","408","126","282","7","415","1223","0","33.93","10.30"
"10","009","00","110","0014","0360","408","126","282","7","415","1223","0","33.93","10.30"
"10","009","00","110","0015","0000","231","73","158","1","232","907","0","25.58","8.05"
"10","009","00","110","0015","0361","231","73","158","1","232","907","0","25.58","8.05"
"10","009","00","110","0016","0000","279","77","202","4","283","824","0","34.34","9.34"
"10","009","00","110","0016","0362","279","77","202","4","283","824","0","34.34","9.34"
"10","009","00","110","0017","0000","265","82","183","3","268","983","0","27.26","8.34"
"10","009","00","110","0017","0363","265","82","183","3","268","983","0","27.26","8.34"
"10","009","00","110","0018","0000","561","170","391","3","564","1406","0","40.11","12.09"
"10","009","00","110","0018","0349","321","98","223","3","324","798","0","40.60","12.28"
"10","009","00","110","0018","0350","240","72","168","0","240","608","0","39.47","11.84"
"10","009","00","120","0000","0000","6805","2647","4158","96","6901","20647","23741","33.42","12.82"
"10","009","00","120","0001","0000","420","176","244","4","424","1134","0","37.39","15.52"
"10","009","00","120","0001","0316","420","176","244","4","424","1134","0","37.39","15.52"
"10","009","00","120","0002","0000","506","220","286","6","512","1437","0","35.63","15.31"
"10","009","00","120","0002","0317","506","220","286","6","512","1437","0","35.63","15.31"
"10","009","00","120","0003","0000","832","379","453","4","836","2263","0","36.94","16.75"
"10","009","00","120","0003","0318","399","168","231","2","401","1093","0","36.69","15.37"
"10","009","00","120","0003","0319","433","211","222","2","435","1170","0","37.18","18.03"
"10","009","00","120","0004","0000","731","230","501","11","742","2078","0","35.71","11.07"
"10","009","00","120","0004","0320","405","130","275","6","411","1082","0","37.99","12.01"
"10","009","00","120","0004","0321","326","100","226","5","331","996","0","33.23","10.04"
"10","009","00","120","0005","0000","740","251","489","14","754","2042","0","36.92","12.29"
"10","009","00","120","0005","0322","346","139","207","10","356","958","0","37.16","14.51"
"10","009","00","120","0005","0323","394","112","282","4","398","1084","0","36.72","10.33"
"10","009","00","120","0006","0000","423","114","309","5","428","1250","0","34.24","9.12"
"10","009","00","120","0006","0324","423","114","309","5","428","1250","0","34.24","9.12"
"10","009","00","120","0007","0000","593","256","337","5","598","2022","0","29.57","12.66"
"10","009","00","120","0007","0325","240","117","123","3","243","1023","0","23.75","11.44"
"10","009","00","120","0007","0326","353","139","214","2","355","999","0","35.54","13.91"
"10","009","00","120","0008","0000","259","171","88","6","265","782","0","33.89","21.87"
"10","009","00","120","0008","0327","259","171","88","6","265","782","0","33.89","21.87"
"10","009","00","120","0009","0000","437","184","253","9","446","1484","0","30.05","12.40"
"10","009","00","120","0009","0328","180","71","109","3","183","686","0","26.68","10.35"
"10","009","00","120","0009","0329","257","113","144","6","263","798","0","32.96","14.16"
"10","009","00","120","0010","0000","500","185","315","8","508","1710","0","29.71","10.82"
"10","009","00","120","0010","0330","267","89","178","7","274","859","0","31.90","10.36"
"10","009","00","120","0010","0331","233","96","137","1","234","851","0","27.50","11.28"
"10","009","00","120","0011","0000","423","180","243","8","431","1413","0","30.50","12.74"
"10","009","00","120","0011","0332","203","88","115","2","205","668","0","30.69","13.17"
"10","009","00","120","0011","0333","220","92","128","6","226","745","0","30.34","12.35"
"10","009","00","120","0012","0000","264","101","163","8","272","1102","0","24.68","9.17"
"10","009","00","120","0012","0334","264","101","163","8","272","1102","0","24.68","9.17"
"10","009","00","120","0013","0000","443","122","321","5","448","1181","0","37.93","10.33"
"10","009","00","120","0013","0335","443","122","321","5","448","1181","0","37.93","10.33"
"10","009","00","120","0014","0000","234","78","156","3","237","749","0","31.64","10.41"
"10","009","00","120","0014","0336","234","78","156","3","237","749","0","31.64","10.41"
"10","009","00","130","0000","0000","9790","4700","5090","131","9921","39270","48001","25.26","11.97"
"10","009","00","130","0001","0000","1123","580","543","10","1133","4277","0","26.49","13.56"
"10","009","00","130","0001","0007","318","159","159","7","325","1135","0","28.63","14.01"
"10","009","00","130","0001","0008","265","141","124","1","266","957","0","27.80","14.73"
"10","009","00","130","0001","0009","304","160","144","2","306","1158","0","26.42","13.82"
"10","009","00","130","0001","0010","236","120","116","0","236","1027","0","22.98","11.68"
"10","009","00","130","0002","0000","1934","1018","916","20","1954","7460","0","26.19","13.65"
"10","009","00","130","0002","0001","319","180","139","1","320","1356","0","23.60","13.27"
"10","009","00","130","0002","0002","285","159","126","3","288","1247","0","23.10","12.75"
"10","009","00","130","0002","0003","381","200","181","3","384","1260","0","30.48","15.87"
"10","009","00","130","0002","0004","386","197","189","6","392","1494","0","26.24","13.19"
"10","009","00","130","0002","0005","314","148","166","3","317","1082","0","29.30","13.68"
"10","009","00","130","0002","0006","249","134","115","4","253","1021","0","24.78","13.12"
"10","009","00","130","0003","0000","517","191","326","6","523","1968","0","26.58","9.71"
"10","009","00","130","0003","0011","182","58","124","2","184","739","0","24.90","7.85"
"10","009","00","130","0003","0012","335","133","202","4","339","1229","0","27.58","10.82"
"10","009","00","130","0004","0000","752","307","445","13","765","2867","0","26.68","10.71"
"10","009","00","130","0004","0013","319","140","179","5","324","1178","0","27.50","11.88"
"10","009","00","130","0004","0014","261","98","163","3","264","1013","0","26.06","9.67"
"10","009","00","130","0004","0015","172","69","103","5","177","676","0","26.18","10.21"
"10","009","00","130","0005","0000","634","343","291","8","642","2721","0","23.59","12.61"
"10","009","00","130","0005","0025","321","186","135","3","324","1339","0","24.20","13.89"
"10","009","00","130","0005","0026","313","157","156","5","318","1382","0","23.01","11.36"
"10","009","00","130","0006","0000","661","383","278","7","668","3051","0","21.89","12.55"
"10","009","00","130","0006","0018","253","137","116","2","255","1075","0","23.72","12.74"
"10","009","00","130","0006","0019","205","139","66","4","209","942","0","22.19","14.76"
"10","009","00","130","0006","0020","203","107","96","1","204","1034","0","19.73","10.35"
"10","009","00","130","0007","0000","506","245","261","8","514","2216","0","23.19","11.06"
"10","009","00","130","0007","0016","247","125","122","5","252","1215","0","20.74","10.29"
"10","009","00","130","0007","0017","259","120","139","3","262","1001","0","26.17","11.99"
"10","009","00","130","0008","0000","517","215","302","5","522","2141","0","24.38","10.04"
"10","009","00","130","0008","0023","235","104","131","5","240","1001","0","23.98","10.39"
"10","009","00","130","0008","0024","282","111","171","0","282","1140","0","24.74","9.74"
"10","009","00","130","0009","0000","1003","462","541","18","1021","4026","0","25.36","11.48"
"10","009","00","130","0009","0027","286","147","139","2","288","1218","0","23.65","12.07"
"10","009","00","130","0009","0028","229","93","136","8","237","951","0","24.92","9.78"
"10","009","00","130","0009","0029","237","98","139","3","240","908","0","26.43","10.79"
"10","009","00","130","0009","0030","251","124","127","5","256","949","0","26.98","13.07"
"10","009","00","130","0010","0000","302","129","173","3","305","1156","0","26.38","11.16"
"10","009","00","130","0010","0031","302","129","173","3","305","1156","0","26.38","11.16"
"10","009","00","130","0011","0000","928","385","543","19","947","3617","0","26.18","10.64"
"10","009","00","130","0011","0032","354","155","199","9","363","1244","0","29.18","12.46"
"10","009","00","130","0011","0033","305","101","204","5","310","1255","0","24.70","8.05"
"10","009","00","130","0011","0034","269","129","140","5","274","1118","0","24.51","11.54"
"10","009","00","130","0012","0000","544","262","282","12","556","2222","0","25.02","11.79"
"10","009","00","130","0012","0035","324","161","163","6","330","1193","0","27.66","13.50"
"10","009","00","130","0012","0036","220","101","119","6","226","1029","0","21.96","9.82"
"10","009","00","130","0013","0000","369","180","189","2","371","1548","0","23.97","11.63"
"10","009","00","130","0013","0021","183","98","85","2","185","808","0","22.90","12.13"
"10","009","00","130","0013","0022","186","82","104","0","186","740","0","25.14","11.08"
"10","009","00","140","0000","0000","4011","1748","2263","56","4067","12612","13963","32.25","13.86"
"10","009","00","140","0001","0000","557","290","267","8","565","1442","0","39.18","20.11"
"10","009","00","140","0001","0065","328","170","158","4","332","863","0","38.47","19.70"
"10","009","00","140","0001","0066","229","120","109","4","233","579","0","40.24","20.73"
"10","009","00","140","0002","0000","383","181","202","5","388","1155","0","33.59","15.67"
"10","009","00","140","0002","0067","383","181","202","5","388","1155","0","33.59","15.67"
"10","009","00","140","0003","0000","437","180","257","6","443","1536","0","28.84","11.72"
"10","009","00","140","0003","0063","213","69","144","3","216","864","0","25.00","7.99"
"10","009","00","140","0003","0064","224","111","113","3","227","672","0","33.78","16.52"
"10","009","00","140","0004","0000","199","90","109","1","200","511","0","39.14","17.61"
"10","009","00","140","0004","0062","199","90","109","1","200","511","0","39.14","17.61"
"10","009","00","140","0005","0000","341","118","223","2","343","1160","0","29.57","10.17"
"10","009","00","140","0005","0061","341","118","223","2","343","1160","0","29.57","10.17"
"10","009","00","140","0006","0000","181","77","104","3","184","532","0","34.59","14.47"
"10","009","00","140","0006","0069","181","77","104","3","184","532","0","34.59","14.47"
"10","009","00","140","0007","0000","266","74","192","5","271","778","0","34.83","9.51"
"10","009","00","140","0007","0068","266","74","192","5","271","778","0","34.83","9.51"
"10","009","00","140","0008","0000","211","86","125","3","214","812","0","26.35","10.59"
"10","009","00","140","0008","0071","211","86","125","3","214","812","0","26.35","10.59"
"10","009","00","140","0009","0000","278","116","162","5","283","825","0","34.30","14.06"
"10","009","00","140","0009","0070","278","116","162","5","283","825","0","34.30","14.06"
"10","009","00","140","0010","0000","555","265","290","12","567","1857","0","30.53","14.27"
"10","009","00","140","0010","0072","268","126","142","7","275","888","0","30.97","14.19"
"10","009","00","140","0010","0073","287","139","148","5","292","969","0","30.13","14.34"
"10","009","00","140","0011","0000","313","141","172","2","315","1015","0","31.03","13.89"
"10","009","00","140","0011","0076","313","141","172","2","315","1015","0","31.03","13.89"
"10","009","00","140","0012","0000","290","130","160","4","294","989","0","29.73","13.14"
"10","009","00","140","0012","0074","163","97","66","3","166","590","0","28.14","16.44"
"10","009","00","140","0012","0075","127","33","94","1","128","399","0","32.08","8.27"
"10","009","00","150","0000","0000","3957","1581","2376","53","4010","10933","12368","36.68","14.46"
"10","009","00","150","0001","0000","704","297","407","2","706","1848","0","38.20","16.07"
"10","009","00","150","0001","0077","338","140","198","0","338","882","0","38.32","15.87"
"10","009","00","150","0001","0078","366","157","209","2","368","966","0","38.10","16.25"
"10","009","00","150","0002","0000","525","234","291","5","530","1415","0","37.46","16.54"
"10","009","00","150","0002","0079","270","118","152","2","272","726","0","37.47","16.25"
"10","009","00","150","0002","0080","255","116","139","3","258","689","0","37.45","16.84"
"10","009","00","150","0003","0000","517","212","305","7","524","1455","0","36.01","14.57"
"10","009","00","150","0003","0081","248","95","153","4","252","733","0","34.38","12.96"
"10","009","00","150","0003","0082","269","117","152","3","272","722","0","37.67","16.20"
"10","009","00","150","0004","0000","432","142","290","13","445","1158","0","38.43","12.26"
"10","009","00","150","0004","0085","178","56","122","2","180","453","0","39.74","12.36"
"10","009","00","150","0004","0086","254","86","168","11","265","705","0","37.59","12.20"
"10","009","00","150","0005","0000","505","183","322","10","515","1437","0","35.84","12.73"
"10","009","00","150","0005","0083","179","67","112","2","181","468","0","38.68","14.32"
"10","009","00","150","0005","0084","326","116","210","8","334","969","0","34.47","11.97"
"10","009","00","150","0006","0000","295","107","188","4","299","806","0","37.10","13.28"
"10","009","00","150","0006","0087","295","107","188","4","299","806","0","37.10","13.28"
"10","009","00","150","0007","0000","282","112","170","0","282","774","0","36.43","14.47"
"10","009","00","150","0007","0088","282","112","170","0","282","774","0","36.43","14.47"
"10","009","00","150","0008","0000","390","175","215","4","394","1187","0","33.19","14.74"
"10","009","00","150","0008","0089","390","175","215","4","394","1187","0","33.19","14.74"
"10","009","00","150","0009","0000","307","119","188","8","315","853","0","36.93","13.95"
"10","009","00","150","0009","0090","307","119","188","8","315","853","0","36.93","13.95"
"10","009","00","160","0000","0000","5491","2757","2734","102","5593","20367","22792","27.46","13.54"
"10","009","00","160","0001","0000","415","239","176","7","422","1177","0","35.85","20.31"
"10","009","00","160","0001","0037","415","239","176","7","422","1177","0","35.85","20.31"
"10","009","00","160","0002","0000","320","173","147","7","327","1060","0","30.85","16.32"
"10","009","00","160","0002","0039","320","173","147","7","327","1060","0","30.85","16.32"
"10","009","00","160","0003","0000","311","165","146","6","317","1093","0","29.00","15.10"
"10","009","00","160","0003","0038","311","165","146","6","317","1093","0","29.00","15.10"
"10","009","00","160","0004","0000","492","274","218","9","501","1980","0","25.30","13.84"
"10","009","00","160","0004","0040","228","113","115","2","230","988","0","23.28","11.44"
"10","009","00","160","0004","0041","264","161","103","7","271","992","0","27.32","16.23"
"10","009","00","160","0005","0000","361","159","202","10","371","1449","0","25.60","10.97"
"10","009","00","160","0005","0043","174","83","91","7","181","706","0","25.64","11.76"
"10","009","00","160","0005","0044","187","76","111","3","190","743","0","25.57","10.23"
"10","009","00","160","0006","0000","452","192","260","15","467","1828","0","25.55","10.50"
"10","009","00","160","0006","0045","301","111","190","9","310","1133","0","27.36","9.80"
"10","009","00","160","0006","0046","151","81","70","6","157","695","0","22.59","11.65"
"10","009","00","160","0007","0000","157","72","85","3","160","592","0","27.03","12.16"
"10","009","00","160","0007","0047","157","72","85","3","160","592","0","27.03","12.16"
"10","009","00","160","0008","0000","220","104","116","4","224","672","0","33.33","15.48"
"10","009","00","160","0008","0049","220","104","116","4","224","672","0","33.33","15.48"
"10","009","00","160","0009","0000","140","37","103","3","143","450","0","31.78","8.22"
"10","009","00","160","0009","0048","140","37","103","3","143","450","0","31.78","8.22"
"10","009","00","160","0010","0000","211","125","86","2","213","811","0","26.26","15.41"
"10","009","00","160","0010","0042","211","125","86","2","213","811","0","26.26","15.41"
"10","009","00","160","0011","0000","381","194","187","9","390","1466","0","26.60","13.23"
"10","009","00","160","0011","0052","274","123","151","6","280","1020","0","27.45","12.06"
"10","009","00","160","0011","0053","107","71","36","3","110","446","0","24.66","15.92"
"10","009","00","160","0012","0000","370","179","191","3","373","1332","0","28.00","13.44"
"10","009","00","160","0012","0054","215","118","97","3","218","775","0","28.13","15.23"
"10","009","00","160","0012","0055","155","61","94","0","155","557","0","27.83","10.95"
"10","009","00","160","0013","0000","766","358","408","12","778","2935","0","26.51","12.20"
"10","009","00","160","0013","0056","305","157","148","4","309","1031","0","29.97","15.23"
"10","009","00","160","0013","0057","260","122","138","4","264","960","0","27.50","12.71"
"10","009","00","160","0013","0058","201","79","122","4","205","944","0","21.72","8.37"
"10","009","00","160","0014","0000","435","246","189","3","438","1741","0","25.16","14.13"
"10","009","00","160","0014","0059","295","147","148","1","296","1162","0","25.47","12.65"
"10","009","00","160","0014","0060","140","99","41","2","142","579","0","24.53","17.10"
"10","009","00","160","0015","0000","460","240","220","9","469","1781","0","26.33","13.48"
"10","009","00","160","0015","0050","325","156","169","7","332","1214","0","27.35","12.85"
"10","009","00","160","0015","0051","135","84","51","2","137","567","0","24.16","14.81"
"10","009","00","170","0000","0000","6694","2437","4257","85","6779","21835","24426","31.05","11.16"
"10","009","00","170","0001","0000","1025","382","643","5","1030","3218","0","32.01","11.87"
"10","009","00","170","0001","0196","284","91","193","1","285","882","0","32.31","10.32"
"10","009","00","170","0001","0197","393","160","233","1","394","1238","0","31.83","12.92"
"10","009","00","170","0001","0198","348","131","217","3","351","1098","0","31.97","11.93"
"10","009","00","170","0002","0000","490","166","324","5","495","1454","0","34.04","11.42"
"10","009","00","170","0002","0199","237","76","161","0","237","698","0","33.95","10.89"
"10","009","00","170","0002","0200","253","90","163","5","258","756","0","34.13","11.90"
"10","009","00","170","0003","0000","408","139","269","6","414","1308","0","31.65","10.63"
"10","009","00","170","0003","0201","408","139","269","6","414","1308","0","31.65","10.63"
"10","009","00","170","0004","0000","229","78","151","6","235","705","0","33.33","11.06"
"10","009","00","170","0004","0202","229","78","151","6","235","705","0","33.33","11.06"
"10","009","00","170","0005","0000","289","116","173","5","294","936","0","31.41","12.39"
"10","009","00","170","0005","0203","289","116","173","5","294","936","0","31.41","12.39"
"10","009","00","170","0006","0000","297","97","200","5","302","1030","0","29.32","9.42"
"10","009","00","170","0006","0204","297","97","200","5","302","1030","0","29.32","9.42"
"10","009","00","170","0007","0000","285","140","145","7","292","890","0","32.81","15.73"
"10","009","00","170","0007","0205","285","140","145","7","292","890","0","32.81","15.73"
"10","009","00","170","0008","0000","258","61","197","8","266","715","0","37.20","8.53"
"10","009","00","170","0008","0206","258","61","197","8","266","715","0","37.20","8.53"
"10","009","00","170","0009","0000","176","85","91","3","179","570","0","31.40","14.91"
"10","009","00","170","0009","0207","176","85","91","3","179","570","0","31.40","14.91"
"10","009","00","170","0010","0000","220","105","115","2","222","836","0","26.56","12.56"
"10","009","00","170","0010","0208","220","105","115","2","222","836","0","26.56","12.56"
"10","009","00","170","0011","0000","137","27","110","3","140","351","0","39.89","7.69"
"10","009","00","170","0011","0209","137","27","110","3","140","351","0","39.89","7.69"
"10","009","00","170","0012","0000","295","94","201","2","297","1112","0","26.71","8.45"
"10","009","00","170","0012","0210","295","94","201","2","297","1112","0","26.71","8.45"
"10","009","00","170","0013","0000","436","167","269","10","446","1457","0","30.61","11.46"
"10","009","00","170","0013","0211","145","45","100","2","147","565","0","26.02","7.96"
"10","009","00","170","0013","0212","291","122","169","8","299","892","0","33.52","13.68"
"10","009","00","170","0014","0000","314","76","238","3","317","958","0","33.09","7.93"
"10","009","00","170","0014","0213","314","76","238","3","317","958","0","33.09","7.93"
"10","009","00","170","0015","0000","249","87","162","4","253","813","0","31.12","10.70"
"10","009","00","170","0015","0214","249","87","162","4","253","813","0","31.12","10.70"
"10","009","00","170","0016","0000","311","157","154","0","311","1127","0","27.60","13.93"
"10","009","00","170","0016","0215","311","157","154","0","311","1127","0","27.60","13.93"
"10","009","00","170","0017","0000","265","99","166","3","268","816","0","32.84","12.13"
"10","009","00","170","0017","0216","265","99","166","3","268","816","0","32.84","12.13"
"10","009","00","170","0018","0000","413","132","281","4","417","1472","0","28.33","8.97"
"10","009","00","170","0018","0217","181","58","123","1","182","645","0","28.22","8.99"
"10","009","00","170","0018","0218","232","74","158","3","235","827","0","28.42","8.95"
"10","009","00","170","0019","0000","172","51","121","1","173","578","0","29.93","8.82"
"10","009","00","170","0019","0219","172","51","121","1","173","578","0","29.93","8.82"
"10","009","00","170","0020","0000","198","83","115","2","200","803","0","24.91","10.34"
"10","009","00","170","0020","0220","198","83","115","2","200","803","0","24.91","10.34"
"10","009","00","170","0021","0000","227","95","132","1","228","686","0","33.24","13.85"
"10","009","00","170","0021","0221","227","95","132","1","228","686","0","33.24","13.85"
"10","009","00","180","0000","0000","5472","2278","3194","78","5550","20121","22100","27.58","11.32"
"10","009","00","180","0001","0000","584","265","319","5","589","1728","0","34.09","15.34"
"10","009","00","180","0001","0171","327","143","184","3","330","1061","0","31.10","13.48"
"10","009","00","180","0001","0172","257","122","135","2","259","667","0","38.83","18.29"
"10","009","00","180","0002","0000","185","67","118","1","186","626","0","29.71","10.70"
"10","009","00","180","0002","0176","185","67","118","1","186","626","0","29.71","10.70"
"10","009","00","180","0003","0000","259","105","154","0","259","902","0","28.71","11.64"
"10","009","00","180","0003","0177","259","105","154","0","259","902","0","28.71","11.64"
"10","009","00","180","0004","0000","258","89","169","5","263","883","0","29.78","10.08"
"10","009","00","180","0004","0178","258","89","169","5","263","883","0","29.78","10.08"
"10","009","00","180","0005","0000","750","389","361","14","764","2201","0","34.71","17.67"
"10","009","00","180","0005","0173","303","176","127","5","308","846","0","36.41","20.80"
"10","009","00","180","0005","0174","132","31","101","3","135","459","0","29.41","6.75"
"10","009","00","180","0005","0175","315","182","133","6","321","896","0","35.83","20.31"
"10","009","00","180","0006","0000","294","138","156","0","294","1152","0","25.52","11.98"
"10","009","00","180","0006","0181","294","138","156","0","294","1152","0","25.52","11.98"
"10","009","00","180","0007","0000","188","75","113","3","191","712","0","26.83","10.53"
"10","009","00","180","0007","0180","188","75","113","3","191","712","0","26.83","10.53"
"10","009","00","180","0008","0000","210","91","119","3","213","828","0","25.72","10.99"
"10","009","00","180","0008","0179","210","91","119","3","213","828","0","25.72","10.99"
"10","009","00","180","0009","0000","227","103","124","0","227","846","0","26.83","12.17"
"10","009","00","180","0009","0185","227","103","124","0","227","846","0","26.83","12.17"
"10","009","00","180","0010","0000","85","32","53","1","86","352","0","24.43","9.09"
"10","009","00","180","0010","0186","85","32","53","1","86","352","0","24.43","9.09"
"10","009","00","180","0011","0000","186","56","130","6","192","743","0","25.84","7.54"
"10","009","00","180","0011","0183","186","56","130","6","192","743","0","25.84","7.54"
"10","009","00","180","0012","0000","221","99","122","6","227","898","0","25.28","11.02"
"10","009","00","180","0012","0182","221","99","122","6","227","898","0","25.28","11.02"
"10","009","00","180","0013","0000","381","159","222","3","384","1669","0","23.01","9.53"
"10","009","00","180","0013","0187","181","72","109","2","183","872","0","20.99","8.26"
"10","009","00","180","0013","0188","200","87","113","1","201","797","0","25.22","10.92"
"10","009","00","180","0014","0000","177","82","95","3","180","782","0","23.02","10.49"
"10","009","00","180","0014","0189","177","82","95","3","180","782","0","23.02","10.49"
"10","009","00","180","0015","0000","136","65","71","2","138","683","0","20.20","9.52"
"10","009","00","180","0015","0190","136","65","71","2","138","683","0","20.20","9.52"
"10","009","00","180","0016","0000","242","72","170","2","244","878","0","27.79","8.20"
"10","009","00","180","0016","0191","242","72","170","2","244","878","0","27.79","8.20"
"10","009","00","180","0017","0000","280","102","178","4","284","1016","0","27.95","10.04"
"10","009","00","180","0017","0193","280","102","178","4","284","1016","0","27.95","10.04"
"10","009","00","180","0018","0000","214","97","117","11","225","958","0","23.49","10.13"
"10","009","00","180","0018","0194","214","97","117","11","225","958","0","23.49","10.13"
"10","009","00","180","0019","0000","165","86","79","4","169","724","0","23.34","11.88"
"10","009","00","180","0019","0195","165","86","79","4","169","724","0","23.34","11.88"
"10","009","00","180","0020","0000","158","50","108","2","160","533","0","30.02","9.38"
"10","009","00","180","0020","0184","158","50","108","2","160","533","0","30.02","9.38"
"10","009","00","180","0021","0000","272","56","216","3","275","1007","0","27.31","5.56"
"10","009","00","180","0021","0192","272","56","216","3","275","1007","0","27.31","5.56"
"10","009","00","190","0000","0000","7415","2236","5179","138","7553","23413","26186","32.26","9.55"
"10","009","00","190","0001","0000","379","160","219","4","383","1198","0","31.97","13.36"
"10","009","00","190","0001","0223","379","160","219","4","383","1198","0","31.97","13.36"
"10","009","00","190","0002","0000","350","149","201","5","355","1068","0","33.24","13.95"
"10","009","00","190","0002","0222","350","149","201","5","355","1068","0","33.24","13.95"
"10","009","00","190","0003","0000","167","72","95","0","167","614","0","27.20","11.73"
"10","009","00","190","0003","0224","167","72","95","0","167","614","0","27.20","11.73"
"10","009","00","190","0004","0000","261","75","186","4","265","851","0","31.14","8.81"
"10","009","00","190","0004","0226","261","75","186","4","265","851","0","31.14","8.81"
"10","009","00","190","0005","0000","252","76","176","6","258","694","0","37.18","10.95"
"10","009","00","190","0005","0225","252","76","176","6","258","694","0","37.18","10.95"
"10","009","00","190","0006","0000","346","83","263","7","353","973","0","36.28","8.53"
"10","009","00","190","0006","0227","346","83","263","7","353","973","0","36.28","8.53"
"10","009","00","190","0007","0000","401","98","303","14","415","1405","0","29.54","6.98"
"10","009","00","190","0007","0228","401","98","303","14","415","1405","0","29.54","6.98"
"10","009","00","190","0008","0000","544","174","370","10","554","2020","0","27.43","8.61"
"10","009","00","190","0008","0229","212","61","151","1","213","843","0","25.27","7.24"
"10","009","00","190","0008","0230","332","113","219","9","341","1177","0","28.97","9.60"
"10","009","00","190","0009","0000","402","126","276","9","411","1473","0","27.90","8.55"
"10","009","00","190","0009","0231","206","62","144","3","209","729","0","28.67","8.50"
"10","009","00","190","0009","0232","196","64","132","6","202","744","0","27.15","8.60"
"10","009","00","190","0010","0000","397","144","253","7","404","1410","0","28.65","10.21"
"10","009","00","190","0010","0233","397","144","253","7","404","1410","0","28.65","10.21"
"10","009","00","190","0011","0000","142","34","108","2","144","511","0","28.18","6.65"
"10","009","00","190","0011","0234","142","34","108","2","144","511","0","28.18","6.65"
"10","009","00","190","0012","0000","427","149","278","7","434","1493","0","29.07","9.98"
"10","009","00","190","0012","0235","427","149","278","7","434","1493","0","29.07","9.98"
"10","009","00","190","0013","0000","253","87","166","7","260","806","0","32.26","10.79"
"10","009","00","190","0013","0236","253","87","166","7","260","806","0","32.26","10.79"
"10","009","00","190","0014","0000","635","85","550","11","646","1888","0","34.22","4.50"
"10","009","00","190","0014","0237","127","24","103","4","131","361","0","36.29","6.65"
"10","009","00","190","0014","0238","234","31","203","3","237","754","0","31.43","4.11"
"10","009","00","190","0014","0239","274","30","244","4","278","773","0","35.96","3.88"
"10","009","00","190","0015","0000","283","102","181","4","287","896","0","32.03","11.38"
"10","009","00","190","0015","0240","283","102","181","4","287","896","0","32.03","11.38"
"10","009","00","190","0016","0000","298","71","227","4","302","980","0","30.82","7.24"
"10","009","00","190","0016","0246","298","71","227","4","302","980","0","30.82","7.24"
"10","009","00","190","0017","0000","325","124","201","12","337","925","0","36.43","13.41"
"10","009","00","190","0017","0244","325","124","201","12","337","925","0","36.43","13.41"
"10","009","00","190","0018","0000","231","74","157","1","232","686","0","33.82","10.79"
"10","009","00","190","0018","0245","231","74","157","1","232","686","0","33.82","10.79"
"10","009","00","190","0019","0000","660","190","470","8","668","1773","0","37.68","10.72"
"10","009","00","190","0019","0241","363","81","282","5","368","920","0","40.00","8.80"
"10","009","00","190","0019","0242","297","109","188","3","300","853","0","35.17","12.78"
"10","009","00","190","0020","0000","482","99","383","7","489","1154","0","42.37","8.58"
"10","009","00","190","0020","0243","482","99","383","7","489","1154","0","42.37","8.58"
"10","009","00","190","0021","0000","180","64","116","9","189","595","0","31.76","10.76"
"10","009","00","190","0021","0247","180","64","116","9","189","595","0","31.76","10.76"
"10","009","00","200","0000","0000","7093","2055","5038","120","7213","21442","23934","33.64","9.58"
"10","009","00","200","0001","0000","649","219","430","9","658","2131","0","30.88","10.28"
"10","009","00","200","0001","0248","368","122","246","4","372","1274","0","29.20","9.58"
"10","009","00","200","0001","0249","281","97","184","5","286","857","0","33.37","11.32"
"10","009","00","200","0002","0000","720","237","483","10","730","1971","0","37.04","12.02"
"10","009","00","200","0002","0250","448","146","302","3","451","1238","0","36.43","11.79"
"10","009","00","200","0002","0251","272","91","181","7","279","733","0","38.06","12.41"
"10","009","00","200","0003","0000","354","84","270","7","361","969","0","37.25","8.67"
"10","009","00","200","0003","0271","354","84","270","7","361","969","0","37.25","8.67"
"10","009","00","200","0004","0000","403","87","316","10","413","1149","0","35.94","7.57"
"10","009","00","200","0004","0272","403","87","316","10","413","1149","0","35.94","7.57"
"10","009","00","200","0005","0000","318","93","225","3","321","944","0","34.00","9.85"
"10","009","00","200","0005","0258","318","93","225","3","321","944","0","34.00","9.85"
"10","009","00","200","0006","0000","196","84","112","3","199","598","0","33.28","14.05"
"10","009","00","200","0006","0259","196","84","112","3","199","598","0","33.28","14.05"
"10","009","00","200","0007","0000","182","63","119","4","186","597","0","31.16","10.55"
"10","009","00","200","0007","0260","182","63","119","4","186","597","0","31.16","10.55"
"10","009","00","200","0008","0000","300","75","225","3","303","943","0","32.13","7.95"
"10","009","00","200","0008","0261","300","75","225","3","303","943","0","32.13","7.95"
"10","009","00","200","0009","0000","175","78","97","7","182","603","0","30.18","12.94"
"10","009","00","200","0009","0262","175","78","97","7","182","603","0","30.18","12.94"
"10","009","00","200","0010","0000","287","109","178","4","291","905","0","32.15","12.04"
"10","009","00","200","0010","0263","287","109","178","4","291","905","0","32.15","12.04"
"10","009","00","200","0011","0000","212","52","160","2","214","680","0","31.47","7.65"
"10","009","00","200","0011","0252","212","52","160","2","214","680","0","31.47","7.65"
"10","009","00","200","0012","0000","202","49","153","2","204","627","0","32.54","7.81"
"10","009","00","200","0012","0253","202","49","153","2","204","627","0","32.54","7.81"
"10","009","00","200","0013","0000","362","94","268","5","367","1006","0","36.48","9.34"
"10","009","00","200","0013","0256","362","94","268","5","367","1006","0","36.48","9.34"
"10","009","00","200","0014","0000","342","93","249","5","347","967","0","35.88","9.62"
"10","009","00","200","0014","0254","342","93","249","5","347","967","0","35.88","9.62"
"10","009","00","200","0015","0000","265","69","196","6","271","803","0","33.75","8.59"
"10","009","00","200","0015","0255","265","69","196","6","271","803","0","33.75","8.59"
"10","009","00","200","0016","0000","321","89","232","4","325","927","0","35.06","9.60"
"10","009","00","200","0016","0264","321","89","232","4","325","927","0","35.06","9.60"
"10","009","00","200","0017","0000","246","59","187","5","251","776","0","32.35","7.60"
"10","009","00","200","0017","0265","246","59","187","5","251","776","0","32.35","7.60"
"10","009","00","200","0018","0000","290","113","177","1","291","989","0","29.42","11.43"
"10","009","00","200","0018","0266","290","113","177","1","291","989","0","29.42","11.43"
"10","009","00","200","0019","0000","185","40","145","4","189","484","0","39.05","8.26"
"10","009","00","200","0019","0267","185","40","145","4","189","484","0","39.05","8.26"
"10","009","00","200","0020","0000","196","38","158","4","200","647","0","30.91","5.87"
"10","009","00","200","0020","0268","196","38","158","4","200","647","0","30.91","5.87"
"10","009","00","200","0021","0000","225","38","187","4","229","655","0","34.96","5.80"
"10","009","00","200","0021","0269","225","38","187","4","229","655","0","34.96","5.80"
"10","009","00","200","0022","0000","190","37","153","3","193","653","0","29.56","5.67"
"10","009","00","200","0022","0270","190","37","153","3","193","653","0","29.56","5.67"
"10","009","00","200","0023","0000","226","71","155","5","231","653","0","35.38","10.87"
"10","009","00","200","0023","0257","226","71","155","5","231","653","0","35.38","10.87"
"10","009","00","200","0024","0000","247","84","163","10","257","765","0","33.59","10.98"
"10","009","00","200","0024","0273","247","84","163","10","257","765","0","33.59","10.98"
"10","010","00","000","0000","0000","163940","60905","103035","2002","165942","436894","496440","37.98","13.94"
"10","010","00","010","0000","0000","12475","4706","7769","115","12590","32207","38651","39.09","14.61"
"10","010","00","010","0001","0000","872","393","479","9","881","2315","0","38.06","16.98"
"10","010","00","010","0001","0094","469","235","234","7","476","1259","0","37.81","18.67"
"10","010","00","010","0001","0095","403","158","245","2","405","1056","0","38.35","14.96"
"10","010","00","010","0002","0000","189","41","148","1","190","466","0","40.77","8.80"
"10","010","00","010","0002","0096","189","41","148","1","190","466","0","40.77","8.80"
"10","010","00","010","0003","0000","618","195","423","4","622","1453","0","42.81","13.42"
"10","010","00","010","0003","0097","320","101","219","1","321","719","0","44.65","14.05"
"10","010","00","010","0003","0098","298","94","204","3","301","734","0","41.01","12.81"
"10","010","00","010","0004","0000","729","271","458","7","736","1685","0","43.68","16.08"
"10","010","00","010","0004","0099","358","124","234","4","362","754","0","48.01","16.45"
"10","010","00","010","0004","0100","371","147","224","3","374","931","0","40.17","15.79"
"10","010","00","010","0005","0000","470","174","296","11","481","1133","0","42.45","15.36"
"10","010","00","010","0005","0101","318","120","198","7","325","748","0","43.45","16.04"
"10","010","00","010","0005","0102","152","54","98","4","156","385","0","40.52","14.03"
"10","010","00","010","0006","0000","381","119","262","4","385","1105","0","34.84","10.77"
"10","010","00","010","0006","0103","381","119","262","4","385","1105","0","34.84","10.77"
"10","010","00","010","0007","0000","330","127","203","3","333","817","0","40.76","15.54"
"10","010","00","010","0007","0104","330","127","203","3","333","817","0","40.76","15.54"
"10","010","00","010","0008","0000","766","323","443","7","773","1799","0","42.97","17.95"
"10","010","00","010","0008","0109","371","138","233","3","374","916","0","40.83","15.07"
"10","010","00","010","0008","0110","395","185","210","4","399","883","0","45.19","20.95"
"10","010","00","010","0009","0000","488","143","345","9","497","1244","0","39.95","11.50"
"10","010","00","010","0009","0111","238","72","166","5","243","631","0","38.51","11.41"
"10","010","00","010","0009","0112","250","71","179","4","254","613","0","41.44","11.58"
"10","010","00","010","0010","0000","909","483","426","7","916","2556","0","35.84","18.90"
"10","010","00","010","0010","0113","296","101","195","1","297","818","0","36.31","12.35"
"10","010","00","010","0010","0114","613","382","231","6","619","1738","0","35.62","21.98"
"10","010","00","010","0011","0000","292","100","192","2","294","724","0","40.61","13.81"
"10","010","00","010","0011","0115","191","60","131","1","192","483","0","39.75","12.42"
"10","010","00","010","0011","0116","101","40","61","1","102","241","0","42.32","16.60"
"10","010","00","010","0012","0000","219","80","139","2","221","547","0","40.40","14.63"
"10","010","00","010","0012","0117","122","30","92","2","124","300","0","41.33","10.00"
"10","010","00","010","0012","0118","97","50","47","0","97","247","0","39.27","20.24"
"10","010","00","010","0013","0000","1396","478","918","9","1405","3489","0","40.27","13.70"
"10","010","00","010","0013","0119","457","117","340","2","459","1084","0","42.34","10.79"
"10","010","00","010","0013","0120","331","125","206","1","332","824","0","40.29","15.17"
"10","010","00","010","0013","0121","356","133","223","3","359","968","0","37.09","13.74"
"10","010","00","010","0013","0122","252","103","149","3","255","613","0","41.60","16.80"
"10","010","00","010","0014","0000","1677","597","1080","16","1693","4625","0","36.61","12.91"
"10","010","00","010","0014","0123","310","108","202","0","310","945","0","32.80","11.43"
"10","010","00","010","0014","0124","385","123","262","3","388","893","0","43.45","13.77"
"10","010","00","010","0014","0125","352","130","222","3","355","936","0","37.93","13.89"
"10","010","00","010","0014","0126","325","134","191","6","331","971","0","34.09","13.80"
"10","010","00","010","0014","0127","305","102","203","4","309","880","0","35.11","11.59"
"10","010","00","010","0015","0000","712","210","502","4","716","1819","0","39.36","11.54"
"10","010","00","010","0015","0128","315","91","224","3","318","811","0","39.21","11.22"
"10","010","00","010","0015","0129","397","119","278","1","398","1008","0","39.48","11.81"
"10","010","00","010","0016","0000","1114","386","728","13","1127","3112","0","36.21","12.40"
"10","010","00","010","0016","0130","445","120","325","4","449","1189","0","37.76","10.09"
"10","010","00","010","0016","0131","378","160","218","4","382","1142","0","33.45","14.01"
"10","010","00","010","0016","0132","291","106","185","5","296","781","0","37.90","13.57"
"10","010","00","010","0017","0000","272","105","167","2","274","679","0","40.35","15.46"
"10","010","00","010","0017","0133","272","105","167","2","274","679","0","40.35","15.46"
"10","010","00","010","0018","0000","1041","481","560","5","1046","2639","0","39.64","18.23"
"10","010","00","010","0018","0105","65","20","45","1","66","212","0","31.13","9.43"
"10","010","00","010","0018","0106","287","91","196","1","288","706","0","40.79","12.89"
"10","010","00","010","0018","0107","351","200","151","1","352","893","0","39.42","22.40"
"10","010","00","010","0018","0108","338","170","168","2","340","828","0","41.06","20.53"
"10","010","00","020","0000","0000","13472","4941","8531","155","13627","34834","41439","39.12","14.18"
"10","010","00","020","0001","0000","716","338","378","11","727","1887","0","38.53","17.91"
"10","010","00","020","0001","0058","437","218","219","5","442","1140","0","38.77","19.12"
"10","010","00","020","0001","0059","279","120","159","6","285","747","0","38.15","16.06"
"10","010","00","020","0002","0000","946","420","526","6","952","2322","0","41.00","18.09"
"10","010","00","020","0002","0060","477","223","254","1","478","1219","0","39.21","18.29"
"10","010","00","020","0002","0061","469","197","272","5","474","1103","0","42.97","17.86"
"10","010","00","020","0003","0000","482","176","306","2","484","1092","0","44.32","16.12"
"10","010","00","020","0003","0062","482","176","306","2","484","1092","0","44.32","16.12"
"10","010","00","020","0004","0000","177","59","118","2","179","377","0","47.48","15.65"
"10","010","00","020","0004","0063","177","59","118","2","179","377","0","47.48","15.65"
"10","010","00","020","0005","0000","259","102","157","4","263","610","0","43.11","16.72"
"10","010","00","020","0005","0064","259","102","157","4","263","610","0","43.11","16.72"
"10","010","00","020","0006","0000","293","120","173","5","298","618","0","48.22","19.42"
"10","010","00","020","0006","0065","293","120","173","5","298","618","0","48.22","19.42"
"10","010","00","020","0007","0000","326","121","205","2","328","819","0","40.05","14.77"
"10","010","00","020","0007","0066","326","121","205","2","328","819","0","40.05","14.77"
"10","010","00","020","0008","0000","704","290","414","5","709","1676","0","42.30","17.30"
"10","010","00","020","0008","0067","310","113","197","3","313","748","0","41.84","15.11"
"10","010","00","020","0008","0068","394","177","217","2","396","928","0","42.67","19.07"
"10","010","00","020","0009","0000","934","304","630","9","943","2498","0","37.75","12.17"
"10","010","00","020","0009","0069","443","178","265","3","446","1110","0","40.18","16.04"
"10","010","00","020","0009","0070","491","126","365","6","497","1388","0","35.81","9.08"
"10","010","00","020","0010","0000","1736","756","980","11","1747","4243","0","41.17","17.82"
"10","010","00","020","0010","0071","582","288","294","4","586","1536","0","38.15","18.75"
"10","010","00","020","0010","0072","498","200","298","3","501","1222","0","41.00","16.37"
"10","010","00","020","0010","0073","656","268","388","4","660","1485","0","44.44","18.05"
"10","010","00","020","0011","0000","240","78","162","1","241","669","0","36.02","11.66"
"10","010","00","020","0011","0074","240","78","162","1","241","669","0","36.02","11.66"
"10","010","00","020","0012","0000","189","61","128","3","192","608","0","31.58","10.03"
"10","010","00","020","0012","0075","189","61","128","3","192","608","0","31.58","10.03"
"10","010","00","020","0013","0000","271","89","182","4","275","768","0","35.81","11.59"
"10","010","00","020","0013","0076","271","89","182","4","275","768","0","35.81","11.59"
"10","010","00","020","0014","0000","410","91","319","4","414","1015","0","40.79","8.97"
"10","010","00","020","0014","0077","410","91","319","4","414","1015","0","40.79","8.97"
"10","010","00","020","0015","0000","670","265","405","6","676","1769","0","38.21","14.98"
"10","010","00","020","0015","0078","670","265","405","6","676","1769","0","38.21","14.98"
"10","010","00","020","0016","0000","1107","394","713","16","1123","3190","0","35.20","12.35"
"10","010","00","020","0016","0079","473","180","293","10","483","1385","0","34.87","13.00"
"10","010","00","020","0016","0080","323","135","188","0","323","888","0","36.37","15.20"
"10","010","00","020","0016","0081","311","79","232","6","317","917","0","34.57","8.62"
"10","010","00","020","0017","0000","1083","435","648","12","1095","2926","0","37.42","14.87"
"10","010","00","020","0017","0082","546","175","371","10","556","1583","0","35.12","11.05"
"10","010","00","020","0017","0083","537","260","277","2","539","1343","0","40.13","19.36"
"10","010","00","020","0018","0000","248","84","164","4","252","742","0","33.96","11.32"
"10","010","00","020","0018","0084","248","84","164","4","252","742","0","33.96","11.32"
"10","010","00","020","0019","0000","410","150","260","6","416","1040","0","40.00","14.42"
"10","010","00","020","0019","0085","410","150","260","6","416","1040","0","40.00","14.42"
"10","010","00","020","0020","0000","325","104","221","9","334","870","0","38.39","11.95"
"10","010","00","020","0020","0086","325","104","221","9","334","870","0","38.39","11.95"
"10","010","00","020","0021","0000","110","31","79","5","115","246","0","46.75","12.60"
"10","010","00","020","0021","0088","110","31","79","5","115","246","0","46.75","12.60"
"10","010","00","020","0022","0000","271","79","192","4","275","709","0","38.79","11.14"
"10","010","00","020","0022","0087","271","79","192","4","275","709","0","38.79","11.14"
"10","010","00","020","0023","0000","261","72","189","5","266","767","0","34.68","9.39"
"10","010","00","020","0023","0089","261","72","189","5","266","767","0","34.68","9.39"
"10","010","00","020","0024","0000","268","114","154","5","273","678","0","40.27","16.81"
"10","010","00","020","0024","0090","268","114","154","5","273","678","0","40.27","16.81"
"10","010","00","020","0025","0000","416","84","332","6","422","1019","0","41.41","8.24"
"10","010","00","020","0025","0091","416","84","332","6","422","1019","0","41.41","8.24"
"10","010","00","020","0026","0000","423","93","330","6","429","1190","0","36.05","7.82"
"10","010","00","020","0026","0092","423","93","330","6","429","1190","0","36.05","7.82"
"10","010","00","020","0027","0000","197","31","166","2","199","486","0","40.95","6.38"
"10","010","00","020","0027","0093","197","31","166","2","199","486","0","40.95","6.38"
"10","010","00","030","0000","0000","8338","3150","5188","122","8460","23144","25692","36.55","13.61"
"10","010","00","030","0001","0000","230","114","116","3","233","593","0","39.29","19.22"
"10","010","00","030","0001","0134","230","114","116","3","233","593","0","39.29","19.22"
"10","010","00","030","0002","0000","144","66","78","3","147","356","0","41.29","18.54"
"10","010","00","030","0002","0135","144","66","78","3","147","356","0","41.29","18.54"
"10","010","00","030","0003","0000","792","353","439","10","802","2143","0","37.42","16.47"
"10","010","00","030","0003","0136","342","159","183","9","351","918","0","38.24","17.32"
"10","010","00","030","0003","0137","450","194","256","1","451","1225","0","36.82","15.84"
"10","010","00","030","0004","0000","384","161","223","5","389","1064","0","36.56","15.13"
"10","010","00","030","0004","0138","384","161","223","5","389","1064","0","36.56","15.13"
"10","010","00","030","0005","0000","681","303","378","9","690","1593","0","43.31","19.02"
"10","010","00","030","0005","0139","392","175","217","6","398","939","0","42.39","18.64"
"10","010","00","030","0005","0140","289","128","161","3","292","654","0","44.65","19.57"
"10","010","00","030","0006","0000","302","107","195","0","302","860","0","35.12","12.44"
"10","010","00","030","0006","0141","302","107","195","0","302","860","0","35.12","12.44"
"10","010","00","030","0007","0000","197","92","105","8","205","683","0","30.01","13.47"
"10","010","00","030","0007","0142","197","92","105","8","205","683","0","30.01","13.47"
"10","010","00","030","0008","0000","229","101","128","3","232","742","0","31.27","13.61"
"10","010","00","030","0008","0143","229","101","128","3","232","742","0","31.27","13.61"
"10","010","00","030","0009","0000","389","116","273","12","401","920","0","43.59","12.61"
"10","010","00","030","0009","0158","389","116","273","12","401","920","0","43.59","12.61"
"10","010","00","030","0010","0000","382","138","244","3","385","1287","0","29.91","10.72"
"10","010","00","030","0010","0159","382","138","244","3","385","1287","0","29.91","10.72"
"10","010","00","030","0011","0000","759","266","493","6","765","2276","0","33.61","11.69"
"10","010","00","030","0011","0160","358","122","236","1","359","1070","0","33.55","11.40"
"10","010","00","030","0011","0161","401","144","257","5","406","1206","0","33.67","11.94"
"10","010","00","030","0012","0000","332","106","226","8","340","1106","0","30.74","9.58"
"10","010","00","030","0012","0162","332","106","226","8","340","1106","0","30.74","9.58"
"10","010","00","030","0013","0000","361","165","196","8","369","1090","0","33.85","15.14"
"10","010","00","030","0013","0151","361","165","196","8","369","1090","0","33.85","15.14"
"10","010","00","030","0014","0000","685","228","457","11","696","1861","0","37.40","12.25"
"10","010","00","030","0014","0152","342","95","247","5","347","924","0","37.55","10.28"
"10","010","00","030","0014","0153","343","133","210","6","349","937","0","37.25","14.19"
"10","010","00","030","0015","0000","105","49","56","1","106","281","0","37.72","17.44"
"10","010","00","030","0015","0154","105","49","56","1","106","281","0","37.72","17.44"
"10","010","00","030","0016","0000","138","56","82","5","143","385","0","37.14","14.55"
"10","010","00","030","0016","0155","138","56","82","5","143","385","0","37.14","14.55"
"10","010","00","030","0017","0000","126","41","85","1","127","288","0","44.10","14.24"
"10","010","00","030","0017","0156","56","21","35","1","57","117","0","48.72","17.95"
"10","010","00","030","0017","0157","70","20","50","0","70","171","0","40.94","11.70"
"10","010","00","030","0018","0000","240","127","113","2","242","713","0","33.94","17.81"
"10","010","00","030","0018","0144","240","127","113","2","242","713","0","33.94","17.81"
"10","010","00","030","0019","0000","420","154","266","6","426","1117","0","38.14","13.79"
"10","010","00","030","0019","0145","420","154","266","6","426","1117","0","38.14","13.79"
"10","010","00","030","0020","0000","539","153","386","7","546","1286","0","42.46","11.90"
"10","010","00","030","0020","0147","539","153","386","7","546","1286","0","42.46","11.90"
"10","010","00","030","0021","0000","472","132","340","4","476","1350","0","35.26","9.78"
"10","010","00","030","0021","0146","472","132","340","4","476","1350","0","35.26","9.78"
"10","010","00","030","0022","0000","194","65","129","5","199","518","0","38.42","12.55"
"10","010","00","030","0022","0148","116","39","77","2","118","270","0","43.70","14.44"
"10","010","00","030","0022","0149","78","26","52","3","81","248","0","32.66","10.48"
"10","010","00","030","0023","0000","237","57","180","2","239","632","0","37.82","9.02"
"10","010","00","030","0023","0150","237","57","180","2","239","632","0","37.82","9.02"
"10","010","00","040","0000","0000","10586","4249","6337","120","10706","26546","30237","40.33","16.01"
"10","010","00","040","0001","0000","216","79","137","1","217","467","0","46.47","16.92"
"10","010","00","040","0001","0274","216","79","137","1","217","467","0","46.47","16.92"
"10","010","00","040","0002","0000","814","326","488","4","818","1816","0","45.04","17.95"
"10","010","00","040","0002","0275","377","150","227","1","378","892","0","42.38","16.82"
"10","010","00","040","0002","0276","437","176","261","3","440","924","0","47.62","19.05"
"10","010","00","040","0003","0000","384","173","211","3","387","885","0","43.73","19.55"
"10","010","00","040","0003","0277","384","173","211","3","387","885","0","43.73","19.55"
"10","010","00","040","0004","0000","2376","1045","1331","19","2395","5889","0","40.67","17.74"
"10","010","00","040","0004","0278","593","231","362","2","595","1407","0","42.29","16.42"
"10","010","00","040","0004","0279","547","250","297","4","551","1394","0","39.53","17.93"
"10","010","00","040","0004","0280","608","239","369","6","614","1520","0","40.39","15.72"
"10","010","00","040","0004","0281","628","325","303","7","635","1568","0","40.50","20.73"
"10","010","00","040","0005","0000","477","167","310","9","486","1127","0","43.12","14.82"
"10","010","00","040","0005","0282","477","167","310","9","486","1127","0","43.12","14.82"
"10","010","00","040","0006","0000","655","306","349","10","665","1783","0","37.30","17.16"
"10","010","00","040","0006","0283","655","306","349","10","665","1783","0","37.30","17.16"
"10","010","00","040","0007","0000","268","65","203","1","269","595","0","45.21","10.92"
"10","010","00","040","0007","0284","268","65","203","1","269","595","0","45.21","10.92"
"10","010","00","040","0008","0000","260","58","202","2","262","703","0","37.27","8.25"
"10","010","00","040","0008","0285","260","58","202","2","262","703","0","37.27","8.25"
"10","010","00","040","0009","0000","264","82","182","5","269","612","0","43.95","13.40"
"10","010","00","040","0009","0286","264","82","182","5","269","612","0","43.95","13.40"
"10","010","00","040","0010","0000","74","41","33","1","75","184","0","40.76","22.28"
"10","010","00","040","0010","0287","74","41","33","1","75","184","0","40.76","22.28"
"10","010","00","040","0011","0000","550","242","308","7","557","1563","0","35.64","15.48"
"10","010","00","040","0011","0288","550","242","308","7","557","1563","0","35.64","15.48"
"10","010","00","040","0012","0000","523","193","330","9","532","1405","0","37.86","13.74"
"10","010","00","040","0012","0289","523","193","330","9","532","1405","0","37.86","13.74"
"10","010","00","040","0013","0000","525","195","330","9","534","1327","0","40.24","14.69"
"10","010","00","040","0013","0290","396","155","241","8","404","979","0","41.27","15.83"
"10","010","00","040","0013","0291","129","40","89","1","130","348","0","37.36","11.49"
"10","010","00","040","0014","0000","317","133","184","6","323","793","0","40.73","16.77"
"10","010","00","040","0014","0292","317","133","184","6","323","793","0","40.73","16.77"
"10","010","00","040","0015","0000","643","190","453","9","652","1546","0","42.17","12.29"
"10","010","00","040","0015","0293","643","190","453","9","652","1546","0","42.17","12.29"
"10","010","00","040","0016","0000","733","310","423","7","740","2009","0","36.83","15.43"
"10","010","00","040","0016","0294","368","173","195","3","371","961","0","38.61","18.00"
"10","010","00","040","0016","0295","365","137","228","4","369","1048","0","35.21","13.07"
"10","010","00","040","0017","0000","346","126","220","4","350","905","0","38.67","13.92"
"10","010","00","040","0017","0296","346","126","220","4","350","905","0","38.67","13.92"
"10","010","00","040","0018","0000","254","123","131","4","258","656","0","39.33","18.75"
"10","010","00","040","0018","0297","254","123","131","4","258","656","0","39.33","18.75"
"10","010","00","040","0019","0000","271","117","154","6","277","644","0","43.01","18.17"
"10","010","00","040","0019","0298","271","117","154","6","277","644","0","43.01","18.17"
"10","010","00","040","0020","0000","295","132","163","1","296","817","0","36.23","16.16"
"10","010","00","040","0020","0299","295","132","163","1","296","817","0","36.23","16.16"
"10","010","00","040","0021","0000","341","146","195","3","344","820","0","41.95","17.80"
"10","010","00","040","0021","0300","341","146","195","3","344","820","0","41.95","17.80"
"10","010","00","050","0000","0000","24054","9243","14811","250","24304","61483","71044","39.53","15.03"
"10","010","00","050","0001","0000","939","416","523","5","944","2300","0","41.04","18.09"
"10","010","00","050","0001","0358","557","253","304","5","562","1280","0","43.91","19.77"
"10","010","00","050","0001","0359","382","163","219","0","382","1020","0","37.45","15.98"
"10","010","00","050","0002","0000","676","313","363","7","683","1528","0","44.70","20.48"
"10","010","00","050","0002","0360","676","313","363","7","683","1528","0","44.70","20.48"
"10","010","00","050","0003","0000","1395","537","858","13","1408","3338","0","42.18","16.09"
"10","010","00","050","0003","0361","738","278","460","6","744","1664","0","44.71","16.71"
"10","010","00","050","0003","0362","657","259","398","7","664","1674","0","39.67","15.47"
"10","010","00","050","0004","0000","872","321","551","11","883","2158","0","40.92","14.87"
"10","010","00","050","0004","0363","472","142","330","7","479","1080","0","44.35","13.15"
"10","010","00","050","0004","0364","400","179","221","4","404","1078","0","37.48","16.60"
"10","010","00","050","0005","0000","677","217","460","8","685","1567","0","43.71","13.85"
"10","010","00","050","0005","0365","677","217","460","8","685","1567","0","43.71","13.85"
"10","010","00","050","0006","0000","643","256","387","6","649","1827","0","35.52","14.01"
"10","010","00","050","0006","0366","237","92","145","4","241","701","0","34.38","13.12"
"10","010","00","050","0006","0367","406","164","242","2","408","1126","0","36.23","14.56"
"10","010","00","050","0007","0000","567","223","344","6","573","1469","0","39.01","15.18"
"10","010","00","050","0007","0368","567","223","344","6","573","1469","0","39.01","15.18"
"10","010","00","050","0008","0000","690","164","526","9","699","1708","0","40.93","9.60"
"10","010","00","050","0008","0369","390","93","297","5","395","956","0","41.32","9.73"
"10","010","00","050","0008","0370","300","71","229","4","304","752","0","40.43","9.44"
"10","010","00","050","0009","0000","365","153","212","4","369","962","0","38.36","15.90"
"10","010","00","050","0009","0371","365","153","212","4","369","962","0","38.36","15.90"
"10","010","00","050","0010","0000","349","119","230","4","353","817","0","43.21","14.57"
"10","010","00","050","0010","0372","349","119","230","4","353","817","0","43.21","14.57"
"10","010","00","050","0011","0000","345","99","246","4","349","821","0","42.51","12.06"
"10","010","00","050","0011","0373","345","99","246","4","349","821","0","42.51","12.06"
"10","010","00","050","0012","0000","835","359","476","9","844","2163","0","39.02","16.60"
"10","010","00","050","0012","0374","662","292","370","5","667","1752","0","38.07","16.67"
"10","010","00","050","0012","0375","173","67","106","4","177","411","0","43.07","16.30"
"10","010","00","050","0013","0000","600","252","348","8","608","1346","0","45.17","18.72"
"10","010","00","050","0013","0376","600","252","348","8","608","1346","0","45.17","18.72"
"10","010","00","050","0014","0000","207","75","132","2","209","523","0","39.96","14.34"
"10","010","00","050","0014","0377","207","75","132","2","209","523","0","39.96","14.34"
"10","010","00","050","0015","0000","454","179","275","16","470","1154","0","40.73","15.51"
"10","010","00","050","0015","0378","454","179","275","16","470","1154","0","40.73","15.51"
"10","010","00","050","0016","0000","671","247","424","2","673","1837","0","36.64","13.45"
"10","010","00","050","0016","0396","318","114","204","1","319","955","0","33.40","11.94"
"10","010","00","050","0016","0397","353","133","220","1","354","882","0","40.14","15.08"
"10","010","00","050","0017","0000","933","372","561","10","943","2740","0","34.42","13.58"
"10","010","00","050","0017","0398","466","183","283","6","472","1292","0","36.53","14.16"
"10","010","00","050","0017","0399","467","189","278","4","471","1448","0","32.53","13.05"
"10","010","00","050","0018","0000","853","305","548","5","858","1995","0","43.01","15.29"
"10","010","00","050","0018","0402","419","149","270","2","421","907","0","46.42","16.43"
"10","010","00","050","0018","0403","434","156","278","3","437","1088","0","40.17","14.34"
"10","010","00","050","0019","0000","992","431","561","13","1005","2450","0","41.02","17.59"
"10","010","00","050","0019","0404","551","214","337","9","560","1361","0","41.15","15.72"
"10","010","00","050","0019","0405","441","217","224","4","445","1089","0","40.86","19.93"
"10","010","00","050","0020","0000","1381","470","911","17","1398","3513","0","39.80","13.38"
"10","010","00","050","0020","0406","469","137","332","9","478","1232","0","38.80","11.12"
"10","010","00","050","0020","0407","474","169","305","3","477","1148","0","41.55","14.72"
"10","010","00","050","0020","0408","438","164","274","5","443","1133","0","39.10","14.47"
"10","010","00","050","0021","0000","514","154","360","6","520","1281","0","40.59","12.02"
"10","010","00","050","0021","0409","514","154","360","6","520","1281","0","40.59","12.02"
"10","010","00","050","0022","0000","1933","770","1163","16","1949","5279","0","36.92","14.59"
"10","010","00","050","0022","0379","614","225","389","4","618","1494","0","41.37","15.06"
"10","010","00","050","0022","0380","591","241","350","5","596","1633","0","36.50","14.76"
"10","010","00","050","0022","0381","267","99","168","4","271","750","0","36.13","13.20"
"10","010","00","050","0022","0382","461","205","256","3","464","1402","0","33.10","14.62"
"10","010","00","050","0023","0000","955","439","516","9","964","2449","0","39.36","17.93"
"10","010","00","050","0023","0383","471","209","262","7","478","1211","0","39.47","17.26"
"10","010","00","050","0023","0384","484","230","254","2","486","1238","0","39.26","18.58"
"10","010","00","050","0024","0000","884","365","519","9","893","2361","0","37.82","15.46"
"10","010","00","050","0024","0390","381","155","226","5","386","1014","0","38.07","15.29"
"10","010","00","050","0024","0391","503","210","293","4","507","1347","0","37.64","15.59"
"10","010","00","050","0025","0000","1029","305","724","16","1045","2602","0","40.16","11.72"
"10","010","00","050","0025","0392","630","175","455","10","640","1639","0","39.05","10.68"
"10","010","00","050","0025","0393","399","130","269","6","405","963","0","42.06","13.50"
"10","010","00","050","0026","0000","590","213","377","6","596","1690","0","35.27","12.60"
"10","010","00","050","0026","0394","387","130","257","5","392","1051","0","37.30","12.37"
"10","010","00","050","0026","0395","203","83","120","1","204","639","0","31.92","12.99"
"10","010","00","050","0027","0000","1134","448","686","11","1145","2956","0","38.73","15.16"
"10","010","00","050","0027","0400","520","179","341","5","525","1372","0","38.27","13.05"
"10","010","00","050","0027","0401","614","269","345","6","620","1584","0","39.14","16.98"
"10","010","00","050","0028","0000","2571","1041","1530","18","2589","6649","0","38.94","15.66"
"10","010","00","050","0028","0385","488","207","281","2","490","1301","0","37.66","15.91"
"10","010","00","050","0028","0386","517","236","281","2","519","1338","0","38.79","17.64"
"10","010","00","050","0028","0387","534","220","314","3","537","1390","0","38.63","15.83"
"10","010","00","050","0028","0388","490","194","296","3","493","1281","0","38.49","15.14"
"10","010","00","050","0028","0389","542","184","358","8","550","1339","0","41.08","13.74"
"10","010","00","060","0000","0000","4785","1403","3382","67","4852","12575","13890","38.58","11.16"
"10","010","00","060","0001","0000","512","189","323","6","518","1277","0","40.56","14.80"
"10","010","00","060","0001","0257","512","189","323","6","518","1277","0","40.56","14.80"
"10","010","00","060","0002","0000","291","103","188","4","295","653","0","45.18","15.77"
"10","010","00","060","0002","0258","291","103","188","4","295","653","0","45.18","15.77"
"10","010","00","060","0003","0000","233","71","162","3","236","636","0","37.11","11.16"
"10","010","00","060","0003","0259","135","34","101","3","138","382","0","36.13","8.90"
"10","010","00","060","0003","0260","98","37","61","0","98","254","0","38.58","14.57"
"10","010","00","060","0004","0000","394","97","297","5","399","952","0","41.91","10.19"
"10","010","00","060","0004","0273","394","97","297","5","399","952","0","41.91","10.19"
"10","010","00","060","0005","0000","260","52","208","3","263","656","0","40.09","7.93"
"10","010","00","060","0005","0272","260","52","208","3","263","656","0","40.09","7.93"
"10","010","00","060","0006","0000","281","73","208","3","284","758","0","37.47","9.63"
"10","010","00","060","0006","0266","281","73","208","3","284","758","0","37.47","9.63"
"10","010","00","060","0007","0000","260","60","200","4","264","803","0","32.88","7.47"
"10","010","00","060","0007","0267","260","60","200","4","264","803","0","32.88","7.47"
"10","010","00","060","0008","0000","362","86","276","11","373","1113","0","33.51","7.73"
"10","010","00","060","0008","0268","362","86","276","11","373","1113","0","33.51","7.73"
"10","010","00","060","0009","0000","330","100","230","5","335","971","0","34.50","10.30"
"10","010","00","060","0009","0269","330","100","230","5","335","971","0","34.50","10.30"
"10","010","00","060","0010","0000","368","123","245","5","373","921","0","40.50","13.36"
"10","010","00","060","0010","0270","216","64","152","3","219","538","0","40.71","11.90"
"10","010","00","060","0010","0271","152","59","93","2","154","383","0","40.21","15.40"
"10","010","00","060","0011","0000","501","158","343","6","507","1264","0","40.11","12.50"
"10","010","00","060","0011","0261","343","130","213","4","347","885","0","39.21","14.69"
"10","010","00","060","0011","0262","158","28","130","2","160","379","0","42.22","7.39"
"10","010","00","060","0012","0000","393","115","278","5","398","1013","0","39.29","11.35"
"10","010","00","060","0012","0263","393","115","278","5","398","1013","0","39.29","11.35"
"10","010","00","060","0013","0000","241","76","165","4","245","680","0","36.03","11.18"
"10","010","00","060","0013","0264","241","76","165","4","245","680","0","36.03","11.18"
"10","010","00","060","0014","0000","359","100","259","3","362","878","0","41.23","11.39"
"10","010","00","060","0014","0265","359","100","259","3","362","878","0","41.23","11.39"
"10","010","00","070","0000","0000","10846","3236","7610","142","10988","27120","30952","40.52","11.93"
"10","010","00","070","0001","0000","983","417","566","9","992","2204","0","45.01","18.92"
"10","010","00","070","0001","0324","479","179","300","3","482","1059","0","45.51","16.90"
"10","010","00","070","0001","0325","504","238","266","6","510","1145","0","44.54","20.79"
"10","010","00","070","0002","0000","653","215","438","7","660","1541","0","42.83","13.95"
"10","010","00","070","0002","0326","312","114","198","1","313","701","0","44.65","16.26"
"10","010","00","070","0002","0327","341","101","240","6","347","840","0","41.31","12.02"
"10","010","00","070","0003","0000","586","204","382","5","591","1424","0","41.50","14.33"
"10","010","00","070","0003","0328","269","100","169","2","271","666","0","40.69","15.02"
"10","010","00","070","0003","0329","317","104","213","3","320","758","0","42.22","13.72"
"10","010","00","070","0004","0000","632","235","397","10","642","1618","0","39.68","14.52"
"10","010","00","070","0004","0330","321","120","201","2","323","783","0","41.25","15.33"
"10","010","00","070","0004","0331","311","115","196","8","319","835","0","38.20","13.77"
"10","010","00","070","0005","0000","528","107","421","9","537","1375","0","39.05","7.78"
"10","010","00","070","0005","0332","256","58","198","8","264","689","0","38.32","8.42"
"10","010","00","070","0005","0333","272","49","223","1","273","686","0","39.80","7.14"
"10","010","00","070","0006","0000","641","162","479","12","653","1582","0","41.28","10.24"
"10","010","00","070","0006","0334","305","81","224","5","310","742","0","41.78","10.92"
"10","010","00","070","0006","0335","336","81","255","7","343","840","0","40.83","9.64"
"10","010","00","070","0007","0000","631","164","467","7","638","1618","0","39.43","10.14"
"10","010","00","070","0007","0336","309","72","237","5","314","782","0","40.15","9.21"
"10","010","00","070","0007","0337","322","92","230","2","324","836","0","38.76","11.00"
"10","010","00","070","0008","0000","378","131","247","6","384","931","0","41.25","14.07"
"10","010","00","070","0008","0338","378","131","247","6","384","931","0","41.25","14.07"
"10","010","00","070","0009","0000","215","49","166","2","217","549","0","39.53","8.93"
"10","010","00","070","0009","0339","215","49","166","2","217","549","0","39.53","8.93"
"10","010","00","070","0010","0000","357","45","312","10","367","886","0","41.42","5.08"
"10","010","00","070","0010","0340","357","45","312","10","367","886","0","41.42","5.08"
"10","010","00","070","0011","0000","168","27","141","4","172","465","0","36.99","5.81"
"10","010","00","070","0011","0341","168","27","141","4","172","465","0","36.99","5.81"
"10","010","00","070","0012","0000","195","59","136","2","197","486","0","40.53","12.14"
"10","010","00","070","0012","0342","195","59","136","2","197","486","0","40.53","12.14"
"10","010","00","070","0013","0000","751","177","574","12","763","1627","0","46.90","10.88"
"10","010","00","070","0013","0343","348","74","274","6","354","785","0","45.10","9.43"
"10","010","00","070","0013","0344","403","103","300","6","409","842","0","48.57","12.23"
"10","010","00","070","0014","0000","588","140","448","5","593","1538","0","38.56","9.10"
"10","010","00","070","0014","0345","286","62","224","2","288","798","0","36.09","7.77"
"10","010","00","070","0014","0346","302","78","224","3","305","740","0","41.22","10.54"
"10","010","00","070","0015","0000","509","132","377","5","514","1308","0","39.30","10.09"
"10","010","00","070","0015","0347","258","66","192","1","259","624","0","41.51","10.58"
"10","010","00","070","0015","0348","251","66","185","4","255","684","0","37.28","9.65"
"10","010","00","070","0016","0000","554","212","342","7","561","1492","0","37.60","14.21"
"10","010","00","070","0016","0351","244","78","166","4","248","599","0","41.40","13.02"
"10","010","00","070","0016","0352","310","134","176","3","313","893","0","35.05","15.01"
"10","010","00","070","0017","0000","405","156","249","6","411","1023","0","40.18","15.25"
"10","010","00","070","0017","0350","405","156","249","6","411","1023","0","40.18","15.25"
"10","010","00","070","0018","0000","372","125","247","5","377","947","0","39.81","13.20"
"10","010","00","070","0018","0349","372","125","247","5","377","947","0","39.81","13.20"
"10","010","00","070","0019","0000","354","83","271","8","362","985","0","36.75","8.43"
"10","010","00","070","0019","0353","354","83","271","8","362","985","0","36.75","8.43"
"10","010","00","070","0020","0000","428","132","296","5","433","1118","0","38.73","11.81"
"10","010","00","070","0020","0354","428","132","296","5","433","1118","0","38.73","11.81"
"10","010","00","070","0021","0000","384","111","273","1","385","1017","0","37.86","10.91"
"10","010","00","070","0021","0355","384","111","273","1","385","1017","0","37.86","10.91"
"10","010","00","070","0022","0000","206","65","141","3","209","548","0","38.14","11.86"
"10","010","00","070","0022","0356","206","65","141","3","209","548","0","38.14","11.86"
"10","010","00","070","0023","0000","328","88","240","2","330","838","0","39.38","10.50"
"10","010","00","070","0023","0357","328","88","240","2","330","838","0","39.38","10.50"
"10","010","00","080","0000","0000","7362","2227","5135","97","7459","20088","21914","37.13","11.09"
"10","010","00","080","0001","0000","439","176","263","1","440","1127","0","39.04","15.62"
"10","010","00","080","0001","0001","439","176","263","1","440","1127","0","39.04","15.62"
"10","010","00","080","0002","0000","273","99","174","3","276","788","0","35.03","12.56"
"10","010","00","080","0002","0002","273","99","174","3","276","788","0","35.03","12.56"
"10","010","00","080","0003","0000","321","97","224","4","325","829","0","39.20","11.70"
"10","010","00","080","0003","0003","321","97","224","4","325","829","0","39.20","11.70"
"10","010","00","080","0004","0000","99","59","40","1","100","211","0","47.39","27.96"
"10","010","00","080","0004","0004","99","59","40","1","100","211","0","47.39","27.96"
"10","010","00","080","0005","0000","426","142","284","4","430","1153","0","37.29","12.32"
"10","010","00","080","0005","0005","426","142","284","4","430","1153","0","37.29","12.32"
"10","010","00","080","0006","0000","366","159","207","7","373","1165","0","32.02","13.65"
"10","010","00","080","0006","0006","366","159","207","7","373","1165","0","32.02","13.65"
"10","010","00","080","0007","0000","327","86","241","8","335","861","0","38.91","9.99"
"10","010","00","080","0007","0007","327","86","241","8","335","861","0","38.91","9.99"
"10","010","00","080","0008","0000","241","64","177","10","251","615","0","40.81","10.41"
"10","010","00","080","0008","0008","241","64","177","10","251","615","0","40.81","10.41"
"10","010","00","080","0009","0000","262","63","199","3","265","725","0","36.55","8.69"
"10","010","00","080","0009","0009","200","51","149","2","202","557","0","36.27","9.16"
"10","010","00","080","0009","0010","62","12","50","1","63","168","0","37.50","7.14"
"10","010","00","080","0010","0000","263","39","224","7","270","677","0","39.88","5.76"
"10","010","00","080","0010","0016","263","39","224","7","270","677","0","39.88","5.76"
"10","010","00","080","0011","0000","396","101","295","3","399","996","0","40.06","10.14"
"10","010","00","080","0011","0017","396","101","295","3","399","996","0","40.06","10.14"
"10","010","00","080","0012","0000","308","99","209","4","312","905","0","34.48","10.94"
"10","010","00","080","0012","0018","308","99","209","4","312","905","0","34.48","10.94"
"10","010","00","080","0013","0000","354","103","251","8","362","1019","0","35.53","10.11"
"10","010","00","080","0013","0019","354","103","251","8","362","1019","0","35.53","10.11"
"10","010","00","080","0014","0000","484","138","346","6","490","1433","0","34.19","9.63"
"10","010","00","080","0014","0020","484","138","346","6","490","1433","0","34.19","9.63"
"10","010","00","080","0015","0000","203","53","150","1","204","594","0","34.34","8.92"
"10","010","00","080","0015","0021","203","53","150","1","204","594","0","34.34","8.92"
"10","010","00","080","0016","0000","146","30","116","4","150","467","0","32.12","6.42"
"10","010","00","080","0016","0022","146","30","116","4","150","467","0","32.12","6.42"
"10","010","00","080","0017","0000","212","61","151","3","215","611","0","35.19","9.98"
"10","010","00","080","0017","0023","212","61","151","3","215","611","0","35.19","9.98"
"10","010","00","080","0018","0000","292","98","194","2","294","838","0","35.08","11.69"
"10","010","00","080","0018","0024","292","98","194","2","294","838","0","35.08","11.69"
"10","010","00","080","0019","0000","595","146","449","7","602","1392","0","43.25","10.49"
"10","010","00","080","0019","0011","103","16","87","1","104","204","0","50.98","7.84"
"10","010","00","080","0019","0012","113","27","86","3","116","235","0","49.36","11.49"
"10","010","00","080","0019","0013","134","36","98","0","134","362","0","37.02","9.94"
"10","010","00","080","0019","0014","245","67","178","3","248","591","0","41.96","11.34"
"10","010","00","080","0020","0000","219","63","156","2","221","578","0","38.24","10.90"
"10","010","00","080","0020","0015","219","63","156","2","221","578","0","38.24","10.90"
"10","010","00","080","0021","0000","269","107","162","2","271","734","0","36.92","14.58"
"10","010","00","080","0021","0025","269","107","162","2","271","734","0","36.92","14.58"
"10","010","00","080","0022","0000","171","59","112","3","174","521","0","33.40","11.32"
"10","010","00","080","0022","0026","171","59","112","3","174","521","0","33.40","11.32"
"10","010","00","080","0023","0000","238","78","160","1","239","627","0","38.12","12.44"
"10","010","00","080","0023","0027","238","78","160","1","239","627","0","38.12","12.44"
"10","010","00","080","0024","0000","264","52","212","2","266","659","0","40.36","7.89"
"10","010","00","080","0024","0028","264","52","212","2","266","659","0","40.36","7.89"
"10","010","00","080","0025","0000","194","55","139","1","195","563","0","34.64","9.77"
"10","010","00","080","0025","0029","155","42","113","1","156","440","0","35.45","9.55"
"10","010","00","080","0025","0030","39","13","26","0","39","123","0","31.71","10.57"
"10","010","00","090","0000","0000","7241","2626","4615","127","7368","21235","23594","34.70","12.37"
"10","010","00","090","0001","0000","669","226","443","13","682","1898","0","35.93","11.91"
"10","010","00","090","0001","0031","669","226","443","13","682","1898","0","35.93","11.91"
"10","010","00","090","0002","0000","300","105","195","6","306","922","0","33.19","11.39"
"10","010","00","090","0002","0032","300","105","195","6","306","922","0","33.19","11.39"
"10","010","00","090","0003","0000","417","155","262","6","423","1320","0","32.05","11.74"
"10","010","00","090","0003","0033","417","155","262","6","423","1320","0","32.05","11.74"
"10","010","00","090","0004","0000","540","225","315","8","548","1622","0","33.79","13.87"
"10","010","00","090","0004","0034","540","225","315","8","548","1622","0","33.79","13.87"
"10","010","00","090","0005","0000","325","118","207","8","333","1120","0","29.73","10.54"
"10","010","00","090","0005","0035","325","118","207","8","333","1120","0","29.73","10.54"
"10","010","00","090","0006","0000","208","89","119","4","212","701","0","30.24","12.70"
"10","010","00","090","0006","0036","208","89","119","4","212","701","0","30.24","12.70"
"10","010","00","090","0007","0000","136","52","84","8","144","388","0","37.11","13.40"
"10","010","00","090","0007","0037","136","52","84","8","144","388","0","37.11","13.40"
"10","010","00","090","0008","0000","297","156","141","6","303","839","0","36.11","18.59"
"10","010","00","090","0008","0038","297","156","141","6","303","839","0","36.11","18.59"
"10","010","00","090","0009","0000","315","103","212","9","324","857","0","37.81","12.02"
"10","010","00","090","0009","0039","315","103","212","9","324","857","0","37.81","12.02"
"10","010","00","090","0010","0000","253","77","176","6","259","714","0","36.27","10.78"
"10","010","00","090","0010","0040","253","77","176","6","259","714","0","36.27","10.78"
"10","010","00","090","0011","0000","142","54","88","2","144","368","0","39.13","14.67"
"10","010","00","090","0011","0041","77","28","49","1","78","169","0","46.15","16.57"
"10","010","00","090","0011","0042","65","26","39","1","66","199","0","33.17","13.07"
"10","010","00","090","0012","0000","262","105","157","2","264","957","0","27.59","10.97"
"10","010","00","090","0012","0043","262","105","157","2","264","957","0","27.59","10.97"
"10","010","00","090","0013","0000","467","164","303","11","478","1185","0","40.34","13.84"
"10","010","00","090","0013","0047","467","164","303","11","478","1185","0","40.34","13.84"
"10","010","00","090","0014","0000","274","93","181","5","279","821","0","33.98","11.33"
"10","010","00","090","0014","0048","274","93","181","5","279","821","0","33.98","11.33"
"10","010","00","090","0015","0000","220","78","142","1","221","650","0","34.00","12.00"
"10","010","00","090","0015","0049","220","78","142","1","221","650","0","34.00","12.00"
"10","010","00","090","0016","0000","246","81","165","6","252","795","0","31.70","10.19"
"10","010","00","090","0016","0050","246","81","165","6","252","795","0","31.70","10.19"
"10","010","00","090","0017","0000","230","86","144","5","235","670","0","35.07","12.84"
"10","010","00","090","0017","0051","123","43","80","4","127","358","0","35.47","12.01"
"10","010","00","090","0017","0052","107","43","64","1","108","312","0","34.62","13.78"
"10","010","00","090","0018","0000","411","142","269","6","417","1074","0","38.83","13.22"
"10","010","00","090","0018","0053","411","142","269","6","417","1074","0","38.83","13.22"
"10","010","00","090","0019","0000","331","70","261","4","335","893","0","37.51","7.84"
"10","010","00","090","0019","0054","331","70","261","4","335","893","0","37.51","7.84"
"10","010","00","090","0020","0000","374","153","221","2","376","1167","0","32.22","13.11"
"10","010","00","090","0020","0055","374","153","221","2","376","1167","0","32.22","13.11"
"10","010","00","090","0021","0000","325","130","195","2","327","757","0","43.20","17.17"
"10","010","00","090","0021","0056","171","55","116","1","172","414","0","41.55","13.29"
"10","010","00","090","0021","0057","154","75","79","1","155","343","0","45.19","21.87"
"10","010","00","090","0022","0000","85","32","53","1","86","284","0","30.28","11.27"
"10","010","00","090","0022","0044","85","32","53","1","86","284","0","30.28","11.27"
"10","010","00","090","0023","0000","414","132","282","6","420","1233","0","34.06","10.71"
"10","010","00","090","0023","0045","317","97","220","5","322","1008","0","31.94","9.62"
"10","010","00","090","0023","0046","97","35","62","1","98","225","0","43.56","15.56"
"10","010","00","100","0000","0000","6192","2203","3989","116","6308","15973","17439","39.49","13.79"
"10","010","00","100","0001","0000","260","87","173","6","266","663","0","40.12","13.12"
"10","010","00","100","0001","0163","166","57","109","5","171","444","0","38.51","12.84"
"10","010","00","100","0001","0164","94","30","64","1","95","219","0","43.38","13.70"
"10","010","00","100","0002","0000","605","194","411","9","614","1416","0","43.36","13.70"
"10","010","00","100","0002","0165","365","114","251","3","368","782","0","47.06","14.58"
"10","010","00","100","0002","0166","240","80","160","6","246","634","0","38.80","12.62"
"10","010","00","100","0003","0000","453","196","257","7","460","1125","0","40.89","17.42"
"10","010","00","100","0003","0167","453","196","257","7","460","1125","0","40.89","17.42"
"10","010","00","100","0004","0000","354","158","196","4","358","829","0","43.18","19.06"
"10","010","00","100","0004","0168","354","158","196","4","358","829","0","43.18","19.06"
"10","010","00","100","0005","0000","280","101","179","7","287","749","0","38.32","13.48"
"10","010","00","100","0005","0169","280","101","179","7","287","749","0","38.32","13.48"
"10","010","00","100","0006","0000","464","143","321","11","475","1195","0","39.75","11.97"
"10","010","00","100","0006","0170","464","143","321","11","475","1195","0","39.75","11.97"
"10","010","00","100","0007","0000","148","53","95","1","149","368","0","40.49","14.40"
"10","010","00","100","0007","0171","148","53","95","1","149","368","0","40.49","14.40"
"10","010","00","100","0008","0000","171","77","94","6","177","412","0","42.96","18.69"
"10","010","00","100","0008","0172","127","55","72","3","130","312","0","41.67","17.63"
"10","010","00","100","0008","0173","44","22","22","3","47","100","0","47.00","22.00"
"10","010","00","100","0009","0000","321","122","199","8","329","721","0","45.63","16.92"
"10","010","00","100","0009","0174","321","122","199","8","329","721","0","45.63","16.92"
"10","010","00","100","0010","0000","173","58","115","1","174","422","0","41.23","13.74"
"10","010","00","100","0010","0175","173","58","115","1","174","422","0","41.23","13.74"
"10","010","00","100","0011","0000","183","82","101","5","188","417","0","45.08","19.66"
"10","010","00","100","0011","0176","183","82","101","5","188","417","0","45.08","19.66"
"10","010","00","100","0012","0000","247","95","152","5","252","591","0","42.64","16.07"
"10","010","00","100","0012","0177","247","95","152","5","252","591","0","42.64","16.07"
"10","010","00","100","0013","0000","479","182","297","6","485","1447","0","33.52","12.58"
"10","010","00","100","0013","0178","180","65","115","4","184","537","0","34.26","12.10"
"10","010","00","100","0013","0179","299","117","182","2","301","910","0","33.08","12.86"
"10","010","00","100","0014","0000","241","91","150","4","245","826","0","29.66","11.02"
"10","010","00","100","0014","0180","241","91","150","4","245","826","0","29.66","11.02"
"10","010","00","100","0015","0000","260","74","186","5","265","777","0","34.11","9.52"
"10","010","00","100","0015","0181","260","74","186","5","265","777","0","34.11","9.52"
"10","010","00","100","0016","0000","287","57","230","10","297","796","0","37.31","7.16"
"10","010","00","100","0016","0182","287","57","230","10","297","796","0","37.31","7.16"
"10","010","00","100","0017","0000","147","52","95","3","150","422","0","35.55","12.32"
"10","010","00","100","0017","0183","147","52","95","3","150","422","0","35.55","12.32"
"10","010","00","100","0018","0000","182","93","89","8","190","520","0","36.54","17.88"
"10","010","00","100","0018","0184","182","93","89","8","190","520","0","36.54","17.88"
"10","010","00","100","0019","0000","292","89","203","3","295","724","0","40.75","12.29"
"10","010","00","100","0019","0185","239","74","165","2","241","589","0","40.92","12.56"
"10","010","00","100","0019","0186","53","15","38","1","54","135","0","40.00","11.11"
"10","010","00","100","0020","0000","151","51","100","1","152","363","0","41.87","14.05"
"10","010","00","100","0020","0187","151","51","100","1","152","363","0","41.87","14.05"
"10","010","00","100","0021","0000","199","69","130","2","201","554","0","36.28","12.45"
"10","010","00","100","0021","0188","199","69","130","2","201","554","0","36.28","12.45"
"10","010","00","100","0022","0000","295","79","216","4","299","636","0","47.01","12.42"
"10","010","00","100","0022","0189","230","67","163","4","234","518","0","45.17","12.93"
"10","010","00","100","0022","0190","65","12","53","0","65","118","0","55.08","10.17"
"10","010","00","110","0000","0000","5032","1617","3415","71","5103","13469","14778","37.89","12.01"
"10","010","00","110","0001","0000","178","44","134","2","180","512","0","35.16","8.59"
"10","010","00","110","0001","0191","178","44","134","2","180","512","0","35.16","8.59"
"10","010","00","110","0002","0000","218","59","159","2","220","540","0","40.74","10.93"
"10","010","00","110","0002","0192","218","59","159","2","220","540","0","40.74","10.93"
"10","010","00","110","0003","0000","462","154","308","4","466","1289","0","36.15","11.95"
"10","010","00","110","0003","0193","462","154","308","4","466","1289","0","36.15","11.95"
"10","010","00","110","0004","0000","475","190","285","9","484","1319","0","36.69","14.40"
"10","010","00","110","0004","0194","475","190","285","9","484","1319","0","36.69","14.40"
"10","010","00","110","0005","0000","180","82","98","0","180","736","0","24.46","11.14"
"10","010","00","110","0005","0195","110","46","64","0","110","322","0","34.16","14.29"
"10","010","00","110","0005","0196","70","36","34","0","70","414","0","16.91","8.70"
"10","010","00","110","0006","0000","396","112","284","3","399","1002","0","39.82","11.18"
"10","010","00","110","0006","0197","396","112","284","3","399","1002","0","39.82","11.18"
"10","010","00","110","0007","0000","156","42","114","5","161","427","0","37.70","9.84"
"10","010","00","110","0007","0198","156","42","114","5","161","427","0","37.70","9.84"
"10","010","00","110","0008","0000","327","72","255","6","333","799","0","41.68","9.01"
"10","010","00","110","0008","0199","327","72","255","6","333","799","0","41.68","9.01"
"10","010","00","110","0009","0000","383","89","294","4","387","982","0","39.41","9.06"
"10","010","00","110","0009","0200","383","89","294","4","387","982","0","39.41","9.06"
"10","010","00","110","0010","0000","330","132","198","5","335","937","0","35.75","14.09"
"10","010","00","110","0010","0201","330","132","198","5","335","937","0","35.75","14.09"
"10","010","00","110","0011","0000","295","119","176","5","300","927","0","32.36","12.84"
"10","010","00","110","0011","0202","295","119","176","5","300","927","0","32.36","12.84"
"10","010","00","110","0012","0000","343","87","256","7","350","895","0","39.11","9.72"
"10","010","00","110","0012","0203","237","62","175","7","244","639","0","38.18","9.70"
"10","010","00","110","0012","0204","106","25","81","0","106","256","0","41.41","9.77"
"10","010","00","110","0013","0000","436","149","287","7","443","1126","0","39.34","13.23"
"10","010","00","110","0013","0205","303","103","200","5","308","842","0","36.58","12.23"
"10","010","00","110","0013","0206","133","46","87","2","135","284","0","47.54","16.20"
"10","010","00","110","0014","0000","576","174","402","9","585","1379","0","42.42","12.62"
"10","010","00","110","0014","0207","414","111","303","9","423","1004","0","42.13","11.06"
"10","010","00","110","0014","0208","162","63","99","0","162","375","0","43.20","16.80"
"10","010","00","110","0015","0000","277","112","165","3","280","599","0","46.74","18.70"
"10","010","00","110","0015","0209","144","66","78","1","145","323","0","44.89","20.43"
"10","010","00","110","0015","0210","133","46","87","2","135","276","0","48.91","16.67"
"10","010","00","120","0000","0000","17324","6688","10636","184","17508","43700","48786","40.06","15.30"
"10","010","00","120","0001","0000","1626","671","955","16","1642","4025","0","40.80","16.67"
"10","010","00","120","0001","0211","375","173","202","5","380","1017","0","37.36","17.01"
"10","010","00","120","0001","0212","452","169","283","5","457","1070","0","42.71","15.79"
"10","010","00","120","0001","0213","401","154","247","5","406","1069","0","37.98","14.41"
"10","010","00","120","0001","0214","398","175","223","1","399","869","0","45.91","20.14"
"10","010","00","120","0002","0000","1053","468","585","8","1061","2466","0","43.03","18.98"
"10","010","00","120","0002","0215","475","194","281","1","476","1129","0","42.16","17.18"
"10","010","00","120","0002","0216","578","274","304","7","585","1337","0","43.75","20.49"
"10","010","00","120","0003","0000","777","225","552","8","785","1615","0","48.61","13.93"
"10","010","00","120","0003","0224","318","96","222","0","318","613","0","51.88","15.66"
"10","010","00","120","0003","0225","309","89","220","4","313","640","0","48.91","13.91"
"10","010","00","120","0003","0226","150","40","110","4","154","362","0","42.54","11.05"
"10","010","00","120","0004","0000","786","264","522","8","794","2073","0","38.30","12.74"
"10","010","00","120","0004","0227","381","129","252","2","383","1025","0","37.37","12.59"
"10","010","00","120","0004","0228","405","135","270","6","411","1048","0","39.22","12.88"
"10","010","00","120","0005","0000","344","98","246","4","348","782","0","44.50","12.53"
"10","010","00","120","0005","0229","344","98","246","4","348","782","0","44.50","12.53"
"10","010","00","120","0006","0000","610","270","340","7","617","1540","0","40.06","17.53"
"10","010","00","120","0006","0217","485","219","266","4","489","1235","0","39.60","17.73"
"10","010","00","120","0006","0218","125","51","74","3","128","305","0","41.97","16.72"
"10","010","00","120","0007","0000","748","303","445","6","754","1867","0","40.39","16.23"
"10","010","00","120","0007","0219","274","105","169","5","279","653","0","42.73","16.08"
"10","010","00","120","0007","0220","474","198","276","1","475","1214","0","39.13","16.31"
"10","010","00","120","0008","0000","678","309","369","7","685","1779","0","38.50","17.37"
"10","010","00","120","0008","0221","351","154","197","6","357","1023","0","34.90","15.05"
"10","010","00","120","0008","0222","327","155","172","1","328","756","0","43.39","20.50"
"10","010","00","120","0009","0000","182","86","96","2","184","427","0","43.09","20.14"
"10","010","00","120","0009","0223","182","86","96","2","184","427","0","43.09","20.14"
"10","010","00","120","0010","0000","241","139","102","4","245","614","0","39.90","22.64"
"10","010","00","120","0010","0233","241","139","102","4","245","614","0","39.90","22.64"
"10","010","00","120","0011","0000","214","91","123","0","214","384","0","55.73","23.70"
"10","010","00","120","0011","0234","214","91","123","0","214","384","0","55.73","23.70"
"10","010","00","120","0012","0000","519","174","345","4","523","1345","0","38.88","12.94"
"10","010","00","120","0012","0235","333","122","211","1","334","758","0","44.06","16.09"
"10","010","00","120","0012","0236","186","52","134","3","189","587","0","32.20","8.86"
"10","010","00","120","0013","0000","835","233","602","8","843","1915","0","44.02","12.17"
"10","010","00","120","0013","0230","450","117","333","2","452","1029","0","43.93","11.37"
"10","010","00","120","0013","0231","385","116","269","6","391","886","0","44.13","13.09"
"10","010","00","120","0014","0000","425","151","274","7","432","1028","0","42.02","14.69"
"10","010","00","120","0014","0232","425","151","274","7","432","1028","0","42.02","14.69"
"10","010","00","120","0015","0000","713","264","449","13","726","2028","0","35.80","13.02"
"10","010","00","120","0015","0239","301","107","194","9","310","893","0","34.71","11.98"
"10","010","00","120","0015","0240","412","157","255","4","416","1135","0","36.65","13.83"
"10","010","00","120","0016","0000","794","264","530","11","805","1983","0","40.60","13.31"
"10","010","00","120","0016","0241","468","153","315","5","473","1068","0","44.29","14.33"
"10","010","00","120","0016","0242","326","111","215","6","332","915","0","36.28","12.13"
"10","010","00","120","0017","0000","685","313","372","6","691","1782","0","38.78","17.56"
"10","010","00","120","0017","0237","331","148","183","1","332","804","0","41.29","18.41"
"10","010","00","120","0017","0238","354","165","189","5","359","978","0","36.71","16.87"
"10","010","00","120","0018","0000","1648","621","1027","20","1668","4357","0","38.28","14.25"
"10","010","00","120","0018","0244","521","175","346","8","529","1373","0","38.53","12.75"
"10","010","00","120","0018","0245","569","213","356","9","578","1473","0","39.24","14.46"
"10","010","00","120","0018","0246","558","233","325","3","561","1511","0","37.13","15.42"
"10","010","00","120","0019","0000","1208","501","707","13","1221","2967","0","41.15","16.89"
"10","010","00","120","0019","0247","630","250","380","10","640","1505","0","42.52","16.61"
"10","010","00","120","0019","0248","578","251","327","3","581","1462","0","39.74","17.17"
"10","010","00","120","0020","0000","711","308","403","8","719","1853","0","38.80","16.62"
"10","010","00","120","0020","0252","430","174","256","4","434","1067","0","40.67","16.31"
"10","010","00","120","0020","0253","281","134","147","4","285","786","0","36.26","17.05"
"10","010","00","120","0021","0000","644","257","387","6","650","1779","0","36.54","14.45"
"10","010","00","120","0021","0250","405","159","246","5","410","1170","0","35.04","13.59"
"10","010","00","120","0021","0251","239","98","141","1","240","609","0","39.41","16.09"
"10","010","00","120","0022","0000","338","125","213","1","339","910","0","37.25","13.74"
"10","010","00","120","0022","0254","338","125","213","1","339","910","0","37.25","13.74"
"10","010","00","120","0023","0000","380","135","245","5","385","971","0","39.65","13.90"
"10","010","00","120","0023","0255","380","135","245","5","385","971","0","39.65","13.90"
"10","010","00","120","0024","0000","425","130","295","6","431","1239","0","34.79","10.49"
"10","010","00","120","0024","0256","425","130","295","6","431","1239","0","34.79","10.49"
"10","010","00","120","0025","0000","434","171","263","2","436","1179","0","36.98","14.50"
"10","010","00","120","0025","0243","434","171","263","2","436","1179","0","36.98","14.50"
"10","010","00","120","0026","0000","306","117","189","4","310","792","0","39.14","14.77"
"10","010","00","120","0026","0249","306","117","189","4","310","792","0","39.14","14.77"
"10","010","00","130","0000","0000","13972","5297","8675","159","14131","38789","43935","36.43","13.66"
"10","010","00","130","0001","0000","612","232","380","9","621","1790","0","34.69","12.96"
"10","010","00","130","0001","0465","247","86","161","5","252","670","0","37.61","12.84"
"10","010","00","130","0001","0466","365","146","219","4","369","1120","0","32.95","13.04"
"10","010","00","130","0002","0000","372","144","228","3","375","935","0","40.11","15.40"
"10","010","00","130","0002","0467","372","144","228","3","375","935","0","40.11","15.40"
"10","010","00","130","0003","0000","322","124","198","4","326","787","0","41.42","15.76"
"10","010","00","130","0003","0479","322","124","198","4","326","787","0","41.42","15.76"
"10","010","00","130","0004","0000","342","84","258","4","346","862","0","40.14","9.74"
"10","010","00","130","0004","0478","342","84","258","4","346","862","0","40.14","9.74"
"10","010","00","130","0005","0000","460","185","275","8","468","1500","0","31.20","12.33"
"10","010","00","130","0005","0468","237","100","137","5","242","770","0","31.43","12.99"
"10","010","00","130","0005","0469","223","85","138","3","226","730","0","30.96","11.64"
"10","010","00","130","0006","0000","1059","398","661","9","1068","2900","0","36.83","13.72"
"10","010","00","130","0006","0448","353","149","204","3","356","1046","0","34.03","14.24"
"10","010","00","130","0006","0449","316","106","210","4","320","816","0","39.22","12.99"
"10","010","00","130","0006","0450","390","143","247","2","392","1038","0","37.76","13.78"
"10","010","00","130","0007","0000","1234","476","758","15","1249","3322","0","37.60","14.33"
"10","010","00","130","0007","0451","514","222","292","7","521","1290","0","40.39","17.21"
"10","010","00","130","0007","0452","345","136","209","1","346","872","0","39.68","15.60"
"10","010","00","130","0007","0453","375","118","257","7","382","1160","0","32.93","10.17"
"10","010","00","130","0008","0000","2664","1116","1548","19","2683","7020","0","38.22","15.90"
"10","010","00","130","0008","0454","490","197","293","5","495","1391","0","35.59","14.16"
"10","010","00","130","0008","0455","518","251","267","3","521","1253","0","41.58","20.03"
"10","010","00","130","0008","0456","395","177","218","4","399","1081","0","36.91","16.37"
"10","010","00","130","0008","0457","505","194","311","3","508","1306","0","38.90","14.85"
"10","010","00","130","0008","0458","283","112","171","2","285","785","0","36.31","14.27"
"10","010","00","130","0008","0459","473","185","288","2","475","1204","0","39.45","15.37"
"10","010","00","130","0009","0000","2025","782","1243","27","2052","5652","0","36.31","13.84"
"10","010","00","130","0009","0460","415","164","251","3","418","1176","0","35.54","13.95"
"10","010","00","130","0009","0461","478","196","282","1","479","1344","0","35.64","14.58"
"10","010","00","130","0009","0462","334","136","198","4","338","981","0","34.45","13.86"
"10","010","00","130","0009","0463","366","156","210","9","375","971","0","38.62","16.07"
"10","010","00","130","0009","0464","432","130","302","10","442","1180","0","37.46","11.02"
"10","010","00","130","0010","0000","646","252","394","5","651","1825","0","35.67","13.81"
"10","010","00","130","0010","0470","260","108","152","2","262","771","0","33.98","14.01"
"10","010","00","130","0010","0471","386","144","242","3","389","1054","0","36.91","13.66"
"10","010","00","130","0011","0000","514","153","361","6","520","1490","0","34.90","10.27"
"10","010","00","130","0011","0472","209","53","156","2","211","574","0","36.76","9.23"
"10","010","00","130","0011","0473","305","100","205","4","309","916","0","33.73","10.92"
"10","010","00","130","0012","0000","716","271","445","7","723","2097","0","34.48","12.92"
"10","010","00","130","0012","0474","136","47","89","0","136","430","0","31.63","10.93"
"10","010","00","130","0012","0475","265","103","162","5","270","770","0","35.06","13.38"
"10","010","00","130","0012","0476","315","121","194","2","317","897","0","35.34","13.49"
"10","010","00","130","0013","0000","321","112","209","2","323","1020","0","31.67","10.98"
"10","010","00","130","0013","0477","321","112","209","2","323","1020","0","31.67","10.98"
"10","010","00","130","0014","0000","411","155","256","9","420","1122","0","37.43","13.81"
"10","010","00","130","0014","0480","99","46","53","0","99","280","0","35.36","16.43"
"10","010","00","130","0014","0481","312","109","203","9","321","842","0","38.12","12.95"
"10","010","00","130","0015","0000","342","101","241","6","348","932","0","37.34","10.84"
"10","010","00","130","0015","0482","342","101","241","6","348","932","0","37.34","10.84"
"10","010","00","130","0016","0000","657","217","440","8","665","1851","0","35.93","11.72"
"10","010","00","130","0016","0483","447","154","293","4","451","1187","0","37.99","12.97"
"10","010","00","130","0016","0484","210","63","147","4","214","664","0","32.23","9.49"
"10","010","00","130","0017","0000","224","97","127","3","227","723","0","31.40","13.42"
"10","010","00","130","0017","0487","224","97","127","3","227","723","0","31.40","13.42"
"10","010","00","130","0018","0000","339","118","221","6","345","966","0","35.71","12.22"
"10","010","00","130","0018","0488","165","71","94","2","167","462","0","36.15","15.37"
"10","010","00","130","0018","0489","174","47","127","4","178","504","0","35.32","9.33"
"10","010","00","130","0019","0000","196","58","138","1","197","634","0","31.07","9.15"
"10","010","00","130","0019","0486","196","58","138","1","197","634","0","31.07","9.15"
"10","010","00","130","0020","0000","259","106","153","3","262","714","0","36.69","14.85"
"10","010","00","130","0020","0485","259","106","153","3","262","714","0","36.69","14.85"
"10","010","00","130","0021","0000","155","68","87","1","156","356","0","43.82","19.10"
"10","010","00","130","0021","0490","155","68","87","1","156","356","0","43.82","19.10"
"10","010","00","130","0022","0000","102","48","54","4","106","291","0","36.43","16.49"
"10","010","00","130","0022","0491","102","48","54","4","106","291","0","36.43","16.49"
"10","010","00","140","0000","0000","10844","4128","6716","129","10973","30617","34503","35.84","13.48"
"10","010","00","140","0001","0000","967","398","569","4","971","2455","0","39.55","16.21"
"10","010","00","140","0001","0410","491","186","305","3","494","1292","0","38.24","14.40"
"10","010","00","140","0001","0411","476","212","264","1","477","1163","0","41.01","18.23"
"10","010","00","140","0002","0000","728","253","475","9","737","2167","0","34.01","11.68"
"10","010","00","140","0002","0412","344","124","220","3","347","973","0","35.66","12.74"
"10","010","00","140","0002","0413","384","129","255","6","390","1194","0","32.66","10.80"
"10","010","00","140","0003","0000","234","91","143","2","236","750","0","31.47","12.13"
"10","010","00","140","0003","0414","234","91","143","2","236","750","0","31.47","12.13"
"10","010","00","140","0004","0000","307","76","231","7","314","813","0","38.62","9.35"
"10","010","00","140","0004","0415","307","76","231","7","314","813","0","38.62","9.35"
"10","010","00","140","0005","0000","502","154","348","8","510","1212","0","42.08","12.71"
"10","010","00","140","0005","0416","502","154","348","8","510","1212","0","42.08","12.71"
"10","010","00","140","0006","0000","295","111","184","4","299","603","0","49.59","18.41"
"10","010","00","140","0006","0417","295","111","184","4","299","603","0","49.59","18.41"
"10","010","00","140","0007","0000","308","104","204","2","310","1025","0","30.24","10.15"
"10","010","00","140","0007","0418","308","104","204","2","310","1025","0","30.24","10.15"
"10","010","00","140","0008","0000","1986","882","1104","21","2007","5214","0","38.49","16.92"
"10","010","00","140","0008","0419","503","206","297","5","508","1289","0","39.41","15.98"
"10","010","00","140","0008","0420","508","225","283","7","515","1341","0","38.40","16.78"
"10","010","00","140","0008","0421","252","117","135","1","253","634","0","39.91","18.45"
"10","010","00","140","0008","0422","512","244","268","8","520","1389","0","37.44","17.57"
"10","010","00","140","0008","0423","211","90","121","0","211","561","0","37.61","16.04"
"10","010","00","140","0009","0000","550","192","358","3","553","1401","0","39.47","13.70"
"10","010","00","140","0009","0424","550","192","358","3","553","1401","0","39.47","13.70"
"10","010","00","140","0010","0000","468","197","271","7","475","1362","0","34.88","14.46"
"10","010","00","140","0010","0425","468","197","271","7","475","1362","0","34.88","14.46"
"10","010","00","140","0011","0000","617","218","399","13","630","1562","0","40.33","13.96"
"10","010","00","140","0011","0426","617","218","399","13","630","1562","0","40.33","13.96"
"10","010","00","140","0012","0000","489","165","324","1","490","1738","0","28.19","9.49"
"10","010","00","140","0012","0427","206","80","126","0","206","759","0","27.14","10.54"
"10","010","00","140","0012","0428","283","85","198","1","284","979","0","29.01","8.68"
"10","010","00","140","0013","0000","175","72","103","5","180","611","0","29.46","11.78"
"10","010","00","140","0013","0431","175","72","103","5","180","611","0","29.46","11.78"
"10","010","00","140","0014","0000","310","123","187","2","312","998","0","31.26","12.32"
"10","010","00","140","0014","0429","102","29","73","0","102","334","0","30.54","8.68"
"10","010","00","140","0014","0430","208","94","114","2","210","664","0","31.63","14.16"
"10","010","00","140","0015","0000","298","138","160","3","301","851","0","35.37","16.22"
"10","010","00","140","0015","0432","176","71","105","2","178","464","0","38.36","15.30"
"10","010","00","140","0015","0433","122","67","55","1","123","387","0","31.78","17.31"
"10","010","00","140","0016","0000","213","80","133","5","218","624","0","34.94","12.82"
"10","010","00","140","0016","0434","213","80","133","5","218","624","0","34.94","12.82"
"10","010","00","140","0017","0000","603","184","419","13","616","1756","0","35.08","10.48"
"10","010","00","140","0017","0435","73","30","43","2","75","211","0","35.55","14.22"
"10","010","00","140","0017","0436","530","154","376","11","541","1545","0","35.02","9.97"
"10","010","00","140","0018","0000","219","82","137","5","224","626","0","35.78","13.10"
"10","010","00","140","0018","0437","219","82","137","5","224","626","0","35.78","13.10"
"10","010","00","140","0019","0000","157","63","94","0","157","416","0","37.74","15.14"
"10","010","00","140","0019","0438","157","63","94","0","157","416","0","37.74","15.14"
"10","010","00","140","0020","0000","633","219","414","9","642","1845","0","34.80","11.87"
"10","010","00","140","0020","0439","341","111","230","6","347","902","0","38.47","12.31"
"10","010","00","140","0020","0440","292","108","184","3","295","943","0","31.28","11.45"
"10","010","00","140","0021","0000","272","125","147","1","273","903","0","30.23","13.84"
"10","010","00","140","0021","0441","236","95","141","1","237","797","0","29.74","11.92"
"10","010","00","140","0021","0442","36","30","6","0","36","106","0","33.96","28.30"
"10","010","00","140","0022","0000","66","15","51","0","66","238","0","27.73","6.30"
"10","010","00","140","0022","0443","66","15","51","0","66","238","0","27.73","6.30"
"10","010","00","140","0023","0000","241","87","154","1","242","766","0","31.59","11.36"
"10","010","00","140","0023","0444","83","37","46","1","84","318","0","26.42","11.64"
"10","010","00","140","0023","0445","158","50","108","0","158","448","0","35.27","11.16"
"10","010","00","140","0024","0000","206","99","107","4","210","681","0","30.84","14.54"
"10","010","00","140","0024","0446","138","60","78","2","140","434","0","32.26","13.82"
"10","010","00","140","0024","0447","68","39","29","2","70","247","0","28.34","15.79"
"10","010","00","150","0000","0000","5620","2319","3301","80","5700","16554","18481","34.43","14.01"
"10","010","00","150","0001","0000","805","311","494","11","816","2182","0","37.40","14.25"
"10","010","00","150","0001","0301","374","146","228","3","377","962","0","39.19","15.18"
"10","010","00","150","0001","0302","431","165","266","8","439","1220","0","35.98","13.52"
"10","010","00","150","0002","0000","352","167","185","4","356","869","0","40.97","19.22"
"10","010","00","150","0002","0303","352","167","185","4","356","869","0","40.97","19.22"
"10","010","00","150","0003","0000","194","64","130","2","196","540","0","36.30","11.85"
"10","010","00","150","0003","0307","194","64","130","2","196","540","0","36.30","11.85"
"10","010","00","150","0004","0000","1541","610","931","23","1564","4337","0","36.06","14.07"
"10","010","00","150","0004","0304","448","175","273","5","453","1142","0","39.67","15.32"
"10","010","00","150","0004","0305","469","179","290","4","473","1353","0","34.96","13.23"
"10","010","00","150","0004","0306","624","256","368","14","638","1842","0","34.64","13.90"
"10","010","00","150","0005","0000","147","57","90","2","149","393","0","37.91","14.50"
"10","010","00","150","0005","0308","147","57","90","2","149","393","0","37.91","14.50"
"10","010","00","150","0006","0000","182","77","105","1","183","500","0","36.60","15.40"
"10","010","00","150","0006","0314","182","77","105","1","183","500","0","36.60","15.40"
"10","010","00","150","0007","0000","108","39","69","2","110","355","0","30.99","10.99"
"10","010","00","150","0007","0315","108","39","69","2","110","355","0","30.99","10.99"
"10","010","00","150","0008","0000","181","73","108","4","185","579","0","31.95","12.61"
"10","010","00","150","0008","0309","181","73","108","4","185","579","0","31.95","12.61"
"10","010","00","150","0009","0000","556","216","340","7","563","1618","0","34.80","13.35"
"10","010","00","150","0009","0311","277","105","172","5","282","848","0","33.25","12.38"
"10","010","00","150","0009","0312","279","111","168","2","281","770","0","36.49","14.42"
"10","010","00","150","0010","0000","205","78","127","5","210","548","0","38.32","14.23"
"10","010","00","150","0010","0310","205","78","127","5","210","548","0","38.32","14.23"
"10","010","00","150","0011","0000","225","90","135","1","226","814","0","27.76","11.06"
"10","010","00","150","0011","0313","225","90","135","1","226","814","0","27.76","11.06"
"10","010","00","150","0012","0000","139","65","74","1","140","488","0","28.69","13.32"
"10","010","00","150","0012","0316","139","65","74","1","140","488","0","28.69","13.32"
"10","010","00","150","0013","0000","83","38","45","1","84","275","0","30.55","13.82"
"10","010","00","150","0013","0319","83","38","45","1","84","275","0","30.55","13.82"
"10","010","00","150","0014","0000","153","88","65","0","153","414","0","36.96","21.26"
"10","010","00","150","0014","0317","153","88","65","0","153","414","0","36.96","21.26"
"10","010","00","150","0015","0000","206","109","97","7","213","703","0","30.30","15.50"
"10","010","00","150","0015","0320","206","109","97","7","213","703","0","30.30","15.50"
"10","010","00","150","0016","0000","182","114","68","2","184","610","0","30.16","18.69"
"10","010","00","150","0016","0321","182","114","68","2","184","610","0","30.16","18.69"
"10","010","00","150","0017","0000","237","92","145","5","242","929","0","26.05","9.90"
"10","010","00","150","0017","0322","136","39","97","4","140","525","0","26.67","7.43"
"10","010","00","150","0017","0323","101","53","48","1","102","404","0","25.25","13.12"
"10","010","00","150","0018","0000","124","31","93","2","126","400","0","31.50","7.75"
"10","010","00","150","0018","0318","124","31","93","2","126","400","0","31.50","7.75"
"10","010","00","160","0000","0000","3353","1479","1874","32","3385","9931","11097","34.09","14.89"
"10","010","00","160","0001","0000","437","226","211","7","444","1143","0","38.85","19.77"
"10","010","00","160","0001","0492","437","226","211","7","444","1143","0","38.85","19.77"
"10","010","00","160","0002","0000","168","78","90","1","169","440","0","38.41","17.73"
"10","010","00","160","0002","0493","168","78","90","1","169","440","0","38.41","17.73"
"10","010","00","160","0003","0000","410","159","251","3","413","1282","0","32.22","12.40"
"10","010","00","160","0003","0494","262","105","157","1","263","749","0","35.11","14.02"
"10","010","00","160","0003","0495","148","54","94","2","150","533","0","28.14","10.13"
"10","010","00","160","0004","0000","671","288","383","4","675","1748","0","38.62","16.48"
"10","010","00","160","0004","0496","329","136","193","3","332","898","0","36.97","15.14"
"10","010","00","160","0004","0497","342","152","190","1","343","850","0","40.35","17.88"
"10","010","00","160","0005","0000","294","118","176","5","299","835","0","35.81","14.13"
"10","010","00","160","0005","0498","294","118","176","5","299","835","0","35.81","14.13"
"10","010","00","160","0006","0000","312","141","171","2","314","849","0","36.98","16.61"
"10","010","00","160","0006","0499","312","141","171","2","314","849","0","36.98","16.61"
"10","010","00","160","0007","0000","409","175","234","4","413","1220","0","33.85","14.34"
"10","010","00","160","0007","0500","210","149","61","3","213","794","0","26.83","18.77"
"10","010","00","160","0007","0501","199","26","173","1","200","426","0","46.95","6.10"
"10","010","00","160","0008","0000","157","56","101","3","160","596","0","26.85","9.40"
"10","010","00","160","0008","0502","157","56","101","3","160","596","0","26.85","9.40"
"10","010","00","160","0009","0000","251","117","134","0","251","956","0","26.26","12.24"
"10","010","00","160","0009","0503","104","45","59","0","104","314","0","33.12","14.33"
"10","010","00","160","0009","0504","147","72","75","0","147","642","0","22.90","11.21"
"10","010","00","160","0010","0000","147","58","89","1","148","498","0","29.72","11.65"
"10","010","00","160","0010","0505","147","58","89","1","148","498","0","29.72","11.65"
"10","010","00","160","0011","0000","97","63","34","2","99","364","0","27.20","17.31"
"10","010","00","160","0011","0506","45","29","16","1","46","160","0","28.75","18.13"
"10","010","00","160","0011","0507","52","34","18","1","53","204","0","25.98","16.67"
"10","010","00","170","0000","0000","998","425","573","16","1014","4008","4553","25.30","10.60"
"10","010","00","170","0001","0000","353","135","218","4","357","1448","0","24.65","9.32"
"10","010","00","170","0001","0521","190","78","112","2","192","723","0","26.56","10.79"
"10","010","00","170","0001","0522","163","57","106","2","165","725","0","22.76","7.86"
"10","010","00","170","0002","0000","170","60","110","4","174","650","0","26.77","9.23"
"10","010","00","170","0002","0523","75","33","42","3","78","342","0","22.81","9.65"
"10","010","00","170","0002","0524","95","27","68","1","96","308","0","31.17","8.77"
"10","010","00","170","0003","0000","116","62","54","2","118","420","0","28.10","14.76"
"10","010","00","170","0003","0525","43","24","19","1","44","181","0","24.31","13.26"
"10","010","00","170","0003","0526","73","38","35","1","74","239","0","30.96","15.90"
"10","010","00","170","0004","0000","184","80","104","4","188","923","0","20.37","8.67"
"10","010","00","170","0004","0527","93","25","68","1","94","484","0","19.42","5.17"
"10","010","00","170","0004","0528","56","39","17","0","56","196","0","28.57","19.90"
"10","010","00","170","0004","0529","35","16","19","3","38","243","0","15.64","6.58"
"10","010","00","170","0005","0000","175","88","87","2","177","567","0","31.22","15.52"
"10","010","00","170","0005","0530","175","88","87","2","177","567","0","31.22","15.52"
"10","010","00","180","0000","0000","1446","968","478","20","1466","4621","5455","31.72","20.95"
"10","010","00","180","0001","0000","111","61","50","1","112","367","0","30.52","16.62"
"10","010","00","180","0001","0508","111","61","50","1","112","367","0","30.52","16.62"
"10","010","00","180","0002","0000","63","45","18","2","65","184","0","35.33","24.46"
"10","010","00","180","0002","0509","63","45","18","2","65","184","0","35.33","24.46"
"10","010","00","180","0003","0000","42","28","14","0","42","142","0","29.58","19.72"
"10","010","00","180","0003","0510","42","28","14","0","42","142","0","29.58","19.72"
"10","010","00","180","0004","0000","83","50","33","0","83","316","0","26.27","15.82"
"10","010","00","180","0004","0511","57","34","23","0","57","235","0","24.26","14.47"
"10","010","00","180","0004","0512","26","16","10","0","26","81","0","32.10","19.75"
"10","010","00","180","0005","0000","128","95","33","2","130","292","0","44.52","32.53"
"10","010","00","180","0005","0514","128","95","33","2","130","292","0","44.52","32.53"
"10","010","00","180","0006","0000","82","51","31","1","83","303","0","27.39","16.83"
"10","010","00","180","0006","0513","82","51","31","1","83","303","0","27.39","16.83"
"10","010","00","180","0007","0000","247","195","52","4","251","819","0","30.65","23.81"
"10","010","00","180","0007","0516","247","195","52","4","251","819","0","30.65","23.81"
"10","010","00","180","0008","0000","299","177","122","8","307","939","0","32.69","18.85"
"10","010","00","180","0008","0515","299","177","122","8","307","939","0","32.69","18.85"
"10","010","00","180","0009","0000","86","65","21","0","86","244","0","35.25","26.64"
"10","010","00","180","0009","0517","86","65","21","0","86","244","0","35.25","26.64"
"10","010","00","180","0010","0000","130","98","32","1","131","472","0","27.75","20.76"
"10","010","00","180","0010","0518","130","98","32","1","131","472","0","27.75","20.76"
"10","010","00","180","0011","0000","93","68","25","1","94","289","0","32.53","23.53"
"10","010","00","180","0011","0519","93","68","25","1","94","289","0","32.53","23.53"
"10","010","00","180","0012","0000","82","35","47","0","82","254","0","32.28","13.78"
"10","010","00","180","0012","0520","82","35","47","0","82","254","0","32.28","13.78"
"10","013","00","000","0000","0000","278295","109130","169165","3019","281314","700254","807970","40.17","15.58"
"10","013","00","010","0000","0000","72409","33121","39288","699","73108","167496","196653","43.65","19.77"
"10","013","00","010","0012","0000","1136","408","728","16","1152","2604","0","44.24","15.67"
"10","013","00","010","0012","0006","566","186","380","6","572","1339","0","42.72","13.89"
"10","013","00","010","0012","0007","570","222","348","10","580","1265","0","45.85","17.55"
"10","013","00","010","0020","0000","601","264","337","2","603","1528","0","39.46","17.28"
"10","013","00","010","0020","0011","325","122","203","0","325","751","0","43.28","16.25"
"10","013","00","010","0020","0012","276","142","134","2","278","777","0","35.78","18.28"
"10","013","00","010","0021","0000","393","173","220","7","400","843","0","47.45","20.52"
"10","013","00","010","0021","0013","393","173","220","7","400","843","0","47.45","20.52"
"10","013","00","010","0022","0000","822","373","449","6","828","1836","0","45.10","20.32"
"10","013","00","010","0022","0029","414","171","243","5","419","906","0","46.25","18.87"
"10","013","00","010","0022","0030","408","202","206","1","409","930","0","43.98","21.72"
"10","013","00","010","0023","0000","1207","533","674","9","1216","2467","0","49.29","21.61"
"10","013","00","010","0023","0024","641","261","380","5","646","1277","0","50.59","20.44"
"10","013","00","010","0023","0025","566","272","294","4","570","1190","0","47.90","22.86"
"10","013","00","010","0024","0000","1642","860","782","12","1654","3454","0","47.89","24.90"
"10","013","00","010","0024","0026","457","249","208","8","465","1046","0","44.46","23.80"
"10","013","00","010","0024","0027","550","261","289","2","552","1134","0","48.68","23.02"
"10","013","00","010","0024","0028","635","350","285","2","637","1274","0","50.00","27.47"
"10","013","00","010","0025","0000","1717","789","928","9","1726","3905","0","44.20","20.20"
"10","013","00","010","0025","0021","576","254","322","3","579","1258","0","46.03","20.19"
"10","013","00","010","0025","0022","610","283","327","0","610","1325","0","46.04","21.36"
"10","013","00","010","0025","0023","531","252","279","6","537","1322","0","40.62","19.06"
"10","013","00","010","0026","0000","4211","2177","2034","26","4237","9028","0","46.93","24.11"
"10","013","00","010","0026","0014","590","300","290","3","593","1298","0","45.69","23.11"
"10","013","00","010","0026","0015","623","320","303","4","627","1358","0","46.17","23.56"
"10","013","00","010","0026","0016","638","324","314","5","643","1364","0","47.14","23.75"
"10","013","00","010","0026","0017","560","314","246","2","562","1259","0","44.64","24.94"
"10","013","00","010","0026","0018","598","324","274","2","600","1209","0","49.63","26.80"
"10","013","00","010","0026","0019","609","319","290","7","616","1281","0","48.09","24.90"
"10","013","00","010","0026","0020","593","276","317","3","596","1259","0","47.34","21.92"
"10","013","00","010","0027","0000","674","198","476","6","680","1482","0","45.88","13.36"
"10","013","00","010","0027","0037","674","198","476","6","680","1482","0","45.88","13.36"
"10","013","00","010","0028","0000","438","128","310","2","440","1032","0","42.64","12.40"
"10","013","00","010","0028","0036","438","128","310","2","440","1032","0","42.64","12.40"
"10","013","00","010","0029","0000","474","116","358","6","480","1115","0","43.05","10.40"
"10","013","00","010","0029","0038","474","116","358","6","480","1115","0","43.05","10.40"
"10","013","00","010","0030","0000","3127","1498","1629","27","3154","7115","0","44.33","21.05"
"10","013","00","010","0030","0031","634","285","349","7","641","1461","0","43.87","19.51"
"10","013","00","010","0030","0032","604","309","295","6","610","1435","0","42.51","21.53"
"10","013","00","010","0030","0033","690","356","334","4","694","1372","0","50.58","25.95"
"10","013","00","010","0030","0034","566","269","297","7","573","1426","0","40.18","18.86"
"10","013","00","010","0030","0035","633","279","354","3","636","1421","0","44.76","19.63"
"10","013","00","010","0031","0000","2268","946","1322","21","2289","5421","0","42.22","17.45"
"10","013","00","010","0031","0063","662","245","417","7","669","1449","0","46.17","16.91"
"10","013","00","010","0031","0064","580","212","368","7","587","1381","0","42.51","15.35"
"10","013","00","010","0031","0065","355","157","198","1","356","967","0","36.81","16.24"
"10","013","00","010","0031","0066","671","332","339","6","677","1624","0","41.69","20.44"
"10","013","00","010","0032","0000","238","70","168","3","241","510","0","47.25","13.73"
"10","013","00","010","0032","0067","238","70","168","3","241","510","0","47.25","13.73"
"10","013","00","010","0033","0000","1238","420","818","12","1250","2821","0","44.31","14.89"
"10","013","00","010","0033","0077","560","185","375","4","564","1223","0","46.12","15.13"
"10","013","00","010","0033","0078","678","235","443","8","686","1598","0","42.93","14.71"
"10","013","00","010","0034","0000","358","123","235","4","362","796","0","45.48","15.45"
"10","013","00","010","0034","0074","358","123","235","4","362","796","0","45.48","15.45"
"10","013","00","010","0035","0000","405","183","222","8","413","900","0","45.89","20.33"
"10","013","00","010","0035","0075","405","183","222","8","413","900","0","45.89","20.33"
"10","013","00","010","0036","0000","560","285","275","1","561","1173","0","47.83","24.30"
"10","013","00","010","0036","0079","560","285","275","1","561","1173","0","47.83","24.30"
"10","013","00","010","0037","0000","301","100","201","0","301","678","0","44.40","14.75"
"10","013","00","010","0037","0076","301","100","201","0","301","678","0","44.40","14.75"
"10","013","00","010","0038","0000","556","315","241","8","564","1104","0","51.09","28.53"
"10","013","00","010","0038","0080","556","315","241","8","564","1104","0","51.09","28.53"
"10","013","00","010","0039","0000","273","99","174","4","277","655","0","42.29","15.11"
"10","013","00","010","0039","0081","273","99","174","4","277","655","0","42.29","15.11"
"10","013","00","010","0040","0000","2904","1205","1699","27","2931","6960","0","42.11","17.31"
"10","013","00","010","0040","0082","507","178","329","5","512","1289","0","39.72","13.81"
"10","013","00","010","0040","0083","559","213","346","7","566","1403","0","40.34","15.18"
"10","013","00","010","0040","0084","641","302","339","6","647","1446","0","44.74","20.89"
"10","013","00","010","0040","0085","495","198","297","3","498","1314","0","37.90","15.07"
"10","013","00","010","0040","0086","702","314","388","6","708","1508","0","46.95","20.82"
"10","013","00","010","0041","0000","983","348","635","13","996","2467","0","40.37","14.11"
"10","013","00","010","0041","0060","561","158","403","8","569","1262","0","45.09","12.52"
"10","013","00","010","0041","0061","422","190","232","5","427","1205","0","35.44","15.77"
"10","013","00","010","0042","0000","669","194","475","10","679","1488","0","45.63","13.04"
"10","013","00","010","0042","0062","669","194","475","10","679","1488","0","45.63","13.04"
"10","013","00","010","0043","0000","925","304","621","14","939","2203","0","42.62","13.80"
"10","013","00","010","0043","0071","487","153","334","4","491","1183","0","41.50","12.93"
"10","013","00","010","0043","0072","438","151","287","10","448","1020","0","43.92","14.80"
"10","013","00","010","0044","0000","621","106","515","6","627","1481","0","42.34","7.16"
"10","013","00","010","0044","0073","621","106","515","6","627","1481","0","42.34","7.16"
"10","013","00","010","0045","0000","463","337","126","6","469","1083","0","43.31","31.12"
"10","013","00","010","0045","0068","463","337","126","6","469","1083","0","43.31","31.12"
"10","013","00","010","0046","0000","714","252","462","5","719","1791","0","40.15","14.07"
"10","013","00","010","0046","0069","338","137","201","1","339","870","0","38.97","15.75"
"10","013","00","010","0046","0070","376","115","261","4","380","921","0","41.26","12.49"
"10","013","00","010","0049","0000","838","287","551","15","853","1995","0","42.76","14.39"
"10","013","00","010","0049","0052","395","122","273","8","403","946","0","42.60","12.90"
"10","013","00","010","0049","0053","443","165","278","7","450","1049","0","42.90","15.73"
"10","013","00","010","0050","0000","447","161","286","7","454","1004","0","45.22","16.04"
"10","013","00","010","0050","0054","447","161","286","7","454","1004","0","45.22","16.04"
"10","013","00","010","0051","0000","520","123","397","10","530","1166","0","45.45","10.55"
"10","013","00","010","0051","0059","520","123","397","10","530","1166","0","45.45","10.55"
"10","013","00","010","0053","0000","3398","1532","1866","51","3449","8068","0","42.75","18.99"
"10","013","00","010","0053","0042","537","272","265","4","541","1239","0","43.66","21.95"
"10","013","00","010","0053","0043","499","232","267","3","502","1307","0","38.41","17.75"
"10","013","00","010","0053","0044","582","244","338","6","588","1390","0","42.30","17.55"
"10","013","00","010","0053","0045","586","232","354","7","593","1398","0","42.42","16.60"
"10","013","00","010","0053","0046","594","289","305","7","601","1359","0","44.22","21.27"
"10","013","00","010","0053","0047","600","263","337","24","624","1375","0","45.38","19.13"
"10","013","00","010","0054","0000","1213","425","788","11","1224","2872","0","42.62","14.80"
"10","013","00","010","0054","0057","606","228","378","4","610","1412","0","43.20","16.15"
"10","013","00","010","0054","0058","607","197","410","7","614","1460","0","42.05","13.49"
"10","013","00","010","0055","0000","1679","758","921","10","1689","4077","0","41.43","18.59"
"10","013","00","010","0055","0039","578","257","321","3","581","1334","0","43.55","19.27"
"10","013","00","010","0055","0040","531","253","278","2","533","1373","0","38.82","18.43"
"10","013","00","010","0055","0041","570","248","322","5","575","1370","0","41.97","18.10"
"10","013","00","010","0056","0000","836","286","550","8","844","1956","0","43.15","14.62"
"10","013","00","010","0056","0055","415","144","271","4","419","1031","0","40.64","13.97"
"10","013","00","010","0056","0056","421","142","279","4","425","925","0","45.95","15.35"
"10","013","00","010","0059","0000","758","407","351","3","761","1637","0","46.49","24.86"
"10","013","00","010","0059","0116","343","158","185","2","345","814","0","42.38","19.41"
"10","013","00","010","0059","0117","415","249","166","1","416","823","0","50.55","30.26"
"10","013","00","010","0060","0000","2001","1036","965","19","2020","4657","0","43.38","22.25"
"10","013","00","010","0060","0118","515","257","258","6","521","1164","0","44.76","22.08"
"10","013","00","010","0060","0119","424","202","222","4","428","1025","0","41.76","19.71"
"10","013","00","010","0060","0120","515","271","244","6","521","1229","0","42.39","22.05"
"10","013","00","010","0060","0121","547","306","241","3","550","1239","0","44.39","24.70"
"10","013","00","010","0061","0000","339","164","175","4","343","730","0","46.99","22.47"
"10","013","00","010","0061","0138","339","164","175","4","343","730","0","46.99","22.47"
"10","013","00","010","0062","0000","263","125","138","2","265","652","0","40.64","19.17"
"10","013","00","010","0062","0139","263","125","138","2","265","652","0","40.64","19.17"
"10","013","00","010","0063","0000","302","129","173","3","305","626","0","48.72","20.61"
"10","013","00","010","0063","0140","302","129","173","3","305","626","0","48.72","20.61"
"10","013","00","010","0064","0000","1971","1020","951","18","1989","4603","0","43.21","22.16"
"10","013","00","010","0064","0134","524","248","276","5","529","1118","0","47.32","22.18"
"10","013","00","010","0064","0135","491","252","239","4","495","1149","0","43.08","21.93"
"10","013","00","010","0064","0136","508","261","247","6","514","1203","0","42.73","21.70"
"10","013","00","010","0064","0137","448","259","189","3","451","1133","0","39.81","22.86"
"10","013","00","010","0065","0000","2021","1076","945","20","2041","5471","0","37.31","19.67"
"10","013","00","010","0065","0112","442","230","212","6","448","1773","0","25.27","12.97"
"10","013","00","010","0065","0113","500","277","223","2","502","1224","0","41.01","22.63"
"10","013","00","010","0065","0114","608","291","317","10","618","1310","0","47.18","22.21"
"10","013","00","010","0065","0115","471","278","193","2","473","1164","0","40.64","23.88"
"10","013","00","010","0066","0000","770","361","409","13","783","1912","0","40.95","18.88"
"10","013","00","010","0066","0106","378","172","206","9","387","913","0","42.39","18.84"
"10","013","00","010","0066","0107","392","189","203","4","396","999","0","39.64","18.92"
"10","013","00","010","0067","0000","985","444","541","12","997","2231","0","44.69","19.90"
"10","013","00","010","0067","0122","466","208","258","3","469","1085","0","43.23","19.17"
"10","013","00","010","0067","0123","519","236","283","9","528","1146","0","46.07","20.59"
"10","013","00","010","0068","0000","1088","481","607","8","1096","2284","0","47.99","21.06"
"10","013","00","010","0068","0132","613","275","338","5","618","1239","0","49.88","22.20"
"10","013","00","010","0068","0133","475","206","269","3","478","1045","0","45.74","19.71"
"10","013","00","010","0069","0000","2562","1265","1297","18","2580","6059","0","42.58","20.88"
"10","013","00","010","0069","0127","503","242","261","6","509","1220","0","41.72","19.84"
"10","013","00","010","0069","0128","547","290","257","1","548","1204","0","45.51","24.09"
"10","013","00","010","0069","0129","485","244","241","4","489","1196","0","40.89","20.40"
"10","013","00","010","0069","0130","508","257","251","4","512","1232","0","41.56","20.86"
"10","013","00","010","0069","0131","519","232","287","3","522","1207","0","43.25","19.22"
"10","013","00","010","0070","0000","1017","465","552","11","1028","2149","0","47.84","21.64"
"10","013","00","010","0070","0143","456","211","245","5","461","1001","0","46.05","21.08"
"10","013","00","010","0070","0144","561","254","307","6","567","1148","0","49.39","22.13"
"10","013","00","010","0071","0000","873","382","491","10","883","2058","0","42.91","18.56"
"10","013","00","010","0071","0110","463","170","293","6","469","1044","0","44.92","16.28"
"10","013","00","010","0071","0111","410","212","198","4","414","1014","0","40.83","20.91"
"10","013","00","010","0073","0000","5175","2892","2283","39","5214","12298","0","42.40","23.52"
"10","013","00","010","0073","0087","349","205","144","5","354","809","0","43.76","25.34"
"10","013","00","010","0073","0088","522","212","310","1","523","1266","0","41.31","16.75"
"10","013","00","010","0073","0089","502","261","241","1","503","1273","0","39.51","20.50"
"10","013","00","010","0073","0090","547","330","217","4","551","1346","0","40.94","24.52"
"10","013","00","010","0073","0091","518","263","255","5","523","1225","0","42.69","21.47"
"10","013","00","010","0073","0092","392","214","178","3","395","910","0","43.41","23.52"
"10","013","00","010","0073","0093","567","357","210","3","570","1392","0","40.95","25.65"
"10","013","00","010","0073","0094","607","355","252","5","612","1343","0","45.57","26.43"
"10","013","00","010","0073","0095","567","328","239","5","572","1310","0","43.66","25.04"
"10","013","00","010","0073","0096","604","367","237","7","611","1424","0","42.91","25.77"
"10","013","00","010","0074","0000","801","523","278","8","809","1655","0","48.88","31.60"
"10","013","00","010","0074","0108","400","254","146","4","404","810","0","49.88","31.36"
"10","013","00","010","0074","0109","401","269","132","4","405","845","0","47.93","31.83"
"10","013","00","010","0075","0000","4545","2642","1903","31","4576","11543","0","39.64","22.89"
"10","013","00","010","0075","0097","533","316","217","2","535","1434","0","37.31","22.04"
"10","013","00","010","0075","0098","458","282","176","7","465","1184","0","39.27","23.82"
"10","013","00","010","0075","0099","517","285","232","4","521","1320","0","39.47","21.59"
"10","013","00","010","0075","0100","547","319","228","4","551","1300","0","42.38","24.54"
"10","013","00","010","0075","0101","602","332","270","3","605","1430","0","42.31","23.22"
"10","013","00","010","0075","0102","502","295","207","3","505","1245","0","40.56","23.69"
"10","013","00","010","0075","0103","551","322","229","3","554","1388","0","39.91","23.20"
"10","013","00","010","0075","0104","278","174","104","3","281","773","0","36.35","22.51"
"10","013","00","010","0075","0105","557","317","240","2","559","1469","0","38.05","21.58"
"10","013","00","010","0076","0000","571","186","385","7","578","1324","0","43.66","14.05"
"10","013","00","010","0076","0124","571","186","385","7","578","1324","0","43.66","14.05"
"10","013","00","010","0077","0000","371","103","268","4","375","849","0","44.17","12.13"
"10","013","00","010","0077","0125","371","103","268","4","375","849","0","44.17","12.13"
"10","013","00","010","0078","0000","424","133","291","14","438","1089","0","40.22","12.21"
"10","013","00","010","0078","0126","424","133","291","14","438","1089","0","40.22","12.21"
"10","013","00","010","0079","0000","420","127","293","8","428","941","0","45.48","13.50"
"10","013","00","010","0079","0142","420","127","293","8","428","941","0","45.48","13.50"
"10","013","00","010","0080","0000","686","170","516","6","692","1560","0","44.36","10.90"
"10","013","00","010","0080","0141","686","170","516","6","692","1560","0","44.36","10.90"
"10","013","00","010","0081","0000","1254","923","331","11","1265","2890","0","43.77","31.94"
"10","013","00","010","0081","0048","599","486","113","7","606","1352","0","44.82","35.95"
"10","013","00","010","0081","0049","655","437","218","4","659","1538","0","42.85","28.41"
"10","013","00","010","0085","0000","537","172","365","2","539","1053","0","51.19","16.33"
"10","013","00","010","0085","0001","537","172","365","2","539","1053","0","51.19","16.33"
"10","013","00","010","0086","0000","289","154","135","7","296","675","0","43.85","22.81"
"10","013","00","010","0086","0002","289","154","135","7","296","675","0","43.85","22.81"
"10","013","00","010","0087","0000","633","267","366","4","637","1310","0","48.63","20.38"
"10","013","00","010","0087","0003","633","267","366","4","637","1310","0","48.63","20.38"
"10","013","00","010","0088","0000","555","207","348","6","561","1240","0","45.24","16.69"
"10","013","00","010","0088","0004","555","207","348","6","561","1240","0","45.24","16.69"
"10","013","00","010","0089","0000","304","97","207","3","307","654","0","46.94","14.83"
"10","013","00","010","0089","0005","304","97","207","3","307","654","0","46.94","14.83"
"10","013","00","010","0090","0000","600","201","399","7","607","1166","0","52.06","17.24"
"10","013","00","010","0090","0008","600","201","399","7","607","1166","0","52.06","17.24"
"10","013","00","010","0091","0000","487","198","289","2","489","1039","0","47.06","19.06"
"10","013","00","010","0091","0009","487","198","289","2","489","1039","0","47.06","19.06"
"10","013","00","010","0092","0000","505","169","336","10","515","1018","0","50.59","16.60"
"10","013","00","010","0092","0010","505","169","336","10","515","1018","0","50.59","16.60"
"10","013","00","010","0093","0000","216","124","92","3","219","525","0","41.71","23.62"
"10","013","00","010","0093","0050","216","124","92","3","219","525","0","41.71","23.62"
"10","013","00","010","0094","0000","237","102","135","4","241","520","0","46.35","19.62"
"10","013","00","010","0094","0051","237","102","135","4","241","520","0","46.35","19.62"
"10","013","00","020","0000","0000","18697","7380","11317","163","18860","46629","53851","40.45","15.83"
"10","013","00","020","0001","0000","224","118","106","2","226","505","0","44.75","23.37"
"10","013","00","020","0001","0145","224","118","106","2","226","505","0","44.75","23.37"
"10","013","00","020","0002","0000","300","102","198","2","302","582","0","51.89","17.53"
"10","013","00","020","0002","0151","300","102","198","2","302","582","0","51.89","17.53"
"10","013","00","020","0003","0000","547","217","330","8","555","1227","0","45.23","17.69"
"10","013","00","020","0003","0167","547","217","330","8","555","1227","0","45.23","17.69"
"10","013","00","020","0004","0000","414","155","259","3","417","983","0","42.42","15.77"
"10","013","00","020","0004","0166","414","155","259","3","417","983","0","42.42","15.77"
"10","013","00","020","0005","0000","1750","751","999","7","1757","4770","0","36.83","15.74"
"10","013","00","020","0005","0146","349","126","223","1","350","913","0","38.34","13.80"
"10","013","00","020","0005","0147","313","141","172","2","315","937","0","33.62","15.05"
"10","013","00","020","0005","0148","401","169","232","3","404","991","0","40.77","17.05"
"10","013","00","020","0005","0149","321","138","183","0","321","928","0","34.59","14.87"
"10","013","00","020","0005","0150","366","177","189","1","367","1001","0","36.66","17.68"
"10","013","00","020","0006","0000","377","107","270","1","378","859","0","44.00","12.46"
"10","013","00","020","0006","0152","377","107","270","1","378","859","0","44.00","12.46"
"10","013","00","020","0007","0000","2290","985","1305","17","2307","5434","0","42.45","18.13"
"10","013","00","020","0007","0153","537","233","304","1","538","1261","0","42.66","18.48"
"10","013","00","020","0007","0154","685","286","399","5","690","1728","0","39.93","16.55"
"10","013","00","020","0007","0155","566","238","328","7","573","1254","0","45.69","18.98"
"10","013","00","020","0007","0156","502","228","274","4","506","1191","0","42.49","19.14"
"10","013","00","020","0008","0000","2764","1197","1567","21","2785","6463","0","43.09","18.52"
"10","013","00","020","0008","0157","509","201","308","3","512","1141","0","44.87","17.62"
"10","013","00","020","0008","0158","543","245","298","6","549","1347","0","40.76","18.19"
"10","013","00","020","0008","0159","588","271","317","3","591","1410","0","41.91","19.22"
"10","013","00","020","0008","0160","477","192","285","5","482","1097","0","43.94","17.50"
"10","013","00","020","0008","0161","647","288","359","4","651","1468","0","44.35","19.62"
"10","013","00","020","0009","0000","881","377","504","5","886","2106","0","42.07","17.90"
"10","013","00","020","0009","0162","359","151","208","3","362","868","0","41.71","17.40"
"10","013","00","020","0009","0163","522","226","296","2","524","1238","0","42.33","18.26"
"10","013","00","020","0010","0000","549","208","341","6","555","1387","0","40.01","15.00"
"10","013","00","020","0010","0168","549","208","341","6","555","1387","0","40.01","15.00"
"10","013","00","020","0011","0000","928","325","603","4","932","2401","0","38.82","13.54"
"10","013","00","020","0011","0169","523","208","315","1","524","1292","0","40.56","16.10"
"10","013","00","020","0011","0170","405","117","288","3","408","1109","0","36.79","10.55"
"10","013","00","020","0012","0000","918","364","554","10","928","2381","0","38.98","15.29"
"10","013","00","020","0012","0171","494","195","299","5","499","1336","0","37.35","14.60"
"10","013","00","020","0012","0172","424","169","255","5","429","1045","0","41.05","16.17"
"10","013","00","020","0013","0000","2663","1118","1545","23","2686","7120","0","37.72","15.70"
"10","013","00","020","0013","0173","423","149","274","1","424","1077","0","39.37","13.83"
"10","013","00","020","0013","0174","452","185","267","5","457","1240","0","36.85","14.92"
"10","013","00","020","0013","0175","471","222","249","5","476","1161","0","41.00","19.12"
"10","013","00","020","0013","0176","411","163","248","2","413","1106","0","37.34","14.74"
"10","013","00","020","0013","0177","467","188","279","3","470","1323","0","35.53","14.21"
"10","013","00","020","0013","0178","439","211","228","7","446","1213","0","36.77","17.39"
"10","013","00","020","0014","0000","449","186","263","6","455","1172","0","38.82","15.87"
"10","013","00","020","0014","0179","449","186","263","6","455","1172","0","38.82","15.87"
"10","013","00","020","0015","0000","554","207","347","7","561","1413","0","39.70","14.65"
"10","013","00","020","0015","0180","554","207","347","7","561","1413","0","39.70","14.65"
"10","013","00","020","0016","0000","309","104","205","5","314","881","0","35.64","11.80"
"10","013","00","020","0016","0181","309","104","205","5","314","881","0","35.64","11.80"
"10","013","00","020","0017","0000","169","57","112","0","169","468","0","36.11","12.18"
"10","013","00","020","0017","0182","169","57","112","0","169","468","0","36.11","12.18"
"10","013","00","020","0018","0000","622","172","450","12","634","1633","0","38.82","10.53"
"10","013","00","020","0018","0164","403","116","287","10","413","1149","0","35.94","10.10"
"10","013","00","020","0018","0165","219","56","163","2","221","484","0","45.66","11.57"
"10","013","00","020","0019","0000","696","252","444","6","702","1615","0","43.47","15.60"
"10","013","00","020","0019","0183","365","143","222","5","370","884","0","41.86","16.18"
"10","013","00","020","0019","0184","331","109","222","1","332","731","0","45.42","14.91"
"10","013","00","020","0020","0000","683","203","480","12","695","1694","0","41.03","11.98"
"10","013","00","020","0020","0185","323","98","225","7","330","900","0","36.67","10.89"
"10","013","00","020","0020","0186","360","105","255","5","365","794","0","45.97","13.22"
"10","013","00","020","0021","0000","610","175","435","6","616","1535","0","40.13","11.40"
"10","013","00","020","0021","0187","445","136","309","5","450","1185","0","37.97","11.48"
"10","013","00","020","0021","0188","165","39","126","1","166","350","0","47.43","11.14"
"10","013","00","030","0000","0000","15316","4962","10354","135","15451","39127","46590","39.49","12.68"
"10","013","00","030","0001","0000","949","291","658","8","957","1975","0","48.46","14.73"
"10","013","00","030","0001","0189","447","141","306","6","453","955","0","47.43","14.76"
"10","013","00","030","0001","0190","502","150","352","2","504","1020","0","49.41","14.71"
"10","013","00","030","0004","0000","243","96","147","0","243","631","0","38.51","15.21"
"10","013","00","030","0004","0192","243","96","147","0","243","631","0","38.51","15.21"
"10","013","00","030","0007","0000","595","163","432","8","603","1575","0","38.29","10.35"
"10","013","00","030","0007","0203","378","115","263","5","383","1022","0","37.48","11.25"
"10","013","00","030","0007","0204","217","48","169","3","220","553","0","39.78","8.68"
"10","013","00","030","0008","0000","332","113","219","1","333","734","0","45.37","15.40"
"10","013","00","030","0008","0205","332","113","219","1","333","734","0","45.37","15.40"
"10","013","00","030","0009","0000","436","144","292","5","441","1192","0","37.00","12.08"
"10","013","00","030","0009","0206","436","144","292","5","441","1192","0","37.00","12.08"
"10","013","00","030","0010","0000","240","74","166","2","242","559","0","43.29","13.24"
"10","013","00","030","0010","0207","240","74","166","2","242","559","0","43.29","13.24"
"10","013","00","030","0011","0000","493","122","371","2","495","1329","0","37.25","9.18"
"10","013","00","030","0011","0208","493","122","371","2","495","1329","0","37.25","9.18"
"10","013","00","030","0012","0000","703","169","534","7","710","1804","0","39.36","9.37"
"10","013","00","030","0012","0209","278","82","196","2","280","729","0","38.41","11.25"
"10","013","00","030","0012","0210","425","87","338","5","430","1075","0","40.00","8.09"
"10","013","00","030","0013","0000","1046","246","800","6","1052","2840","0","37.04","8.66"
"10","013","00","030","0013","0211","524","140","384","1","525","1361","0","38.57","10.29"
"10","013","00","030","0013","0212","522","106","416","5","527","1479","0","35.63","7.17"
"10","013","00","030","0014","0000","666","189","477","2","668","1680","0","39.76","11.25"
"10","013","00","030","0014","0213","335","86","249","1","336","817","0","41.13","10.53"
"10","013","00","030","0014","0214","331","103","228","1","332","863","0","38.47","11.94"
"10","013","00","030","0015","0000","531","199","332","5","536","1562","0","34.31","12.74"
"10","013","00","030","0015","0215","160","69","91","2","162","417","0","38.85","16.55"
"10","013","00","030","0015","0216","371","130","241","3","374","1145","0","32.66","11.35"
"10","013","00","030","0016","0000","2096","725","1371","20","2116","5363","0","39.46","13.52"
"10","013","00","030","0016","0217","411","124","287","5","416","1003","0","41.48","12.36"
"10","013","00","030","0016","0218","433","144","289","3","436","1017","0","42.87","14.16"
"10","013","00","030","0016","0219","352","155","197","6","358","998","0","35.87","15.53"
"10","013","00","030","0016","0220","391","150","241","2","393","1046","0","37.57","14.34"
"10","013","00","030","0016","0221","509","152","357","4","513","1299","0","39.49","11.70"
"10","013","00","030","0017","0000","789","163","626","15","804","1937","0","41.51","8.42"
"10","013","00","030","0017","0222","468","80","388","8","476","1201","0","39.63","6.66"
"10","013","00","030","0017","0223","321","83","238","7","328","736","0","44.57","11.28"
"10","013","00","030","0018","0000","597","179","418","3","600","1532","0","39.16","11.68"
"10","013","00","030","0018","0224","318","88","230","2","320","815","0","39.26","10.80"
"10","013","00","030","0018","0225","279","91","188","1","280","717","0","39.05","12.69"
"10","013","00","030","0019","0000","3478","1282","2196","28","3506","9392","0","37.33","13.65"
"10","013","00","030","0019","0193","341","126","215","4","345","896","0","38.50","14.06"
"10","013","00","030","0019","0194","424","168","256","4","428","1156","0","37.02","14.53"
"10","013","00","030","0019","0195","503","188","315","2","505","1436","0","35.17","13.09"
"10","013","00","030","0019","0196","432","170","262","1","433","1202","0","36.02","14.14"
"10","013","00","030","0019","0197","381","136","245","6","387","1110","0","34.86","12.25"
"10","013","00","030","0019","0198","449","167","282","4","453","1116","0","40.59","14.96"
"10","013","00","030","0019","0199","502","157","345","4","506","1182","0","42.81","13.28"
"10","013","00","030","0019","0200","446","170","276","3","449","1294","0","34.70","13.14"
"10","013","00","030","0020","0000","550","190","360","4","554","1324","0","41.84","14.35"
"10","013","00","030","0020","0201","550","190","360","4","554","1324","0","41.84","14.35"
"10","013","00","030","0021","0000","419","89","330","8","427","1049","0","40.71","8.48"
"10","013","00","030","0021","0226","419","89","330","8","427","1049","0","40.71","8.48"
"10","013","00","030","0022","0000","287","200","87","3","290","664","0","43.67","30.12"
"10","013","00","030","0022","0227","287","200","87","3","290","664","0","43.67","30.12"
"10","013","00","030","0029","0000","379","132","247","3","382","852","0","44.84","15.49"
"10","013","00","030","0029","0191","379","132","247","3","382","852","0","44.84","15.49"
"10","013","00","030","0030","0000","487","196","291","5","492","1133","0","43.42","17.30"
"10","013","00","030","0030","0202","487","196","291","5","492","1133","0","43.42","17.30"
"10","013","00","040","0000","0000","7389","3396","3993","90","7479","25502","30236","29.33","13.32"
"10","013","00","040","0001","0000","295","160","135","2","297","896","0","33.15","17.86"
"10","013","00","040","0001","0228","295","160","135","2","297","896","0","33.15","17.86"
"10","013","00","040","0002","0000","710","340","370","4","714","2205","0","32.38","15.42"
"10","013","00","040","0002","0229","217","104","113","1","218","706","0","30.88","14.73"
"10","013","00","040","0002","0230","259","122","137","1","260","755","0","34.44","16.16"
"10","013","00","040","0002","0231","234","114","120","2","236","744","0","31.72","15.32"
"10","013","00","040","0003","0000","320","170","150","8","328","1109","0","29.58","15.33"
"10","013","00","040","0003","0232","320","170","150","8","328","1109","0","29.58","15.33"
"10","013","00","040","0004","0000","1195","617","578","10","1205","4194","0","28.73","14.71"
"10","013","00","040","0004","0248","261","131","130","2","263","1028","0","25.58","12.74"
"10","013","00","040","0004","0249","356","190","166","0","356","1081","0","32.93","17.58"
"10","013","00","040","0004","0250","314","150","164","3","317","1035","0","30.63","14.49"
"10","013","00","040","0004","0251","264","146","118","5","269","1050","0","25.62","13.90"
"10","013","00","040","0005","0000","893","419","474","13","906","3117","0","29.07","13.44"
"10","013","00","040","0005","0233","284","137","147","3","287","1081","0","26.55","12.67"
"10","013","00","040","0005","0234","298","146","152","4","302","1011","0","29.87","14.44"
"10","013","00","040","0005","0235","311","136","175","6","317","1025","0","30.93","13.27"
"10","013","00","040","0006","0000","229","91","138","1","230","856","0","26.87","10.63"
"10","013","00","040","0006","0236","229","91","138","1","230","856","0","26.87","10.63"
"10","013","00","040","0007","0000","168","62","106","5","173","504","0","34.33","12.30"
"10","013","00","040","0007","0237","168","62","106","5","173","504","0","34.33","12.30"
"10","013","00","040","0008","0000","164","60","104","3","167","473","0","35.31","12.68"
"10","013","00","040","0008","0238","164","60","104","3","167","473","0","35.31","12.68"
"10","013","00","040","0009","0000","272","106","166","6","278","1021","0","27.23","10.38"
"10","013","00","040","0009","0239","272","106","166","6","278","1021","0","27.23","10.38"
"10","013","00","040","0010","0000","247","99","148","7","254","928","0","27.37","10.67"
"10","013","00","040","0010","0240","247","99","148","7","254","928","0","27.37","10.67"
"10","013","00","040","0011","0000","285","134","151","0","285","1079","0","26.41","12.42"
"10","013","00","040","0011","0241","285","134","151","0","285","1079","0","26.41","12.42"
"10","013","00","040","0012","0000","485","146","339","5","490","1560","0","31.41","9.36"
"10","013","00","040","0012","0242","240","53","187","4","244","776","0","31.44","6.83"
"10","013","00","040","0012","0243","245","93","152","1","246","784","0","31.38","11.86"
"10","013","00","040","0013","0000","532","269","263","9","541","2199","0","24.60","12.23"
"10","013","00","040","0013","0244","283","134","149","3","286","1089","0","26.26","12.30"
"10","013","00","040","0013","0245","249","135","114","6","255","1110","0","22.97","12.16"
"10","013","00","040","0014","0000","320","105","215","4","324","1388","0","23.34","7.56"
"10","013","00","040","0014","0246","164","59","105","2","166","683","0","24.30","8.64"
"10","013","00","040","0014","0247","156","46","110","2","158","705","0","22.41","6.52"
"10","013","00","040","0015","0000","483","254","229","1","484","1686","0","28.71","15.07"
"10","013","00","040","0015","0252","222","108","114","0","222","824","0","26.94","13.11"
"10","013","00","040","0015","0253","261","146","115","1","262","862","0","30.39","16.94"
"10","013","00","040","0016","0000","457","201","256","7","464","1205","0","38.51","16.68"
"10","013","00","040","0016","0254","255","121","134","2","257","585","0","43.93","20.68"
"10","013","00","040","0016","0255","202","80","122","5","207","620","0","33.39","12.90"
"10","013","00","040","0017","0000","334","163","171","5","339","1082","0","31.33","15.06"
"10","013","00","040","0017","0256","334","163","171","5","339","1082","0","31.33","15.06"
"10","013","00","050","0000","0000","18027","5922","12105","192","18219","43230","49955","42.14","13.70"
"10","013","00","050","0001","0000","245","75","170","1","246","587","0","41.91","12.78"
"10","013","00","050","0001","0271","245","75","170","1","246","587","0","41.91","12.78"
"10","013","00","050","0002","0000","362","127","235","1","363","817","0","44.43","15.54"
"10","013","00","050","0002","0266","362","127","235","1","363","817","0","44.43","15.54"
"10","013","00","050","0003","0000","1462","516","946","15","1477","3322","0","44.46","15.53"
"10","013","00","050","0003","0267","487","174","313","7","494","1113","0","44.38","15.63"
"10","013","00","050","0003","0268","458","182","276","4","462","1078","0","42.86","16.88"
"10","013","00","050","0003","0269","517","160","357","4","521","1131","0","46.07","14.15"
"10","013","00","050","0004","0000","239","78","161","2","241","711","0","33.90","10.97"
"10","013","00","050","0004","0270","239","78","161","2","241","711","0","33.90","10.97"
"10","013","00","050","0005","0000","605","242","363","12","617","1403","0","43.98","17.25"
"10","013","00","050","0005","0272","605","242","363","12","617","1403","0","43.98","17.25"
"10","013","00","050","0006","0000","858","352","506","9","867","2249","0","38.55","15.65"
"10","013","00","050","0006","0273","400","174","226","3","403","1090","0","36.97","15.96"
"10","013","00","050","0006","0274","458","178","280","6","464","1159","0","40.03","15.36"
"10","013","00","050","0007","0000","829","270","559","4","833","2047","0","40.69","13.19"
"10","013","00","050","0007","0275","405","130","275","2","407","969","0","42.00","13.42"
"10","013","00","050","0007","0276","424","140","284","2","426","1078","0","39.52","12.99"
"10","013","00","050","0008","0000","694","214","480","9","703","1671","0","42.07","12.81"
"10","013","00","050","0008","0277","344","121","223","4","348","862","0","40.37","14.04"
"10","013","00","050","0008","0278","350","93","257","5","355","809","0","43.88","11.50"
"10","013","00","050","0009","0000","1019","324","695","8","1027","2276","0","45.12","14.24"
"10","013","00","050","0009","0299","493","131","362","4","497","1036","0","47.97","12.64"
"10","013","00","050","0009","0300","526","193","333","4","530","1240","0","42.74","15.56"
"10","013","00","050","0010","0000","443","115","328","4","447","973","0","45.94","11.82"
"10","013","00","050","0010","0281","443","115","328","4","447","973","0","45.94","11.82"
"10","013","00","050","0011","0000","715","204","511","7","722","1835","0","39.35","11.12"
"10","013","00","050","0011","0282","378","116","262","6","384","956","0","40.17","12.13"
"10","013","00","050","0011","0283","337","88","249","1","338","879","0","38.45","10.01"
"10","013","00","050","0012","0000","685","191","494","7","692","1593","0","43.44","11.99"
"10","013","00","050","0012","0284","378","99","279","2","380","862","0","44.08","11.48"
"10","013","00","050","0012","0285","307","92","215","5","312","731","0","42.68","12.59"
"10","013","00","050","0013","0000","565","186","379","6","571","1407","0","40.58","13.22"
"10","013","00","050","0013","0286","565","186","379","6","571","1407","0","40.58","13.22"
"10","013","00","050","0014","0000","364","97","267","4","368","822","0","44.77","11.80"
"10","013","00","050","0014","0289","364","97","267","4","368","822","0","44.77","11.80"
"10","013","00","050","0015","0000","540","117","423","7","547","1248","0","43.83","9.38"
"10","013","00","050","0015","0290","540","117","423","7","547","1248","0","43.83","9.38"
"10","013","00","050","0016","0000","556","194","362","12","568","1471","0","38.61","13.19"
"10","013","00","050","0016","0291","556","194","362","12","568","1471","0","38.61","13.19"
"10","013","00","050","0017","0000","417","130","287","7","424","943","0","44.96","13.79"
"10","013","00","050","0017","0292","417","130","287","7","424","943","0","44.96","13.79"
"10","013","00","050","0018","0000","841","256","585","7","848","1968","0","43.09","13.01"
"10","013","00","050","0018","0293","352","101","251","2","354","802","0","44.14","12.59"
"10","013","00","050","0018","0294","489","155","334","5","494","1166","0","42.37","13.29"
"10","013","00","050","0019","0000","711","213","498","10","721","1666","0","43.28","12.79"
"10","013","00","050","0019","0297","415","128","287","3","418","953","0","43.86","13.43"
"10","013","00","050","0019","0298","296","85","211","7","303","713","0","42.50","11.92"
"10","013","00","050","0020","0000","713","192","521","11","724","1692","0","42.79","11.35"
"10","013","00","050","0020","0295","356","91","265","5","361","839","0","43.03","10.85"
"10","013","00","050","0020","0296","357","101","256","6","363","853","0","42.56","11.84"
"10","013","00","050","0021","0000","770","280","490","8","778","1694","0","45.93","16.53"
"10","013","00","050","0021","0279","363","126","237","2","365","800","0","45.63","15.75"
"10","013","00","050","0021","0280","407","154","253","6","413","894","0","46.20","17.23"
"10","013","00","050","0022","0000","871","338","533","7","878","2075","0","42.31","16.29"
"10","013","00","050","0022","0258","489","185","304","5","494","1168","0","42.29","15.84"
"10","013","00","050","0022","0259","382","153","229","2","384","907","0","42.34","16.87"
"10","013","00","050","0023","0000","625","210","415","5","630","1508","0","41.78","13.93"
"10","013","00","050","0023","0257","625","210","415","5","630","1508","0","41.78","13.93"
"10","013","00","050","0024","0000","450","131","319","4","454","977","0","46.47","13.41"
"10","013","00","050","0024","0287","450","131","319","4","454","977","0","46.47","13.41"
"10","013","00","050","0025","0000","728","332","396","5","733","2019","0","36.31","16.44"
"10","013","00","050","0025","0260","368","183","185","4","372","1003","0","37.09","18.25"
"10","013","00","050","0025","0261","360","149","211","1","361","1016","0","35.53","14.67"
"10","013","00","050","0026","0000","529","139","390","5","534","1343","0","39.76","10.35"
"10","013","00","050","0026","0288","529","139","390","5","534","1343","0","39.76","10.35"
"10","013","00","050","0027","0000","474","160","314","7","481","1145","0","42.01","13.97"
"10","013","00","050","0027","0263","474","160","314","7","481","1145","0","42.01","13.97"
"10","013","00","050","0028","0000","354","96","258","2","356","828","0","43.00","11.59"
"10","013","00","050","0028","0264","354","96","258","2","356","828","0","43.00","11.59"
"10","013","00","050","0029","0000","232","93","139","3","235","546","0","43.04","17.03"
"10","013","00","050","0029","0262","232","93","139","3","235","546","0","43.04","17.03"
"10","013","00","050","0030","0000","131","50","81","3","134","394","0","34.01","12.69"
"10","013","00","050","0030","0265","131","50","81","3","134","394","0","34.01","12.69"
"10","013","00","060","0000","0000","10960","4220","6740","101","11061","26079","29381","42.41","16.18"
"10","013","00","060","0001","0000","1107","493","614","13","1120","2655","0","42.18","18.57"
"10","013","00","060","0001","0301","427","141","286","4","431","1004","0","42.93","14.04"
"10","013","00","060","0001","0302","680","352","328","9","689","1651","0","41.73","21.32"
"10","013","00","060","0002","0000","1509","686","823","11","1520","3605","0","42.16","19.03"
"10","013","00","060","0002","0303","769","354","415","6","775","1846","0","41.98","19.18"
"10","013","00","060","0002","0304","740","332","408","5","745","1759","0","42.35","18.87"
"10","013","00","060","0003","0000","889","369","520","5","894","1921","0","46.54","19.21"
"10","013","00","060","0003","0305","433","206","227","3","436","966","0","45.13","21.33"
"10","013","00","060","0003","0306","456","163","293","2","458","955","0","47.96","17.07"
"10","013","00","060","0004","0000","1169","483","686","7","1176","2628","0","44.75","18.38"
"10","013","00","060","0004","0307","355","142","213","2","357","744","0","47.98","19.09"
"10","013","00","060","0004","0308","814","341","473","5","819","1884","0","43.47","18.10"
"10","013","00","060","0005","0000","478","214","264","1","479","1056","0","45.36","20.27"
"10","013","00","060","0005","0309","478","214","264","1","479","1056","0","45.36","20.27"
"10","013","00","060","0006","0000","407","160","247","3","410","859","0","47.73","18.63"
"10","013","00","060","0006","0314","407","160","247","3","410","859","0","47.73","18.63"
"10","013","00","060","0007","0000","471","157","314","1","472","1045","0","45.17","15.02"
"10","013","00","060","0007","0315","471","157","314","1","472","1045","0","45.17","15.02"
"10","013","00","060","0008","0000","664","235","429","10","674","1475","0","45.69","15.93"
"10","013","00","060","0008","0313","664","235","429","10","674","1475","0","45.69","15.93"
"10","013","00","060","0009","0000","702","296","406","3","705","1639","0","43.01","18.06"
"10","013","00","060","0009","0310","702","296","406","3","705","1639","0","43.01","18.06"
"10","013","00","060","0010","0000","523","152","371","7","530","1144","0","46.33","13.29"
"10","013","00","060","0010","0311","523","152","371","7","530","1144","0","46.33","13.29"
"10","013","00","060","0011","0000","269","73","196","4","273","743","0","36.74","9.83"
"10","013","00","060","0011","0312","269","73","196","4","273","743","0","36.74","9.83"
"10","013","00","060","0012","0000","922","229","693","8","930","2349","0","39.59","9.75"
"10","013","00","060","0012","0320","512","138","374","5","517","1218","0","42.45","11.33"
"10","013","00","060","0012","0321","410","91","319","3","413","1131","0","36.52","8.05"
"10","013","00","060","0013","0000","666","191","475","11","677","1719","0","39.38","11.11"
"10","013","00","060","0013","0316","301","88","213","4","305","813","0","37.52","10.82"
"10","013","00","060","0013","0317","365","103","262","7","372","906","0","41.06","11.37"
"10","013","00","060","0014","0000","481","152","329","9","490","1404","0","34.90","10.83"
"10","013","00","060","0014","0318","481","152","329","9","490","1404","0","34.90","10.83"
"10","013","00","060","0015","0000","399","147","252","6","405","1127","0","35.94","13.04"
"10","013","00","060","0015","0319","399","147","252","6","405","1127","0","35.94","13.04"
"10","013","00","060","0016","0000","304","183","121","2","306","710","0","43.10","25.77"
"10","013","00","060","0016","0322","304","183","121","2","306","710","0","43.10","25.77"
"10","013","00","070","0000","0000","4678","1580","3098","40","4718","9689","10711","48.69","16.31"
"10","013","00","070","0001","0000","1003","328","675","10","1013","2127","0","47.63","15.42"
"10","013","00","070","0001","0323","352","103","249","4","356","748","0","47.59","13.77"
"10","013","00","070","0001","0324","651","225","426","6","657","1379","0","47.64","16.32"
"10","013","00","070","0002","0000","436","159","277","3","439","925","0","47.46","17.19"
"10","013","00","070","0002","0325","436","159","277","3","439","925","0","47.46","17.19"
"10","013","00","070","0003","0000","738","254","484","6","744","1484","0","50.13","17.12"
"10","013","00","070","0003","0326","333","113","220","6","339","699","0","48.50","16.17"
"10","013","00","070","0003","0327","405","141","264","0","405","785","0","51.59","17.96"
"10","013","00","070","0004","0000","1176","398","778","14","1190","2480","0","47.98","16.05"
"10","013","00","070","0004","0328","555","171","384","8","563","1186","0","47.47","14.42"
"10","013","00","070","0004","0329","621","227","394","6","627","1294","0","48.45","17.54"
"10","013","00","070","0005","0000","558","168","390","2","560","1156","0","48.44","14.53"
"10","013","00","070","0005","0330","558","168","390","2","560","1156","0","48.44","14.53"
"10","013","00","070","0006","0000","420","162","258","1","421","846","0","49.76","19.15"
"10","013","00","070","0006","0331","420","162","258","1","421","846","0","49.76","19.15"
"10","013","00","070","0007","0000","347","111","236","4","351","671","0","52.31","16.54"
"10","013","00","070","0007","0332","347","111","236","4","351","671","0","52.31","16.54"
"10","013","00","080","0000","0000","8244","2281","5963","90","8334","19063","21784","43.72","11.97"
"10","013","00","080","0001","0000","596","156","440","7","603","1438","0","41.93","10.85"
"10","013","00","080","0001","0333","596","156","440","7","603","1438","0","41.93","10.85"
"10","013","00","080","0002","0000","589","155","434","3","592","1353","0","43.75","11.46"
"10","013","00","080","0002","0334","589","155","434","3","592","1353","0","43.75","11.46"
"10","013","00","080","0003","0000","792","190","602","7","799","1675","0","47.70","11.34"
"10","013","00","080","0003","0335","792","190","602","7","799","1675","0","47.70","11.34"
"10","013","00","080","0004","0000","511","142","369","9","520","1222","0","42.55","11.62"
"10","013","00","080","0004","0337","511","142","369","9","520","1222","0","42.55","11.62"
"10","013","00","080","0005","0000","473","145","328","5","478","1155","0","41.39","12.55"
"10","013","00","080","0005","0336","473","145","328","5","478","1155","0","41.39","12.55"
"10","013","00","080","0006","0000","612","152","460","3","615","1563","0","39.35","9.72"
"10","013","00","080","0006","0345","612","152","460","3","615","1563","0","39.35","9.72"
"10","013","00","080","0007","0000","800","163","637","20","820","1747","0","46.94","9.33"
"10","013","00","080","0007","0347","800","163","637","20","820","1747","0","46.94","9.33"
"10","013","00","080","0008","0000","537","139","398","8","545","1257","0","43.36","11.06"
"10","013","00","080","0008","0346","537","139","398","8","545","1257","0","43.36","11.06"
"10","013","00","080","0009","0000","616","181","435","9","625","1454","0","42.98","12.45"
"10","013","00","080","0009","0348","616","181","435","9","625","1454","0","42.98","12.45"
"10","013","00","080","0010","0000","2009","618","1391","12","2021","4613","0","43.81","13.40"
"10","013","00","080","0010","0340","319","98","221","1","320","666","0","48.05","14.71"
"10","013","00","080","0010","0341","505","127","378","2","507","1081","0","46.90","11.75"
"10","013","00","080","0010","0342","403","125","278","3","406","1001","0","40.56","12.49"
"10","013","00","080","0010","0343","471","158","313","5","476","1140","0","41.75","13.86"
"10","013","00","080","0010","0344","311","110","201","1","312","725","0","43.03","15.17"
"10","013","00","080","0011","0000","709","240","469","7","716","1586","0","45.15","15.13"
"10","013","00","080","0011","0338","416","122","294","4","420","1004","0","41.83","12.15"
"10","013","00","080","0011","0339","293","118","175","3","296","582","0","50.86","20.27"
"10","013","00","090","0000","0000","9173","2775","6398","106","9279","21985","25657","42.21","12.62"
"10","013","00","090","0001","0000","1308","400","908","12","1320","3156","0","41.83","12.67"
"10","013","00","090","0001","0349","652","196","456","1","653","1637","0","39.89","11.97"
"10","013","00","090","0001","0350","656","204","452","11","667","1519","0","43.91","13.43"
"10","013","00","090","0002","0000","473","165","308","8","481","1106","0","43.49","14.92"
"10","013","00","090","0002","0353","473","165","308","8","481","1106","0","43.49","14.92"
"10","013","00","090","0003","0000","342","93","249","2","344","840","0","40.95","11.07"
"10","013","00","090","0003","0354","342","93","249","2","344","840","0","40.95","11.07"
"10","013","00","090","0004","0000","577","185","392","5","582","1323","0","43.99","13.98"
"10","013","00","090","0004","0355","577","185","392","5","582","1323","0","43.99","13.98"
"10","013","00","090","0005","0000","822","240","582","5","827","1992","0","41.52","12.05"
"10","013","00","090","0005","0356","433","121","312","4","437","946","0","46.19","12.79"
"10","013","00","090","0005","0357","389","119","270","1","390","1046","0","37.28","11.38"
"10","013","00","090","0006","0000","599","176","423","4","603","1418","0","42.52","12.41"
"10","013","00","090","0006","0358","599","176","423","4","603","1418","0","42.52","12.41"
"10","013","00","090","0007","0000","637","173","464","8","645","1522","0","42.38","11.37"
"10","013","00","090","0007","0351","637","173","464","8","645","1522","0","42.38","11.37"
"10","013","00","090","0008","0000","594","154","440","7","601","1564","0","38.43","9.85"
"10","013","00","090","0008","0352","594","154","440","7","601","1564","0","38.43","9.85"
"10","013","00","090","0009","0000","655","160","495","11","666","1502","0","44.34","10.65"
"10","013","00","090","0009","0359","132","35","97","3","135","316","0","42.72","11.08"
"10","013","00","090","0009","0360","523","125","398","8","531","1186","0","44.77","10.54"
"10","013","00","090","0010","0000","992","226","766","10","1002","2297","0","43.62","9.84"
"10","013","00","090","0010","0361","401","89","312","7","408","973","0","41.93","9.15"
"10","013","00","090","0010","0362","591","137","454","3","594","1324","0","44.86","10.35"
"10","013","00","090","0011","0000","845","370","475","10","855","1980","0","43.18","18.69"
"10","013","00","090","0011","0363","629","188","441","8","637","1474","0","43.22","12.75"
"10","013","00","090","0011","0364","216","182","34","2","218","506","0","43.08","35.97"
"10","013","00","090","0012","0000","722","245","477","14","736","1815","0","40.55","13.50"
"10","013","00","090","0012","0365","324","97","227","4","328","813","0","40.34","11.93"
"10","013","00","090","0012","0366","398","148","250","10","408","1002","0","40.72","14.77"
"10","013","00","090","0013","0000","350","128","222","3","353","956","0","36.92","13.39"
"10","013","00","090","0013","0367","350","128","222","3","353","956","0","36.92","13.39"
"10","013","00","090","0014","0000","257","60","197","7","264","514","0","51.36","11.67"
"10","013","00","090","0014","0368","257","60","197","7","264","514","0","51.36","11.67"
"10","013","00","100","0000","0000","7681","3028","4653","111","7792","21921","24795","35.55","13.81"
"10","013","00","100","0001","0000","1074","322","752","22","1096","3077","0","35.62","10.46"
"10","013","00","100","0001","0382","348","110","238","12","360","1000","0","36.00","11.00"
"10","013","00","100","0001","0383","358","114","244","7","365","1079","0","33.83","10.57"
"10","013","00","100","0001","0384","368","98","270","3","371","998","0","37.17","9.82"
"10","013","00","100","0002","0000","904","279","625","10","914","2767","0","33.03","10.08"
"10","013","00","100","0002","0376","310","93","217","6","316","926","0","34.13","10.04"
"10","013","00","100","0002","0377","362","120","242","3","365","1031","0","35.40","11.64"
"10","013","00","100","0002","0378","232","66","166","1","233","810","0","28.77","8.15"
"10","013","00","100","0003","0000","580","259","321","9","589","1800","0","32.72","14.39"
"10","013","00","100","0003","0369","298","129","169","7","305","907","0","33.63","14.22"
"10","013","00","100","0003","0370","282","130","152","2","284","893","0","31.80","14.56"
"10","013","00","100","0004","0000","784","359","425","9","793","2311","0","34.31","15.53"
"10","013","00","100","0004","0371","357","180","177","7","364","1105","0","32.94","16.29"
"10","013","00","100","0004","0372","427","179","248","2","429","1206","0","35.57","14.84"
"10","013","00","100","0005","0000","555","258","297","11","566","1683","0","33.63","15.33"
"10","013","00","100","0005","0373","262","117","145","3","265","718","0","36.91","16.30"
"10","013","00","100","0005","0374","293","141","152","8","301","965","0","31.19","14.61"
"10","013","00","100","0006","0000","352","187","165","4","356","1022","0","34.83","18.30"
"10","013","00","100","0006","0375","352","187","165","4","356","1022","0","34.83","18.30"
"10","013","00","100","0007","0000","608","229","379","10","618","1803","0","34.28","12.70"
"10","013","00","100","0007","0379","301","104","197","7","308","874","0","35.24","11.90"
"10","013","00","100","0007","0380","307","125","182","3","310","929","0","33.37","13.46"
"10","013","00","100","0008","0000","213","63","150","3","216","537","0","40.22","11.73"
"10","013","00","100","0008","0391","213","63","150","3","216","537","0","40.22","11.73"
"10","013","00","100","0009","0000","345","146","199","6","351","908","0","38.66","16.08"
"10","013","00","100","0009","0381","345","146","199","6","351","908","0","38.66","16.08"
"10","013","00","100","0010","0000","640","247","393","8","648","1606","0","40.35","15.38"
"10","013","00","100","0010","0389","334","138","196","7","341","808","0","42.20","17.08"
"10","013","00","100","0010","0390","306","109","197","1","307","798","0","38.47","13.66"
"10","013","00","100","0011","0000","1245","523","722","14","1259","3450","0","36.49","15.16"
"10","013","00","100","0011","0385","386","169","217","4","390","1097","0","35.55","15.41"
"10","013","00","100","0011","0386","431","187","244","5","436","1139","0","38.28","16.42"
"10","013","00","100","0011","0387","428","167","261","5","433","1214","0","35.67","13.76"
"10","013","00","100","0012","0000","381","156","225","5","386","957","0","40.33","16.30"
"10","013","00","100","0012","0388","381","156","225","5","386","957","0","40.33","16.30"
"10","013","00","110","0000","0000","8508","2183","6325","125","8633","21162","23583","40.79","10.32"
"10","013","00","110","0001","0000","960","230","730","9","969","2093","0","46.30","10.99"
"10","013","00","110","0001","0392","428","111","317","3","431","877","0","49.14","12.66"
"10","013","00","110","0001","0393","532","119","413","6","538","1216","0","44.24","9.79"
"10","013","00","110","0002","0000","536","121","415","9","545","1236","0","44.09","9.79"
"10","013","00","110","0002","0394","536","121","415","9","545","1236","0","44.09","9.79"
"10","013","00","110","0003","0000","330","70","260","2","332","707","0","46.96","9.90"
"10","013","00","110","0003","0395","330","70","260","2","332","707","0","46.96","9.90"
"10","013","00","110","0004","0000","239","57","182","6","245","578","0","42.39","9.86"
"10","013","00","110","0004","0396","239","57","182","6","245","578","0","42.39","9.86"
"10","013","00","110","0005","0000","440","117","323","5","445","995","0","44.72","11.76"
"10","013","00","110","0005","0397","440","117","323","5","445","995","0","44.72","11.76"
"10","013","00","110","0006","0000","437","91","346","11","448","1135","0","39.47","8.02"
"10","013","00","110","0006","0398","437","91","346","11","448","1135","0","39.47","8.02"
"10","013","00","110","0007","0000","253","68","185","2","255","592","0","43.07","11.49"
"10","013","00","110","0007","0399","253","68","185","2","255","592","0","43.07","11.49"
"10","013","00","110","0008","0000","310","53","257","5","315","727","0","43.33","7.29"
"10","013","00","110","0008","0400","310","53","257","5","315","727","0","43.33","7.29"
"10","013","00","110","0009","0000","212","68","144","5","217","618","0","35.11","11.00"
"10","013","00","110","0009","0401","212","68","144","5","217","618","0","35.11","11.00"
"10","013","00","110","0010","0000","482","129","353","2","484","1183","0","40.91","10.90"
"10","013","00","110","0010","0402","482","129","353","2","484","1183","0","40.91","10.90"
"10","013","00","110","0011","0000","505","132","373","9","514","1416","0","36.30","9.32"
"10","013","00","110","0011","0403","264","59","205","4","268","731","0","36.66","8.07"
"10","013","00","110","0011","0404","241","73","168","5","246","685","0","35.91","10.66"
"10","013","00","110","0012","0000","656","197","459","10","666","1828","0","36.43","10.78"
"10","013","00","110","0012","0405","337","101","236","6","343","897","0","38.24","11.26"
"10","013","00","110","0012","0406","319","96","223","4","323","931","0","34.69","10.31"
"10","013","00","110","0013","0000","462","131","331","12","474","1231","0","38.51","10.64"
"10","013","00","110","0013","0407","462","131","331","12","474","1231","0","38.51","10.64"
"10","013","00","110","0014","0000","437","119","318","5","442","1041","0","42.46","11.43"
"10","013","00","110","0014","0408","437","119","318","5","442","1041","0","42.46","11.43"
"10","013","00","110","0015","0000","359","110","249","6","365","1085","0","33.64","10.14"
"10","013","00","110","0015","0409","359","110","249","6","365","1085","0","33.64","10.14"
"10","013","00","110","0016","0000","396","99","297","5","401","988","0","40.59","10.02"
"10","013","00","110","0016","0410","396","99","297","5","401","988","0","40.59","10.02"
"10","013","00","110","0017","0000","411","102","309","8","419","1054","0","39.75","9.68"
"10","013","00","110","0017","0411","411","102","309","8","419","1054","0","39.75","9.68"
"10","013","00","110","0018","0000","538","148","390","5","543","1172","0","46.33","12.63"
"10","013","00","110","0018","0412","353","75","278","3","356","698","0","51.00","10.74"
"10","013","00","110","0018","0413","185","73","112","2","187","474","0","39.45","15.40"
"10","013","00","110","0019","0000","545","141","404","9","554","1483","0","37.36","9.51"
"10","013","00","110","0019","0414","253","62","191","4","257","668","0","38.47","9.28"
"10","013","00","110","0019","0415","292","79","213","5","297","815","0","36.44","9.69"
"10","013","00","120","0000","0000","7206","2174","5032","86","7292","17504","20028","41.66","12.42"
"10","013","00","120","0001","0000","507","141","366","5","512","1171","0","43.72","12.04"
"10","013","00","120","0001","0416","507","141","366","5","512","1171","0","43.72","12.04"
"10","013","00","120","0002","0000","312","99","213","2","314","715","0","43.92","13.85"
"10","013","00","120","0002","0417","312","99","213","2","314","715","0","43.92","13.85"
"10","013","00","120","0003","0000","767","241","526","7","774","1663","0","46.54","14.49"
"10","013","00","120","0003","0418","397","119","278","2","399","912","0","43.75","13.05"
"10","013","00","120","0003","0419","370","122","248","5","375","751","0","49.93","16.25"
"10","013","00","120","0004","0000","407","114","293","3","410","885","0","46.33","12.88"
"10","013","00","120","0004","0420","407","114","293","3","410","885","0","46.33","12.88"
"10","013","00","120","0005","0000","273","67","206","3","276","530","0","52.08","12.64"
"10","013","00","120","0005","0421","273","67","206","3","276","530","0","52.08","12.64"
"10","013","00","120","0006","0000","485","178","307","7","492","1083","0","45.43","16.44"
"10","013","00","120","0006","0422","485","178","307","7","492","1083","0","45.43","16.44"
"10","013","00","120","0007","0000","477","158","319","6","483","990","0","48.79","15.96"
"10","013","00","120","0007","0423","477","158","319","6","483","990","0","48.79","15.96"
"10","013","00","120","0008","0000","580","195","385","7","587","1392","0","42.17","14.01"
"10","013","00","120","0008","0424","580","195","385","7","587","1392","0","42.17","14.01"
"10","013","00","120","0009","0000","785","204","581","10","795","1976","0","40.23","10.32"
"10","013","00","120","0009","0427","384","101","283","1","385","986","0","39.05","10.24"
"10","013","00","120","0009","0428","401","103","298","9","410","990","0","41.41","10.40"
"10","013","00","120","0010","0000","563","195","368","8","571","1657","0","34.46","11.77"
"10","013","00","120","0010","0425","290","98","192","4","294","829","0","35.46","11.82"
"10","013","00","120","0010","0426","273","97","176","4","277","828","0","33.45","11.71"
"10","013","00","120","0011","0000","622","138","484","6","628","1673","0","37.54","8.25"
"10","013","00","120","0011","0429","381","77","304","2","383","1043","0","36.72","7.38"
"10","013","00","120","0011","0430","241","61","180","4","245","630","0","38.89","9.68"
"10","013","00","120","0012","0000","530","190","340","2","532","1374","0","38.72","13.83"
"10","013","00","120","0012","0431","530","190","340","2","532","1374","0","38.72","13.83"
"10","013","00","120","0013","0000","475","106","369","11","486","1233","0","39.42","8.60"
"10","013","00","120","0013","0432","475","106","369","11","486","1233","0","39.42","8.60"
"10","013","00","120","0014","0000","423","148","275","9","432","1162","0","37.18","12.74"
"10","013","00","120","0014","0433","191","94","97","3","194","588","0","32.99","15.99"
"10","013","00","120","0014","0434","232","54","178","6","238","574","0","41.46","9.41"
"10","013","00","130","0000","0000","19108","6796","12312","194","19302","46892","52910","41.16","14.49"
"10","013","00","130","0001","0000","1623","649","974","10","1633","3943","0","41.42","16.46"
"10","013","00","130","0001","0435","550","209","341","3","553","1228","0","45.03","17.02"
"10","013","00","130","0001","0436","526","206","320","4","530","1259","0","42.10","16.36"
"10","013","00","130","0001","0437","547","234","313","3","550","1456","0","37.77","16.07"
"10","013","00","130","0002","0000","1287","474","813","10","1297","3127","0","41.48","15.16"
"10","013","00","130","0002","0438","595","200","395","6","601","1454","0","41.33","13.76"
"10","013","00","130","0002","0439","692","274","418","4","696","1673","0","41.60","16.38"
"10","013","00","130","0003","0000","596","210","386","8","604","1261","0","47.90","16.65"
"10","013","00","130","0003","0440","596","210","386","8","604","1261","0","47.90","16.65"
"10","013","00","130","0004","0000","247","79","168","2","249","565","0","44.07","13.98"
"10","013","00","130","0004","0441","247","79","168","2","249","565","0","44.07","13.98"
"10","013","00","130","0005","0000","926","341","585","10","936","2169","0","43.15","15.72"
"10","013","00","130","0005","0442","475","169","306","4","479","1113","0","43.04","15.18"
"10","013","00","130","0005","0443","451","172","279","6","457","1056","0","43.28","16.29"
"10","013","00","130","0006","0000","1142","454","688","3","1145","2795","0","40.97","16.24"
"10","013","00","130","0006","0444","567","191","376","2","569","1415","0","40.21","13.50"
"10","013","00","130","0006","0445","575","263","312","1","576","1380","0","41.74","19.06"
"10","013","00","130","0007","0000","1879","693","1186","14","1893","4356","0","43.46","15.91"
"10","013","00","130","0007","0446","668","259","409","4","672","1391","0","48.31","18.62"
"10","013","00","130","0007","0447","580","189","391","5","585","1453","0","40.26","13.01"
"10","013","00","130","0007","0448","631","245","386","5","636","1512","0","42.06","16.20"
"10","013","00","130","0008","0000","1248","447","801","12","1260","3045","0","41.38","14.68"
"10","013","00","130","0008","0449","557","193","364","3","560","1393","0","40.20","13.85"
"10","013","00","130","0008","0450","691","254","437","9","700","1652","0","42.37","15.38"
"10","013","00","130","0009","0000","767","259","508","2","769","1580","0","48.67","16.39"
"10","013","00","130","0009","0451","344","123","221","2","346","733","0","47.20","16.78"
"10","013","00","130","0009","0452","423","136","287","0","423","847","0","49.94","16.06"
"10","013","00","130","0010","0000","827","220","607","6","833","1847","0","45.10","11.91"
"10","013","00","130","0010","0453","403","110","293","3","406","939","0","43.24","11.71"
"10","013","00","130","0010","0454","424","110","314","3","427","908","0","47.03","12.11"
"10","013","00","130","0011","0000","796","256","540","10","806","1835","0","43.92","13.95"
"10","013","00","130","0011","0455","230","75","155","4","234","537","0","43.58","13.97"
"10","013","00","130","0011","0456","566","181","385","6","572","1298","0","44.07","13.94"
"10","013","00","130","0012","0000","1191","349","842","15","1206","2856","0","42.23","12.22"
"10","013","00","130","0012","0457","580","178","402","8","588","1283","0","45.83","13.87"
"10","013","00","130","0012","0458","611","171","440","7","618","1573","0","39.29","10.87"
"10","013","00","130","0013","0000","479","140","339","7","486","920","0","52.83","15.22"
"10","013","00","130","0013","0459","479","140","339","7","486","920","0","52.83","15.22"
"10","013","00","130","0014","0000","497","146","351","7","504","1079","0","46.71","13.53"
"10","013","00","130","0014","0460","497","146","351","7","504","1079","0","46.71","13.53"
"10","013","00","130","0015","0000","753","228","525","8","761","2282","0","33.35","9.99"
"10","013","00","130","0015","0461","367","109","258","5","372","1082","0","34.38","10.07"
"10","013","00","130","0015","0462","386","119","267","3","389","1200","0","32.42","9.92"
"10","013","00","130","0016","0000","554","126","428","5","559","1517","0","36.85","8.31"
"10","013","00","130","0016","0463","554","126","428","5","559","1517","0","36.85","8.31"
"10","013","00","130","0017","0000","885","396","489","11","896","2397","0","37.38","16.52"
"10","013","00","130","0017","0464","481","205","276","7","488","1200","0","40.67","17.08"
"10","013","00","130","0017","0465","404","191","213","4","408","1197","0","34.09","15.96"
"10","013","00","130","0018","0000","768","400","368","9","777","2350","0","33.06","17.02"
"10","013","00","130","0018","0466","431","221","210","6","437","1325","0","32.98","16.68"
"10","013","00","130","0018","0467","337","179","158","3","340","1025","0","33.17","17.46"
"10","013","00","130","0019","0000","362","139","223","6","368","782","0","47.06","17.77"
"10","013","00","130","0019","0468","362","139","223","6","368","782","0","47.06","17.77"
"10","013","00","130","0020","0000","702","270","432","10","712","1726","0","41.25","15.64"
"10","013","00","130","0020","0469","358","95","263","7","365","878","0","41.57","10.82"
"10","013","00","130","0020","0470","344","175","169","3","347","848","0","40.92","20.64"
"10","013","00","130","0021","0000","838","233","605","16","854","2405","0","35.51","9.69"
"10","013","00","130","0021","0471","434","131","303","4","438","1212","0","36.14","10.81"
"10","013","00","130","0021","0472","404","102","302","12","416","1193","0","34.87","8.55"
"10","013","00","130","0022","0000","411","144","267","8","419","1260","0","33.25","11.43"
"10","013","00","130","0022","0473","411","144","267","8","419","1260","0","33.25","11.43"
"10","013","00","130","0023","0000","330","143","187","5","335","795","0","42.14","17.99"
"10","013","00","130","0023","0474","330","143","187","5","335","795","0","42.14","17.99"
"10","013","00","140","0000","0000","6730","2276","4454","69","6799","14893","16409","45.65","15.28"
"10","013","00","140","0001","0000","662","232","430","3","665","1447","0","45.96","16.03"
"10","013","00","140","0001","0475","662","232","430","3","665","1447","0","45.96","16.03"
"10","013","00","140","0002","0000","408","106","302","6","414","868","0","47.70","12.21"
"10","013","00","140","0002","0476","408","106","302","6","414","868","0","47.70","12.21"
"10","013","00","140","0003","0000","334","113","221","4","338","676","0","50.00","16.72"
"10","013","00","140","0003","0477","334","113","221","4","338","676","0","50.00","16.72"
"10","013","00","140","0004","0000","277","88","189","4","281","577","0","48.70","15.25"
"10","013","00","140","0004","0478","277","88","189","4","281","577","0","48.70","15.25"
"10","013","00","140","0005","0000","574","167","407","3","577","1289","0","44.76","12.96"
"10","013","00","140","0005","0479","574","167","407","3","577","1289","0","44.76","12.96"
"10","013","00","140","0006","0000","473","154","319","4","477","969","0","49.23","15.89"
"10","013","00","140","0006","0480","473","154","319","4","477","969","0","49.23","15.89"
"10","013","00","140","0007","0000","314","114","200","4","318","621","0","51.21","18.36"
"10","013","00","140","0007","0481","314","114","200","4","318","621","0","51.21","18.36"
"10","013","00","140","0008","0000","252","73","179","2","254","459","0","55.34","15.90"
"10","013","00","140","0008","0482","252","73","179","2","254","459","0","55.34","15.90"
"10","013","00","140","0009","0000","1097","400","697","10","1107","2368","0","46.75","16.89"
"10","013","00","140","0009","0483","552","221","331","6","558","1201","0","46.46","18.40"
"10","013","00","140","0009","0484","545","179","366","4","549","1167","0","47.04","15.34"
"10","013","00","140","0010","0000","238","77","161","3","241","477","0","50.52","16.14"
"10","013","00","140","0010","0485","238","77","161","3","241","477","0","50.52","16.14"
"10","013","00","140","0011","0000","352","125","227","1","353","881","0","40.07","14.19"
"10","013","00","140","0011","0486","352","125","227","1","353","881","0","40.07","14.19"
"10","013","00","140","0012","0000","360","117","243","6","366","796","0","45.98","14.70"
"10","013","00","140","0012","0487","360","117","243","6","366","796","0","45.98","14.70"
"10","013","00","140","0013","0000","429","159","270","9","438","1099","0","39.85","14.47"
"10","013","00","140","0013","0488","429","159","270","9","438","1099","0","39.85","14.47"
"10","013","00","140","0014","0000","501","154","347","3","504","1186","0","42.50","12.98"
"10","013","00","140","0014","0489","501","154","347","3","504","1186","0","42.50","12.98"
"10","013","00","140","0015","0000","459","197","262","7","466","1180","0","39.49","16.69"
"10","013","00","140","0015","0490","459","197","262","7","466","1180","0","39.49","16.69"
"10","013","00","150","0000","0000","3367","1300","2067","54","3421","8649","9464","39.55","15.03"
"10","013","00","150","0001","0000","830","372","458","9","839","1959","0","42.83","18.99"
"10","013","00","150","0001","0491","319","144","175","1","320","717","0","44.63","20.08"
"10","013","00","150","0001","0492","372","159","213","8","380","938","0","40.51","16.95"
"10","013","00","150","0001","0493","139","69","70","0","139","304","0","45.72","22.70"
"10","013","00","150","0002","0000","529","197","332","5","534","1030","0","51.84","19.13"
"10","013","00","150","0002","0494","361","127","234","5","366","712","0","51.40","17.84"
"10","013","00","150","0002","0495","168","70","98","0","168","318","0","52.83","22.01"
"10","013","00","150","0003","0000","379","162","217","13","392","860","0","45.58","18.84"
"10","013","00","150","0003","0496","379","162","217","13","392","860","0","45.58","18.84"
"10","013","00","150","0004","0000","341","107","234","3","344","734","0","46.87","14.58"
"10","013","00","150","0004","0497","341","107","234","3","344","734","0","46.87","14.58"
"10","013","00","150","0005","0000","566","243","323","6","572","1713","0","33.39","14.19"
"10","013","00","150","0005","0498","161","52","109","1","162","368","0","44.02","14.13"
"10","013","00","150","0005","0499","217","102","115","4","221","665","0","33.23","15.34"
"10","013","00","150","0005","0500","188","89","99","1","189","680","0","27.79","13.09"
"10","013","00","150","0006","0000","357","124","233","11","368","1100","0","33.45","11.27"
"10","013","00","150","0006","0502","164","56","108","6","170","524","0","32.44","10.69"
"10","013","00","150","0006","0503","193","68","125","5","198","576","0","34.38","11.81"
"10","013","00","150","0007","0000","365","95","270","7","372","1253","0","29.69","7.58"
"10","013","00","150","0007","0501","365","95","270","7","372","1253","0","29.69","7.58"
"10","013","00","160","0000","0000","7952","2905","5047","89","8041","20786","23466","38.68","13.98"
"10","013","00","160","0001","0000","461","221","240","5","466","1196","0","38.96","18.48"
"10","013","00","160","0001","0504","461","221","240","5","466","1196","0","38.96","18.48"
"10","013","00","160","0002","0000","323","183","140","4","327","865","0","37.80","21.16"
"10","013","00","160","0002","0505","323","183","140","4","327","865","0","37.80","21.16"
"10","013","00","160","0003","0000","352","110","242","4","356","906","0","39.29","12.14"
"10","013","00","160","0003","0506","352","110","242","4","356","906","0","39.29","12.14"
"10","013","00","160","0004","0000","249","76","173","4","253","573","0","44.15","13.26"
"10","013","00","160","0004","0507","249","76","173","4","253","573","0","44.15","13.26"
"10","013","00","160","0005","0000","614","208","406","7","621","1578","0","39.35","13.18"
"10","013","00","160","0005","0508","314","108","206","3","317","834","0","38.01","12.95"
"10","013","00","160","0005","0509","300","100","200","4","304","744","0","40.86","13.44"
"10","013","00","160","0006","0000","1530","453","1077","20","1550","4151","0","37.34","10.91"
"10","013","00","160","0006","0510","338","100","238","4","342","1005","0","34.03","9.95"
"10","013","00","160","0006","0511","398","107","291","5","403","1033","0","39.01","10.36"
"10","013","00","160","0006","0512","398","121","277","8","406","1079","0","37.63","11.21"
"10","013","00","160","0006","0513","396","125","271","3","399","1034","0","38.59","12.09"
"10","013","00","160","0007","0000","801","259","542","8","809","1866","0","43.35","13.88"
"10","013","00","160","0007","0514","390","120","270","5","395","921","0","42.89","13.03"
"10","013","00","160","0007","0515","411","139","272","3","414","945","0","43.81","14.71"
"10","013","00","160","0008","0000","653","244","409","1","654","1416","0","46.19","17.23"
"10","013","00","160","0008","0516","334","124","210","0","334","694","0","48.13","17.87"
"10","013","00","160","0008","0517","319","120","199","1","320","722","0","44.32","16.62"
"10","013","00","160","0009","0000","827","308","519","9","836","2027","0","41.24","15.19"
"10","013","00","160","0009","0518","398","144","254","6","404","987","0","40.93","14.59"
"10","013","00","160","0009","0519","429","164","265","3","432","1040","0","41.54","15.77"
"10","013","00","160","0010","0000","250","64","186","3","253","695","0","36.40","9.21"
"10","013","00","160","0010","0520","250","64","186","3","253","695","0","36.40","9.21"
"10","013","00","160","0011","0000","235","90","145","2","237","874","0","27.12","10.30"
"10","013","00","160","0011","0521","235","90","145","2","237","874","0","27.12","10.30"
"10","013","00","160","0012","0000","290","127","163","2","292","927","0","31.50","13.70"
"10","013","00","160","0012","0526","290","127","163","2","292","927","0","31.50","13.70"
"10","013","00","160","0013","0000","120","57","63","2","122","428","0","28.50","13.32"
"10","013","00","160","0013","0527","120","57","63","2","122","428","0","28.50","13.32"
"10","013","00","160","0014","0000","1014","426","588","16","1030","2680","0","38.43","15.90"
"10","013","00","160","0014","0522","368","153","215","6","374","963","0","38.84","15.89"
"10","013","00","160","0014","0523","294","126","168","6","300","792","0","37.88","15.91"
"10","013","00","160","0014","0524","352","147","205","4","356","925","0","38.49","15.89"
"10","013","00","160","0015","0000","233","79","154","2","235","604","0","38.91","13.08"
"10","013","00","160","0015","0525","233","79","154","2","235","604","0","38.91","13.08"
"10","013","00","170","0000","0000","11616","3219","8397","150","11766","29974","33639","39.25","10.74"
"10","013","00","170","0001","0000","669","162","507","9","678","1629","0","41.62","9.94"
"10","013","00","170","0001","0528","333","88","245","3","336","809","0","41.53","10.88"
"10","013","00","170","0001","0529","336","74","262","6","342","820","0","41.71","9.02"
"10","013","00","170","0002","0000","911","272","639","8","919","2479","0","37.07","10.97"
"10","013","00","170","0002","0530","446","138","308","2","448","1212","0","36.96","11.39"
"10","013","00","170","0002","0531","465","134","331","6","471","1267","0","37.17","10.58"
"10","013","00","170","0003","0000","818","216","602","10","828","2135","0","38.78","10.12"
"10","013","00","170","0003","0532","383","100","283","3","386","1052","0","36.69","9.51"
"10","013","00","170","0003","0533","435","116","319","7","442","1083","0","40.81","10.71"
"10","013","00","170","0004","0000","306","109","197","2","308","807","0","38.17","13.51"
"10","013","00","170","0004","0534","306","109","197","2","308","807","0","38.17","13.51"
"10","013","00","170","0005","0000","362","122","240","1","363","820","0","44.27","14.88"
"10","013","00","170","0005","0535","362","122","240","1","363","820","0","44.27","14.88"
"10","013","00","170","0006","0000","826","299","527","13","839","2294","0","36.57","13.03"
"10","013","00","170","0006","0536","419","153","266","7","426","1185","0","35.95","12.91"
"10","013","00","170","0006","0537","407","146","261","6","413","1109","0","37.24","13.17"
"10","013","00","170","0007","0000","878","314","564","11","889","2190","0","40.59","14.34"
"10","013","00","170","0007","0538","423","186","237","3","426","1074","0","39.66","17.32"
"10","013","00","170","0007","0539","455","128","327","8","463","1116","0","41.49","11.47"
"10","013","00","170","0008","0000","501","143","358","8","509","1194","0","42.63","11.98"
"10","013","00","170","0008","0542","501","143","358","8","509","1194","0","42.63","11.98"
"10","013","00","170","0009","0000","901","217","684","7","908","2092","0","43.40","10.37"
"10","013","00","170","0009","0543","462","94","368","4","466","1058","0","44.05","8.88"
"10","013","00","170","0009","0544","439","123","316","3","442","1034","0","42.75","11.90"
"10","013","00","170","0010","0000","640","110","530","12","652","1553","0","41.98","7.08"
"10","013","00","170","0010","0545","329","49","280","3","332","843","0","39.38","5.81"
"10","013","00","170","0010","0546","311","61","250","9","320","710","0","45.07","8.59"
"10","013","00","170","0011","0000","566","136","430","10","576","1368","0","42.11","9.94"
"10","013","00","170","0011","0547","566","136","430","10","576","1368","0","42.11","9.94"
"10","013","00","170","0012","0000","797","254","543","10","807","2061","0","39.16","12.32"
"10","013","00","170","0012","0540","377","148","229","4","381","994","0","38.33","14.89"
"10","013","00","170","0012","0541","420","106","314","6","426","1067","0","39.93","9.93"
"10","013","00","170","0013","0000","1055","340","715","15","1070","2733","0","39.15","12.44"
"10","013","00","170","0013","0548","349","97","252","5","354","856","0","41.36","11.33"
"10","013","00","170","0013","0549","367","98","269","5","372","935","0","39.79","10.48"
"10","013","00","170","0013","0550","339","145","194","5","344","942","0","36.52","15.39"
"10","013","00","170","0014","0000","1611","373","1238","21","1632","4335","0","37.65","8.60"
"10","013","00","170","0014","0551","484","96","388","1","485","1398","0","34.69","6.87"
"10","013","00","170","0014","0552","671","160","511","8","679","1695","0","40.06","9.44"
"10","013","00","170","0014","0553","456","117","339","12","468","1242","0","37.68","9.42"
"10","013","00","170","0015","0000","775","152","623","13","788","2284","0","34.50","6.65"
"10","013","00","170","0015","0554","388","79","309","6","394","1080","0","36.48","7.31"
"10","013","00","170","0015","0555","387","73","314","7","394","1204","0","32.72","6.06"
"10","013","00","180","0000","0000","4688","1504","3184","51","4739","11939","15223","39.69","12.60"
"10","013","00","180","0001","0000","843","295","548","9","852","2220","0","38.38","13.29"
"10","013","00","180","0001","0556","457","149","308","3","460","1203","0","38.24","12.39"
"10","013","00","180","0001","0557","386","146","240","6","392","1017","0","38.54","14.36"
"10","013","00","180","0002","0000","794","304","490","8","802","1996","0","40.18","15.23"
"10","013","00","180","0002","0558","297","125","172","4","301","778","0","38.69","16.07"
"10","013","00","180","0002","0559","497","179","318","4","501","1218","0","41.13","14.70"
"10","013","00","180","0003","0000","492","172","320","5","497","1200","0","41.42","14.33"
"10","013","00","180","0003","0561","492","172","320","5","497","1200","0","41.42","14.33"
"10","013","00","180","0004","0000","504","136","368","9","513","1272","0","40.33","10.69"
"10","013","00","180","0004","0560","504","136","368","9","513","1272","0","40.33","10.69"
"10","013","00","180","0005","0000","369","112","257","4","373","1046","0","35.66","10.71"
"10","013","00","180","0005","0562","369","112","257","4","373","1046","0","35.66","10.71"
"10","013","00","180","0006","0000","609","189","420","6","615","1466","0","41.95","12.89"
"10","013","00","180","0006","0563","311","100","211","2","313","758","0","41.29","13.19"
"10","013","00","180","0006","0564","298","89","209","4","302","708","0","42.66","12.57"
"10","013","00","180","0007","0000","356","117","239","2","358","905","0","39.56","12.93"
"10","013","00","180","0007","0565","356","117","239","2","358","905","0","39.56","12.93"
"10","013","00","180","0008","0000","721","179","542","8","729","1834","0","39.75","9.76"
"10","013","00","180","0008","0566","324","78","246","4","328","874","0","37.53","8.92"
"10","013","00","180","0008","0567","397","101","296","4","401","960","0","41.77","10.52"
"10","013","00","190","0000","0000","6280","1979","4301","80","6360","15160","17145","41.95","13.05"
"10","013","00","190","0001","0000","623","191","432","7","630","1392","0","45.26","13.72"
"10","013","00","190","0001","0568","295","94","201","4","299","657","0","45.51","14.31"
"10","013","00","190","0001","0569","328","97","231","3","331","735","0","45.03","13.20"
"10","013","00","190","0002","0000","622","187","435","7","629","1509","0","41.68","12.39"
"10","013","00","190","0002","0570","356","103","253","4","360","856","0","42.06","12.03"
"10","013","00","190","0002","0571","266","84","182","3","269","653","0","41.19","12.86"
"10","013","00","190","0003","0000","690","211","479","10","700","1603","0","43.67","13.16"
"10","013","00","190","0003","0576","363","118","245","4","367","770","0","47.66","15.32"
"10","013","00","190","0003","0577","327","93","234","6","333","833","0","39.98","11.16"
"10","013","00","190","0004","0000","321","121","200","5","326","690","0","47.25","17.54"
"10","013","00","190","0004","0575","321","121","200","5","326","690","0","47.25","17.54"
"10","013","00","190","0005","0000","1375","415","960","15","1390","3098","0","44.87","13.40"
"10","013","00","190","0005","0572","482","150","332","3","485","1015","0","47.78","14.78"
"10","013","00","190","0005","0573","484","136","348","7","491","1126","0","43.61","12.08"
"10","013","00","190","0005","0574","409","129","280","5","414","957","0","43.26","13.48"
"10","013","00","190","0006","0000","641","241","400","13","654","1761","0","37.14","13.69"
"10","013","00","190","0006","0580","292","104","188","2","294","762","0","38.58","13.65"
"10","013","00","190","0006","0581","349","137","212","11","360","999","0","36.04","13.71"
"10","013","00","190","0007","0000","433","150","283","5","438","1241","0","35.29","12.09"
"10","013","00","190","0007","0579","433","150","283","5","438","1241","0","35.29","12.09"
"10","013","00","190","0008","0000","353","106","247","2","355","895","0","39.66","11.84"
"10","013","00","190","0008","0578","353","106","247","2","355","895","0","39.66","11.84"
"10","013","00","190","0009","0000","759","213","546","9","768","1885","0","40.74","11.30"
"10","013","00","190","0009","0582","480","148","332","6","486","1120","0","43.39","13.21"
"10","013","00","190","0009","0583","279","65","214","3","282","765","0","36.86","8.50"
"10","013","00","190","0010","0000","463","144","319","7","470","1086","0","43.28","13.26"
"10","013","00","190","0010","0584","463","144","319","7","470","1086","0","43.28","13.26"
"10","013","00","200","0000","0000","3883","1287","2596","39","3922","9254","10249","42.38","13.91"
"10","013","00","200","0001","0000","691","229","462","4","695","1652","0","42.07","13.86"
"10","013","00","200","0001","0585","353","122","231","2","355","844","0","42.06","14.45"
"10","013","00","200","0001","0586","338","107","231","2","340","808","0","42.08","13.24"
"10","013","00","200","0002","0000","395","140","255","4","399","908","0","43.94","15.42"
"10","013","00","200","0002","0587","395","140","255","4","399","908","0","43.94","15.42"
"10","013","00","200","0003","0000","221","86","135","2","223","487","0","45.79","17.66"
"10","013","00","200","0003","0590","221","86","135","2","223","487","0","45.79","17.66"
"10","013","00","200","0004","0000","310","182","128","1","311","673","0","46.21","27.04"
"10","013","00","200","0004","0591","310","182","128","1","311","673","0","46.21","27.04"
"10","013","00","200","0005","0000","366","126","240","3","369","1011","0","36.50","12.46"
"10","013","00","200","0005","0588","366","126","240","3","369","1011","0","36.50","12.46"
"10","013","00","200","0006","0000","362","133","229","6","368","965","0","38.13","13.78"
"10","013","00","200","0006","0589","362","133","229","6","368","965","0","38.13","13.78"
"10","013","00","200","0007","0000","455","165","290","5","460","1028","0","44.75","16.05"
"10","013","00","200","0007","0592","455","165","290","5","460","1028","0","44.75","16.05"
"10","013","00","200","0008","0000","424","70","354","7","431","1050","0","41.05","6.67"
"10","013","00","200","0008","0593","424","70","354","7","431","1050","0","41.05","6.67"
"10","013","00","200","0009","0000","422","96","326","4","426","965","0","44.15","9.95"
"10","013","00","200","0009","0594","422","96","326","4","426","965","0","44.15","9.95"
"10","013","00","200","0010","0000","237","60","177","3","240","515","0","46.60","11.65"
"10","013","00","200","0010","0595","237","60","177","3","240","515","0","46.60","11.65"
"10","013","00","210","0000","0000","6418","1995","4423","79","6497","16509","18414","39.35","12.08"
"10","013","00","210","0001","0000","586","210","376","4","590","1467","0","40.22","14.31"
"10","013","00","210","0001","0596","586","210","376","4","590","1467","0","40.22","14.31"
"10","013","00","210","0002","0000","540","193","347","8","548","1302","0","42.09","14.82"
"10","013","00","210","0002","0597","540","193","347","8","548","1302","0","42.09","14.82"
"10","013","00","210","0003","0000","344","96","248","1","345","733","0","47.07","13.10"
"10","013","00","210","0003","0598","344","96","248","1","345","733","0","47.07","13.10"
"10","013","00","210","0004","0000","692","235","457","4","696","1793","0","38.82","13.11"
"10","013","00","210","0004","0599","350","107","243","3","353","926","0","38.12","11.56"
"10","013","00","210","0004","0600","342","128","214","1","343","867","0","39.56","14.76"
"10","013","00","210","0005","0000","800","205","595","9","809","1922","0","42.09","10.67"
"10","013","00","210","0005","0601","380","103","277","6","386","928","0","41.59","11.10"
"10","013","00","210","0005","0602","420","102","318","3","423","994","0","42.56","10.26"
"10","013","00","210","0006","0000","791","193","598","15","806","2056","0","39.20","9.39"
"10","013","00","210","0006","0603","342","74","268","5","347","839","0","41.36","8.82"
"10","013","00","210","0006","0604","449","119","330","10","459","1217","0","37.72","9.78"
"10","013","00","210","0007","0000","401","118","283","9","410","936","0","43.80","12.61"
"10","013","00","210","0007","0605","401","118","283","9","410","936","0","43.80","12.61"
"10","013","00","210","0008","0000","270","86","184","7","277","674","0","41.10","12.76"
"10","013","00","210","0008","0606","270","86","184","7","277","674","0","41.10","12.76"
"10","013","00","210","0009","0000","448","119","329","6","454","1138","0","39.89","10.46"
"10","013","00","210","0009","0607","448","119","329","6","454","1138","0","39.89","10.46"
"10","013","00","210","0010","0000","413","99","314","6","419","1061","0","39.49","9.33"
"10","013","00","210","0010","0608","413","99","314","6","419","1061","0","39.49","9.33"
"10","013","00","210","0011","0000","356","124","232","4","360","1072","0","33.58","11.57"
"10","013","00","210","0011","0609","356","124","232","4","360","1072","0","33.58","11.57"
"10","013","00","210","0012","0000","777","317","460","6","783","2355","0","33.25","13.46"
"10","013","00","210","0012","0610","356","147","209","4","360","1229","0","29.29","11.96"
"10","013","00","210","0012","0611","421","170","251","2","423","1126","0","37.57","15.10"
"10","013","00","220","0000","0000","2105","1153","952","19","2124","10595","12095","20.05","10.88"
"10","013","00","220","0001","0000","500","243","257","4","504","2066","0","24.39","11.76"
"10","013","00","220","0001","0612","264","112","152","1","265","1093","0","24.25","10.25"
"10","013","00","220","0001","0613","236","131","105","3","239","973","0","24.56","13.46"
"10","013","00","220","0002","0000","271","133","138","3","274","1247","0","21.97","10.67"
"10","013","00","220","0002","0614","271","133","138","3","274","1247","0","21.97","10.67"
"10","013","00","220","0003","0000","225","159","66","1","226","975","0","23.18","16.31"
"10","013","00","220","0003","0615","225","159","66","1","226","975","0","23.18","16.31"
"10","013","00","220","0004","0000","291","175","116","2","293","1617","0","18.12","10.82"
"10","013","00","220","0004","0616","291","175","116","2","293","1617","0","18.12","10.82"
"10","013","00","220","0005","0000","193","104","89","1","194","1117","0","17.37","9.31"
"10","013","00","220","0005","0617","193","104","89","1","194","1117","0","17.37","9.31"
"10","013","00","220","0006","0000","197","108","89","1","198","1101","0","17.98","9.81"
"10","013","00","220","0006","0618","197","108","89","1","198","1101","0","17.98","9.81"
"10","013","00","220","0007","0000","260","147","113","2","262","1622","0","16.15","9.06"
"10","013","00","220","0007","0619","260","147","113","2","262","1622","0","16.15","9.06"
"10","013","00","220","0008","0000","168","84","84","5","173","850","0","20.35","9.88"
"10","013","00","220","0008","0620","168","84","84","5","173","850","0","20.35","9.88"
"10","013","00","230","0000","0000","2365","949","1416","36","2401","7290","8221","32.94","13.02"
"10","013","00","230","0001","0000","484","215","269","8","492","1315","0","37.41","16.35"
"10","013","00","230","0001","0623","173","74","99","5","178","470","0","37.87","15.74"
"10","013","00","230","0001","0624","311","141","170","3","314","845","0","37.16","16.69"
"10","013","00","230","0002","0000","225","58","167","2","227","534","0","42.51","10.86"
"10","013","00","230","0002","0625","225","58","167","2","227","534","0","42.51","10.86"
"10","013","00","230","0003","0000","158","60","98","0","158","610","0","25.90","9.84"
"10","013","00","230","0003","0622","158","60","98","0","158","610","0","25.90","9.84"
"10","013","00","230","0004","0000","201","87","114","7","208","717","0","29.01","12.13"
"10","013","00","230","0004","0621","201","87","114","7","208","717","0","29.01","12.13"
"10","013","00","230","0005","0000","111","43","68","0","111","370","0","30.00","11.62"
"10","013","00","230","0005","0626","111","43","68","0","111","370","0","30.00","11.62"
"10","013","00","230","0006","0000","269","109","160","4","273","837","0","32.62","13.02"
"10","013","00","230","0006","0627","269","109","160","4","273","837","0","32.62","13.02"
"10","013","00","230","0007","0000","351","145","206","9","360","1197","0","30.08","12.11"
"10","013","00","230","0007","0628","172","66","106","5","177","585","0","30.26","11.28"
"10","013","00","230","0007","0629","179","79","100","4","183","612","0","29.90","12.91"
"10","013","00","230","0008","0000","148","36","112","0","148","418","0","35.41","8.61"
"10","013","00","230","0008","0630","148","36","112","0","148","418","0","35.41","8.61"
"10","013","00","230","0009","0000","111","55","56","1","112","412","0","27.18","13.35"
"10","013","00","230","0009","0631","111","55","56","1","112","412","0","27.18","13.35"
"10","013","00","230","0010","0000","152","74","78","2","154","481","0","32.02","15.38"
"10","013","00","230","0010","0632","152","74","78","2","154","481","0","32.02","15.38"
"10","013","00","230","0011","0000","155","67","88","3","158","399","0","39.60","16.79"
"10","013","00","230","0011","0633","155","67","88","3","158","399","0","39.60","16.79"
"10","013","00","240","0000","0000","1900","838","1062","24","1924","6686","7397","28.78","12.53"
"10","013","00","240","0001","0000","419","199","220","8","427","1429","0","29.88","13.93"
"10","013","00","240","0001","0634","419","199","220","8","427","1429","0","29.88","13.93"
"10","013","00","240","0002","0000","118","61","57","2","120","392","0","30.61","15.56"
"10","013","00","240","0002","0635","118","61","57","2","120","392","0","30.61","15.56"
"10","013","00","240","0003","0000","370","168","202","4","374","1208","0","30.96","13.91"
"10","013","00","240","0003","0637","370","168","202","4","374","1208","0","30.96","13.91"
"10","013","00","240","0004","0000","391","135","256","4","395","1223","0","32.30","11.04"
"10","013","00","240","0004","0638","391","135","256","4","395","1223","0","32.30","11.04"
"10","013","00","240","0005","0000","148","51","97","0","148","526","0","28.14","9.70"
"10","013","00","240","0005","0636","148","51","97","0","148","526","0","28.14","9.70"
"10","013","00","240","0006","0000","267","137","130","5","272","1255","0","21.67","10.92"
"10","013","00","240","0006","0639","267","137","130","5","272","1255","0","21.67","10.92"
"10","013","00","240","0007","0000","90","41","49","0","90","348","0","25.86","11.78"
"10","013","00","240","0007","0640","90","41","49","0","90","348","0","25.86","11.78"
"10","013","00","240","0008","0000","97","46","51","1","98","305","0","32.13","15.08"
"10","013","00","240","0008","0641","97","46","51","1","98","305","0","32.13","15.08"
"10","013","00","250","0000","0000","1583","540","1043","25","1608","4637","5145","34.68","11.65"
"10","013","00","250","0001","0000","353","170","183","8","361","966","0","37.37","17.60"
"10","013","00","250","0001","0642","204","96","108","6","210","548","0","38.32","17.52"
"10","013","00","250","0001","0643","149","74","75","2","151","418","0","36.12","17.70"
"10","013","00","250","0002","0000","691","224","467","11","702","1872","0","37.50","11.97"
"10","013","00","250","0002","0644","332","87","245","6","338","901","0","37.51","9.66"
"10","013","00","250","0002","0645","359","137","222","5","364","971","0","37.49","14.11"
"10","013","00","250","0003","0000","291","70","221","3","294","962","0","30.56","7.28"
"10","013","00","250","0003","0646","291","70","221","3","294","962","0","30.56","7.28"
"10","013","00","250","0004","0000","248","76","172","3","251","837","0","29.99","9.08"
"10","013","00","250","0004","0647","248","76","172","3","251","837","0","29.99","9.08"
"10","013","00","260","0000","0000","1939","1461","478","34","1973","6401","7691","30.82","22.82"
"10","013","00","260","0001","0000","556","432","124","10","566","1460","0","38.77","29.59"
"10","013","00","260","0001","0651","556","432","124","10","566","1460","0","38.77","29.59"
"10","013","00","260","0002","0000","95","59","36","1","96","341","0","28.15","17.30"
"10","013","00","260","0002","0650","95","59","36","1","96","341","0","28.15","17.30"
"10","013","00","260","0003","0000","87","56","31","1","88","566","0","15.55","9.89"
"10","013","00","260","0003","0649","87","56","31","1","88","566","0","15.55","9.89"
"10","013","00","260","0004","0000","175","146","29","3","178","639","0","27.86","22.85"
"10","013","00","260","0004","0648","175","146","29","3","178","639","0","27.86","22.85"
"10","013","00","260","0005","0000","218","158","60","3","221","725","0","30.48","21.79"
"10","013","00","260","0005","0652","218","158","60","3","221","725","0","30.48","21.79"
"10","013","00","260","0006","0000","188","137","51","5","193","550","0","35.09","24.91"
"10","013","00","260","0006","0653","188","137","51","5","193","550","0","35.09","24.91"
"10","013","00","260","0007","0000","100","66","34","1","101","341","0","29.62","19.35"
"10","013","00","260","0007","0654","100","66","34","1","101","341","0","29.62","19.35"
"10","013","00","260","0008","0000","154","112","42","4","158","468","0","33.76","23.93"
"10","013","00","260","0008","0655","154","112","42","4","158","468","0","33.76","23.93"
"10","013","00","260","0009","0000","199","163","36","5","204","694","0","29.39","23.49"
"10","013","00","260","0009","0656","199","163","36","5","204","694","0","29.39","23.49"
"10","013","00","260","0010","0000","167","132","35","1","168","617","0","27.23","21.39"
"10","013","00","260","0010","0657","167","132","35","1","168","617","0","27.23","21.39"
"10","013","00","270","0000","0000","923","652","271","13","936","2842","3230","32.93","22.94"
"10","013","00","270","0001","0000","348","233","115","3","351","1089","0","32.23","21.40"
"10","013","00","270","0001","0658","115","76","39","0","115","314","0","36.62","24.20"
"10","013","00","270","0001","0659","178","134","44","3","181","614","0","29.48","21.82"
"10","013","00","270","0001","0660","55","23","32","0","55","161","0","34.16","14.29"
"10","013","00","270","0002","0000","105","87","18","2","107","297","0","36.03","29.29"
"10","013","00","270","0002","0662","105","87","18","2","107","297","0","36.03","29.29"
"10","013","00","270","0003","0000","72","56","16","0","72","183","0","39.34","30.60"
"10","013","00","270","0003","0661","72","56","16","0","72","183","0","39.34","30.60"
"10","013","00","270","0004","0000","65","40","25","3","68","441","0","15.42","9.07"
"10","013","00","270","0004","0665","65","40","25","3","68","441","0","15.42","9.07"
"10","013","00","270","0005","0000","148","126","22","3","151","356","0","42.42","35.39"
"10","013","00","270","0005","0664","148","126","22","3","151","356","0","42.42","35.39"
"10","013","00","270","0006","0000","185","110","75","2","187","476","0","39.29","23.11"
"10","013","00","270","0006","0663","185","110","75","2","187","476","0","39.29","23.11"
"10","013","00","280","0000","0000","1979","1512","467","13","1992","5610","6706","35.51","26.95"
"10","013","00","280","0001","0000","161","115","46","1","162","443","0","36.57","25.96"
"10","013","00","280","0001","0666","161","115","46","1","162","443","0","36.57","25.96"
"10","013","00","280","0002","0000","311","237","74","2","313","771","0","40.60","30.74"
"10","013","00","280","0002","0667","311","237","74","2","313","771","0","40.60","30.74"
"10","013","00","280","0003","0000","282","220","62","1","283","1041","0","27.19","21.13"
"10","013","00","280","0003","0671","282","220","62","1","283","1041","0","27.19","21.13"
"10","013","00","280","0004","0000","308","206","102","2","310","887","0","34.95","23.22"
"10","013","00","280","0004","0672","308","206","102","2","310","887","0","34.95","23.22"
"10","013","00","280","0005","0000","135","109","26","0","135","419","0","32.22","26.01"
"10","013","00","280","0005","0673","135","109","26","0","135","419","0","32.22","26.01"
"10","013","00","280","0006","0000","782","625","157","7","789","2049","0","38.51","30.50"
"10","013","00","280","0006","0668","240","182","58","2","242","655","0","36.95","27.79"
"10","013","00","280","0006","0669","291","246","45","0","291","711","0","40.93","34.60"
"10","013","00","280","0006","0670","251","197","54","5","256","683","0","37.48","28.84"
"10","013","00","290","0000","0000","1448","1136","312","19","1467","4332","5365","33.86","26.22"
"10","013","00","290","0001","0000","324","268","56","3","327","844","0","38.74","31.75"
"10","013","00","290","0001","0674","232","195","37","2","234","632","0","37.03","30.85"
"10","013","00","290","0001","0675","92","73","19","1","93","212","0","43.87","34.43"
"10","013","00","290","0002","0000","335","258","77","8","343","950","0","36.11","27.16"
"10","013","00","290","0002","0676","335","258","77","8","343","950","0","36.11","27.16"
"10","013","00","290","0003","0000","212","117","95","1","213","610","0","34.92","19.18"
"10","013","00","290","0003","0677","212","117","95","1","213","610","0","34.92","19.18"
"10","013","00","290","0004","0000","115","93","22","3","118","408","0","28.92","22.79"
"10","013","00","290","0004","0679","115","93","22","3","118","408","0","28.92","22.79"
"10","013","00","290","0005","0000","207","176","31","4","211","772","0","27.33","22.80"
"10","013","00","290","0005","0680","207","176","31","4","211","772","0","27.33","22.80"
"10","013","00","290","0006","0000","255","224","31","0","255","748","0","34.09","29.95"
"10","013","00","290","0006","0678","255","224","31","0","255","748","0","34.09","29.95"
"10","013","00","300","0000","0000","2177","1803","374","17","2194","6217","7400","35.29","29.00"
"10","013","00","300","0001","0000","257","209","48","1","258","909","0","28.38","22.99"
"10","013","00","300","0001","0681","257","209","48","1","258","909","0","28.38","22.99"
"10","013","00","300","0002","0000","195","149","46","2","197","586","0","33.62","25.43"
"10","013","00","300","0002","0682","131","103","28","2","133","355","0","37.46","29.01"
"10","013","00","300","0002","0683","64","46","18","0","64","231","0","27.71","19.91"
"10","013","00","300","0003","0000","260","222","38","2","262","709","0","36.95","31.31"
"10","013","00","300","0003","0684","160","140","20","2","162","434","0","37.33","32.26"
"10","013","00","300","0003","0685","100","82","18","0","100","275","0","36.36","29.82"
"10","013","00","300","0004","0000","405","338","67","5","410","1112","0","36.87","30.40"
"10","013","00","300","0004","0686","405","338","67","5","410","1112","0","36.87","30.40"
"10","013","00","300","0005","0000","299","243","56","0","299","840","0","35.60","28.93"
"10","013","00","300","0005","0687","299","243","56","0","299","840","0","35.60","28.93"
"10","013","00","300","0006","0000","350","309","41","0","350","864","0","40.51","35.76"
"10","013","00","300","0006","0688","350","309","41","0","350","864","0","40.51","35.76"
"10","013","00","300","0007","0000","411","333","78","7","418","1197","0","34.92","27.82"
"10","013","00","300","0007","0689","200","169","31","2","202","574","0","35.19","29.44"
"10","013","00","300","0007","0690","211","164","47","5","216","623","0","34.67","26.32"
"10","013","00","310","0000","0000","1010","763","247","29","1039","3975","4912","26.14","19.19"
"10","013","00","310","0001","0000","191","147","44","2","193","923","0","20.91","15.93"
"10","013","00","310","0001","0691","191","147","44","2","193","923","0","20.91","15.93"
"10","013","00","310","0002","0000","185","138","47","4","189","685","0","27.59","20.15"
"10","013","00","310","0002","0692","185","138","47","4","189","685","0","27.59","20.15"
"10","013","00","310","0003","0000","56","38","18","5","61","311","0","19.61","12.22"
"10","013","00","310","0003","0693","56","38","18","5","61","311","0","19.61","12.22"
"10","013","00","310","0004","0000","281","218","63","6","287","940","0","30.53","23.19"
"10","013","00","310","0004","0694","281","218","63","6","287","940","0","30.53","23.19"
"10","013","00","310","0005","0000","171","131","40","6","177","647","0","27.36","20.25"
"10","013","00","310","0005","0695","171","131","40","6","177","647","0","27.36","20.25"
"10","013","00","310","0006","0000","126","91","35","6","132","469","0","28.14","19.40"
"10","013","00","310","0006","0696","126","91","35","6","132","469","0","28.14","19.40"
"10","013","00","320","0000","0000","1283","1044","239","25","1308","4092","4805","31.96","25.51"
"10","013","00","320","0001","0000","221","172","49","5","226","702","0","32.19","24.50"
"10","013","00","320","0001","0697","221","172","49","5","226","702","0","32.19","24.50"
"10","013","00","320","0002","0000","201","168","33","6","207","759","0","27.27","22.13"
"10","013","00","320","0002","0698","201","168","33","6","207","759","0","27.27","22.13"
"10","013","00","320","0003","0000","214","183","31","3","217","626","0","34.66","29.23"
"10","013","00","320","0003","0699","214","183","31","3","217","626","0","34.66","29.23"
"10","013","00","320","0004","0000","73","58","15","0","73","229","0","31.88","25.33"
"10","013","00","320","0004","0700","73","58","15","0","73","229","0","31.88","25.33"
"10","013","00","320","0005","0000","95","72","23","3","98","293","0","33.45","24.57"
"10","013","00","320","0005","0701","95","72","23","3","98","293","0","33.45","24.57"
"10","013","00","320","0006","0000","146","119","27","1","147","490","0","30.00","24.29"
"10","013","00","320","0006","0702","146","119","27","1","147","490","0","30.00","24.29"
"10","013","00","320","0007","0000","219","179","40","6","225","624","0","36.06","28.69"
"10","013","00","320","0007","0703","219","179","40","6","225","624","0","36.06","28.69"
"10","013","00","320","0008","0000","114","93","21","1","115","369","0","31.17","25.20"
"10","013","00","320","0008","0704","114","93","21","1","115","369","0","31.17","25.20"
"10","013","00","330","0000","0000","1253","996","257","22","1275","4134","4860","30.84","24.09"
"10","013","00","330","0001","0000","500","395","105","6","506","1579","0","32.05","25.02"
"10","013","00","330","0001","0705","260","202","58","2","262","732","0","35.79","27.60"
"10","013","00","330","0001","0706","114","94","20","2","116","520","0","22.31","18.08"
"10","013","00","330","0001","0707","126","99","27","2","128","327","0","39.14","30.28"
"10","013","00","330","0002","0000","224","193","31","5","229","645","0","35.50","29.92"
"10","013","00","330","0002","0708","224","193","31","5","229","645","0","35.50","29.92"
"10","013","00","330","0003","0000","145","124","21","5","150","435","0","34.48","28.51"
"10","013","00","330","0003","0709","145","124","21","5","150","435","0","34.48","28.51"
"10","013","00","330","0004","0000","128","95","33","2","130","359","0","36.21","26.46"
"10","013","00","330","0004","0710","128","95","33","2","130","359","0","36.21","26.46"
"10","013","00","330","0005","0000","151","118","33","1","152","567","0","26.81","20.81"
"10","013","00","330","0005","0711","151","118","33","1","152","567","0","26.81","20.81"
"10","013","00","330","0006","0000","105","71","34","3","108","549","0","19.67","12.93"
"10","013","00","330","0006","0712","105","71","34","3","108","549","0","19.67","12.93"
"10","002","00","000","0000","0000","145530","54104","91426","1521","147051","385260","451946","38.17","14.04"
"10","002","00","010","0000","0000","31168","13087","18081","270","31438","78886","95269","39.85","16.59"
"10","002","00","010","0001","0000","1053","489","564","10","1063","2534","0","41.95","19.30"
"10","002","00","010","0001","0024","279","145","134","3","282","625","0","45.12","23.20"
"10","002","00","010","0001","0025","417","180","237","3","420","937","0","44.82","19.21"
"10","002","00","010","0001","0026","357","164","193","4","361","972","0","37.14","16.87"
"10","002","00","010","0002","0000","594","297","297","7","601","1744","0","34.46","17.03"
"10","002","00","010","0002","0022","328","159","169","1","329","1037","0","31.73","15.33"
"10","002","00","010","0002","0023","266","138","128","6","272","707","0","38.47","19.52"
"10","002","00","010","0008","0000","926","397","529","6","932","2115","0","44.07","18.77"
"10","002","00","010","0008","0030","509","201","308","2","511","1130","0","45.22","17.79"
"10","002","00","010","0008","0031","417","196","221","4","421","985","0","42.74","19.90"
"10","002","00","010","0009","0000","521","208","313","8","529","1269","0","41.69","16.39"
"10","002","00","010","0009","0032","521","208","313","8","529","1269","0","41.69","16.39"
"10","002","00","010","0010","0000","848","311","537","3","851","1962","0","43.37","15.85"
"10","002","00","010","0010","0036","462","189","273","1","463","1126","0","41.12","16.79"
"10","002","00","010","0010","0037","386","122","264","2","388","836","0","46.41","14.59"
"10","002","00","010","0011","0000","876","432","444","14","890","2131","0","41.76","20.27"
"10","002","00","010","0011","0034","440","189","251","2","442","1010","0","43.76","18.71"
"10","002","00","010","0011","0035","436","243","193","12","448","1121","0","39.96","21.68"
"10","002","00","010","0012","0000","520","183","337","6","526","1298","0","40.52","14.10"
"10","002","00","010","0012","0033","520","183","337","6","526","1298","0","40.52","14.10"
"10","002","00","010","0013","0000","715","274","441","10","725","1846","0","39.27","14.84"
"10","002","00","010","0013","0052","357","144","213","5","362","938","0","38.59","15.35"
"10","002","00","010","0013","0053","358","130","228","5","363","908","0","39.98","14.32"
"10","002","00","010","0014","0000","845","357","488","7","852","2200","0","38.73","16.23"
"10","002","00","010","0014","0047","404","193","211","1","405","1072","0","37.78","18.00"
"10","002","00","010","0014","0048","441","164","277","6","447","1128","0","39.63","14.54"
"10","002","00","010","0015","0000","1189","508","681","14","1203","3263","0","36.87","15.57"
"10","002","00","010","0015","0041","407","153","254","6","413","1064","0","38.82","14.38"
"10","002","00","010","0015","0042","367","166","201","4","371","1111","0","33.39","14.94"
"10","002","00","010","0015","0043","415","189","226","4","419","1088","0","38.51","17.37"
"10","002","00","010","0016","0000","531","181","350","9","540","1459","0","37.01","12.41"
"10","002","00","010","0016","0054","292","82","210","6","298","765","0","38.95","10.72"
"10","002","00","010","0016","0055","239","99","140","3","242","694","0","34.87","14.27"
"10","002","00","010","0017","0000","606","273","333","5","611","1801","0","33.93","15.16"
"10","002","00","010","0017","0061","285","141","144","4","289","894","0","32.33","15.77"
"10","002","00","010","0017","0062","321","132","189","1","322","907","0","35.50","14.55"
"10","002","00","010","0018","0000","650","224","426","9","659","1464","0","45.01","15.30"
"10","002","00","010","0018","0028","322","109","213","5","327","686","0","47.67","15.89"
"10","002","00","010","0018","0029","328","115","213","4","332","778","0","42.67","14.78"
"10","002","00","010","0019","0000","401","128","273","1","402","951","0","42.27","13.46"
"10","002","00","010","0019","0057","401","128","273","1","402","951","0","42.27","13.46"
"10","002","00","010","0021","0000","633","243","390","8","641","1595","0","40.19","15.24"
"10","002","00","010","0021","0058","294","121","173","4","298","789","0","37.77","15.34"
"10","002","00","010","0021","0059","339","122","217","4","343","806","0","42.56","15.14"
"10","002","00","010","0022","0000","524","243","281","3","527","1334","0","39.51","18.22"
"10","002","00","010","0022","0060","524","243","281","3","527","1334","0","39.51","18.22"
"10","002","00","010","0023","0000","449","150","299","1","450","1122","0","40.11","13.37"
"10","002","00","010","0023","0056","449","150","299","1","450","1122","0","40.11","13.37"
"10","002","00","010","0024","0000","942","321","621","11","953","2678","0","35.59","11.99"
"10","002","00","010","0024","0066","298","100","198","2","300","890","0","33.71","11.24"
"10","002","00","010","0024","0067","277","79","198","3","280","797","0","35.13","9.91"
"10","002","00","010","0024","0068","367","142","225","6","373","991","0","37.64","14.33"
"10","002","00","010","0025","0000","768","305","463","7","775","2080","0","37.26","14.66"
"10","002","00","010","0025","0069","423","195","228","2","425","1103","0","38.53","17.68"
"10","002","00","010","0025","0070","345","110","235","5","350","977","0","35.82","11.26"
"10","002","00","010","0026","0000","827","273","554","8","835","2200","0","37.95","12.41"
"10","002","00","010","0026","0071","390","145","245","5","395","1102","0","35.84","13.16"
"10","002","00","010","0026","0072","437","128","309","3","440","1098","0","40.07","11.66"
"10","002","00","010","0027","0000","1157","389","768","6","1163","3159","0","36.82","12.31"
"10","002","00","010","0027","0073","380","141","239","2","382","972","0","39.30","14.51"
"10","002","00","010","0027","0074","398","133","265","3","401","1164","0","34.45","11.43"
"10","002","00","010","0027","0075","379","115","264","1","380","1023","0","37.15","11.24"
"10","002","00","010","0028","0000","488","165","323","4","492","1112","0","44.24","14.84"
"10","002","00","010","0028","0081","488","165","323","4","492","1112","0","44.24","14.84"
"10","002","00","010","0031","0000","346","137","209","4","350","902","0","38.80","15.19"
"10","002","00","010","0031","0078","346","137","209","4","350","902","0","38.80","15.19"
"10","002","00","010","0032","0000","739","242","497","6","745","1736","0","42.91","13.94"
"10","002","00","010","0032","0079","346","114","232","3","349","817","0","42.72","13.95"
"10","002","00","010","0032","0080","393","128","265","3","396","919","0","43.09","13.93"
"10","002","00","010","0034","0000","553","224","329","4","557","1330","0","41.88","16.84"
"10","002","00","010","0034","0076","281","128","153","0","281","616","0","45.62","20.78"
"10","002","00","010","0034","0077","272","96","176","4","276","714","0","38.66","13.45"
"10","002","00","010","0035","0000","1179","458","721","10","1189","2908","0","40.89","15.75"
"10","002","00","010","0035","0007","373","152","221","1","374","931","0","40.17","16.33"
"10","002","00","010","0035","0008","419","156","263","3","422","1000","0","42.20","15.60"
"10","002","00","010","0035","0009","387","150","237","6","393","977","0","40.23","15.35"
"10","002","00","010","0036","0000","935","431","504","14","949","2157","0","44.00","19.98"
"10","002","00","010","0036","0001","499","215","284","9","508","1107","0","45.89","19.42"
"10","002","00","010","0036","0002","436","216","220","5","441","1050","0","42.00","20.57"
"10","002","00","010","0037","0000","647","295","352","7","654","1576","0","41.50","18.72"
"10","002","00","010","0037","0003","344","152","192","5","349","834","0","41.85","18.23"
"10","002","00","010","0037","0004","303","143","160","2","305","742","0","41.11","19.27"
"10","002","00","010","0038","0000","1767","882","885","10","1777","4247","0","41.84","20.77"
"10","002","00","010","0038","0010","499","250","249","3","502","1055","0","47.58","23.70"
"10","002","00","010","0038","0011","380","204","176","3","383","1020","0","37.55","20.00"
"10","002","00","010","0038","0012","439","222","217","3","442","1056","0","41.86","21.02"
"10","002","00","010","0038","0013","449","206","243","1","450","1116","0","40.32","18.46"
"10","002","00","010","0039","0000","1230","562","668","6","1236","2966","0","41.67","18.95"
"10","002","00","010","0039","0016","368","151","217","1","369","885","0","41.69","17.06"
"10","002","00","010","0039","0017","385","204","181","3","388","944","0","41.10","21.61"
"10","002","00","010","0039","0018","477","207","270","2","479","1137","0","42.13","18.21"
"10","002","00","010","0040","0000","1084","561","523","5","1089","2613","0","41.68","21.47"
"10","002","00","010","0040","0019","376","255","121","3","379","870","0","43.56","29.31"
"10","002","00","010","0040","0020","341","156","185","1","342","779","0","43.90","20.03"
"10","002","00","010","0040","0021","367","150","217","1","368","964","0","38.17","15.56"
"10","002","00","010","0041","0000","1151","482","669","9","1160","3044","0","38.11","15.83"
"10","002","00","010","0041","0044","306","98","208","4","310","812","0","38.18","12.07"
"10","002","00","010","0041","0045","434","205","229","3","437","1146","0","38.13","17.89"
"10","002","00","010","0041","0046","411","179","232","2","413","1086","0","38.03","16.48"
"10","002","00","010","0042","0000","1169","524","645","14","1183","3099","0","38.17","16.91"
"10","002","00","010","0042","0049","453","198","255","6","459","1132","0","40.55","17.49"
"10","002","00","010","0042","0050","358","164","194","3","361","951","0","37.96","17.25"
"10","002","00","010","0042","0051","358","162","196","5","363","1016","0","35.73","15.94"
"10","002","00","010","0043","0000","1098","535","563","4","1102","2533","0","43.51","21.12"
"10","002","00","010","0043","0014","571","301","270","2","573","1294","0","44.28","23.26"
"10","002","00","010","0043","0015","527","234","293","2","529","1239","0","42.70","18.89"
"10","002","00","010","0044","0000","657","318","339","3","660","1969","0","33.52","16.15"
"10","002","00","010","0044","0005","340","165","175","0","340","1017","0","33.43","16.22"
"10","002","00","010","0044","0006","317","153","164","3","320","952","0","33.61","16.07"
"10","002","00","010","0045","0000","305","127","178","2","307","770","0","39.87","16.49"
"10","002","00","010","0045","0027","305","127","178","2","307","770","0","39.87","16.49"
"10","002","00","010","0046","0000","1014","428","586","7","1021","2844","0","35.90","15.05"
"10","002","00","010","0046","0063","439","186","253","3","442","1229","0","35.96","15.13"
"10","002","00","010","0046","0064","303","137","166","3","306","788","0","38.83","17.39"
"10","002","00","010","0046","0065","272","105","167","1","273","827","0","33.01","12.70"
"10","002","00","010","0047","0000","1231","530","701","8","1239","2875","0","43.10","18.43"
"10","002","00","010","0047","0038","433","178","255","3","436","990","0","44.04","17.98"
"10","002","00","010","0047","0039","381","170","211","3","384","905","0","42.43","18.78"
"10","002","00","010","0047","0040","417","182","235","2","419","980","0","42.76","18.57"
"10","002","00","020","0000","0000","23090","8589","14501","204","23294","56993","71097","40.87","15.07"
"10","002","00","020","0004","0000","618","221","397","7","625","1532","0","40.80","14.43"
"10","002","00","020","0004","0084","618","221","397","7","625","1532","0","40.80","14.43"
"10","002","00","020","0005","0000","1294","450","844","12","1306","3501","0","37.30","12.85"
"10","002","00","020","0005","0085","573","163","410","6","579","1443","0","40.12","11.30"
"10","002","00","020","0005","0086","367","148","219","4","371","1118","0","33.18","13.24"
"10","002","00","020","0005","0087","354","139","215","2","356","940","0","37.87","14.79"
"10","002","00","020","0006","0000","1051","321","730","8","1059","2687","0","39.41","11.95"
"10","002","00","020","0006","0088","590","168","422","4","594","1521","0","39.05","11.05"
"10","002","00","020","0006","0089","461","153","308","4","465","1166","0","39.88","13.12"
"10","002","00","020","0007","0000","1191","481","710","6","1197","3002","0","39.87","16.02"
"10","002","00","020","0007","0090","547","215","332","3","550","1304","0","42.18","16.49"
"10","002","00","020","0007","0091","340","142","198","1","341","829","0","41.13","17.13"
"10","002","00","020","0007","0092","304","124","180","2","306","869","0","35.21","14.27"
"10","002","00","020","0008","0000","873","336","537","7","880","2352","0","37.41","14.29"
"10","002","00","020","0008","0093","502","191","311","5","507","1477","0","34.33","12.93"
"10","002","00","020","0008","0094","371","145","226","2","373","875","0","42.63","16.57"
"10","002","00","020","0009","0000","549","205","344","8","557","1294","0","43.04","15.84"
"10","002","00","020","0009","0095","549","205","344","8","557","1294","0","43.04","15.84"
"10","002","00","020","0010","0000","631","239","392","2","633","1501","0","42.17","15.92"
"10","002","00","020","0010","0096","631","239","392","2","633","1501","0","42.17","15.92"
"10","002","00","020","0011","0000","488","195","293","2","490","1123","0","43.63","17.36"
"10","002","00","020","0011","0097","488","195","293","2","490","1123","0","43.63","17.36"
"10","002","00","020","0016","0000","1423","560","863","8","1431","3579","0","39.98","15.65"
"10","002","00","020","0016","0100","419","146","273","3","422","1025","0","41.17","14.24"
"10","002","00","020","0016","0101","539","233","306","3","542","1283","0","42.24","18.16"
"10","002","00","020","0016","0102","465","181","284","2","467","1271","0","36.74","14.24"
"10","002","00","020","0017","0000","1077","395","682","15","1092","2799","0","39.01","14.11"
"10","002","00","020","0017","0106","535","187","348","7","542","1413","0","38.36","13.23"
"10","002","00","020","0017","0107","542","208","334","8","550","1386","0","39.68","15.01"
"10","002","00","020","0018","0000","1094","385","709","9","1103","2795","0","39.46","13.77"
"10","002","00","020","0018","0108","440","145","295","1","441","1069","0","41.25","13.56"
"10","002","00","020","0018","0109","342","128","214","6","348","879","0","39.59","14.56"
"10","002","00","020","0018","0110","312","112","200","2","314","847","0","37.07","13.22"
"10","002","00","020","0019","0000","1389","560","829","13","1402","3502","0","40.03","15.99"
"10","002","00","020","0019","0115","563","232","331","4","567","1399","0","40.53","16.58"
"10","002","00","020","0019","0116","424","165","259","5","429","1083","0","39.61","15.24"
"10","002","00","020","0019","0117","402","163","239","4","406","1020","0","39.80","15.98"
"10","002","00","020","0020","0000","1126","429","697","12","1138","2641","0","43.09","16.24"
"10","002","00","020","0020","0118","578","220","358","3","581","1375","0","42.25","16.00"
"10","002","00","020","0020","0119","548","209","339","9","557","1266","0","44.00","16.51"
"10","002","00","020","0021","0000","370","135","235","4","374","1099","0","34.03","12.28"
"10","002","00","020","0021","0120","370","135","235","4","374","1099","0","34.03","12.28"
"10","002","00","020","0022","0000","1225","484","741","11","1236","2919","0","42.34","16.58"
"10","002","00","020","0022","0121","486","200","286","5","491","1057","0","46.45","18.92"
"10","002","00","020","0022","0122","430","166","264","4","434","1068","0","40.64","15.54"
"10","002","00","020","0022","0123","309","118","191","2","311","794","0","39.17","14.86"
"10","002","00","020","0023","0000","1161","395","766","13","1174","2844","0","41.28","13.89"
"10","002","00","020","0023","0127","370","116","254","5","375","953","0","39.35","12.17"
"10","002","00","020","0023","0128","402","134","268","2","404","952","0","42.44","14.08"
"10","002","00","020","0023","0129","389","145","244","6","395","939","0","42.07","15.44"
"10","002","00","020","0024","0000","1484","520","964","12","1496","3570","0","41.90","14.57"
"10","002","00","020","0024","0130","567","204","363","5","572","1370","0","41.75","14.89"
"10","002","00","020","0024","0131","445","149","296","3","448","1040","0","43.08","14.33"
"10","002","00","020","0024","0132","472","167","305","4","476","1160","0","41.03","14.40"
"10","002","00","020","0025","0000","1556","641","915","11","1567","3337","0","46.96","19.21"
"10","002","00","020","0025","0124","689","300","389","8","697","1354","0","51.48","22.16"
"10","002","00","020","0025","0125","406","166","240","2","408","847","0","48.17","19.60"
"10","002","00","020","0025","0126","461","175","286","1","462","1136","0","40.67","15.40"
"10","002","00","020","0026","0000","1769","693","1076","16","1785","4280","0","41.71","16.19"
"10","002","00","020","0026","0111","449","168","281","3","452","1092","0","41.39","15.38"
"10","002","00","020","0026","0112","504","204","300","5","509","1135","0","44.85","17.97"
"10","002","00","020","0026","0113","440","183","257","3","443","1108","0","39.98","16.52"
"10","002","00","020","0026","0114","376","138","238","5","381","945","0","40.32","14.60"
"10","002","00","020","0027","0000","1240","478","762","9","1249","2960","0","42.20","16.15"
"10","002","00","020","0027","0103","413","172","241","3","416","1020","0","40.78","16.86"
"10","002","00","020","0027","0104","417","165","252","3","420","965","0","43.52","17.10"
"10","002","00","020","0027","0105","410","141","269","3","413","975","0","42.36","14.46"
"10","002","00","020","0028","0000","567","191","376","9","576","1355","0","42.51","14.10"
"10","002","00","020","0028","0082","310","106","204","6","316","662","0","47.73","16.01"
"10","002","00","020","0028","0083","257","85","172","3","260","693","0","37.52","12.27"
"10","002","00","020","0029","0000","531","152","379","8","539","1343","0","40.13","11.32"
"10","002","00","020","0029","0099","531","152","379","8","539","1343","0","40.13","11.32"
"10","002","00","020","0030","0000","383","123","260","2","385","978","0","39.37","12.58"
"10","002","00","020","0030","0098","383","123","260","2","385","978","0","39.37","12.58"
"10","002","00","030","0000","0000","12290","4457","7833","155","12445","33916","38592","36.69","13.14"
"10","002","00","030","0001","0000","1197","381","816","22","1219","3347","0","36.42","11.38"
"10","002","00","030","0001","0133","287","100","187","3","290","859","0","33.76","11.64"
"10","002","00","030","0001","0134","288","86","202","3","291","802","0","36.28","10.72"
"10","002","00","030","0001","0135","286","89","197","8","294","797","0","36.89","11.17"
"10","002","00","030","0001","0136","336","106","230","8","344","889","0","38.70","11.92"
"10","002","00","030","0002","0000","382","110","272","3","385","1020","0","37.75","10.78"
"10","002","00","030","0002","0137","382","110","272","3","385","1020","0","37.75","10.78"
"10","002","00","030","0003","0000","1379","478","901","14","1393","3753","0","37.12","12.74"
"10","002","00","030","0003","0138","354","129","225","7","361","1063","0","33.96","12.14"
"10","002","00","030","0003","0139","361","127","234","2","363","970","0","37.42","13.09"
"10","002","00","030","0003","0140","371","127","244","2","373","929","0","40.15","13.67"
"10","002","00","030","0003","0141","293","95","198","3","296","791","0","37.42","12.01"
"10","002","00","030","0004","0000","346","92","254","6","352","861","0","40.88","10.69"
"10","002","00","030","0004","0142","210","68","142","3","213","543","0","39.23","12.52"
"10","002","00","030","0004","0143","136","24","112","3","139","318","0","43.71","7.55"
"10","002","00","030","0005","0000","498","170","328","8","506","1218","0","41.54","13.96"
"10","002","00","030","0005","0144","338","120","218","5","343","804","0","42.66","14.93"
"10","002","00","030","0005","0145","160","50","110","3","163","414","0","39.37","12.08"
"10","002","00","030","0007","0000","1151","385","766","11","1162","3062","0","37.95","12.57"
"10","002","00","030","0007","0146","355","107","248","5","360","1015","0","35.47","10.54"
"10","002","00","030","0007","0147","394","133","261","1","395","1049","0","37.65","12.68"
"10","002","00","030","0007","0148","402","145","257","5","407","998","0","40.78","14.53"
"10","002","00","030","0008","0000","576","192","384","9","585","1452","0","40.29","13.22"
"10","002","00","030","0008","0149","382","123","259","5","387","996","0","38.86","12.35"
"10","002","00","030","0008","0150","194","69","125","4","198","456","0","43.42","15.13"
"10","002","00","030","0009","0000","795","381","414","8","803","2219","0","36.19","17.17"
"10","002","00","030","0009","0154","213","120","93","2","215","557","0","38.60","21.54"
"10","002","00","030","0009","0155","281","138","143","2","283","841","0","33.65","16.41"
"10","002","00","030","0009","0156","301","123","178","4","305","821","0","37.15","14.98"
"10","002","00","030","0010","0000","889","353","536","6","895","2348","0","38.12","15.03"
"10","002","00","030","0010","0157","310","143","167","2","312","875","0","35.66","16.34"
"10","002","00","030","0010","0158","243","94","149","2","245","661","0","37.07","14.22"
"10","002","00","030","0010","0159","336","116","220","2","338","812","0","41.63","14.29"
"10","002","00","030","0011","0000","375","179","196","8","383","953","0","40.19","18.78"
"10","002","00","030","0011","0160","375","179","196","8","383","953","0","40.19","18.78"
"10","002","00","030","0012","0000","216","88","128","1","217","437","0","49.66","20.14"
"10","002","00","030","0012","0161","216","88","128","1","217","437","0","49.66","20.14"
"10","002","00","030","0013","0000","165","75","90","2","167","499","0","33.47","15.03"
"10","002","00","030","0013","0162","165","75","90","2","167","499","0","33.47","15.03"
"10","002","00","030","0014","0000","183","65","118","2","185","521","0","35.51","12.48"
"10","002","00","030","0014","0163","183","65","118","2","185","521","0","35.51","12.48"
"10","002","00","030","0015","0000","184","88","96","1","185","431","0","42.92","20.42"
"10","002","00","030","0015","0164","184","88","96","1","185","431","0","42.92","20.42"
"10","002","00","030","0016","0000","193","74","119","1","194","573","0","33.86","12.91"
"10","002","00","030","0016","0165","193","74","119","1","194","573","0","33.86","12.91"
"10","002","00","030","0017","0000","153","61","92","0","153","439","0","34.85","13.90"
"10","002","00","030","0017","0166","153","61","92","0","153","439","0","34.85","13.90"
"10","002","00","030","0018","0000","332","134","198","2","334","909","0","36.74","14.74"
"10","002","00","030","0018","0167","332","134","198","2","334","909","0","36.74","14.74"
"10","002","00","030","0019","0000","333","95","238","2","335","893","0","37.51","10.64"
"10","002","00","030","0019","0168","333","95","238","2","335","893","0","37.51","10.64"
"10","002","00","030","0020","0000","328","109","219","9","337","1052","0","32.03","10.36"
"10","002","00","030","0020","0169","154","65","89","4","158","485","0","32.58","13.40"
"10","002","00","030","0020","0170","174","44","130","5","179","567","0","31.57","7.76"
"10","002","00","030","0021","0000","424","184","240","14","438","1414","0","30.98","13.01"
"10","002","00","030","0021","0171","233","104","129","6","239","717","0","33.33","14.50"
"10","002","00","030","0021","0172","191","80","111","8","199","697","0","28.55","11.48"
"10","002","00","030","0022","0000","343","138","205","8","351","1011","0","34.72","13.65"
"10","002","00","030","0022","0173","343","138","205","8","351","1011","0","34.72","13.65"
"10","002","00","030","0023","0000","402","121","281","6","408","1165","0","35.02","10.39"
"10","002","00","030","0023","0174","222","81","141","5","227","625","0","36.32","12.96"
"10","002","00","030","0023","0175","180","40","140","1","181","540","0","33.52","7.41"
"10","002","00","030","0024","0000","89","38","51","2","91","330","0","27.58","11.52"
"10","002","00","030","0024","0176","89","38","51","2","91","330","0","27.58","11.52"
"10","002","00","030","0025","0000","222","62","160","4","226","691","0","32.71","8.97"
"10","002","00","030","0025","0177","222","62","160","4","226","691","0","32.71","8.97"
"10","002","00","030","0026","0000","215","53","162","1","216","584","0","36.99","9.08"
"10","002","00","030","0026","0178","119","30","89","1","120","356","0","33.71","8.43"
"10","002","00","030","0026","0179","96","23","73","0","96","228","0","42.11","10.09"
"10","002","00","030","0027","0000","920","351","569","5","925","2734","0","33.83","12.84"
"10","002","00","030","0027","0151","263","109","154","0","263","785","0","33.50","13.89"
"10","002","00","030","0027","0152","299","120","179","5","304","852","0","35.68","14.08"
"10","002","00","030","0027","0153","358","122","236","0","358","1097","0","32.63","11.12"
"10","002","00","040","0000","0000","8208","3443","4765","101","8309","24942","28673","33.31","13.80"
"10","002","00","040","0001","0000","81","22","59","0","81","304","0","26.64","7.24"
"10","002","00","040","0001","0180","81","22","59","0","81","304","0","26.64","7.24"
"10","002","00","040","0002","0000","190","77","113","6","196","676","0","28.99","11.39"
"10","002","00","040","0002","0181","190","77","113","6","196","676","0","28.99","11.39"
"10","002","00","040","0003","0000","263","78","185","4","267","874","0","30.55","8.92"
"10","002","00","040","0003","0183","263","78","185","4","267","874","0","30.55","8.92"
"10","002","00","040","0004","0000","86","31","55","0","86","345","0","24.93","8.99"
"10","002","00","040","0004","0184","86","31","55","0","86","345","0","24.93","8.99"
"10","002","00","040","0005","0000","351","134","217","11","362","1352","0","26.78","9.91"
"10","002","00","040","0005","0185","173","68","105","5","178","624","0","28.53","10.90"
"10","002","00","040","0005","0186","178","66","112","6","184","728","0","25.27","9.07"
"10","002","00","040","0006","0000","243","101","142","0","243","862","0","28.19","11.72"
"10","002","00","040","0006","0187","243","101","142","0","243","862","0","28.19","11.72"
"10","002","00","040","0007","0000","215","77","138","2","217","678","0","32.01","11.36"
"10","002","00","040","0007","0188","215","77","138","2","217","678","0","32.01","11.36"
"10","002","00","040","0008","0000","565","276","289","8","573","1576","0","36.36","17.51"
"10","002","00","040","0008","0189","299","136","163","5","304","853","0","35.64","15.94"
"10","002","00","040","0008","0190","266","140","126","3","269","723","0","37.21","19.36"
"10","002","00","040","0009","0000","475","187","288","7","482","1356","0","35.55","13.79"
"10","002","00","040","0009","0191","252","101","151","3","255","791","0","32.24","12.77"
"10","002","00","040","0009","0192","223","86","137","4","227","565","0","40.18","15.22"
"10","002","00","040","0010","0000","302","150","152","5","307","710","0","43.24","21.13"
"10","002","00","040","0010","0193","302","150","152","5","307","710","0","43.24","21.13"
"10","002","00","040","0011","0000","198","111","87","2","200","488","0","40.98","22.75"
"10","002","00","040","0011","0194","198","111","87","2","200","488","0","40.98","22.75"
"10","002","00","040","0012","0000","195","91","104","0","195","533","0","36.59","17.07"
"10","002","00","040","0012","0195","195","91","104","0","195","533","0","36.59","17.07"
"10","002","00","040","0013","0000","265","121","144","2","267","645","0","41.40","18.76"
"10","002","00","040","0013","0196","265","121","144","2","267","645","0","41.40","18.76"
"10","002","00","040","0014","0000","575","233","342","7","582","2076","0","28.03","11.22"
"10","002","00","040","0014","0197","288","92","196","2","290","1050","0","27.62","8.76"
"10","002","00","040","0014","0198","287","141","146","5","292","1026","0","28.46","13.74"
"10","002","00","040","0015","0000","700","310","390","8","708","2044","0","34.64","15.17"
"10","002","00","040","0015","0199","297","120","177","1","298","863","0","34.53","13.90"
"10","002","00","040","0015","0200","403","190","213","7","410","1181","0","34.72","16.09"
"10","002","00","040","0016","0000","716","294","422","10","726","2076","0","34.97","14.16"
"10","002","00","040","0016","0201","274","114","160","8","282","901","0","31.30","12.65"
"10","002","00","040","0016","0202","442","180","262","2","444","1175","0","37.79","15.32"
"10","002","00","040","0017","0000","295","119","176","4","299","931","0","32.12","12.78"
"10","002","00","040","0017","0203","295","119","176","4","299","931","0","32.12","12.78"
"10","002","00","040","0018","0000","596","275","321","2","598","1711","0","34.95","16.07"
"10","002","00","040","0018","0204","369","193","176","2","371","1025","0","36.20","18.83"
"10","002","00","040","0018","0205","227","82","145","0","227","686","0","33.09","11.95"
"10","002","00","040","0019","0000","225","102","123","2","227","692","0","32.80","14.74"
"10","002","00","040","0019","0206","225","102","123","2","227","692","0","32.80","14.74"
"10","002","00","040","0020","0000","487","200","287","6","493","1301","0","37.89","15.37"
"10","002","00","040","0020","0207","202","76","126","2","204","569","0","35.85","13.36"
"10","002","00","040","0020","0208","285","124","161","4","289","732","0","39.48","16.94"
"10","002","00","040","0021","0000","307","105","202","4","311","909","0","34.21","11.55"
"10","002","00","040","0021","0209","307","105","202","4","311","909","0","34.21","11.55"
"10","002","00","040","0022","0000","312","128","184","1","313","1008","0","31.05","12.70"
"10","002","00","040","0022","0210","312","128","184","1","313","1008","0","31.05","12.70"
"10","002","00","040","0023","0000","339","132","207","7","346","1090","0","31.74","12.11"
"10","002","00","040","0023","0211","339","132","207","7","346","1090","0","31.74","12.11"
"10","002","00","040","0024","0000","227","89","138","3","230","705","0","32.62","12.62"
"10","002","00","040","0024","0182","227","89","138","3","230","705","0","32.62","12.62"
"10","002","00","050","0000","0000","11379","4134","7245","132","11511","30794","35091","37.38","13.42"
"10","002","00","050","0001","0000","527","195","332","6","533","1601","0","33.29","12.18"
"10","002","00","050","0001","0212","369","138","231","3","372","1093","0","34.03","12.63"
"10","002","00","050","0001","0213","158","57","101","3","161","508","0","31.69","11.22"
"10","002","00","050","0002","0000","706","297","409","7","713","1954","0","36.49","15.20"
"10","002","00","050","0002","0214","331","128","203","2","333","987","0","33.74","12.97"
"10","002","00","050","0002","0215","375","169","206","5","380","967","0","39.30","17.48"
"10","002","00","050","0003","0000","1492","721","771","15","1507","3987","0","37.80","18.08"
"10","002","00","050","0003","0216","339","172","167","1","340","956","0","35.56","17.99"
"10","002","00","050","0003","0217","352","184","168","2","354","955","0","37.07","19.27"
"10","002","00","050","0003","0218","400","189","211","6","406","970","0","41.86","19.48"
"10","002","00","050","0003","0219","401","176","225","6","407","1106","0","36.80","15.91"
"10","002","00","050","0004","0000","922","408","514","12","934","2517","0","37.11","16.21"
"10","002","00","050","0004","0220","284","138","146","2","286","815","0","35.09","16.93"
"10","002","00","050","0004","0221","341","139","202","3","344","870","0","39.54","15.98"
"10","002","00","050","0004","0222","297","131","166","7","304","832","0","36.54","15.75"
"10","002","00","050","0005","0000","228","82","146","4","232","620","0","37.42","13.23"
"10","002","00","050","0005","0223","228","82","146","4","232","620","0","37.42","13.23"
"10","002","00","050","0006","0000","570","248","322","12","582","1372","0","42.42","18.08"
"10","002","00","050","0006","0224","255","109","146","8","263","576","0","45.66","18.92"
"10","002","00","050","0006","0225","315","139","176","4","319","796","0","40.08","17.46"
"10","002","00","050","0007","0000","447","132","315","1","448","1198","0","37.40","11.02"
"10","002","00","050","0007","0226","447","132","315","1","448","1198","0","37.40","11.02"
"10","002","00","050","0008","0000","524","143","381","6","530","1460","0","36.30","9.79"
"10","002","00","050","0008","0227","330","108","222","5","335","875","0","38.29","12.34"
"10","002","00","050","0008","0228","194","35","159","1","195","585","0","33.33","5.98"
"10","002","00","050","0009","0000","826","242","584","11","837","2114","0","39.59","11.45"
"10","002","00","050","0009","0229","348","107","241","5","353","920","0","38.37","11.63"
"10","002","00","050","0009","0230","478","135","343","6","484","1194","0","40.54","11.31"
"10","002","00","050","0010","0000","842","283","559","12","854","2406","0","35.49","11.76"
"10","002","00","050","0010","0231","298","91","207","4","302","844","0","35.78","10.78"
"10","002","00","050","0010","0232","230","86","144","3","233","643","0","36.24","13.37"
"10","002","00","050","0010","0233","314","106","208","5","319","919","0","34.71","11.53"
"10","002","00","050","0011","0000","344","113","231","2","346","1132","0","30.57","9.98"
"10","002","00","050","0011","0234","344","113","231","2","346","1132","0","30.57","9.98"
"10","002","00","050","0012","0000","293","103","190","4","297","830","0","35.78","12.41"
"10","002","00","050","0012","0235","293","103","190","4","297","830","0","35.78","12.41"
"10","002","00","050","0013","0000","418","143","275","8","426","1059","0","40.23","13.50"
"10","002","00","050","0013","0236","418","143","275","8","426","1059","0","40.23","13.50"
"10","002","00","050","0014","0000","479","150","329","4","483","1359","0","35.54","11.04"
"10","002","00","050","0014","0237","479","150","329","4","483","1359","0","35.54","11.04"
"10","002","00","050","0015","0000","1032","345","687","10","1042","2526","0","41.25","13.66"
"10","002","00","050","0015","0238","359","148","211","4","363","898","0","40.42","16.48"
"10","002","00","050","0015","0239","333","106","227","4","337","820","0","41.10","12.93"
"10","002","00","050","0015","0240","340","91","249","2","342","808","0","42.33","11.26"
"10","002","00","050","0016","0000","1223","368","855","13","1236","3316","0","37.27","11.10"
"10","002","00","050","0016","0241","438","136","302","3","441","1073","0","41.10","12.67"
"10","002","00","050","0016","0242","458","132","326","5","463","1215","0","38.11","10.86"
"10","002","00","050","0016","0243","327","100","227","5","332","1028","0","32.30","9.73"
"10","002","00","050","0017","0000","328","123","205","2","330","921","0","35.83","13.36"
"10","002","00","050","0017","0244","328","123","205","2","330","921","0","35.83","13.36"
"10","002","00","050","0018","0000","178","38","140","3","181","422","0","42.89","9.00"
"10","002","00","050","0018","0245","178","38","140","3","181","422","0","42.89","9.00"
"10","002","00","060","0000","0000","7790","2587","5203","94","7884","21700","24419","36.33","11.92"
"10","002","00","060","0001","0000","976","352","624","10","986","2606","0","37.84","13.51"
"10","002","00","060","0001","0246","359","132","227","4","363","899","0","40.38","14.68"
"10","002","00","060","0001","0247","289","96","193","3","292","778","0","37.53","12.34"
"10","002","00","060","0001","0248","328","124","204","3","331","929","0","35.63","13.35"
"10","002","00","060","0002","0000","689","263","426","8","697","1928","0","36.15","13.64"
"10","002","00","060","0002","0250","302","110","192","3","305","925","0","32.97","11.89"
"10","002","00","060","0002","0251","387","153","234","5","392","1003","0","39.08","15.25"
"10","002","00","060","0003","0000","365","125","240","6","371","931","0","39.85","13.43"
"10","002","00","060","0003","0252","365","125","240","6","371","931","0","39.85","13.43"
"10","002","00","060","0004","0000","280","79","201","3","283","979","0","28.91","8.07"
"10","002","00","060","0004","0253","280","79","201","3","283","979","0","28.91","8.07"
"10","002","00","060","0005","0000","518","146","372","7","525","1599","0","32.83","9.13"
"10","002","00","060","0005","0254","268","69","199","5","273","805","0","33.91","8.57"
"10","002","00","060","0005","0255","250","77","173","2","252","794","0","31.74","9.70"
"10","002","00","060","0006","0000","481","140","341","9","490","1492","0","32.84","9.38"
"10","002","00","060","0006","0256","266","75","191","8","274","785","0","34.90","9.55"
"10","002","00","060","0006","0257","215","65","150","1","216","707","0","30.55","9.19"
"10","002","00","060","0007","0000","305","90","215","3","308","792","0","38.89","11.36"
"10","002","00","060","0007","0258","305","90","215","3","308","792","0","38.89","11.36"
"10","002","00","060","0008","0000","872","279","593","14","886","2369","0","37.40","11.78"
"10","002","00","060","0008","0259","306","100","206","6","312","889","0","35.10","11.25"
"10","002","00","060","0008","0260","292","90","202","0","292","729","0","40.05","12.35"
"10","002","00","060","0008","0261","274","89","185","8","282","751","0","37.55","11.85"
"10","002","00","060","0009","0000","593","198","395","2","595","1580","0","37.66","12.53"
"10","002","00","060","0009","0262","248","89","159","1","249","661","0","37.67","13.46"
"10","002","00","060","0009","0263","345","109","236","1","346","919","0","37.65","11.86"
"10","002","00","060","0010","0000","502","158","344","4","506","1240","0","40.81","12.74"
"10","002","00","060","0010","0264","502","158","344","4","506","1240","0","40.81","12.74"
"10","002","00","060","0011","0000","851","301","550","9","860","2246","0","38.29","13.40"
"10","002","00","060","0011","0265","388","150","238","4","392","1103","0","35.54","13.60"
"10","002","00","060","0011","0266","463","151","312","5","468","1143","0","40.94","13.21"
"10","002","00","060","0012","0000","379","122","257","9","388","1058","0","36.67","11.53"
"10","002","00","060","0012","0267","379","122","257","9","388","1058","0","36.67","11.53"
"10","002","00","060","0013","0000","560","192","368","7","567","1756","0","32.29","10.93"
"10","002","00","060","0013","0268","275","105","170","1","276","945","0","29.21","11.11"
"10","002","00","060","0013","0269","285","87","198","6","291","811","0","35.88","10.73"
"10","002","00","060","0014","0000","419","142","277","3","422","1124","0","37.54","12.63"
"10","002","00","060","0014","0249","419","142","277","3","422","1124","0","37.54","12.63"
"10","002","00","070","0000","0000","10332","3517","6815","125","10457","28401","32189","36.82","12.38"
"10","002","00","070","0001","0000","2142","831","1311","22","2164","5810","0","37.25","14.30"
"10","002","00","070","0001","0270","583","244","339","7","590","1443","0","40.89","16.91"
"10","002","00","070","0001","0271","304","123","181","1","305","889","0","34.31","13.84"
"10","002","00","070","0001","0272","469","170","299","1","470","1254","0","37.48","13.56"
"10","002","00","070","0001","0273","381","114","267","9","390","1161","0","33.59","9.82"
"10","002","00","070","0001","0274","405","180","225","4","409","1063","0","38.48","16.93"
"10","002","00","070","0002","0000","757","261","496","9","766","2164","0","35.40","12.06"
"10","002","00","070","0002","0275","366","103","263","3","369","1017","0","36.28","10.13"
"10","002","00","070","0002","0276","391","158","233","6","397","1147","0","34.61","13.78"
"10","002","00","070","0003","0000","672","198","474","7","679","1676","0","40.51","11.81"
"10","002","00","070","0003","0277","344","101","243","2","346","904","0","38.27","11.17"
"10","002","00","070","0003","0278","328","97","231","5","333","772","0","43.13","12.56"
"10","002","00","070","0004","0000","554","236","318","4","558","1505","0","37.08","15.68"
"10","002","00","070","0004","0279","272","118","154","2","274","751","0","36.48","15.71"
"10","002","00","070","0004","0280","282","118","164","2","284","754","0","37.67","15.65"
"10","002","00","070","0005","0000","772","271","501","6","778","1941","0","40.08","13.96"
"10","002","00","070","0005","0281","409","134","275","3","412","1032","0","39.92","12.98"
"10","002","00","070","0005","0282","363","137","226","3","366","909","0","40.26","15.07"
"10","002","00","070","0006","0000","442","119","323","5","447","1249","0","35.79","9.53"
"10","002","00","070","0006","0283","442","119","323","5","447","1249","0","35.79","9.53"
"10","002","00","070","0007","0000","450","187","263","11","461","1436","0","32.10","13.02"
"10","002","00","070","0007","0284","197","85","112","4","201","564","0","35.64","15.07"
"10","002","00","070","0007","0285","253","102","151","7","260","872","0","29.82","11.70"
"10","002","00","070","0008","0000","228","74","154","2","230","608","0","37.83","12.17"
"10","002","00","070","0008","0286","152","41","111","2","154","383","0","40.21","10.70"
"10","002","00","070","0008","0287","76","33","43","0","76","225","0","33.78","14.67"
"10","002","00","070","0009","0000","652","222","430","9","661","1818","0","36.36","12.21"
"10","002","00","070","0009","0288","280","105","175","5","285","921","0","30.94","11.40"
"10","002","00","070","0009","0289","372","117","255","4","376","897","0","41.92","13.04"
"10","002","00","070","0010","0000","471","164","307","8","479","1340","0","35.75","12.24"
"10","002","00","070","0010","0290","230","70","160","3","233","613","0","38.01","11.42"
"10","002","00","070","0010","0291","241","94","147","5","246","727","0","33.84","12.93"
"10","002","00","070","0011","0000","866","232","634","9","875","2277","0","38.43","10.19"
"10","002","00","070","0011","0292","284","73","211","4","288","782","0","36.83","9.34"
"10","002","00","070","0011","0293","365","98","267","2","367","923","0","39.76","10.62"
"10","002","00","070","0011","0294","217","61","156","3","220","572","0","38.46","10.66"
"10","002","00","070","0012","0000","887","275","612","11","898","2403","0","37.37","11.44"
"10","002","00","070","0012","0295","342","102","240","2","344","881","0","39.05","11.58"
"10","002","00","070","0012","0296","278","79","199","4","282","734","0","38.42","10.76"
"10","002","00","070","0012","0297","267","94","173","5","272","788","0","34.52","11.93"
"10","002","00","070","0013","0000","306","99","207","3","309","888","0","34.80","11.15"
"10","002","00","070","0013","0298","306","99","207","3","309","888","0","34.80","11.15"
"10","002","00","070","0014","0000","338","93","245","7","345","926","0","37.26","10.04"
"10","002","00","070","0014","0299","338","93","245","7","345","926","0","37.26","10.04"
"10","002","00","070","0015","0000","350","128","222","4","354","997","0","35.51","12.84"
"10","002","00","070","0015","0300","350","128","222","4","354","997","0","35.51","12.84"
"10","002","00","070","0016","0000","445","127","318","8","453","1363","0","33.24","9.32"
"10","002","00","070","0016","0301","215","58","157","2","217","662","0","32.78","8.76"
"10","002","00","070","0016","0302","230","69","161","6","236","701","0","33.67","9.84"
"10","002","00","080","0000","0000","17819","5422","12397","193","18012","45636","52999","39.47","11.88"
"10","002","00","080","0001","0000","470","117","353","3","473","1262","0","37.48","9.27"
"10","002","00","080","0001","0329","470","117","353","3","473","1262","0","37.48","9.27"
"10","002","00","080","0002","0000","693","175","518","12","705","1625","0","43.38","10.77"
"10","002","00","080","0002","0303","351","83","268","7","358","824","0","43.45","10.07"
"10","002","00","080","0002","0304","342","92","250","5","347","801","0","43.32","11.49"
"10","002","00","080","0003","0000","456","141","315","2","458","1136","0","40.32","12.41"
"10","002","00","080","0003","0305","456","141","315","2","458","1136","0","40.32","12.41"
"10","002","00","080","0004","0000","318","99","219","4","322","894","0","36.02","11.07"
"10","002","00","080","0004","0306","318","99","219","4","322","894","0","36.02","11.07"
"10","002","00","080","0005","0000","345","77","268","10","355","867","0","40.95","8.88"
"10","002","00","080","0005","0307","345","77","268","10","355","867","0","40.95","8.88"
"10","002","00","080","0006","0000","545","175","370","5","550","1409","0","39.03","12.42"
"10","002","00","080","0006","0308","545","175","370","5","550","1409","0","39.03","12.42"
"10","002","00","080","0007","0000","1091","293","798","14","1105","2951","0","37.44","9.93"
"10","002","00","080","0007","0309","400","99","301","8","408","953","0","42.81","10.39"
"10","002","00","080","0007","0310","328","96","232","5","333","1060","0","31.42","9.06"
"10","002","00","080","0007","0311","363","98","265","1","364","938","0","38.81","10.45"
"10","002","00","080","0008","0000","1175","350","825","8","1183","2943","0","40.20","11.89"
"10","002","00","080","0008","0312","360","105","255","6","366","963","0","38.01","10.90"
"10","002","00","080","0008","0313","413","117","296","2","415","1073","0","38.68","10.90"
"10","002","00","080","0008","0314","402","128","274","0","402","907","0","44.32","14.11"
"10","002","00","080","0009","0000","315","108","207","5","320","673","0","47.55","16.05"
"10","002","00","080","0009","0316","315","108","207","5","320","673","0","47.55","16.05"
"10","002","00","080","0010","0000","281","59","222","3","284","709","0","40.06","8.32"
"10","002","00","080","0010","0315","281","59","222","3","284","709","0","40.06","8.32"
"10","002","00","080","0011","0000","653","178","475","2","655","1498","0","43.72","11.88"
"10","002","00","080","0011","0317","653","178","475","2","655","1498","0","43.72","11.88"
"10","002","00","080","0012","0000","355","93","262","6","361","870","0","41.49","10.69"
"10","002","00","080","0012","0318","355","93","262","6","361","870","0","41.49","10.69"
"10","002","00","080","0013","0000","546","135","411","4","550","1512","0","36.38","8.93"
"10","002","00","080","0013","0319","274","68","206","3","277","732","0","37.84","9.29"
"10","002","00","080","0013","0320","272","67","205","1","273","780","0","35.00","8.59"
"10","002","00","080","0014","0000","207","55","152","1","208","474","0","43.88","11.60"
"10","002","00","080","0014","0321","207","55","152","1","208","474","0","43.88","11.60"
"10","002","00","080","0015","0000","1829","552","1277","21","1850","4962","0","37.28","11.12"
"10","002","00","080","0015","0322","471","125","346","4","475","1222","0","38.87","10.23"
"10","002","00","080","0015","0323","469","133","336","9","478","1246","0","38.36","10.67"
"10","002","00","080","0015","0324","486","150","336","5","491","1342","0","36.59","11.18"
"10","002","00","080","0015","0325","403","144","259","3","406","1152","0","35.24","12.50"
"10","002","00","080","0016","0000","1193","375","818","12","1205","3096","0","38.92","12.11"
"10","002","00","080","0016","0326","498","164","334","7","505","1283","0","39.36","12.78"
"10","002","00","080","0016","0327","362","111","251","3","365","928","0","39.33","11.96"
"10","002","00","080","0016","0328","333","100","233","2","335","885","0","37.85","11.30"
"10","002","00","080","0017","0000","1899","637","1262","25","1924","4619","0","41.65","13.79"
"10","002","00","080","0017","0330","595","191","404","8","603","1488","0","40.52","12.84"
"10","002","00","080","0017","0331","397","145","252","5","402","900","0","44.67","16.11"
"10","002","00","080","0017","0332","477","165","312","5","482","1095","0","44.02","15.07"
"10","002","00","080","0017","0333","430","136","294","7","437","1136","0","38.47","11.97"
"10","002","00","080","0018","0000","1521","541","980","16","1537","3769","0","40.78","14.35"
"10","002","00","080","0018","0334","537","198","339","4","541","1315","0","41.14","15.06"
"10","002","00","080","0018","0335","524","190","334","4","528","1252","0","42.17","15.18"
"10","002","00","080","0018","0336","460","153","307","8","468","1202","0","38.94","12.73"
"10","002","00","080","0019","0000","883","242","641","11","894","2557","0","34.96","9.46"
"10","002","00","080","0019","0337","448","127","321","2","450","1296","0","34.72","9.80"
"10","002","00","080","0019","0338","435","115","320","9","444","1261","0","35.21","9.12"
"10","002","00","080","0020","0000","368","150","218","3","371","1080","0","34.35","13.89"
"10","002","00","080","0020","0339","368","150","218","3","371","1080","0","34.35","13.89"
"10","002","00","080","0021","0000","927","306","621","10","937","2509","0","37.35","12.20"
"10","002","00","080","0021","0340","514","145","369","4","518","1263","0","41.01","11.48"
"10","002","00","080","0021","0341","413","161","252","6","419","1246","0","33.63","12.92"
"10","002","00","080","0022","0000","692","238","454","6","698","1680","0","41.55","14.17"
"10","002","00","080","0022","0342","418","134","284","4","422","982","0","42.97","13.65"
"10","002","00","080","0022","0343","274","104","170","2","276","698","0","39.54","14.90"
"10","002","00","080","0023","0000","748","247","501","6","754","1761","0","42.82","14.03"
"10","002","00","080","0023","0344","390","118","272","3","393","887","0","44.31","13.30"
"10","002","00","080","0023","0345","358","129","229","3","361","874","0","41.30","14.76"
"10","002","00","080","0024","0000","309","79","230","4","313","780","0","40.13","10.13"
"10","002","00","080","0024","0346","309","79","230","4","313","780","0","40.13","10.13"
"10","002","00","090","0000","0000","13688","4356","9332","129","13817","35466","40343","38.96","12.28"
"10","002","00","090","0001","0000","802","227","575","8","810","2052","0","39.47","11.06"
"10","002","00","090","0001","0347","414","122","292","3","417","1094","0","38.12","11.15"
"10","002","00","090","0001","0348","388","105","283","5","393","958","0","41.02","10.96"
"10","002","00","090","0002","0000","785","295","490","10","795","1872","0","42.47","15.76"
"10","002","00","090","0002","0349","375","154","221","5","380","917","0","41.44","16.79"
"10","002","00","090","0002","0350","410","141","269","5","415","955","0","43.46","14.76"
"10","002","00","090","0003","0000","1092","359","733","9","1101","2629","0","41.88","13.66"
"10","002","00","090","0003","0351","318","120","198","2","320","786","0","40.71","15.27"
"10","002","00","090","0003","0352","347","113","234","3","350","851","0","41.13","13.28"
"10","002","00","090","0003","0353","427","126","301","4","431","992","0","43.45","12.70"
"10","002","00","090","0004","0000","660","239","421","6","666","1563","0","42.61","15.29"
"10","002","00","090","0004","0354","342","123","219","2","344","771","0","44.62","15.95"
"10","002","00","090","0004","0355","318","116","202","4","322","792","0","40.66","14.65"
"10","002","00","090","0005","0000","501","162","339","3","504","1350","0","37.33","12.00"
"10","002","00","090","0005","0356","501","162","339","3","504","1350","0","37.33","12.00"
"10","002","00","090","0006","0000","1109","409","700","10","1119","2551","0","43.87","16.03"
"10","002","00","090","0006","0357","247","105","142","3","250","592","0","42.23","17.74"
"10","002","00","090","0006","0358","429","152","277","5","434","938","0","46.27","16.20"
"10","002","00","090","0006","0359","433","152","281","2","435","1021","0","42.61","14.89"
"10","002","00","090","0007","0000","739","218","521","7","746","1777","0","41.98","12.27"
"10","002","00","090","0007","0360","390","116","274","6","396","943","0","41.99","12.30"
"10","002","00","090","0007","0361","349","102","247","1","350","834","0","41.97","12.23"
"10","002","00","090","0008","0000","1343","453","890","16","1359","3725","0","36.48","12.16"
"10","002","00","090","0008","0362","324","103","221","4","328","951","0","34.49","10.83"
"10","002","00","090","0008","0363","377","140","237","3","380","948","0","40.08","14.77"
"10","002","00","090","0008","0364","311","104","207","3","314","941","0","33.37","11.05"
"10","002","00","090","0008","0365","331","106","225","6","337","885","0","38.08","11.98"
"10","002","00","090","0009","0000","1439","514","925","9","1448","3727","0","38.85","13.79"
"10","002","00","090","0009","0369","371","135","236","0","371","924","0","40.15","14.61"
"10","002","00","090","0009","0370","343","140","203","5","348","943","0","36.90","14.85"
"10","002","00","090","0009","0371","415","142","273","2","417","1038","0","40.17","13.68"
"10","002","00","090","0009","0372","310","97","213","2","312","822","0","37.96","11.80"
"10","002","00","090","0010","0000","1208","355","853","16","1224","3260","0","37.55","10.89"
"10","002","00","090","0010","0366","444","131","313","7","451","1124","0","40.12","11.65"
"10","002","00","090","0010","0367","329","101","228","5","334","912","0","36.62","11.07"
"10","002","00","090","0010","0368","435","123","312","4","439","1224","0","35.87","10.05"
"10","002","00","090","0011","0000","639","169","470","4","643","1654","0","38.88","10.22"
"10","002","00","090","0011","0373","342","69","273","1","343","912","0","37.61","7.57"
"10","002","00","090","0011","0374","297","100","197","3","300","742","0","40.43","13.48"
"10","002","00","090","0012","0000","555","199","356","2","557","1417","0","39.31","14.04"
"10","002","00","090","0012","0375","247","106","141","0","247","625","0","39.52","16.96"
"10","002","00","090","0012","0376","308","93","215","2","310","792","0","39.14","11.74"
"10","002","00","090","0013","0000","672","187","485","11","683","1951","0","35.01","9.58"
"10","002","00","090","0013","0377","328","82","246","6","334","912","0","36.62","8.99"
"10","002","00","090","0013","0378","344","105","239","5","349","1039","0","33.59","10.11"
"10","002","00","090","0014","0000","1145","284","861","11","1156","3177","0","36.39","8.94"
"10","002","00","090","0014","0379","334","84","250","4","338","1003","0","33.70","8.37"
"10","002","00","090","0014","0380","475","120","355","7","482","1257","0","38.35","9.55"
"10","002","00","090","0014","0381","336","80","256","0","336","917","0","36.64","8.72"
"10","002","00","090","0015","0000","999","286","713","7","1006","2761","0","36.44","10.36"
"10","002","00","090","0015","0382","293","72","221","4","297","852","0","34.86","8.45"
"10","002","00","090","0015","0383","436","123","313","3","439","1221","0","35.95","10.07"
"10","002","00","090","0015","0384","270","91","179","0","270","688","0","39.24","13.23"
"10","002","00","100","0000","0000","7140","2368","4772","76","7216","19047","21219","37.89","12.43"
"10","002","00","100","0001","0000","83","37","46","0","83","207","0","40.10","17.87"
"10","002","00","100","0001","0385","83","37","46","0","83","207","0","40.10","17.87"
"10","002","00","100","0002","0000","147","56","91","3","150","498","0","30.12","11.24"
"10","002","00","100","0002","0386","147","56","91","3","150","498","0","30.12","11.24"
"10","002","00","100","0003","0000","234","76","158","5","239","712","0","33.57","10.67"
"10","002","00","100","0003","0387","234","76","158","5","239","712","0","33.57","10.67"
"10","002","00","100","0004","0000","246","71","175","2","248","553","0","44.85","12.84"
"10","002","00","100","0004","0391","246","71","175","2","248","553","0","44.85","12.84"
"10","002","00","100","0005","0000","158","64","94","1","159","448","0","35.49","14.29"
"10","002","00","100","0005","0392","158","64","94","1","159","448","0","35.49","14.29"
"10","002","00","100","0006","0000","406","171","235","2","408","1133","0","36.01","15.09"
"10","002","00","100","0006","0393","406","171","235","2","408","1133","0","36.01","15.09"
"10","002","00","100","0007","0000","429","162","267","5","434","1145","0","37.90","14.15"
"10","002","00","100","0007","0394","429","162","267","5","434","1145","0","37.90","14.15"
"10","002","00","100","0008","0000","306","116","190","4","310","870","0","35.63","13.33"
"10","002","00","100","0008","0395","306","116","190","4","310","870","0","35.63","13.33"
"10","002","00","100","0009","0000","395","118","277","2","397","1358","0","29.23","8.69"
"10","002","00","100","0009","0396","395","118","277","2","397","1358","0","29.23","8.69"
"10","002","00","100","0010","0000","1539","519","1020","12","1551","4328","0","35.84","11.99"
"10","002","00","100","0010","0398","347","114","233","5","352","990","0","35.56","11.52"
"10","002","00","100","0010","0399","382","144","238","3","385","1075","0","35.81","13.40"
"10","002","00","100","0010","0400","419","134","285","0","419","1123","0","37.31","11.93"
"10","002","00","100","0010","0401","391","127","264","4","395","1140","0","34.65","11.14"
"10","002","00","100","0011","0000","331","90","241","6","337","890","0","37.87","10.11"
"10","002","00","100","0011","0397","331","90","241","6","337","890","0","37.87","10.11"
"10","002","00","100","0012","0000","238","80","158","3","241","586","0","41.13","13.65"
"10","002","00","100","0012","0388","238","80","158","3","241","586","0","41.13","13.65"
"10","002","00","100","0013","0000","188","71","117","4","192","525","0","36.57","13.52"
"10","002","00","100","0013","0389","188","71","117","4","192","525","0","36.57","13.52"
"10","002","00","100","0014","0000","281","97","184","4","285","731","0","38.99","13.27"
"10","002","00","100","0014","0390","281","97","184","4","285","731","0","38.99","13.27"
"10","002","00","100","0015","0000","520","153","367","6","526","1266","0","41.55","12.09"
"10","002","00","100","0015","0402","520","153","367","6","526","1266","0","41.55","12.09"
"10","002","00","100","0016","0000","287","97","190","3","290","758","0","38.26","12.80"
"10","002","00","100","0016","0403","287","97","190","3","290","758","0","38.26","12.80"
"10","002","00","100","0017","0000","747","222","525","7","754","1581","0","47.69","14.04"
"10","002","00","100","0017","0404","399","123","276","2","401","813","0","49.32","15.13"
"10","002","00","100","0017","0405","348","99","249","5","353","768","0","45.96","12.89"
"10","002","00","100","0018","0000","605","168","437","7","612","1458","0","41.98","11.52"
"10","002","00","100","0018","0406","266","66","200","5","271","668","0","40.57","9.88"
"10","002","00","100","0018","0407","339","102","237","2","341","790","0","43.16","12.91"
"10","002","00","110","0000","0000","1369","1074","295","18","1387","4915","6099","28.22","21.85"
"10","002","00","110","0001","0000","288","249","39","2","290","923","0","31.42","26.98"
"10","002","00","110","0001","0408","288","249","39","2","290","923","0","31.42","26.98"
"10","002","00","110","0002","0000","184","163","21","5","189","629","0","30.05","25.91"
"10","002","00","110","0002","0409","184","163","21","5","189","629","0","30.05","25.91"
"10","002","00","110","0003","0000","200","137","63","4","204","701","0","29.10","19.54"
"10","002","00","110","0003","0410","200","137","63","4","204","701","0","29.10","19.54"
"10","002","00","110","0004","0000","100","53","47","0","100","262","0","38.17","20.23"
"10","002","00","110","0004","0411","100","53","47","0","100","262","0","38.17","20.23"
"10","002","00","110","0005","0000","98","76","22","1","99","325","0","30.46","23.38"
"10","002","00","110","0005","0412","98","76","22","1","99","325","0","30.46","23.38"
"10","002","00","110","0006","0000","112","97","15","1","113","392","0","28.83","24.74"
"10","002","00","110","0006","0413","112","97","15","1","113","392","0","28.83","24.74"
"10","002","00","110","0007","0000","18","11","7","0","18","54","0","33.33","20.37"
"10","002","00","110","0007","0414","18","11","7","0","18","54","0","33.33","20.37"
"10","002","00","110","0008","0000","185","151","34","3","188","763","0","24.64","19.79"
"10","002","00","110","0008","0416","185","151","34","3","188","763","0","24.64","19.79"
"10","002","00","110","0009","0000","126","94","32","2","128","659","0","19.42","14.26"
"10","002","00","110","0009","0417","126","94","32","2","128","659","0","19.42","14.26"
"10","002","00","110","0010","0000","58","43","15","0","58","207","0","28.02","20.77"
"10","002","00","110","0010","0415","58","43","15","0","58","207","0","28.02","20.77"
"10","002","00","120","0000","0000","1257","1070","187","24","1281","4564","5956","28.07","23.44"
"10","002","00","120","0001","0000","297","245","52","8","305","1156","0","26.38","21.19"
"10","002","00","120","0001","0419","297","245","52","8","305","1156","0","26.38","21.19"
"10","002","00","120","0002","0000","236","205","31","3","239","955","0","25.03","21.47"
"10","002","00","120","0002","0420","236","205","31","3","239","955","0","25.03","21.47"
"10","002","00","120","0003","0000","153","125","28","0","153","435","0","35.17","28.74"
"10","002","00","120","0003","0418","153","125","28","0","153","435","0","35.17","28.74"
"10","002","00","120","0004","0000","86","79","7","2","88","406","0","21.67","19.46"
"10","002","00","120","0004","0421","86","79","7","2","88","406","0","21.67","19.46"
"10","002","00","120","0005","0000","130","107","23","3","133","430","0","30.93","24.88"
"10","002","00","120","0005","0422","130","107","23","3","133","430","0","30.93","24.88"
"10","002","00","120","0006","0000","126","105","21","1","127","475","0","26.74","22.11"
"10","002","00","120","0006","0423","126","105","21","1","127","475","0","26.74","22.11"
"10","002","00","120","0007","0000","229","204","25","7","236","707","0","33.38","28.85"
"10","002","00","120","0007","0424","229","204","25","7","236","707","0","33.38","28.85"
"10","015","00","000","0000","0000","97780","66929","30851","1286","99066","275091","322836","36.01","24.33"
"10","015","00","010","0000","0000","32687","21464","11223","302","32989","83830","101853","39.35","25.60"
"10","015","00","010","0001","0000","621","405","216","5","626","1592","0","39.32","25.44"
"10","015","00","010","0001","0022","367","239","128","2","369","821","0","44.95","29.11"
"10","015","00","010","0001","0023","254","166","88","3","257","771","0","33.33","21.53"
"10","015","00","010","0002","0000","820","540","280","18","838","1985","0","42.22","27.20"
"10","015","00","010","0002","0016","462","303","159","8","470","1114","0","42.19","27.20"
"10","015","00","010","0002","0017","358","237","121","10","368","871","0","42.25","27.21"
"10","015","00","010","0003","0000","167","107","60","2","169","422","0","40.05","25.36"
"10","015","00","010","0003","0027","167","107","60","2","169","422","0","40.05","25.36"
"10","015","00","010","0004","0000","273","158","115","2","275","664","0","41.42","23.80"
"10","015","00","010","0004","0033","273","158","115","2","275","664","0","41.42","23.80"
"10","015","00","010","0005","0000","206","122","84","0","206","558","0","36.92","21.86"
"10","015","00","010","0005","0035","206","122","84","0","206","558","0","36.92","21.86"
"10","015","00","010","0006","0000","1094","685","409","11","1105","2927","0","37.75","23.40"
"10","015","00","010","0006","0037","367","243","124","4","371","901","0","41.18","26.97"
"10","015","00","010","0006","0038","333","217","116","3","336","1036","0","32.43","20.95"
"10","015","00","010","0006","0039","394","225","169","4","398","990","0","40.20","22.73"
"10","015","00","010","0007","0000","576","330","246","7","583","1769","0","32.96","18.65"
"10","015","00","010","0007","0059","257","141","116","1","258","947","0","27.24","14.89"
"10","015","00","010","0007","0060","319","189","130","6","325","822","0","39.54","22.99"
"10","015","00","010","0008","0000","1249","801","448","12","1261","3186","0","39.58","25.14"
"10","015","00","010","0008","0056","417","263","154","4","421","985","0","42.74","26.70"
"10","015","00","010","0008","0057","435","298","137","5","440","1125","0","39.11","26.49"
"10","015","00","010","0008","0058","397","240","157","3","400","1076","0","37.17","22.30"
"10","015","00","010","0009","0000","657","419","238","2","659","1486","0","44.35","28.20"
"10","015","00","010","0009","0001","328","218","110","1","329","736","0","44.70","29.62"
"10","015","00","010","0009","0002","329","201","128","1","330","750","0","44.00","26.80"
"10","015","00","010","0010","0000","805","658","147","14","819","2020","0","40.54","32.57"
"10","015","00","010","0010","0006","163","131","32","1","164","473","0","34.67","27.70"
"10","015","00","010","0010","0007","347","264","83","10","357","842","0","42.40","31.35"
"10","015","00","010","0010","0008","295","263","32","3","298","705","0","42.27","37.30"
"10","015","00","010","0012","0000","198","130","68","0","198","464","0","42.67","28.02"
"10","015","00","010","0012","0034","198","130","68","0","198","464","0","42.67","28.02"
"10","015","00","010","0013","0000","227","131","96","1","228","492","0","46.34","26.63"
"10","015","00","010","0013","0032","227","131","96","1","228","492","0","46.34","26.63"
"10","015","00","010","0014","0000","1329","862","467","14","1343","3477","0","38.63","24.79"
"10","015","00","010","0014","0042","396","269","127","4","400","983","0","40.69","27.37"
"10","015","00","010","0014","0043","334","219","115","1","335","903","0","37.10","24.25"
"10","015","00","010","0014","0044","323","201","122","5","328","796","0","41.21","25.25"
"10","015","00","010","0014","0045","276","173","103","4","280","795","0","35.22","21.76"
"10","015","00","010","0015","0000","300","178","122","5","305","821","0","37.15","21.68"
"10","015","00","010","0015","0061","300","178","122","5","305","821","0","37.15","21.68"
"10","015","00","010","0016","0000","1960","1277","683","17","1977","4822","0","41.00","26.48"
"10","015","00","010","0016","0078","375","241","134","6","381","924","0","41.23","26.08"
"10","015","00","010","0016","0079","356","230","126","1","357","960","0","37.19","23.96"
"10","015","00","010","0016","0080","423","285","138","2","425","958","0","44.36","29.75"
"10","015","00","010","0016","0081","363","228","135","5","368","924","0","39.83","24.68"
"10","015","00","010","0016","0082","443","293","150","3","446","1056","0","42.23","27.75"
"10","015","00","010","0017","0000","1537","1060","477","11","1548","3629","0","42.66","29.21"
"10","015","00","010","0017","0018","390","283","107","3","393","908","0","43.28","31.17"
"10","015","00","010","0017","0019","407","290","117","0","407","906","0","44.92","32.01"
"10","015","00","010","0017","0020","354","219","135","4","358","887","0","40.36","24.69"
"10","015","00","010","0017","0021","386","268","118","4","390","928","0","42.03","28.88"
"10","015","00","010","0018","0000","1250","855","395","19","1269","3092","0","41.04","27.65"
"10","015","00","010","0018","0003","415","297","118","7","422","996","0","42.37","29.82"
"10","015","00","010","0018","0004","394","273","121","4","398","987","0","40.32","27.66"
"10","015","00","010","0018","0005","441","285","156","8","449","1109","0","40.49","25.70"
"10","015","00","010","0019","0000","424","235","189","6","430","1077","0","39.93","21.82"
"10","015","00","010","0019","0028","424","235","189","6","430","1077","0","39.93","21.82"
"10","015","00","010","0020","0000","215","110","105","1","216","537","0","40.22","20.48"
"10","015","00","010","0020","0030","215","110","105","1","216","537","0","40.22","20.48"
"10","015","00","010","0021","0000","715","444","271","9","724","1821","0","39.76","24.38"
"10","015","00","010","0021","0040","336","215","121","3","339","853","0","39.74","25.21"
"10","015","00","010","0021","0041","379","229","150","6","385","968","0","39.77","23.66"
"10","015","00","010","0022","0000","466","318","148","5","471","1214","0","38.80","26.19"
"10","015","00","010","0022","0063","466","318","148","5","471","1214","0","38.80","26.19"
"10","015","00","010","0023","0000","1022","621","401","5","1027","2759","0","37.22","22.51"
"10","015","00","010","0023","0069","287","176","111","2","289","782","0","36.96","22.51"
"10","015","00","010","0023","0070","383","228","155","2","385","977","0","39.41","23.34"
"10","015","00","010","0023","0071","352","217","135","1","353","1000","0","35.30","21.70"
"10","015","00","010","0024","0000","643","417","226","3","646","1757","0","36.77","23.73"
"10","015","00","010","0024","0076","296","197","99","0","296","766","0","38.64","25.72"
"10","015","00","010","0024","0077","347","220","127","3","350","991","0","35.32","22.20"
"10","015","00","010","0025","0000","380","261","119","3","383","932","0","41.09","28.00"
"10","015","00","010","0025","0009","380","261","119","3","383","932","0","41.09","28.00"
"10","015","00","010","0026","0000","238","160","78","2","240","616","0","38.96","25.97"
"10","015","00","010","0026","0024","238","160","78","2","240","616","0","38.96","25.97"
"10","015","00","010","0027","0000","208","153","55","1","209","549","0","38.07","27.87"
"10","015","00","010","0027","0026","208","153","55","1","209","549","0","38.07","27.87"
"10","015","00","010","0028","0000","333","198","135","2","335","763","0","43.91","25.95"
"10","015","00","010","0028","0031","333","198","135","2","335","763","0","43.91","25.95"
"10","015","00","010","0029","0000","1047","640","407","8","1055","2643","0","39.92","24.21"
"10","015","00","010","0029","0053","351","213","138","0","351","828","0","42.39","25.72"
"10","015","00","010","0029","0054","363","223","140","7","370","874","0","42.33","25.51"
"10","015","00","010","0029","0055","333","204","129","1","334","941","0","35.49","21.68"
"10","015","00","010","0030","0000","198","124","74","2","200","496","0","40.32","25.00"
"10","015","00","010","0030","0062","198","124","74","2","200","496","0","40.32","25.00"
"10","015","00","010","0031","0000","776","475","301","12","788","1849","0","42.62","25.69"
"10","015","00","010","0031","0067","379","245","134","6","385","942","0","40.87","26.01"
"10","015","00","010","0031","0068","397","230","167","6","403","907","0","44.43","25.36"
"10","015","00","010","0032","0000","405","224","181","3","408","1069","0","38.17","20.95"
"10","015","00","010","0032","0087","405","224","181","3","408","1069","0","38.17","20.95"
"10","015","00","010","0033","0000","1221","896","325","8","1229","3012","0","40.80","29.75"
"10","015","00","010","0033","0010","360","280","80","5","365","1006","0","36.28","27.83"
"10","015","00","010","0033","0011","412","290","122","1","413","995","0","41.51","29.15"
"10","015","00","010","0033","0012","449","326","123","2","451","1011","0","44.61","32.25"
"10","015","00","010","0034","0000","222","119","103","0","222","584","0","38.01","20.38"
"10","015","00","010","0034","0025","222","119","103","0","222","584","0","38.01","20.38"
"10","015","00","010","0035","0000","173","117","56","0","173","419","0","41.29","27.92"
"10","015","00","010","0035","0029","173","117","56","0","173","419","0","41.29","27.92"
"10","015","00","010","0036","0000","305","202","103","1","306","817","0","37.45","24.72"
"10","015","00","010","0036","0036","305","202","103","1","306","817","0","37.45","24.72"
"10","015","00","010","0037","0000","1975","1308","667","23","1998","5198","0","38.44","25.16"
"10","015","00","010","0037","0048","356","223","133","1","357","903","0","39.53","24.70"
"10","015","00","010","0037","0049","334","234","100","3","337","929","0","36.28","25.19"
"10","015","00","010","0037","0050","400","258","142","12","412","1165","0","35.36","22.15"
"10","015","00","010","0037","0051","442","295","147","3","445","1198","0","37.15","24.62"
"10","015","00","010","0037","0052","443","298","145","4","447","1003","0","44.57","29.71"
"10","015","00","010","0038","0000","870","550","320","4","874","2120","0","41.23","25.94"
"10","015","00","010","0038","0065","407","265","142","1","408","1061","0","38.45","24.98"
"10","015","00","010","0038","0066","463","285","178","3","466","1059","0","44.00","26.91"
"10","015","00","010","0039","0000","316","188","128","1","317","816","0","38.85","23.04"
"10","015","00","010","0039","0064","316","188","128","1","317","816","0","38.85","23.04"
"10","015","00","010","0040","0000","465","332","133","5","470","1480","0","31.76","22.43"
"10","015","00","010","0040","0092","218","171","47","1","219","733","0","29.88","23.33"
"10","015","00","010","0040","0093","247","161","86","4","251","747","0","33.60","21.55"
"10","015","00","010","0041","0000","1618","1102","516","10","1628","4171","0","39.03","26.42"
"10","015","00","010","0041","0083","402","246","156","2","404","1105","0","36.56","22.26"
"10","015","00","010","0041","0084","393","269","124","1","394","1009","0","39.05","26.66"
"10","015","00","010","0041","0085","425","285","140","1","426","1053","0","40.46","27.07"
"10","015","00","010","0041","0086","398","302","96","6","404","1004","0","40.24","30.08"
"10","015","00","010","0042","0000","856","572","284","10","866","2412","0","35.90","23.71"
"10","015","00","010","0042","0046","454","299","155","7","461","1213","0","38.00","24.65"
"10","015","00","010","0042","0047","402","273","129","3","405","1199","0","33.78","22.77"
"10","015","00","010","0043","0000","1237","824","413","7","1244","3671","0","33.89","22.45"
"10","015","00","010","0043","0072","312","206","106","2","314","907","0","34.62","22.71"
"10","015","00","010","0043","0073","315","214","101","1","316","886","0","35.67","24.15"
"10","015","00","010","0043","0074","298","194","104","1","299","938","0","31.88","20.68"
"10","015","00","010","0043","0075","312","210","102","3","315","940","0","33.51","22.34"
"10","015","00","010","0044","0000","1684","1139","545","15","1699","4204","0","40.41","27.09"
"10","015","00","010","0044","0088","461","312","149","5","466","1004","0","46.41","31.08"
"10","015","00","010","0044","0089","428","271","157","4","432","1116","0","38.71","24.28"
"10","015","00","010","0044","0090","394","287","107","2","396","1140","0","34.74","25.18"
"10","015","00","010","0044","0091","401","269","132","4","405","944","0","42.90","28.50"
"10","015","00","010","0045","0000","1406","1017","389","16","1422","3438","0","41.36","29.58"
"10","015","00","010","0045","0013","420","266","154","6","426","1087","0","39.19","24.47"
"10","015","00","010","0045","0014","444","328","116","3","447","1107","0","40.38","29.63"
"10","015","00","010","0045","0015","542","423","119","7","549","1244","0","44.13","34.00"
"10","015","00","020","0000","0000","3564","2504","1060","69","3633","9479","10764","38.33","26.42"
"10","015","00","020","0001","0000","433","298","135","11","444","1166","0","38.08","25.56"
"10","015","00","020","0001","0221","433","298","135","11","444","1166","0","38.08","25.56"
"10","015","00","020","0002","0000","261","205","56","5","266","631","0","42.16","32.49"
"10","015","00","020","0002","0222","261","205","56","5","266","631","0","42.16","32.49"
"10","015","00","020","0003","0000","260","180","80","3","263","575","0","45.74","31.30"
"10","015","00","020","0003","0223","260","180","80","3","263","575","0","45.74","31.30"
"10","015","00","020","0004","0000","408","312","96","4","412","1075","0","38.33","29.02"
"10","015","00","020","0004","0224","408","312","96","4","412","1075","0","38.33","29.02"
"10","015","00","020","0005","0000","463","355","108","14","477","1332","0","35.81","26.65"
"10","015","00","020","0005","0225","228","175","53","12","240","745","0","32.21","23.49"
"10","015","00","020","0005","0226","235","180","55","2","237","587","0","40.37","30.66"
"10","015","00","020","0006","0000","167","131","36","8","175","539","0","32.47","24.30"
"10","015","00","020","0006","0227","94","61","33","7","101","301","0","33.55","20.27"
"10","015","00","020","0006","0228","73","70","3","1","74","238","0","31.09","29.41"
"10","015","00","020","0007","0000","458","293","165","6","464","1250","0","37.12","23.44"
"10","015","00","020","0007","0229","250","139","111","4","254","730","0","34.79","19.04"
"10","015","00","020","0007","0230","208","154","54","2","210","520","0","40.38","29.62"
"10","015","00","020","0008","0000","204","110","94","4","208","538","0","38.66","20.45"
"10","015","00","020","0008","0231","204","110","94","4","208","538","0","38.66","20.45"
"10","015","00","020","0009","0000","208","137","71","3","211","524","0","40.27","26.15"
"10","015","00","020","0009","0232","208","137","71","3","211","524","0","40.27","26.15"
"10","015","00","020","0010","0000","339","235","104","3","342","793","0","43.13","29.63"
"10","015","00","020","0010","0233","339","235","104","3","342","793","0","43.13","29.63"
"10","015","00","020","0011","0000","319","212","107","8","327","959","0","34.10","22.11"
"10","015","00","020","0011","0234","319","212","107","8","327","959","0","34.10","22.11"
"10","015","00","020","0012","0000","44","36","8","0","44","97","0","45.36","37.11"
"10","015","00","020","0012","0235","44","36","8","0","44","97","0","45.36","37.11"
"10","015","00","030","0000","0000","5911","4194","1717","107","6018","19990","23121","30.11","20.98"
"10","015","00","030","0001","0000","1743","1166","577","19","1762","5047","0","34.91","23.10"
"10","015","00","030","0001","0280","321","208","113","6","327","1028","0","31.81","20.23"
"10","015","00","030","0001","0281","320","224","96","3","323","870","0","37.13","25.75"
"10","015","00","030","0001","0282","207","120","87","3","210","607","0","34.60","19.77"
"10","015","00","030","0001","0283","297","208","89","5","302","858","0","35.20","24.24"
"10","015","00","030","0001","0284","257","180","77","1","258","761","0","33.90","23.65"
"10","015","00","030","0001","0285","341","226","115","1","342","923","0","37.05","24.49"
"10","015","00","030","0002","0000","474","330","144","8","482","1587","0","30.37","20.79"
"10","015","00","030","0002","0287","251","179","72","2","253","817","0","30.97","21.91"
"10","015","00","030","0002","0288","223","151","72","6","229","770","0","29.74","19.61"
"10","015","00","030","0003","0000","335","239","96","5","340","1191","0","28.55","20.07"
"10","015","00","030","0003","0291","160","123","37","4","164","508","0","32.28","24.21"
"10","015","00","030","0003","0292","175","116","59","1","176","683","0","25.77","16.98"
"10","015","00","030","0004","0000","336","248","88","3","339","1281","0","26.46","19.36"
"10","015","00","030","0004","0289","182","120","62","2","184","536","0","34.33","22.39"
"10","015","00","030","0004","0290","154","128","26","1","155","745","0","20.81","17.18"
"10","015","00","030","0005","0000","446","287","159","5","451","1150","0","39.22","24.96"
"10","015","00","030","0005","0286","446","287","159","5","451","1150","0","39.22","24.96"
"10","015","00","030","0006","0000","314","220","94","4","318","1204","0","26.41","18.27"
"10","015","00","030","0006","0293","314","220","94","4","318","1204","0","26.41","18.27"
"10","015","00","030","0007","0000","148","113","35","4","152","606","0","25.08","18.65"
"10","015","00","030","0007","0294","148","113","35","4","152","606","0","25.08","18.65"
"10","015","00","030","0008","0000","280","229","51","7","287","963","0","29.80","23.78"
"10","015","00","030","0008","0295","280","229","51","7","287","963","0","29.80","23.78"
"10","015","00","030","0009","0000","153","116","37","3","156","521","0","29.94","22.26"
"10","015","00","030","0009","0296","153","116","37","3","156","521","0","29.94","22.26"
"10","015","00","030","0010","0000","399","304","95","11","410","1500","0","27.33","20.27"
"10","015","00","030","0010","0297","250","192","58","5","255","956","0","26.67","20.08"
"10","015","00","030","0010","0298","149","112","37","6","155","544","0","28.49","20.59"
"10","015","00","030","0011","0000","306","232","74","10","316","1449","0","21.81","16.01"
"10","015","00","030","0011","0299","91","73","18","2","93","412","0","22.57","17.72"
"10","015","00","030","0011","0300","215","159","56","8","223","1037","0","21.50","15.33"
"10","015","00","030","0012","0000","251","182","69","11","262","838","0","31.26","21.72"
"10","015","00","030","0012","0301","251","182","69","11","262","838","0","31.26","21.72"
"10","015","00","030","0013","0000","201","159","42","11","212","750","0","28.27","21.20"
"10","015","00","030","0013","0302","201","159","42","11","212","750","0","28.27","21.20"
"10","015","00","030","0014","0000","241","155","86","5","246","864","0","28.47","17.94"
"10","015","00","030","0014","0303","241","155","86","5","246","864","0","28.47","17.94"
"10","015","00","030","0015","0000","284","214","70","1","285","1039","0","27.43","20.60"
"10","015","00","030","0015","0304","284","214","70","1","285","1039","0","27.43","20.60"
"10","015","00","040","0000","0000","5940","4116","1824","92","6032","17209","20015","35.05","23.92"
"10","015","00","040","0001","0000","498","309","189","13","511","1249","0","40.91","24.74"
"10","015","00","040","0001","0094","128","81","47","3","131","336","0","38.99","24.11"
"10","015","00","040","0001","0095","370","228","142","10","380","913","0","41.62","24.97"
"10","015","00","040","0002","0000","310","134","176","8","318","901","0","35.29","14.87"
"10","015","00","040","0002","0096","197","90","107","7","204","598","0","34.11","15.05"
"10","015","00","040","0002","0097","113","44","69","1","114","303","0","37.62","14.52"
"10","015","00","040","0003","0000","803","536","267","15","818","2413","0","33.90","22.21"
"10","015","00","040","0003","0098","377","253","124","8","385","1128","0","34.13","22.43"
"10","015","00","040","0003","0099","426","283","143","7","433","1285","0","33.70","22.02"
"10","015","00","040","0004","0000","1440","1005","435","17","1457","4113","0","35.42","24.43"
"10","015","00","040","0004","0103","308","220","88","6","314","904","0","34.73","24.34"
"10","015","00","040","0004","0104","396","277","119","3","399","997","0","40.02","27.78"
"10","015","00","040","0004","0105","379","265","114","4","383","1026","0","37.33","25.83"
"10","015","00","040","0004","0106","357","243","114","4","361","1186","0","30.44","20.49"
"10","015","00","040","0005","0000","370","246","124","2","372","992","0","37.50","24.80"
"10","015","00","040","0005","0107","370","246","124","2","372","992","0","37.50","24.80"
"10","015","00","040","0006","0000","1247","904","343","13","1260","3787","0","33.27","23.87"
"10","015","00","040","0006","0108","317","211","106","1","318","988","0","32.19","21.36"
"10","015","00","040","0006","0109","325","247","78","6","331","936","0","35.36","26.39"
"10","015","00","040","0006","0110","313","236","77","3","316","860","0","36.74","27.44"
"10","015","00","040","0006","0111","292","210","82","3","295","1003","0","29.41","20.94"
"10","015","00","040","0007","0000","393","303","90","5","398","1243","0","32.02","24.38"
"10","015","00","040","0007","0112","273","219","54","3","276","887","0","31.12","24.69"
"10","015","00","040","0007","0113","120","84","36","2","122","356","0","34.27","23.60"
"10","015","00","040","0008","0000","879","679","200","19","898","2511","0","35.76","27.04"
"10","015","00","040","0008","0100","357","277","80","13","370","986","0","37.53","28.09"
"10","015","00","040","0008","0101","420","324","96","5","425","1178","0","36.08","27.50"
"10","015","00","040","0008","0102","102","78","24","1","103","347","0","29.68","22.48"
"10","015","00","050","0000","0000","27161","18241","8920","295","27456","72533","83515","37.85","25.15"
"10","015","00","050","0001","0000","2912","1867","1045","22","2934","7104","0","41.30","26.28"
"10","015","00","050","0001","0170","395","243","152","2","397","1059","0","37.49","22.95"
"10","015","00","050","0001","0171","460","322","138","2","462","1027","0","44.99","31.35"
"10","015","00","050","0001","0172","425","265","160","3","428","1042","0","41.07","25.43"
"10","015","00","050","0001","0173","394","228","166","7","401","1013","0","39.59","22.51"
"10","015","00","050","0001","0174","453","307","146","2","455","1049","0","43.37","29.27"
"10","015","00","050","0001","0175","395","255","140","3","398","937","0","42.48","27.21"
"10","015","00","050","0001","0176","390","247","143","3","393","977","0","40.23","25.28"
"10","015","00","050","0002","0000","2017","1272","745","12","2029","4909","0","41.33","25.91"
"10","015","00","050","0002","0177","531","344","187","7","538","1239","0","43.42","27.76"
"10","015","00","050","0002","0178","494","316","178","3","497","1255","0","39.60","25.18"
"10","015","00","050","0002","0179","494","311","183","1","495","1245","0","39.76","24.98"
"10","015","00","050","0002","0180","498","301","197","1","499","1170","0","42.65","25.73"
"10","015","00","050","0003","0000","1273","782","491","28","1301","3726","0","34.92","20.99"
"10","015","00","050","0003","0136","471","267","204","9","480","1232","0","38.96","21.67"
"10","015","00","050","0003","0137","447","264","183","8","455","1309","0","34.76","20.17"
"10","015","00","050","0003","0138","355","251","104","11","366","1185","0","30.89","21.18"
"10","015","00","050","0004","0000","1642","1099","543","11","1653","4253","0","38.87","25.84"
"10","015","00","050","0004","0132","393","248","145","3","396","1039","0","38.11","23.87"
"10","015","00","050","0004","0133","444","310","134","1","445","1027","0","43.33","30.19"
"10","015","00","050","0004","0134","389","268","121","2","391","1045","0","37.42","25.65"
"10","015","00","050","0004","0135","416","273","143","5","421","1142","0","36.87","23.91"
"10","015","00","050","0005","0000","2603","1734","869","25","2628","6951","0","37.81","24.95"
"10","015","00","050","0005","0139","545","374","171","3","548","1273","0","43.05","29.38"
"10","015","00","050","0005","0140","448","303","145","4","452","1141","0","39.61","26.56"
"10","015","00","050","0005","0141","395","263","132","2","397","1166","0","34.05","22.56"
"10","015","00","050","0005","0142","391","236","155","2","393","1014","0","38.76","23.27"
"10","015","00","050","0005","0143","449","307","142","10","459","1373","0","33.43","22.36"
"10","015","00","050","0005","0144","375","251","124","4","379","984","0","38.52","25.51"
"10","015","00","050","0006","0000","2024","1383","641","19","2043","5283","0","38.67","26.18"
"10","015","00","050","0006","0145","472","315","157","2","474","1215","0","39.01","25.93"
"10","015","00","050","0006","0146","508","353","155","2","510","1220","0","41.80","28.93"
"10","015","00","050","0006","0147","314","211","103","2","316","814","0","38.82","25.92"
"10","015","00","050","0006","0148","317","220","97","5","322","954","0","33.75","23.06"
"10","015","00","050","0006","0149","413","284","129","8","421","1080","0","38.98","26.30"
"10","015","00","050","0007","0000","1171","739","432","22","1193","2931","0","40.70","25.21"
"10","015","00","050","0007","0150","395","268","127","11","406","1090","0","37.25","24.59"
"10","015","00","050","0007","0151","368","235","133","5","373","889","0","41.96","26.43"
"10","015","00","050","0007","0152","408","236","172","6","414","952","0","43.49","24.79"
"10","015","00","050","0008","0000","603","346","257","11","614","1568","0","39.16","22.07"
"10","015","00","050","0008","0153","308","165","143","3","311","801","0","38.83","20.60"
"10","015","00","050","0008","0154","295","181","114","8","303","767","0","39.50","23.60"
"10","015","00","050","0009","0000","415","320","95","4","419","1280","0","32.73","25.00"
"10","015","00","050","0009","0155","415","320","95","4","419","1280","0","32.73","25.00"
"10","015","00","050","0010","0000","1006","724","282","12","1018","2922","0","34.84","24.78"
"10","015","00","050","0010","0156","380","261","119","4","384","908","0","42.29","28.74"
"10","015","00","050","0010","0157","267","199","68","5","272","914","0","29.76","21.77"
"10","015","00","050","0010","0158","359","264","95","3","362","1100","0","32.91","24.00"
"10","015","00","050","0011","0000","1215","831","384","15","1230","3170","0","38.80","26.21"
"10","015","00","050","0011","0159","389","274","115","4","393","947","0","41.50","28.93"
"10","015","00","050","0011","0160","391","251","140","5","396","989","0","40.04","25.38"
"10","015","00","050","0011","0161","435","306","129","6","441","1234","0","35.74","24.80"
"10","015","00","050","0012","0000","1473","1032","441","12","1485","4138","0","35.89","24.94"
"10","015","00","050","0012","0162","381","280","101","2","383","1120","0","34.20","25.00"
"10","015","00","050","0012","0163","451","336","115","4","455","1149","0","39.60","29.24"
"10","015","00","050","0012","0164","317","208","109","1","318","967","0","32.89","21.51"
"10","015","00","050","0012","0165","324","208","116","5","329","902","0","36.47","23.06"
"10","015","00","050","0013","0000","1515","1014","501","11","1526","3933","0","38.80","25.78"
"10","015","00","050","0013","0166","398","279","119","2","400","1017","0","39.33","27.43"
"10","015","00","050","0013","0167","357","230","127","3","360","1014","0","35.50","22.68"
"10","015","00","050","0013","0168","374","255","119","4","378","949","0","39.83","26.87"
"10","015","00","050","0013","0169","386","250","136","2","388","953","0","40.71","26.23"
"10","015","00","050","0014","0000","2292","1563","729","20","2312","5995","0","38.57","26.07"
"10","015","00","050","0014","0181","399","280","119","2","401","999","0","40.14","28.03"
"10","015","00","050","0014","0182","424","289","135","2","426","991","0","42.99","29.16"
"10","015","00","050","0014","0183","300","229","71","0","300","772","0","38.86","29.66"
"10","015","00","050","0014","0184","392","251","141","1","393","1130","0","34.78","22.21"
"10","015","00","050","0014","0185","424","291","133","7","431","1111","0","38.79","26.19"
"10","015","00","050","0014","0186","353","223","130","8","361","992","0","36.39","22.48"
"10","015","00","050","0015","0000","2007","1458","549","32","2039","5503","0","37.05","26.49"
"10","015","00","050","0015","0187","450","318","132","9","459","1128","0","40.69","28.19"
"10","015","00","050","0015","0188","323","244","79","3","326","978","0","33.33","24.95"
"10","015","00","050","0015","0189","397","302","95","10","407","1019","0","39.94","29.64"
"10","015","00","050","0015","0190","399","290","109","3","402","1135","0","35.42","25.55"
"10","015","00","050","0015","0191","438","304","134","7","445","1243","0","35.80","24.46"
"10","015","00","050","0016","0000","731","482","249","12","743","2360","0","31.48","20.42"
"10","015","00","050","0016","0192","342","211","131","8","350","1134","0","30.86","18.61"
"10","015","00","050","0016","0193","389","271","118","4","393","1226","0","32.06","22.10"
"10","015","00","050","0017","0000","1512","1020","492","10","1522","4520","0","33.67","22.57"
"10","015","00","050","0017","0194","428","284","144","3","431","1178","0","36.59","24.11"
"10","015","00","050","0017","0195","366","248","118","3","369","1059","0","34.84","23.42"
"10","015","00","050","0017","0196","414","279","135","3","417","1271","0","32.81","21.95"
"10","015","00","050","0017","0197","304","209","95","1","305","1012","0","30.14","20.65"
"10","015","00","050","0018","0000","750","575","175","17","767","1987","0","38.60","28.94"
"10","015","00","050","0018","0198","357","274","83","10","367","965","0","38.03","28.39"
"10","015","00","050","0018","0199","393","301","92","7","400","1022","0","39.14","29.45"
"10","015","00","060","0000","0000","5657","3748","1909","77","5734","15544","17427","36.89","24.11"
"10","015","00","060","0001","0000","138","84","54","1","139","352","0","39.49","23.86"
"10","015","00","060","0001","0201","138","84","54","1","139","352","0","39.49","23.86"
"10","015","00","060","0002","0000","385","258","127","6","391","1019","0","38.37","25.32"
"10","015","00","060","0002","0200","385","258","127","6","391","1019","0","38.37","25.32"
"10","015","00","060","0003","0000","652","441","211","12","664","1879","0","35.34","23.47"
"10","015","00","060","0003","0202","322","210","112","2","324","997","0","32.50","21.06"
"10","015","00","060","0003","0203","330","231","99","10","340","882","0","38.55","26.19"
"10","015","00","060","0004","0000","472","300","172","5","477","1317","0","36.22","22.78"
"10","015","00","060","0004","0204","238","145","93","2","240","640","0","37.50","22.66"
"10","015","00","060","0004","0205","234","155","79","3","237","677","0","35.01","22.90"
"10","015","00","060","0005","0000","296","207","89","3","299","900","0","33.22","23.00"
"10","015","00","060","0005","0206","296","207","89","3","299","900","0","33.22","23.00"
"10","015","00","060","0006","0000","318","219","99","1","319","729","0","43.76","30.04"
"10","015","00","060","0006","0209","318","219","99","1","319","729","0","43.76","30.04"
"10","015","00","060","0007","0000","575","374","201","10","585","1627","0","35.96","22.99"
"10","015","00","060","0007","0207","276","167","109","5","281","734","0","38.28","22.75"
"10","015","00","060","0007","0208","299","207","92","5","304","893","0","34.04","23.18"
"10","015","00","060","0008","0000","284","231","53","4","288","772","0","37.31","29.92"
"10","015","00","060","0008","0210","284","231","53","4","288","772","0","37.31","29.92"
"10","015","00","060","0009","0000","294","198","96","8","302","747","0","40.43","26.51"
"10","015","00","060","0009","0211","294","198","96","8","302","747","0","40.43","26.51"
"10","015","00","060","0010","0000","534","312","222","6","540","1402","0","38.52","22.25"
"10","015","00","060","0010","0212","369","210","159","5","374","981","0","38.12","21.41"
"10","015","00","060","0010","0213","165","102","63","1","166","421","0","39.43","24.23"
"10","015","00","060","0011","0000","935","540","395","6","941","2522","0","37.31","21.41"
"10","015","00","060","0011","0214","379","238","141","5","384","1115","0","34.44","21.35"
"10","015","00","060","0011","0215","389","184","205","0","389","981","0","39.65","18.76"
"10","015","00","060","0011","0216","167","118","49","1","168","426","0","39.44","27.70"
"10","015","00","060","0012","0000","110","80","30","4","114","259","0","44.02","30.89"
"10","015","00","060","0012","0217","110","80","30","4","114","259","0","44.02","30.89"
"10","015","00","060","0013","0000","267","213","54","3","270","816","0","33.09","26.10"
"10","015","00","060","0013","0218","267","213","54","3","270","816","0","33.09","26.10"
"10","015","00","060","0014","0000","230","176","54","7","237","700","0","33.86","25.14"
"10","015","00","060","0014","0220","230","176","54","7","237","700","0","33.86","25.14"
"10","015","00","060","0015","0000","167","115","52","1","168","503","0","33.40","22.86"
"10","015","00","060","0015","0219","167","115","52","1","168","503","0","33.40","22.86"
"10","015","00","070","0000","0000","3531","2547","984","80","3611","10956","12280","32.96","23.25"
"10","015","00","070","0001","0000","320","204","116","1","321","809","0","39.68","25.22"
"10","015","00","070","0001","0237","320","204","116","1","321","809","0","39.68","25.22"
"10","015","00","070","0002","0000","414","257","157","12","426","1258","0","33.86","20.43"
"10","015","00","070","0002","0236","414","257","157","12","426","1258","0","33.86","20.43"
"10","015","00","070","0003","0000","270","210","60","13","283","918","0","30.83","22.88"
"10","015","00","070","0003","0238","270","210","60","13","283","918","0","30.83","22.88"
"10","015","00","070","0004","0000","254","211","43","4","258","970","0","26.60","21.75"
"10","015","00","070","0004","0239","254","211","43","4","258","970","0","26.60","21.75"
"10","015","00","070","0005","0000","353","246","107","4","357","1018","0","35.07","24.17"
"10","015","00","070","0005","0240","353","246","107","4","357","1018","0","35.07","24.17"
"10","015","00","070","0006","0000","178","127","51","2","180","435","0","41.38","29.20"
"10","015","00","070","0006","0247","178","127","51","2","180","435","0","41.38","29.20"
"10","015","00","070","0007","0000","226","142","84","5","231","765","0","30.20","18.56"
"10","015","00","070","0007","0248","192","116","76","5","197","630","0","31.27","18.41"
"10","015","00","070","0007","0249","34","26","8","0","34","135","0","25.19","19.26"
"10","015","00","070","0008","0000","160","128","32","0","160","454","0","35.24","28.19"
"10","015","00","070","0008","0250","160","128","32","0","160","454","0","35.24","28.19"
"10","015","00","070","0009","0000","105","64","41","2","107","302","0","35.43","21.19"
"10","015","00","070","0009","0251","105","64","41","2","107","302","0","35.43","21.19"
"10","015","00","070","0010","0000","143","92","51","4","147","409","0","35.94","22.49"
"10","015","00","070","0010","0252","143","92","51","4","147","409","0","35.94","22.49"
"10","015","00","070","0011","0000","293","248","45","7","300","990","0","30.30","25.05"
"10","015","00","070","0011","0241","225","191","34","4","229","799","0","28.66","23.90"
"10","015","00","070","0011","0242","68","57","11","3","71","191","0","37.17","29.84"
"10","015","00","070","0012","0000","308","233","75","10","318","928","0","34.27","25.11"
"10","015","00","070","0012","0243","159","132","27","5","164","479","0","34.24","27.56"
"10","015","00","070","0012","0244","149","101","48","5","154","449","0","34.30","22.49"
"10","015","00","070","0013","0000","252","174","78","11","263","820","0","32.07","21.22"
"10","015","00","070","0013","0245","252","174","78","11","263","820","0","32.07","21.22"
"10","015","00","070","0014","0000","255","211","44","5","260","880","0","29.55","23.98"
"10","015","00","070","0014","0246","255","211","44","5","260","880","0","29.55","23.98"
"10","015","00","080","0000","0000","1091","841","250","40","1131","3966","4341","28.52","21.21"
"10","015","00","080","0001","0000","404","301","103","16","420","1596","0","26.32","18.86"
"10","015","00","080","0001","0255","181","129","52","6","187","652","0","28.68","19.79"
"10","015","00","080","0001","0256","155","114","41","5","160","608","0","26.32","18.75"
"10","015","00","080","0001","0257","68","58","10","5","73","336","0","21.73","17.26"
"10","015","00","080","0002","0000","160","121","39","8","168","614","0","27.36","19.71"
"10","015","00","080","0002","0258","160","121","39","8","168","614","0","27.36","19.71"
"10","015","00","080","0003","0000","118","99","19","2","120","390","0","30.77","25.38"
"10","015","00","080","0003","0259","118","99","19","2","120","390","0","30.77","25.38"
"10","015","00","080","0004","0000","226","163","63","9","235","721","0","32.59","22.61"
"10","015","00","080","0004","0254","226","163","63","9","235","721","0","32.59","22.61"
"10","015","00","080","0005","0000","183","157","26","5","188","645","0","29.15","24.34"
"10","015","00","080","0005","0253","183","157","26","5","188","645","0","29.15","24.34"
"10","015","00","090","0000","0000","3159","2215","944","59","3218","9935","11248","32.39","22.29"
"10","015","00","090","0001","0000","630","436","194","5","635","1828","0","34.74","23.85"
"10","015","00","090","0001","0267","272","196","76","2","274","778","0","35.22","25.19"
"10","015","00","090","0001","0268","358","240","118","3","361","1050","0","34.38","22.86"
"10","015","00","090","0002","0000","635","436","199","10","645","1800","0","35.83","24.22"
"10","015","00","090","0002","0269","308","226","82","6","314","829","0","37.88","27.26"
"10","015","00","090","0002","0270","327","210","117","4","331","971","0","34.09","21.63"
"10","015","00","090","0003","0000","194","126","68","2","196","520","0","37.69","24.23"
"10","015","00","090","0003","0271","194","126","68","2","196","520","0","37.69","24.23"
"10","015","00","090","0004","0000","295","191","104","2","297","923","0","32.18","20.69"
"10","015","00","090","0004","0272","295","191","104","2","297","923","0","32.18","20.69"
"10","015","00","090","0005","0000","160","120","40","7","167","580","0","28.79","20.69"
"10","015","00","090","0005","0273","160","120","40","7","167","580","0","28.79","20.69"
"10","015","00","090","0006","0000","301","209","92","5","306","941","0","32.52","22.21"
"10","015","00","090","0006","0274","301","209","92","5","306","941","0","32.52","22.21"
"10","015","00","090","0007","0000","250","200","50","3","253","867","0","29.18","23.07"
"10","015","00","090","0007","0275","250","200","50","3","253","867","0","29.18","23.07"
"10","015","00","090","0008","0000","73","62","11","3","76","332","0","22.89","18.67"
"10","015","00","090","0008","0276","73","62","11","3","76","332","0","22.89","18.67"
"10","015","00","090","0009","0000","203","135","68","5","208","740","0","28.11","18.24"
"10","015","00","090","0009","0277","203","135","68","5","208","740","0","28.11","18.24"
"10","015","00","090","0010","0000","220","183","37","9","229","825","0","27.76","22.18"
"10","015","00","090","0010","0278","220","183","37","9","229","825","0","27.76","22.18"
"10","015","00","090","0011","0000","198","117","81","8","206","579","0","35.58","20.21"
"10","015","00","090","0011","0279","198","117","81","8","206","579","0","35.58","20.21"
"10","015","00","100","0000","0000","2514","1731","783","71","2585","8785","9897","29.43","19.70"
"10","015","00","100","0001","0000","125","94","31","4","129","471","0","27.39","19.96"
"10","015","00","100","0001","0305","125","94","31","4","129","471","0","27.39","19.96"
"10","015","00","100","0002","0000","232","148","84","5","237","970","0","24.43","15.26"
"10","015","00","100","0002","0306","232","148","84","5","237","970","0","24.43","15.26"
"10","015","00","100","0003","0000","174","142","32","5","179","613","0","29.20","23.16"
"10","015","00","100","0003","0307","174","142","32","5","179","613","0","29.20","23.16"
"10","015","00","100","0004","0000","144","104","40","5","149","573","0","26.00","18.15"
"10","015","00","100","0004","0308","144","104","40","5","149","573","0","26.00","18.15"
"10","015","00","100","0005","0000","317","234","83","3","320","1040","0","30.77","22.50"
"10","015","00","100","0005","0309","317","234","83","3","320","1040","0","30.77","22.50"
"10","015","00","100","0006","0000","126","90","36","5","131","428","0","30.61","21.03"
"10","015","00","100","0006","0310","126","90","36","5","131","428","0","30.61","21.03"
"10","015","00","100","0007","0000","231","167","64","8","239","864","0","27.66","19.33"
"10","015","00","100","0007","0311","231","167","64","8","239","864","0","27.66","19.33"
"10","015","00","100","0008","0000","132","92","40","2","134","368","0","36.41","25.00"
"10","015","00","100","0008","0312","132","92","40","2","134","368","0","36.41","25.00"
"10","015","00","100","0009","0000","399","243","156","7","406","1306","0","31.09","18.61"
"10","015","00","100","0009","0313","399","243","156","7","406","1306","0","31.09","18.61"
"10","015","00","100","0010","0000","148","100","48","3","151","442","0","34.16","22.62"
"10","015","00","100","0010","0314","148","100","48","3","151","442","0","34.16","22.62"
"10","015","00","100","0011","0000","158","129","29","11","169","597","0","28.31","21.61"
"10","015","00","100","0011","0315","158","129","29","11","169","597","0","28.31","21.61"
"10","015","00","100","0012","0000","135","80","55","3","138","491","0","28.11","16.29"
"10","015","00","100","0012","0316","135","80","55","3","138","491","0","28.11","16.29"
"10","015","00","100","0013","0000","193","108","85","10","203","622","0","32.64","17.36"
"10","015","00","100","0013","0317","193","108","85","10","203","622","0","32.64","17.36"
"10","015","00","110","0000","0000","3929","3066","863","43","3972","12966","16204","30.63","23.65"
"10","015","00","110","0001","0000","381","318","63","3","384","1423","0","26.99","22.35"
"10","015","00","110","0001","0116","190","155","35","1","191","726","0","26.31","21.35"
"10","015","00","110","0001","0117","191","163","28","2","193","697","0","27.69","23.39"
"10","015","00","110","0002","0000","580","407","173","6","586","1842","0","31.81","22.10"
"10","015","00","110","0002","0118","256","218","38","2","258","842","0","30.64","25.89"
"10","015","00","110","0002","0119","266","149","117","3","269","841","0","31.99","17.72"
"10","015","00","110","0002","0120","58","40","18","1","59","159","0","37.11","25.16"
"10","015","00","110","0003","0000","524","386","138","6","530","1790","0","29.61","21.56"
"10","015","00","110","0003","0121","130","101","29","3","133","398","0","33.42","25.38"
"10","015","00","110","0003","0122","247","177","70","1","248","881","0","28.15","20.09"
"10","015","00","110","0003","0123","147","108","39","2","149","511","0","29.16","21.14"
"10","015","00","110","0004","0000","387","328","59","4","391","1188","0","32.91","27.61"
"10","015","00","110","0004","0127","387","328","59","4","391","1188","0","32.91","27.61"
"10","015","00","110","0005","0000","397","331","66","9","406","1217","0","33.36","27.20"
"10","015","00","110","0005","0128","214","168","46","8","222","720","0","30.83","23.33"
"10","015","00","110","0005","0129","183","163","20","1","184","497","0","37.02","32.80"
"10","015","00","110","0006","0000","347","297","50","0","347","1126","0","30.82","26.38"
"10","015","00","110","0006","0130","259","225","34","0","259","802","0","32.29","28.05"
"10","015","00","110","0006","0131","88","72","16","0","88","324","0","27.16","22.22"
"10","015","00","110","0007","0000","500","363","137","9","509","1791","0","28.42","20.27"
"10","015","00","110","0007","0124","326","234","92","4","330","1144","0","28.85","20.45"
"10","015","00","110","0007","0125","174","129","45","5","179","647","0","27.67","19.94"
"10","015","00","110","0008","0000","357","304","53","2","359","1048","0","34.26","29.01"
"10","015","00","110","0008","0126","357","304","53","2","359","1048","0","34.26","29.01"
"10","015","00","110","0009","0000","456","332","124","4","460","1541","0","29.85","21.54"
"10","015","00","110","0009","0114","274","193","81","2","276","914","0","30.20","21.12"
"10","015","00","110","0009","0115","182","139","43","2","184","627","0","29.35","22.17"
"10","015","00","120","0000","0000","1316","1090","226","21","1337","5080","6174","26.32","21.46"
"10","015","00","120","0001","0000","297","251","46","6","303","1044","0","29.02","24.04"
"10","015","00","120","0001","0260","297","251","46","6","303","1044","0","29.02","24.04"
"10","015","00","120","0002","0000","121","103","18","0","121","515","0","23.50","20.00"
"10","015","00","120","0002","0261","121","103","18","0","121","515","0","23.50","20.00"
"10","015","00","120","0003","0000","196","160","36","3","199","757","0","26.29","21.14"
"10","015","00","120","0003","0262","196","160","36","3","199","757","0","26.29","21.14"
"10","015","00","120","0004","0000","181","152","29","3","184","639","0","28.79","23.79"
"10","015","00","120","0004","0263","181","152","29","3","184","639","0","28.79","23.79"
"10","015","00","120","0005","0000","261","206","55","7","268","1075","0","24.93","19.16"
"10","015","00","120","0005","0264","126","101","25","5","131","432","0","30.32","23.38"
"10","015","00","120","0005","0265","135","105","30","2","137","643","0","21.31","16.33"
"10","015","00","120","0006","0000","260","218","42","2","262","1050","0","24.95","20.76"
"10","015","00","120","0006","0266","260","218","42","2","262","1050","0","24.95","20.76"
"10","015","00","130","0000","0000","1320","1172","148","30","1350","4818","5997","28.02","24.33"
"10","015","00","130","0001","0000","139","124","15","3","142","523","0","27.15","23.71"
"10","015","00","130","0001","0318","139","124","15","3","142","523","0","27.15","23.71"
"10","015","00","130","0002","0000","235","207","28","7","242","969","0","24.97","21.36"
"10","015","00","130","0002","0319","123","107","16","3","126","511","0","24.66","20.94"
"10","015","00","130","0002","0320","112","100","12","4","116","458","0","25.33","21.83"
"10","015","00","130","0003","0000","238","212","26","5","243","691","0","35.17","30.68"
"10","015","00","130","0003","0321","238","212","26","5","243","691","0","35.17","30.68"
"10","015","00","130","0004","0000","191","170","21","3","194","721","0","26.91","23.58"
"10","015","00","130","0004","0322","191","170","21","3","194","721","0","26.91","23.58"
"10","015","00","130","0005","0000","230","207","23","6","236","1017","0","23.21","20.35"
"10","015","00","130","0005","0323","144","134","10","6","150","623","0","24.08","21.51"
"10","015","00","130","0005","0324","86","73","13","0","86","394","0","21.83","18.53"
"10","015","00","130","0006","0000","287","252","35","6","293","897","0","32.66","28.09"
"10","015","00","130","0006","0325","106","90","16","2","108","321","0","33.64","28.04"
"10","015","00","130","0006","0326","130","115","15","3","133","393","0","33.84","29.26"
"10","015","00","130","0006","0327","51","47","4","1","52","183","0","28.42","25.68"
"10","014","00","000","0000","0000","58829","38284","20545","857","59686","182958","214132","32.62","20.93"
"10","014","00","010","0000","0000","30752","19115","11637","284","31036","87202","104445","35.59","21.92"
"10","014","00","010","0001","0000","451","315","136","10","461","1446","0","31.88","21.78"
"10","014","00","010","0001","0066","250","161","89","6","256","797","0","32.12","20.20"
"10","014","00","010","0001","0067","201","154","47","4","205","649","0","31.59","23.73"
"10","014","00","010","0002","0000","255","165","90","6","261","865","0","30.17","19.08"
"10","014","00","010","0002","0068","255","165","90","6","261","865","0","30.17","19.08"
"10","014","00","010","0003","0000","761","496","265","6","767","2210","0","34.71","22.44"
"10","014","00","010","0003","0072","539","349","190","2","541","1445","0","37.44","24.15"
"10","014","00","010","0003","0073","222","147","75","4","226","765","0","29.54","19.22"
"10","014","00","010","0004","0000","891","598","293","7","898","2796","0","32.12","21.39"
"10","014","00","010","0004","0077","320","210","110","1","321","943","0","34.04","22.27"
"10","014","00","010","0004","0078","294","218","76","3","297","968","0","30.68","22.52"
"10","014","00","010","0004","0079","277","170","107","3","280","885","0","31.64","19.21"
"10","014","00","010","0005","0000","1237","692","545","8","1245","2822","0","44.12","24.52"
"10","014","00","010","0005","0074","410","249","161","2","412","957","0","43.05","26.02"
"10","014","00","010","0005","0075","405","234","171","2","407","926","0","43.95","25.27"
"10","014","00","010","0005","0076","422","209","213","4","426","939","0","45.37","22.26"
"10","014","00","010","0006","0000","898","604","294","7","905","2707","0","33.43","22.31"
"10","014","00","010","0006","0069","352","229","123","1","353","869","0","40.62","26.35"
"10","014","00","010","0006","0070","248","170","78","2","250","865","0","28.90","19.65"
"10","014","00","010","0006","0071","298","205","93","4","302","973","0","31.04","21.07"
"10","014","00","010","0007","0000","2326","1511","815","14","2340","6528","0","35.85","23.15"
"10","014","00","010","0007","0031","400","268","132","1","401","1125","0","35.64","23.82"
"10","014","00","010","0007","0032","327","195","132","1","328","945","0","34.71","20.63"
"10","014","00","010","0007","0033","375","239","136","2","377","1082","0","34.84","22.09"
"10","014","00","010","0007","0034","375","249","126","5","380","1085","0","35.02","22.95"
"10","014","00","010","0007","0035","386","258","128","3","389","1119","0","34.76","23.06"
"10","014","00","010","0007","0036","463","302","161","2","465","1172","0","39.68","25.77"
"10","014","00","010","0008","0000","1275","723","552","18","1293","3035","0","42.60","23.82"
"10","014","00","010","0008","0008","410","230","180","8","418","984","0","42.48","23.37"
"10","014","00","010","0008","0009","472","266","206","5","477","1028","0","46.40","25.88"
"10","014","00","010","0008","0010","393","227","166","5","398","1023","0","38.91","22.19"
"10","014","00","010","0009","0000","301","164","137","2","303","826","0","36.68","19.85"
"10","014","00","010","0009","0011","301","164","137","2","303","826","0","36.68","19.85"
"10","014","00","010","0010","0000","942","650","292","6","948","2489","0","38.09","26.11"
"10","014","00","010","0010","0040","468","324","144","3","471","1223","0","38.51","26.49"
"10","014","00","010","0010","0041","474","326","148","3","477","1266","0","37.68","25.75"
"10","014","00","010","0011","0000","1199","772","427","10","1209","3004","0","40.25","25.70"
"10","014","00","010","0011","0037","393","255","138","2","395","1055","0","37.44","24.17"
"10","014","00","010","0011","0038","362","233","129","1","363","921","0","39.41","25.30"
"10","014","00","010","0011","0039","444","284","160","7","451","1028","0","43.87","27.63"
"10","014","00","010","0012","0000","1590","982","608","9","1599","3981","0","40.17","24.67"
"10","014","00","010","0012","0004","378","236","142","0","378","953","0","39.66","24.76"
"10","014","00","010","0012","0005","398","248","150","2","400","945","0","42.33","26.24"
"10","014","00","010","0012","0006","365","201","164","4","369","972","0","37.96","20.68"
"10","014","00","010","0012","0007","449","297","152","3","452","1111","0","40.68","26.73"
"10","014","00","010","0013","0000","480","263","217","2","482","1313","0","36.71","20.03"
"10","014","00","010","0013","0002","192","102","90","1","193","526","0","36.69","19.39"
"10","014","00","010","0013","0003","288","161","127","1","289","787","0","36.72","20.46"
"10","014","00","010","0014","0000","220","155","65","2","222","638","0","34.80","24.29"
"10","014","00","010","0014","0013","220","155","65","2","222","638","0","34.80","24.29"
"10","014","00","010","0015","0000","563","311","252","5","568","1628","0","34.89","19.10"
"10","014","00","010","0015","0014","341","179","162","1","342","855","0","40.00","20.94"
"10","014","00","010","0015","0015","222","132","90","4","226","773","0","29.24","17.08"
"10","014","00","010","0016","0000","215","128","87","4","219","620","0","35.32","20.65"
"10","014","00","010","0016","0017","215","128","87","4","219","620","0","35.32","20.65"
"10","014","00","010","0017","0000","398","226","172","3","401","1215","0","33.00","18.60"
"10","014","00","010","0017","0020","398","226","172","3","401","1215","0","33.00","18.60"
"10","014","00","010","0018","0000","326","183","143","2","328","813","0","40.34","22.51"
"10","014","00","010","0018","0012","326","183","143","2","328","813","0","40.34","22.51"
"10","014","00","010","0019","0000","269","145","124","0","269","683","0","39.39","21.23"
"10","014","00","010","0019","0016","269","145","124","0","269","683","0","39.39","21.23"
"10","014","00","010","0020","0000","346","184","162","2","348","768","0","45.31","23.96"
"10","014","00","010","0020","0021","346","184","162","2","348","768","0","45.31","23.96"
"10","014","00","010","0021","0000","274","163","111","1","275","727","0","37.83","22.42"
"10","014","00","010","0021","0018","274","163","111","1","275","727","0","37.83","22.42"
"10","014","00","010","0022","0000","290","146","144","0","290","762","0","38.06","19.16"
"10","014","00","010","0022","0019","290","146","144","0","290","762","0","38.06","19.16"
"10","014","00","010","0023","0000","242","138","104","4","246","941","0","26.14","14.67"
"10","014","00","010","0023","0001","242","138","104","4","246","941","0","26.14","14.67"
"10","014","00","010","0024","0000","316","179","137","3","319","736","0","43.34","24.32"
"10","014","00","010","0024","0022","316","179","137","3","319","736","0","43.34","24.32"
"10","014","00","010","0025","0000","177","110","67","1","178","575","0","30.96","19.13"
"10","014","00","010","0025","0028","177","110","67","1","178","575","0","30.96","19.13"
"10","014","00","010","0026","0000","268","124","144","3","271","711","0","38.12","17.44"
"10","014","00","010","0026","0023","268","124","144","3","271","711","0","38.12","17.44"
"10","014","00","010","0027","0000","136","81","55","0","136","400","0","34.00","20.25"
"10","014","00","010","0027","0029","136","81","55","0","136","400","0","34.00","20.25"
"10","014","00","010","0028","0000","154","86","68","1","155","389","0","39.85","22.11"
"10","014","00","010","0028","0024","154","86","68","1","155","389","0","39.85","22.11"
"10","014","00","010","0029","0000","543","351","192","10","553","1604","0","34.48","21.88"
"10","014","00","010","0029","0082","306","191","115","5","311","799","0","38.92","23.90"
"10","014","00","010","0029","0083","237","160","77","5","242","805","0","30.06","19.88"
"10","014","00","010","0030","0000","728","397","331","10","738","2224","0","33.18","17.85"
"10","014","00","010","0030","0080","308","166","142","6","314","995","0","31.56","16.68"
"10","014","00","010","0030","0081","420","231","189","4","424","1229","0","34.50","18.80"
"10","014","00","010","0031","0000","962","614","348","13","975","3044","0","32.03","20.17"
"10","014","00","010","0031","0044","251","159","92","6","257","961","0","26.74","16.55"
"10","014","00","010","0031","0045","377","231","146","5","382","1126","0","33.93","20.52"
"10","014","00","010","0031","0046","334","224","110","2","336","957","0","35.11","23.41"
"10","014","00","010","0032","0000","975","638","337","5","980","2559","0","38.30","24.93"
"10","014","00","010","0032","0042","536","361","175","3","539","1289","0","41.82","28.01"
"10","014","00","010","0032","0043","439","277","162","2","441","1270","0","34.72","21.81"
"10","014","00","010","0033","0000","490","307","183","2","492","1481","0","33.22","20.73"
"10","014","00","010","0033","0047","289","175","114","0","289","733","0","39.43","23.87"
"10","014","00","010","0033","0048","201","132","69","2","203","748","0","27.14","17.65"
"10","014","00","010","0034","0000","724","448","276","5","729","2117","0","34.44","21.16"
"10","014","00","010","0034","0049","311","188","123","2","313","947","0","33.05","19.85"
"10","014","00","010","0034","0050","413","260","153","3","416","1170","0","35.56","22.22"
"10","014","00","010","0035","0000","392","234","158","8","400","1309","0","30.56","17.88"
"10","014","00","010","0035","0051","392","234","158","8","400","1309","0","30.56","17.88"
"10","014","00","010","0036","0000","1028","660","368","12","1040","2638","0","39.42","25.02"
"10","014","00","010","0036","0025","244","147","97","3","247","718","0","34.40","20.47"
"10","014","00","010","0036","0026","410","252","158","5","415","919","0","45.16","27.42"
"10","014","00","010","0036","0027","374","261","113","4","378","1001","0","37.76","26.07"
"10","014","00","010","0037","0000","327","192","135","3","330","940","0","35.11","20.43"
"10","014","00","010","0037","0030","327","192","135","3","330","940","0","35.11","20.43"
"10","014","00","010","0038","0000","2899","1891","1008","23","2922","8103","0","36.06","23.34"
"10","014","00","010","0038","0052","439","280","159","5","444","1195","0","37.15","23.43"
"10","014","00","010","0038","0053","379","262","117","4","383","1176","0","32.57","22.28"
"10","014","00","010","0038","0054","420","280","140","2","422","1217","0","34.68","23.01"
"10","014","00","010","0038","0055","446","272","174","5","451","1259","0","35.82","21.60"
"10","014","00","010","0038","0056","324","192","132","2","326","1035","0","31.50","18.55"
"10","014","00","010","0038","0057","402","271","131","3","405","1084","0","37.36","25.00"
"10","014","00","010","0038","0058","489","334","155","2","491","1137","0","43.18","29.38"
"10","014","00","010","0039","0000","1496","1020","476","13","1509","5024","0","30.04","20.30"
"10","014","00","010","0039","0059","415","282","133","3","418","1349","0","30.99","20.90"
"10","014","00","010","0039","0060","331","217","114","6","337","1284","0","26.25","16.90"
"10","014","00","010","0039","0061","403","276","127","1","404","1270","0","31.81","21.73"
"10","014","00","010","0039","0062","347","245","102","3","350","1121","0","31.22","21.86"
"10","014","00","010","0040","0000","750","414","336","4","754","2362","0","31.92","17.53"
"10","014","00","010","0040","0063","372","218","154","1","373","1127","0","33.10","19.34"
"10","014","00","010","0040","0064","378","196","182","3","381","1235","0","30.85","15.87"
"10","014","00","010","0041","0000","414","209","205","9","423","1214","0","34.84","17.22"
"10","014","00","010","0041","0065","414","209","205","9","423","1214","0","34.84","17.22"
"10","014","00","010","0042","0000","467","316","151","2","469","1392","0","33.69","22.70"
"10","014","00","010","0042","0084","212","129","83","1","213","723","0","29.46","17.84"
"10","014","00","010","0042","0085","255","187","68","1","256","669","0","38.27","27.95"
"10","014","00","010","0043","0000","344","190","154","4","348","952","0","36.55","19.96"
"10","014","00","010","0043","0086","344","190","154","4","348","952","0","36.55","19.96"
"10","014","00","010","0044","0000","385","227","158","3","388","1256","0","30.89","18.07"
"10","014","00","010","0044","0087","385","227","158","3","388","1256","0","30.89","18.07"
"10","014","00","010","0045","0000","458","284","174","7","465","1365","0","34.07","20.81"
"10","014","00","010","0045","0088","250","155","95","3","253","717","0","35.29","21.62"
"10","014","00","010","0045","0089","208","129","79","4","212","648","0","32.72","19.91"
"10","014","00","010","0046","0000","570","429","141","15","585","1990","0","29.40","21.56"
"10","014","00","010","0046","0090","339","258","81","9","348","1087","0","32.01","23.74"
"10","014","00","010","0046","0091","231","171","60","6","237","903","0","26.25","18.94"
"10","014","00","020","0000","0000","3290","2392","898","68","3358","11887","13396","28.25","20.12"
"10","014","00","020","0001","0000","202","166","36","10","212","596","0","35.57","27.85"
"10","014","00","020","0001","0107","112","90","22","7","119","347","0","34.29","25.94"
"10","014","00","020","0001","0108","90","76","14","3","93","249","0","37.35","30.52"
"10","014","00","020","0002","0000","228","156","72","8","236","935","0","25.24","16.68"
"10","014","00","020","0002","0105","120","79","41","5","125","469","0","26.65","16.84"
"10","014","00","020","0002","0106","108","77","31","3","111","466","0","23.82","16.52"
"10","014","00","020","0003","0000","303","220","83","7","310","1337","0","23.19","16.45"
"10","014","00","020","0003","0103","126","86","40","1","127","508","0","25.00","16.93"
"10","014","00","020","0003","0104","177","134","43","6","183","829","0","22.07","16.16"
"10","014","00","020","0004","0000","655","505","150","19","674","2619","0","25.74","19.28"
"10","014","00","020","0004","0101","313","240","73","9","322","1309","0","24.60","18.33"
"10","014","00","020","0004","0102","342","265","77","10","352","1310","0","26.87","20.23"
"10","014","00","020","0005","0000","578","398","180","6","584","1823","0","32.04","21.83"
"10","014","00","020","0005","0099","276","177","99","2","278","882","0","31.52","20.07"
"10","014","00","020","0005","0100","302","221","81","4","306","941","0","32.52","23.49"
"10","014","00","020","0006","0000","635","410","225","4","639","2079","0","30.74","19.72"
"10","014","00","020","0006","0096","92","62","30","1","93","333","0","27.93","18.62"
"10","014","00","020","0006","0097","299","187","112","1","300","938","0","31.98","19.94"
"10","014","00","020","0006","0098","244","161","83","2","246","808","0","30.45","19.93"
"10","014","00","020","0007","0000","188","139","49","5","193","725","0","26.62","19.17"
"10","014","00","020","0007","0095","188","139","49","5","193","725","0","26.62","19.17"
"10","014","00","020","0008","0000","501","398","103","9","510","1773","0","28.76","22.45"
"10","014","00","020","0008","0092","144","109","35","6","150","501","0","29.94","21.76"
"10","014","00","020","0008","0093","256","202","54","2","258","911","0","28.32","22.17"
"10","014","00","020","0008","0094","101","87","14","1","102","361","0","28.25","24.10"
"10","014","00","030","0000","0000","2302","1535","767","44","2346","7211","8330","32.53","21.29"
"10","014","00","030","0001","0000","452","300","152","16","468","1682","0","27.82","17.84"
"10","014","00","030","0001","0115","227","176","51","8","235","915","0","25.68","19.23"
"10","014","00","030","0001","0116","225","124","101","8","233","767","0","30.38","16.17"
"10","014","00","030","0002","0000","378","263","115","4","382","1084","0","35.24","24.26"
"10","014","00","030","0002","0113","378","263","115","4","382","1084","0","35.24","24.26"
"10","014","00","030","0003","0000","282","175","107","7","289","865","0","33.41","20.23"
"10","014","00","030","0003","0112","282","175","107","7","289","865","0","33.41","20.23"
"10","014","00","030","0004","0000","312","189","123","4","316","752","0","42.02","25.13"
"10","014","00","030","0004","0111","312","189","123","4","316","752","0","42.02","25.13"
"10","014","00","030","0005","0000","527","387","140","4","531","1611","0","32.96","24.02"
"10","014","00","030","0005","0109","318","231","87","1","319","864","0","36.92","26.74"
"10","014","00","030","0005","0110","209","156","53","3","212","747","0","28.38","20.88"
"10","014","00","030","0006","0000","164","114","50","2","166","528","0","31.44","21.59"
"10","014","00","030","0006","0117","164","114","50","2","166","528","0","31.44","21.59"
"10","014","00","030","0007","0000","187","107","80","7","194","689","0","28.16","15.53"
"10","014","00","030","0007","0114","187","107","80","7","194","689","0","28.16","15.53"
"10","014","00","040","0000","0000","4807","2996","1811","74","4881","14938","16897","32.68","20.06"
"10","014","00","040","0001","0000","135","83","52","5","140","486","0","28.81","17.08"
"10","014","00","040","0001","0127","60","36","24","3","63","271","0","23.25","13.28"
"10","014","00","040","0001","0128","75","47","28","2","77","215","0","35.81","21.86"
"10","014","00","040","0002","0000","154","115","39","1","155","449","0","34.52","25.61"
"10","014","00","040","0002","0139","154","115","39","1","155","449","0","34.52","25.61"
"10","014","00","040","0003","0000","152","115","37","2","154","467","0","32.98","24.63"
"10","014","00","040","0003","0137","152","115","37","2","154","467","0","32.98","24.63"
"10","014","00","040","0004","0000","118","58","60","2","120","333","0","36.04","17.42"
"10","014","00","040","0004","0138","118","58","60","2","120","333","0","36.04","17.42"
"10","014","00","040","0005","0000","341","187","154","5","346","1149","0","30.11","16.28"
"10","014","00","040","0005","0125","207","104","103","0","207","715","0","28.95","14.55"
"10","014","00","040","0005","0126","134","83","51","5","139","434","0","32.03","19.12"
"10","014","00","040","0006","0000","365","224","141","5","370","1236","0","29.94","18.12"
"10","014","00","040","0006","0123","192","122","70","3","195","741","0","26.32","16.46"
"10","014","00","040","0006","0124","173","102","71","2","175","495","0","35.35","20.61"
"10","014","00","040","0007","0000","358","171","187","7","365","1068","0","34.18","16.01"
"10","014","00","040","0007","0120","62","26","36","2","64","211","0","30.33","12.32"
"10","014","00","040","0007","0121","159","67","92","3","162","466","0","34.76","14.38"
"10","014","00","040","0007","0122","137","78","59","2","139","391","0","35.55","19.95"
"10","014","00","040","0008","0000","727","408","319","9","736","2211","0","33.29","18.45"
"10","014","00","040","0008","0118","339","155","184","6","345","1032","0","33.43","15.02"
"10","014","00","040","0008","0119","388","253","135","3","391","1179","0","33.16","21.46"
"10","014","00","040","0009","0000","324","211","113","5","329","1122","0","29.32","18.81"
"10","014","00","040","0009","0132","324","211","113","5","329","1122","0","29.32","18.81"
"10","014","00","040","0010","0000","995","669","326","13","1008","3124","0","32.27","21.41"
"10","014","00","040","0010","0129","494","314","180","5","499","1334","0","37.41","23.54"
"10","014","00","040","0010","0130","227","162","65","3","230","712","0","32.30","22.75"
"10","014","00","040","0010","0131","274","193","81","5","279","1078","0","25.88","17.90"
"10","014","00","040","0011","0000","403","302","101","5","408","1094","0","37.29","27.61"
"10","014","00","040","0011","0133","403","302","101","5","408","1094","0","37.29","27.61"
"10","014","00","040","0012","0000","390","327","63","10","400","1133","0","35.30","28.86"
"10","014","00","040","0012","0134","390","327","63","10","400","1133","0","35.30","28.86"
"10","014","00","040","0013","0000","345","126","219","5","350","1066","0","32.83","11.82"
"10","014","00","040","0013","0135","293","110","183","4","297","914","0","32.49","12.04"
"10","014","00","040","0013","0136","52","16","36","1","53","152","0","34.87","10.53"
"10","014","00","050","0000","0000","2018","1172","846","31","2049","6713","7514","30.52","17.46"
"10","014","00","050","0001","0000","149","92","57","2","151","650","0","23.23","14.15"
"10","014","00","050","0001","0147","149","92","57","2","151","650","0","23.23","14.15"
"10","014","00","050","0002","0000","318","134","184","5","323","871","0","37.08","15.38"
"10","014","00","050","0002","0148","134","77","57","1","135","413","0","32.69","18.64"
"10","014","00","050","0002","0149","184","57","127","4","188","458","0","41.05","12.45"
"10","014","00","050","0003","0000","220","131","89","7","227","835","0","27.19","15.69"
"10","014","00","050","0003","0146","220","131","89","7","227","835","0","27.19","15.69"
"10","014","00","050","0004","0000","427","269","158","0","427","1440","0","29.65","18.68"
"10","014","00","050","0004","0143","339","201","138","0","339","1099","0","30.85","18.29"
"10","014","00","050","0004","0144","88","68","20","0","88","341","0","25.81","19.94"
"10","014","00","050","0005","0000","216","144","72","5","221","858","0","25.76","16.78"
"10","014","00","050","0005","0145","216","144","72","5","221","858","0","25.76","16.78"
"10","014","00","050","0006","0000","321","234","87","6","327","1026","0","31.87","22.81"
"10","014","00","050","0006","0140","149","124","25","4","153","493","0","31.03","25.15"
"10","014","00","050","0006","0141","172","110","62","2","174","533","0","32.65","20.64"
"10","014","00","050","0007","0000","367","168","199","6","373","1033","0","36.11","16.26"
"10","014","00","050","0007","0142","367","168","199","6","373","1033","0","36.11","16.26"
"10","014","00","060","0000","0000","2157","1268","889","49","2206","7030","8018","31.38","18.04"
"10","014","00","060","0001","0000","299","166","133","5","304","1091","0","27.86","15.22"
"10","014","00","060","0001","0152","136","66","70","3","139","430","0","32.33","15.35"
"10","014","00","060","0001","0153","163","100","63","2","165","661","0","24.96","15.13"
"10","014","00","060","0002","0000","214","133","81","6","220","660","0","33.33","20.15"
"10","014","00","060","0002","0154","214","133","81","6","220","660","0","33.33","20.15"
"10","014","00","060","0003","0000","73","53","20","2","75","322","0","23.29","16.46"
"10","014","00","060","0003","0155","73","53","20","2","75","322","0","23.29","16.46"
"10","014","00","060","0004","0000","250","163","87","8","258","773","0","33.38","21.09"
"10","014","00","060","0004","0156","250","163","87","8","258","773","0","33.38","21.09"
"10","014","00","060","0005","0000","660","386","274","10","670","1890","0","35.45","20.42"
"10","014","00","060","0005","0150","326","206","120","6","332","983","0","33.77","20.96"
"10","014","00","060","0005","0151","334","180","154","4","338","907","0","37.27","19.85"
"10","014","00","060","0006","0000","93","40","53","5","98","337","0","29.08","11.87"
"10","014","00","060","0006","0158","93","40","53","5","98","337","0","29.08","11.87"
"10","014","00","060","0007","0000","254","141","113","4","258","832","0","31.01","16.95"
"10","014","00","060","0007","0157","254","141","113","4","258","832","0","31.01","16.95"
"10","014","00","060","0008","0000","109","53","56","5","114","304","0","37.50","17.43"
"10","014","00","060","0008","0159","109","53","56","5","114","304","0","37.50","17.43"
"10","014","00","060","0009","0000","127","86","41","1","128","393","0","32.57","21.88"
"10","014","00","060","0009","0160","127","86","41","1","128","393","0","32.57","21.88"
"10","014","00","060","0010","0000","78","47","31","3","81","428","0","18.93","10.98"
"10","014","00","060","0010","0161","78","47","31","3","81","428","0","18.93","10.98"
"10","014","00","070","0000","0000","2055","1402","653","45","2100","7358","8123","28.54","19.05"
"10","014","00","070","0001","0000","340","259","81","8","348","1544","0","22.54","16.77"
"10","014","00","070","0001","0169","132","101","31","5","137","813","0","16.85","12.42"
"10","014","00","070","0001","0170","89","77","12","2","91","332","0","27.41","23.19"
"10","014","00","070","0001","0171","119","81","38","1","120","399","0","30.08","20.30"
"10","014","00","070","0002","0000","244","179","65","12","256","1127","0","22.72","15.88"
"10","014","00","070","0002","0168","244","179","65","12","256","1127","0","22.72","15.88"
"10","014","00","070","0003","0000","263","191","72","5","268","951","0","28.18","20.08"
"10","014","00","070","0003","0167","263","191","72","5","268","951","0","28.18","20.08"
"10","014","00","070","0004","0000","82","55","27","0","82","252","0","32.54","21.83"
"10","014","00","070","0004","0172","82","55","27","0","82","252","0","32.54","21.83"
"10","014","00","070","0005","0000","163","114","49","1","164","511","0","32.09","22.31"
"10","014","00","070","0005","0166","163","114","49","1","164","511","0","32.09","22.31"
"10","014","00","070","0006","0000","293","177","116","3","296","886","0","33.41","19.98"
"10","014","00","070","0006","0165","293","177","116","3","296","886","0","33.41","19.98"
"10","014","00","070","0007","0000","670","427","243","16","686","2087","0","32.87","20.46"
"10","014","00","070","0007","0162","198","119","79","5","203","681","0","29.81","17.47"
"10","014","00","070","0007","0163","216","141","75","3","219","618","0","35.44","22.82"
"10","014","00","070","0007","0164","256","167","89","8","264","788","0","33.50","21.19"
"10","014","00","080","0000","0000","1837","1328","509","43","1880","6168","6828","30.48","21.53"
"10","014","00","080","0001","0000","190","143","47","1","191","599","0","31.89","23.87"
"10","014","00","080","0001","0182","16","10","6","0","16","31","0","51.61","32.26"
"10","014","00","080","0001","0183","174","133","41","1","175","568","0","30.81","23.42"
"10","014","00","080","0002","0000","332","267","65","12","344","1145","0","30.04","23.32"
"10","014","00","080","0002","0179","182","148","34","1","183","642","0","28.50","23.05"
"10","014","00","080","0002","0180","107","88","19","6","113","321","0","35.20","27.41"
"10","014","00","080","0002","0181","43","31","12","5","48","182","0","26.37","17.03"
"10","014","00","080","0003","0000","124","81","43","5","129","519","0","24.86","15.61"
"10","014","00","080","0003","0178","124","81","43","5","129","519","0","24.86","15.61"
"10","014","00","080","0004","0000","587","402","185","7","594","1898","0","31.30","21.18"
"10","014","00","080","0004","0176","345","226","119","2","347","1203","0","28.84","18.79"
"10","014","00","080","0004","0177","242","176","66","5","247","695","0","35.54","25.32"
"10","014","00","080","0005","0000","258","164","94","6","264","853","0","30.95","19.23"
"10","014","00","080","0005","0175","258","164","94","6","264","853","0","30.95","19.23"
"10","014","00","080","0006","0000","346","271","75","12","358","1154","0","31.02","23.48"
"10","014","00","080","0006","0173","138","111","27","6","144","495","0","29.09","22.42"
"10","014","00","080","0006","0174","208","160","48","6","214","659","0","32.47","24.28"
"10","014","00","090","0000","0000","2920","1869","1051","68","2988","9526","10806","31.37","19.62"
"10","014","00","090","0001","0000","377","163","214","7","384","1297","0","29.61","12.57"
"10","014","00","090","0001","0184","204","95","109","4","208","641","0","32.45","14.82"
"10","014","00","090","0001","0185","173","68","105","3","176","656","0","26.83","10.37"
"10","014","00","090","0002","0000","193","103","90","4","197","589","0","33.45","17.49"
"10","014","00","090","0002","0186","193","103","90","4","197","589","0","33.45","17.49"
"10","014","00","090","0003","0000","187","84","103","5","192","588","0","32.65","14.29"
"10","014","00","090","0003","0187","187","84","103","5","192","588","0","32.65","14.29"
"10","014","00","090","0004","0000","187","96","91","3","190","564","0","33.69","17.02"
"10","014","00","090","0004","0188","187","96","91","3","190","564","0","33.69","17.02"
"10","014","00","090","0005","0000","447","281","166","6","453","1352","0","33.51","20.78"
"10","014","00","090","0005","0191","221","133","88","2","223","645","0","34.57","20.62"
"10","014","00","090","0005","0192","226","148","78","4","230","707","0","32.53","20.93"
"10","014","00","090","0006","0000","575","382","193","12","587","1720","0","34.13","22.21"
"10","014","00","090","0006","0189","336","256","80","6","342","916","0","37.34","27.95"
"10","014","00","090","0006","0190","239","126","113","6","245","804","0","30.47","15.67"
"10","014","00","090","0007","0000","260","169","91","12","272","811","0","33.54","20.84"
"10","014","00","090","0007","0193","134","98","36","3","137","420","0","32.62","23.33"
"10","014","00","090","0007","0194","126","71","55","9","135","391","0","34.53","18.16"
"10","014","00","090","0008","0000","423","360","63","11","434","1705","0","25.45","21.11"
"10","014","00","090","0008","0195","204","176","28","7","211","832","0","25.36","21.15"
"10","014","00","090","0008","0196","219","184","35","4","223","873","0","25.54","21.08"
"10","014","00","090","0009","0000","271","231","40","8","279","900","0","31.00","25.67"
"10","014","00","090","0009","0197","88","80","8","2","90","228","0","39.47","35.09"
"10","014","00","090","0009","0198","183","151","32","6","189","672","0","28.13","22.47"
"10","014","00","100","0000","0000","1341","992","349","38","1379","4892","5663","28.19","20.28"
"10","014","00","100","0001","0000","207","174","33","9","216","733","0","29.47","23.74"
"10","014","00","100","0001","0203","109","92","17","6","115","365","0","31.51","25.21"
"10","014","00","100","0001","0204","98","82","16","3","101","368","0","27.45","22.28"
"10","014","00","100","0002","0000","288","268","20","7","295","1061","0","27.80","25.26"
"10","014","00","100","0002","0202","288","268","20","7","295","1061","0","27.80","25.26"
"10","014","00","100","0003","0000","344","247","97","7","351","1229","0","28.56","20.10"
"10","014","00","100","0003","0201","344","247","97","7","351","1229","0","28.56","20.10"
"10","014","00","100","0004","0000","332","172","160","11","343","1341","0","25.58","12.83"
"10","014","00","100","0004","0200","332","172","160","11","343","1341","0","25.58","12.83"
"10","014","00","100","0005","0000","170","131","39","4","174","528","0","32.95","24.81"
"10","014","00","100","0005","0199","170","131","39","4","174","528","0","32.95","24.81"
"10","014","00","110","0000","0000","624","477","147","10","634","3562","4083","17.80","13.39"
"10","014","00","110","0001","0000","198","155","43","4","202","986","0","20.49","15.72"
"10","014","00","110","0001","0207","140","105","35","2","142","782","0","18.16","13.43"
"10","014","00","110","0001","0208","58","50","8","2","60","204","0","29.41","24.51"
"10","014","00","110","0002","0000","169","128","41","3","172","1038","0","16.57","12.33"
"10","014","00","110","0002","0206","169","128","41","3","172","1038","0","16.57","12.33"
"10","014","00","110","0003","0000","257","194","63","3","260","1538","0","16.91","12.61"
"10","014","00","110","0003","0205","257","194","63","3","260","1538","0","16.91","12.61"
"10","014","00","120","0000","0000","893","732","161","15","908","3275","4132","27.73","22.35"
"10","014","00","120","0001","0000","194","169","25","3","197","730","0","26.99","23.15"
"10","014","00","120","0001","0212","194","169","25","3","197","730","0","26.99","23.15"
"10","014","00","120","0002","0000","103","83","20","2","105","251","0","41.83","33.07"
"10","014","00","120","0002","0213","103","83","20","2","105","251","0","41.83","33.07"
"10","014","00","120","0003","0000","67","38","29","1","68","261","0","26.05","14.56"
"10","014","00","120","0003","0214","67","38","29","1","68","261","0","26.05","14.56"
"10","014","00","120","0004","0000","223","187","36","5","228","957","0","23.82","19.54"
"10","014","00","120","0004","0211","223","187","36","5","228","957","0","23.82","19.54"
"10","014","00","120","0005","0000","163","133","30","2","165","575","0","28.70","23.13"
"10","014","00","120","0005","0210","163","133","30","2","165","575","0","28.70","23.13"
"10","014","00","120","0006","0000","143","122","21","2","145","501","0","28.94","24.35"
"10","014","00","120","0006","0209","143","122","21","2","145","501","0","28.94","24.35"
"10","014","00","130","0000","0000","866","702","164","20","886","2912","3575","30.43","24.11"
"10","014","00","130","0001","0000","181","159","22","7","188","593","0","31.70","26.81"
"10","014","00","130","0001","0218","181","159","22","7","188","593","0","31.70","26.81"
"10","014","00","130","0002","0000","112","102","10","1","113","318","0","35.53","32.08"
"10","014","00","130","0002","0217","112","102","10","1","113","318","0","35.53","32.08"
"10","014","00","130","0003","0000","135","114","21","3","138","421","0","32.78","27.08"
"10","014","00","130","0003","0216","135","114","21","3","138","421","0","32.78","27.08"
"10","014","00","130","0004","0000","145","128","17","3","148","577","0","25.65","22.18"
"10","014","00","130","0004","0219","145","128","17","3","148","577","0","25.65","22.18"
"10","014","00","130","0005","0000","293","199","94","6","299","1003","0","29.81","19.84"
"10","014","00","130","0005","0215","293","199","94","6","299","1003","0","29.81","19.84"
"10","014","00","140","0000","0000","1117","978","139","29","1146","3004","3673","38.15","32.56"
"10","014","00","140","0001","0000","244","211","33","5","249","512","0","48.63","41.21"
"10","014","00","140","0001","0223","244","211","33","5","249","512","0","48.63","41.21"
"10","014","00","140","0002","0000","253","225","28","6","259","603","0","42.95","37.31"
"10","014","00","140","0002","0222","253","225","28","6","259","603","0","42.95","37.31"
"10","014","00","140","0003","0000","377","322","55","10","387","1235","0","31.34","26.07"
"10","014","00","140","0003","0220","200","180","20","6","206","650","0","31.69","27.69"
"10","014","00","140","0003","0221","177","142","35","4","181","585","0","30.94","24.27"
"10","014","00","140","0004","0000","122","112","10","2","124","325","0","38.15","34.46"
"10","014","00","140","0004","0224","122","112","10","2","124","325","0","38.15","34.46"
"10","014","00","140","0005","0000","121","108","13","6","127","329","0","38.60","32.83"
"10","014","00","140","0005","0225","121","108","13","6","127","329","0","38.60","32.83"
"10","014","00","150","0000","0000","1061","882","179","14","1075","2990","3450","35.95","29.50"
"10","014","00","150","0001","0000","231","196","35","5","236","589","0","40.07","33.28"
"10","014","00","150","0001","0231","231","196","35","5","236","589","0","40.07","33.28"
"10","014","00","150","0002","0000","275","234","41","3","278","851","0","32.67","27.50"
"10","014","00","150","0002","0232","275","234","41","3","278","851","0","32.67","27.50"
"10","014","00","150","0003","0000","98","83","15","2","100","334","0","29.94","24.85"
"10","014","00","150","0003","0230","98","83","15","2","100","334","0","29.94","24.85"
"10","014","00","150","0004","0000","207","163","44","2","209","548","0","38.14","29.74"
"10","014","00","150","0004","0226","84","64","20","2","86","232","0","37.07","27.59"
"10","014","00","150","0004","0227","123","99","24","0","123","316","0","38.92","31.33"
"10","014","00","150","0005","0000","143","115","28","0","143","359","0","39.83","32.03"
"10","014","00","150","0005","0229","143","115","28","0","143","359","0","39.83","32.03"
"10","014","00","150","0006","0000","107","91","16","2","109","309","0","35.28","29.45"
"10","014","00","150","0006","0228","107","91","16","2","109","309","0","35.28","29.45"
"10","014","00","160","0000","0000","789","444","345","25","814","4290","5199","18.97","10.35"
"10","014","00","160","0001","0000","208","116","92","2","210","1293","0","16.24","8.97"
"10","014","00","160","0001","0235","208","116","92","2","210","1293","0","16.24","8.97"
"10","014","00","160","0002","0000","128","38","90","10","138","773","0","17.85","4.92"
"10","014","00","160","0002","0236","128","38","90","10","138","773","0","17.85","4.92"
"10","014","00","160","0003","0000","267","157","110","10","277","1256","0","22.05","12.50"
"10","014","00","160","0003","0234","267","157","110","10","277","1256","0","22.05","12.50"
"10","014","00","160","0004","0000","186","133","53","3","189","968","0","19.52","13.74"
"10","014","00","160","0004","0233","186","133","53","3","189","968","0","19.52","13.74"
"10","016","00","000","0000","0000","26221","13112","13109","298","26519","92051","105634","28.81","14.24"
"10","016","00","010","0000","0000","17054","8925","8129","159","17213","54139","62912","31.79","16.49"
"10","016","00","010","0002","0000","137","81","56","0","137","496","0","27.62","16.33"
"10","016","00","010","0002","0001","137","81","56","0","137","496","0","27.62","16.33"
"10","016","00","010","0003","0000","217","121","96","3","220","534","0","41.20","22.66"
"10","016","00","010","0003","0002","217","121","96","3","220","534","0","41.20","22.66"
"10","016","00","010","0004","0000","198","94","104","3","201","520","0","38.65","18.08"
"10","016","00","010","0004","0003","198","94","104","3","201","520","0","38.65","18.08"
"10","016","00","010","0005","0000","334","145","189","2","336","872","0","38.53","16.63"
"10","016","00","010","0005","0004","334","145","189","2","336","872","0","38.53","16.63"
"10","016","00","010","0006","0000","375","162","213","6","381","932","0","40.88","17.38"
"10","016","00","010","0006","0005","375","162","213","6","381","932","0","40.88","17.38"
"10","016","00","010","0007","0000","270","156","114","1","271","785","0","34.52","19.87"
"10","016","00","010","0007","0006","270","156","114","1","271","785","0","34.52","19.87"
"10","016","00","010","0008","0000","647","321","326","3","650","1903","0","34.16","16.87"
"10","016","00","010","0008","0007","324","153","171","2","326","935","0","34.87","16.36"
"10","016","00","010","0008","0008","323","168","155","1","324","968","0","33.47","17.36"
"10","016","00","010","0009","0000","1480","960","520","17","1497","4135","0","36.20","23.22"
"10","016","00","010","0009","0010","503","360","143","8","511","1381","0","37.00","26.07"
"10","016","00","010","0009","0011","505","302","203","4","509","1416","0","35.95","21.33"
"10","016","00","010","0009","0012","472","298","174","5","477","1338","0","35.65","22.27"
"10","016","00","010","0010","0000","411","245","166","5","416","1175","0","35.40","20.85"
"10","016","00","010","0010","0009","411","245","166","5","416","1175","0","35.40","20.85"
"10","016","00","010","0011","0000","1666","911","755","4","1670","5179","0","32.25","17.59"
"10","016","00","010","0011","0013","398","216","182","1","399","1242","0","32.13","17.39"
"10","016","00","010","0011","0014","333","173","160","2","335","1168","0","28.68","14.81"
"10","016","00","010","0011","0015","456","229","227","0","456","1397","0","32.64","16.39"
"10","016","00","010","0011","0016","479","293","186","1","480","1372","0","34.99","21.36"
"10","016","00","010","0012","0000","765","389","376","6","771","2417","0","31.90","16.09"
"10","016","00","010","0012","0017","341","172","169","1","342","1163","0","29.41","14.79"
"10","016","00","010","0012","0018","424","217","207","5","429","1254","0","34.21","17.30"
"10","016","00","010","0013","0000","509","252","257","7","516","1483","0","34.79","16.99"
"10","016","00","010","0013","0019","509","252","257","7","516","1483","0","34.79","16.99"
"10","016","00","010","0014","0000","1777","1019","758","17","1794","5825","0","30.80","17.49"
"10","016","00","010","0014","0020","369","206","163","6","375","1141","0","32.87","18.05"
"10","016","00","010","0014","0021","482","277","205","5","487","1376","0","35.39","20.13"
"10","016","00","010","0014","0022","521","317","204","4","525","1551","0","33.85","20.44"
"10","016","00","010","0014","0023","405","219","186","2","407","1757","0","23.16","12.46"
"10","016","00","010","0015","0000","997","544","453","5","1002","3202","0","31.29","16.99"
"10","016","00","010","0015","0024","310","169","141","3","313","1006","0","31.11","16.80"
"10","016","00","010","0015","0025","358","196","162","2","360","1066","0","33.77","18.39"
"10","016","00","010","0015","0026","329","179","150","0","329","1130","0","29.12","15.84"
"10","016","00","010","0016","0000","987","534","453","9","996","3283","0","30.34","16.27"
"10","016","00","010","0016","0027","339","190","149","4","343","1038","0","33.04","18.30"
"10","016","00","010","0016","0028","330","178","152","2","332","1142","0","29.07","15.59"
"10","016","00","010","0016","0029","318","166","152","3","321","1103","0","29.10","15.05"
"10","016","00","010","0017","0000","558","293","265","10","568","1855","0","30.62","15.80"
"10","016","00","010","0017","0030","264","137","127","4","268","1007","0","26.61","13.60"
"10","016","00","010","0017","0031","294","156","138","6","300","848","0","35.38","18.40"
"10","016","00","010","0018","0000","221","136","85","3","224","979","0","22.88","13.89"
"10","016","00","010","0018","0032","221","136","85","3","224","979","0","22.88","13.89"
"10","016","00","010","0019","0000","289","128","161","2","291","953","0","30.54","13.43"
"10","016","00","010","0019","0033","289","128","161","2","291","953","0","30.54","13.43"
"10","016","00","010","0020","0000","879","508","371","4","883","2661","0","33.18","19.09"
"10","016","00","010","0020","0034","338","198","140","1","339","930","0","36.45","21.29"
"10","016","00","010","0020","0035","295","172","123","2","297","898","0","33.07","19.15"
"10","016","00","010","0020","0036","246","138","108","1","247","833","0","29.65","16.57"
"10","016","00","010","0021","0000","145","71","74","0","145","439","0","33.03","16.17"
"10","016","00","010","0021","0037","145","71","74","0","145","439","0","33.03","16.17"
"10","016","00","010","0022","0000","672","409","263","7","679","2134","0","31.82","19.17"
"10","016","00","010","0022","0038","376","221","155","3","379","1162","0","32.62","19.02"
"10","016","00","010","0022","0039","296","188","108","4","300","972","0","30.86","19.34"
"10","016","00","010","0023","0000","199","107","92","5","204","650","0","31.38","16.46"
"10","016","00","010","0023","0040","199","107","92","5","204","650","0","31.38","16.46"
"10","016","00","010","0024","0000","357","123","234","7","364","1060","0","34.34","11.60"
"10","016","00","010","0024","0042","357","123","234","7","364","1060","0","34.34","11.60"
"10","016","00","010","0025","0000","385","210","175","6","391","1240","0","31.53","16.94"
"10","016","00","010","0025","0041","385","210","175","6","391","1240","0","31.53","16.94"
"10","016","00","010","0026","0000","229","71","158","1","230","677","0","33.97","10.49"
"10","016","00","010","0026","0043","229","71","158","1","230","677","0","33.97","10.49"
"10","016","00","010","0027","0000","513","194","319","8","521","1707","0","30.52","11.36"
"10","016","00","010","0027","0046","230","97","133","2","232","777","0","29.86","12.48"
"10","016","00","010","0027","0047","283","97","186","6","289","930","0","31.08","10.43"
"10","016","00","010","0028","0000","763","242","521","5","768","2539","0","30.25","9.53"
"10","016","00","010","0028","0044","449","152","297","2","451","1454","0","31.02","10.45"
"10","016","00","010","0028","0045","314","90","224","3","317","1085","0","29.22","8.29"
"10","016","00","010","0029","0000","97","54","43","0","97","470","0","20.64","11.49"
"10","016","00","010","0029","0048","97","54","43","0","97","470","0","20.64","11.49"
"10","016","00","010","0030","0000","114","55","59","2","116","378","0","30.69","14.55"
"10","016","00","010","0030","0049","114","55","59","2","116","378","0","30.69","14.55"
"10","016","00","010","0031","0000","303","182","121","6","309","1162","0","26.59","15.66"
"10","016","00","010","0031","0050","303","182","121","6","309","1162","0","26.59","15.66"
"10","016","00","010","0032","0000","385","105","280","2","387","1368","0","28.29","7.68"
"10","016","00","010","0032","0051","385","105","280","2","387","1368","0","28.29","7.68"
"10","016","00","010","0033","0000","132","80","52","2","134","812","0","16.50","9.85"
"10","016","00","010","0033","0052","132","80","52","2","134","812","0","16.50","9.85"
"10","016","00","010","0034","0000","43","23","20","1","44","314","0","14.01","7.32"
"10","016","00","010","0034","0053","43","23","20","1","44","314","0","14.01","7.32"
"10","016","00","020","0000","0000","3975","1691","2284","63","4038","13570","15248","29.76","12.46"
"10","016","00","020","0001","0000","365","197","168","5","370","1199","0","30.86","16.43"
"10","016","00","020","0001","0054","365","197","168","5","370","1199","0","30.86","16.43"
"10","016","00","020","0002","0000","98","45","53","1","99","358","0","27.65","12.57"
"10","016","00","020","0002","0055","98","45","53","1","99","358","0","27.65","12.57"
"10","016","00","020","0003","0000","66","36","30","2","68","243","0","27.98","14.81"
"10","016","00","020","0003","0056","66","36","30","2","68","243","0","27.98","14.81"
"10","016","00","020","0004","0000","86","40","46","5","91","297","0","30.64","13.47"
"10","016","00","020","0004","0057","86","40","46","5","91","297","0","30.64","13.47"
"10","016","00","020","0005","0000","181","44","137","3","184","683","0","26.94","6.44"
"10","016","00","020","0005","0058","181","44","137","3","184","683","0","26.94","6.44"
"10","016","00","020","0006","0000","87","45","42","0","87","327","0","26.61","13.76"
"10","016","00","020","0006","0059","87","45","42","0","87","327","0","26.61","13.76"
"10","016","00","020","0007","0000","217","70","147","5","222","748","0","29.68","9.36"
"10","016","00","020","0007","0060","217","70","147","5","222","748","0","29.68","9.36"
"10","016","00","020","0008","0000","167","74","93","4","171","839","0","20.38","8.82"
"10","016","00","020","0008","0061","167","74","93","4","171","839","0","20.38","8.82"
"10","016","00","020","0009","0000","291","125","166","3","294","860","0","34.19","14.53"
"10","016","00","020","0009","0062","291","125","166","3","294","860","0","34.19","14.53"
"10","016","00","020","0010","0000","49","16","33","1","50","123","0","40.65","13.01"
"10","016","00","020","0010","0063","49","16","33","1","50","123","0","40.65","13.01"
"10","016","00","020","0011","0000","73","36","37","2","75","221","0","33.94","16.29"
"10","016","00","020","0011","0065","73","36","37","2","75","221","0","33.94","16.29"
"10","016","00","020","0012","0000","108","55","53","2","110","300","0","36.67","18.33"
"10","016","00","020","0012","0067","108","55","53","2","110","300","0","36.67","18.33"
"10","016","00","020","0013","0000","131","72","59","3","134","641","0","20.90","11.23"
"10","016","00","020","0013","0066","131","72","59","3","134","641","0","20.90","11.23"
"10","016","00","020","0014","0000","102","55","47","0","102","389","0","26.22","14.14"
"10","016","00","020","0014","0068","102","55","47","0","102","389","0","26.22","14.14"
"10","016","00","020","0015","0000","261","61","200","3","264","807","0","32.71","7.56"
"10","016","00","020","0015","0064","261","61","200","3","264","807","0","32.71","7.56"
"10","016","00","020","0016","0000","120","74","46","3","123","334","0","36.83","22.16"
"10","016","00","020","0016","0069","120","74","46","3","123","334","0","36.83","22.16"
"10","016","00","020","0017","0000","31","14","17","1","32","94","0","34.04","14.89"
"10","016","00","020","0017","0070","31","14","17","1","32","94","0","34.04","14.89"
"10","016","00","020","0018","0000","282","141","141","5","287","911","0","31.50","15.48"
"10","016","00","020","0018","0071","282","141","141","5","287","911","0","31.50","15.48"
"10","016","00","020","0019","0000","296","108","188","7","303","1004","0","30.18","10.76"
"10","016","00","020","0019","0072","296","108","188","7","303","1004","0","30.18","10.76"
"10","016","00","020","0020","0000","195","68","127","0","195","670","0","29.10","10.15"
"10","016","00","020","0020","0073","195","68","127","0","195","670","0","29.10","10.15"
"10","016","00","020","0021","0000","541","245","296","3","544","1760","0","30.91","13.92"
"10","016","00","020","0021","0074","277","139","138","2","279","913","0","30.56","15.22"
"10","016","00","020","0021","0075","264","106","158","1","265","847","0","31.29","12.51"
"10","016","00","020","0022","0000","228","70","158","5","233","762","0","30.58","9.19"
"10","016","00","020","0022","0076","228","70","158","5","233","762","0","30.58","9.19"
"10","016","00","030","0000","0000","2239","1139","1100","29","2268","8798","9915","25.78","12.95"
"10","016","00","030","0001","0000","166","88","78","4","170","525","0","32.38","16.76"
"10","016","00","030","0001","0077","166","88","78","4","170","525","0","32.38","16.76"
"10","016","00","030","0002","0000","207","121","86","0","207","671","0","30.85","18.03"
"10","016","00","030","0002","0078","207","121","86","0","207","671","0","30.85","18.03"
"10","016","00","030","0003","0000","51","32","19","1","52","110","0","47.27","29.09"
"10","016","00","030","0003","0079","51","32","19","1","52","110","0","47.27","29.09"
"10","016","00","030","0004","0000","47","39","8","1","48","156","0","30.77","25.00"
"10","016","00","030","0004","0080","47","39","8","1","48","156","0","30.77","25.00"
"10","016","00","030","0005","0000","77","41","36","3","80","297","0","26.94","13.80"
"10","016","00","030","0005","0081","77","41","36","3","80","297","0","26.94","13.80"
"10","016","00","030","0006","0000","48","30","18","0","48","216","0","22.22","13.89"
"10","016","00","030","0006","0082","48","30","18","0","48","216","0","22.22","13.89"
"10","016","00","030","0007","0000","62","32","30","1","63","168","0","37.50","19.05"
"10","016","00","030","0007","0083","62","32","30","1","63","168","0","37.50","19.05"
"10","016","00","030","0008","0000","465","242","223","5","470","1719","0","27.34","14.08"
"10","016","00","030","0008","0084","271","135","136","2","273","986","0","27.69","13.69"
"10","016","00","030","0008","0085","194","107","87","3","197","733","0","26.88","14.60"
"10","016","00","030","0009","0000","89","45","44","1","90","307","0","29.32","14.66"
"10","016","00","030","0009","0086","89","45","44","1","90","307","0","29.32","14.66"
"10","016","00","030","0010","0000","213","81","132","3","216","766","0","28.20","10.57"
"10","016","00","030","0010","0087","213","81","132","3","216","766","0","28.20","10.57"
"10","016","00","030","0011","0000","203","84","119","3","206","798","0","25.81","10.53"
"10","016","00","030","0011","0088","203","84","119","3","206","798","0","25.81","10.53"
"10","016","00","030","0012","0000","263","59","204","2","265","1412","0","18.77","4.18"
"10","016","00","030","0012","0089","263","59","204","2","265","1412","0","18.77","4.18"
"10","016","00","030","0013","0000","235","178","57","2","237","1110","0","21.35","16.04"
"10","016","00","030","0013","0090","235","178","57","2","237","1110","0","21.35","16.04"
"10","016","00","030","0014","0000","64","56","8","1","65","274","0","23.72","20.44"
"10","016","00","030","0014","0091","64","56","8","1","65","274","0","23.72","20.44"
"10","016","00","030","0015","0000","49","11","38","2","51","269","0","18.96","4.09"
"10","016","00","030","0015","0092","49","11","38","2","51","269","0","18.96","4.09"
"10","016","00","040","0000","0000","1897","859","1038","24","1921","7398","8309","25.97","11.61"
"10","016","00","040","0001","0000","56","21","35","1","57","301","0","18.94","6.98"
"10","016","00","040","0001","0093","56","21","35","1","57","301","0","18.94","6.98"
"10","016","00","040","0002","0000","99","36","63","1","100","415","0","24.10","8.67"
"10","016","00","040","0002","0094","99","36","63","1","100","415","0","24.10","8.67"
"10","016","00","040","0003","0000","94","64","30","3","97","285","0","34.04","22.46"
"10","016","00","040","0003","0096","94","64","30","3","97","285","0","34.04","22.46"
"10","016","00","040","0004","0000","218","83","135","4","222","817","0","27.17","10.16"
"10","016","00","040","0004","0095","218","83","135","4","222","817","0","27.17","10.16"
"10","016","00","040","0005","0000","189","72","117","1","190","665","0","28.57","10.83"
"10","016","00","040","0005","0097","189","72","117","1","190","665","0","28.57","10.83"
"10","016","00","040","0006","0000","56","14","42","1","57","145","0","39.31","9.66"
"10","016","00","040","0006","0098","56","14","42","1","57","145","0","39.31","9.66"
"10","016","00","040","0007","0000","179","76","103","5","184","642","0","28.66","11.84"
"10","016","00","040","0007","0099","179","76","103","5","184","642","0","28.66","11.84"
"10","016","00","040","0008","0000","62","15","47","2","64","225","0","28.44","6.67"
"10","016","00","040","0008","0100","62","15","47","2","64","225","0","28.44","6.67"
"10","016","00","040","0009","0000","142","45","97","0","142","580","0","24.48","7.76"
"10","016","00","040","0009","0101","142","45","97","0","142","580","0","24.48","7.76"
"10","016","00","040","0010","0000","323","96","227","4","327","1265","0","25.85","7.59"
"10","016","00","040","0010","0102","323","96","227","4","327","1265","0","25.85","7.59"
"10","016","00","040","0011","0000","479","337","142","2","481","2058","0","23.37","16.38"
"10","016","00","040","0011","0103","230","160","70","1","231","927","0","24.92","17.26"
"10","016","00","040","0011","0104","249","177","72","1","250","1131","0","22.10","15.65"
"10","016","00","050","0000","0000","656","271","385","15","671","4779","5401","14.04","5.67"
"10","016","00","050","0001","0000","131","57","74","2","133","723","0","18.40","7.88"
"10","016","00","050","0001","0105","131","57","74","2","133","723","0","18.40","7.88"
"10","016","00","050","0002","0000","92","52","40","0","92","436","0","21.10","11.93"
"10","016","00","050","0002","0106","92","52","40","0","92","436","0","21.10","11.93"
"10","016","00","050","0003","0000","53","19","34","2","55","342","0","16.08","5.56"
"10","016","00","050","0003","0107","53","19","34","2","55","342","0","16.08","5.56"
"10","016","00","050","0004","0000","94","33","61","2","96","487","0","19.71","6.78"
"10","016","00","050","0004","0108","94","33","61","2","96","487","0","19.71","6.78"
"10","016","00","050","0005","0000","174","44","130","6","180","1425","0","12.63","3.09"
"10","016","00","050","0005","0109","83","24","59","4","87","669","0","13.00","3.59"
"10","016","00","050","0005","0110","91","20","71","2","93","756","0","12.30","2.65"
"10","016","00","050","0006","0000","18","10","8","0","18","527","0","3.42","1.90"
"10","016","00","050","0006","0112","18","10","8","0","18","527","0","3.42","1.90"
"10","016","00","050","0007","0000","8","3","5","0","8","220","0","3.64","1.36"
"10","016","00","050","0007","0113","8","3","5","0","8","220","0","3.64","1.36"
"10","016","00","050","0008","0000","36","17","19","2","38","296","0","12.84","5.74"
"10","016","00","050","0008","0111","36","17","19","2","38","296","0","12.84","5.74"
"10","016","00","050","0009","0000","50","36","14","1","51","323","0","15.79","11.15"
"10","016","00","050","0009","0114","50","36","14","1","51","323","0","15.79","11.15"
"10","016","00","060","0000","0000","400","227","173","8","408","3367","3849","12.12","6.74"
"10","016","00","060","0001","0000","22","10","12","1","23","259","0","8.88","3.86"
"10","016","00","060","0001","0115","22","10","12","1","23","259","0","8.88","3.86"
"10","016","00","060","0002","0000","63","34","29","0","63","573","0","10.99","5.93"
"10","016","00","060","0002","0116","63","34","29","0","63","573","0","10.99","5.93"
"10","016","00","060","0003","0000","69","40","29","3","72","643","0","11.20","6.22"
"10","016","00","060","0003","0117","69","40","29","3","72","643","0","11.20","6.22"
"10","016","00","060","0004","0000","58","27","31","0","58","367","0","15.80","7.36"
"10","016","00","060","0004","0118","58","27","31","0","58","367","0","15.80","7.36"
"10","016","00","060","0005","0000","46","22","24","0","46","377","0","12.20","5.84"
"10","016","00","060","0005","0119","46","22","24","0","46","377","0","12.20","5.84"
"10","016","00","060","0006","0000","142","94","48","4","146","1148","0","12.72","8.19"
"10","016","00","060","0006","0120","142","94","48","4","146","1148","0","12.72","8.19"
"10","017","00","000","0000","0000","128826","69196","59630","1238","130064","318539","365891","40.83","21.72"
"10","017","00","010","0000","0000","17325","9116","8209","169","17494","45298","50967","38.62","20.12"
"10","017","00","010","0001","0000","309","153","156","0","309","649","0","47.61","23.57"
"10","017","00","010","0001","0040","309","153","156","0","309","649","0","47.61","23.57"
"10","017","00","010","0002","0000","543","295","248","5","548","1166","0","47.00","25.30"
"10","017","00","010","0002","0038","543","295","248","5","548","1166","0","47.00","25.30"
"10","017","00","010","0003","0000","371","189","182","3","374","874","0","42.79","21.62"
"10","017","00","010","0003","0039","371","189","182","3","374","874","0","42.79","21.62"
"10","017","00","010","0004","0000","400","214","186","7","407","991","0","41.07","21.59"
"10","017","00","010","0004","0037","400","214","186","7","407","991","0","41.07","21.59"
"10","017","00","010","0005","0000","583","285","298","4","587","1177","0","49.87","24.21"
"10","017","00","010","0005","0036","583","285","298","4","587","1177","0","49.87","24.21"
"10","017","00","010","0006","0000","467","216","251","0","467","1117","0","41.81","19.34"
"10","017","00","010","0006","0035","467","216","251","0","467","1117","0","41.81","19.34"
"10","017","00","010","0007","0000","532","301","231","8","540","1217","0","44.37","24.73"
"10","017","00","010","0007","0034","532","301","231","8","540","1217","0","44.37","24.73"
"10","017","00","010","0008","0000","320","175","145","8","328","752","0","43.62","23.27"
"10","017","00","010","0008","0033","320","175","145","8","328","752","0","43.62","23.27"
"10","017","00","010","0009","0000","545","312","233","8","553","1594","0","34.69","19.57"
"10","017","00","010","0009","0032","545","312","233","8","553","1594","0","34.69","19.57"
"10","017","00","010","0010","0000","993","585","408","11","1004","2260","0","44.42","25.88"
"10","017","00","010","0010","0030","544","286","258","5","549","1181","0","46.49","24.22"
"10","017","00","010","0010","0031","449","299","150","6","455","1079","0","42.17","27.71"
"10","017","00","010","0011","0000","604","330","274","7","611","1294","0","47.22","25.50"
"10","017","00","010","0011","0029","604","330","274","7","611","1294","0","47.22","25.50"
"10","017","00","010","0012","0000","811","485","326","8","819","1981","0","41.34","24.48"
"10","017","00","010","0012","0027","505","299","206","4","509","1129","0","45.08","26.48"
"10","017","00","010","0012","0028","306","186","120","4","310","852","0","36.38","21.83"
"10","017","00","010","0013","0000","779","492","287","16","795","1945","0","40.87","25.30"
"10","017","00","010","0013","0025","472","293","179","9","481","1103","0","43.61","26.56"
"10","017","00","010","0013","0026","307","199","108","7","314","842","0","37.29","23.63"
"10","017","00","010","0014","0000","510","280","230","4","514","1245","0","41.29","22.49"
"10","017","00","010","0014","0024","510","280","230","4","514","1245","0","41.29","22.49"
"10","017","00","010","0015","0000","391","236","155","5","396","1125","0","35.20","20.98"
"10","017","00","010","0015","0021","391","236","155","5","396","1125","0","35.20","20.98"
"10","017","00","010","0016","0000","677","297","380","6","683","1688","0","40.46","17.59"
"10","017","00","010","0016","0018","381","180","201","3","384","990","0","38.79","18.18"
"10","017","00","010","0016","0019","296","117","179","3","299","698","0","42.84","16.76"
"10","017","00","010","0017","0000","298","178","120","5","303","920","0","32.93","19.35"
"10","017","00","010","0017","0020","298","178","120","5","303","920","0","32.93","19.35"
"10","017","00","010","0018","0000","458","191","267","2","460","1211","0","37.99","15.77"
"10","017","00","010","0018","0017","458","191","267","2","460","1211","0","37.99","15.77"
"10","017","00","010","0019","0000","601","167","434","4","605","1442","0","41.96","11.58"
"10","017","00","010","0019","0006","601","167","434","4","605","1442","0","41.96","11.58"
"10","017","00","010","0020","0000","401","155","246","4","405","1212","0","33.42","12.79"
"10","017","00","010","0020","0007","401","155","246","4","405","1212","0","33.42","12.79"
"10","017","00","010","0021","0000","202","61","141","4","206","439","0","46.92","13.90"
"10","017","00","010","0021","0001","202","61","141","4","206","439","0","46.92","13.90"
"10","017","00","010","0022","0000","1832","873","959","14","1846","5622","0","32.84","15.53"
"10","017","00","010","0022","0002","429","161","268","1","430","1226","0","35.07","13.13"
"10","017","00","010","0022","0003","418","223","195","6","424","1343","0","31.57","16.60"
"10","017","00","010","0022","0004","529","291","238","3","532","1557","0","34.17","18.69"
"10","017","00","010","0022","0005","456","198","258","4","460","1496","0","30.75","13.24"
"10","017","00","010","0023","0000","574","285","289","4","578","1615","0","35.79","17.65"
"10","017","00","010","0023","0023","574","285","289","4","578","1615","0","35.79","17.65"
"10","017","00","010","0024","0000","356","195","161","5","361","907","0","39.80","21.50"
"10","017","00","010","0024","0022","356","195","161","5","361","907","0","39.80","21.50"
"10","017","00","010","0025","0000","2152","1277","875","12","2164","5731","0","37.76","22.28"
"10","017","00","010","0025","0012","561","302","259","4","565","1473","0","38.36","20.50"
"10","017","00","010","0025","0013","516","313","203","5","521","1463","0","35.61","21.39"
"10","017","00","010","0025","0014","419","251","168","2","421","1100","0","38.27","22.82"
"10","017","00","010","0025","0015","388","246","142","0","388","915","0","42.40","26.89"
"10","017","00","010","0025","0016","268","165","103","1","269","780","0","34.49","21.15"
"10","017","00","010","0026","0000","1616","889","727","15","1631","5124","0","31.83","17.35"
"10","017","00","010","0026","0008","497","266","231","6","503","1435","0","35.05","18.54"
"10","017","00","010","0026","0009","589","338","251","5","594","1580","0","37.59","21.39"
"10","017","00","010","0026","0010","205","123","82","3","208","777","0","26.77","15.83"
"10","017","00","010","0026","0011","325","162","163","1","326","1332","0","24.47","12.16"
"10","017","00","020","0000","0000","18002","9187","8815","198","18200","46431","53534","39.20","19.79"
"10","017","00","020","0001","0000","1397","743","654","17","1414","3732","0","37.89","19.91"
"10","017","00","020","0001","0235","454","236","218","12","466","1219","0","38.23","19.36"
"10","017","00","020","0001","0236","455","246","209","3","458","1182","0","38.75","20.81"
"10","017","00","020","0001","0237","488","261","227","2","490","1331","0","36.81","19.61"
"10","017","00","020","0002","0000","1022","499","523","6","1028","2522","0","40.76","19.79"
"10","017","00","020","0002","0238","477","205","272","4","481","1075","0","44.74","19.07"
"10","017","00","020","0002","0239","545","294","251","2","547","1447","0","37.80","20.32"
"10","017","00","020","0003","0000","1458","801","657","17","1475","3476","0","42.43","23.04"
"10","017","00","020","0003","0242","456","220","236","9","465","1094","0","42.50","20.11"
"10","017","00","020","0003","0243","511","270","241","4","515","1215","0","42.39","22.22"
"10","017","00","020","0003","0244","491","311","180","4","495","1167","0","42.42","26.65"
"10","017","00","020","0004","0000","835","448","387","3","838","1877","0","44.65","23.87"
"10","017","00","020","0004","0245","422","206","216","3","425","934","0","45.50","22.06"
"10","017","00","020","0004","0246","413","242","171","0","413","943","0","43.80","25.66"
"10","017","00","020","0005","0000","936","514","422","11","947","2193","0","43.18","23.44"
"10","017","00","020","0005","0247","514","284","230","8","522","1211","0","43.10","23.45"
"10","017","00","020","0005","0248","422","230","192","3","425","982","0","43.28","23.42"
"10","017","00","020","0006","0000","590","300","290","8","598","1482","0","40.35","20.24"
"10","017","00","020","0006","0249","118","55","63","0","118","284","0","41.55","19.37"
"10","017","00","020","0006","0250","472","245","227","8","480","1198","0","40.07","20.45"
"10","017","00","020","0007","0000","471","256","215","8","479","1165","0","41.12","21.97"
"10","017","00","020","0007","0251","471","256","215","8","479","1165","0","41.12","21.97"
"10","017","00","020","0008","0000","833","405","428","7","840","2268","0","37.04","17.86"
"10","017","00","020","0008","0255","346","167","179","2","348","982","0","35.44","17.01"
"10","017","00","020","0008","0256","487","238","249","5","492","1286","0","38.26","18.51"
"10","017","00","020","0009","0000","1643","857","786","23","1666","4366","0","38.16","19.63"
"10","017","00","020","0009","0252","502","246","256","7","509","1311","0","38.83","18.76"
"10","017","00","020","0009","0253","683","370","313","10","693","1723","0","40.22","21.47"
"10","017","00","020","0009","0254","458","241","217","6","464","1332","0","34.83","18.09"
"10","017","00","020","0010","0000","1382","636","746","14","1396","3616","0","38.61","17.59"
"10","017","00","020","0010","0261","690","323","367","6","696","1791","0","38.86","18.03"
"10","017","00","020","0010","0262","692","313","379","8","700","1825","0","38.36","17.15"
"10","017","00","020","0011","0000","730","346","384","10","740","2070","0","35.75","16.71"
"10","017","00","020","0011","0257","425","186","239","4","429","1076","0","39.87","17.29"
"10","017","00","020","0011","0258","305","160","145","6","311","994","0","31.29","16.10"
"10","017","00","020","0012","0000","165","70","95","1","166","402","0","41.29","17.41"
"10","017","00","020","0012","0270","165","70","95","1","166","402","0","41.29","17.41"
"10","017","00","020","0013","0000","104","55","49","1","105","317","0","33.12","17.35"
"10","017","00","020","0013","0271","104","55","49","1","105","317","0","33.12","17.35"
"10","017","00","020","0014","0000","132","56","76","1","133","325","0","40.92","17.23"
"10","017","00","020","0014","0272","132","56","76","1","133","325","0","40.92","17.23"
"10","017","00","020","0015","0000","913","522","391","8","921","1965","0","46.87","26.56"
"10","017","00","020","0015","0273","402","219","183","3","405","975","0","41.54","22.46"
"10","017","00","020","0015","0274","511","303","208","5","516","990","0","52.12","30.61"
"10","017","00","020","0016","0000","227","87","140","7","234","448","0","52.23","19.42"
"10","017","00","020","0016","0275","227","87","140","7","234","448","0","52.23","19.42"
"10","017","00","020","0017","0000","793","429","364","28","821","1879","0","43.69","22.83"
"10","017","00","020","0017","0240","413","222","191","7","420","968","0","43.39","22.93"
"10","017","00","020","0017","0241","380","207","173","21","401","911","0","44.02","22.72"
"10","017","00","020","0018","0000","2139","1053","1086","10","2149","6051","0","35.51","17.40"
"10","017","00","020","0018","0263","523","255","268","2","525","1502","0","34.95","16.98"
"10","017","00","020","0018","0264","505","244","261","1","506","1474","0","34.33","16.55"
"10","017","00","020","0018","0265","468","215","253","1","469","1450","0","32.34","14.83"
"10","017","00","020","0018","0266","643","339","304","6","649","1625","0","39.94","20.86"
"10","017","00","020","0019","0000","1392","678","714","10","1402","3772","0","37.17","17.97"
"10","017","00","020","0019","0267","490","237","253","4","494","1375","0","35.93","17.24"
"10","017","00","020","0019","0268","381","179","202","3","384","1049","0","36.61","17.06"
"10","017","00","020","0019","0269","521","262","259","3","524","1348","0","38.87","19.44"
"10","017","00","020","0020","0000","840","432","408","8","848","2505","0","33.85","17.25"
"10","017","00","020","0020","0259","410","193","217","4","414","1230","0","33.66","15.69"
"10","017","00","020","0020","0260","430","239","191","4","434","1275","0","34.04","18.75"
"10","017","00","030","0000","0000","13452","7430","6022","133","13585","33447","38494","40.62","22.21"
"10","017","00","030","0001","0000","556","292","264","7","563","1390","0","40.50","21.01"
"10","017","00","030","0001","0205","556","292","264","7","563","1390","0","40.50","21.01"
"10","017","00","030","0002","0000","277","130","147","3","280","641","0","43.68","20.28"
"10","017","00","030","0002","0207","277","130","147","3","280","641","0","43.68","20.28"
"10","017","00","030","0003","0000","268","123","145","0","268","754","0","35.54","16.31"
"10","017","00","030","0003","0208","268","123","145","0","268","754","0","35.54","16.31"
"10","017","00","030","0004","0000","1495","846","649","11","1506","3626","0","41.53","23.33"
"10","017","00","030","0004","0209","426","274","152","2","428","1038","0","41.23","26.40"
"10","017","00","030","0004","0210","515","292","223","4","519","1229","0","42.23","23.76"
"10","017","00","030","0004","0211","554","280","274","5","559","1359","0","41.13","20.60"
"10","017","00","030","0005","0000","1050","581","469","6","1056","2636","0","40.06","22.04"
"10","017","00","030","0005","0221","550","284","266","5","555","1262","0","43.98","22.50"
"10","017","00","030","0005","0222","500","297","203","1","501","1374","0","36.46","21.62"
"10","017","00","030","0006","0000","1273","824","449","7","1280","2957","0","43.29","27.87"
"10","017","00","030","0006","0223","465","374","91","4","469","989","0","47.42","37.82"
"10","017","00","030","0006","0224","394","226","168","1","395","975","0","40.51","23.18"
"10","017","00","030","0006","0225","414","224","190","2","416","993","0","41.89","22.56"
"10","017","00","030","0007","0000","1000","569","431","12","1012","2529","0","40.02","22.50"
"10","017","00","030","0007","0214","458","239","219","8","466","1105","0","42.17","21.63"
"10","017","00","030","0007","0215","542","330","212","4","546","1424","0","38.34","23.17"
"10","017","00","030","0008","0000","1087","570","517","13","1100","2563","0","42.92","22.24"
"10","017","00","030","0008","0212","656","353","303","8","664","1460","0","45.48","24.18"
"10","017","00","030","0008","0213","431","217","214","5","436","1103","0","39.53","19.67"
"10","017","00","030","0009","0000","142","62","80","3","145","405","0","35.80","15.31"
"10","017","00","030","0009","0216","142","62","80","3","145","405","0","35.80","15.31"
"10","017","00","030","0010","0000","1944","1011","933","15","1959","4724","0","41.47","21.40"
"10","017","00","030","0010","0217","619","319","300","6","625","1493","0","41.86","21.37"
"10","017","00","030","0010","0218","437","221","216","2","439","1045","0","42.01","21.15"
"10","017","00","030","0010","0219","459","243","216","5","464","1072","0","43.28","22.67"
"10","017","00","030","0010","0220","429","228","201","2","431","1114","0","38.69","20.47"
"10","017","00","030","0011","0000","175","86","89","0","175","408","0","42.89","21.08"
"10","017","00","030","0011","0206","175","86","89","0","175","408","0","42.89","21.08"
"10","017","00","030","0012","0000","1991","1073","918","25","2016","4877","0","41.34","22.00"
"10","017","00","030","0012","0231","551","299","252","9","560","1327","0","42.20","22.53"
"10","017","00","030","0012","0232","492","265","227","5","497","1219","0","40.77","21.74"
"10","017","00","030","0012","0233","390","216","174","6","396","965","0","41.04","22.38"
"10","017","00","030","0012","0234","558","293","265","5","563","1366","0","41.22","21.45"
"10","017","00","030","0013","0000","2194","1263","931","31","2225","5937","0","37.48","21.27"
"10","017","00","030","0013","0226","437","243","194","3","440","1202","0","36.61","20.22"
"10","017","00","030","0013","0227","386","210","176","7","393","1215","0","32.35","17.28"
"10","017","00","030","0013","0228","473","268","205","6","479","1187","0","40.35","22.58"
"10","017","00","030","0013","0229","554","336","218","12","566","1368","0","41.37","24.56"
"10","017","00","030","0013","0230","344","206","138","3","347","965","0","35.96","21.35"
"10","017","00","040","0000","0000","14745","7426","7319","139","14884","35403","42303","42.04","20.98"
"10","017","00","040","0001","0000","642","329","313","7","649","1698","0","38.22","19.38"
"10","017","00","040","0001","0079","315","153","162","5","320","860","0","37.21","17.79"
"10","017","00","040","0001","0080","327","176","151","2","329","838","0","39.26","21.00"
"10","017","00","040","0002","0000","426","222","204","6","432","1015","0","42.56","21.87"
"10","017","00","040","0002","0081","426","222","204","6","432","1015","0","42.56","21.87"
"10","017","00","040","0003","0000","638","341","297","5","643","1481","0","43.42","23.02"
"10","017","00","040","0003","0082","399","210","189","3","402","936","0","42.95","22.44"
"10","017","00","040","0003","0083","239","131","108","2","241","545","0","44.22","24.04"
"10","017","00","040","0004","0000","697","388","309","4","701","1716","0","40.85","22.61"
"10","017","00","040","0004","0084","361","210","151","2","363","881","0","41.20","23.84"
"10","017","00","040","0004","0085","336","178","158","2","338","835","0","40.48","21.32"
"10","017","00","040","0005","0000","914","499","415","4","918","2263","0","40.57","22.05"
"10","017","00","040","0005","0086","491","273","218","4","495","1213","0","40.81","22.51"
"10","017","00","040","0005","0087","423","226","197","0","423","1050","0","40.29","21.52"
"10","017","00","040","0006","0000","683","374","309","9","692","1653","0","41.86","22.63"
"10","017","00","040","0006","0088","683","374","309","9","692","1653","0","41.86","22.63"
"10","017","00","040","0007","0000","357","156","201","4","361","924","0","39.07","16.88"
"10","017","00","040","0007","0089","357","156","201","4","361","924","0","39.07","16.88"
"10","017","00","040","0008","0000","419","202","217","2","421","945","0","44.55","21.38"
"10","017","00","040","0008","0090","419","202","217","2","421","945","0","44.55","21.38"
"10","017","00","040","0009","0000","383","176","207","1","384","840","0","45.71","20.95"
"10","017","00","040","0009","0091","383","176","207","1","384","840","0","45.71","20.95"
"10","017","00","040","0010","0000","687","352","335","8","695","1413","0","49.19","24.91"
"10","017","00","040","0010","0092","507","254","253","5","512","1002","0","51.10","25.35"
"10","017","00","040","0010","0093","180","98","82","3","183","411","0","44.53","23.84"
"10","017","00","040","0011","0000","330","137","193","6","336","730","0","46.03","18.77"
"10","017","00","040","0011","0094","330","137","193","6","336","730","0","46.03","18.77"
"10","017","00","040","0012","0000","387","176","211","3","390","917","0","42.53","19.19"
"10","017","00","040","0012","0095","387","176","211","3","390","917","0","42.53","19.19"
"10","017","00","040","0013","0000","990","478","512","5","995","2538","0","39.20","18.83"
"10","017","00","040","0013","0096","515","235","280","2","517","1258","0","41.10","18.68"
"10","017","00","040","0013","0097","475","243","232","3","478","1280","0","37.34","18.98"
"10","017","00","040","0014","0000","277","103","174","2","279","710","0","39.30","14.51"
"10","017","00","040","0014","0098","277","103","174","2","279","710","0","39.30","14.51"
"10","017","00","040","0015","0000","475","218","257","3","478","1247","0","38.33","17.48"
"10","017","00","040","0015","0099","235","94","141","1","236","624","0","37.82","15.06"
"10","017","00","040","0015","0100","240","124","116","2","242","623","0","38.84","19.90"
"10","017","00","040","0016","0000","313","131","182","4","317","770","0","41.17","17.01"
"10","017","00","040","0016","0101","313","131","182","4","317","770","0","41.17","17.01"
"10","017","00","040","0017","0000","721","374","347","2","723","1698","0","42.58","22.03"
"10","017","00","040","0017","0102","721","374","347","2","723","1698","0","42.58","22.03"
"10","017","00","040","0018","0000","349","147","202","5","354","790","0","44.81","18.61"
"10","017","00","040","0018","0103","349","147","202","5","354","790","0","44.81","18.61"
"10","017","00","040","0019","0000","386","187","199","6","392","846","0","46.34","22.10"
"10","017","00","040","0019","0104","386","187","199","6","392","846","0","46.34","22.10"
"10","017","00","040","0020","0000","281","131","150","4","285","820","0","34.76","15.98"
"10","017","00","040","0020","0105","281","131","150","4","285","820","0","34.76","15.98"
"10","017","00","040","0021","0000","300","169","131","3","303","670","0","45.22","25.22"
"10","017","00","040","0021","0106","300","169","131","3","303","670","0","45.22","25.22"
"10","017","00","040","0022","0000","339","188","151","7","346","957","0","36.15","19.64"
"10","017","00","040","0022","0107","339","188","151","7","346","957","0","36.15","19.64"
"10","017","00","040","0023","0000","373","180","193","6","379","1056","0","35.89","17.05"
"10","017","00","040","0023","0108","373","180","193","6","379","1056","0","35.89","17.05"
"10","017","00","040","0024","0000","1142","711","431","19","1161","2712","0","42.81","26.22"
"10","017","00","040","0024","0109","392","202","190","12","404","1182","0","34.18","17.09"
"10","017","00","040","0024","0110","750","509","241","7","757","1530","0","49.48","33.27"
"10","017","00","040","0025","0000","314","155","159","1","315","676","0","46.60","22.93"
"10","017","00","040","0025","0113","314","155","159","1","315","676","0","46.60","22.93"
"10","017","00","040","0026","0000","247","114","133","1","248","548","0","45.26","20.80"
"10","017","00","040","0026","0114","247","114","133","1","248","548","0","45.26","20.80"
"10","017","00","040","0027","0000","367","141","226","2","369","692","0","53.32","20.38"
"10","017","00","040","0027","0115","367","141","226","2","369","692","0","53.32","20.38"
"10","017","00","040","0028","0000","276","135","141","6","282","571","0","49.39","23.64"
"10","017","00","040","0028","0116","276","135","141","6","282","571","0","49.39","23.64"
"10","017","00","040","0029","0000","1032","512","520","4","1036","2507","0","41.32","20.42"
"10","017","00","040","0029","0111","451","217","234","2","453","1334","0","33.96","16.27"
"10","017","00","040","0029","0112","581","295","286","2","583","1173","0","49.70","25.15"
"10","017","00","050","0000","0000","16359","8708","7651","184","16543","40977","46058","40.37","21.25"
"10","017","00","050","0001","0000","355","189","166","2","357","769","0","46.42","24.58"
"10","017","00","050","0001","0117","355","189","166","2","357","769","0","46.42","24.58"
"10","017","00","050","0002","0000","495","240","255","3","498","992","0","50.20","24.19"
"10","017","00","050","0002","0118","495","240","255","3","498","992","0","50.20","24.19"
"10","017","00","050","0003","0000","313","151","162","5","318","750","0","42.40","20.13"
"10","017","00","050","0003","0119","313","151","162","5","318","750","0","42.40","20.13"
"10","017","00","050","0004","0000","373","150","223","6","379","962","0","39.40","15.59"
"10","017","00","050","0004","0120","373","150","223","6","379","962","0","39.40","15.59"
"10","017","00","050","0005","0000","346","194","152","4","350","749","0","46.73","25.90"
"10","017","00","050","0005","0121","346","194","152","4","350","749","0","46.73","25.90"
"10","017","00","050","0006","0000","506","276","230","8","514","1221","0","42.10","22.60"
"10","017","00","050","0006","0122","506","276","230","8","514","1221","0","42.10","22.60"
"10","017","00","050","0007","0000","306","182","124","4","310","742","0","41.78","24.53"
"10","017","00","050","0007","0123","306","182","124","4","310","742","0","41.78","24.53"
"10","017","00","050","0008","0000","494","248","246","7","501","1138","0","44.02","21.79"
"10","017","00","050","0008","0124","494","248","246","7","501","1138","0","44.02","21.79"
"10","017","00","050","0009","0000","374","214","160","11","385","961","0","40.06","22.27"
"10","017","00","050","0009","0125","374","214","160","11","385","961","0","40.06","22.27"
"10","017","00","050","0010","0000","480","279","201","8","488","1266","0","38.55","22.04"
"10","017","00","050","0010","0126","480","279","201","8","488","1266","0","38.55","22.04"
"10","017","00","050","0011","0000","686","336","350","8","694","1710","0","40.58","19.65"
"10","017","00","050","0011","0127","289","149","140","3","292","812","0","35.96","18.35"
"10","017","00","050","0011","0128","397","187","210","5","402","898","0","44.77","20.82"
"10","017","00","050","0012","0000","581","296","285","10","591","1512","0","39.09","19.58"
"10","017","00","050","0012","0132","581","296","285","10","591","1512","0","39.09","19.58"
"10","017","00","050","0013","0000","359","184","175","1","360","1271","0","28.32","14.48"
"10","017","00","050","0013","0133","359","184","175","1","360","1271","0","28.32","14.48"
"10","017","00","050","0014","0000","229","121","108","2","231","563","0","41.03","21.49"
"10","017","00","050","0014","0130","229","121","108","2","231","563","0","41.03","21.49"
"10","017","00","050","0015","0000","316","151","165","4","320","864","0","37.04","17.48"
"10","017","00","050","0015","0131","316","151","165","4","320","864","0","37.04","17.48"
"10","017","00","050","0016","0000","273","116","157","7","280","654","0","42.81","17.74"
"10","017","00","050","0016","0153","273","116","157","7","280","654","0","42.81","17.74"
"10","017","00","050","0017","0000","405","192","213","4","409","828","0","49.40","23.19"
"10","017","00","050","0017","0152","405","192","213","4","409","828","0","49.40","23.19"
"10","017","00","050","0018","0000","339","161","178","7","346","904","0","38.27","17.81"
"10","017","00","050","0018","0151","339","161","178","7","346","904","0","38.27","17.81"
"10","017","00","050","0019","0000","571","274","297","9","580","1556","0","37.28","17.61"
"10","017","00","050","0019","0150","571","274","297","9","580","1556","0","37.28","17.61"
"10","017","00","050","0020","0000","2460","1423","1037","19","2479","5331","0","46.50","26.69"
"10","017","00","050","0020","0137","561","330","231","3","564","1063","0","53.06","31.04"
"10","017","00","050","0020","0138","613","336","277","8","621","1435","0","43.28","23.41"
"10","017","00","050","0020","0139","721","438","283","1","722","1510","0","47.81","29.01"
"10","017","00","050","0020","0140","565","319","246","7","572","1323","0","43.24","24.11"
"10","017","00","050","0021","0000","2144","1236","908","15","2159","5461","0","39.53","22.63"
"10","017","00","050","0021","0141","505","287","218","1","506","1249","0","40.51","22.98"
"10","017","00","050","0021","0142","359","206","153","1","360","848","0","42.45","24.29"
"10","017","00","050","0021","0143","486","296","190","8","494","1319","0","37.45","22.44"
"10","017","00","050","0021","0144","444","253","191","1","445","1319","0","33.74","19.18"
"10","017","00","050","0021","0145","350","194","156","4","354","726","0","48.76","26.72"
"10","017","00","050","0022","0000","1559","819","740","13","1572","3826","0","41.09","21.41"
"10","017","00","050","0022","0134","498","267","231","3","501","1250","0","40.08","21.36"
"10","017","00","050","0022","0135","543","283","260","5","548","1433","0","38.24","19.75"
"10","017","00","050","0022","0136","518","269","249","5","523","1143","0","45.76","23.53"
"10","017","00","050","0023","0000","206","125","81","4","210","431","0","48.72","29.00"
"10","017","00","050","0023","0129","206","125","81","4","210","431","0","48.72","29.00"
"10","017","00","050","0024","0000","2189","1151","1038","23","2212","6516","0","33.95","17.66"
"10","017","00","050","0024","0146","493","276","217","1","494","1635","0","30.21","16.88"
"10","017","00","050","0024","0147","515","279","236","2","517","1589","0","32.54","17.56"
"10","017","00","050","0024","0148","602","304","298","8","610","1670","0","36.53","18.20"
"10","017","00","050","0024","0149","579","292","287","12","591","1622","0","36.44","18.00"
"10","017","00","060","0000","0000","29260","15999","13261","237","29497","70296","81453","41.96","22.76"
"10","017","00","060","0001","0000","447","241","206","5","452","1179","0","38.34","20.44"
"10","017","00","060","0001","0155","447","241","206","5","452","1179","0","38.34","20.44"
"10","017","00","060","0002","0000","402","195","207","5","407","1020","0","39.90","19.12"
"10","017","00","060","0002","0156","402","195","207","5","407","1020","0","39.90","19.12"
"10","017","00","060","0003","0000","486","251","235","0","486","1326","0","36.65","18.93"
"10","017","00","060","0003","0154","486","251","235","0","486","1326","0","36.65","18.93"
"10","017","00","060","0004","0000","476","250","226","2","478","998","0","47.90","25.05"
"10","017","00","060","0004","0157","476","250","226","2","478","998","0","47.90","25.05"
"10","017","00","060","0005","0000","336","129","207","2","338","883","0","38.28","14.61"
"10","017","00","060","0005","0158","336","129","207","2","338","883","0","38.28","14.61"
"10","017","00","060","0006","0000","704","360","344","3","707","1988","0","35.56","18.11"
"10","017","00","060","0006","0159","511","263","248","1","512","1380","0","37.10","19.06"
"10","017","00","060","0006","0160","193","97","96","2","195","608","0","32.07","15.95"
"10","017","00","060","0007","0000","697","333","364","3","700","1900","0","36.84","17.53"
"10","017","00","060","0007","0161","526","245","281","2","528","1446","0","36.51","16.94"
"10","017","00","060","0007","0162","171","88","83","1","172","454","0","37.89","19.38"
"10","017","00","060","0008","0000","1355","627","728","12","1367","3163","0","43.22","19.82"
"10","017","00","060","0008","0165","819","357","462","5","824","1860","0","44.30","19.19"
"10","017","00","060","0008","0166","536","270","266","7","543","1303","0","41.67","20.72"
"10","017","00","060","0009","0000","373","156","217","3","376","821","0","45.80","19.00"
"10","017","00","060","0009","0163","373","156","217","3","376","821","0","45.80","19.00"
"10","017","00","060","0010","0000","220","99","121","2","222","556","0","39.93","17.81"
"10","017","00","060","0010","0164","220","99","121","2","222","556","0","39.93","17.81"
"10","017","00","060","0011","0000","1432","778","654","16","1448","3892","0","37.20","19.99"
"10","017","00","060","0011","0193","736","389","347","9","745","1910","0","39.01","20.37"
"10","017","00","060","0011","0194","696","389","307","7","703","1982","0","35.47","19.63"
"10","017","00","060","0012","0000","693","383","310","2","695","1657","0","41.94","23.11"
"10","017","00","060","0012","0200","693","383","310","2","695","1657","0","41.94","23.11"
"10","017","00","060","0013","0000","2051","1097","954","15","2066","5349","0","38.62","20.51"
"10","017","00","060","0013","0201","489","244","245","3","492","1271","0","38.71","19.20"
"10","017","00","060","0013","0202","547","342","205","3","550","1398","0","39.34","24.46"
"10","017","00","060","0013","0203","542","284","258","5","547","1407","0","38.88","20.18"
"10","017","00","060","0013","0204","473","227","246","4","477","1273","0","37.47","17.83"
"10","017","00","060","0014","0000","1502","811","691","15","1517","4007","0","37.86","20.24"
"10","017","00","060","0014","0195","884","461","423","8","892","2156","0","41.37","21.38"
"10","017","00","060","0014","0196","618","350","268","7","625","1851","0","33.77","18.91"
"10","017","00","060","0015","0000","1057","544","513","8","1065","2451","0","43.45","22.20"
"10","017","00","060","0015","0167","505","250","255","3","508","1156","0","43.94","21.63"
"10","017","00","060","0015","0168","552","294","258","5","557","1295","0","43.01","22.70"
"10","017","00","060","0016","0000","2223","1252","971","16","2239","4656","0","48.09","26.89"
"10","017","00","060","0016","0172","772","432","340","6","778","1539","0","50.55","28.07"
"10","017","00","060","0016","0173","712","415","297","6","718","1709","0","42.01","24.28"
"10","017","00","060","0016","0174","739","405","334","4","743","1408","0","52.77","28.76"
"10","017","00","060","0017","0000","1486","810","676","6","1492","3415","0","43.69","23.72"
"10","017","00","060","0017","0175","727","380","347","2","729","1773","0","41.12","21.43"
"10","017","00","060","0017","0176","759","430","329","4","763","1642","0","46.47","26.19"
"10","017","00","060","0018","0000","1814","1046","768","15","1829","3876","0","47.19","26.99"
"10","017","00","060","0018","0177","701","394","307","7","708","1586","0","44.64","24.84"
"10","017","00","060","0018","0178","561","336","225","4","565","1145","0","49.34","29.34"
"10","017","00","060","0018","0179","552","316","236","4","556","1145","0","48.56","27.60"
"10","017","00","060","0019","0000","1031","517","514","7","1038","2426","0","42.79","21.31"
"10","017","00","060","0019","0180","550","282","268","3","553","1239","0","44.63","22.76"
"10","017","00","060","0019","0181","481","235","246","4","485","1187","0","40.86","19.80"
"10","017","00","060","0020","0000","1028","606","422","15","1043","2796","0","37.30","21.67"
"10","017","00","060","0020","0185","491","294","197","6","497","1411","0","35.22","20.84"
"10","017","00","060","0020","0186","537","312","225","9","546","1385","0","39.42","22.53"
"10","017","00","060","0021","0000","2072","1173","899","18","2090","4808","0","43.47","24.40"
"10","017","00","060","0021","0197","547","290","257","5","552","1546","0","35.71","18.76"
"10","017","00","060","0021","0198","964","540","424","7","971","2100","0","46.24","25.71"
"10","017","00","060","0021","0199","561","343","218","6","567","1162","0","48.80","29.52"
"10","017","00","060","0022","0000","1641","967","674","13","1654","3289","0","50.29","29.40"
"10","017","00","060","0022","0182","856","517","339","6","862","1726","0","49.94","29.95"
"10","017","00","060","0022","0183","361","205","156","1","362","686","0","52.77","29.88"
"10","017","00","060","0022","0184","424","245","179","6","430","877","0","49.03","27.94"
"10","017","00","060","0023","0000","1707","969","738","20","1727","4694","0","36.79","20.64"
"10","017","00","060","0023","0190","615","357","258","3","618","1681","0","36.76","21.24"
"10","017","00","060","0023","0191","391","221","170","5","396","1069","0","37.04","20.67"
"10","017","00","060","0023","0192","701","391","310","12","713","1944","0","36.68","20.11"
"10","017","00","060","0024","0000","2255","1350","905","15","2270","4907","0","46.26","27.51"
"10","017","00","060","0024","0187","730","431","299","7","737","1557","0","47.33","27.68"
"10","017","00","060","0024","0188","625","354","271","4","629","1416","0","44.42","25.00"
"10","017","00","060","0024","0189","900","565","335","4","904","1934","0","46.74","29.21"
"10","017","00","060","0025","0000","1772","1055","717","19","1791","4239","0","42.25","24.89"
"10","017","00","060","0025","0169","716","414","302","11","727","1633","0","44.52","25.35"
"10","017","00","060","0025","0170","741","437","304","7","748","1833","0","40.81","23.84"
"10","017","00","060","0025","0171","315","204","111","1","316","773","0","40.88","26.39"
"10","017","00","070","0000","0000","19683","11330","8353","178","19861","46687","53082","42.54","24.27"
"10","017","00","070","0001","0000","505","280","225","10","515","1024","0","50.29","27.34"
"10","017","00","070","0001","0041","505","280","225","10","515","1024","0","50.29","27.34"
"10","017","00","070","0002","0000","596","368","228","6","602","1165","0","51.67","31.59"
"10","017","00","070","0002","0042","596","368","228","6","602","1165","0","51.67","31.59"
"10","017","00","070","0003","0000","600","342","258","3","603","1243","0","48.51","27.51"
"10","017","00","070","0003","0043","600","342","258","3","603","1243","0","48.51","27.51"
"10","017","00","070","0004","0000","1084","628","456","7","1091","2232","0","48.88","28.14"
"10","017","00","070","0004","0044","559","317","242","3","562","1092","0","51.47","29.03"
"10","017","00","070","0004","0045","525","311","214","4","529","1140","0","46.40","27.28"
"10","017","00","070","0005","0000","296","146","150","4","300","723","0","41.49","20.19"
"10","017","00","070","0005","0046","296","146","150","4","300","723","0","41.49","20.19"
"10","017","00","070","0006","0000","567","333","234","4","571","1508","0","37.86","22.08"
"10","017","00","070","0006","0047","567","333","234","4","571","1508","0","37.86","22.08"
"10","017","00","070","0007","0000","349","197","152","8","357","712","0","50.14","27.67"
"10","017","00","070","0007","0048","349","197","152","8","357","712","0","50.14","27.67"
"10","017","00","070","0008","0000","543","260","283","8","551","1483","0","37.15","17.53"
"10","017","00","070","0008","0049","543","260","283","8","551","1483","0","37.15","17.53"
"10","017","00","070","0009","0000","715","422","293","5","720","1552","0","46.39","27.19"
"10","017","00","070","0009","0050","715","422","293","5","720","1552","0","46.39","27.19"
"10","017","00","070","0010","0000","707","419","288","6","713","1439","0","49.55","29.12"
"10","017","00","070","0010","0051","707","419","288","6","713","1439","0","49.55","29.12"
"10","017","00","070","0011","0000","902","529","373","8","910","1997","0","45.57","26.49"
"10","017","00","070","0011","0052","458","268","190","6","464","987","0","47.01","27.15"
"10","017","00","070","0011","0053","444","261","183","2","446","1010","0","44.16","25.84"
"10","017","00","070","0012","0000","784","420","364","7","791","1817","0","43.53","23.12"
"10","017","00","070","0012","0058","444","258","186","2","446","1068","0","41.76","24.16"
"10","017","00","070","0012","0059","340","162","178","5","345","749","0","46.06","21.63"
"10","017","00","070","0013","0000","1464","921","543","9","1473","3468","0","42.47","26.56"
"10","017","00","070","0013","0060","570","332","238","3","573","1312","0","43.67","25.30"
"10","017","00","070","0013","0061","557","349","208","4","561","1378","0","40.71","25.33"
"10","017","00","070","0013","0062","337","240","97","2","339","778","0","43.57","30.85"
"10","017","00","070","0014","0000","1129","637","492","12","1141","2716","0","42.01","23.45"
"10","017","00","070","0014","0063","623","345","278","7","630","1440","0","43.75","23.96"
"10","017","00","070","0014","0064","506","292","214","5","511","1276","0","40.05","22.88"
"10","017","00","070","0015","0000","483","255","228","2","485","1308","0","37.08","19.50"
"10","017","00","070","0015","0078","483","255","228","2","485","1308","0","37.08","19.50"
"10","017","00","070","0016","0000","1858","1158","700","18","1876","4064","0","46.16","28.49"
"10","017","00","070","0016","0054","310","189","121","2","312","712","0","43.82","26.54"
"10","017","00","070","0016","0055","413","282","131","6","419","914","0","45.84","30.85"
"10","017","00","070","0016","0056","554","341","213","6","560","1108","0","50.54","30.78"
"10","017","00","070","0016","0057","581","346","235","4","585","1330","0","43.98","26.02"
"10","017","00","070","0017","0000","1615","903","712","21","1636","4618","0","35.43","19.55"
"10","017","00","070","0017","0075","525","301","224","8","533","1215","0","43.87","24.77"
"10","017","00","070","0017","0076","513","267","246","7","520","1598","0","32.54","16.71"
"10","017","00","070","0017","0077","577","335","242","6","583","1805","0","32.30","18.56"
"10","017","00","070","0018","0000","1538","918","620","15","1553","3461","0","44.87","26.52"
"10","017","00","070","0018","0065","422","255","167","5","427","944","0","45.23","27.01"
"10","017","00","070","0018","0066","439","242","197","3","442","1047","0","42.22","23.11"
"10","017","00","070","0018","0067","677","421","256","7","684","1470","0","46.53","28.64"
"10","017","00","070","0019","0000","960","521","439","8","968","2604","0","37.17","20.01"
"10","017","00","070","0019","0073","512","273","239","4","516","1471","0","35.08","18.56"
"10","017","00","070","0019","0074","448","248","200","4","452","1133","0","39.89","21.89"
"10","017","00","070","0020","0000","2988","1673","1315","17","3005","7553","0","39.79","22.15"
"10","017","00","070","0020","0068","643","381","262","5","648","1445","0","44.84","26.37"
"10","017","00","070","0020","0069","669","352","317","3","672","1482","0","45.34","23.75"
"10","017","00","070","0020","0070","483","277","206","3","486","1413","0","34.39","19.60"
"10","017","00","070","0020","0071","529","299","230","5","534","1524","0","35.04","19.62"
"10","017","00","070","0020","0072","664","364","300","1","665","1689","0","39.37","21.55"
"10","018","00","000","0000","0000","154971","81447","73524","1901","156872","361353","452807","43.41","22.54"
"10","018","00","010","0000","0000","76339","42096","34243","891","77230","169450","221541","45.58","24.84"
"10","018","00","010","0001","0000","334","133","201","7","341","689","0","49.49","19.30"
"10","018","00","010","0001","0118","334","133","201","7","341","689","0","49.49","19.30"
"10","018","00","010","0002","0000","651","352","299","6","657","1426","0","46.07","24.68"
"10","018","00","010","0002","0120","426","242","184","4","430","977","0","44.01","24.77"
"10","018","00","010","0002","0121","225","110","115","2","227","449","0","50.56","24.50"
"10","018","00","010","0003","0000","364","136","228","6","370","860","0","43.02","15.81"
"10","018","00","010","0003","0119","364","136","228","6","370","860","0","43.02","15.81"
"10","018","00","010","0004","0000","212","87","125","5","217","472","0","45.97","18.43"
"10","018","00","010","0004","0117","212","87","125","5","217","472","0","45.97","18.43"
"10","018","00","010","0005","0000","275","99","176","2","277","527","0","52.56","18.79"
"10","018","00","010","0005","0004","275","99","176","2","277","527","0","52.56","18.79"
"10","018","00","010","0007","0000","279","118","161","5","284","591","0","48.05","19.97"
"10","018","00","010","0007","0005","279","118","161","5","284","591","0","48.05","19.97"
"10","018","00","010","0010","0000","313","146","167","3","316","712","0","44.38","20.51"
"10","018","00","010","0010","0130","313","146","167","3","316","712","0","44.38","20.51"
"10","018","00","010","0011","0000","457","260","197","3","460","1657","0","27.76","15.69"
"10","018","00","010","0011","0001","457","260","197","3","460","1657","0","27.76","15.69"
"10","018","00","010","0012","0000","241","107","134","4","245","544","0","45.04","19.67"
"10","018","00","010","0012","0006","241","107","134","4","245","544","0","45.04","19.67"
"10","018","00","010","0013","0000","1422","822","600","23","1445","3181","0","45.43","25.84"
"10","018","00","010","0013","0030","440","235","205","7","447","1017","0","43.95","23.11"
"10","018","00","010","0013","0031","503","318","185","9","512","1177","0","43.50","27.02"
"10","018","00","010","0013","0032","479","269","210","7","486","987","0","49.24","27.25"
"10","018","00","010","0014","0000","1251","578","673","17","1268","2794","0","45.38","20.69"
"10","018","00","010","0014","0132","368","171","197","5","373","829","0","44.99","20.63"
"10","018","00","010","0014","0133","433","190","243","6","439","934","0","47.00","20.34"
"10","018","00","010","0014","0134","450","217","233","6","456","1031","0","44.23","21.05"
"10","018","00","010","0015","0000","631","284","347","6","637","1360","0","46.84","20.88"
"10","018","00","010","0015","0135","287","126","161","2","289","589","0","49.07","21.39"
"10","018","00","010","0015","0136","344","158","186","4","348","771","0","45.14","20.49"
"10","018","00","010","0016","0000","2178","1170","1008","21","2199","5451","0","40.34","21.46"
"10","018","00","010","0016","0122","475","222","253","3","478","1091","0","43.81","20.35"
"10","018","00","010","0016","0123","460","232","228","7","467","1113","0","41.96","20.84"
"10","018","00","010","0016","0124","455","277","178","5","460","1139","0","40.39","24.32"
"10","018","00","010","0016","0125","402","233","169","2","404","1091","0","37.03","21.36"
"10","018","00","010","0016","0126","386","206","180","4","390","1017","0","38.35","20.26"
"10","018","00","010","0017","0000","539","320","219","0","539","1058","0","50.95","30.25"
"10","018","00","010","0017","0002","539","320","219","0","539","1058","0","50.95","30.25"
"10","018","00","010","0018","0000","2019","1117","902","25","2044","4446","0","45.97","25.12"
"10","018","00","010","0018","0009","305","190","115","4","309","642","0","48.13","29.60"
"10","018","00","010","0018","0010","583","286","297","6","589","1260","0","46.75","22.70"
"10","018","00","010","0018","0011","566","332","234","12","578","1334","0","43.33","24.89"
"10","018","00","010","0018","0012","565","309","256","3","568","1210","0","46.94","25.54"
"10","018","00","010","0019","0000","1898","1053","845","17","1915","4120","0","46.48","25.56"
"10","018","00","010","0019","0013","455","279","176","3","458","959","0","47.76","29.09"
"10","018","00","010","0019","0014","478","286","192","3","481","980","0","49.08","29.18"
"10","018","00","010","0019","0015","536","279","257","4","540","1175","0","45.96","23.74"
"10","018","00","010","0019","0016","429","209","220","7","436","1006","0","43.34","20.78"
"10","018","00","010","0020","0000","2066","1051","1015","15","2081","4584","0","45.40","22.93"
"10","018","00","010","0020","0021","435","223","212","4","439","1026","0","42.79","21.73"
"10","018","00","010","0020","0022","523","276","247","8","531","1225","0","43.35","22.53"
"10","018","00","010","0020","0023","523","262","261","1","524","1089","0","48.12","24.06"
"10","018","00","010","0020","0024","585","290","295","2","587","1244","0","47.19","23.31"
"10","018","00","010","0021","0000","2663","1355","1308","30","2693","5827","0","46.22","23.25"
"10","018","00","010","0021","0025","498","266","232","7","505","1139","0","44.34","23.35"
"10","018","00","010","0021","0026","591","296","295","4","595","1245","0","47.79","23.78"
"10","018","00","010","0021","0027","449","216","233","5","454","1127","0","40.28","19.17"
"10","018","00","010","0021","0028","546","295","251","7","553","1186","0","46.63","24.87"
"10","018","00","010","0021","0029","579","282","297","7","586","1130","0","51.86","24.96"
"10","018","00","010","0022","0000","1448","731","717","19","1467","3117","0","47.06","23.45"
"10","018","00","010","0022","0044","749","345","404","9","758","1651","0","45.91","20.90"
"10","018","00","010","0022","0045","699","386","313","10","709","1466","0","48.36","26.33"
"10","018","00","010","0023","0000","1317","643","674","13","1330","2796","0","47.57","23.00"
"10","018","00","010","0023","0046","418","177","241","6","424","955","0","44.40","18.53"
"10","018","00","010","0023","0047","426","213","213","2","428","877","0","48.80","24.29"
"10","018","00","010","0023","0048","473","253","220","5","478","964","0","49.59","26.24"
"10","018","00","010","0024","0000","2283","1337","946","26","2309","4392","0","52.57","30.44"
"10","018","00","010","0024","0057","634","345","289","7","641","1196","0","53.60","28.85"
"10","018","00","010","0024","0058","387","264","123","8","395","939","0","42.07","28.12"
"10","018","00","010","0024","0059","592","352","240","2","594","1103","0","53.85","31.91"
"10","018","00","010","0024","0060","670","376","294","9","679","1154","0","58.84","32.58"
"10","018","00","010","0025","0000","2042","1531","511","24","2066","3972","0","52.01","38.54"
"10","018","00","010","0025","0061","681","538","143","9","690","1319","0","52.31","40.79"
"10","018","00","010","0025","0062","688","505","183","11","699","1353","0","51.66","37.32"
"10","018","00","010","0025","0063","673","488","185","4","677","1300","0","52.08","37.54"
"10","018","00","010","0026","0000","2868","1620","1248","44","2912","6185","0","47.08","26.19"
"10","018","00","010","0026","0039","584","344","240","10","594","1306","0","45.48","26.34"
"10","018","00","010","0026","0040","543","325","218","9","552","1222","0","45.17","26.60"
"10","018","00","010","0026","0041","583","342","241","6","589","1220","0","48.28","28.03"
"10","018","00","010","0026","0042","611","318","293","9","620","1302","0","47.62","24.42"
"10","018","00","010","0026","0043","547","291","256","10","557","1135","0","49.07","25.64"
"10","018","00","010","0027","0000","1538","906","632","26","1564","3075","0","50.86","29.46"
"10","018","00","010","0027","0036","450","287","163","4","454","921","0","49.29","31.16"
"10","018","00","010","0027","0037","525","301","224","8","533","1066","0","50.00","28.24"
"10","018","00","010","0027","0038","563","318","245","14","577","1088","0","53.03","29.23"
"10","018","00","010","0028","0000","1512","774","738","14","1526","3537","0","43.14","21.88"
"10","018","00","010","0028","0140","419","216","203","6","425","1043","0","40.75","20.71"
"10","018","00","010","0028","0141","503","261","242","5","508","1047","0","48.52","24.93"
"10","018","00","010","0028","0142","590","297","293","3","593","1447","0","40.98","20.53"
"10","018","00","010","0029","0000","1339","650","689","17","1356","3009","0","45.06","21.60"
"10","018","00","010","0029","0127","419","181","238","5","424","882","0","48.07","20.52"
"10","018","00","010","0029","0128","452","240","212","3","455","1054","0","43.17","22.77"
"10","018","00","010","0029","0129","468","229","239","9","477","1073","0","44.45","21.34"
"10","018","00","010","0030","0000","2308","1252","1056","24","2332","5175","0","45.06","24.19"
"10","018","00","010","0030","0151","358","218","140","0","358","989","0","36.20","22.04"
"10","018","00","010","0030","0152","375","181","194","7","382","867","0","44.06","20.88"
"10","018","00","010","0030","0153","468","279","189","5","473","894","0","52.91","31.21"
"10","018","00","010","0030","0154","412","197","215","8","420","1082","0","38.82","18.21"
"10","018","00","010","0030","0155","695","377","318","4","699","1343","0","52.05","28.07"
"10","018","00","010","0031","0000","2446","1293","1153","32","2478","5610","0","44.17","23.05"
"10","018","00","010","0031","0143","572","262","310","7","579","1285","0","45.06","20.39"
"10","018","00","010","0031","0144","507","294","213","3","510","1080","0","47.22","27.22"
"10","018","00","010","0031","0145","419","232","187","11","430","1103","0","38.98","21.03"
"10","018","00","010","0031","0146","470","248","222","2","472","1099","0","42.95","22.57"
"10","018","00","010","0031","0147","478","257","221","9","487","1043","0","46.69","24.64"
"10","018","00","010","0032","0000","579","323","256","9","588","1240","0","47.42","26.05"
"10","018","00","010","0032","0116","579","323","256","9","588","1240","0","47.42","26.05"
"10","018","00","010","0033","0000","1457","944","513","23","1480","2932","0","50.48","32.20"
"10","018","00","010","0033","0072","488","350","138","6","494","1063","0","46.47","32.93"
"10","018","00","010","0033","0073","386","233","153","7","393","775","0","50.71","30.06"
"10","018","00","010","0033","0074","583","361","222","10","593","1094","0","54.20","33.00"
"10","018","00","010","0035","0000","412","318","94","5","417","887","0","47.01","35.85"
"10","018","00","010","0035","0067","412","318","94","5","417","887","0","47.01","35.85"
"10","018","00","010","0036","0000","1249","844","405","9","1258","2672","0","47.08","31.59"
"10","018","00","010","0036","0064","405","278","127","0","405","971","0","41.71","28.63"
"10","018","00","010","0036","0065","416","260","156","3","419","817","0","51.29","31.82"
"10","018","00","010","0036","0066","428","306","122","6","434","884","0","49.10","34.62"
"10","018","00","010","0037","0000","1959","1437","522","25","1984","3777","0","52.53","38.05"
"10","018","00","010","0037","0068","624","509","115","5","629","1168","0","53.85","43.58"
"10","018","00","010","0037","0069","390","279","111","6","396","802","0","49.38","34.79"
"10","018","00","010","0037","0070","380","299","81","5","385","663","0","58.07","45.10"
"10","018","00","010","0037","0071","565","350","215","9","574","1144","0","50.17","30.59"
"10","018","00","010","0038","0000","1136","541","595","13","1149","2728","0","42.12","19.83"
"10","018","00","010","0038","0049","406","191","215","3","409","936","0","43.70","20.41"
"10","018","00","010","0038","0050","385","198","187","8","393","946","0","41.54","20.93"
"10","018","00","010","0038","0051","345","152","193","2","347","846","0","41.02","17.97"
"10","018","00","010","0039","0000","1432","628","804","35","1467","3260","0","45.00","19.26"
"10","018","00","010","0039","0052","532","237","295","11","543","1277","0","42.52","18.56"
"10","018","00","010","0039","0053","480","234","246","14","494","1055","0","46.82","22.18"
"10","018","00","010","0039","0054","420","157","263","10","430","928","0","46.34","16.92"
"10","018","00","010","0040","0000","881","489","392","11","892","2117","0","42.14","23.10"
"10","018","00","010","0040","0055","451","218","233","8","459","1108","0","41.43","19.68"
"10","018","00","010","0040","0056","430","271","159","3","433","1009","0","42.91","26.86"
"10","018","00","010","0041","0000","2639","1320","1319","21","2660","6204","0","42.88","21.28"
"10","018","00","010","0041","0079","437","239","198","5","442","1033","0","42.79","23.14"
"10","018","00","010","0041","0090","519","254","265","7","526","1218","0","43.19","20.85"
"10","018","00","010","0041","0091","551","244","307","3","554","1367","0","40.53","17.85"
"10","018","00","010","0041","0092","552","290","262","4","556","1254","0","44.34","23.13"
"10","018","00","010","0041","0093","580","293","287","2","582","1332","0","43.69","22.00"
"10","018","00","010","0042","0000","4327","2299","2028","36","4363","9368","0","46.57","24.54"
"10","018","00","010","0042","0075","462","280","182","1","463","1038","0","44.61","26.97"
"10","018","00","010","0042","0076","562","292","270","2","564","1196","0","47.16","24.41"
"10","018","00","010","0042","0077","567","314","253","8","575","1203","0","47.80","26.10"
"10","018","00","010","0042","0078","787","412","375","9","796","1737","0","45.83","23.72"
"10","018","00","010","0042","0080","370","184","186","3","373","864","0","43.17","21.30"
"10","018","00","010","0042","0081","439","230","209","2","441","962","0","45.84","23.91"
"10","018","00","010","0042","0082","620","302","318","6","626","1386","0","45.17","21.79"
"10","018","00","010","0042","0083","520","285","235","5","525","982","0","53.46","29.02"
"10","018","00","010","0043","0000","2304","1292","1012","36","2340","5305","0","44.11","24.35"
"10","018","00","010","0043","0094","468","263","205","11","479","1065","0","44.98","24.69"
"10","018","00","010","0043","0095","434","252","182","8","442","1006","0","43.94","25.05"
"10","018","00","010","0043","0096","481","265","216","10","491","1109","0","44.27","23.90"
"10","018","00","010","0043","0097","478","268","210","4","482","1126","0","42.81","23.80"
"10","018","00","010","0043","0098","443","244","199","3","446","999","0","44.64","24.42"
"10","018","00","010","0044","0000","1989","1127","862","24","2013","4355","0","46.22","25.88"
"10","018","00","010","0044","0112","443","244","199","3","446","1165","0","38.28","20.94"
"10","018","00","010","0044","0113","538","281","257","8","546","1079","0","50.60","26.04"
"10","018","00","010","0044","0114","449","229","220","6","455","950","0","47.89","24.11"
"10","018","00","010","0044","0115","559","373","186","7","566","1161","0","48.75","32.13"
"10","018","00","010","0045","0000","2134","1311","823","28","2162","5215","0","41.46","25.14"
"10","018","00","010","0045","0107","418","278","140","6","424","1102","0","38.48","25.23"
"10","018","00","010","0045","0108","487","293","194","6","493","1204","0","40.95","24.34"
"10","018","00","010","0045","0109","412","251","161","5","417","1031","0","40.45","24.35"
"10","018","00","010","0045","0110","351","229","122","2","353","936","0","37.71","24.47"
"10","018","00","010","0045","0111","466","260","206","9","475","942","0","50.42","27.60"
"10","018","00","010","0046","0000","1959","1161","798","20","1979","4835","0","40.93","24.01"
"10","018","00","010","0046","0103","396","244","152","7","403","1117","0","36.08","21.84"
"10","018","00","010","0046","0104","528","343","185","6","534","1299","0","41.11","26.40"
"10","018","00","010","0046","0105","468","250","218","5","473","1175","0","40.26","21.28"
"10","018","00","010","0046","0106","567","324","243","2","569","1244","0","45.74","26.05"
"10","018","00","010","0047","0000","3215","1895","1320","36","3251","6299","0","51.61","30.08"
"10","018","00","010","0047","0084","517","316","201","5","522","1057","0","49.39","29.90"
"10","018","00","010","0047","0085","472","273","199","7","479","1003","0","47.76","27.22"
"10","018","00","010","0047","0086","538","301","237","7","545","1038","0","52.50","29.00"
"10","018","00","010","0047","0087","590","360","230","7","597","1142","0","52.28","31.52"
"10","018","00","010","0047","0088","464","242","222","6","470","900","0","52.22","26.89"
"10","018","00","010","0047","0089","634","403","231","4","638","1159","0","55.05","34.77"
"10","018","00","010","0048","0000","1057","550","507","16","1073","2356","0","45.54","23.34"
"10","018","00","010","0048","0033","338","166","172","8","346","764","0","45.29","21.73"
"10","018","00","010","0048","0034","352","191","161","4","356","790","0","45.06","24.18"
"10","018","00","010","0048","0035","367","193","174","4","371","802","0","46.26","24.06"
"10","018","00","010","0049","0000","1448","720","728","14","1462","3398","0","43.03","21.19"
"10","018","00","010","0049","0137","474","273","201","5","479","1080","0","44.35","25.28"
"10","018","00","010","0049","0138","454","201","253","4","458","1094","0","41.86","18.37"
"10","018","00","010","0049","0139","520","246","274","5","525","1224","0","42.89","20.10"
"10","018","00","010","0050","0000","2150","1154","996","24","2174","4960","0","43.83","23.27"
"10","018","00","010","0050","0017","506","263","243","10","516","1250","0","41.28","21.04"
"10","018","00","010","0050","0018","506","280","226","5","511","1254","0","40.75","22.33"
"10","018","00","010","0050","0019","581","325","256","6","587","1297","0","45.26","25.06"
"10","018","00","010","0050","0020","557","286","271","3","560","1159","0","48.32","24.68"
"10","018","00","010","0051","0000","847","497","350","8","855","1881","0","45.45","26.42"
"10","018","00","010","0051","0007","319","197","122","3","322","756","0","42.59","26.06"
"10","018","00","010","0051","0008","528","300","228","5","533","1125","0","47.38","26.67"
"10","018","00","010","0052","0000","1629","867","762","19","1648","3466","0","47.55","25.01"
"10","018","00","010","0052","0148","547","321","226","5","552","1196","0","46.15","26.84"
"10","018","00","010","0052","0149","560","293","267","10","570","1279","0","44.57","22.91"
"10","018","00","010","0052","0150","522","253","269","4","526","991","0","53.08","25.53"
"10","018","00","010","0053","0000","1754","1017","737","20","1774","4931","0","35.98","20.62"
"10","018","00","010","0053","0156","390","214","176","3","393","995","0","39.50","21.51"
"10","018","00","010","0053","0157","281","164","117","4","285","931","0","30.61","17.62"
"10","018","00","010","0053","0158","352","223","129","2","354","954","0","37.11","23.38"
"10","018","00","010","0053","0159","395","223","172","7","402","1162","0","34.60","19.19"
"10","018","00","010","0053","0160","336","193","143","4","340","889","0","38.25","21.71"
"10","018","00","010","0054","0000","1927","950","977","15","1942","3964","0","48.99","23.97"
"10","018","00","010","0054","0099","460","239","221","3","463","998","0","46.39","23.95"
"10","018","00","010","0054","0100","456","226","230","2","458","890","0","51.46","25.39"
"10","018","00","010","0054","0101","516","259","257","4","520","1041","0","49.95","24.88"
"10","018","00","010","0054","0102","495","226","269","6","501","1035","0","48.41","21.84"
"10","018","00","010","0055","0000","426","235","191","6","432","958","0","45.09","24.53"
"10","018","00","010","0055","0003","426","235","191","6","432","958","0","45.09","24.53"
"10","018","00","010","0056","0000","535","252","283","4","539","1175","0","45.87","21.45"
"10","018","00","010","0056","0131","535","252","283","4","539","1175","0","45.87","21.45"
"10","018","00","020","0000","0000","53020","27138","25882","657","53677","125506","152490","42.77","21.62"
"10","018","00","020","0001","0000","252","127","125","3","255","555","0","45.95","22.88"
"10","018","00","020","0001","0161","252","127","125","3","255","555","0","45.95","22.88"
"10","018","00","020","0002","0000","320","138","182","1","321","728","0","44.09","18.96"
"10","018","00","020","0002","0165","320","138","182","1","321","728","0","44.09","18.96"
"10","018","00","020","0003","0000","329","137","192","7","336","743","0","45.22","18.44"
"10","018","00","020","0003","0163","329","137","192","7","336","743","0","45.22","18.44"
"10","018","00","020","0004","0000","196","68","128","2","198","464","0","42.67","14.66"
"10","018","00","020","0004","0162","196","68","128","2","198","464","0","42.67","14.66"
"10","018","00","020","0005","0000","468","188","280","10","478","1063","0","44.97","17.69"
"10","018","00","020","0005","0166","468","188","280","10","478","1063","0","44.97","17.69"
"10","018","00","020","0007","0000","526","231","295","10","536","1170","0","45.81","19.74"
"10","018","00","020","0007","0167","526","231","295","10","536","1170","0","45.81","19.74"
"10","018","00","020","0008","0000","441","196","245","4","445","975","0","45.64","20.10"
"10","018","00","020","0008","0197","441","196","245","4","445","975","0","45.64","20.10"
"10","018","00","020","0009","0000","408","188","220","2","410","867","0","47.29","21.68"
"10","018","00","020","0009","0192","408","188","220","2","410","867","0","47.29","21.68"
"10","018","00","020","0010","0000","383","217","166","3","386","775","0","49.81","28.00"
"10","018","00","020","0010","0190","383","217","166","3","386","775","0","49.81","28.00"
"10","018","00","020","0011","0000","381","145","236","1","382","826","0","46.25","17.55"
"10","018","00","020","0011","0191","381","145","236","1","382","826","0","46.25","17.55"
"10","018","00","020","0012","0000","600","259","341","4","604","1365","0","44.25","18.97"
"10","018","00","020","0012","0195","365","155","210","2","367","793","0","46.28","19.55"
"10","018","00","020","0012","0196","235","104","131","2","237","572","0","41.43","18.18"
"10","018","00","020","0013","0000","680","319","361","6","686","1599","0","42.90","19.95"
"10","018","00","020","0013","0193","425","203","222","2","427","936","0","45.62","21.69"
"10","018","00","020","0013","0194","255","116","139","4","259","663","0","39.06","17.50"
"10","018","00","020","0014","0000","1901","863","1038","18","1919","4837","0","39.67","17.84"
"10","018","00","020","0014","0198","492","222","270","5","497","1227","0","40.51","18.09"
"10","018","00","020","0014","0199","555","275","280","3","558","1261","0","44.25","21.81"
"10","018","00","020","0014","0200","400","177","223","5","405","1199","0","33.78","14.76"
"10","018","00","020","0014","0201","454","189","265","5","459","1150","0","39.91","16.43"
"10","018","00","020","0015","0000","1340","690","650","16","1356","3018","0","44.93","22.86"
"10","018","00","020","0015","0215","466","233","233","6","472","1007","0","46.87","23.14"
"10","018","00","020","0015","0216","435","235","200","4","439","1010","0","43.47","23.27"
"10","018","00","020","0015","0217","439","222","217","6","445","1001","0","44.46","22.18"
"10","018","00","020","0016","0000","1780","879","901","25","1805","4021","0","44.89","21.86"
"10","018","00","020","0016","0211","469","210","259","7","476","1113","0","42.77","18.87"
"10","018","00","020","0016","0212","462","239","223","7","469","1042","0","45.01","22.94"
"10","018","00","020","0016","0213","452","229","223","4","456","949","0","48.05","24.13"
"10","018","00","020","0016","0214","397","201","196","7","404","917","0","44.06","21.92"
"10","018","00","020","0017","0000","957","522","435","8","965","2080","0","46.39","25.10"
"10","018","00","020","0017","0218","536","282","254","7","543","1129","0","48.10","24.98"
"10","018","00","020","0017","0219","421","240","181","1","422","951","0","44.37","25.24"
"10","018","00","020","0018","0000","793","345","448","9","802","1845","0","43.47","18.70"
"10","018","00","020","0018","0262","518","229","289","5","523","1219","0","42.90","18.79"
"10","018","00","020","0018","0263","275","116","159","4","279","626","0","44.57","18.53"
"10","018","00","020","0019","0000","1717","990","727","19","1736","3780","0","45.93","26.19"
"10","018","00","020","0019","0254","520","291","229","6","526","1156","0","45.50","25.17"
"10","018","00","020","0019","0255","552","330","222","7","559","1180","0","47.37","27.97"
"10","018","00","020","0019","0256","331","201","130","3","334","722","0","46.26","27.84"
"10","018","00","020","0019","0257","314","168","146","3","317","722","0","43.91","23.27"
"10","018","00","020","0020","0000","353","144","209","8","361","837","0","43.13","17.20"
"10","018","00","020","0020","0264","353","144","209","8","361","837","0","43.13","17.20"
"10","018","00","020","0021","0000","1276","677","599","24","1300","2741","0","47.43","24.70"
"10","018","00","020","0021","0228","385","215","170","5","390","841","0","46.37","25.56"
"10","018","00","020","0021","0229","441","223","218","7","448","886","0","50.56","25.17"
"10","018","00","020","0021","0230","450","239","211","12","462","1014","0","45.56","23.57"
"10","018","00","020","0022","0000","2618","1378","1240","35","2653","5956","0","44.54","23.14"
"10","018","00","020","0022","0239","402","210","192","6","408","869","0","46.95","24.17"
"10","018","00","020","0022","0240","349","190","159","15","364","847","0","42.98","22.43"
"10","018","00","020","0022","0241","405","214","191","3","408","863","0","47.28","24.80"
"10","018","00","020","0022","0242","379","189","190","2","381","967","0","39.40","19.54"
"10","018","00","020","0022","0243","489","242","247","4","493","1166","0","42.28","20.75"
"10","018","00","020","0022","0244","594","333","261","5","599","1244","0","48.15","26.77"
"10","018","00","020","0023","0000","2136","1683","453","23","2159","4508","0","47.89","37.33"
"10","018","00","020","0023","0250","506","395","111","8","514","1085","0","47.37","36.41"
"10","018","00","020","0023","0251","502","406","96","6","508","1122","0","45.28","36.19"
"10","018","00","020","0023","0252","580","447","133","4","584","1208","0","48.34","37.00"
"10","018","00","020","0023","0253","548","435","113","5","553","1093","0","50.59","39.80"
"10","018","00","020","0024","0000","2013","997","1016","23","2036","5777","0","35.24","17.26"
"10","018","00","020","0024","0265","506","234","272","5","511","1307","0","39.10","17.90"
"10","018","00","020","0024","0266","436","255","181","7","443","1220","0","36.31","20.90"
"10","018","00","020","0024","0267","397","181","216","3","400","1169","0","34.22","15.48"
"10","018","00","020","0024","0268","314","159","155","2","316","953","0","33.16","16.68"
"10","018","00","020","0024","0269","360","168","192","6","366","1128","0","32.45","14.89"
"10","018","00","020","0025","0000","221","108","113","6","227","574","0","39.55","18.82"
"10","018","00","020","0025","0282","221","108","113","6","227","574","0","39.55","18.82"
"10","018","00","020","0026","0000","1194","566","628","22","1216","2946","0","41.28","19.21"
"10","018","00","020","0026","0270","309","146","163","6","315","750","0","42.00","19.47"
"10","018","00","020","0026","0271","504","247","257","5","509","1282","0","39.70","19.27"
"10","018","00","020","0026","0272","381","173","208","11","392","914","0","42.89","18.93"
"10","018","00","020","0027","0000","741","329","412","18","759","1982","0","38.29","16.60"
"10","018","00","020","0027","0280","308","124","184","10","318","845","0","37.63","14.67"
"10","018","00","020","0027","0281","433","205","228","8","441","1137","0","38.79","18.03"
"10","018","00","020","0028","0000","1362","698","664","16","1378","3687","0","37.37","18.93"
"10","018","00","020","0028","0273","411","224","187","1","412","1093","0","37.69","20.49"
"10","018","00","020","0028","0274","509","247","262","6","515","1419","0","36.29","17.41"
"10","018","00","020","0028","0275","442","227","215","9","451","1175","0","38.38","19.32"
"10","018","00","020","0029","0000","1433","707","726","8","1441","4195","0","34.35","16.85"
"10","018","00","020","0029","0276","354","154","200","4","358","1068","0","33.52","14.42"
"10","018","00","020","0029","0277","334","194","140","0","334","875","0","38.17","22.17"
"10","018","00","020","0029","0278","374","187","187","2","376","1078","0","34.88","17.35"
"10","018","00","020","0029","0279","371","172","199","2","373","1174","0","31.77","14.65"
"10","018","00","020","0030","0000","698","331","367","8","706","1590","0","44.40","20.82"
"10","018","00","020","0030","0181","436","202","234","6","442","972","0","45.47","20.78"
"10","018","00","020","0030","0182","262","129","133","2","264","618","0","42.72","20.87"
"10","018","00","020","0031","0000","1493","691","802","19","1512","3409","0","44.35","20.27"
"10","018","00","020","0031","0168","462","224","238","1","463","1145","0","40.44","19.56"
"10","018","00","020","0031","0169","520","244","276","10","530","1104","0","48.01","22.10"
"10","018","00","020","0031","0170","511","223","288","8","519","1160","0","44.74","19.22"
"10","018","00","020","0032","0000","1988","1030","958","23","2011","5102","0","39.42","20.19"
"10","018","00","020","0032","0173","337","193","144","3","340","938","0","36.25","20.58"
"10","018","00","020","0032","0174","517","280","237","3","520","1165","0","44.64","24.03"
"10","018","00","020","0032","0175","355","198","157","7","362","1087","0","33.30","18.22"
"10","018","00","020","0032","0176","258","150","108","4","262","735","0","35.65","20.41"
"10","018","00","020","0032","0177","521","209","312","6","527","1177","0","44.77","17.76"
"10","018","00","020","0033","0000","1194","519","675","23","1217","2825","0","43.08","18.37"
"10","018","00","020","0033","0178","401","177","224","4","405","984","0","41.16","17.99"
"10","018","00","020","0033","0179","369","145","224","9","378","903","0","41.86","16.06"
"10","018","00","020","0033","0180","424","197","227","10","434","938","0","46.27","21.00"
"10","018","00","020","0034","0000","1498","600","898","22","1520","3409","0","44.59","17.60"
"10","018","00","020","0034","0186","488","219","269","10","498","1086","0","45.86","20.17"
"10","018","00","020","0034","0187","444","167","277","8","452","1103","0","40.98","15.14"
"10","018","00","020","0034","0188","566","214","352","4","570","1220","0","46.72","17.54"
"10","018","00","020","0036","0000","2108","1096","1012","30","2138","4668","0","45.80","23.48"
"10","018","00","020","0036","0258","496","247","249","5","501","1052","0","47.62","23.48"
"10","018","00","020","0036","0259","517","259","258","11","528","1140","0","46.32","22.72"
"10","018","00","020","0036","0260","571","308","263","6","577","1209","0","47.73","25.48"
"10","018","00","020","0036","0261","524","282","242","8","532","1267","0","41.99","22.26"
"10","018","00","020","0037","0000","2318","1094","1224","28","2346","5381","0","43.60","20.33"
"10","018","00","020","0037","0202","445","206","239","4","449","1048","0","42.84","19.66"
"10","018","00","020","0037","0203","459","186","273","3","462","1019","0","45.34","18.25"
"10","018","00","020","0037","0204","477","243","234","7","484","1106","0","43.76","21.97"
"10","018","00","020","0037","0205","501","251","250","7","508","1188","0","42.76","21.13"
"10","018","00","020","0037","0206","436","208","228","7","443","1020","0","43.43","20.39"
"10","018","00","020","0038","0000","1653","765","888","31","1684","4426","0","38.05","17.28"
"10","018","00","020","0038","0207","420","190","230","5","425","1145","0","37.12","16.59"
"10","018","00","020","0038","0208","395","193","202","15","410","1074","0","38.18","17.97"
"10","018","00","020","0038","0209","415","166","249","3","418","1141","0","36.63","14.55"
"10","018","00","020","0038","0210","423","216","207","8","431","1066","0","40.43","20.26"
"10","018","00","020","0039","0000","1495","805","690","14","1509","4165","0","36.23","19.33"
"10","018","00","020","0039","0220","240","124","116","2","242","1264","0","19.15","9.81"
"10","018","00","020","0039","0221","423","226","197","4","427","887","0","48.14","25.48"
"10","018","00","020","0039","0222","403","222","181","4","407","1031","0","39.48","21.53"
"10","018","00","020","0039","0223","429","233","196","4","433","983","0","44.05","23.70"
"10","018","00","020","0040","0000","2188","1145","1043","20","2208","4801","0","45.99","23.85"
"10","018","00","020","0040","0224","472","240","232","5","477","1165","0","40.94","20.60"
"10","018","00","020","0040","0225","563","270","293","6","569","1221","0","46.60","22.11"
"10","018","00","020","0040","0226","569","300","269","3","572","1127","0","50.75","26.62"
"10","018","00","020","0040","0227","584","335","249","6","590","1288","0","45.81","26.01"
"10","018","00","020","0041","0000","2413","1335","1078","23","2436","5732","0","42.50","23.29"
"10","018","00","020","0041","0245","464","232","232","4","468","1175","0","39.83","19.74"
"10","018","00","020","0041","0246","472","257","215","5","477","1166","0","40.91","22.04"
"10","018","00","020","0041","0247","489","286","203","3","492","1124","0","43.77","25.44"
"10","018","00","020","0041","0248","522","298","224","4","526","1182","0","44.50","25.21"
"10","018","00","020","0041","0249","466","262","204","7","473","1085","0","43.59","24.15"
"10","018","00","020","0042","0000","2963","1663","1300","39","3002","6577","0","45.64","25.29"
"10","018","00","020","0042","0233","492","239","253","11","503","1166","0","43.14","20.50"
"10","018","00","020","0042","0234","432","234","198","6","438","1040","0","42.12","22.50"
"10","018","00","020","0042","0235","508","295","213","7","515","1087","0","47.38","27.14"
"10","018","00","020","0042","0236","480","280","200","1","481","1041","0","46.21","26.90"
"10","018","00","020","0042","0237","508","293","215","7","515","1118","0","46.06","26.21"
"10","018","00","020","0042","0238","543","322","221","7","550","1125","0","48.89","28.62"
"10","018","00","020","0043","0000","1321","643","678","16","1337","2938","0","45.51","21.89"
"10","018","00","020","0043","0231","644","287","357","8","652","1461","0","44.63","19.64"
"10","018","00","020","0043","0232","677","356","321","8","685","1477","0","46.38","24.10"
"10","018","00","020","0044","0000","603","306","297","5","608","1564","0","38.87","19.57"
"10","018","00","020","0044","0171","310","159","151","1","311","829","0","37.52","19.18"
"10","018","00","020","0044","0172","293","147","146","4","297","735","0","40.41","20.00"
"10","018","00","020","0045","0000","1565","1015","550","16","1581","3326","0","47.53","30.52"
"10","018","00","020","0045","0183","626","506","120","6","632","1219","0","51.85","41.51"
"10","018","00","020","0045","0184","450","240","210","5","455","1113","0","40.88","21.56"
"10","018","00","020","0045","0185","489","269","220","5","494","994","0","49.70","27.06"
"10","018","00","020","0046","0000","340","150","190","2","342","684","0","50.00","21.93"
"10","018","00","020","0046","0164","340","150","190","2","342","684","0","50.00","21.93"
"10","018","00","020","0047","0000","363","161","202","7","370","995","0","37.19","16.18"
"10","018","00","020","0047","0189","363","161","202","7","370","995","0","37.19","16.18"
"10","018","00","030","0000","0000","25612","12213","13399","353","25965","66397","78776","39.11","18.39"
"10","018","00","030","0001","0000","1045","374","671","13","1058","2715","0","38.97","13.78"
"10","018","00","030","0001","0313","333","119","214","5","338","857","0","39.44","13.89"
"10","018","00","030","0001","0314","370","129","241","3","373","930","0","40.11","13.87"
"10","018","00","030","0001","0315","342","126","216","5","347","928","0","37.39","13.58"
"10","018","00","030","0002","0000","2072","892","1180","33","2105","5496","0","38.30","16.23"
"10","018","00","030","0002","0308","360","162","198","5","365","1057","0","34.53","15.33"
"10","018","00","030","0002","0309","345","144","201","5","350","925","0","37.84","15.57"
"10","018","00","030","0002","0310","470","216","254","5","475","1310","0","36.26","16.49"
"10","018","00","030","0002","0311","379","163","216","8","387","982","0","39.41","16.60"
"10","018","00","030","0002","0312","518","207","311","10","528","1222","0","43.21","16.94"
"10","018","00","030","0003","0000","897","434","463","17","914","2275","0","40.18","19.08"
"10","018","00","030","0003","0306","356","182","174","4","360","935","0","38.50","19.47"
"10","018","00","030","0003","0307","541","252","289","13","554","1340","0","41.34","18.81"
"10","018","00","030","0004","0000","824","326","498","11","835","2355","0","35.46","13.84"
"10","018","00","030","0004","0304","403","167","236","7","410","1212","0","33.83","13.78"
"10","018","00","030","0004","0305","421","159","262","4","425","1143","0","37.18","13.91"
"10","018","00","030","0005","0000","900","310","590","21","921","2096","0","43.94","14.79"
"10","018","00","030","0005","0302","464","153","311","12","476","1143","0","41.64","13.39"
"10","018","00","030","0005","0303","436","157","279","9","445","953","0","46.69","16.47"
"10","018","00","030","0006","0000","1301","561","740","23","1324","3186","0","41.56","17.61"
"10","018","00","030","0006","0299","449","199","250","3","452","1122","0","40.29","17.74"
"10","018","00","030","0006","0300","368","171","197","9","377","862","0","43.74","19.84"
"10","018","00","030","0006","0301","484","191","293","11","495","1202","0","41.18","15.89"
"10","018","00","030","0007","0000","1280","625","655","12","1292","2869","0","45.03","21.78"
"10","018","00","030","0007","0292","423","189","234","4","427","892","0","47.87","21.19"
"10","018","00","030","0007","0293","467","230","237","7","474","1093","0","43.37","21.04"
"10","018","00","030","0007","0294","390","206","184","1","391","884","0","44.23","23.30"
"10","018","00","030","0008","0000","1720","882","838","21","1741","4595","0","37.89","19.19"
"10","018","00","030","0008","0295","463","209","254","6","469","1134","0","41.36","18.43"
"10","018","00","030","0008","0296","410","208","202","4","414","1141","0","36.28","18.23"
"10","018","00","030","0008","0297","379","211","168","4","383","1182","0","32.40","17.85"
"10","018","00","030","0008","0298","468","254","214","7","475","1138","0","41.74","22.32"
"10","018","00","030","0009","0000","1963","984","979","18","1981","5017","0","39.49","19.61"
"10","018","00","030","0009","0283","433","218","215","6","439","990","0","44.34","22.02"
"10","018","00","030","0009","0284","354","186","168","5","359","943","0","38.07","19.72"
"10","018","00","030","0009","0285","347","184","163","0","347","968","0","35.85","19.01"
"10","018","00","030","0009","0286","417","201","216","6","423","1030","0","41.07","19.51"
"10","018","00","030","0009","0287","412","195","217","1","413","1086","0","38.03","17.96"
"10","018","00","030","0010","0000","1811","1030","781","26","1837","4051","0","45.35","25.43"
"10","018","00","030","0010","0316","324","170","154","8","332","815","0","40.74","20.86"
"10","018","00","030","0010","0317","553","329","224","8","561","1053","0","53.28","31.24"
"10","018","00","030","0010","0318","377","222","155","3","380","951","0","39.96","23.34"
"10","018","00","030","0010","0319","557","309","248","7","564","1232","0","45.78","25.08"
"10","018","00","030","0011","0000","1413","776","637","14","1427","3559","0","40.10","21.80"
"10","018","00","030","0011","0320","424","210","214","5","429","1215","0","35.31","17.28"
"10","018","00","030","0011","0321","472","255","217","3","475","1156","0","41.09","22.06"
"10","018","00","030","0011","0322","517","311","206","6","523","1188","0","44.02","26.18"
"10","018","00","030","0012","0000","1582","761","821","18","1600","4357","0","36.72","17.47"
"10","018","00","030","0012","0323","440","210","230","2","442","1176","0","37.59","17.86"
"10","018","00","030","0012","0324","369","159","210","6","375","1025","0","36.59","15.51"
"10","018","00","030","0012","0325","393","193","200","4","397","1146","0","34.64","16.84"
"10","018","00","030","0012","0326","380","199","181","6","386","1010","0","38.22","19.70"
"10","018","00","030","0013","0000","1063","447","616","19","1082","2843","0","38.06","15.72"
"10","018","00","030","0013","0327","432","185","247","10","442","1042","0","42.42","17.75"
"10","018","00","030","0013","0328","332","136","196","7","339","897","0","37.79","15.16"
"10","018","00","030","0013","0329","299","126","173","2","301","904","0","33.30","13.94"
"10","018","00","030","0014","0000","431","177","254","5","436","1121","0","38.89","15.79"
"10","018","00","030","0014","0330","431","177","254","5","436","1121","0","38.89","15.79"
"10","018","00","030","0015","0000","773","361","412","10","783","2151","0","36.40","16.78"
"10","018","00","030","0015","0331","408","207","201","5","413","1131","0","36.52","18.30"
"10","018","00","030","0015","0332","365","154","211","5","370","1020","0","36.27","15.10"
"10","018","00","030","0016","0000","875","446","429","15","890","2366","0","37.62","18.85"
"10","018","00","030","0016","0333","405","188","217","7","412","1245","0","33.09","15.10"
"10","018","00","030","0016","0334","470","258","212","8","478","1121","0","42.64","23.02"
"10","018","00","030","0017","0000","273","137","136","4","277","924","0","29.98","14.83"
"10","018","00","030","0017","0346","273","137","136","4","277","924","0","29.98","14.83"
"10","018","00","030","0018","0000","329","161","168","4","333","862","0","38.63","18.68"
"10","018","00","030","0018","0345","329","161","168","4","333","862","0","38.63","18.68"
"10","018","00","030","0019","0000","298","162","136","5","303","770","0","39.35","21.04"
"10","018","00","030","0019","0344","298","162","136","5","303","770","0","39.35","21.04"
"10","018","00","030","0020","0000","626","350","276","11","637","1828","0","34.85","19.15"
"10","018","00","030","0020","0342","275","154","121","1","276","718","0","38.44","21.45"
"10","018","00","030","0020","0343","351","196","155","10","361","1110","0","32.52","17.66"
"10","018","00","030","0021","0000","1482","716","766","21","1503","4280","0","35.12","16.73"
"10","018","00","030","0021","0337","422","234","188","7","429","1083","0","39.61","21.61"
"10","018","00","030","0021","0338","291","138","153","3","294","974","0","30.18","14.17"
"10","018","00","030","0021","0339","429","186","243","5","434","1239","0","35.03","15.01"
"10","018","00","030","0021","0340","340","158","182","6","346","984","0","35.16","16.06"
"10","018","00","030","0022","0000","551","257","294","8","559","1479","0","37.80","17.38"
"10","018","00","030","0022","0335","323","157","166","8","331","863","0","38.35","18.19"
"10","018","00","030","0022","0336","228","100","128","0","228","616","0","37.01","16.23"
"10","018","00","030","0023","0000","337","130","207","4","341","792","0","43.06","16.41"
"10","018","00","030","0023","0341","337","130","207","4","341","792","0","43.06","16.41"
"10","018","00","030","0024","0000","1766","914","852","20","1786","4410","0","40.50","20.73"
"10","018","00","030","0024","0288","338","164","174","6","344","789","0","43.60","20.79"
"10","018","00","030","0024","0289","500","262","238","7","507","1240","0","40.89","21.13"
"10","018","00","030","0024","0290","496","260","236","4","500","1222","0","40.92","21.28"
"10","018","00","030","0024","0291","432","228","204","3","435","1159","0","37.53","19.67"
"10","020","00","000","0000","0000","92209","39901","52308","724","92933","221038","264721","42.04","18.05"
"10","020","00","010","0000","0000","42406","19300","23106","311","42717","100157","119170","42.65","19.27"
"10","020","00","010","0001","0000","1751","712","1039","9","1760","4525","0","38.90","15.73"
"10","020","00","010","0001","0086","529","155","374","3","532","1289","0","41.27","12.02"
"10","020","00","010","0001","0087","385","169","216","3","388","983","0","39.47","17.19"
"10","020","00","010","0001","0088","405","198","207","1","406","1142","0","35.55","17.34"
"10","020","00","010","0001","0089","432","190","242","2","434","1111","0","39.06","17.10"
"10","020","00","010","0002","0000","1369","595","774","5","1374","3379","0","40.66","17.61"
"10","020","00","010","0002","0083","445","190","255","3","448","1094","0","40.95","17.37"
"10","020","00","010","0002","0084","505","226","279","2","507","1209","0","41.94","18.69"
"10","020","00","010","0002","0085","419","179","240","0","419","1076","0","38.94","16.64"
"10","020","00","010","0003","0000","1182","537","645","7","1189","2803","0","42.42","19.16"
"10","020","00","010","0003","0081","571","241","330","2","573","1364","0","42.01","17.67"
"10","020","00","010","0003","0082","611","296","315","5","616","1439","0","42.81","20.57"
"10","020","00","010","0004","0000","1315","610","705","13","1328","3208","0","41.40","19.01"
"10","020","00","010","0004","0074","381","168","213","4","385","1014","0","37.97","16.57"
"10","020","00","010","0004","0075","497","243","254","6","503","1128","0","44.59","21.54"
"10","020","00","010","0004","0076","437","199","238","3","440","1066","0","41.28","18.67"
"10","020","00","010","0005","0000","904","435","469","4","908","2125","0","42.73","20.47"
"10","020","00","010","0005","0077","482","221","261","3","485","1177","0","41.21","18.78"
"10","020","00","010","0005","0078","422","214","208","1","423","948","0","44.62","22.57"
"10","020","00","010","0034","0000","1770","961","809","12","1782","4239","0","42.04","22.67"
"10","020","00","010","0034","0024","482","298","184","5","487","1231","0","39.56","24.21"
"10","020","00","010","0034","0025","555","323","232","4","559","1270","0","44.02","25.43"
"10","020","00","010","0034","0026","357","174","183","2","359","861","0","41.70","20.21"
"10","020","00","010","0034","0027","376","166","210","1","377","877","0","42.99","18.93"
"10","020","00","010","0035","0000","1846","920","926","20","1866","4140","0","45.07","22.22"
"10","020","00","010","0035","0020","477","226","251","7","484","1062","0","45.57","21.28"
"10","020","00","010","0035","0021","491","254","237","5","496","1170","0","42.39","21.71"
"10","020","00","010","0035","0022","421","212","209","2","423","907","0","46.64","23.37"
"10","020","00","010","0035","0023","457","228","229","6","463","1001","0","46.25","22.78"
"10","020","00","010","0036","0000","1695","855","840","14","1709","3945","0","43.32","21.67"
"10","020","00","010","0036","0017","553","238","315","8","561","1433","0","39.15","16.61"
"10","020","00","010","0036","0018","510","261","249","3","513","1055","0","48.63","24.74"
"10","020","00","010","0036","0019","632","356","276","3","635","1457","0","43.58","24.43"
"10","020","00","010","0037","0000","1057","511","546","7","1064","2249","0","47.31","22.72"
"10","020","00","010","0037","0013","538","265","273","1","539","1144","0","47.12","23.16"
"10","020","00","010","0037","0014","519","246","273","6","525","1105","0","47.51","22.26"
"10","020","00","010","0038","0000","803","428","375","6","809","1740","0","46.49","24.60"
"10","020","00","010","0038","0005","339","187","152","3","342","683","0","50.07","27.38"
"10","020","00","010","0038","0006","464","241","223","3","467","1057","0","44.18","22.80"
"10","020","00","010","0039","0000","1784","883","901","8","1792","4209","0","42.58","20.98"
"10","020","00","010","0039","0030","579","310","269","2","581","1472","0","39.47","21.06"
"10","020","00","010","0039","0031","614","293","321","2","616","1352","0","45.56","21.67"
"10","020","00","010","0039","0032","591","280","311","4","595","1385","0","42.96","20.22"
"10","020","00","010","0041","0000","803","370","433","5","808","1933","0","41.80","19.14"
"10","020","00","010","0041","0008","370","170","200","2","372","923","0","40.30","18.42"
"10","020","00","010","0041","0009","433","200","233","3","436","1010","0","43.17","19.80"
"10","020","00","010","0042","0000","380","160","220","2","382","1058","0","36.11","15.12"
"10","020","00","010","0042","0007","380","160","220","2","382","1058","0","36.11","15.12"
"10","020","00","010","0043","0000","1296","607","689","7","1303","2882","0","45.21","21.06"
"10","020","00","010","0043","0015","670","316","354","2","672","1496","0","44.92","21.12"
"10","020","00","010","0043","0016","626","291","335","5","631","1386","0","45.53","21.00"
"10","020","00","010","0044","0000","1083","539","544","6","1089","2346","0","46.42","22.98"
"10","020","00","010","0044","0001","457","216","241","2","459","1021","0","44.96","21.16"
"10","020","00","010","0044","0002","626","323","303","4","630","1325","0","47.55","24.38"
"10","020","00","010","0045","0000","850","397","453","8","858","1953","0","43.93","20.33"
"10","020","00","010","0045","0045","372","177","195","5","377","895","0","42.12","19.78"
"10","020","00","010","0045","0046","478","220","258","3","481","1058","0","45.46","20.79"
"10","020","00","010","0046","0000","494","195","299","3","497","1241","0","40.05","15.71"
"10","020","00","010","0046","0047","494","195","299","3","497","1241","0","40.05","15.71"
"10","020","00","010","0047","0000","632","222","410","10","642","1578","0","40.68","14.07"
"10","020","00","010","0047","0048","360","120","240","7","367","804","0","45.65","14.93"
"10","020","00","010","0047","0049","272","102","170","3","275","774","0","35.53","13.18"
"10","020","00","010","0048","0000","518","199","319","2","520","1231","0","42.24","16.17"
"10","020","00","010","0048","0050","518","199","319","2","520","1231","0","42.24","16.17"
"10","020","00","010","0049","0000","1298","581","717","12","1310","3435","0","38.14","16.91"
"10","020","00","010","0049","0051","434","177","257","2","436","1031","0","42.29","17.17"
"10","020","00","010","0049","0052","434","217","217","6","440","1306","0","33.69","16.62"
"10","020","00","010","0049","0053","430","187","243","4","434","1098","0","39.53","17.03"
"10","020","00","010","0050","0000","947","423","524","9","956","2160","0","44.26","19.58"
"10","020","00","010","0050","0054","437","221","216","5","442","1021","0","43.29","21.65"
"10","020","00","010","0050","0055","510","202","308","4","514","1139","0","45.13","17.73"
"10","020","00","010","0051","0000","1063","433","630","13","1076","2474","0","43.49","17.50"
"10","020","00","010","0051","0056","513","195","318","7","520","1246","0","41.73","15.65"
"10","020","00","010","0051","0057","550","238","312","6","556","1228","0","45.28","19.38"
"10","020","00","010","0052","0000","1128","481","647","9","1137","2693","0","42.22","17.86"
"10","020","00","010","0052","0058","602","257","345","4","606","1409","0","43.01","18.24"
"10","020","00","010","0052","0059","526","224","302","5","531","1284","0","41.36","17.45"
"10","020","00","010","0053","0000","1159","523","636","13","1172","2905","0","40.34","18.00"
"10","020","00","010","0053","0065","420","168","252","8","428","1179","0","36.30","14.25"
"10","020","00","010","0053","0066","739","355","384","5","744","1726","0","43.11","20.57"
"10","020","00","010","0054","0000","1525","701","824","12","1537","3865","0","39.77","18.14"
"10","020","00","010","0054","0062","472","185","287","4","476","1141","0","41.72","16.21"
"10","020","00","010","0054","0063","457","217","240","4","461","1198","0","38.48","18.11"
"10","020","00","010","0054","0064","596","299","297","4","600","1526","0","39.32","19.59"
"10","020","00","010","0055","0000","1517","711","806","12","1529","3606","0","42.40","19.72"
"10","020","00","010","0055","0067","490","214","276","5","495","1173","0","42.20","18.24"
"10","020","00","010","0055","0068","569","302","267","4","573","1272","0","45.05","23.74"
"10","020","00","010","0055","0069","458","195","263","3","461","1161","0","39.71","16.80"
"10","020","00","010","0056","0000","905","371","534","5","910","1993","0","45.66","18.62"
"10","020","00","010","0056","0043","464","198","266","2","466","996","0","46.79","19.88"
"10","020","00","010","0056","0044","441","173","268","3","444","997","0","44.53","17.35"
"10","020","00","010","0057","0000","665","278","387","4","669","1684","0","39.73","16.51"
"10","020","00","010","0057","0041","393","174","219","3","396","902","0","43.90","19.29"
"10","020","00","010","0057","0042","272","104","168","1","273","782","0","34.91","13.30"
"10","020","00","010","0058","0000","843","330","513","10","853","1923","0","44.36","17.16"
"10","020","00","010","0058","0039","420","132","288","3","423","912","0","46.38","14.47"
"10","020","00","010","0058","0040","423","198","225","7","430","1011","0","42.53","19.58"
"10","020","00","010","0059","0000","802","324","478","8","810","1928","0","42.01","16.80"
"10","020","00","010","0059","0035","381","163","218","0","381","906","0","42.05","17.99"
"10","020","00","010","0059","0036","421","161","260","8","429","1022","0","41.98","15.75"
"10","020","00","010","0060","0000","851","353","498","5","856","1797","0","47.63","19.64"
"10","020","00","010","0060","0033","408","204","204","0","408","890","0","45.84","22.92"
"10","020","00","010","0060","0034","443","149","294","5","448","907","0","49.39","16.43"
"10","020","00","010","0061","0000","902","446","456","5","907","1852","0","48.97","24.08"
"10","020","00","010","0061","0028","549","282","267","3","552","1166","0","47.34","24.19"
"10","020","00","010","0061","0029","353","164","189","2","355","686","0","51.75","23.91"
"10","020","00","010","0062","0000","994","360","634","7","1001","2130","0","47.00","16.90"
"10","020","00","010","0062","0037","492","184","308","3","495","1125","0","44.00","16.36"
"10","020","00","010","0062","0038","502","176","326","4","506","1005","0","50.35","17.51"
"10","020","00","010","0063","0000","971","404","567","4","975","2284","0","42.69","17.69"
"10","020","00","010","0063","0072","581","239","342","2","583","1312","0","44.44","18.22"
"10","020","00","010","0063","0073","390","165","225","2","392","972","0","40.33","16.98"
"10","020","00","010","0064","0000","952","368","584","12","964","2085","0","46.24","17.65"
"10","020","00","010","0064","0070","462","185","277","8","470","1097","0","42.84","16.86"
"10","020","00","010","0064","0071","490","183","307","4","494","988","0","50.00","18.52"
"10","020","00","010","0065","0000","911","438","473","3","914","2195","0","41.64","19.95"
"10","020","00","010","0065","0003","375","181","194","2","377","1015","0","37.14","17.83"
"10","020","00","010","0065","0004","536","257","279","1","537","1180","0","45.51","21.78"
"10","020","00","010","0066","0000","1622","819","803","10","1632","3695","0","44.17","22.17"
"10","020","00","010","0066","0010","582","286","296","3","585","1290","0","45.35","22.17"
"10","020","00","010","0066","0011","527","258","269","5","532","1221","0","43.57","21.13"
"10","020","00","010","0066","0012","513","275","238","2","515","1184","0","43.50","23.23"
"10","020","00","010","0067","0000","777","368","409","6","783","1950","0","40.15","18.87"
"10","020","00","010","0067","0060","376","181","195","2","378","963","0","39.25","18.80"
"10","020","00","010","0067","0061","401","187","214","4","405","987","0","41.03","18.95"
"10","020","00","010","0068","0000","1042","452","590","4","1046","2719","0","38.47","16.62"
"10","020","00","010","0068","0079","546","236","310","3","549","1354","0","40.55","17.43"
"10","020","00","010","0068","0080","496","216","280","1","497","1365","0","36.41","15.82"
"10","020","00","020","0000","0000","49803","20601","29202","413","50216","120881","145551","41.54","17.04"
"10","020","00","020","0001","0000","302","123","179","3","305","819","0","37.24","15.02"
"10","020","00","020","0001","0164","302","123","179","3","305","819","0","37.24","15.02"
"10","020","00","020","0002","0000","804","271","533","6","810","2045","0","39.61","13.25"
"10","020","00","020","0002","0169","381","110","271","4","385","1001","0","38.46","10.99"
"10","020","00","020","0002","0170","423","161","262","2","425","1044","0","40.71","15.42"
"10","020","00","020","0003","0000","1018","382","636","13","1031","2205","0","46.76","17.32"
"10","020","00","020","0003","0160","499","186","313","7","506","1127","0","44.90","16.50"
"10","020","00","020","0003","0161","519","196","323","6","525","1078","0","48.70","18.18"
"10","020","00","020","0005","0000","761","289","472","14","775","1945","0","39.85","14.86"
"10","020","00","020","0005","0165","405","174","231","6","411","1104","0","37.23","15.76"
"10","020","00","020","0005","0166","356","115","241","8","364","841","0","43.28","13.67"
"10","020","00","020","0009","0000","1732","706","1026","22","1754","4451","0","39.41","15.86"
"10","020","00","020","0009","0171","544","221","323","5","549","1473","0","37.27","15.00"
"10","020","00","020","0009","0172","608","237","371","13","621","1523","0","40.77","15.56"
"10","020","00","020","0009","0173","580","248","332","4","584","1455","0","40.14","17.04"
"10","020","00","020","0010","0000","1740","574","1166","18","1758","4153","0","42.33","13.82"
"10","020","00","020","0010","0180","609","190","419","5","614","1390","0","44.17","13.67"
"10","020","00","020","0010","0181","535","180","355","6","541","1379","0","39.23","13.05"
"10","020","00","020","0010","0182","596","204","392","7","603","1384","0","43.57","14.74"
"10","020","00","020","0011","0000","1299","542","757","12","1311","3225","0","40.65","16.81"
"10","020","00","020","0011","0177","690","295","395","5","695","1654","0","42.02","17.84"
"10","020","00","020","0011","0178","609","247","362","7","616","1571","0","39.21","15.72"
"10","020","00","020","0012","0000","1177","447","730","4","1181","2954","0","39.98","15.13"
"10","020","00","020","0012","0187","621","246","375","3","624","1562","0","39.95","15.75"
"10","020","00","020","0012","0188","556","201","355","1","557","1392","0","40.01","14.44"
"10","020","00","020","0013","0000","593","228","365","7","600","1556","0","38.56","14.65"
"10","020","00","020","0013","0189","593","228","365","7","600","1556","0","38.56","14.65"
"10","020","00","020","0014","0000","424","176","248","9","433","1125","0","38.49","15.64"
"10","020","00","020","0014","0186","424","176","248","9","433","1125","0","38.49","15.64"
"10","020","00","020","0015","0000","821","270","551","3","824","2143","0","38.45","12.60"
"10","020","00","020","0015","0101","405","142","263","2","407","1040","0","39.13","13.65"
"10","020","00","020","0015","0102","416","128","288","1","417","1103","0","37.81","11.60"
"10","020","00","020","0016","0000","1611","683","928","20","1631","4114","0","39.65","16.60"
"10","020","00","020","0016","0106","496","187","309","9","505","1158","0","43.61","16.15"
"10","020","00","020","0016","0107","508","207","301","4","512","1263","0","40.54","16.39"
"10","020","00","020","0016","0108","607","289","318","7","614","1693","0","36.27","17.07"
"10","020","00","020","0017","0000","1336","535","801","16","1352","3239","0","41.74","16.52"
"10","020","00","020","0017","0119","444","157","287","8","452","1048","0","43.13","14.98"
"10","020","00","020","0017","0120","456","204","252","4","460","1088","0","42.28","18.75"
"10","020","00","020","0017","0121","436","174","262","4","440","1103","0","39.89","15.78"
"10","020","00","020","0018","0000","1394","551","843","11","1405","3497","0","40.18","15.76"
"10","020","00","020","0018","0103","441","171","270","0","441","1023","0","43.11","16.72"
"10","020","00","020","0018","0104","468","179","289","7","475","1182","0","40.19","15.14"
"10","020","00","020","0018","0105","485","201","284","4","489","1292","0","37.85","15.56"
"10","020","00","020","0019","0000","1355","582","773","10","1365","3363","0","40.59","17.31"
"10","020","00","020","0019","0114","396","191","205","5","401","987","0","40.63","19.35"
"10","020","00","020","0019","0115","469","192","277","3","472","1128","0","41.84","17.02"
"10","020","00","020","0019","0116","490","199","291","2","492","1248","0","39.42","15.95"
"10","020","00","020","0020","0000","751","291","460","8","759","1847","0","41.09","15.76"
"10","020","00","020","0020","0117","410","152","258","2","412","970","0","42.47","15.67"
"10","020","00","020","0020","0118","341","139","202","6","347","877","0","39.57","15.85"
"10","020","00","020","0021","0000","2650","1222","1428","23","2673","6843","0","39.06","17.86"
"10","020","00","020","0021","0122","564","264","300","2","566","1437","0","39.39","18.37"
"10","020","00","020","0021","0123","490","217","273","5","495","1253","0","39.51","17.32"
"10","020","00","020","0021","0124","552","269","283","3","555","1460","0","38.01","18.42"
"10","020","00","020","0021","0125","476","219","257","6","482","1255","0","38.41","17.45"
"10","020","00","020","0021","0126","568","253","315","7","575","1438","0","39.99","17.59"
"10","020","00","020","0022","0000","795","331","464","8","803","2010","0","39.95","16.47"
"10","020","00","020","0022","0112","402","163","239","6","408","970","0","42.06","16.80"
"10","020","00","020","0022","0113","393","168","225","2","395","1040","0","37.98","16.15"
"10","020","00","020","0031","0000","869","366","503","9","878","1889","0","46.48","19.38"
"10","020","00","020","0031","0090","391","158","233","6","397","859","0","46.22","18.39"
"10","020","00","020","0031","0091","478","208","270","3","481","1030","0","46.70","20.19"
"10","020","00","020","0045","0000","773","442","331","3","776","1615","0","48.05","27.37"
"10","020","00","020","0045","0151","347","123","224","1","348","755","0","46.09","16.29"
"10","020","00","020","0045","0152","426","319","107","2","428","860","0","49.77","37.09"
"10","020","00","020","0046","0000","684","276","408","7","691","1915","0","36.08","14.41"
"10","020","00","020","0046","0149","350","134","216","2","352","926","0","38.01","14.47"
"10","020","00","020","0046","0150","334","142","192","5","339","989","0","34.28","14.36"
"10","020","00","020","0047","0000","2339","992","1347","18","2357","5748","0","41.01","17.26"
"10","020","00","020","0047","0145","610","276","334","2","612","1547","0","39.56","17.84"
"10","020","00","020","0047","0146","506","200","306","4","510","1297","0","39.32","15.42"
"10","020","00","020","0047","0147","597","265","332","7","604","1334","0","45.28","19.87"
"10","020","00","020","0047","0148","626","251","375","5","631","1570","0","40.19","15.99"
"10","020","00","020","0048","0000","2124","830","1294","12","2136","5437","0","39.29","15.27"
"10","020","00","020","0048","0141","536","243","293","1","537","1169","0","45.94","20.79"
"10","020","00","020","0048","0142","547","208","339","3","550","1279","0","43.00","16.26"
"10","020","00","020","0048","0143","509","114","395","4","513","1601","0","32.04","7.12"
"10","020","00","020","0048","0144","532","265","267","4","536","1388","0","38.62","19.09"
"10","020","00","020","0049","0000","1766","655","1111","8","1774","4510","0","39.33","14.52"
"10","020","00","020","0049","0131","527","198","329","2","529","1464","0","36.13","13.52"
"10","020","00","020","0049","0132","574","199","375","3","577","1405","0","41.07","14.16"
"10","020","00","020","0049","0133","665","258","407","3","668","1641","0","40.71","15.72"
"10","020","00","020","0050","0000","1532","659","873","9","1541","3560","0","43.29","18.51"
"10","020","00","020","0050","0128","342","101","241","2","344","898","0","38.31","11.25"
"10","020","00","020","0050","0129","704","321","383","2","706","1550","0","45.55","20.71"
"10","020","00","020","0050","0130","486","237","249","5","491","1112","0","44.15","21.31"
"10","020","00","020","0051","0000","775","307","468","5","780","1726","0","45.19","17.79"
"10","020","00","020","0051","0153","422","171","251","3","425","915","0","46.45","18.69"
"10","020","00","020","0051","0154","353","136","217","2","355","811","0","43.77","16.77"
"10","020","00","020","0052","0000","817","601","216","6","823","1739","0","47.33","34.56"
"10","020","00","020","0052","0155","412","293","119","3","415","868","0","47.81","33.76"
"10","020","00","020","0052","0156","405","308","97","3","408","871","0","46.84","35.36"
"10","020","00","020","0053","0000","2153","986","1167","27","2180","5111","0","42.65","19.29"
"10","020","00","020","0053","0137","483","204","279","9","492","1185","0","41.52","17.22"
"10","020","00","020","0053","0138","572","263","309","6","578","1319","0","43.82","19.94"
"10","020","00","020","0053","0139","598","270","328","7","605","1464","0","41.33","18.44"
"10","020","00","020","0053","0140","500","249","251","5","505","1143","0","44.18","21.78"
"10","020","00","020","0054","0000","652","494","158","5","657","1383","0","47.51","35.72"
"10","020","00","020","0054","0157","652","494","158","5","657","1383","0","47.51","35.72"
"10","020","00","020","0055","0000","698","305","393","5","703","1622","0","43.34","18.80"
"10","020","00","020","0055","0127","698","305","393","5","703","1622","0","43.34","18.80"
"10","020","00","020","0056","0000","773","324","449","8","781","1864","0","41.90","17.38"
"10","020","00","020","0056","0092","367","146","221","7","374","951","0","39.33","15.35"
"10","020","00","020","0056","0093","406","178","228","1","407","913","0","44.58","19.50"
"10","020","00","020","0057","0000","737","247","490","2","739","1627","0","45.42","15.18"
"10","020","00","020","0057","0094","737","247","490","2","739","1627","0","45.42","15.18"
"10","020","00","020","0058","0000","1027","393","634","3","1030","2211","0","46.59","17.77"
"10","020","00","020","0058","0095","546","235","311","2","548","1200","0","45.67","19.58"
"10","020","00","020","0058","0096","481","158","323","1","482","1011","0","47.68","15.63"
"10","020","00","020","0059","0000","1003","365","638","8","1011","2209","0","45.77","16.52"
"10","020","00","020","0059","0097","478","159","319","3","481","1109","0","43.37","14.34"
"10","020","00","020","0059","0098","525","206","319","5","530","1100","0","48.18","18.73"
"10","020","00","020","0060","0000","548","230","318","3","551","1253","0","43.97","18.36"
"10","020","00","020","0060","0100","548","230","318","3","551","1253","0","43.97","18.36"
"10","020","00","020","0061","0000","640","229","411","5","645","1355","0","47.60","16.90"
"10","020","00","020","0061","0099","640","229","411","5","645","1355","0","47.60","16.90"
"10","020","00","020","0062","0000","687","269","418","7","694","1512","0","45.90","17.79"
"10","020","00","020","0062","0158","328","118","210","5","333","719","0","46.31","16.41"
"10","020","00","020","0062","0159","359","151","208","2","361","793","0","45.52","19.04"
"10","020","00","020","0063","0000","634","232","402","7","641","1521","0","42.14","15.25"
"10","020","00","020","0063","0162","320","130","190","2","322","743","0","43.34","17.50"
"10","020","00","020","0063","0163","314","102","212","5","319","778","0","41.00","13.11"
"10","020","00","020","0064","0000","807","282","525","4","811","2042","0","39.72","13.81"
"10","020","00","020","0064","0167","457","169","288","1","458","1129","0","40.57","14.97"
"10","020","00","020","0064","0168","350","113","237","3","353","913","0","38.66","12.38"
"10","020","00","020","0065","0000","1704","691","1013","13","1717","4195","0","40.93","16.47"
"10","020","00","020","0065","0109","589","211","378","6","595","1364","0","43.62","15.47"
"10","020","00","020","0065","0110","553","237","316","4","557","1386","0","40.19","17.10"
"10","020","00","020","0065","0111","562","243","319","3","565","1445","0","39.10","16.82"
"10","020","00","020","0066","0000","1142","498","644","7","1149","2686","0","42.78","18.54"
"10","020","00","020","0066","0134","561","278","283","5","566","1313","0","43.11","21.17"
"10","020","00","020","0066","0135","581","220","361","2","583","1373","0","42.46","16.02"
"10","020","00","020","0067","0000","645","237","408","6","651","1570","0","41.46","15.10"
"10","020","00","020","0067","0136","645","237","408","6","651","1570","0","41.46","15.10"
"10","020","00","020","0068","0000","1366","591","775","6","1372","3637","0","37.72","16.25"
"10","020","00","020","0068","0183","448","196","252","1","449","1276","0","35.19","15.36"
"10","020","00","020","0068","0184","468","184","284","3","471","1212","0","38.86","15.18"
"10","020","00","020","0068","0185","450","211","239","2","452","1149","0","39.34","18.36"
"10","020","00","020","0069","0000","1836","717","1119","11","1847","4295","0","43.00","16.69"
"10","020","00","020","0069","0174","517","195","322","5","522","1243","0","42.00","15.69"
"10","020","00","020","0069","0175","599","250","349","4","603","1324","0","45.54","18.88"
"10","020","00","020","0069","0176","720","272","448","2","722","1728","0","41.78","15.74"
"10","020","00","020","0070","0000","509","180","329","2","511","1115","0","45.83","16.14"
"10","020","00","020","0070","0179","509","180","329","2","511","1115","0","45.83","16.14"
"09","020","00","000","0000","0000","23100","19817","3283","306","23406","124592","139764","18.79","15.91"
"09","020","00","010","0000","0000","7289","6336","953","87","7376","37667","42770","19.58","16.82"
"09","020","00","010","0001","0000","954","843","111","12","966","4809","0","20.09","17.53"
"09","020","00","010","0001","0001","269","245","24","1","270","1369","0","19.72","17.90"
"09","020","00","010","0001","0002","359","315","44","5","364","1748","0","20.82","18.02"
"09","020","00","010","0001","0003","326","283","43","6","332","1692","0","19.62","16.73"
"09","020","00","010","0002","0000","2022","1768","254","18","2040","9671","0","21.09","18.28"
"09","020","00","010","0002","0007","313","268","45","2","315","1584","0","19.89","16.92"
"09","020","00","010","0002","0008","332","284","48","1","333","1622","0","20.53","17.51"
"09","020","00","010","0002","0009","314","271","43","4","318","1564","0","20.33","17.33"
"09","020","00","010","0002","0010","347","306","41","0","347","1654","0","20.98","18.50"
"09","020","00","010","0002","0011","384","339","45","5","389","1730","0","22.49","19.60"
"09","020","00","010","0002","0012","332","300","32","6","338","1517","0","22.28","19.78"
"09","020","00","010","0003","0000","1062","928","134","19","1081","5344","0","20.23","17.37"
"09","020","00","010","0003","0004","338","291","47","5","343","1870","0","18.34","15.56"
"09","020","00","010","0003","0005","287","256","31","7","294","1608","0","18.28","15.92"
"09","020","00","010","0003","0006","437","381","56","7","444","1866","0","23.79","20.42"
"09","020","00","010","0004","0000","723","636","87","10","733","3979","0","18.42","15.98"
"09","020","00","010","0004","0013","263","224","39","6","269","1334","0","20.16","16.79"
"09","020","00","010","0004","0014","234","219","15","0","234","1174","0","19.93","18.65"
"09","020","00","010","0004","0015","226","193","33","4","230","1471","0","15.64","13.12"
"09","020","00","010","0005","0000","729","617","112","8","737","4023","0","18.32","15.34"
"09","020","00","010","0005","0020","235","207","28","2","237","1334","0","17.77","15.52"
"09","020","00","010","0005","0021","222","175","47","2","224","1229","0","18.23","14.24"
"09","020","00","010","0005","0022","272","235","37","4","276","1460","0","18.90","16.10"
"09","020","00","010","0006","0000","454","401","53","8","462","2226","0","20.75","18.01"
"09","020","00","010","0006","0019","454","401","53","8","462","2226","0","20.75","18.01"
"09","020","00","010","0007","0000","499","442","57","7","506","2885","0","17.54","15.32"
"09","020","00","010","0007","0023","236","206","30","4","240","1590","0","15.09","12.96"
"09","020","00","010","0007","0024","263","236","27","3","266","1295","0","20.54","18.22"
"09","020","00","010","0008","0000","846","701","145","5","851","4730","0","17.99","14.82"
"09","020","00","010","0008","0016","291","247","44","2","293","1565","0","18.72","15.78"
"09","020","00","010","0008","0017","260","214","46","2","262","1530","0","17.12","13.99"
"09","020","00","010","0008","0018","295","240","55","1","296","1635","0","18.10","14.68"
"09","020","00","020","0000","0000","3411","3038","373","45","3456","18724","20622","18.46","16.23"
"09","020","00","020","0001","0000","965","853","112","14","979","5076","0","19.29","16.80"
"09","020","00","020","0001","0070","156","143","13","4","160","895","0","17.88","15.98"
"09","020","00","020","0001","0071","185","157","28","5","190","994","0","19.11","15.79"
"09","020","00","020","0001","0072","300","272","28","3","303","1524","0","19.88","17.85"
"09","020","00","020","0001","0073","324","281","43","2","326","1663","0","19.60","16.90"
"09","020","00","020","0002","0000","336","300","36","7","343","1955","0","17.54","15.35"
"09","020","00","020","0002","0081","155","131","24","3","158","1033","0","15.30","12.68"
"09","020","00","020","0002","0082","181","169","12","4","185","922","0","20.07","18.33"
"09","020","00","020","0003","0000","216","200","16","4","220","1153","0","19.08","17.35"
"09","020","00","020","0003","0083","216","200","16","4","220","1153","0","19.08","17.35"
"09","020","00","020","0004","0000","436","368","68","5","441","2348","0","18.78","15.67"
"09","020","00","020","0004","0084","214","180","34","2","216","1251","0","17.27","14.39"
"09","020","00","020","0004","0085","222","188","34","3","225","1097","0","20.51","17.14"
"09","020","00","020","0005","0000","380","349","31","3","383","2045","0","18.73","17.07"
"09","020","00","020","0005","0074","180","169","11","1","181","960","0","18.85","17.60"
"09","020","00","020","0005","0075","200","180","20","2","202","1085","0","18.62","16.59"
"09","020","00","020","0006","0000","265","232","33","0","265","1592","0","16.65","14.57"
"09","020","00","020","0006","0078","265","232","33","0","265","1592","0","16.65","14.57"
"09","020","00","020","0007","0000","367","335","32","5","372","2210","0","16.83","15.16"
"09","020","00","020","0007","0079","228","216","12","0","228","1233","0","18.49","17.52"
"09","020","00","020","0007","0080","139","119","20","5","144","977","0","14.74","12.18"
"09","020","00","020","0008","0000","446","401","45","7","453","2345","0","19.32","17.10"
"09","020","00","020","0008","0076","246","220","26","2","248","1212","0","20.46","18.15"
"09","020","00","020","0008","0077","200","181","19","5","205","1133","0","18.09","15.98"
"09","020","00","030","0000","0000","5202","4450","752","88","5290","26724","30316","19.79","16.65"
"09","020","00","030","0001","0000","839","745","94","15","854","3969","0","21.52","18.77"
"09","020","00","030","0001","0052","291","249","42","7","298","1248","0","23.88","19.95"
"09","020","00","030","0001","0053","251","229","22","4","255","1260","0","20.24","18.17"
"09","020","00","030","0001","0054","297","267","30","4","301","1461","0","20.60","18.28"
"09","020","00","030","0002","0000","651","560","91","19","670","3328","0","20.13","16.83"
"09","020","00","030","0002","0055","377","324","53","8","385","1882","0","20.46","17.22"
"09","020","00","030","0002","0056","274","236","38","11","285","1446","0","19.71","16.32"
"09","020","00","030","0003","0000","516","450","66","10","526","2699","0","19.49","16.67"
"09","020","00","030","0003","0066","203","166","37","2","205","1279","0","16.03","12.98"
"09","020","00","030","0003","0067","313","284","29","8","321","1420","0","22.61","20.00"
"09","020","00","030","0004","0000","425","352","73","4","429","2132","0","20.12","16.51"
"09","020","00","030","0004","0059","199","173","26","3","202","1061","0","19.04","16.31"
"09","020","00","030","0004","0060","226","179","47","1","227","1071","0","21.20","16.71"
"09","020","00","030","0005","0000","652","563","89","11","663","3259","0","20.34","17.28"
"09","020","00","030","0005","0068","327","283","44","5","332","1652","0","20.10","17.13"
"09","020","00","030","0005","0069","325","280","45","6","331","1607","0","20.60","17.42"
"09","020","00","030","0006","0000","1528","1259","269","20","1548","8073","0","19.18","15.60"
"09","020","00","030","0006","0061","389","301","88","3","392","2006","0","19.54","15.00"
"09","020","00","030","0006","0062","288","256","32","7","295","1672","0","17.64","15.31"
"09","020","00","030","0006","0063","277","237","40","4","281","1459","0","19.26","16.24"
"09","020","00","030","0006","0064","278","225","53","4","282","1502","0","18.77","14.98"
"09","020","00","030","0006","0065","296","240","56","2","298","1434","0","20.78","16.74"
"09","020","00","030","0007","0000","237","214","23","5","242","1560","0","15.51","13.72"
"09","020","00","030","0007","0057","237","214","23","5","242","1560","0","15.51","13.72"
"09","020","00","030","0008","0000","354","307","47","4","358","1704","0","21.01","18.02"
"09","020","00","030","0008","0058","354","307","47","4","358","1704","0","21.01","18.02"
"09","020","00","040","0000","0000","5336","4337","999","57","5393","29252","32749","18.44","14.83"
"09","020","00","040","0001","0000","478","411","67","5","483","3363","0","14.36","12.22"
"09","020","00","040","0001","0025","267","231","36","3","270","1783","0","15.14","12.96"
"09","020","00","040","0001","0026","211","180","31","2","213","1580","0","13.48","11.39"
"09","020","00","040","0002","0000","820","681","139","18","838","5049","0","16.60","13.49"
"09","020","00","040","0002","0027","326","256","70","4","330","2119","0","15.57","12.08"
"09","020","00","040","0002","0028","170","143","27","4","174","1014","0","17.16","14.10"
"09","020","00","040","0002","0029","324","282","42","10","334","1916","0","17.43","14.72"
"09","020","00","040","0003","0000","304","259","45","1","305","1618","0","18.85","16.01"
"09","020","00","040","0003","0041","304","259","45","1","305","1618","0","18.85","16.01"
"09","020","00","040","0004","0000","1525","1227","298","10","1535","7551","0","20.33","16.25"
"09","020","00","040","0004","0030","344","282","62","3","347","1878","0","18.48","15.02"
"09","020","00","040","0004","0031","431","308","123","4","435","1865","0","23.32","16.51"
"09","020","00","040","0004","0032","391","330","61","0","391","1872","0","20.89","17.63"
"09","020","00","040","0004","0033","359","307","52","3","362","1936","0","18.70","15.86"
"09","020","00","040","0005","0000","929","787","142","10","939","5268","0","17.82","14.94"
"09","020","00","040","0005","0034","352","285","67","7","359","1933","0","18.57","14.74"
"09","020","00","040","0005","0035","286","252","34","1","287","1816","0","15.80","13.88"
"09","020","00","040","0005","0036","291","250","41","2","293","1519","0","19.29","16.46"
"09","020","00","040","0006","0000","1280","972","308","13","1293","6403","0","20.19","15.18"
"09","020","00","040","0006","0037","292","259","33","5","297","1570","0","18.92","16.50"
"09","020","00","040","0006","0038","313","264","49","3","316","1874","0","16.86","14.09"
"09","020","00","040","0006","0039","447","255","192","5","452","1681","0","26.89","15.17"
"09","020","00","040","0006","0040","228","194","34","0","228","1278","0","17.84","15.18"
"09","020","00","050","0000","0000","1825","1626","199","29","1854","11656","12646","15.91","13.95"
"09","020","00","050","0001","0000","456","410","46","9","465","2843","0","16.36","14.42"
"09","020","00","050","0001","0048","242","226","16","3","245","1411","0","17.36","16.02"
"09","020","00","050","0001","0049","214","184","30","6","220","1432","0","15.36","12.85"
"09","020","00","050","0002","0000","184","171","13","6","190","1428","0","13.31","11.97"
"09","020","00","050","0002","0047","184","171","13","6","190","1428","0","13.31","11.97"
"09","020","00","050","0003","0000","344","295","49","7","351","2415","0","14.53","12.22"
"09","020","00","050","0003","0045","167","141","26","5","172","1285","0","13.39","10.97"
"09","020","00","050","0003","0046","177","154","23","2","179","1130","0","15.84","13.63"
"09","020","00","050","0004","0000","612","543","69","4","616","3328","0","18.51","16.32"
"09","020","00","050","0004","0042","298","271","27","4","302","1601","0","18.86","16.93"
"09","020","00","050","0004","0043","314","272","42","0","314","1727","0","18.18","15.75"
"09","020","00","050","0005","0000","229","207","22","3","232","1642","0","14.13","12.61"
"09","020","00","050","0005","0044","229","207","22","3","232","1642","0","14.13","12.61"
"09","020","00","060","0000","0000","37","30","7","0","37","569","661","6.50","5.27"
"09","020","00","060","0001","0000","19","15","4","0","19","270","0","7.04","5.56"
"09","020","00","060","0001","0050","19","15","4","0","19","270","0","7.04","5.56"
"09","020","00","060","0002","0000","18","15","3","0","18","299","0","6.02","5.02"
"09","020","00","060","0002","0051","18","15","3","0","18","299","0","6.02","5.02"
"09","007","00","000","0000","0000","3093","2634","459","25","3118","11673","13449","26.71","22.56"
"09","007","00","010","0000","0000","1884","1612","272","16","1900","6505","7644","29.21","24.78"
"09","007","00","010","0001","0000","645","551","94","7","652","1982","0","32.90","27.80"
"09","007","00","010","0001","0001","327","280","47","4","331","1041","0","31.80","26.90"
"09","007","00","010","0001","0002","318","271","47","3","321","941","0","34.11","28.80"
"09","007","00","010","0010","0000","469","408","61","4","473","1682","0","28.12","24.26"
"09","007","00","010","0010","0003","469","408","61","4","473","1682","0","28.12","24.26"
"09","007","00","010","0011","0000","332","279","53","2","334","1223","0","27.31","22.81"
"09","007","00","010","0011","0004","332","279","53","2","334","1223","0","27.31","22.81"
"09","007","00","010","0012","0000","438","374","64","3","441","1618","0","27.26","23.11"
"09","007","00","010","0012","0005","438","374","64","3","441","1618","0","27.26","23.11"
"09","007","00","020","0000","0000","617","523","94","7","624","2537","2846","24.60","20.61"
"09","007","00","020","0007","0000","329","277","52","6","335","1310","0","25.57","21.15"
"09","007","00","020","0007","0006","329","277","52","6","335","1310","0","25.57","21.15"
"09","007","00","020","0008","0000","288","246","42","1","289","1227","0","23.55","20.05"
"09","007","00","020","0008","0007","288","246","42","1","289","1227","0","23.55","20.05"
"09","007","00","030","0000","0000","297","246","51","2","299","1363","1496","21.94","18.05"
"09","007","00","030","0006","0000","158","128","30","0","158","668","0","23.65","19.16"
"09","007","00","030","0006","0008","158","128","30","0","158","668","0","23.65","19.16"
"09","007","00","030","0007","0000","139","118","21","2","141","695","0","20.29","16.98"
"09","007","00","030","0007","0009","139","118","21","2","141","695","0","20.29","16.98"
"09","007","00","040","0000","0000","295","253","42","0","295","1268","1463","23.26","19.95"
"09","007","00","040","0003","0000","295","253","42","0","295","1268","0","23.26","19.95"
"09","007","00","040","0003","0010","295","253","42","0","295","1268","0","23.26","19.95"
