prv_code,city_code,area_code,dept_code,li_code,tbox_no,valid_ticket,invalid_ticket,vote_ticket,votable_population,population,cand_male_num,cand_female_num,cand_num,elected_male_num,elected_female_num,elected_num,elect_to_population,vote_to_elect,elected_to_cand
00,000,00,000,0000,0000,3054541,132609,3187150,4927490,5920742,2454,771,3225,1491,525,2016,83.22,64.68,62.51
09,007,00,000,0000,0000,8449,164,8613,11799,13976,22,9,31,16,6,22,84.42,73.00,70.97
09,007,01,010,0001,0001,712,11,723,1012,0,7,2,9,6,1,7,0.00,71.44,77.78
09,007,01,010,0001,0002,651,15,666,901,0,7,2,9,6,1,7,0.00,73.92,77.78
09,007,01,010,0A01,0003,1161,30,1191,1698,0,7,2,9,6,1,7,0.00,70.14,77.78
09,007,01,010,0A02,0004,892,26,918,1265,0,7,2,9,6,1,7,0.00,72.57,77.78
09,007,01,010,0A03,0005,1060,18,1078,1589,0,7,2,9,6,1,7,0.00,67.84,77.78
09,007,01,010,0001,0000,1363,26,1389,1913,0,7,2,9,6,1,7,0.00,72.61,77.78
09,007,01,010,0A01,0000,1161,30,1191,1698,0,7,2,9,6,1,7,0.00,70.14,77.78
09,007,01,010,0A02,0000,892,26,918,1265,0,7,2,9,6,1,7,0.00,72.57,77.78
09,007,01,010,0A03,0000,1060,18,1078,1589,0,7,2,9,6,1,7,0.00,67.84,77.78
09,007,01,020,0A01,0006,1035,20,1055,1366,0,4,2,6,4,1,5,0.00,77.23,83.33
09,007,01,020,0A02,0007,1009,24,1033,1375,0,4,2,6,4,1,5,0.00,75.13,83.33
09,007,01,020,0A01,0000,1035,20,1055,1366,0,4,2,6,4,1,5,0.00,77.23,83.33
09,007,01,020,0A02,0000,1009,24,1033,1375,0,4,2,6,4,1,5,0.00,75.13,83.33
09,007,01,030,0A01,0008,443,5,448,633,0,6,3,9,2,3,5,0.00,70.77,55.56
09,007,01,030,0A02,0009,513,6,519,684,0,6,3,9,2,3,5,0.00,75.88,55.56
09,007,01,030,0A01,0000,443,5,448,633,0,6,3,9,2,3,5,0.00,70.77,55.56
09,007,01,030,0A02,0000,513,6,519,684,0,6,3,9,2,3,5,0.00,75.88,55.56
09,007,01,040,0A01,0010,973,9,982,1276,0,5,2,7,4,1,5,0.00,76.96,71.43
09,007,01,040,0A01,0000,973,9,982,1276,0,5,2,7,4,1,5,0.00,76.96,71.43
09,007,00,010,0000,0000,4476,100,4576,6465,7804,7,2,9,6,1,7,82.84,70.78,77.78
09,007,01,010,0000,0000,4476,100,4576,6465,7804,7,2,9,6,1,7,82.84,70.78,77.78
09,007,00,020,0000,0000,2044,44,2088,2741,3183,4,2,6,4,1,5,86.11,76.18,83.33
09,007,01,020,0000,0000,2044,44,2088,2741,3183,4,2,6,4,1,5,86.11,76.18,83.33
09,007,00,030,0000,0000,956,11,967,1317,1471,6,3,9,2,3,5,89.53,73.42,55.56
09,007,01,030,0000,0000,956,11,967,1317,1471,6,3,9,2,3,5,89.53,73.42,55.56
09,007,00,040,0000,0000,973,9,982,1276,1518,5,2,7,4,1,5,84.06,76.96,71.43
09,007,01,040,0000,0000,973,9,982,1276,1518,5,2,7,4,1,5,84.06,76.96,71.43
09,020,00,000,0000,0000,46066,1934,48000,122012,140938,46,20,66,33,14,47,86.57,39.34,71.21
09,020,01,010,0001,0001,562,17,579,1341,0,11,5,16,7,4,11,0.00,43.18,68.75
09,020,01,010,0001,0002,727,24,751,1675,0,11,5,16,7,4,11,0.00,44.84,68.75
09,020,01,010,0001,0003,724,23,747,1676,0,11,5,16,7,4,11,0.00,44.57,68.75
09,020,01,010,0003,0004,667,25,692,1786,0,11,5,16,7,4,11,0.00,38.75,68.75
09,020,01,010,0003,0005,559,20,579,1583,0,11,5,16,7,4,11,0.00,36.58,68.75
09,020,01,010,0003,0006,745,27,772,1815,0,11,5,16,7,4,11,0.00,42.53,68.75
09,020,01,010,0002,0007,589,28,617,1522,0,11,5,16,7,4,11,0.00,40.54,68.75
09,020,01,010,0002,0008,555,18,573,1514,0,11,5,16,7,4,11,0.00,37.85,68.75
09,020,01,010,0002,0009,552,31,583,1489,0,11,5,16,7,4,11,0.00,39.15,68.75
09,020,01,010,0001,0000,2013,64,2077,4692,0,11,5,16,7,4,11,0.00,44.27,68.75
09,020,01,010,0002,0010,578,23,601,1563,0,11,5,16,7,4,11,0.00,38.45,68.75
09,020,01,010,0002,0011,690,26,716,1683,0,11,5,16,7,4,11,0.00,42.54,68.75
09,020,01,010,0002,0012,553,17,570,1436,0,11,5,16,7,4,11,0.00,39.69,68.75
09,020,01,010,0004,0013,486,8,494,1267,0,11,5,16,7,4,11,0.00,38.99,68.75
09,020,01,010,0004,0014,419,17,436,1093,0,11,5,16,7,4,11,0.00,39.89,68.75
09,020,01,010,0004,0015,484,21,505,1383,0,11,5,16,7,4,11,0.00,36.51,68.75
09,020,01,010,0008,0016,591,17,608,1575,0,11,5,16,7,4,11,0.00,38.60,68.75
09,020,01,010,0008,0017,581,24,605,1517,0,11,5,16,7,4,11,0.00,39.88,68.75
09,020,01,010,0008,0018,551,14,565,1593,0,11,5,16,7,4,11,0.00,35.47,68.75
09,020,01,010,0006,0019,842,60,902,2203,0,11,5,16,7,4,11,0.00,40.94,68.75
09,020,01,010,0002,0000,3517,143,3660,9207,0,11,5,16,7,4,11,0.00,39.75,68.75
09,020,01,010,0005,0020,493,19,512,1304,0,11,5,16,7,4,11,0.00,39.26,68.75
09,020,01,010,0005,0021,458,25,483,1205,0,11,5,16,7,4,11,0.00,40.08,68.75
09,020,01,010,0005,0022,504,12,516,1437,0,11,5,16,7,4,11,0.00,35.91,68.75
09,020,01,010,0007,0023,444,32,476,1570,0,11,5,16,7,4,11,0.00,30.32,68.75
09,020,01,010,0007,0024,507,26,533,1260,0,11,5,16,7,4,11,0.00,42.30,68.75
09,020,01,010,0003,0000,1971,72,2043,5184,0,11,5,16,7,4,11,0.00,39.41,68.75
09,020,01,010,0004,0000,1389,46,1435,3743,0,11,5,16,7,4,11,0.00,38.34,68.75
09,020,01,010,0005,0000,1455,56,1511,3946,0,11,5,16,7,4,11,0.00,38.29,68.75
09,020,01,010,0006,0000,842,60,902,2203,0,11,5,16,7,4,11,0.00,40.94,68.75
09,020,01,010,0007,0000,951,58,1009,2830,0,11,5,16,7,4,11,0.00,35.65,68.75
09,020,01,010,0008,0000,1723,55,1778,4685,0,11,5,16,7,4,11,0.00,37.95,68.75
09,020,01,020,0001,0000,1840,91,1931,4938,0,6,4,10,6,2,8,0.00,39.10,80.00
09,020,01,020,0002,0000,644,31,675,1891,0,6,4,10,6,2,8,0.00,35.70,80.00
09,020,01,020,0003,0000,501,34,535,1149,0,6,4,10,6,2,8,0.00,46.56,80.00
09,020,01,020,0004,0000,916,56,972,2330,0,6,4,10,6,2,8,0.00,41.72,80.00
09,020,01,020,0005,0000,801,43,844,2014,0,6,4,10,6,2,8,0.00,41.91,80.00
09,020,01,020,0006,0000,533,36,569,1570,0,6,4,10,6,2,8,0.00,36.24,80.00
09,020,01,020,0007,0000,723,29,752,2173,0,6,4,10,6,2,8,0.00,34.61,80.00
09,020,01,020,0001,0076,277,14,291,862,0,6,4,10,6,2,8,0.00,33.76,80.00
09,020,01,020,0001,0077,338,26,364,974,0,6,4,10,6,2,8,0.00,37.37,80.00
09,020,01,020,0001,0078,631,25,656,1495,0,6,4,10,6,2,8,0.00,43.88,80.00
09,020,01,020,0001,0079,594,26,620,1607,0,6,4,10,6,2,8,0.00,38.58,80.00
09,020,01,020,0008,0000,920,29,949,2288,0,6,4,10,6,2,8,0.00,41.48,80.00
09,020,01,020,0005,0080,404,14,418,957,0,6,4,10,6,2,8,0.00,43.68,80.00
09,020,01,020,0005,0081,397,29,426,1057,0,6,4,10,6,2,8,0.00,40.30,80.00
09,020,01,020,0008,0082,533,14,547,1202,0,6,4,10,6,2,8,0.00,45.51,80.00
09,020,01,020,0008,0083,387,15,402,1086,0,6,4,10,6,2,8,0.00,37.02,80.00
09,020,01,020,0006,0084,533,36,569,1570,0,6,4,10,6,2,8,0.00,36.24,80.00
09,020,01,020,0007,0085,410,22,432,1224,0,6,4,10,6,2,8,0.00,35.29,80.00
09,020,01,020,0007,0086,313,7,320,949,0,6,4,10,6,2,8,0.00,33.72,80.00
09,020,01,020,0002,0087,301,12,313,998,0,6,4,10,6,2,8,0.00,31.36,80.00
09,020,01,020,0002,0088,343,19,362,893,0,6,4,10,6,2,8,0.00,40.54,80.00
09,020,01,020,0003,0089,501,34,535,1149,0,6,4,10,6,2,8,0.00,46.56,80.00
09,020,01,020,0004,0090,471,33,504,1252,0,6,4,10,6,2,8,0.00,40.26,80.00
09,020,01,020,0004,0091,445,23,468,1078,0,6,4,10,6,2,8,0.00,43.41,80.00
09,020,01,030,0001,0000,1583,77,1660,3818,0,9,5,14,6,3,9,0.00,43.48,64.29
09,020,01,030,0002,0000,1261,59,1320,3303,0,9,5,14,6,3,9,0.00,39.96,64.29
09,020,01,030,0003,0000,1006,55,1061,2648,0,9,5,14,6,3,9,0.00,40.07,64.29
09,020,01,030,0004,0000,767,23,790,2136,0,9,5,14,6,3,9,0.00,36.99,64.29
09,020,01,030,0005,0000,1301,42,1343,3247,0,9,5,14,6,3,9,0.00,41.36,64.29
09,020,01,030,0001,0058,497,25,522,1187,0,9,5,14,6,3,9,0.00,43.98,64.29
09,020,01,030,0001,0059,541,25,566,1218,0,9,5,14,6,3,9,0.00,46.47,64.29
09,020,01,030,0006,0000,3245,120,3365,7969,0,9,5,14,6,3,9,0.00,42.23,64.29
09,020,01,030,0001,0060,545,27,572,1413,0,9,5,14,6,3,9,0.00,40.48,64.29
09,020,01,030,0002,0061,677,38,715,1899,0,9,5,14,6,3,9,0.00,37.65,64.29
09,020,01,030,0002,0062,584,21,605,1404,0,9,5,14,6,3,9,0.00,43.09,64.29
09,020,01,030,0007,0063,606,24,630,1534,0,9,5,14,6,3,9,0.00,41.07,64.29
09,020,01,030,0008,0064,649,24,673,1710,0,9,5,14,6,3,9,0.00,39.36,64.29
09,020,01,030,0004,0065,339,14,353,1042,0,9,5,14,6,3,9,0.00,33.88,64.29
09,020,01,030,0004,0066,428,9,437,1094,0,9,5,14,6,3,9,0.00,39.95,64.29
09,020,01,030,0006,0067,761,27,788,1837,0,9,5,14,6,3,9,0.00,42.90,64.29
09,020,01,030,0006,0068,566,22,588,1591,0,9,5,14,6,3,9,0.00,36.96,64.29
09,020,01,030,0006,0069,671,23,694,1674,0,9,5,14,6,3,9,0.00,41.46,64.29
09,020,01,030,0007,0000,606,24,630,1534,0,9,5,14,6,3,9,0.00,41.07,64.29
09,020,01,030,0006,0070,616,21,637,1477,0,9,5,14,6,3,9,0.00,43.13,64.29
09,020,01,030,0006,0071,631,27,658,1390,0,9,5,14,6,3,9,0.00,47.34,64.29
09,020,01,030,0003,0072,454,30,484,1256,0,9,5,14,6,3,9,0.00,38.54,64.29
09,020,01,030,0003,0073,552,25,577,1392,0,9,5,14,6,3,9,0.00,41.45,64.29
09,020,01,030,0005,0074,687,18,705,1650,0,9,5,14,6,3,9,0.00,42.73,64.29
09,020,01,030,0005,0075,614,24,638,1597,0,9,5,14,6,3,9,0.00,39.95,64.29
09,020,01,030,0008,0000,649,24,673,1710,0,9,5,14,6,3,9,0.00,39.36,64.29
09,020,01,040,0001,0000,1023,36,1059,3305,0,7,4,11,5,4,9,0.00,32.04,81.82
09,020,01,040,0002,0000,1964,92,2056,5098,0,7,4,11,5,4,9,0.00,40.33,81.82
09,020,01,040,0001,0025,537,17,554,1761,0,7,4,11,5,4,9,0.00,31.46,81.82
09,020,01,040,0001,0026,486,19,505,1544,0,7,4,11,5,4,9,0.00,32.71,81.82
09,020,01,040,0002,0027,432,18,450,1185,0,7,4,11,5,4,9,0.00,37.97,81.82
09,020,01,040,0002,0028,368,16,384,1004,0,7,4,11,5,4,9,0.00,38.25,81.82
09,020,01,040,0002,0029,390,11,401,971,0,7,4,11,5,4,9,0.00,41.30,81.82
09,020,01,040,0003,0000,608,28,636,1649,0,7,4,11,5,4,9,0.00,38.57,81.82
09,020,01,040,0002,0030,417,28,445,1052,0,7,4,11,5,4,9,0.00,42.30,81.82
09,020,01,040,0002,0031,357,19,376,886,0,7,4,11,5,4,9,0.00,42.44,81.82
09,020,01,040,0004,0032,509,31,540,1463,0,7,4,11,5,4,9,0.00,36.91,81.82
09,020,01,040,0004,0033,424,23,447,1114,0,7,4,11,5,4,9,0.00,40.13,81.82
09,020,01,040,0004,0034,518,29,547,1242,0,7,4,11,5,4,9,0.00,44.04,81.82
09,020,01,040,0004,0035,271,42,313,980,0,7,4,11,5,4,9,0.00,31.94,81.82
09,020,01,040,0004,0036,479,20,499,1180,0,7,4,11,5,4,9,0.00,42.29,81.82
09,020,01,040,0004,0037,564,39,603,1349,0,7,4,11,5,4,9,0.00,44.70,81.82
09,020,01,040,0005,0038,408,11,419,971,0,7,4,11,5,4,9,0.00,43.15,81.82
09,020,01,040,0005,0039,332,15,347,942,0,7,4,11,5,4,9,0.00,36.84,81.82
09,020,01,040,0004,0000,2765,184,2949,7328,0,7,4,11,5,4,9,0.00,40.24,81.82
09,020,01,040,0005,0040,565,31,596,1753,0,7,4,11,5,4,9,0.00,34.00,81.82
09,020,01,040,0005,0041,575,24,599,1528,0,7,4,11,5,4,9,0.00,39.20,81.82
09,020,01,040,0006,0042,595,21,616,1572,0,7,4,11,5,4,9,0.00,39.19,81.82
09,020,01,040,0006,0043,383,19,402,1001,0,7,4,11,5,4,9,0.00,40.16,81.82
09,020,01,040,0006,0044,485,22,507,1383,0,7,4,11,5,4,9,0.00,36.66,81.82
09,020,01,040,0006,0045,446,11,457,1225,0,7,4,11,5,4,9,0.00,37.31,81.82
09,020,01,040,0006,0046,392,34,426,1076,0,7,4,11,5,4,9,0.00,39.59,81.82
09,020,01,040,0003,0047,608,28,636,1649,0,7,4,11,5,4,9,0.00,38.57,81.82
09,020,01,040,0005,0000,1880,81,1961,5194,0,7,4,11,5,4,9,0.00,37.76,81.82
09,020,01,040,0006,0000,2301,107,2408,6257,0,7,4,11,5,4,9,0.00,38.48,81.82
09,020,01,050,0001,0000,1029,21,1050,2796,0,9,2,11,6,1,7,0.00,37.55,63.64
09,020,01,050,0002,0000,440,4,444,1404,0,9,2,11,6,1,7,0.00,31.62,63.64
09,020,01,050,0003,0000,719,21,740,2330,0,9,2,11,6,1,7,0.00,31.76,63.64
09,020,01,050,0004,0000,1305,16,1321,3246,0,9,2,11,6,1,7,0.00,40.70,63.64
09,020,01,050,0004,0048,673,12,685,1561,0,9,2,11,6,1,7,0.00,43.88,63.64
09,020,01,050,0004,0049,632,4,636,1685,0,9,2,11,6,1,7,0.00,37.74,63.64
09,020,01,050,0005,0000,664,14,678,1636,0,9,2,11,6,1,7,0.00,41.44,63.64
09,020,01,050,0005,0050,664,14,678,1636,0,9,2,11,6,1,7,0.00,41.44,63.64
09,020,01,050,0003,0051,395,12,407,1255,0,9,2,11,6,1,7,0.00,32.43,63.64
09,020,01,050,0003,0052,324,9,333,1075,0,9,2,11,6,1,7,0.00,30.98,63.64
09,020,01,050,0002,0053,440,4,444,1404,0,9,2,11,6,1,7,0.00,31.62,63.64
09,020,01,050,0001,0054,527,10,537,1390,0,9,2,11,6,1,7,0.00,38.63,63.64
09,020,01,050,0001,0055,502,11,513,1406,0,9,2,11,6,1,7,0.00,36.49,63.64
09,020,01,060,0001,0000,93,2,95,272,0,4,0,4,3,0,3,0.00,34.93,75.00
09,020,01,060,0002,0000,118,1,119,289,0,4,0,4,3,0,3,0.00,41.18,75.00
09,020,01,060,0001,0056,93,2,95,272,0,4,0,4,3,0,3,0.00,34.93,75.00
09,020,01,060,0002,0057,118,1,119,289,0,4,0,4,3,0,3,0.00,41.18,75.00
09,020,00,010,0000,0000,13861,554,14415,36490,42247,11,5,16,7,4,11,86.37,39.50,68.75
09,020,01,010,0000,0000,13861,554,14415,36490,42247,11,5,16,7,4,11,86.37,39.50,68.75
09,020,00,020,0000,0000,6878,349,7227,18353,20642,6,4,10,6,2,8,88.91,39.38,80.00
09,020,01,020,0000,0000,6878,349,7227,18353,20642,6,4,10,6,2,8,88.91,39.38,80.00
09,020,00,030,0000,0000,10418,424,10842,26365,30634,9,5,14,6,3,9,86.06,41.12,64.29
09,020,01,030,0000,0000,10418,424,10842,26365,30634,9,5,14,6,3,9,86.06,41.12,64.29
09,020,00,040,0000,0000,10541,528,11069,28831,34124,7,4,11,5,4,9,84.49,38.39,81.82
09,020,01,040,0000,0000,10541,528,11069,28831,34124,7,4,11,5,4,9,84.49,38.39,81.82
09,020,00,050,0000,0000,4157,76,4233,11412,12619,9,2,11,6,1,7,90.44,37.09,63.64
09,020,01,050,0000,0000,4157,76,4233,11412,12619,9,2,11,6,1,7,90.44,37.09,63.64
09,020,00,060,0000,0000,211,3,214,561,672,4,0,4,3,0,3,83.48,38.15,75.00
09,020,01,060,0000,0000,211,3,214,561,672,4,0,4,3,0,3,83.48,38.15,75.00
10,002,00,000,0000,0000,229612,10261,239873,372517,449012,185,42,227,108,23,131,82.96,64.39,57.71
10,002,00,010,0000,0000,44220,2558,46778,76148,94588,20,8,28,12,4,16,80.50,61.43,57.14
10,002,01,010,0000,0000,11441,504,11945,20198,25539,6,3,9,3,1,4,79.09,59.14,44.44
10,002,02,010,0000,0000,9717,999,10716,17572,21646,4,1,5,3,1,4,81.18,60.98,80.00
10,002,03,010,0000,0000,13867,651,14518,23605,29534,4,4,8,3,2,5,79.92,61.50,62.50
10,002,04,010,0000,0000,9195,404,9599,14773,17869,6,0,6,3,0,3,82.67,64.98,50.00
10,002,01,010,0036,0001,586,32,618,1028,0,6,3,9,3,1,4,0.00,60.12,44.44
10,002,01,010,0036,0002,592,30,622,989,0,6,3,9,3,1,4,0.00,62.89,44.44
10,002,01,010,0037,0003,435,16,451,792,0,6,3,9,3,1,4,0.00,56.94,44.44
10,002,01,010,0037,0004,417,12,429,694,0,6,3,9,3,1,4,0.00,61.82,44.44
10,002,01,010,0044,0005,510,17,527,984,0,6,3,9,3,1,4,0.00,53.56,44.44
10,002,01,010,0044,0006,457,20,477,879,0,6,3,9,3,1,4,0.00,54.27,44.44
10,002,01,010,0035,0007,466,17,483,882,0,6,3,9,3,1,4,0.00,54.76,44.44
10,002,01,010,0035,0008,530,21,551,974,0,6,3,9,3,1,4,0.00,56.57,44.44
10,002,01,010,0035,0009,525,30,555,944,0,6,3,9,3,1,4,0.00,58.79,44.44
10,002,01,010,0038,0010,592,28,620,1040,0,6,3,9,3,1,4,0.00,59.62,44.44
10,002,01,010,0038,0011,554,16,570,987,0,6,3,9,3,1,4,0.00,57.75,44.44
10,002,01,010,0038,0012,612,33,645,1035,0,6,3,9,3,1,4,0.00,62.32,44.44
10,002,01,010,0038,0013,634,18,652,1082,0,6,3,9,3,1,4,0.00,60.26,44.44
10,002,01,010,0043,0014,736,25,761,1289,0,6,3,9,3,1,4,0.00,59.04,44.44
10,002,01,010,0043,0015,712,38,750,1248,0,6,3,9,3,1,4,0.00,60.10,44.44
10,002,01,010,0039,0016,470,21,491,851,0,6,3,9,3,1,4,0.00,57.70,44.44
10,002,01,010,0039,0017,528,15,543,907,0,6,3,9,3,1,4,0.00,59.87,44.44
10,002,01,010,0039,0018,647,35,682,1092,0,6,3,9,3,1,4,0.00,62.45,44.44
10,002,01,010,0040,0019,502,18,520,837,0,6,3,9,3,1,4,0.00,62.13,44.44
10,002,01,010,0040,0020,432,27,459,753,0,6,3,9,3,1,4,0.00,60.96,44.44
10,002,01,010,0040,0021,504,35,539,911,0,6,3,9,3,1,4,0.00,59.17,44.44
10,002,01,010,0035,0000,1521,68,1589,2800,0,6,3,9,3,1,4,0.00,56.75,44.44
10,002,01,010,0036,0000,1178,62,1240,2017,0,6,3,9,3,1,4,0.00,61.48,44.44
10,002,01,010,0037,0000,852,28,880,1486,0,6,3,9,3,1,4,0.00,59.22,44.44
10,002,01,010,0038,0000,2392,95,2487,4144,0,6,3,9,3,1,4,0.00,60.01,44.44
10,002,01,010,0039,0000,1645,71,1716,2850,0,6,3,9,3,1,4,0.00,60.21,44.44
10,002,01,010,0040,0000,1438,80,1518,2501,0,6,3,9,3,1,4,0.00,60.70,44.44
10,002,01,010,0043,0000,1448,63,1511,2537,0,6,3,9,3,1,4,0.00,59.56,44.44
10,002,01,010,0044,0000,967,37,1004,1863,0,6,3,9,3,1,4,0.00,53.89,44.44
10,002,01,020,0004,0000,755,71,826,1486,0,2,1,3,1,1,2,0.00,55.59,66.67
10,002,01,020,0005,0000,1775,116,1891,3392,0,2,1,3,1,1,2,0.00,55.75,66.67
10,002,01,020,0006,0000,1512,113,1625,2626,0,2,1,3,1,1,2,0.00,61.88,66.67
10,002,01,020,0028,0082,385,24,409,620,0,2,1,3,1,1,2,0.00,65.97,66.67
10,002,01,020,0028,0083,341,24,365,652,0,2,1,3,1,1,2,0.00,55.98,66.67
10,002,01,020,0004,0084,755,71,826,1486,0,2,1,3,1,1,2,0.00,55.59,66.67
10,002,01,020,0005,0085,792,53,845,1438,0,2,1,3,1,1,2,0.00,58.76,66.67
10,002,01,020,0005,0086,538,30,568,1052,0,2,1,3,1,1,2,0.00,53.99,66.67
10,002,01,020,0005,0087,445,33,478,902,0,2,1,3,1,1,2,0.00,52.99,66.67
10,002,01,020,0006,0088,865,76,941,1485,0,2,1,3,1,1,2,0.00,63.37,66.67
10,002,01,020,0006,0089,647,37,684,1141,0,2,1,3,1,1,2,0.00,59.95,66.67
10,002,01,020,0028,0000,726,48,774,1272,0,2,1,3,1,1,2,0.00,60.85,66.67
10,002,01,030,0024,0176,264,8,272,312,0,2,0,2,1,0,1,0.00,87.18,50.00
10,002,01,030,0025,0177,446,8,454,673,0,2,0,2,1,0,1,0.00,67.46,50.00
10,002,01,030,0026,0178,217,4,221,347,0,2,0,2,1,0,1,0.00,63.69,50.00
10,002,01,030,0026,0179,117,3,120,205,0,2,0,2,1,0,1,0.00,58.54,50.00
10,002,01,030,0024,0000,264,8,272,312,0,2,0,2,1,0,1,0.00,87.18,50.00
10,002,01,030,0025,0000,446,8,454,673,0,2,0,2,1,0,1,0.00,67.46,50.00
10,002,01,030,0026,0000,334,7,341,552,0,2,0,2,1,0,1,0.00,61.78,50.00
10,002,01,040,0017,0000,673,32,705,906,0,3,5,8,2,2,4,0.00,77.81,50.00
10,002,01,040,0018,0000,1082,44,1126,1676,0,3,5,8,2,2,4,0.00,67.18,50.00
10,002,01,040,0019,0000,559,17,576,679,0,3,5,8,2,2,4,0.00,84.83,50.00
10,002,01,040,0020,0000,900,43,943,1254,0,3,5,8,2,2,4,0.00,75.20,50.00
10,002,01,040,0017,0203,673,32,705,906,0,3,5,8,2,2,4,0.00,77.81,50.00
10,002,01,040,0018,0204,652,24,676,1000,0,3,5,8,2,2,4,0.00,67.60,50.00
10,002,01,040,0018,0205,430,20,450,676,0,3,5,8,2,2,4,0.00,66.57,50.00
10,002,01,040,0019,0206,559,17,576,679,0,3,5,8,2,2,4,0.00,84.83,50.00
10,002,01,040,0020,0207,402,19,421,558,0,3,5,8,2,2,4,0.00,75.45,50.00
10,002,01,040,0020,0208,498,24,522,696,0,3,5,8,2,2,4,0.00,75.00,50.00
10,002,01,040,0021,0209,651,22,673,881,0,3,5,8,2,2,4,0.00,76.39,50.00
10,002,01,040,0021,0000,651,22,673,881,0,3,5,8,2,2,4,0.00,76.39,50.00
10,002,01,040,0022,0210,702,27,729,981,0,3,5,8,2,2,4,0.00,74.31,50.00
10,002,01,040,0023,0211,759,34,793,1058,0,3,5,8,2,2,4,0.00,74.95,50.00
10,002,01,040,0022,0000,702,27,729,981,0,3,5,8,2,2,4,0.00,74.31,50.00
10,002,01,040,0023,0000,759,34,793,1058,0,3,5,8,2,2,4,0.00,74.95,50.00
10,002,01,050,0001,0000,997,47,1044,1512,0,4,2,6,3,1,4,0.00,69.05,66.67
10,002,01,050,0002,0000,1086,32,1118,1885,0,4,2,6,3,1,4,0.00,59.31,66.67
10,002,01,050,0003,0000,2233,79,2312,3848,0,4,2,6,3,1,4,0.00,60.08,66.67
10,002,01,050,0004,0000,1352,70,1422,2425,0,4,2,6,3,1,4,0.00,58.64,66.67
10,002,01,050,0005,0000,468,22,490,590,0,4,2,6,3,1,4,0.00,83.05,66.67
10,002,01,050,0006,0000,864,16,880,1277,0,4,2,6,3,1,4,0.00,68.91,66.67
10,002,01,050,0001,0212,675,27,702,1022,0,4,2,6,3,1,4,0.00,68.69,66.67
10,002,01,050,0001,0213,322,20,342,490,0,4,2,6,3,1,4,0.00,69.80,66.67
10,002,01,050,0002,0214,547,16,563,935,0,4,2,6,3,1,4,0.00,60.21,66.67
10,002,01,050,0002,0215,539,16,555,950,0,4,2,6,3,1,4,0.00,58.42,66.67
10,002,01,050,0003,0216,538,16,554,911,0,4,2,6,3,1,4,0.00,60.81,66.67
10,002,01,050,0003,0217,450,27,477,921,0,4,2,6,3,1,4,0.00,51.79,66.67
10,002,01,050,0003,0218,518,18,536,960,0,4,2,6,3,1,4,0.00,55.83,66.67
10,002,01,050,0003,0219,727,18,745,1056,0,4,2,6,3,1,4,0.00,70.55,66.67
10,002,01,050,0004,0220,409,29,438,779,0,4,2,6,3,1,4,0.00,56.23,66.67
10,002,01,050,0004,0221,452,33,485,842,0,4,2,6,3,1,4,0.00,57.60,66.67
10,002,01,050,0004,0222,491,8,499,804,0,4,2,6,3,1,4,0.00,62.06,66.67
10,002,01,050,0005,0223,468,22,490,590,0,4,2,6,3,1,4,0.00,83.05,66.67
10,002,01,050,0006,0224,398,6,404,551,0,4,2,6,3,1,4,0.00,73.32,66.67
10,002,01,050,0006,0225,466,10,476,726,0,4,2,6,3,1,4,0.00,65.56,66.67
10,002,01,060,0001,0000,1598,59,1657,2580,0,3,3,6,3,1,4,0.00,64.22,66.67
10,002,01,060,0002,0000,1077,58,1135,1886,0,3,3,6,3,1,4,0.00,60.18,66.67
10,002,01,060,0003,0000,578,32,610,895,0,3,3,6,3,1,4,0.00,68.16,66.67
10,002,01,060,0014,0000,760,59,819,1093,0,3,3,6,3,1,4,0.00,74.93,66.67
10,002,01,060,0001,0247,559,27,586,910,0,3,3,6,3,1,4,0.00,64.40,66.67
10,002,01,060,0001,0248,467,14,481,765,0,3,3,6,3,1,4,0.00,62.88,66.67
10,002,01,060,0001,0249,572,18,590,905,0,3,3,6,3,1,4,0.00,65.19,66.67
10,002,01,060,0014,0250,760,59,819,1093,0,3,3,6,3,1,4,0.00,74.93,66.67
10,002,01,060,0002,0251,527,37,564,912,0,3,3,6,3,1,4,0.00,61.84,66.67
10,002,01,060,0002,0252,550,21,571,974,0,3,3,6,3,1,4,0.00,58.62,66.67
10,002,01,060,0003,0253,578,32,610,895,0,3,3,6,3,1,4,0.00,68.16,66.67
10,002,01,070,0001,0000,3345,116,3461,5709,0,5,2,7,3,1,4,0.00,60.62,57.14
10,002,01,070,0002,0000,1377,24,1401,2108,0,5,2,7,3,1,4,0.00,66.46,57.14
10,002,01,070,0003,0000,1128,36,1164,1637,0,5,2,7,3,1,4,0.00,71.11,57.14
10,002,01,070,0001,0271,807,39,846,1401,0,5,2,7,3,1,4,0.00,60.39,57.14
10,002,01,070,0001,0272,506,7,513,866,0,5,2,7,3,1,4,0.00,59.24,57.14
10,002,01,070,0001,0273,770,23,793,1251,0,5,2,7,3,1,4,0.00,63.39,57.14
10,002,01,070,0001,0274,648,19,667,1142,0,5,2,7,3,1,4,0.00,58.41,57.14
10,002,01,070,0001,0275,614,28,642,1049,0,5,2,7,3,1,4,0.00,61.20,57.14
10,002,01,070,0002,0276,670,12,682,982,0,5,2,7,3,1,4,0.00,69.45,57.14
10,002,01,070,0002,0277,707,12,719,1126,0,5,2,7,3,1,4,0.00,63.85,57.14
10,002,01,070,0003,0278,617,14,631,894,0,5,2,7,3,1,4,0.00,70.58,57.14
10,002,01,070,0003,0279,511,22,533,743,0,5,2,7,3,1,4,0.00,71.74,57.14
10,002,01,080,0002,0000,996,41,1037,1549,0,5,0,5,3,0,3,0.00,66.95,60.00
10,002,01,080,0003,0000,714,25,739,1117,0,5,0,5,3,0,3,0.00,66.16,60.00
10,002,01,080,0004,0000,520,22,542,862,0,5,0,5,3,0,3,0.00,62.88,60.00
10,002,01,080,0005,0000,609,27,636,852,0,5,0,5,3,0,3,0.00,74.65,60.00
10,002,01,080,0006,0000,947,25,972,1351,0,5,0,5,3,0,3,0.00,71.95,60.00
10,002,01,080,0007,0000,1746,59,1805,2818,0,5,0,5,3,0,3,0.00,64.05,60.00
10,002,01,080,0008,0000,1830,63,1893,2872,0,5,0,5,3,0,3,0.00,65.91,60.00
10,002,01,080,0010,0000,426,22,448,669,0,5,0,5,3,0,3,0.00,66.97,60.00
10,002,01,080,0002,0304,511,27,538,796,0,5,0,5,3,0,3,0.00,67.59,60.00
10,002,01,080,0002,0305,485,14,499,753,0,5,0,5,3,0,3,0.00,66.27,60.00
10,002,01,080,0003,0306,714,25,739,1117,0,5,0,5,3,0,3,0.00,66.16,60.00
10,002,01,080,0004,0307,520,22,542,862,0,5,0,5,3,0,3,0.00,62.88,60.00
10,002,01,080,0005,0308,609,27,636,852,0,5,0,5,3,0,3,0.00,74.65,60.00
10,002,01,080,0006,0309,947,25,972,1351,0,5,0,5,3,0,3,0.00,71.95,60.00
10,002,01,080,0007,0310,617,23,640,901,0,5,0,5,3,0,3,0.00,71.03,60.00
10,002,01,080,0007,0311,608,20,628,1006,0,5,0,5,3,0,3,0.00,62.43,60.00
10,002,01,080,0007,0312,521,16,537,911,0,5,0,5,3,0,3,0.00,58.95,60.00
10,002,01,080,0008,0313,508,15,523,919,0,5,0,5,3,0,3,0.00,56.91,60.00
10,002,01,080,0008,0314,687,26,713,1028,0,5,0,5,3,0,3,0.00,69.36,60.00
10,002,01,080,0008,0315,635,22,657,925,0,5,0,5,3,0,3,0.00,71.03,60.00
10,002,01,080,0010,0316,426,22,448,669,0,5,0,5,3,0,3,0.00,66.97,60.00
10,002,01,090,0001,0000,1269,40,1309,2026,0,3,1,4,1,1,2,0.00,64.61,50.00
10,002,01,090,0002,0000,1076,44,1120,1866,0,3,1,4,1,1,2,0.00,60.02,50.00
10,002,01,090,0003,0000,1573,64,1637,2581,0,3,1,4,1,1,2,0.00,63.43,50.00
10,002,01,090,0001,0348,671,28,699,1076,0,3,1,4,1,1,2,0.00,64.96,50.00
10,002,01,090,0001,0349,598,12,610,950,0,3,1,4,1,1,2,0.00,64.21,50.00
10,002,01,090,0002,0350,530,23,553,918,0,3,1,4,1,1,2,0.00,60.24,50.00
10,002,01,090,0002,0351,546,21,567,948,0,3,1,4,1,1,2,0.00,59.81,50.00
10,002,01,090,0003,0352,430,21,451,768,0,3,1,4,1,1,2,0.00,58.72,50.00
10,002,01,090,0003,0353,517,22,539,867,0,3,1,4,1,1,2,0.00,62.17,50.00
10,002,01,090,0003,0354,626,21,647,946,0,3,1,4,1,1,2,0.00,68.39,50.00
10,002,01,100,0004,0000,438,19,457,564,0,5,0,5,2,0,2,0.00,81.03,40.00
10,002,01,100,0005,0000,327,17,344,437,0,5,0,5,2,0,2,0.00,78.72,40.00
10,002,01,100,0006,0000,690,16,706,1117,0,5,0,5,2,0,2,0.00,63.21,40.00
10,002,01,100,0007,0000,697,17,714,1098,0,5,0,5,2,0,2,0.00,65.03,40.00
10,002,01,100,0008,0000,579,15,594,817,0,5,0,5,2,0,2,0.00,72.71,40.00
10,002,01,100,0004,0393,438,19,457,564,0,5,0,5,2,0,2,0.00,81.03,40.00
10,002,01,100,0005,0394,327,17,344,437,0,5,0,5,2,0,2,0.00,78.72,40.00
10,002,01,100,0006,0395,690,16,706,1117,0,5,0,5,2,0,2,0.00,63.21,40.00
10,002,01,100,0007,0396,697,17,714,1098,0,5,0,5,2,0,2,0.00,65.03,40.00
10,002,01,100,0008,0397,579,15,594,817,0,5,0,5,2,0,2,0.00,72.71,40.00
10,002,01,110,0001,0000,627,62,689,879,0,1,0,1,1,0,1,0.00,78.38,100.00
10,002,01,110,0001,0410,627,62,689,879,0,1,0,1,1,0,1,0.00,78.38,100.00
10,002,01,120,0001,0000,891,15,906,1153,0,5,1,6,2,1,3,0.00,78.58,50.00
10,002,01,120,0003,0000,393,2,395,444,0,5,1,6,2,1,3,0.00,88.96,50.00
10,002,01,120,0003,0420,393,2,395,444,0,5,1,6,2,1,3,0.00,88.96,50.00
10,002,01,120,0001,0421,891,15,906,1153,0,5,1,6,2,1,3,0.00,78.58,50.00
10,002,00,020,0000,0000,31543,1643,33186,54698,69945,18,5,23,9,4,13,78.20,60.67,56.52
10,002,01,020,0000,0000,4768,348,5116,8776,10992,2,1,3,1,1,2,79.84,58.30,66.67
10,002,02,020,0000,0000,5791,278,6069,9857,12094,2,1,3,1,1,2,81.50,61.57,66.67
10,002,03,020,0000,0000,9930,442,10372,17026,21993,7,2,9,3,1,4,77.42,60.92,44.44
10,002,04,020,0000,0000,11054,575,11629,19039,24866,7,1,8,4,1,5,76.57,61.08,62.50
10,002,02,010,0001,0000,1151,134,1285,2340,0,4,1,5,3,1,4,0.00,54.91,80.00
10,002,02,010,0002,0000,775,76,851,1669,0,4,1,5,3,1,4,0.00,50.99,80.00
10,002,02,010,0002,0022,399,39,438,986,0,4,1,5,3,1,4,0.00,44.42,80.00
10,002,02,010,0002,0023,376,37,413,683,0,4,1,5,3,1,4,0.00,60.47,80.00
10,002,02,010,0001,0024,327,27,354,592,0,4,1,5,3,1,4,0.00,59.80,80.00
10,002,02,010,0001,0025,423,53,476,851,0,4,1,5,3,1,4,0.00,55.93,80.00
10,002,02,010,0001,0026,401,54,455,897,0,4,1,5,3,1,4,0.00,50.72,80.00
10,002,02,010,0045,0027,477,46,523,723,0,4,1,5,3,1,4,0.00,72.34,80.00
10,002,02,010,0018,0028,388,42,430,625,0,4,1,5,3,1,4,0.00,68.80,80.00
10,002,02,010,0018,0029,468,32,500,735,0,4,1,5,3,1,4,0.00,68.03,80.00
10,002,02,010,0008,0030,693,74,767,1113,0,4,1,5,3,1,4,0.00,68.91,80.00
10,002,02,010,0008,0031,498,43,541,921,0,4,1,5,3,1,4,0.00,58.74,80.00
10,002,02,010,0009,0032,795,66,861,1251,0,4,1,5,3,1,4,0.00,68.82,80.00
10,002,02,010,0012,0033,735,54,789,1330,0,4,1,5,3,1,4,0.00,59.32,80.00
10,002,02,010,0011,0034,524,61,585,986,0,4,1,5,3,1,4,0.00,59.33,80.00
10,002,02,010,0011,0035,556,65,621,1115,0,4,1,5,3,1,4,0.00,55.70,80.00
10,002,02,010,0010,0036,655,83,738,1195,0,4,1,5,3,1,4,0.00,61.76,80.00
10,002,02,010,0010,0037,457,70,527,801,0,4,1,5,3,1,4,0.00,65.79,80.00
10,002,02,010,0047,0038,572,52,624,978,0,4,1,5,3,1,4,0.00,63.80,80.00
10,002,02,010,0047,0039,481,48,529,859,0,4,1,5,3,1,4,0.00,61.58,80.00
10,002,02,010,0047,0040,492,53,545,931,0,4,1,5,3,1,4,0.00,58.54,80.00
10,002,02,010,0008,0000,1191,117,1308,2034,0,4,1,5,3,1,4,0.00,64.31,80.00
10,002,02,010,0009,0000,795,66,861,1251,0,4,1,5,3,1,4,0.00,68.82,80.00
10,002,02,010,0010,0000,1112,153,1265,1996,0,4,1,5,3,1,4,0.00,63.38,80.00
10,002,02,010,0011,0000,1080,126,1206,2101,0,4,1,5,3,1,4,0.00,57.40,80.00
10,002,02,010,0012,0000,735,54,789,1330,0,4,1,5,3,1,4,0.00,59.32,80.00
10,002,02,010,0018,0000,856,74,930,1360,0,4,1,5,3,1,4,0.00,68.38,80.00
10,002,02,010,0045,0000,477,46,523,723,0,4,1,5,3,1,4,0.00,72.34,80.00
10,002,02,010,0047,0000,1545,153,1698,2768,0,4,1,5,3,1,4,0.00,61.34,80.00
10,002,02,020,0007,0000,1707,86,1793,2920,0,2,1,3,1,1,2,0.00,61.40,66.67
10,002,02,020,0008,0000,1350,28,1378,2256,0,2,1,3,1,1,2,0.00,61.08,66.67
10,002,02,020,0009,0000,728,29,757,1241,0,2,1,3,1,1,2,0.00,61.00,66.67
10,002,02,020,0007,0090,750,45,795,1261,0,2,1,3,1,1,2,0.00,63.05,66.67
10,002,02,020,0007,0091,460,22,482,801,0,2,1,3,1,1,2,0.00,60.17,66.67
10,002,02,020,0007,0092,497,19,516,858,0,2,1,3,1,1,2,0.00,60.14,66.67
10,002,02,020,0008,0093,810,14,824,1399,0,2,1,3,1,1,2,0.00,58.90,66.67
10,002,02,020,0008,0094,540,14,554,857,0,2,1,3,1,1,2,0.00,64.64,66.67
10,002,02,020,0009,0095,728,29,757,1241,0,2,1,3,1,1,2,0.00,61.00,66.67
10,002,02,020,0010,0096,887,43,930,1430,0,2,1,3,1,1,2,0.00,65.03,66.67
10,002,02,020,0011,0097,597,51,648,1075,0,2,1,3,1,1,2,0.00,60.28,66.67
10,002,02,020,0030,0098,522,41,563,935,0,2,1,3,1,1,2,0.00,60.21,66.67
10,002,02,020,0010,0000,887,43,930,1430,0,2,1,3,1,1,2,0.00,65.03,66.67
10,002,02,020,0011,0000,597,51,648,1075,0,2,1,3,1,1,2,0.00,60.28,66.67
10,002,02,020,0030,0000,522,41,563,935,0,2,1,3,1,1,2,0.00,60.21,66.67
10,002,02,030,0018,0167,588,22,610,856,0,4,0,4,2,0,2,0.00,71.26,50.00
10,002,02,030,0019,0168,520,14,534,825,0,4,0,4,2,0,2,0.00,64.73,50.00
10,002,02,030,0020,0169,254,15,269,459,0,4,0,4,2,0,2,0.00,58.61,50.00
10,002,02,030,0020,0170,313,5,318,532,0,4,0,4,2,0,2,0.00,59.77,50.00
10,002,02,030,0021,0171,431,8,439,673,0,4,0,4,2,0,2,0.00,65.23,50.00
10,002,02,030,0021,0172,370,5,375,646,0,4,0,4,2,0,2,0.00,58.05,50.00
10,002,02,030,0022,0173,596,20,616,957,0,4,0,4,2,0,2,0.00,64.37,50.00
10,002,02,030,0023,0174,381,8,389,587,0,4,0,4,2,0,2,0.00,66.27,50.00
10,002,02,030,0023,0175,344,5,349,502,0,4,0,4,2,0,2,0.00,69.52,50.00
10,002,02,030,0018,0000,588,22,610,856,0,4,0,4,2,0,2,0.00,71.26,50.00
10,002,02,030,0019,0000,520,14,534,825,0,4,0,4,2,0,2,0.00,64.73,50.00
10,002,02,030,0020,0000,567,20,587,991,0,4,0,4,2,0,2,0.00,59.23,50.00
10,002,02,030,0021,0000,801,13,814,1319,0,4,0,4,2,0,2,0.00,61.71,50.00
10,002,02,030,0022,0000,596,20,616,957,0,4,0,4,2,0,2,0.00,64.37,50.00
10,002,02,030,0023,0000,725,13,738,1089,0,4,0,4,2,0,2,0.00,67.77,50.00
10,002,02,040,0012,0000,391,7,398,490,0,3,1,4,2,1,3,0.00,81.22,75.00
10,002,02,040,0013,0000,398,20,418,612,0,3,1,4,2,1,3,0.00,68.30,75.00
10,002,02,040,0014,0000,1227,41,1268,2001,0,3,1,4,2,1,3,0.00,63.37,75.00
10,002,02,040,0015,0000,1198,51,1249,1971,0,3,1,4,2,1,3,0.00,63.37,75.00
10,002,02,040,0016,0000,1351,59,1410,2064,0,3,1,4,2,1,3,0.00,68.31,75.00
10,002,02,040,0012,0195,391,7,398,490,0,3,1,4,2,1,3,0.00,81.22,75.00
10,002,02,040,0013,0196,398,20,418,612,0,3,1,4,2,1,3,0.00,68.30,75.00
10,002,02,040,0014,0197,632,20,652,1005,0,3,1,4,2,1,3,0.00,64.88,75.00
10,002,02,040,0014,0198,595,21,616,996,0,3,1,4,2,1,3,0.00,61.85,75.00
10,002,02,040,0015,0199,525,19,544,836,0,3,1,4,2,1,3,0.00,65.07,75.00
10,002,02,040,0015,0200,673,32,705,1135,0,3,1,4,2,1,3,0.00,62.11,75.00
10,002,02,040,0016,0201,604,17,621,892,0,3,1,4,2,1,3,0.00,69.62,75.00
10,002,02,040,0016,0202,747,42,789,1172,0,3,1,4,2,1,3,0.00,67.32,75.00
10,002,02,050,0007,0000,785,62,847,1154,0,3,0,3,2,0,2,0.00,73.40,66.67
10,002,02,050,0008,0000,853,41,894,1389,0,3,0,3,2,0,2,0.00,64.36,66.67
10,002,02,050,0009,0000,1188,101,1289,2031,0,3,0,3,2,0,2,0.00,63.47,66.67
10,002,02,050,0007,0226,785,62,847,1154,0,3,0,3,2,0,2,0.00,73.40,66.67
10,002,02,050,0008,0227,510,23,533,832,0,3,0,3,2,0,2,0.00,64.06,66.67
10,002,02,050,0008,0228,343,18,361,557,0,3,0,3,2,0,2,0.00,64.81,66.67
10,002,02,050,0009,0229,539,35,574,886,0,3,0,3,2,0,2,0.00,64.79,66.67
10,002,02,050,0009,0230,649,66,715,1145,0,3,0,3,2,0,2,0.00,62.45,66.67
10,002,02,060,0004,0000,696,10,706,915,0,4,0,4,2,0,2,0.00,77.16,50.00
10,002,02,060,0005,0000,1145,23,1168,1566,0,4,0,4,2,0,2,0.00,74.58,50.00
10,002,02,060,0006,0000,982,28,1010,1433,0,4,0,4,2,0,2,0.00,70.48,50.00
10,002,02,060,0007,0000,619,14,633,771,0,4,0,4,2,0,2,0.00,82.10,50.00
10,002,02,060,0004,0254,696,10,706,915,0,4,0,4,2,0,2,0.00,77.16,50.00
10,002,02,060,0005,0255,560,11,571,773,0,4,0,4,2,0,2,0.00,73.87,50.00
10,002,02,060,0005,0256,585,12,597,793,0,4,0,4,2,0,2,0.00,75.28,50.00
10,002,02,060,0006,0257,483,12,495,703,0,4,0,4,2,0,2,0.00,70.41,50.00
10,002,02,060,0006,0258,499,16,515,730,0,4,0,4,2,0,2,0.00,70.55,50.00
10,002,02,060,0007,0259,619,14,633,771,0,4,0,4,2,0,2,0.00,82.10,50.00
10,002,02,070,0004,0000,1019,17,1036,1443,0,4,0,4,3,0,3,0.00,71.79,75.00
10,002,02,070,0005,0000,1079,55,1134,1873,0,4,0,4,3,0,3,0.00,60.54,75.00
10,002,02,070,0006,0000,731,32,763,1227,0,4,0,4,3,0,3,0.00,62.18,75.00
10,002,02,070,0007,0000,885,44,929,1398,0,4,0,4,3,0,3,0.00,66.45,75.00
10,002,02,070,0008,0000,325,13,338,563,0,4,0,4,3,0,3,0.00,60.04,75.00
10,002,02,070,0004,0280,492,9,501,721,0,4,0,4,3,0,3,0.00,69.49,75.00
10,002,02,070,0004,0281,527,8,535,722,0,4,0,4,3,0,3,0.00,74.10,75.00
10,002,02,070,0005,0282,574,22,596,988,0,4,0,4,3,0,3,0.00,60.32,75.00
10,002,02,070,0005,0283,505,33,538,885,0,4,0,4,3,0,3,0.00,60.79,75.00
10,002,02,070,0006,0284,731,32,763,1227,0,4,0,4,3,0,3,0.00,62.18,75.00
10,002,02,070,0007,0285,364,13,377,566,0,4,0,4,3,0,3,0.00,66.61,75.00
10,002,02,070,0007,0286,521,31,552,832,0,4,0,4,3,0,3,0.00,66.35,75.00
10,002,02,070,0008,0287,224,7,231,360,0,4,0,4,3,0,3,0.00,64.17,75.00
10,002,02,070,0008,0288,101,6,107,203,0,4,0,4,3,0,3,0.00,52.71,75.00
10,002,02,080,0009,0000,435,24,459,667,0,5,0,5,3,0,3,0.00,68.82,60.00
10,002,02,080,0011,0000,941,52,993,1468,0,5,0,5,3,0,3,0.00,67.64,60.00
10,002,02,080,0012,0000,472,39,511,813,0,5,0,5,3,0,3,0.00,62.85,60.00
10,002,02,080,0013,0000,771,33,804,1444,0,5,0,5,3,0,3,0.00,55.68,60.00
10,002,02,080,0014,0000,278,9,287,433,0,5,0,5,3,0,3,0.00,66.28,60.00
10,002,02,080,0015,0000,2593,138,2731,4804,0,5,0,5,3,0,3,0.00,56.85,60.00
10,002,02,080,0016,0000,1680,117,1797,3077,0,5,0,5,3,0,3,0.00,58.40,60.00
10,002,02,080,0009,0317,435,24,459,667,0,5,0,5,3,0,3,0.00,68.82,60.00
10,002,02,080,0011,0318,941,52,993,1468,0,5,0,5,3,0,3,0.00,67.64,60.00
10,002,02,080,0012,0319,472,39,511,813,0,5,0,5,3,0,3,0.00,62.85,60.00
10,002,02,080,0013,0320,362,24,386,712,0,5,0,5,3,0,3,0.00,54.21,60.00
10,002,02,080,0013,0321,409,9,418,732,0,5,0,5,3,0,3,0.00,57.10,60.00
10,002,02,080,0014,0322,278,9,287,433,0,5,0,5,3,0,3,0.00,66.28,60.00
10,002,02,080,0015,0323,667,38,705,1177,0,5,0,5,3,0,3,0.00,59.90,60.00
10,002,02,080,0015,0324,642,32,674,1188,0,5,0,5,3,0,3,0.00,56.73,60.00
10,002,02,080,0015,0325,717,35,752,1314,0,5,0,5,3,0,3,0.00,57.23,60.00
10,002,02,080,0015,0326,567,33,600,1125,0,5,0,5,3,0,3,0.00,53.33,60.00
10,002,02,080,0016,0327,641,47,688,1252,0,5,0,5,3,0,3,0.00,54.95,60.00
10,002,02,080,0016,0328,527,44,571,901,0,5,0,5,3,0,3,0.00,63.37,60.00
10,002,02,080,0016,0329,512,26,538,924,0,5,0,5,3,0,3,0.00,58.23,60.00
10,002,02,090,0004,0000,935,28,963,1529,0,6,1,7,2,0,2,0.00,62.98,28.57
10,002,02,090,0005,0000,764,20,784,1340,0,6,1,7,2,0,2,0.00,58.51,28.57
10,002,02,090,0006,0000,1430,78,1508,2478,0,6,1,7,2,0,2,0.00,60.86,28.57
10,002,02,090,0004,0355,482,11,493,740,0,6,1,7,2,0,2,0.00,66.62,28.57
10,002,02,090,0004,0356,453,17,470,789,0,6,1,7,2,0,2,0.00,59.57,28.57
10,002,02,090,0005,0357,432,6,438,723,0,6,1,7,2,0,2,0.00,60.58,28.57
10,002,02,090,0005,0358,332,14,346,617,0,6,1,7,2,0,2,0.00,56.08,28.57
10,002,02,090,0006,0359,296,24,320,576,0,6,1,7,2,0,2,0.00,55.56,28.57
10,002,02,090,0006,0360,542,29,571,914,0,6,1,7,2,0,2,0.00,62.47,28.57
10,002,02,090,0006,0361,592,25,617,988,0,6,1,7,2,0,2,0.00,62.45,28.57
10,002,02,100,0001,0000,173,5,178,216,0,4,0,4,2,0,2,0.00,82.41,50.00
10,002,02,100,0002,0000,311,11,322,446,0,4,0,4,2,0,2,0.00,72.20,50.00
10,002,02,100,0003,0000,572,7,579,731,0,4,0,4,2,0,2,0.00,79.21,50.00
10,002,02,100,0012,0000,364,10,374,566,0,4,0,4,2,0,2,0.00,66.08,50.00
10,002,02,100,0013,0000,351,13,364,508,0,4,0,4,2,0,2,0.00,71.65,50.00
10,002,02,100,0014,0000,531,22,553,719,0,4,0,4,2,0,2,0.00,76.91,50.00
10,002,02,100,0001,0387,173,5,178,216,0,4,0,4,2,0,2,0.00,82.41,50.00
10,002,02,100,0002,0388,311,11,322,446,0,4,0,4,2,0,2,0.00,72.20,50.00
10,002,02,100,0003,0389,572,7,579,731,0,4,0,4,2,0,2,0.00,79.21,50.00
10,002,02,100,0012,0390,364,10,374,566,0,4,0,4,2,0,2,0.00,66.08,50.00
10,002,02,100,0013,0391,351,13,364,508,0,4,0,4,2,0,2,0.00,71.65,50.00
10,002,02,100,0014,0392,531,22,553,719,0,4,0,4,2,0,2,0.00,76.91,50.00
10,002,02,110,0002,0000,516,9,525,628,0,3,0,3,2,0,2,0.00,83.60,66.67
10,002,02,110,0003,0000,568,11,579,700,0,3,0,3,2,0,2,0.00,82.71,66.67
10,002,02,110,0004,0000,227,4,231,270,0,3,0,3,2,0,2,0.00,85.56,66.67
10,002,02,110,0002,0411,516,9,525,628,0,3,0,3,2,0,2,0.00,83.60,66.67
10,002,02,110,0003,0412,568,11,579,700,0,3,0,3,2,0,2,0.00,82.71,66.67
10,002,02,110,0004,0413,227,4,231,270,0,3,0,3,2,0,2,0.00,85.56,66.67
10,002,02,120,0002,0000,697,14,711,933,0,4,0,4,2,0,2,0.00,76.21,50.00
10,002,02,120,0004,0000,295,9,304,385,0,4,0,4,2,0,2,0.00,78.96,50.00
10,002,02,120,0002,0422,697,14,711,933,0,4,0,4,2,0,2,0.00,76.21,50.00
10,002,02,120,0004,0423,295,9,304,385,0,4,0,4,2,0,2,0.00,78.96,50.00
10,002,00,030,0000,0000,21039,585,21624,32491,37943,15,4,19,8,3,11,85.63,66.55,57.89
10,002,01,030,0000,0000,1044,23,1067,1537,1725,2,0,2,1,0,1,89.10,69.42,50.00
10,002,02,030,0000,0000,3797,102,3899,6037,6643,4,0,4,2,0,2,90.88,64.59,50.00
10,002,03,030,0000,0000,6661,221,6882,10586,12218,5,1,6,2,1,3,86.64,65.01,50.00
10,002,04,030,0000,0000,9537,239,9776,14331,17357,4,3,7,3,2,5,82.57,68.22,71.43
10,002,03,010,0015,0041,638,24,662,1038,0,4,4,8,3,2,5,0.00,63.78,62.50
10,002,03,010,0015,0042,582,31,613,1089,0,4,4,8,3,2,5,0.00,56.29,62.50
10,002,03,010,0015,0043,616,25,641,1041,0,4,4,8,3,2,5,0.00,61.58,62.50
10,002,03,010,0041,0044,467,16,483,761,0,4,4,8,3,2,5,0.00,63.47,62.50
10,002,03,010,0041,0045,662,29,691,1094,0,4,4,8,3,2,5,0.00,63.16,62.50
10,002,03,010,0041,0046,572,20,592,1057,0,4,4,8,3,2,5,0.00,56.01,62.50
10,002,03,010,0014,0047,626,27,653,1021,0,4,4,8,3,2,5,0.00,63.96,62.50
10,002,03,010,0014,0048,656,42,698,1086,0,4,4,8,3,2,5,0.00,64.27,62.50
10,002,03,010,0042,0049,623,26,649,1081,0,4,4,8,3,2,5,0.00,60.04,62.50
10,002,03,010,0042,0050,472,34,506,921,0,4,4,8,3,2,5,0.00,54.94,62.50
10,002,03,010,0042,0051,538,21,559,958,0,4,4,8,3,2,5,0.00,58.35,62.50
10,002,03,010,0013,0052,564,22,586,916,0,4,4,8,3,2,5,0.00,63.97,62.50
10,002,03,010,0013,0053,584,23,607,920,0,4,4,8,3,2,5,0.00,65.98,62.50
10,002,03,010,0016,0054,496,32,528,734,0,4,4,8,3,2,5,0.00,71.93,62.50
10,002,03,010,0016,0055,413,22,435,659,0,4,4,8,3,2,5,0.00,66.01,62.50
10,002,03,010,0023,0056,702,27,729,1081,0,4,4,8,3,2,5,0.00,67.44,62.50
10,002,03,010,0019,0057,526,33,559,903,0,4,4,8,3,2,5,0.00,61.90,62.50
10,002,03,010,0021,0058,475,16,491,759,0,4,4,8,3,2,5,0.00,64.69,62.50
10,002,03,010,0021,0059,465,23,488,748,0,4,4,8,3,2,5,0.00,65.24,62.50
10,002,03,010,0022,0060,768,33,801,1283,0,4,4,8,3,2,5,0.00,62.43,62.50
10,002,03,010,0017,0061,448,23,471,879,0,4,4,8,3,2,5,0.00,53.58,62.50
10,002,03,010,0017,0062,462,27,489,853,0,4,4,8,3,2,5,0.00,57.33,62.50
10,002,03,010,0046,0063,649,33,682,1175,0,4,4,8,3,2,5,0.00,58.04,62.50
10,002,03,010,0046,0064,428,18,446,763,0,4,4,8,3,2,5,0.00,58.45,62.50
10,002,03,010,0046,0065,435,24,459,785,0,4,4,8,3,2,5,0.00,58.47,62.50
10,002,03,010,0013,0000,1148,45,1193,1836,0,4,4,8,3,2,5,0.00,64.98,62.50
10,002,03,010,0014,0000,1282,69,1351,2107,0,4,4,8,3,2,5,0.00,64.12,62.50
10,002,03,010,0015,0000,1836,80,1916,3168,0,4,4,8,3,2,5,0.00,60.48,62.50
10,002,03,010,0016,0000,909,54,963,1393,0,4,4,8,3,2,5,0.00,69.13,62.50
10,002,03,010,0017,0000,910,50,960,1732,0,4,4,8,3,2,5,0.00,55.43,62.50
10,002,03,010,0019,0000,526,33,559,903,0,4,4,8,3,2,5,0.00,61.90,62.50
10,002,03,010,0021,0000,940,39,979,1507,0,4,4,8,3,2,5,0.00,64.96,62.50
10,002,03,010,0022,0000,768,33,801,1283,0,4,4,8,3,2,5,0.00,62.43,62.50
10,002,03,010,0023,0000,702,27,729,1081,0,4,4,8,3,2,5,0.00,67.44,62.50
10,002,03,010,0041,0000,1701,65,1766,2912,0,4,4,8,3,2,5,0.00,60.65,62.50
10,002,03,010,0042,0000,1633,81,1714,2960,0,4,4,8,3,2,5,0.00,57.91,62.50
10,002,03,010,0046,0000,1512,75,1587,2723,0,4,4,8,3,2,5,0.00,58.28,62.50
10,002,03,020,0029,0099,792,54,846,1287,0,7,2,9,3,1,4,0.00,65.73,44.44
10,002,03,020,0016,0100,592,25,617,992,0,7,2,9,3,1,4,0.00,62.20,44.44
10,002,03,020,0016,0101,751,30,781,1250,0,7,2,9,3,1,4,0.00,62.48,44.44
10,002,03,020,0016,0102,664,34,698,1206,0,7,2,9,3,1,4,0.00,57.88,44.44
10,002,03,020,0027,0103,622,22,644,1013,0,7,2,9,3,1,4,0.00,63.57,44.44
10,002,03,020,0027,0104,540,19,559,907,0,7,2,9,3,1,4,0.00,61.63,44.44
10,002,03,020,0027,0105,568,26,594,933,0,7,2,9,3,1,4,0.00,63.67,44.44
10,002,03,020,0017,0106,784,36,820,1366,0,7,2,9,3,1,4,0.00,60.03,44.44
10,002,03,020,0017,0107,797,30,827,1350,0,7,2,9,3,1,4,0.00,61.26,44.44
10,002,03,020,0018,0108,582,32,614,996,0,7,2,9,3,1,4,0.00,61.65,44.44
10,002,03,020,0018,0109,466,26,492,826,0,7,2,9,3,1,4,0.00,59.56,44.44
10,002,03,020,0018,0110,379,28,407,780,0,7,2,9,3,1,4,0.00,52.18,44.44
10,002,03,020,0026,0111,567,22,589,1053,0,7,2,9,3,1,4,0.00,55.94,44.44
10,002,03,020,0026,0112,663,24,687,1097,0,7,2,9,3,1,4,0.00,62.63,44.44
10,002,03,020,0026,0113,621,19,640,1048,0,7,2,9,3,1,4,0.00,61.07,44.44
10,002,03,020,0026,0114,542,15,557,922,0,7,2,9,3,1,4,0.00,60.41,44.44
10,002,03,020,0016,0000,2007,89,2096,3448,0,7,2,9,3,1,4,0.00,60.79,44.44
10,002,03,020,0017,0000,1581,66,1647,2716,0,7,2,9,3,1,4,0.00,60.64,44.44
10,002,03,020,0018,0000,1427,86,1513,2602,0,7,2,9,3,1,4,0.00,58.15,44.44
10,002,03,020,0026,0000,2393,80,2473,4120,0,7,2,9,3,1,4,0.00,60.02,44.44
10,002,03,020,0027,0000,1730,67,1797,2853,0,7,2,9,3,1,4,0.00,62.99,44.44
10,002,03,020,0029,0000,792,54,846,1287,0,7,2,9,3,1,4,0.00,65.73,44.44
10,002,03,030,0009,0000,1372,37,1409,2152,0,5,1,6,2,1,3,0.00,65.47,50.00
10,002,03,030,0010,0000,1289,42,1331,2176,0,5,1,6,2,1,3,0.00,61.17,50.00
10,002,03,030,0011,0000,640,23,663,941,0,5,1,6,2,1,3,0.00,70.46,50.00
10,002,03,030,0012,0000,274,13,287,414,0,5,1,6,2,1,3,0.00,69.32,50.00
10,002,03,030,0013,0000,312,10,322,464,0,5,1,6,2,1,3,0.00,69.40,50.00
10,002,03,030,0014,0000,367,13,380,487,0,5,1,6,2,1,3,0.00,78.03,50.00
10,002,03,030,0015,0000,272,6,278,406,0,5,1,6,2,1,3,0.00,68.47,50.00
10,002,03,030,0027,0151,442,5,447,728,0,5,1,6,2,1,3,0.00,61.40,50.00
10,002,03,030,0027,0152,472,16,488,805,0,5,1,6,2,1,3,0.00,60.62,50.00
10,002,03,030,0027,0153,612,24,636,1052,0,5,1,6,2,1,3,0.00,60.46,50.00
10,002,03,030,0009,0154,334,9,343,518,0,5,1,6,2,1,3,0.00,66.22,50.00
10,002,03,030,0009,0155,514,16,530,835,0,5,1,6,2,1,3,0.00,63.47,50.00
10,002,03,030,0009,0156,524,12,536,799,0,5,1,6,2,1,3,0.00,67.08,50.00
10,002,03,030,0010,0157,481,21,502,812,0,5,1,6,2,1,3,0.00,61.82,50.00
10,002,03,030,0010,0158,333,8,341,599,0,5,1,6,2,1,3,0.00,56.93,50.00
10,002,03,030,0010,0159,475,13,488,765,0,5,1,6,2,1,3,0.00,63.79,50.00
10,002,03,030,0016,0000,302,20,322,536,0,5,1,6,2,1,3,0.00,60.07,50.00
10,002,03,030,0011,0160,640,23,663,941,0,5,1,6,2,1,3,0.00,70.46,50.00
10,002,03,030,0012,0161,274,13,287,414,0,5,1,6,2,1,3,0.00,69.32,50.00
10,002,03,030,0013,0162,312,10,322,464,0,5,1,6,2,1,3,0.00,69.40,50.00
10,002,03,030,0014,0163,367,13,380,487,0,5,1,6,2,1,3,0.00,78.03,50.00
10,002,03,030,0015,0164,272,6,278,406,0,5,1,6,2,1,3,0.00,68.47,50.00
10,002,03,030,0016,0165,302,20,322,536,0,5,1,6,2,1,3,0.00,60.07,50.00
10,002,03,030,0017,0166,307,12,319,425,0,5,1,6,2,1,3,0.00,75.06,50.00
10,002,03,030,0017,0000,307,12,319,425,0,5,1,6,2,1,3,0.00,75.06,50.00
10,002,03,030,0027,0000,1526,45,1571,2585,0,5,1,6,2,1,3,0.00,60.77,50.00
10,002,03,040,0007,0000,469,8,477,671,0,4,0,4,2,0,2,0.00,71.09,50.00
10,002,03,040,0008,0000,1019,53,1072,1554,0,4,0,4,2,0,2,0.00,68.98,50.00
10,002,03,040,0009,0000,943,21,964,1287,0,4,0,4,2,0,2,0.00,74.90,50.00
10,002,03,040,0010,0000,525,22,547,670,0,4,0,4,2,0,2,0.00,81.64,50.00
10,002,03,040,0011,0000,359,16,375,460,0,4,0,4,2,0,2,0.00,81.52,50.00
10,002,03,040,0007,0188,469,8,477,671,0,4,0,4,2,0,2,0.00,71.09,50.00
10,002,03,040,0008,0189,539,31,570,838,0,4,0,4,2,0,2,0.00,68.02,50.00
10,002,03,040,0008,0190,480,22,502,716,0,4,0,4,2,0,2,0.00,70.11,50.00
10,002,03,040,0009,0191,561,12,573,756,0,4,0,4,2,0,2,0.00,75.79,50.00
10,002,03,040,0009,0192,382,9,391,531,0,4,0,4,2,0,2,0.00,73.63,50.00
10,002,03,040,0010,0193,525,22,547,670,0,4,0,4,2,0,2,0.00,81.64,50.00
10,002,03,040,0011,0194,359,16,375,460,0,4,0,4,2,0,2,0.00,81.52,50.00
10,002,03,050,0010,0000,1442,74,1516,2305,0,3,0,3,2,0,2,0.00,65.77,66.67
10,002,03,050,0011,0000,708,33,741,1071,0,3,0,3,2,0,2,0.00,69.19,66.67
10,002,03,050,0012,0000,480,26,506,801,0,3,0,3,2,0,2,0.00,63.17,66.67
10,002,03,050,0013,0000,796,36,832,1044,0,3,0,3,2,0,2,0.00,79.69,66.67
10,002,03,050,0010,0231,527,29,556,802,0,3,0,3,2,0,2,0.00,69.33,66.67
10,002,03,050,0010,0232,407,13,420,605,0,3,0,3,2,0,2,0.00,69.42,66.67
10,002,03,050,0010,0233,508,32,540,898,0,3,0,3,2,0,2,0.00,60.13,66.67
10,002,03,050,0011,0234,708,33,741,1071,0,3,0,3,2,0,2,0.00,69.19,66.67
10,002,03,050,0012,0235,480,26,506,801,0,3,0,3,2,0,2,0.00,63.17,66.67
10,002,03,050,0013,0236,796,36,832,1044,0,3,0,3,2,0,2,0.00,79.69,66.67
10,002,03,060,0008,0000,1220,128,1348,2330,0,2,0,2,2,0,2,0.00,57.85,100.00
10,002,03,060,0009,0000,732,80,812,1527,0,2,0,2,2,0,2,0.00,53.18,100.00
10,002,03,060,0008,0260,434,51,485,883,0,2,0,2,2,0,2,0.00,54.93,100.00
10,002,03,060,0008,0261,390,34,424,713,0,2,0,2,2,0,2,0.00,59.47,100.00
10,002,03,060,0008,0262,396,43,439,734,0,2,0,2,2,0,2,0.00,59.81,100.00
10,002,03,060,0009,0263,343,38,381,713,0,2,0,2,2,0,2,0.00,53.44,100.00
10,002,03,060,0009,0264,389,42,431,814,0,2,0,2,2,0,2,0.00,52.95,100.00
10,002,03,070,0009,0000,867,108,975,1742,0,3,0,3,3,0,3,0.00,55.97,100.00
10,002,03,070,0010,0000,752,78,830,1246,0,3,0,3,3,0,3,0.00,66.61,100.00
10,002,03,070,0011,0000,1309,94,1403,2174,0,3,0,3,3,0,3,0.00,64.54,100.00
10,002,03,070,0012,0000,1109,104,1213,2295,0,3,0,3,3,0,3,0.00,52.85,100.00
10,002,03,070,0009,0289,434,47,481,874,0,3,0,3,3,0,3,0.00,55.03,100.00
10,002,03,070,0009,0290,433,61,494,868,0,3,0,3,3,0,3,0.00,56.91,100.00
10,002,03,070,0010,0291,364,46,410,583,0,3,0,3,3,0,3,0.00,70.33,100.00
10,002,03,070,0010,0292,388,32,420,663,0,3,0,3,3,0,3,0.00,63.35,100.00
10,002,03,070,0011,0293,449,31,480,738,0,3,0,3,3,0,3,0.00,65.04,100.00
10,002,03,070,0011,0294,571,37,608,895,0,3,0,3,3,0,3,0.00,67.93,100.00
10,002,03,070,0011,0295,289,26,315,541,0,3,0,3,3,0,3,0.00,58.23,100.00
10,002,03,070,0012,0296,434,36,470,823,0,3,0,3,3,0,3,0.00,57.11,100.00
10,002,03,070,0012,0297,327,34,361,705,0,3,0,3,3,0,3,0.00,51.21,100.00
10,002,03,070,0012,0298,348,34,382,767,0,3,0,3,3,0,3,0.00,49.80,100.00
10,002,03,080,0001,0000,807,63,870,1276,0,3,0,3,2,0,2,0.00,68.18,66.67
10,002,03,080,0017,0000,2400,158,2558,4398,0,3,0,3,2,0,2,0.00,58.16,66.67
10,002,03,080,0018,0000,2177,107,2284,3675,0,3,0,3,2,0,2,0.00,62.15,66.67
10,002,03,080,0001,0330,807,63,870,1276,0,3,0,3,2,0,2,0.00,68.18,66.67
10,002,03,080,0017,0331,755,64,819,1445,0,3,0,3,2,0,2,0.00,56.68,66.67
10,002,03,080,0017,0332,532,28,560,885,0,3,0,3,2,0,2,0.00,63.28,66.67
10,002,03,080,0017,0333,564,33,597,1022,0,3,0,3,2,0,2,0.00,58.41,66.67
10,002,03,080,0017,0334,549,33,582,1046,0,3,0,3,2,0,2,0.00,55.64,66.67
10,002,03,080,0018,0335,737,33,770,1298,0,3,0,3,2,0,2,0.00,59.32,66.67
10,002,03,080,0018,0336,753,47,800,1208,0,3,0,3,2,0,2,0.00,66.23,66.67
10,002,03,080,0018,0337,687,27,714,1169,0,3,0,3,2,0,2,0.00,61.08,66.67
10,002,03,090,0007,0000,1039,36,1075,1751,0,4,0,4,3,0,3,0.00,61.39,75.00
10,002,03,090,0008,0000,2039,67,2106,3603,0,4,0,4,3,0,3,0.00,58.45,75.00
10,002,03,090,0010,0000,1754,73,1827,3165,0,4,0,4,3,0,3,0.00,57.73,75.00
10,002,03,090,0007,0362,580,25,605,941,0,4,0,4,3,0,3,0.00,64.29,75.00
10,002,03,090,0007,0363,459,11,470,810,0,4,0,4,3,0,3,0.00,58.02,75.00
10,002,03,090,0008,0364,472,17,489,905,0,4,0,4,3,0,3,0.00,54.03,75.00
10,002,03,090,0008,0365,611,14,625,922,0,4,0,4,3,0,3,0.00,67.79,75.00
10,002,03,090,0008,0366,492,13,505,920,0,4,0,4,3,0,3,0.00,54.89,75.00
10,002,03,090,0008,0367,464,23,487,856,0,4,0,4,3,0,3,0.00,56.89,75.00
10,002,03,090,0010,0368,637,16,653,1089,0,4,0,4,3,0,3,0.00,59.96,75.00
10,002,03,090,0010,0369,537,20,557,904,0,4,0,4,3,0,3,0.00,61.62,75.00
10,002,03,090,0010,0370,580,37,617,1172,0,4,0,4,3,0,3,0.00,52.65,75.00
10,002,03,100,0009,0000,715,17,732,1314,0,4,2,6,3,1,4,0.00,55.71,66.67
10,002,03,100,0010,0000,2667,53,2720,4218,0,4,2,6,3,1,4,0.00,64.49,66.67
10,002,03,100,0011,0000,591,16,607,885,0,4,2,6,3,1,4,0.00,68.59,66.67
10,002,03,100,0009,0398,715,17,732,1314,0,4,2,6,3,1,4,0.00,55.71,66.67
10,002,03,100,0011,0399,591,16,607,885,0,4,2,6,3,1,4,0.00,68.59,66.67
10,002,03,100,0010,0400,564,16,580,940,0,4,2,6,3,1,4,0.00,61.70,66.67
10,002,03,100,0010,0401,629,13,642,1044,0,4,2,6,3,1,4,0.00,61.49,66.67
10,002,03,100,0010,0402,694,7,701,1051,0,4,2,6,3,1,4,0.00,66.70,66.67
10,002,03,100,0010,0403,780,17,797,1183,0,4,2,6,3,1,4,0.00,67.37,66.67
10,002,03,110,0005,0000,240,1,241,304,0,3,0,3,1,0,1,0.00,79.28,33.33
10,002,03,110,0006,0000,309,8,317,384,0,3,0,3,1,0,1,0.00,82.55,33.33
10,002,03,110,0007,0000,28,1,29,41,0,3,0,3,1,0,1,0.00,70.73,33.33
10,002,03,110,0005,0414,240,1,241,304,0,3,0,3,1,0,1,0.00,79.28,33.33
10,002,03,110,0006,0415,309,8,317,384,0,3,0,3,1,0,1,0.00,82.55,33.33
10,002,03,110,0007,0416,28,1,29,41,0,3,0,3,1,0,1,0.00,70.73,33.33
10,002,03,120,0005,0000,308,1,309,426,0,2,0,2,1,0,1,0.00,72.54,50.00
10,002,03,120,0006,0000,392,12,404,477,0,2,0,2,1,0,1,0.00,84.70,50.00
10,002,03,120,0005,0424,308,1,309,426,0,2,0,2,1,0,1,0.00,72.54,50.00
10,002,03,120,0006,0425,392,12,404,477,0,2,0,2,1,0,1,0.00,84.70,50.00
10,002,00,040,0000,0000,16778,623,17401,24162,28475,14,7,21,8,3,11,84.85,72.02,52.38
10,002,01,040,0000,0000,5326,219,5545,7435,8723,3,5,8,2,2,4,85.23,74.58,50.00
10,002,02,040,0000,0000,4565,178,4743,7138,8571,3,1,4,2,1,3,83.28,66.45,75.00
10,002,03,040,0000,0000,3315,120,3435,4642,5504,4,0,4,2,0,2,84.34,74.00,50.00
10,002,04,040,0000,0000,3572,106,3678,4947,5677,4,1,5,2,0,2,87.14,74.35,40.00
10,002,04,010,0024,0066,528,26,554,863,0,6,0,6,3,0,3,0.00,64.19,50.00
10,002,04,010,0024,0067,510,21,531,785,0,6,0,6,3,0,3,0.00,67.64,50.00
10,002,04,010,0024,0068,661,30,691,1078,0,6,0,6,3,0,3,0.00,64.10,50.00
10,002,04,010,0025,0069,633,28,661,1080,0,6,0,6,3,0,3,0.00,61.20,50.00
10,002,04,010,0025,0070,581,25,606,940,0,6,0,6,3,0,3,0.00,64.47,50.00
10,002,04,010,0026,0071,625,18,643,1062,0,6,0,6,3,0,3,0.00,60.55,50.00
10,002,04,010,0026,0072,689,14,703,1062,0,6,0,6,3,0,3,0.00,66.20,50.00
10,002,04,010,0027,0073,575,29,604,928,0,6,0,6,3,0,3,0.00,65.09,50.00
10,002,04,010,0027,0074,707,25,732,1144,0,6,0,6,3,0,3,0.00,63.99,50.00
10,002,04,010,0027,0075,622,23,645,974,0,6,0,6,3,0,3,0.00,66.22,50.00
10,002,04,010,0034,0076,329,20,349,542,0,6,0,6,3,0,3,0.00,64.39,50.00
10,002,04,010,0034,0077,402,24,426,679,0,6,0,6,3,0,3,0.00,62.74,50.00
10,002,04,010,0031,0078,537,29,566,861,0,6,0,6,3,0,3,0.00,65.74,50.00
10,002,04,010,0032,0079,516,20,536,799,0,6,0,6,3,0,3,0.00,67.08,50.00
10,002,04,010,0032,0080,566,28,594,886,0,6,0,6,3,0,3,0.00,67.04,50.00
10,002,04,010,0028,0081,714,44,758,1090,0,6,0,6,3,0,3,0.00,69.54,50.00
10,002,04,010,0024,0000,1699,77,1776,2726,0,6,0,6,3,0,3,0.00,65.15,50.00
10,002,04,010,0025,0000,1214,53,1267,2020,0,6,0,6,3,0,3,0.00,62.72,50.00
10,002,04,010,0026,0000,1314,32,1346,2124,0,6,0,6,3,0,3,0.00,63.37,50.00
10,002,04,010,0027,0000,1904,77,1981,3046,0,6,0,6,3,0,3,0.00,65.04,50.00
10,002,04,010,0028,0000,714,44,758,1090,0,6,0,6,3,0,3,0.00,69.54,50.00
10,002,04,010,0031,0000,537,29,566,861,0,6,0,6,3,0,3,0.00,65.74,50.00
10,002,04,010,0032,0000,1082,48,1130,1685,0,6,0,6,3,0,3,0.00,67.06,50.00
10,002,04,010,0034,0000,731,44,775,1221,0,6,0,6,3,0,3,0.00,63.47,50.00
10,002,04,020,0019,0115,780,35,815,1339,0,7,1,8,4,1,5,0.00,60.87,62.50
10,002,04,020,0019,0116,540,26,566,984,0,7,1,8,4,1,5,0.00,57.52,62.50
10,002,04,020,0019,0117,520,29,549,987,0,7,1,8,4,1,5,0.00,55.62,62.50
10,002,04,020,0020,0118,690,53,743,1292,0,7,1,8,4,1,5,0.00,57.51,62.50
10,002,04,020,0020,0119,699,30,729,1198,0,7,1,8,4,1,5,0.00,60.85,62.50
10,002,04,020,0021,0120,466,33,499,1035,0,7,1,8,4,1,5,0.00,48.21,62.50
10,002,04,020,0022,0121,611,43,654,985,0,7,1,8,4,1,5,0.00,66.40,62.50
10,002,04,020,0022,0122,609,38,647,1019,0,7,1,8,4,1,5,0.00,63.49,62.50
10,002,04,020,0022,0123,440,32,472,757,0,7,1,8,4,1,5,0.00,62.35,62.50
10,002,04,020,0025,0124,817,48,865,1315,0,7,1,8,4,1,5,0.00,65.78,62.50
10,002,04,020,0025,0125,509,28,537,836,0,7,1,8,4,1,5,0.00,64.23,62.50
10,002,04,020,0025,0126,608,36,644,1088,0,7,1,8,4,1,5,0.00,59.19,62.50
10,002,04,020,0023,0127,532,24,556,912,0,7,1,8,4,1,5,0.00,60.96,62.50
10,002,04,020,0023,0128,546,28,574,920,0,7,1,8,4,1,5,0.00,62.39,62.50
10,002,04,020,0023,0129,529,15,544,888,0,7,1,8,4,1,5,0.00,61.26,62.50
10,002,04,020,0024,0130,865,25,890,1348,0,7,1,8,4,1,5,0.00,66.02,62.50
10,002,04,020,0024,0131,619,22,641,1013,0,7,1,8,4,1,5,0.00,63.28,62.50
10,002,04,020,0024,0132,674,30,704,1123,0,7,1,8,4,1,5,0.00,62.69,62.50
10,002,04,020,0019,0000,1840,90,1930,3310,0,7,1,8,4,1,5,0.00,58.31,62.50
10,002,04,020,0020,0000,1389,83,1472,2490,0,7,1,8,4,1,5,0.00,59.12,62.50
10,002,04,020,0021,0000,466,33,499,1035,0,7,1,8,4,1,5,0.00,48.21,62.50
10,002,04,020,0022,0000,1660,113,1773,2761,0,7,1,8,4,1,5,0.00,64.22,62.50
10,002,04,020,0023,0000,1607,67,1674,2720,0,7,1,8,4,1,5,0.00,61.54,62.50
10,002,04,020,0024,0000,2158,77,2235,3484,0,7,1,8,4,1,5,0.00,64.15,62.50
10,002,04,020,0025,0000,1934,112,2046,3239,0,7,1,8,4,1,5,0.00,63.17,62.50
10,002,04,030,0001,0000,2138,38,2176,3234,0,4,3,7,3,2,5,0.00,67.29,71.43
10,002,04,030,0002,0000,718,15,733,987,0,4,3,7,3,2,5,0.00,74.27,71.43
10,002,04,030,0003,0000,2332,65,2397,3635,0,4,3,7,3,2,5,0.00,65.94,71.43
10,002,04,030,0004,0000,616,11,627,809,0,4,3,7,3,2,5,0.00,77.50,71.43
10,002,04,030,0005,0000,842,22,864,1196,0,4,3,7,3,2,5,0.00,72.24,71.43
10,002,04,030,0007,0000,1879,53,1932,3028,0,4,3,7,3,2,5,0.00,63.80,71.43
10,002,04,030,0008,0000,1012,35,1047,1442,0,4,3,7,3,2,5,0.00,72.61,71.43
10,002,04,030,0001,0133,549,11,560,887,0,4,3,7,3,2,5,0.00,63.13,71.43
10,002,04,030,0001,0134,525,3,528,767,0,4,3,7,3,2,5,0.00,68.84,71.43
10,002,04,030,0001,0135,509,11,520,756,0,4,3,7,3,2,5,0.00,68.78,71.43
10,002,04,030,0001,0136,555,13,568,824,0,4,3,7,3,2,5,0.00,68.93,71.43
10,002,04,030,0002,0137,718,15,733,987,0,4,3,7,3,2,5,0.00,74.27,71.43
10,002,04,030,0003,0138,677,18,695,1063,0,4,3,7,3,2,5,0.00,65.38,71.43
10,002,04,030,0003,0139,623,14,637,958,0,4,3,7,3,2,5,0.00,66.49,71.43
10,002,04,030,0003,0140,560,17,577,880,0,4,3,7,3,2,5,0.00,65.57,71.43
10,002,04,030,0003,0141,472,16,488,734,0,4,3,7,3,2,5,0.00,66.49,71.43
10,002,04,030,0004,0142,386,5,391,517,0,4,3,7,3,2,5,0.00,75.63,71.43
10,002,04,030,0004,0143,230,6,236,292,0,4,3,7,3,2,5,0.00,80.82,71.43
10,002,04,030,0005,0144,570,13,583,815,0,4,3,7,3,2,5,0.00,71.53,71.43
10,002,04,030,0005,0145,272,9,281,381,0,4,3,7,3,2,5,0.00,73.75,71.43
10,002,04,030,0007,0146,634,17,651,1035,0,4,3,7,3,2,5,0.00,62.90,71.43
10,002,04,030,0007,0147,648,20,668,1037,0,4,3,7,3,2,5,0.00,64.42,71.43
10,002,04,030,0007,0148,597,16,613,956,0,4,3,7,3,2,5,0.00,64.12,71.43
10,002,04,030,0008,0149,723,21,744,1022,0,4,3,7,3,2,5,0.00,72.80,71.43
10,002,04,030,0008,0150,289,14,303,420,0,4,3,7,3,2,5,0.00,72.14,71.43
10,002,04,040,0001,0000,235,7,242,290,0,4,1,5,2,0,2,0.00,83.45,40.00
10,002,04,040,0002,0000,411,14,425,653,0,4,1,5,2,0,2,0.00,65.08,40.00
10,002,04,040,0003,0000,626,14,640,846,0,4,1,5,2,0,2,0.00,75.65,40.00
10,002,04,040,0004,0000,228,3,231,330,0,4,1,5,2,0,2,0.00,70.00,40.00
10,002,04,040,0005,0000,925,18,943,1308,0,4,1,5,2,0,2,0.00,72.09,40.00
10,002,04,040,0006,0000,617,34,651,843,0,4,1,5,2,0,2,0.00,77.22,40.00
10,002,04,040,0001,0180,235,7,242,290,0,4,1,5,2,0,2,0.00,83.45,40.00
10,002,04,040,0002,0181,411,14,425,653,0,4,1,5,2,0,2,0.00,65.08,40.00
10,002,04,040,0024,0182,530,16,546,677,0,4,1,5,2,0,2,0.00,80.65,40.00
10,002,04,040,0003,0183,626,14,640,846,0,4,1,5,2,0,2,0.00,75.65,40.00
10,002,04,040,0004,0184,228,3,231,330,0,4,1,5,2,0,2,0.00,70.00,40.00
10,002,04,040,0005,0185,445,8,453,614,0,4,1,5,2,0,2,0.00,73.78,40.00
10,002,04,040,0005,0186,480,10,490,694,0,4,1,5,2,0,2,0.00,70.61,40.00
10,002,04,040,0006,0187,617,34,651,843,0,4,1,5,2,0,2,0.00,77.22,40.00
10,002,04,040,0024,0000,530,16,546,677,0,4,1,5,2,0,2,0.00,80.65,40.00
10,002,04,050,0014,0000,924,34,958,1348,0,4,0,4,3,0,3,0.00,71.07,75.00
10,002,04,050,0015,0000,1814,65,1879,2517,0,4,0,4,3,0,3,0.00,74.65,75.00
10,002,04,050,0016,0000,2331,66,2397,3286,0,4,0,4,3,0,3,0.00,72.95,75.00
10,002,04,050,0017,0000,743,16,759,923,0,4,0,4,3,0,3,0.00,82.23,75.00
10,002,04,050,0018,0000,330,9,339,409,0,4,0,4,3,0,3,0.00,82.89,75.00
10,002,04,050,0014,0237,423,19,442,595,0,4,0,4,3,0,3,0.00,74.29,75.00
10,002,04,050,0014,0238,501,15,516,753,0,4,0,4,3,0,3,0.00,68.53,75.00
10,002,04,050,0015,0239,624,18,642,900,0,4,0,4,3,0,3,0.00,71.33,75.00
10,002,04,050,0015,0240,602,30,632,827,0,4,0,4,3,0,3,0.00,76.42,75.00
10,002,04,050,0015,0241,588,17,605,790,0,4,0,4,3,0,3,0.00,76.58,75.00
10,002,04,050,0016,0242,747,23,770,1036,0,4,0,4,3,0,3,0.00,74.32,75.00
10,002,04,050,0016,0243,852,23,875,1211,0,4,0,4,3,0,3,0.00,72.25,75.00
10,002,04,050,0016,0244,732,20,752,1039,0,4,0,4,3,0,3,0.00,72.38,75.00
10,002,04,050,0017,0245,743,16,759,923,0,4,0,4,3,0,3,0.00,82.23,75.00
10,002,04,050,0018,0246,330,9,339,409,0,4,0,4,3,0,3,0.00,82.89,75.00
10,002,04,060,0010,0000,876,36,912,1236,0,4,0,4,3,0,3,0.00,73.79,75.00
10,002,04,060,0011,0000,1566,51,1617,2218,0,4,0,4,3,0,3,0.00,72.90,75.00
10,002,04,060,0012,0000,781,27,808,1053,0,4,0,4,3,0,3,0.00,76.73,75.00
10,002,04,060,0013,0000,1071,40,1111,1671,0,4,0,4,3,0,3,0.00,66.49,75.00
10,002,04,060,0010,0265,876,36,912,1236,0,4,0,4,3,0,3,0.00,73.79,75.00
10,002,04,060,0011,0266,770,24,794,1098,0,4,0,4,3,0,3,0.00,72.31,75.00
10,002,04,060,0011,0267,796,27,823,1120,0,4,0,4,3,0,3,0.00,73.48,75.00
10,002,04,060,0012,0268,781,27,808,1053,0,4,0,4,3,0,3,0.00,76.73,75.00
10,002,04,060,0013,0269,535,19,554,892,0,4,0,4,3,0,3,0.00,62.11,75.00
10,002,04,060,0013,0270,536,21,557,779,0,4,0,4,3,0,3,0.00,71.50,75.00
10,002,04,070,0013,0000,540,28,568,839,0,1,1,2,0,1,1,0.00,67.70,50.00
10,002,04,070,0014,0000,630,18,648,896,0,1,1,2,0,1,1,0.00,72.32,50.00
10,002,04,070,0015,0000,663,22,685,951,0,1,1,2,0,1,1,0.00,72.03,50.00
10,002,04,070,0016,0000,853,25,878,1275,0,1,1,2,0,1,1,0.00,68.86,50.00
10,002,04,070,0013,0299,540,28,568,839,0,1,1,2,0,1,1,0.00,67.70,50.00
10,002,04,070,0014,0300,630,18,648,896,0,1,1,2,0,1,1,0.00,72.32,50.00
10,002,04,070,0015,0301,663,22,685,951,0,1,1,2,0,1,1,0.00,72.03,50.00
10,002,04,070,0016,0302,410,12,422,617,0,1,1,2,0,1,1,0.00,68.40,50.00
10,002,04,070,0016,0303,443,13,456,658,0,1,1,2,0,1,1,0.00,69.30,50.00
10,002,04,080,0019,0000,1482,45,1527,2505,0,5,2,7,3,0,3,0.00,60.96,42.86
10,002,04,080,0020,0000,610,32,642,1031,0,5,2,7,3,0,3,0.00,62.27,42.86
10,002,04,080,0021,0000,1440,46,1486,2401,0,5,2,7,3,0,3,0.00,61.89,42.86
10,002,04,080,0022,0000,1070,30,1100,1655,0,5,2,7,3,0,3,0.00,66.47,42.86
10,002,04,080,0023,0000,1034,35,1069,1721,0,5,2,7,3,0,3,0.00,62.12,42.86
10,002,04,080,0024,0000,491,15,506,726,0,5,2,7,3,0,3,0.00,69.70,42.86
10,002,04,080,0019,0338,772,19,791,1241,0,5,2,7,3,0,3,0.00,63.74,42.86
10,002,04,080,0019,0339,710,26,736,1264,0,5,2,7,3,0,3,0.00,58.23,42.86
10,002,04,080,0020,0340,610,32,642,1031,0,5,2,7,3,0,3,0.00,62.27,42.86
10,002,04,080,0021,0341,749,17,766,1214,0,5,2,7,3,0,3,0.00,63.10,42.86
10,002,04,080,0021,0342,691,29,720,1187,0,5,2,7,3,0,3,0.00,60.66,42.86
10,002,04,080,0022,0343,619,16,635,953,0,5,2,7,3,0,3,0.00,66.63,42.86
10,002,04,080,0022,0344,451,14,465,702,0,5,2,7,3,0,3,0.00,66.24,42.86
10,002,04,080,0023,0345,513,17,530,876,0,5,2,7,3,0,3,0.00,60.50,42.86
10,002,04,080,0023,0346,521,18,539,845,0,5,2,7,3,0,3,0.00,63.79,42.86
10,002,04,080,0024,0347,491,15,506,726,0,5,2,7,3,0,3,0.00,69.70,42.86
10,002,04,090,0009,0000,1879,119,1998,3612,0,3,0,3,2,0,2,0.00,55.32,66.67
10,002,04,090,0011,0000,964,53,1017,1577,0,3,0,3,2,0,2,0.00,64.49,66.67
10,002,04,090,0012,0000,932,44,976,1372,0,3,0,3,2,0,2,0.00,71.14,66.67
10,002,04,090,0009,0371,474,28,502,884,0,3,0,3,2,0,2,0.00,56.79,66.67
10,002,04,090,0009,0372,450,28,478,886,0,3,0,3,2,0,2,0.00,53.95,66.67
10,002,04,090,0009,0373,560,33,593,1060,0,3,0,3,2,0,2,0.00,55.94,66.67
10,002,04,090,0009,0374,395,30,425,782,0,3,0,3,2,0,2,0.00,54.35,66.67
10,002,04,090,0011,0375,450,28,478,800,0,3,0,3,2,0,2,0.00,59.75,66.67
10,002,04,090,0011,0376,514,25,539,777,0,3,0,3,2,0,2,0.00,69.37,66.67
10,002,04,090,0012,0377,423,19,442,604,0,3,0,3,2,0,2,0.00,73.18,66.67
10,002,04,090,0012,0378,509,25,534,768,0,3,0,3,2,0,2,0.00,69.53,66.67
10,002,04,100,0015,0000,855,25,880,1238,0,2,2,4,1,2,3,0.00,71.08,75.00
10,002,04,100,0016,0000,536,13,549,746,0,2,2,4,1,2,3,0.00,73.59,75.00
10,002,04,100,0017,0000,1071,30,1101,1549,0,2,2,4,1,2,3,0.00,71.08,75.00
10,002,04,100,0018,0000,822,28,850,1406,0,2,2,4,1,2,3,0.00,60.46,75.00
10,002,04,100,0015,0404,855,25,880,1238,0,2,2,4,1,2,3,0.00,71.08,75.00
10,002,04,100,0016,0405,536,13,549,746,0,2,2,4,1,2,3,0.00,73.59,75.00
10,002,04,100,0017,0406,553,19,572,800,0,2,2,4,1,2,3,0.00,71.50,75.00
10,002,04,100,0017,0407,518,11,529,749,0,2,2,4,1,2,3,0.00,70.63,75.00
10,002,04,100,0018,0408,385,10,395,646,0,2,2,4,1,2,3,0.00,61.15,75.00
10,002,04,100,0018,0409,437,18,455,760,0,2,2,4,1,2,3,0.00,59.87,75.00
10,002,04,110,0008,0000,639,14,653,773,0,5,0,5,3,0,3,0.00,84.48,60.00
10,002,04,110,0009,0000,562,15,577,643,0,5,0,5,3,0,3,0.00,89.74,60.00
10,002,04,110,0010,0000,158,2,160,194,0,5,0,5,3,0,3,0.00,82.47,60.00
10,002,04,110,0010,0417,158,2,160,194,0,5,0,5,3,0,3,0.00,82.47,60.00
10,002,04,110,0008,0418,639,14,653,773,0,5,0,5,3,0,3,0.00,84.48,60.00
10,002,04,110,0009,0419,562,15,577,643,0,5,0,5,3,0,3,0.00,89.74,60.00
10,002,04,120,0007,0000,568,8,576,681,0,2,0,2,1,0,1,0.00,84.58,50.00
10,002,04,120,0007,0426,568,8,576,681,0,2,0,2,1,0,1,0.00,84.58,50.00
10,002,00,050,0000,0000,19394,829,20223,29815,34809,14,2,16,10,1,11,85.65,67.83,68.75
10,002,01,050,0000,0000,7000,266,7266,11537,13591,4,2,6,3,1,4,84.89,62.98,66.67
10,002,02,050,0000,0000,2826,204,3030,4574,5227,3,0,3,2,0,2,87.51,66.24,66.67
10,002,03,050,0000,0000,3426,169,3595,5221,6106,3,0,3,2,0,2,85.51,68.86,66.67
10,002,04,050,0000,0000,6142,190,6332,8483,9885,4,0,4,3,0,3,85.82,74.64,75.00
10,002,05,090,0013,0000,1064,31,1095,1882,0,4,1,5,2,0,2,0.00,58.18,40.00
10,002,05,090,0014,0000,1823,60,1883,3117,0,4,1,5,2,0,2,0.00,60.41,40.00
10,002,05,090,0015,0000,1607,58,1665,2680,0,4,1,5,2,0,2,0.00,62.13,40.00
10,002,05,090,0013,0379,484,17,501,880,0,4,1,5,2,0,2,0.00,56.93,40.00
10,002,05,090,0013,0380,580,14,594,1002,0,4,1,5,2,0,2,0.00,59.28,40.00
10,002,05,090,0014,0381,548,28,576,1071,0,4,1,5,2,0,2,0.00,53.78,40.00
10,002,05,090,0014,0382,780,18,798,1155,0,4,1,5,2,0,2,0.00,69.09,40.00
10,002,05,090,0014,0383,495,14,509,891,0,4,1,5,2,0,2,0.00,57.13,40.00
10,002,05,090,0015,0384,525,16,541,826,0,4,1,5,2,0,2,0.00,65.50,40.00
10,002,05,090,0015,0385,665,29,694,1189,0,4,1,5,2,0,2,0.00,58.37,40.00
10,002,05,090,0015,0386,417,13,430,665,0,4,1,5,2,0,2,0.00,64.66,40.00
10,002,00,060,0000,0000,13701,645,14346,21174,24431,13,3,16,10,1,11,86.67,67.75,68.75
10,002,01,060,0000,0000,4013,208,4221,6454,7576,3,3,6,3,1,4,85.19,65.40,66.67
10,002,02,060,0000,0000,3442,75,3517,4685,5280,4,0,4,2,0,2,88.73,75.07,50.00
10,002,03,060,0000,0000,1952,208,2160,3857,4530,2,0,2,2,0,2,85.14,56.00,100.00
10,002,04,060,0000,0000,4294,154,4448,6178,7045,4,0,4,3,0,3,87.69,72.00,75.00
10,002,00,070,0000,0000,16612,814,17426,27376,31895,13,3,16,9,2,11,85.83,63.65,68.75
10,002,01,070,0000,0000,5850,176,6026,9454,11068,5,2,7,3,1,4,85.42,63.74,57.14
10,002,02,070,0000,0000,4039,161,4200,6504,7671,4,0,4,3,0,3,84.79,64.58,75.00
10,002,03,070,0000,0000,4037,384,4421,7457,8623,3,0,3,3,0,3,86.48,59.29,100.00
10,002,04,070,0000,0000,2686,93,2779,3961,4533,1,1,2,0,1,1,87.38,70.16,50.00
10,002,00,080,0000,0000,26469,1227,27696,44184,52732,18,2,20,11,0,11,83.79,62.68,55.00
10,002,01,080,0000,0000,7788,284,8072,12090,15249,5,0,5,3,0,3,79.28,66.77,60.00
10,002,02,080,0000,0000,7170,412,7582,12706,14739,5,0,5,3,0,3,86.21,59.67,60.00
10,002,03,080,0000,0000,5384,328,5712,9349,11192,3,0,3,2,0,2,83.53,61.10,66.67
10,002,04,080,0000,0000,6127,203,6330,10039,11552,5,2,7,3,0,3,86.90,63.05,42.86
10,002,00,090,0000,0000,20148,815,20963,34579,40630,20,3,23,10,1,11,85.11,60.62,47.83
10,002,01,090,0000,0000,3918,148,4066,6473,7579,3,1,4,1,1,2,85.41,62.81,50.00
10,002,02,090,0000,0000,3129,126,3255,5347,6159,6,1,7,2,0,2,86.82,60.88,28.57
10,002,03,090,0000,0000,4832,176,5008,8519,10083,4,0,4,3,0,3,84.49,58.79,75.00
10,002,04,090,0000,0000,3775,216,3991,6561,7771,3,0,3,2,0,2,84.43,60.83,66.67
10,002,05,090,0000,0000,4494,149,4643,7679,9038,4,1,5,2,0,2,84.96,60.46,40.00
10,002,00,100,0000,0000,12290,334,12624,18575,21264,15,4,19,8,3,11,87.35,67.96,57.89
10,002,01,100,0000,0000,2731,84,2815,4033,4699,5,0,5,2,0,2,85.83,69.80,40.00
10,002,02,100,0000,0000,2302,68,2370,3186,3568,4,0,4,2,0,2,89.29,74.39,50.00
10,002,03,100,0000,0000,3973,86,4059,6417,7330,4,2,6,3,1,4,87.54,63.25,66.67
10,002,04,100,0000,0000,3284,96,3380,4939,5667,2,2,4,1,2,3,87.15,68.43,75.00
10,002,00,110,0000,0000,3874,127,4001,4816,6187,12,0,12,7,0,7,77.84,83.08,58.33
10,002,01,110,0000,0000,627,62,689,879,1159,1,0,1,1,0,1,75.84,78.38,100.00
10,002,02,110,0000,0000,1311,24,1335,1598,1967,3,0,3,2,0,2,81.24,83.54,66.67
10,002,03,110,0000,0000,577,10,587,729,903,3,0,3,1,0,1,80.73,80.52,33.33
10,002,04,110,0000,0000,1359,31,1390,1610,2158,5,0,5,3,0,3,74.61,86.34,60.00
10,002,00,120,0000,0000,3544,61,3605,4499,6113,13,1,14,6,1,7,73.60,80.13,50.00
10,002,01,120,0000,0000,1284,17,1301,1597,2096,5,1,6,2,1,3,76.19,81.47,50.00
10,002,02,120,0000,0000,992,23,1015,1318,1866,4,0,4,2,0,2,70.63,77.01,50.00
10,002,03,120,0000,0000,700,13,713,903,1181,2,0,2,1,0,1,76.46,78.96,50.00
10,002,04,120,0000,0000,568,8,576,681,970,2,0,2,1,0,1,70.21,84.58,50.00
10,004,00,000,0000,0000,253382,12947,266329,450814,578949,192,52,244,104,38,142,77.87,59.08,58.20
10,004,00,010,0000,0000,77360,5012,82372,147979,208197,27,12,39,11,9,20,71.08,55.66,51.28
10,004,01,010,0000,0000,31656,2164,33820,61892,95449,13,7,20,4,5,9,64.84,54.64,45.00
10,004,02,010,0000,0000,27890,1504,29394,53748,73141,8,5,13,3,4,7,73.49,54.69,53.85
10,004,03,010,0000,0000,8745,694,9439,16997,21233,3,0,3,2,0,2,80.05,55.53,66.67
10,004,04,010,0000,0000,9069,650,9719,15342,18374,3,0,3,2,0,2,83.50,63.35,66.67
10,004,01,010,0002,0001,604,43,647,1223,0,13,7,20,4,5,9,0.00,52.90,45.00
10,004,01,010,0002,0002,706,28,734,1231,0,13,7,20,4,5,9,0.00,59.63,45.00
10,004,01,010,0002,0003,650,65,715,1262,0,13,7,20,4,5,9,0.00,56.66,45.00
10,004,01,010,0002,0004,628,26,654,1131,0,13,7,20,4,5,9,0.00,57.82,45.00
10,004,01,010,0002,0005,649,39,688,1266,0,13,7,20,4,5,9,0.00,54.34,45.00
10,004,01,010,0002,0006,552,53,605,1100,0,13,7,20,4,5,9,0.00,55.00,45.00
10,004,01,010,0002,0007,586,27,613,1000,0,13,7,20,4,5,9,0.00,61.30,45.00
10,004,01,010,0002,0008,535,39,574,995,0,13,7,20,4,5,9,0.00,57.69,45.00
10,004,01,010,0002,0009,588,57,645,1167,0,13,7,20,4,5,9,0.00,55.27,45.00
10,004,01,010,0003,0010,584,39,623,1113,0,13,7,20,4,5,9,0.00,55.97,45.00
10,004,01,010,0003,0011,605,33,638,1187,0,13,7,20,4,5,9,0.00,53.75,45.00
10,004,01,010,0003,0012,590,47,637,1154,0,13,7,20,4,5,9,0.00,55.20,45.00
10,004,01,010,0003,0013,525,47,572,1090,0,13,7,20,4,5,9,0.00,52.48,45.00
10,004,01,010,0003,0014,571,52,623,1187,0,13,7,20,4,5,9,0.00,52.49,45.00
10,004,01,010,0003,0015,664,51,715,1320,0,13,7,20,4,5,9,0.00,54.17,45.00
10,004,01,010,0003,0016,545,60,605,1217,0,13,7,20,4,5,9,0.00,49.71,45.00
10,004,01,010,0003,0017,566,38,604,1149,0,13,7,20,4,5,9,0.00,52.57,45.00
10,004,01,010,0003,0018,470,44,514,993,0,13,7,20,4,5,9,0.00,51.76,45.00
10,004,01,010,0003,0019,476,58,534,1098,0,13,7,20,4,5,9,0.00,48.63,45.00
10,004,01,010,0002,0000,5498,377,5875,10375,0,13,7,20,4,5,9,0.00,56.63,45.00
10,004,01,010,0004,0020,653,38,691,1180,0,13,7,20,4,5,9,0.00,58.56,45.00
10,004,01,010,0004,0021,535,23,558,984,0,13,7,20,4,5,9,0.00,56.71,45.00
10,004,01,010,0004,0022,640,47,687,1180,0,13,7,20,4,5,9,0.00,58.22,45.00
10,004,01,010,0004,0023,586,29,615,1159,0,13,7,20,4,5,9,0.00,53.06,45.00
10,004,01,010,0004,0024,733,22,755,1227,0,13,7,20,4,5,9,0.00,61.53,45.00
10,004,01,010,0004,0025,468,51,519,970,0,13,7,20,4,5,9,0.00,53.51,45.00
10,004,01,010,0004,0026,587,38,625,1167,0,13,7,20,4,5,9,0.00,53.56,45.00
10,004,01,010,0005,0027,600,63,663,1216,0,13,7,20,4,5,9,0.00,54.52,45.00
10,004,01,010,0005,0028,514,39,553,1025,0,13,7,20,4,5,9,0.00,53.95,45.00
10,004,01,010,0005,0029,473,28,501,847,0,13,7,20,4,5,9,0.00,59.15,45.00
10,004,01,010,0003,0000,5596,469,6065,11508,0,13,7,20,4,5,9,0.00,52.70,45.00
10,004,01,010,0006,0030,528,21,549,932,0,13,7,20,4,5,9,0.00,58.91,45.00
10,004,01,010,0006,0031,646,22,668,1026,0,13,7,20,4,5,9,0.00,65.11,45.00
10,004,01,010,0006,0032,585,20,605,890,0,13,7,20,4,5,9,0.00,67.98,45.00
10,004,01,010,0027,0033,612,34,646,1236,0,13,7,20,4,5,9,0.00,52.27,45.00
10,004,01,010,0027,0034,679,27,706,1277,0,13,7,20,4,5,9,0.00,55.29,45.00
10,004,01,010,0027,0035,503,41,544,1176,0,13,7,20,4,5,9,0.00,46.26,45.00
10,004,01,010,0027,0036,609,33,642,1282,0,13,7,20,4,5,9,0.00,50.08,45.00
10,004,01,010,0027,0037,481,34,515,1097,0,13,7,20,4,5,9,0.00,46.95,45.00
10,004,01,010,0027,0038,571,27,598,1131,0,13,7,20,4,5,9,0.00,52.87,45.00
10,004,01,010,0028,0039,559,49,608,1171,0,13,7,20,4,5,9,0.00,51.92,45.00
10,004,01,010,0004,0000,4202,248,4450,7867,0,13,7,20,4,5,9,0.00,56.57,45.00
10,004,01,010,0028,0040,516,39,555,1159,0,13,7,20,4,5,9,0.00,47.89,45.00
10,004,01,010,0028,0041,520,39,559,1162,0,13,7,20,4,5,9,0.00,48.11,45.00
10,004,01,010,0028,0042,684,44,728,1262,0,13,7,20,4,5,9,0.00,57.69,45.00
10,004,01,010,0028,0043,510,40,550,1162,0,13,7,20,4,5,9,0.00,47.33,45.00
10,004,01,010,0021,0044,595,31,626,1154,0,13,7,20,4,5,9,0.00,54.25,45.00
10,004,01,010,0021,0045,555,45,600,1046,0,13,7,20,4,5,9,0.00,57.36,45.00
10,004,01,010,0021,0046,536,33,569,1053,0,13,7,20,4,5,9,0.00,54.04,45.00
10,004,01,010,0021,0047,639,34,673,1198,0,13,7,20,4,5,9,0.00,56.18,45.00
10,004,01,010,0021,0048,494,26,520,991,0,13,7,20,4,5,9,0.00,52.47,45.00
10,004,01,010,0021,0049,513,47,560,990,0,13,7,20,4,5,9,0.00,56.57,45.00
10,004,01,010,0005,0000,1587,130,1717,3088,0,13,7,20,4,5,9,0.00,55.60,45.00
10,004,01,010,0029,0050,609,31,640,1171,0,13,7,20,4,5,9,0.00,54.65,45.00
10,004,01,010,0029,0051,578,25,603,1107,0,13,7,20,4,5,9,0.00,54.47,45.00
10,004,01,010,0029,0052,614,42,656,1180,0,13,7,20,4,5,9,0.00,55.59,45.00
10,004,01,010,0030,0053,544,49,593,1074,0,13,7,20,4,5,9,0.00,55.21,45.00
10,004,01,010,0030,0054,561,42,603,1037,0,13,7,20,4,5,9,0.00,58.15,45.00
10,004,01,010,0030,0055,532,65,597,1090,0,13,7,20,4,5,9,0.00,54.77,45.00
10,004,01,010,0006,0000,1759,63,1822,2848,0,13,7,20,4,5,9,0.00,63.97,45.00
10,004,01,010,0021,0000,3332,216,3548,6432,0,13,7,20,4,5,9,0.00,55.16,45.00
10,004,01,010,0027,0000,3455,196,3651,7199,0,13,7,20,4,5,9,0.00,50.72,45.00
10,004,01,010,0028,0000,2789,211,3000,5916,0,13,7,20,4,5,9,0.00,50.71,45.00
10,004,01,010,0029,0000,1801,98,1899,3458,0,13,7,20,4,5,9,0.00,54.92,45.00
10,004,01,010,0030,0000,1637,156,1793,3201,0,13,7,20,4,5,9,0.00,56.01,45.00
10,004,01,020,0001,0000,191,10,201,288,0,3,1,4,2,1,3,0.00,69.79,75.00
10,004,01,020,0002,0000,200,10,210,377,0,3,1,4,2,1,3,0.00,55.70,75.00
10,004,01,020,0003,0000,197,20,217,343,0,3,1,4,2,1,3,0.00,63.27,75.00
10,004,01,020,0004,0000,1065,56,1121,2135,0,3,1,4,2,1,3,0.00,52.51,75.00
10,004,01,020,0005,0000,1562,107,1669,3175,0,3,1,4,2,1,3,0.00,52.57,75.00
10,004,01,020,0006,0000,4569,223,4792,8964,0,3,1,4,2,1,3,0.00,53.46,75.00
10,004,01,020,0001,0135,191,10,201,288,0,3,1,4,2,1,3,0.00,69.79,75.00
10,004,01,020,0002,0136,200,10,210,377,0,3,1,4,2,1,3,0.00,55.70,75.00
10,004,01,020,0003,0137,197,20,217,343,0,3,1,4,2,1,3,0.00,63.27,75.00
10,004,01,020,0004,0138,501,26,527,1037,0,3,1,4,2,1,3,0.00,50.82,75.00
10,004,01,020,0004,0139,564,30,594,1098,0,3,1,4,2,1,3,0.00,54.10,75.00
10,004,01,020,0006,0140,603,24,627,1124,0,3,1,4,2,1,3,0.00,55.78,75.00
10,004,01,020,0006,0141,648,23,671,1186,0,3,1,4,2,1,3,0.00,56.58,75.00
10,004,01,020,0006,0142,608,40,648,1227,0,3,1,4,2,1,3,0.00,52.81,75.00
10,004,01,020,0006,0143,531,34,565,1263,0,3,1,4,2,1,3,0.00,44.73,75.00
10,004,01,020,0006,0144,596,21,617,1176,0,3,1,4,2,1,3,0.00,52.47,75.00
10,004,01,020,0006,0145,505,30,535,928,0,3,1,4,2,1,3,0.00,57.65,75.00
10,004,01,020,0006,0146,517,19,536,932,0,3,1,4,2,1,3,0.00,57.51,75.00
10,004,01,020,0006,0147,561,32,593,1128,0,3,1,4,2,1,3,0.00,52.57,75.00
10,004,01,020,0005,0148,472,39,511,992,0,3,1,4,2,1,3,0.00,51.51,75.00
10,004,01,020,0005,0149,560,42,602,1195,0,3,1,4,2,1,3,0.00,50.38,75.00
10,004,01,020,0005,0150,530,26,556,988,0,3,1,4,2,1,3,0.00,56.28,75.00
10,004,01,020,0021,0151,582,36,618,1092,0,3,1,4,2,1,3,0.00,56.59,75.00
10,004,01,020,0021,0152,741,36,777,1340,0,3,1,4,2,1,3,0.00,57.99,75.00
10,004,01,020,0021,0000,1323,72,1395,2432,0,3,1,4,2,1,3,0.00,57.36,75.00
10,004,01,030,0004,0000,1157,29,1186,1905,0,7,3,10,3,2,5,0.00,62.26,50.00
10,004,01,030,0005,0000,2043,45,2088,3125,0,7,3,10,3,2,5,0.00,66.82,50.00
10,004,01,030,0006,0000,982,29,1011,1666,0,7,3,10,3,2,5,0.00,60.68,50.00
10,004,01,030,0007,0000,2083,55,2138,3203,0,7,3,10,3,2,5,0.00,66.75,50.00
10,004,01,030,0008,0000,555,17,572,890,0,7,3,10,3,2,5,0.00,64.27,50.00
10,004,01,030,0009,0000,362,10,372,526,0,7,3,10,3,2,5,0.00,70.72,50.00
10,004,01,030,0010,0000,597,16,613,961,0,7,3,10,3,2,5,0.00,63.79,50.00
10,004,01,030,0008,0214,555,17,572,890,0,7,3,10,3,2,5,0.00,64.27,50.00
10,004,01,030,0009,0215,362,10,372,526,0,7,3,10,3,2,5,0.00,70.72,50.00
10,004,01,030,0010,0216,597,16,613,961,0,7,3,10,3,2,5,0.00,63.79,50.00
10,004,01,030,0007,0217,597,12,609,890,0,7,3,10,3,2,5,0.00,68.43,50.00
10,004,01,030,0007,0218,450,9,459,676,0,7,3,10,3,2,5,0.00,67.90,50.00
10,004,01,030,0007,0219,499,14,513,803,0,7,3,10,3,2,5,0.00,63.89,50.00
10,004,01,030,0007,0220,537,20,557,834,0,7,3,10,3,2,5,0.00,66.79,50.00
10,004,01,030,0006,0221,503,17,520,844,0,7,3,10,3,2,5,0.00,61.61,50.00
10,004,01,030,0006,0222,479,12,491,822,0,7,3,10,3,2,5,0.00,59.73,50.00
10,004,01,030,0004,0223,565,16,581,935,0,7,3,10,3,2,5,0.00,62.14,50.00
10,004,01,030,0004,0224,592,13,605,970,0,7,3,10,3,2,5,0.00,62.37,50.00
10,004,01,030,0005,0225,751,19,770,1139,0,7,3,10,3,2,5,0.00,67.60,50.00
10,004,01,030,0005,0226,689,13,702,1066,0,7,3,10,3,2,5,0.00,65.85,50.00
10,004,01,030,0005,0227,603,13,616,920,0,7,3,10,3,2,5,0.00,66.96,50.00
10,004,01,040,0001,0000,296,8,304,455,0,6,2,8,3,1,4,0.00,66.81,50.00
10,004,01,040,0002,0000,1132,33,1165,1823,0,6,2,8,3,1,4,0.00,63.91,50.00
10,004,01,040,0003,0000,457,10,467,673,0,6,2,8,3,1,4,0.00,69.39,50.00
10,004,01,040,0004,0000,2166,48,2214,3490,0,6,2,8,3,1,4,0.00,63.44,50.00
10,004,01,040,0005,0000,572,22,594,935,0,6,2,8,3,1,4,0.00,63.53,50.00
10,004,01,040,0006,0000,503,18,521,726,0,6,2,8,3,1,4,0.00,71.76,50.00
10,004,01,040,0007,0000,712,14,726,991,0,6,2,8,3,1,4,0.00,73.26,50.00
10,004,01,040,0001,0248,296,8,304,455,0,6,2,8,3,1,4,0.00,66.81,50.00
10,004,01,040,0002,0249,540,20,560,852,0,6,2,8,3,1,4,0.00,65.73,50.00
10,004,01,040,0002,0250,592,13,605,971,0,6,2,8,3,1,4,0.00,62.31,50.00
10,004,01,040,0003,0251,457,10,467,673,0,6,2,8,3,1,4,0.00,69.39,50.00
10,004,01,040,0004,0252,731,13,744,1112,0,6,2,8,3,1,4,0.00,66.91,50.00
10,004,01,040,0004,0253,736,14,750,1139,0,6,2,8,3,1,4,0.00,65.85,50.00
10,004,01,040,0004,0254,699,21,720,1239,0,6,2,8,3,1,4,0.00,58.11,50.00
10,004,01,040,0006,0255,503,18,521,726,0,6,2,8,3,1,4,0.00,71.76,50.00
10,004,01,040,0005,0256,572,22,594,935,0,6,2,8,3,1,4,0.00,63.53,50.00
10,004,01,040,0007,0257,712,14,726,991,0,6,2,8,3,1,4,0.00,73.26,50.00
10,004,01,050,0004,0000,2746,143,2889,5144,0,3,1,4,2,1,3,0.00,56.16,75.00
10,004,01,050,0006,0000,2713,107,2820,4882,0,3,1,4,2,1,3,0.00,57.76,75.00
10,004,01,050,0007,0000,1805,65,1870,2793,0,3,1,4,2,1,3,0.00,66.95,75.00
10,004,01,050,0017,0000,2210,125,2335,3746,0,3,1,4,2,1,3,0.00,62.33,75.00
10,004,01,050,0007,0275,813,30,843,1272,0,3,1,4,2,1,3,0.00,66.27,75.00
10,004,01,050,0007,0276,992,35,1027,1521,0,3,1,4,2,1,3,0.00,67.52,75.00
10,004,01,050,0006,0281,673,31,704,1092,0,3,1,4,2,1,3,0.00,64.47,75.00
10,004,01,050,0006,0282,734,35,769,1367,0,3,1,4,2,1,3,0.00,56.25,75.00
10,004,01,050,0006,0283,618,22,640,1161,0,3,1,4,2,1,3,0.00,55.12,75.00
10,004,01,050,0006,0284,688,19,707,1262,0,3,1,4,2,1,3,0.00,56.02,75.00
10,004,01,050,0004,0296,682,28,710,1421,0,3,1,4,2,1,3,0.00,49.96,75.00
10,004,01,050,0004,0297,701,37,738,1303,0,3,1,4,2,1,3,0.00,56.64,75.00
10,004,01,050,0004,0298,638,36,674,1096,0,3,1,4,2,1,3,0.00,61.50,75.00
10,004,01,050,0004,0299,725,42,767,1324,0,3,1,4,2,1,3,0.00,57.93,75.00
10,004,01,050,0017,0300,765,33,798,1245,0,3,1,4,2,1,3,0.00,64.10,75.00
10,004,01,050,0017,0301,713,44,757,1283,0,3,1,4,2,1,3,0.00,59.00,75.00
10,004,01,050,0017,0302,732,48,780,1218,0,3,1,4,2,1,3,0.00,64.04,75.00
10,004,01,060,0001,0000,639,26,665,1031,0,3,0,3,2,0,2,0.00,64.50,66.67
10,004,01,060,0003,0000,1128,34,1162,1850,0,3,0,3,2,0,2,0.00,62.81,66.67
10,004,01,060,0005,0000,931,57,988,1782,0,3,0,3,2,0,2,0.00,55.44,66.67
10,004,01,060,0007,0000,1407,85,1492,3077,0,3,0,3,2,0,2,0.00,48.49,66.67
10,004,01,060,0001,0329,639,26,665,1031,0,3,0,3,2,0,2,0.00,64.50,66.67
10,004,01,060,0003,0330,546,21,567,880,0,3,0,3,2,0,2,0.00,64.43,66.67
10,004,01,060,0003,0331,582,13,595,970,0,3,0,3,2,0,2,0.00,61.34,66.67
10,004,01,060,0007,0332,487,19,506,958,0,3,0,3,2,0,2,0.00,52.82,66.67
10,004,01,060,0007,0333,451,37,488,1082,0,3,0,3,2,0,2,0.00,45.10,66.67
10,004,01,060,0007,0334,469,29,498,1037,0,3,0,3,2,0,2,0.00,48.02,66.67
10,004,01,060,0005,0335,535,38,573,914,0,3,0,3,2,0,2,0.00,62.69,66.67
10,004,01,060,0005,0336,396,19,415,868,0,3,0,3,2,0,2,0.00,47.81,66.67
10,004,01,070,0001,0000,397,24,421,470,0,2,0,2,1,0,1,0.00,89.57,50.00
10,004,01,070,0002,0000,265,17,282,360,0,2,0,2,1,0,1,0.00,78.33,50.00
10,004,01,070,0003,0000,532,26,558,893,0,2,0,2,1,0,1,0.00,62.49,50.00
10,004,01,070,0002,0374,265,17,282,360,0,2,0,2,1,0,1,0.00,78.33,50.00
10,004,01,070,0001,0375,397,24,421,470,0,2,0,2,1,0,1,0.00,89.57,50.00
10,004,01,070,0003,0376,532,26,558,893,0,2,0,2,1,0,1,0.00,62.49,50.00
10,004,01,080,0001,0000,1966,56,2022,3166,0,5,2,7,3,1,4,0.00,63.87,57.14
10,004,01,080,0002,0000,542,16,558,808,0,5,2,7,3,1,4,0.00,69.06,57.14
10,004,01,080,0003,0000,101,5,106,167,0,5,2,7,3,1,4,0.00,63.47,57.14
10,004,01,080,0004,0000,146,5,151,208,0,5,2,7,3,1,4,0.00,72.60,57.14
10,004,01,080,0001,0393,710,19,729,1139,0,5,2,7,3,1,4,0.00,64.00,57.14
10,004,01,080,0001,0394,571,20,591,975,0,5,2,7,3,1,4,0.00,60.62,57.14
10,004,01,080,0001,0395,685,17,702,1052,0,5,2,7,3,1,4,0.00,66.73,57.14
10,004,01,080,0002,0396,542,16,558,808,0,5,2,7,3,1,4,0.00,69.06,57.14
10,004,01,080,0003,0397,101,5,106,167,0,5,2,7,3,1,4,0.00,63.47,57.14
10,004,01,080,0004,0398,146,5,151,208,0,5,2,7,3,1,4,0.00,72.60,57.14
10,004,01,090,0002,0000,738,25,763,1110,0,2,2,4,0,2,2,0.00,68.74,50.00
10,004,01,090,0005,0000,250,8,258,354,0,2,2,4,0,2,2,0.00,72.88,50.00
10,004,01,090,0006,0000,478,11,489,687,0,2,2,4,0,2,2,0.00,71.18,50.00
10,004,01,090,0002,0411,738,25,763,1110,0,2,2,4,0,2,2,0.00,68.74,50.00
10,004,01,090,0005,0417,250,8,258,354,0,2,2,4,0,2,2,0.00,72.88,50.00
10,004,01,090,0006,0418,478,11,489,687,0,2,2,4,0,2,2,0.00,71.18,50.00
10,004,01,100,0001,0000,1618,69,1687,2625,0,8,2,10,5,1,6,0.00,64.27,60.00
10,004,01,100,0002,0000,968,82,1050,1754,0,8,2,10,5,1,6,0.00,59.86,60.00
10,004,01,100,0010,0000,1616,65,1681,2582,0,8,2,10,5,1,6,0.00,65.10,60.00
10,004,01,100,0001,0421,922,38,960,1395,0,8,2,10,5,1,6,0.00,68.82,60.00
10,004,01,100,0001,0422,696,31,727,1230,0,8,2,10,5,1,6,0.00,59.11,60.00
10,004,01,100,0010,0423,834,25,859,1273,0,8,2,10,5,1,6,0.00,67.48,60.00
10,004,01,100,0010,0424,782,40,822,1309,0,8,2,10,5,1,6,0.00,62.80,60.00
10,004,01,100,0002,0425,501,46,547,957,0,8,2,10,5,1,6,0.00,57.16,60.00
10,004,01,100,0002,0426,467,36,503,797,0,8,2,10,5,1,6,0.00,63.11,60.00
10,004,01,110,0001,0000,660,13,673,811,0,4,1,5,2,1,3,0.00,82.98,60.00
10,004,01,110,0002,0000,548,11,559,648,0,4,1,5,2,1,3,0.00,86.27,60.00
10,004,01,110,0005,0000,452,6,458,577,0,4,1,5,2,1,3,0.00,79.38,60.00
10,004,01,110,0001,0434,660,13,673,811,0,4,1,5,2,1,3,0.00,82.98,60.00
10,004,01,110,0002,0435,548,11,559,648,0,4,1,5,2,1,3,0.00,86.27,60.00
10,004,01,110,0005,0437,267,3,270,327,0,4,1,5,2,1,3,0.00,82.57,60.00
10,004,01,110,0005,0438,185,3,188,250,0,4,1,5,2,1,3,0.00,75.20,60.00
10,004,01,120,0002,0000,617,14,631,792,0,3,0,3,2,0,2,0.00,79.67,66.67
10,004,01,120,0003,0000,866,12,878,1175,0,3,0,3,2,0,2,0.00,74.72,66.67
10,004,01,120,0002,0443,350,8,358,451,0,3,0,3,2,0,2,0.00,79.38,66.67
10,004,01,120,0002,0444,267,6,273,341,0,3,0,3,2,0,2,0.00,80.06,66.67
10,004,01,120,0003,0447,516,8,524,721,0,3,0,3,2,0,2,0.00,72.68,66.67
10,004,01,120,0003,0448,350,4,354,454,0,3,0,3,2,0,2,0.00,77.97,66.67
10,004,01,130,0001,0000,1001,20,1021,1291,0,4,0,4,2,0,2,0.00,79.09,50.00
10,004,01,130,0001,0458,516,5,521,646,0,4,0,4,2,0,2,0.00,80.65,50.00
10,004,01,130,0001,0459,485,15,500,645,0,4,0,4,2,0,2,0.00,77.52,50.00
10,004,00,020,0000,0000,40915,1855,42770,77389,96298,15,7,22,11,4,15,80.36,55.27,68.18
10,004,01,020,0000,0000,9107,498,9605,17714,21312,3,1,4,2,1,3,83.12,54.22,75.00
10,004,02,020,0000,0000,6833,361,7194,13072,15813,4,0,4,3,0,3,82.67,55.03,75.00
10,004,03,020,0000,0000,11917,518,12435,22448,28286,4,2,6,3,1,4,79.36,55.39,66.67
10,004,04,020,0000,0000,13058,478,13536,24155,30887,4,4,8,3,2,5,78.20,56.04,62.50
10,004,02,010,0001,0000,3448,229,3677,6734,0,8,5,13,3,4,7,0.00,54.60,53.85
10,004,02,010,0001,0056,456,34,490,1035,0,8,5,13,3,4,7,0.00,47.34,53.85
10,004,02,010,0001,0057,522,33,555,1063,0,8,5,13,3,4,7,0.00,52.21,53.85
10,004,02,010,0001,0058,668,31,699,1074,0,8,5,13,3,4,7,0.00,65.08,53.85
10,004,02,010,0001,0059,580,37,617,1115,0,8,5,13,3,4,7,0.00,55.34,53.85
10,004,02,010,0001,0060,613,47,660,1242,0,8,5,13,3,4,7,0.00,53.14,53.85
10,004,02,010,0001,0061,609,47,656,1205,0,8,5,13,3,4,7,0.00,54.44,53.85
10,004,02,010,0031,0062,789,32,821,1259,0,8,5,13,3,4,7,0.00,65.21,53.85
10,004,02,010,0031,0063,696,33,729,1267,0,8,5,13,3,4,7,0.00,57.54,53.85
10,004,02,010,0031,0064,620,38,658,1286,0,8,5,13,3,4,7,0.00,51.17,53.85
10,004,02,010,0031,0065,652,37,689,1189,0,8,5,13,3,4,7,0.00,57.95,53.85
10,004,02,010,0031,0066,674,45,719,1290,0,8,5,13,3,4,7,0.00,55.74,53.85
10,004,02,010,0024,0067,588,47,635,1121,0,8,5,13,3,4,7,0.00,56.65,53.85
10,004,02,010,0024,0068,785,28,813,1295,0,8,5,13,3,4,7,0.00,62.78,53.85
10,004,02,010,0024,0069,690,34,724,1224,0,8,5,13,3,4,7,0.00,59.15,53.85
10,004,02,010,0007,0000,3714,268,3982,7960,0,8,5,13,3,4,7,0.00,50.03,53.85
10,004,02,010,0025,0070,532,27,559,1184,0,8,5,13,3,4,7,0.00,47.21,53.85
10,004,02,010,0025,0071,723,25,748,1265,0,8,5,13,3,4,7,0.00,59.13,53.85
10,004,02,010,0025,0072,703,26,729,1165,0,8,5,13,3,4,7,0.00,62.58,53.85
10,004,02,010,0025,0073,680,24,704,1192,0,8,5,13,3,4,7,0.00,59.06,53.85
10,004,02,010,0025,0074,644,32,676,1305,0,8,5,13,3,4,7,0.00,51.80,53.85
10,004,02,010,0007,0075,530,36,566,1224,0,8,5,13,3,4,7,0.00,46.24,53.85
10,004,02,010,0007,0076,613,50,663,1255,0,8,5,13,3,4,7,0.00,52.83,53.85
10,004,02,010,0007,0077,496,39,535,1072,0,8,5,13,3,4,7,0.00,49.91,53.85
10,004,02,010,0007,0078,591,41,632,1447,0,8,5,13,3,4,7,0.00,43.68,53.85
10,004,02,010,0007,0079,569,46,615,1087,0,8,5,13,3,4,7,0.00,56.58,53.85
10,004,02,010,0008,0000,4406,262,4668,8373,0,8,5,13,3,4,7,0.00,55.75,53.85
10,004,02,010,0007,0080,469,31,500,922,0,8,5,13,3,4,7,0.00,54.23,53.85
10,004,02,010,0007,0081,446,25,471,953,0,8,5,13,3,4,7,0.00,49.42,53.85
10,004,02,010,0008,0082,530,35,565,985,0,8,5,13,3,4,7,0.00,57.36,53.85
10,004,02,010,0008,0083,526,35,561,1014,0,8,5,13,3,4,7,0.00,55.33,53.85
10,004,02,010,0008,0084,556,34,590,1095,0,8,5,13,3,4,7,0.00,53.88,53.85
10,004,02,010,0008,0085,514,28,542,1057,0,8,5,13,3,4,7,0.00,51.28,53.85
10,004,02,010,0008,0086,589,36,625,1121,0,8,5,13,3,4,7,0.00,55.75,53.85
10,004,02,010,0008,0087,646,38,684,1091,0,8,5,13,3,4,7,0.00,62.69,53.85
10,004,02,010,0008,0088,520,22,542,1026,0,8,5,13,3,4,7,0.00,52.83,53.85
10,004,02,010,0008,0089,525,34,559,984,0,8,5,13,3,4,7,0.00,56.81,53.85
10,004,02,010,0009,0000,2708,94,2802,5677,0,8,5,13,3,4,7,0.00,49.36,53.85
10,004,02,010,0026,0090,518,25,543,983,0,8,5,13,3,4,7,0.00,55.24,53.85
10,004,02,010,0026,0091,637,31,668,1083,0,8,5,13,3,4,7,0.00,61.68,53.85
10,004,02,010,0026,0092,555,25,580,1055,0,8,5,13,3,4,7,0.00,54.98,53.85
10,004,02,010,0009,0093,651,18,669,1236,0,8,5,13,3,4,7,0.00,54.13,53.85
10,004,02,010,0009,0094,483,22,505,1019,0,8,5,13,3,4,7,0.00,49.56,53.85
10,004,02,010,0009,0095,650,25,675,1177,0,8,5,13,3,4,7,0.00,57.35,53.85
10,004,02,010,0009,0096,577,19,596,1137,0,8,5,13,3,4,7,0.00,52.42,53.85
10,004,02,010,0009,0097,347,10,357,1108,0,8,5,13,3,4,7,0.00,32.22,53.85
10,004,02,010,0010,0098,542,21,563,985,0,8,5,13,3,4,7,0.00,57.16,53.85
10,004,02,010,0010,0099,439,19,458,829,0,8,5,13,3,4,7,0.00,55.25,53.85
10,004,02,010,0010,0000,3128,142,3270,5841,0,8,5,13,3,4,7,0.00,55.98,53.85
10,004,02,010,0010,0100,482,16,498,841,0,8,5,13,3,4,7,0.00,59.22,53.85
10,004,02,010,0010,0101,494,31,525,1017,0,8,5,13,3,4,7,0.00,51.62,53.85
10,004,02,010,0010,0102,640,25,665,1177,0,8,5,13,3,4,7,0.00,56.50,53.85
10,004,02,010,0010,0103,531,30,561,992,0,8,5,13,3,4,7,0.00,56.55,53.85
10,004,02,010,0024,0000,2063,109,2172,3640,0,8,5,13,3,4,7,0.00,59.67,53.85
10,004,02,010,0025,0000,3282,134,3416,6111,0,8,5,13,3,4,7,0.00,55.90,53.85
10,004,02,010,0026,0000,1710,81,1791,3121,0,8,5,13,3,4,7,0.00,57.39,53.85
10,004,02,010,0031,0000,3431,185,3616,6291,0,8,5,13,3,4,7,0.00,57.48,53.85
10,004,02,020,0007,0000,2263,122,2385,4376,0,4,0,4,3,0,3,0.00,54.50,75.00
10,004,02,020,0008,0000,401,21,422,592,0,4,0,4,3,0,3,0.00,71.28,75.00
10,004,02,020,0009,0000,1318,57,1375,2871,0,4,0,4,3,0,3,0.00,47.89,75.00
10,004,02,020,0010,0000,675,37,712,1242,0,4,0,4,3,0,3,0.00,57.33,75.00
10,004,02,020,0007,0153,544,26,570,1084,0,4,0,4,3,0,3,0.00,52.58,75.00
10,004,02,020,0007,0154,516,21,537,983,0,4,0,4,3,0,3,0.00,54.63,75.00
10,004,02,020,0007,0155,606,34,640,1207,0,4,0,4,3,0,3,0.00,53.02,75.00
10,004,02,020,0007,0156,597,41,638,1102,0,4,0,4,3,0,3,0.00,57.89,75.00
10,004,02,020,0020,0157,407,22,429,780,0,4,0,4,3,0,3,0.00,55.00,75.00
10,004,02,020,0020,0158,439,26,465,811,0,4,0,4,3,0,3,0.00,57.34,75.00
10,004,02,020,0022,0159,630,14,644,968,0,4,0,4,3,0,3,0.00,66.53,75.00
10,004,02,020,0008,0160,401,21,422,592,0,4,0,4,3,0,3,0.00,71.28,75.00
10,004,02,020,0009,0161,356,24,380,931,0,4,0,4,3,0,3,0.00,40.82,75.00
10,004,02,020,0009,0162,544,7,551,903,0,4,0,4,3,0,3,0.00,61.02,75.00
10,004,02,020,0009,0163,418,26,444,1037,0,4,0,4,3,0,3,0.00,42.82,75.00
10,004,02,020,0010,0164,287,14,301,526,0,4,0,4,3,0,3,0.00,57.22,75.00
10,004,02,020,0010,0165,388,23,411,716,0,4,0,4,3,0,3,0.00,57.40,75.00
10,004,02,020,0024,0166,361,24,385,695,0,4,0,4,3,0,3,0.00,55.40,75.00
10,004,02,020,0024,0167,339,38,377,737,0,4,0,4,3,0,3,0.00,51.15,75.00
10,004,02,020,0020,0000,846,48,894,1591,0,4,0,4,3,0,3,0.00,56.19,75.00
10,004,02,020,0022,0000,630,14,644,968,0,4,0,4,3,0,3,0.00,66.53,75.00
10,004,02,020,0024,0000,700,62,762,1432,0,4,0,4,3,0,3,0.00,53.21,75.00
10,004,02,030,0015,0000,738,19,757,1054,0,4,0,4,2,0,2,0.00,71.82,50.00
10,004,02,030,0016,0000,860,23,883,1269,0,4,0,4,2,0,2,0.00,69.58,50.00
10,004,02,030,0017,0000,263,4,267,386,0,4,0,4,2,0,2,0.00,69.17,50.00
10,004,02,030,0018,0000,449,15,464,667,0,4,0,4,2,0,2,0.00,69.57,50.00
10,004,02,030,0019,0000,395,9,404,544,0,4,0,4,2,0,2,0.00,74.26,50.00
10,004,02,030,0016,0228,499,13,512,692,0,4,0,4,2,0,2,0.00,73.99,50.00
10,004,02,030,0016,0229,361,10,371,577,0,4,0,4,2,0,2,0.00,64.30,50.00
10,004,02,030,0017,0230,263,4,267,386,0,4,0,4,2,0,2,0.00,69.17,50.00
10,004,02,030,0018,0231,449,15,464,667,0,4,0,4,2,0,2,0.00,69.57,50.00
10,004,02,030,0019,0232,395,9,404,544,0,4,0,4,2,0,2,0.00,74.26,50.00
10,004,02,030,0015,0233,738,19,757,1054,0,4,0,4,2,0,2,0.00,71.82,50.00
10,004,02,040,0008,0000,2249,67,2316,3626,0,8,0,8,3,0,3,0.00,63.87,37.50
10,004,02,040,0011,0000,368,9,377,516,0,8,0,8,3,0,3,0.00,73.06,37.50
10,004,02,040,0012,0000,575,15,590,858,0,8,0,8,3,0,3,0.00,68.76,37.50
10,004,02,040,0019,0000,541,24,565,796,0,8,0,8,3,0,3,0.00,70.98,37.50
10,004,02,040,0008,0258,700,19,719,1160,0,8,0,8,3,0,3,0.00,61.98,37.50
10,004,02,040,0008,0259,789,32,821,1246,0,8,0,8,3,0,3,0.00,65.89,37.50
10,004,02,040,0008,0260,760,16,776,1220,0,8,0,8,3,0,3,0.00,63.61,37.50
10,004,02,040,0019,0261,541,24,565,796,0,8,0,8,3,0,3,0.00,70.98,37.50
10,004,02,040,0011,0266,368,9,377,516,0,8,0,8,3,0,3,0.00,73.06,37.50
10,004,02,040,0012,0267,575,15,590,858,0,8,0,8,3,0,3,0.00,68.76,37.50
10,004,02,050,0011,0000,1533,61,1594,2410,0,5,3,8,3,2,5,0.00,66.14,62.50
10,004,02,050,0012,0000,861,38,899,1423,0,5,3,8,3,2,5,0.00,63.18,62.50
10,004,02,050,0013,0000,1196,58,1254,2128,0,5,3,8,3,2,5,0.00,58.93,62.50
10,004,02,050,0014,0000,2445,129,2574,5010,0,5,3,8,3,2,5,0.00,51.38,62.50
10,004,02,050,0015,0000,1611,80,1691,3073,0,5,3,8,3,2,5,0.00,55.03,62.50
10,004,02,050,0016,0000,2880,102,2982,6014,0,5,3,8,3,2,5,0.00,49.58,62.50
10,004,02,050,0020,0000,2089,72,2161,4082,0,5,3,8,3,2,5,0.00,52.94,62.50
10,004,02,050,0013,0303,605,36,641,1042,0,5,3,8,3,2,5,0.00,61.52,62.50
10,004,02,050,0013,0304,591,22,613,1086,0,5,3,8,3,2,5,0.00,56.45,62.50
10,004,02,050,0011,0311,810,36,846,1196,0,5,3,8,3,2,5,0.00,70.74,62.50
10,004,02,050,0011,0312,723,25,748,1214,0,5,3,8,3,2,5,0.00,61.61,62.50
10,004,02,050,0012,0313,861,38,899,1423,0,5,3,8,3,2,5,0.00,63.18,62.50
10,004,02,050,0016,0314,693,22,715,1346,0,5,3,8,3,2,5,0.00,53.12,62.50
10,004,02,050,0016,0315,513,16,529,962,0,5,3,8,3,2,5,0.00,54.99,62.50
10,004,02,050,0016,0316,545,17,562,1160,0,5,3,8,3,2,5,0.00,48.45,62.50
10,004,02,050,0016,0317,640,23,663,1378,0,5,3,8,3,2,5,0.00,48.11,62.50
10,004,02,050,0016,0318,489,24,513,1168,0,5,3,8,3,2,5,0.00,43.92,62.50
10,004,02,050,0014,0319,536,24,560,1006,0,5,3,8,3,2,5,0.00,55.67,62.50
10,004,02,050,0014,0320,560,36,596,1327,0,5,3,8,3,2,5,0.00,44.91,62.50
10,004,02,050,0014,0321,656,37,693,1229,0,5,3,8,3,2,5,0.00,56.39,62.50
10,004,02,050,0014,0322,693,32,725,1448,0,5,3,8,3,2,5,0.00,50.07,62.50
10,004,02,050,0020,0323,825,21,846,1446,0,5,3,8,3,2,5,0.00,58.51,62.50
10,004,02,050,0020,0324,660,25,685,1394,0,5,3,8,3,2,5,0.00,49.14,62.50
10,004,02,050,0020,0325,604,26,630,1242,0,5,3,8,3,2,5,0.00,50.72,62.50
10,004,02,050,0015,0326,474,26,500,1010,0,5,3,8,3,2,5,0.00,49.50,62.50
10,004,02,050,0015,0327,667,36,703,1149,0,5,3,8,3,2,5,0.00,61.18,62.50
10,004,02,050,0015,0328,470,18,488,914,0,5,3,8,3,2,5,0.00,53.39,62.50
10,004,02,060,0002,0000,962,69,1031,1708,0,2,0,2,2,0,2,0.00,60.36,100.00
10,004,02,060,0004,0000,1294,120,1414,2683,0,2,0,2,2,0,2,0.00,52.70,100.00
10,004,02,060,0006,0000,528,48,576,785,0,2,0,2,2,0,2,0.00,73.38,100.00
10,004,02,060,0009,0000,1067,99,1166,2010,0,2,0,2,2,0,2,0.00,58.01,100.00
10,004,02,060,0002,0337,446,39,485,748,0,2,0,2,2,0,2,0.00,64.84,100.00
10,004,02,060,0002,0338,516,30,546,960,0,2,0,2,2,0,2,0.00,56.88,100.00
10,004,02,060,0006,0339,528,48,576,785,0,2,0,2,2,0,2,0.00,73.38,100.00
10,004,02,060,0004,0340,430,42,472,994,0,2,0,2,2,0,2,0.00,47.48,100.00
10,004,02,060,0004,0341,422,35,457,809,0,2,0,2,2,0,2,0.00,56.49,100.00
10,004,02,060,0004,0342,442,43,485,880,0,2,0,2,2,0,2,0.00,55.11,100.00
10,004,02,060,0009,0343,499,57,556,999,0,2,0,2,2,0,2,0.00,55.66,100.00
10,004,02,060,0009,0344,568,42,610,1011,0,2,0,2,2,0,2,0.00,60.34,100.00
10,004,02,070,0004,0000,272,18,290,400,0,2,0,2,2,0,2,0.00,72.50,100.00
10,004,02,070,0005,0000,1335,69,1404,2526,0,2,0,2,2,0,2,0.00,55.58,100.00
10,004,02,070,0004,0377,272,18,290,400,0,2,0,2,2,0,2,0.00,72.50,100.00
10,004,02,070,0005,0378,653,31,684,1208,0,2,0,2,2,0,2,0.00,56.62,100.00
10,004,02,070,0005,0379,682,38,720,1318,0,2,0,2,2,0,2,0.00,54.63,100.00
10,004,02,080,0005,0000,252,2,254,310,0,6,2,8,3,1,4,0.00,81.94,50.00
10,004,02,080,0009,0000,1007,22,1029,1456,0,6,2,8,3,1,4,0.00,70.67,50.00
10,004,02,080,0010,0000,1087,26,1113,1593,0,6,2,8,3,1,4,0.00,69.87,50.00
10,004,02,080,0005,0399,252,2,254,310,0,6,2,8,3,1,4,0.00,81.94,50.00
10,004,02,080,0009,0406,473,10,483,645,0,6,2,8,3,1,4,0.00,74.88,50.00
10,004,02,080,0009,0407,534,12,546,811,0,6,2,8,3,1,4,0.00,67.32,50.00
10,004,02,080,0010,0408,507,17,524,761,0,6,2,8,3,1,4,0.00,68.86,50.00
10,004,02,080,0010,0409,580,9,589,832,0,6,2,8,3,1,4,0.00,70.79,50.00
10,004,02,090,0001,0000,729,22,751,1087,0,4,3,7,2,2,4,0.00,69.09,57.14
10,004,02,090,0003,0000,1560,46,1606,2452,0,4,3,7,2,2,4,0.00,65.50,57.14
10,004,02,090,0004,0000,553,16,569,804,0,4,3,7,2,2,4,0.00,70.77,57.14
10,004,02,090,0001,0410,729,22,751,1087,0,4,3,7,2,2,4,0.00,69.09,57.14
10,004,02,090,0003,0413,588,17,605,876,0,4,3,7,2,2,4,0.00,69.06,57.14
10,004,02,090,0003,0414,493,12,505,774,0,4,3,7,2,2,4,0.00,65.25,57.14
10,004,02,090,0003,0415,479,17,496,802,0,4,3,7,2,2,4,0.00,61.85,57.14
10,004,02,090,0004,0416,553,16,569,804,0,4,3,7,2,2,4,0.00,70.77,57.14
10,004,02,100,0003,0000,605,42,647,975,0,4,0,4,2,0,2,0.00,66.36,50.00
10,004,02,100,0004,0000,935,22,957,1133,0,4,0,4,2,0,2,0.00,84.47,50.00
10,004,02,100,0003,0427,605,42,647,975,0,4,0,4,2,0,2,0.00,66.36,50.00
10,004,02,100,0004,0428,935,22,957,1133,0,4,0,4,2,0,2,0.00,84.47,50.00
10,004,02,110,0003,0000,431,31,462,552,0,0,4,4,0,4,4,0.00,83.70,100.00
10,004,02,110,0004,0000,888,96,984,1342,0,0,4,4,0,4,4,0.00,73.32,100.00
10,004,02,110,0006,0000,568,61,629,844,0,0,4,4,0,4,4,0.00,74.53,100.00
10,004,02,110,0003,0436,431,31,462,552,0,0,4,4,0,4,4,0.00,83.70,100.00
10,004,02,110,0004,0439,462,49,511,646,0,0,4,4,0,4,4,0.00,79.10,100.00
10,004,02,110,0004,0440,426,47,473,696,0,0,4,4,0,4,4,0.00,67.96,100.00
10,004,02,110,0006,0441,282,26,308,440,0,0,4,4,0,4,4,0.00,70.00,100.00
10,004,02,110,0006,0442,286,35,321,404,0,0,4,4,0,4,4,0.00,79.46,100.00
10,004,02,120,0001,0000,431,10,441,552,0,7,0,7,2,0,2,0.00,79.89,28.57
10,004,02,120,0004,0000,498,14,512,622,0,7,0,7,2,0,2,0.00,82.32,28.57
10,004,02,120,0005,0000,831,8,839,1086,0,7,0,7,2,0,2,0.00,77.26,28.57
10,004,02,120,0001,0445,142,3,145,196,0,7,0,7,2,0,2,0.00,73.98,28.57
10,004,02,120,0001,0446,289,7,296,356,0,7,0,7,2,0,2,0.00,83.15,28.57
10,004,02,120,0005,0449,384,6,390,506,0,7,0,7,2,0,2,0.00,77.08,28.57
10,004,02,120,0005,0450,447,2,449,580,0,7,0,7,2,0,2,0.00,77.41,28.57
10,004,02,120,0004,0451,498,14,512,622,0,7,0,7,2,0,2,0.00,82.32,28.57
10,004,02,130,0004,0000,1105,16,1121,1416,0,7,1,8,2,1,3,0.00,79.17,37.50
10,004,02,130,0004,0460,417,6,423,542,0,7,1,8,2,1,3,0.00,78.04,37.50
10,004,02,130,0004,0461,688,10,698,874,0,7,1,8,2,1,3,0.00,79.86,37.50
10,004,00,030,0000,0000,17584,568,18152,28318,32981,17,3,20,9,2,11,85.86,64.10,55.00
10,004,01,030,0000,0000,7779,201,7980,12276,14584,7,3,10,3,2,5,84.17,65.00,50.00
10,004,02,030,0000,0000,2705,70,2775,3920,4469,4,0,4,2,0,2,87.72,70.79,50.00
10,004,03,030,0000,0000,3556,180,3736,6392,7316,3,0,3,2,0,2,87.37,58.45,66.67
10,004,04,030,0000,0000,3544,117,3661,5730,6612,3,0,3,2,0,2,86.66,63.89,66.67
10,004,03,010,0011,0104,602,54,656,1142,0,3,0,3,2,0,2,0.00,57.44,66.67
10,004,03,010,0011,0105,561,46,607,1107,0,3,0,3,2,0,2,0.00,54.83,66.67
10,004,03,010,0011,0106,576,36,612,1125,0,3,0,3,2,0,2,0.00,54.40,66.67
10,004,03,010,0011,0107,555,39,594,1146,0,3,0,3,2,0,2,0.00,51.83,66.67
10,004,03,010,0011,0108,609,32,641,1155,0,3,0,3,2,0,2,0.00,55.50,66.67
10,004,03,010,0011,0109,553,34,587,1137,0,3,0,3,2,0,2,0.00,51.63,66.67
10,004,03,010,0011,0000,3456,241,3697,6812,0,3,0,3,2,0,2,0.00,54.27,66.67
10,004,03,010,0022,0110,596,43,639,1102,0,3,0,3,2,0,2,0.00,57.99,66.67
10,004,03,010,0022,0111,523,65,588,1164,0,3,0,3,2,0,2,0.00,50.52,66.67
10,004,03,010,0022,0112,505,72,577,1137,0,3,0,3,2,0,2,0.00,50.75,66.67
10,004,03,010,0022,0113,605,64,669,1301,0,3,0,3,2,0,2,0.00,51.42,66.67
10,004,03,010,0022,0114,630,66,696,1195,0,3,0,3,2,0,2,0.00,58.24,66.67
10,004,03,010,0012,0115,575,37,612,1031,0,3,0,3,2,0,2,0.00,59.36,66.67
10,004,03,010,0012,0116,486,27,513,855,0,3,0,3,2,0,2,0.00,60.00,66.67
10,004,03,010,0012,0117,701,41,742,1208,0,3,0,3,2,0,2,0.00,61.42,66.67
10,004,03,010,0012,0118,668,38,706,1192,0,3,0,3,2,0,2,0.00,59.23,66.67
10,004,03,010,0012,0000,2430,143,2573,4286,0,3,0,3,2,0,2,0.00,60.03,66.67
10,004,03,010,0022,0000,2859,310,3169,5899,0,3,0,3,2,0,2,0.00,53.72,66.67
10,004,03,020,0011,0000,739,36,775,1262,0,4,2,6,3,1,4,0.00,61.41,66.67
10,004,03,020,0012,0000,1871,95,1966,3549,0,4,2,6,3,1,4,0.00,55.40,66.67
10,004,03,020,0013,0000,1772,75,1847,3169,0,4,2,6,3,1,4,0.00,58.28,66.67
10,004,03,020,0014,0000,3520,138,3658,7157,0,4,2,6,3,1,4,0.00,51.11,66.67
10,004,03,020,0012,0168,450,20,470,857,0,4,2,6,3,1,4,0.00,54.84,66.67
10,004,03,020,0012,0169,447,21,468,916,0,4,2,6,3,1,4,0.00,51.09,66.67
10,004,03,020,0012,0170,445,21,466,883,0,4,2,6,3,1,4,0.00,52.77,66.67
10,004,03,020,0012,0171,529,33,562,893,0,4,2,6,3,1,4,0.00,62.93,66.67
10,004,03,020,0013,0172,501,17,518,917,0,4,2,6,3,1,4,0.00,56.49,66.67
10,004,03,020,0013,0173,614,24,638,1154,0,4,2,6,3,1,4,0.00,55.29,66.67
10,004,03,020,0013,0174,657,34,691,1098,0,4,2,6,3,1,4,0.00,62.93,66.67
10,004,03,020,0011,0175,370,18,388,649,0,4,2,6,3,1,4,0.00,59.78,66.67
10,004,03,020,0011,0176,369,18,387,613,0,4,2,6,3,1,4,0.00,63.13,66.67
10,004,03,020,0023,0177,566,22,588,1131,0,4,2,6,3,1,4,0.00,51.99,66.67
10,004,03,020,0023,0178,617,21,638,1073,0,4,2,6,3,1,4,0.00,59.46,66.67
10,004,03,020,0023,0179,604,32,636,1109,0,4,2,6,3,1,4,0.00,57.35,66.67
10,004,03,020,0023,0180,650,29,679,1206,0,4,2,6,3,1,4,0.00,56.30,66.67
10,004,03,020,0023,0181,638,31,669,1160,0,4,2,6,3,1,4,0.00,57.67,66.67
10,004,03,020,0023,0182,588,26,614,1091,0,4,2,6,3,1,4,0.00,56.28,66.67
10,004,03,020,0014,0183,566,28,594,1184,0,4,2,6,3,1,4,0.00,50.17,66.67
10,004,03,020,0014,0184,333,16,349,959,0,4,2,6,3,1,4,0.00,36.39,66.67
10,004,03,020,0014,0185,621,24,645,1162,0,4,2,6,3,1,4,0.00,55.51,66.67
10,004,03,020,0014,0186,485,12,497,1085,0,4,2,6,3,1,4,0.00,45.81,66.67
10,004,03,020,0014,0187,404,15,419,808,0,4,2,6,3,1,4,0.00,51.86,66.67
10,004,03,020,0014,0188,507,19,526,912,0,4,2,6,3,1,4,0.00,57.68,66.67
10,004,03,020,0014,0189,604,24,628,1047,0,4,2,6,3,1,4,0.00,59.98,66.67
10,004,03,020,0025,0190,352,13,365,541,0,4,2,6,3,1,4,0.00,67.47,66.67
10,004,03,020,0023,0000,3663,161,3824,6770,0,4,2,6,3,1,4,0.00,56.48,66.67
10,004,03,020,0025,0000,352,13,365,541,0,4,2,6,3,1,4,0.00,67.47,66.67
10,004,03,030,0001,0000,677,17,694,1056,0,3,0,3,2,0,2,0.00,65.72,66.67
10,004,03,030,0002,0000,518,19,537,818,0,3,0,3,2,0,2,0.00,65.65,66.67
10,004,03,030,0003,0000,2361,144,2505,4518,0,3,0,3,2,0,2,0.00,55.44,66.67
10,004,03,030,0001,0234,677,17,694,1056,0,3,0,3,2,0,2,0.00,65.72,66.67
10,004,03,030,0002,0235,518,19,537,818,0,3,0,3,2,0,2,0.00,65.65,66.67
10,004,03,030,0003,0236,601,20,621,1021,0,3,0,3,2,0,2,0.00,60.82,66.67
10,004,03,030,0003,0237,567,30,597,982,0,3,0,3,2,0,2,0.00,60.79,66.67
10,004,03,030,0003,0238,357,24,381,771,0,3,0,3,2,0,2,0.00,49.42,66.67
10,004,03,030,0003,0239,435,33,468,881,0,3,0,3,2,0,2,0.00,53.12,66.67
10,004,03,030,0003,0240,401,37,438,863,0,3,0,3,2,0,2,0.00,50.75,66.67
10,004,03,040,0009,0000,731,23,754,1181,0,2,0,2,1,0,1,0.00,63.84,50.00
10,004,03,040,0010,0000,315,12,327,497,0,2,0,2,1,0,1,0.00,65.79,50.00
10,004,03,040,0013,0000,307,7,314,422,0,2,0,2,1,0,1,0.00,74.41,50.00
10,004,03,040,0020,0000,586,15,601,858,0,2,0,2,1,0,1,0.00,70.05,50.00
10,004,03,040,0009,0262,731,23,754,1181,0,2,0,2,1,0,1,0.00,63.84,50.00
10,004,03,040,0020,0263,586,15,601,858,0,2,0,2,1,0,1,0.00,70.05,50.00
10,004,03,040,0010,0264,315,12,327,497,0,2,0,2,1,0,1,0.00,65.79,50.00
10,004,03,040,0013,0265,307,7,314,422,0,2,0,2,1,0,1,0.00,74.41,50.00
10,004,03,050,0005,0000,2116,70,2186,3258,0,5,0,5,3,0,3,0.00,67.10,60.00
10,004,03,050,0008,0000,1775,56,1831,3063,0,5,0,5,3,0,3,0.00,59.78,60.00
10,004,03,050,0009,0000,724,15,739,997,0,5,0,5,3,0,3,0.00,74.12,60.00
10,004,03,050,0010,0000,1625,67,1692,2652,0,5,0,5,3,0,3,0.00,63.80,60.00
10,004,03,050,0018,0000,2077,113,2190,3618,0,5,0,5,3,0,3,0.00,60.53,60.00
10,004,03,050,0005,0290,728,23,751,1142,0,5,0,5,3,0,3,0.00,65.76,60.00
10,004,03,050,0005,0291,761,28,789,1191,0,5,0,5,3,0,3,0.00,66.25,60.00
10,004,03,050,0005,0292,627,19,646,925,0,5,0,5,3,0,3,0.00,69.84,60.00
10,004,03,050,0018,0293,693,30,723,1144,0,5,0,5,3,0,3,0.00,63.20,60.00
10,004,03,050,0018,0294,755,49,804,1264,0,5,0,5,3,0,3,0.00,63.61,60.00
10,004,03,050,0018,0295,629,34,663,1210,0,5,0,5,3,0,3,0.00,54.79,60.00
10,004,03,050,0008,0305,684,24,708,1131,0,5,0,5,3,0,3,0.00,62.60,60.00
10,004,03,050,0008,0306,459,16,475,752,0,5,0,5,3,0,3,0.00,63.16,60.00
10,004,03,050,0008,0307,632,16,648,1180,0,5,0,5,3,0,3,0.00,54.92,60.00
10,004,03,050,0009,0308,724,15,739,997,0,5,0,5,3,0,3,0.00,74.12,60.00
10,004,03,050,0010,0309,738,34,772,1236,0,5,0,5,3,0,3,0.00,62.46,60.00
10,004,03,050,0010,0310,887,33,920,1416,0,5,0,5,3,0,3,0.00,64.97,60.00
10,004,03,060,0010,0000,1380,109,1489,2762,0,2,0,2,2,0,2,0.00,53.91,100.00
10,004,03,060,0014,0000,1590,122,1712,3448,0,2,0,2,2,0,2,0.00,49.65,100.00
10,004,03,060,0015,0000,2022,213,2235,4266,0,2,0,2,2,0,2,0.00,52.39,100.00
10,004,03,060,0010,0345,678,68,746,1302,0,2,0,2,2,0,2,0.00,57.30,100.00
10,004,03,060,0010,0346,702,41,743,1460,0,2,0,2,2,0,2,0.00,50.89,100.00
10,004,03,060,0014,0347,577,47,624,1272,0,2,0,2,2,0,2,0.00,49.06,100.00
10,004,03,060,0014,0348,528,42,570,1105,0,2,0,2,2,0,2,0.00,51.58,100.00
10,004,03,060,0014,0349,485,33,518,1071,0,2,0,2,2,0,2,0.00,48.37,100.00
10,004,03,060,0015,0350,465,57,522,1042,0,2,0,2,2,0,2,0.00,50.10,100.00
10,004,03,060,0015,0351,459,55,514,968,0,2,0,2,2,0,2,0.00,53.10,100.00
10,004,03,060,0015,0352,530,37,567,1017,0,2,0,2,2,0,2,0.00,55.75,100.00
10,004,03,060,0015,0353,568,64,632,1239,0,2,0,2,2,0,2,0.00,51.01,100.00
10,004,03,070,0006,0000,942,34,976,1496,0,3,0,3,2,0,2,0.00,65.24,66.67
10,004,03,070,0007,0000,381,22,403,589,0,3,0,3,2,0,2,0.00,68.42,66.67
10,004,03,070,0008,0000,491,18,509,746,0,3,0,3,2,0,2,0.00,68.23,66.67
10,004,03,070,0006,0380,467,16,483,746,0,3,0,3,2,0,2,0.00,64.75,66.67
10,004,03,070,0006,0381,475,18,493,750,0,3,0,3,2,0,2,0.00,65.73,66.67
10,004,03,070,0007,0382,381,22,403,589,0,3,0,3,2,0,2,0.00,68.42,66.67
10,004,03,070,0008,0383,491,18,509,746,0,3,0,3,2,0,2,0.00,68.23,66.67
10,004,03,080,0006,0000,606,17,623,840,0,3,0,3,2,0,2,0.00,74.17,66.67
10,004,03,080,0011,0000,580,9,589,760,0,3,0,3,2,0,2,0.00,77.50,66.67
10,004,03,080,0006,0400,606,17,623,840,0,3,0,3,2,0,2,0.00,74.17,66.67
10,004,03,080,0011,0401,197,3,200,257,0,3,0,3,2,0,2,0.00,77.82,66.67
10,004,03,080,0011,0402,383,6,389,503,0,3,0,3,2,0,2,0.00,77.34,66.67
10,004,03,090,0007,0000,313,31,344,525,0,0,1,1,0,1,1,0.00,65.52,100.00
10,004,03,090,0008,0000,213,14,227,305,0,0,1,1,0,1,1,0.00,74.43,100.00
10,004,03,090,0009,0000,164,11,175,278,0,0,1,1,0,1,1,0.00,62.95,100.00
10,004,03,090,0007,0412,313,31,344,525,0,0,1,1,0,1,1,0.00,65.52,100.00
10,004,03,090,0008,0419,213,14,227,305,0,0,1,1,0,1,1,0.00,74.43,100.00
10,004,03,090,0009,0420,164,11,175,278,0,0,1,1,0,1,1,0.00,62.95,100.00
10,004,03,100,0005,0000,491,82,573,780,0,1,0,1,1,0,1,0.00,73.46,100.00
10,004,03,100,0006,0000,459,78,537,711,0,1,0,1,1,0,1,0.00,75.53,100.00
10,004,03,100,0006,0429,459,78,537,711,0,1,0,1,1,0,1,0.00,75.53,100.00
10,004,03,100,0005,0430,491,82,573,780,0,1,0,1,1,0,1,0.00,73.46,100.00
10,004,03,120,0006,0000,864,25,889,1285,0,7,1,8,2,1,3,0.00,69.18,37.50
10,004,03,120,0007,0000,1220,31,1251,1579,0,7,1,8,2,1,3,0.00,79.23,37.50
10,004,03,120,0006,0452,414,11,425,602,0,7,1,8,2,1,3,0.00,70.60,37.50
10,004,03,120,0006,0453,372,10,382,567,0,7,1,8,2,1,3,0.00,67.37,37.50
10,004,03,120,0006,0454,78,4,82,116,0,7,1,8,2,1,3,0.00,70.69,37.50
10,004,03,120,0007,0455,384,13,397,482,0,7,1,8,2,1,3,0.00,82.37,37.50
10,004,03,120,0007,0456,589,13,602,787,0,7,1,8,2,1,3,0.00,76.49,37.50
10,004,03,120,0007,0457,247,5,252,310,0,7,1,8,2,1,3,0.00,81.29,37.50
10,004,03,130,0002,0000,570,10,580,708,0,5,1,6,2,0,2,0.00,81.92,33.33
10,004,03,130,0003,0000,286,12,298,359,0,5,1,6,2,0,2,0.00,83.01,33.33
10,004,03,130,0002,0462,570,10,580,708,0,5,1,6,2,0,2,0.00,81.92,33.33
10,004,03,130,0003,0463,286,12,298,359,0,5,1,6,2,0,2,0.00,83.01,33.33
10,004,00,040,0000,0000,15523,433,15956,23201,27146,21,2,23,10,1,11,85.47,68.77,47.83
10,004,01,040,0000,0000,5838,153,5991,9093,10844,6,2,8,3,1,4,83.85,65.89,50.00
10,004,02,040,0000,0000,3733,115,3848,5796,6901,8,0,8,3,0,3,83.99,66.39,37.50
10,004,03,040,0000,0000,1939,57,1996,2958,3322,2,0,2,1,0,1,89.04,67.48,50.00
10,004,04,040,0000,0000,4013,108,4121,5354,6079,5,0,5,3,0,3,88.07,76.97,60.00
10,004,04,010,0013,0119,524,40,564,938,0,3,0,3,2,0,2,0.00,60.13,66.67
10,004,04,010,0013,0120,500,48,548,981,0,3,0,3,2,0,2,0.00,55.86,66.67
10,004,04,010,0014,0121,607,76,683,1080,0,3,0,3,2,0,2,0.00,63.24,66.67
10,004,04,010,0014,0122,683,65,748,1316,0,3,0,3,2,0,2,0.00,56.84,66.67
10,004,04,010,0023,0123,608,40,648,1042,0,3,0,3,2,0,2,0.00,62.19,66.67
10,004,04,010,0015,0124,601,59,660,965,0,3,0,3,2,0,2,0.00,68.39,66.67
10,004,04,010,0015,0125,699,48,747,1186,0,3,0,3,2,0,2,0.00,62.98,66.67
10,004,04,010,0016,0126,680,58,738,1160,0,3,0,3,2,0,2,0.00,63.62,66.67
10,004,04,010,0019,0127,505,34,539,885,0,3,0,3,2,0,2,0.00,60.90,66.67
10,004,04,010,0019,0128,380,43,423,779,0,3,0,3,2,0,2,0.00,54.30,66.67
10,004,04,010,0017,0129,664,33,697,940,0,3,0,3,2,0,2,0.00,74.15,66.67
10,004,04,010,0013,0000,1024,88,1112,1919,0,3,0,3,2,0,2,0.00,57.95,66.67
10,004,04,010,0017,0130,460,14,474,646,0,3,0,3,2,0,2,0.00,73.37,66.67
10,004,04,010,0020,0131,497,14,511,809,0,3,0,3,2,0,2,0.00,63.16,66.67
10,004,04,010,0020,0132,500,24,524,800,0,3,0,3,2,0,2,0.00,65.50,66.67
10,004,04,010,0018,0133,584,31,615,904,0,3,0,3,2,0,2,0.00,68.03,66.67
10,004,04,010,0018,0134,577,23,600,911,0,3,0,3,2,0,2,0.00,65.86,66.67
10,004,04,010,0014,0000,1290,141,1431,2396,0,3,0,3,2,0,2,0.00,59.72,66.67
10,004,04,010,0015,0000,1300,107,1407,2151,0,3,0,3,2,0,2,0.00,65.41,66.67
10,004,04,010,0016,0000,680,58,738,1160,0,3,0,3,2,0,2,0.00,63.62,66.67
10,004,04,010,0017,0000,1124,47,1171,1586,0,3,0,3,2,0,2,0.00,73.83,66.67
10,004,04,010,0018,0000,1161,54,1215,1815,0,3,0,3,2,0,2,0.00,66.94,66.67
10,004,04,010,0019,0000,885,77,962,1664,0,3,0,3,2,0,2,0.00,57.81,66.67
10,004,04,010,0020,0000,997,38,1035,1609,0,3,0,3,2,0,2,0.00,64.33,66.67
10,004,04,010,0023,0000,608,40,648,1042,0,3,0,3,2,0,2,0.00,62.19,66.67
10,004,04,020,0015,0000,3297,148,3445,6122,0,4,4,8,3,2,5,0.00,56.27,62.50
10,004,04,020,0016,0000,2376,85,2461,4349,0,4,4,8,3,2,5,0.00,56.59,62.50
10,004,04,020,0017,0000,1161,34,1195,1843,0,4,4,8,3,2,5,0.00,64.84,62.50
10,004,04,020,0018,0000,332,11,343,556,0,4,4,8,3,2,5,0.00,61.69,62.50
10,004,04,020,0019,0000,5892,200,6092,11285,0,4,4,8,3,2,5,0.00,53.98,62.50
10,004,04,020,0015,0191,565,15,580,1055,0,4,4,8,3,2,5,0.00,54.98,62.50
10,004,04,020,0015,0192,514,17,531,1016,0,4,4,8,3,2,5,0.00,52.26,62.50
10,004,04,020,0015,0193,473,19,492,878,0,4,4,8,3,2,5,0.00,56.04,62.50
10,004,04,020,0015,0194,587,23,610,1123,0,4,4,8,3,2,5,0.00,54.32,62.50
10,004,04,020,0015,0195,593,32,625,1012,0,4,4,8,3,2,5,0.00,61.76,62.50
10,004,04,020,0015,0196,565,42,607,1038,0,4,4,8,3,2,5,0.00,58.48,62.50
10,004,04,020,0019,0197,659,11,670,1141,0,4,4,8,3,2,5,0.00,58.72,62.50
10,004,04,020,0019,0198,507,21,528,862,0,4,4,8,3,2,5,0.00,61.25,62.50
10,004,04,020,0019,0199,806,53,859,1480,0,4,4,8,3,2,5,0.00,58.04,62.50
10,004,04,020,0019,0200,453,8,461,843,0,4,4,8,3,2,5,0.00,54.69,62.50
10,004,04,020,0019,0201,483,12,495,972,0,4,4,8,3,2,5,0.00,50.93,62.50
10,004,04,020,0019,0202,653,15,668,1267,0,4,4,8,3,2,5,0.00,52.72,62.50
10,004,04,020,0019,0203,600,25,625,1176,0,4,4,8,3,2,5,0.00,53.15,62.50
10,004,04,020,0019,0204,469,16,485,1178,0,4,4,8,3,2,5,0.00,41.17,62.50
10,004,04,020,0019,0205,628,17,645,1151,0,4,4,8,3,2,5,0.00,56.04,62.50
10,004,04,020,0019,0206,634,22,656,1215,0,4,4,8,3,2,5,0.00,53.99,62.50
10,004,04,020,0016,0207,581,20,601,1104,0,4,4,8,3,2,5,0.00,54.44,62.50
10,004,04,020,0016,0208,591,24,615,1122,0,4,4,8,3,2,5,0.00,54.81,62.50
10,004,04,020,0016,0209,607,17,624,1058,0,4,4,8,3,2,5,0.00,58.98,62.50
10,004,04,020,0016,0210,597,24,621,1065,0,4,4,8,3,2,5,0.00,58.31,62.50
10,004,04,020,0017,0211,498,23,521,900,0,4,4,8,3,2,5,0.00,57.89,62.50
10,004,04,020,0017,0212,663,11,674,943,0,4,4,8,3,2,5,0.00,71.47,62.50
10,004,04,020,0018,0213,332,11,343,556,0,4,4,8,3,2,5,0.00,61.69,62.50
10,004,04,030,0011,0000,1008,31,1039,1752,0,3,0,3,2,0,2,0.00,59.30,66.67
10,004,04,030,0012,0000,1471,51,1522,2426,0,3,0,3,2,0,2,0.00,62.74,66.67
10,004,04,030,0013,0000,592,22,614,934,0,3,0,3,2,0,2,0.00,65.74,66.67
10,004,04,030,0014,0000,473,13,486,618,0,3,0,3,2,0,2,0.00,78.64,66.67
10,004,04,030,0011,0241,559,12,571,939,0,3,0,3,2,0,2,0.00,60.81,66.67
10,004,04,030,0011,0242,449,19,468,813,0,3,0,3,2,0,2,0.00,57.56,66.67
10,004,04,030,0012,0243,494,20,514,793,0,3,0,3,2,0,2,0.00,64.82,66.67
10,004,04,030,0012,0244,509,16,525,809,0,3,0,3,2,0,2,0.00,64.89,66.67
10,004,04,030,0012,0245,468,15,483,824,0,3,0,3,2,0,2,0.00,58.62,66.67
10,004,04,030,0013,0246,592,22,614,934,0,3,0,3,2,0,2,0.00,65.74,66.67
10,004,04,030,0014,0247,473,13,486,618,0,3,0,3,2,0,2,0.00,78.64,66.67
10,004,04,040,0014,0000,544,16,560,764,0,5,0,5,3,0,3,0.00,73.30,60.00
10,004,04,040,0015,0000,1221,26,1247,1661,0,5,0,5,3,0,3,0.00,75.08,60.00
10,004,04,040,0016,0000,555,17,572,736,0,5,0,5,3,0,3,0.00,77.72,60.00
10,004,04,040,0017,0000,439,11,450,532,0,5,0,5,3,0,3,0.00,84.59,60.00
10,004,04,040,0018,0000,617,20,637,766,0,5,0,5,3,0,3,0.00,83.16,60.00
10,004,04,040,0021,0000,637,18,655,895,0,5,0,5,3,0,3,0.00,73.18,60.00
10,004,04,040,0014,0268,544,16,560,764,0,5,0,5,3,0,3,0.00,73.30,60.00
10,004,04,040,0015,0269,609,12,621,827,0,5,0,5,3,0,3,0.00,75.09,60.00
10,004,04,040,0015,0270,612,14,626,834,0,5,0,5,3,0,3,0.00,75.06,60.00
10,004,04,040,0021,0271,637,18,655,895,0,5,0,5,3,0,3,0.00,73.18,60.00
10,004,04,040,0016,0272,555,17,572,736,0,5,0,5,3,0,3,0.00,77.72,60.00
10,004,04,040,0017,0273,439,11,450,532,0,5,0,5,3,0,3,0.00,84.59,60.00
10,004,04,040,0018,0274,617,20,637,766,0,5,0,5,3,0,3,0.00,83.16,60.00
10,004,04,050,0001,0000,664,61,725,1162,0,2,0,2,2,0,2,0.00,62.39,100.00
10,004,04,050,0002,0000,488,54,542,809,0,2,0,2,2,0,2,0.00,67.00,100.00
10,004,04,050,0003,0000,2068,274,2342,3924,0,2,0,2,2,0,2,0.00,59.68,100.00
10,004,04,050,0019,0000,2077,218,2295,4422,0,2,0,2,2,0,2,0.00,51.90,100.00
10,004,04,050,0019,0277,579,57,636,1158,0,2,0,2,2,0,2,0.00,54.92,100.00
10,004,04,050,0019,0278,486,50,536,1038,0,2,0,2,2,0,2,0.00,51.64,100.00
10,004,04,050,0019,0279,530,76,606,1173,0,2,0,2,2,0,2,0.00,51.66,100.00
10,004,04,050,0019,0280,482,35,517,1053,0,2,0,2,2,0,2,0.00,49.10,100.00
10,004,04,050,0003,0285,677,99,776,1290,0,2,0,2,2,0,2,0.00,60.16,100.00
10,004,04,050,0003,0286,683,103,786,1275,0,2,0,2,2,0,2,0.00,61.65,100.00
10,004,04,050,0003,0287,708,72,780,1359,0,2,0,2,2,0,2,0.00,57.40,100.00
10,004,04,050,0002,0288,488,54,542,809,0,2,0,2,2,0,2,0.00,67.00,100.00
10,004,04,050,0001,0289,664,61,725,1162,0,2,0,2,2,0,2,0.00,62.39,100.00
10,004,04,060,0008,0000,2630,111,2741,5119,0,4,2,6,3,2,5,0.00,53.55,83.33
10,004,04,060,0011,0000,2292,59,2351,4236,0,4,2,6,3,2,5,0.00,55.50,83.33
10,004,04,060,0012,0000,941,40,981,1496,0,4,2,6,3,2,5,0.00,65.57,83.33
10,004,04,060,0013,0000,741,29,770,1031,0,4,2,6,3,2,5,0.00,74.68,83.33
10,004,04,060,0016,0000,2885,88,2973,6032,0,4,2,6,3,2,5,0.00,49.29,83.33
10,004,04,060,0017,0000,1402,42,1444,2619,0,4,2,6,3,2,5,0.00,55.14,83.33
10,004,04,060,0012,0354,481,18,499,763,0,4,2,6,3,2,5,0.00,65.40,83.33
10,004,04,060,0012,0355,460,22,482,733,0,4,2,6,3,2,5,0.00,65.76,83.33
10,004,04,060,0013,0356,741,29,770,1031,0,4,2,6,3,2,5,0.00,74.68,83.33
10,004,04,060,0008,0357,519,18,537,951,0,4,2,6,3,2,5,0.00,56.47,83.33
10,004,04,060,0008,0358,590,20,610,1031,0,4,2,6,3,2,5,0.00,59.17,83.33
10,004,04,060,0008,0359,473,20,493,1070,0,4,2,6,3,2,5,0.00,46.07,83.33
10,004,04,060,0008,0360,485,23,508,995,0,4,2,6,3,2,5,0.00,51.06,83.33
10,004,04,060,0008,0361,563,30,593,1072,0,4,2,6,3,2,5,0.00,55.32,83.33
10,004,04,060,0017,0362,447,12,459,898,0,4,2,6,3,2,5,0.00,51.11,83.33
10,004,04,060,0017,0363,398,11,409,791,0,4,2,6,3,2,5,0.00,51.71,83.33
10,004,04,060,0017,0364,557,19,576,930,0,4,2,6,3,2,5,0.00,61.94,83.33
10,004,04,060,0011,0365,591,13,604,1062,0,4,2,6,3,2,5,0.00,56.87,83.33
10,004,04,060,0011,0366,548,12,560,1039,0,4,2,6,3,2,5,0.00,53.90,83.33
10,004,04,060,0011,0367,634,13,647,1139,0,4,2,6,3,2,5,0.00,56.80,83.33
10,004,04,060,0011,0368,519,21,540,996,0,4,2,6,3,2,5,0.00,54.22,83.33
10,004,04,060,0016,0369,547,22,569,1084,0,4,2,6,3,2,5,0.00,52.49,83.33
10,004,04,060,0016,0370,575,23,598,1120,0,4,2,6,3,2,5,0.00,53.39,83.33
10,004,04,060,0016,0371,544,21,565,1155,0,4,2,6,3,2,5,0.00,48.92,83.33
10,004,04,060,0016,0372,613,10,623,1259,0,4,2,6,3,2,5,0.00,49.48,83.33
10,004,04,060,0016,0373,606,12,618,1414,0,4,2,6,3,2,5,0.00,43.71,83.33
10,004,04,070,0009,0000,1375,52,1427,2278,0,6,1,7,5,1,6,0.00,62.64,85.71
10,004,04,070,0010,0000,976,38,1014,1521,0,6,1,7,5,1,6,0.00,66.67,85.71
10,004,04,070,0011,0000,2753,126,2879,4709,0,6,1,7,5,1,6,0.00,61.14,85.71
10,004,04,070,0012,0000,700,41,741,1072,0,6,1,7,5,1,6,0.00,69.12,85.71
10,004,04,070,0009,0384,686,30,716,1221,0,6,1,7,5,1,6,0.00,58.64,85.71
10,004,04,070,0009,0385,689,22,711,1057,0,6,1,7,5,1,6,0.00,67.27,85.71
10,004,04,070,0010,0386,552,21,573,865,0,6,1,7,5,1,6,0.00,66.24,85.71
10,004,04,070,0010,0387,424,17,441,656,0,6,1,7,5,1,6,0.00,67.23,85.71
10,004,04,070,0011,0388,742,25,767,1167,0,6,1,7,5,1,6,0.00,65.72,85.71
10,004,04,070,0011,0389,868,40,908,1491,0,6,1,7,5,1,6,0.00,60.90,85.71
10,004,04,070,0011,0390,555,44,599,1006,0,6,1,7,5,1,6,0.00,59.54,85.71
10,004,04,070,0011,0391,588,17,605,1045,0,6,1,7,5,1,6,0.00,57.89,85.71
10,004,04,070,0012,0392,700,41,741,1072,0,6,1,7,5,1,6,0.00,69.12,85.71
10,004,04,080,0007,0000,269,14,283,402,0,2,0,2,1,0,1,0.00,70.40,50.00
10,004,04,080,0008,0000,648,17,665,882,0,2,0,2,1,0,1,0.00,75.40,50.00
10,004,04,080,0007,0403,269,14,283,402,0,2,0,2,1,0,1,0.00,70.40,50.00
10,004,04,080,0008,0404,463,12,475,622,0,2,0,2,1,0,1,0.00,76.37,50.00
10,004,04,080,0008,0405,185,5,190,260,0,2,0,2,1,0,1,0.00,73.08,50.00
10,004,04,100,0007,0000,344,40,384,516,0,1,1,2,1,1,2,0.00,74.42,100.00
10,004,04,100,0008,0000,498,72,570,840,0,1,1,2,1,1,2,0.00,67.86,100.00
10,004,04,100,0009,0000,467,20,487,573,0,1,1,2,1,1,2,0.00,84.99,100.00
10,004,04,100,0008,0431,498,72,570,840,0,1,1,2,1,1,2,0.00,67.86,100.00
10,004,04,100,0009,0432,467,20,487,573,0,1,1,2,1,1,2,0.00,84.99,100.00
10,004,04,100,0007,0433,344,40,384,516,0,1,1,2,1,1,2,0.00,74.42,100.00
10,004,00,050,0000,0000,35703,1908,37611,64610,80893,15,4,19,10,3,13,79.87,58.21,68.42
10,004,01,050,0000,0000,9474,440,9914,16565,20829,3,1,4,2,1,3,79.53,59.85,75.00
10,004,02,050,0000,0000,12615,540,13155,24140,29701,5,3,8,3,2,5,81.28,54.49,62.50
10,004,03,050,0000,0000,8317,321,8638,13588,17481,5,0,5,3,0,3,77.73,63.57,60.00
10,004,04,050,0000,0000,5297,607,5904,10317,12882,2,0,2,2,0,2,80.09,57.23,100.00
10,004,00,060,0000,0000,23839,1351,25190,45935,58583,11,2,13,9,2,11,78.41,54.84,84.62
10,004,01,060,0000,0000,4105,202,4307,7740,9134,3,0,3,2,0,2,84.74,55.65,66.67
10,004,02,060,0000,0000,3851,336,4187,7186,8448,2,0,2,2,0,2,85.06,58.27,100.00
10,004,03,060,0000,0000,4992,444,5436,10476,13762,2,0,2,2,0,2,76.12,51.89,100.00
10,004,04,060,0000,0000,10891,369,11260,20533,27239,4,2,6,3,2,5,75.38,54.84,83.33
10,004,00,070,0000,0000,10419,485,10904,17060,20052,13,1,14,10,1,11,85.08,63.92,78.57
10,004,01,070,0000,0000,1194,67,1261,1723,1961,2,0,2,1,0,1,87.86,73.19,50.00
10,004,02,070,0000,0000,1607,87,1694,2926,3381,2,0,2,2,0,2,86.54,57.89,100.00
10,004,03,070,0000,0000,1814,74,1888,2831,3326,3,0,3,2,0,2,85.12,66.69,66.67
10,004,04,070,0000,0000,5804,257,6061,9580,11384,6,1,7,5,1,6,84.15,63.27,85.71
10,004,00,080,0000,0000,7204,189,7393,10592,12249,16,4,20,9,2,11,86.47,69.80,55.00
10,004,01,080,0000,0000,2755,82,2837,4349,4953,5,2,7,3,1,4,87.81,65.23,57.14
10,004,02,080,0000,0000,2346,50,2396,3359,4031,6,2,8,3,1,4,83.33,71.33,50.00
10,004,03,080,0000,0000,1186,26,1212,1600,1829,3,0,3,2,0,2,87.48,75.75,66.67
10,004,04,080,0000,0000,917,31,948,1284,1436,2,0,2,1,0,1,89.42,73.83,50.00
10,004,00,090,0000,0000,4998,184,5182,7602,8693,6,6,12,2,5,7,87.45,68.17,58.33
10,004,01,090,0000,0000,1466,44,1510,2151,2460,2,2,4,0,2,2,87.44,70.20,50.00
10,004,02,090,0000,0000,2842,84,2926,4343,5030,4,3,7,2,2,4,86.34,67.37,57.14
10,004,03,090,0000,0000,690,56,746,1108,1203,0,1,1,0,1,1,92.10,67.33,100.00
10,004,00,100,0000,0000,8001,572,8573,12489,14362,14,3,17,9,2,11,86.96,68.64,64.71
10,004,01,100,0000,0000,4202,216,4418,6961,8138,8,2,10,5,1,6,85.54,63.47,60.00
10,004,02,100,0000,0000,1540,64,1604,2108,2398,4,0,4,2,0,2,87.91,76.09,50.00
10,004,03,100,0000,0000,950,160,1110,1491,1671,1,0,1,1,0,1,89.23,74.45,100.00
10,004,04,100,0000,0000,1309,132,1441,1929,2155,1,1,2,1,1,2,89.51,74.70,100.00
10,004,00,110,0000,0000,3547,218,3765,4774,5331,4,5,9,2,5,7,89.55,78.86,77.78
10,004,01,110,0000,0000,1660,30,1690,2036,2281,4,1,5,2,1,3,89.26,83.01,60.00
10,004,02,110,0000,0000,1887,188,2075,2738,3050,0,4,4,0,4,4,89.77,75.79,100.00
10,004,00,120,0000,0000,5327,114,5441,7091,9584,17,1,18,6,1,7,73.99,76.73,38.89
10,004,01,120,0000,0000,1483,26,1509,1967,2464,3,0,3,2,0,2,79.83,76.72,66.67
10,004,02,120,0000,0000,1760,32,1792,2260,2971,7,0,7,2,0,2,76.07,79.29,28.57
10,004,03,120,0000,0000,2084,56,2140,2864,4149,7,1,8,2,1,3,69.03,74.72,37.50
10,004,00,130,0000,0000,2962,58,3020,3774,4580,16,2,18,6,1,7,82.40,80.02,38.89
10,004,01,130,0000,0000,1001,20,1021,1291,1598,4,0,4,2,0,2,80.79,79.09,50.00
10,004,02,130,0000,0000,1105,16,1121,1416,1716,7,1,8,2,1,3,82.52,79.17,37.50
10,004,03,130,0000,0000,856,22,878,1067,1266,5,1,6,2,0,2,84.28,82.29,33.33
10,005,00,000,0000,0000,284000,12584,296584,440906,533370,245,66,311,145,43,188,82.66,67.27,60.45
10,005,00,010,0000,0000,42297,2507,44804,70966,85998,22,9,31,10,6,16,82.52,63.13,51.61
10,005,01,010,0000,0000,8563,543,9106,14125,16986,2,3,5,0,3,3,83.16,64.47,60.00
10,005,02,010,0000,0000,7903,401,8304,13197,15382,6,1,7,3,0,3,85.80,62.92,42.86
10,005,03,010,0000,0000,13488,783,14271,22591,27252,7,3,10,3,2,5,82.90,63.17,50.00
10,005,04,010,0000,0000,12343,780,13123,21053,26378,7,2,9,4,1,5,79.81,62.33,55.56
10,005,01,010,0001,0001,585,52,637,1058,0,2,3,5,0,3,3,0.00,60.21,60.00
10,005,01,010,0003,0002,567,43,610,953,0,2,3,5,0,3,3,0.00,64.01,60.00
10,005,01,010,0007,0003,598,55,653,1039,0,2,3,5,0,3,3,0.00,62.85,60.00
10,005,01,010,0007,0004,610,35,645,1065,0,2,3,5,0,3,3,0.00,60.56,60.00
10,005,01,010,0007,0005,676,18,694,1028,0,2,3,5,0,3,3,0.00,67.51,60.00
10,005,01,010,0006,0006,748,29,777,1163,0,2,3,5,0,3,3,0.00,66.81,60.00
10,005,01,010,0006,0007,786,38,824,1221,0,2,3,5,0,3,3,0.00,67.49,60.00
10,005,01,010,0006,0008,647,41,688,1059,0,2,3,5,0,3,3,0.00,64.97,60.00
10,005,01,010,0004,0009,678,55,733,1086,0,2,3,5,0,3,3,0.00,67.50,60.00
10,005,01,010,0001,0000,585,52,637,1058,0,2,3,5,0,3,3,0.00,60.21,60.00
10,005,01,010,0004,0010,642,46,688,1026,0,2,3,5,0,3,3,0.00,67.06,60.00
10,005,01,010,0005,0011,634,33,667,1038,0,2,3,5,0,3,3,0.00,64.26,60.00
10,005,01,010,0005,0012,668,41,709,1222,0,2,3,5,0,3,3,0.00,58.02,60.00
10,005,01,010,0005,0013,724,57,781,1167,0,2,3,5,0,3,3,0.00,66.92,60.00
10,005,01,010,0003,0000,567,43,610,953,0,2,3,5,0,3,3,0.00,64.01,60.00
10,005,01,010,0004,0000,1320,101,1421,2112,0,2,3,5,0,3,3,0.00,67.28,60.00
10,005,01,010,0005,0000,2026,131,2157,3427,0,2,3,5,0,3,3,0.00,62.94,60.00
10,005,01,010,0006,0000,2181,108,2289,3443,0,2,3,5,0,3,3,0.00,66.48,60.00
10,005,01,010,0007,0000,1884,108,1992,3132,0,2,3,5,0,3,3,0.00,63.60,60.00
10,005,01,020,0001,0000,1372,40,1412,2080,0,7,3,10,5,1,6,0.00,67.88,60.00
10,005,01,020,0002,0000,880,35,915,1365,0,7,3,10,5,1,6,0.00,67.03,60.00
10,005,01,020,0003,0000,544,27,571,810,0,7,3,10,5,1,6,0.00,70.49,60.00
10,005,01,020,0004,0000,1036,26,1062,1517,0,7,3,10,5,1,6,0.00,70.01,60.00
10,005,01,020,0005,0000,722,19,741,1137,0,7,3,10,5,1,6,0.00,65.17,60.00
10,005,01,020,0006,0000,1344,37,1381,1968,0,7,3,10,5,1,6,0.00,70.17,60.00
10,005,01,020,0007,0000,700,34,734,993,0,7,3,10,5,1,6,0.00,73.92,60.00
10,005,01,020,0008,0000,1419,35,1454,2075,0,7,3,10,5,1,6,0.00,70.07,60.00
10,005,01,020,0009,0000,2462,83,2545,3874,0,7,3,10,5,1,6,0.00,65.69,60.00
10,005,01,020,0010,0000,1382,51,1433,2126,0,7,3,10,5,1,6,0.00,67.40,60.00
10,005,01,020,0011,0000,612,25,637,890,0,7,3,10,5,1,6,0.00,71.57,60.00
10,005,01,020,0012,0000,424,11,435,607,0,7,3,10,5,1,6,0.00,71.66,60.00
10,005,01,020,0013,0000,867,34,901,1272,0,7,3,10,5,1,6,0.00,70.83,60.00
10,005,01,020,0001,0189,547,10,557,829,0,7,3,10,5,1,6,0.00,67.19,60.00
10,005,01,020,0001,0190,825,30,855,1251,0,7,3,10,5,1,6,0.00,68.35,60.00
10,005,01,020,0002,0191,509,20,529,725,0,7,3,10,5,1,6,0.00,72.97,60.00
10,005,01,020,0002,0192,371,15,386,640,0,7,3,10,5,1,6,0.00,60.31,60.00
10,005,01,020,0003,0193,544,27,571,810,0,7,3,10,5,1,6,0.00,70.49,60.00
10,005,01,020,0004,0194,540,8,548,782,0,7,3,10,5,1,6,0.00,70.08,60.00
10,005,01,020,0004,0195,496,18,514,735,0,7,3,10,5,1,6,0.00,69.93,60.00
10,005,01,020,0005,0196,722,19,741,1137,0,7,3,10,5,1,6,0.00,65.17,60.00
10,005,01,020,0006,0197,791,16,807,1161,0,7,3,10,5,1,6,0.00,69.51,60.00
10,005,01,020,0006,0198,553,21,574,807,0,7,3,10,5,1,6,0.00,71.13,60.00
10,005,01,020,0007,0199,700,34,734,993,0,7,3,10,5,1,6,0.00,73.92,60.00
10,005,01,020,0008,0200,736,18,754,1054,0,7,3,10,5,1,6,0.00,71.54,60.00
10,005,01,020,0008,0201,683,17,700,1021,0,7,3,10,5,1,6,0.00,68.56,60.00
10,005,01,020,0009,0202,906,22,928,1396,0,7,3,10,5,1,6,0.00,66.48,60.00
10,005,01,020,0009,0203,794,28,822,1273,0,7,3,10,5,1,6,0.00,64.57,60.00
10,005,01,020,0009,0204,762,33,795,1205,0,7,3,10,5,1,6,0.00,65.98,60.00
10,005,01,020,0010,0205,651,25,676,1032,0,7,3,10,5,1,6,0.00,65.50,60.00
10,005,01,020,0010,0206,731,26,757,1094,0,7,3,10,5,1,6,0.00,69.20,60.00
10,005,01,020,0011,0207,612,25,637,890,0,7,3,10,5,1,6,0.00,71.57,60.00
10,005,01,020,0012,0208,424,11,435,607,0,7,3,10,5,1,6,0.00,71.66,60.00
10,005,01,020,0013,0209,867,34,901,1272,0,7,3,10,5,1,6,0.00,70.83,60.00
10,005,01,030,0001,0000,657,29,686,1019,0,5,3,8,3,1,4,0.00,67.32,50.00
10,005,01,030,0002,0000,1334,45,1379,1863,0,5,3,8,3,1,4,0.00,74.02,50.00
10,005,01,030,0003,0000,1252,49,1301,1746,0,5,3,8,3,1,4,0.00,74.51,50.00
10,005,01,030,0004,0000,1059,25,1084,1473,0,5,3,8,3,1,4,0.00,73.59,50.00
10,005,01,030,0005,0000,472,19,491,657,0,5,3,8,3,1,4,0.00,74.73,50.00
10,005,01,030,0006,0000,1683,41,1724,2508,0,5,3,8,3,1,4,0.00,68.74,50.00
10,005,01,030,0001,0155,657,29,686,1019,0,5,3,8,3,1,4,0.00,67.32,50.00
10,005,01,030,0002,0156,611,16,627,834,0,5,3,8,3,1,4,0.00,75.18,50.00
10,005,01,030,0002,0157,723,29,752,1029,0,5,3,8,3,1,4,0.00,73.08,50.00
10,005,01,030,0003,0158,656,26,682,941,0,5,3,8,3,1,4,0.00,72.48,50.00
10,005,01,030,0003,0159,596,23,619,805,0,5,3,8,3,1,4,0.00,76.89,50.00
10,005,01,030,0024,0160,671,18,689,987,0,5,3,8,3,1,4,0.00,69.81,50.00
10,005,01,030,0024,0161,612,26,638,956,0,5,3,8,3,1,4,0.00,66.74,50.00
10,005,01,030,0005,0162,472,19,491,657,0,5,3,8,3,1,4,0.00,74.73,50.00
10,005,01,030,0004,0163,503,11,514,700,0,5,3,8,3,1,4,0.00,73.43,50.00
10,005,01,030,0004,0164,556,14,570,773,0,5,3,8,3,1,4,0.00,73.74,50.00
10,005,01,030,0006,0165,627,19,646,910,0,5,3,8,3,1,4,0.00,70.99,50.00
10,005,01,030,0006,0166,481,10,491,766,0,5,3,8,3,1,4,0.00,64.10,50.00
10,005,01,030,0006,0167,575,12,587,832,0,5,3,8,3,1,4,0.00,70.55,50.00
10,005,01,030,0024,0000,1283,44,1327,1943,0,5,3,8,3,1,4,0.00,68.30,50.00
10,005,01,040,0001,0000,1068,68,1136,1810,0,4,2,6,2,1,3,0.00,62.76,50.00
10,005,01,040,0002,0000,1887,163,2050,3229,0,4,2,6,2,1,3,0.00,63.49,50.00
10,005,01,040,0003,0000,1425,56,1481,2604,0,4,2,6,2,1,3,0.00,56.87,50.00
10,005,01,040,0004,0000,2816,138,2954,4818,0,4,2,6,2,1,3,0.00,61.31,50.00
10,005,01,040,0005,0000,3138,105,3243,5048,0,4,2,6,2,1,3,0.00,64.24,50.00
10,005,01,040,0001,0277,581,34,615,953,0,4,2,6,2,1,3,0.00,64.53,50.00
10,005,01,040,0001,0278,487,34,521,857,0,4,2,6,2,1,3,0.00,60.79,50.00
10,005,01,040,0002,0279,527,34,561,940,0,4,2,6,2,1,3,0.00,59.68,50.00
10,005,01,040,0002,0280,775,70,845,1324,0,4,2,6,2,1,3,0.00,63.82,50.00
10,005,01,040,0002,0281,585,59,644,965,0,4,2,6,2,1,3,0.00,66.74,50.00
10,005,01,040,0003,0282,783,41,824,1388,0,4,2,6,2,1,3,0.00,59.37,50.00
10,005,01,040,0003,0283,642,15,657,1216,0,4,2,6,2,1,3,0.00,54.03,50.00
10,005,01,040,0004,0284,673,35,708,1133,0,4,2,6,2,1,3,0.00,62.49,50.00
10,005,01,040,0004,0285,653,24,677,1150,0,4,2,6,2,1,3,0.00,58.87,50.00
10,005,01,040,0004,0286,732,37,769,1264,0,4,2,6,2,1,3,0.00,60.84,50.00
10,005,01,040,0004,0287,758,42,800,1271,0,4,2,6,2,1,3,0.00,62.94,50.00
10,005,01,040,0005,0288,708,38,746,1189,0,4,2,6,2,1,3,0.00,62.74,50.00
10,005,01,040,0005,0289,755,14,769,1209,0,4,2,6,2,1,3,0.00,63.61,50.00
10,005,01,040,0005,0290,430,13,443,638,0,4,2,6,2,1,3,0.00,69.44,50.00
10,005,01,040,0005,0291,647,16,663,1102,0,4,2,6,2,1,3,0.00,60.16,50.00
10,005,01,040,0005,0292,598,24,622,910,0,4,2,6,2,1,3,0.00,68.35,50.00
10,005,01,050,0001,0000,1278,41,1319,2075,0,6,0,6,3,0,3,0.00,63.57,50.00
10,005,01,050,0002,0000,1009,33,1042,1613,0,6,0,6,3,0,3,0.00,64.60,50.00
10,005,01,050,0003,0000,1714,49,1763,2710,0,6,0,6,3,0,3,0.00,65.06,50.00
10,005,01,050,0004,0000,2205,84,2289,3597,0,6,0,6,3,0,3,0.00,63.64,50.00
10,005,01,050,0005,0000,2594,119,2713,4348,0,6,0,6,3,0,3,0.00,62.40,50.00
10,005,01,050,0001,0342,649,22,671,1048,0,6,0,6,3,0,3,0.00,64.03,50.00
10,005,01,050,0001,0343,629,19,648,1027,0,6,0,6,3,0,3,0.00,63.10,50.00
10,005,01,050,0002,0344,519,21,540,838,0,6,0,6,3,0,3,0.00,64.44,50.00
10,005,01,050,0002,0345,490,12,502,775,0,6,0,6,3,0,3,0.00,64.77,50.00
10,005,01,050,0003,0346,639,13,652,989,0,6,0,6,3,0,3,0.00,65.93,50.00
10,005,01,050,0003,0347,550,22,572,874,0,6,0,6,3,0,3,0.00,65.45,50.00
10,005,01,050,0003,0348,525,14,539,847,0,6,0,6,3,0,3,0.00,63.64,50.00
10,005,01,050,0004,0349,735,24,759,1133,0,6,0,6,3,0,3,0.00,66.99,50.00
10,005,01,050,0004,0350,592,23,615,975,0,6,0,6,3,0,3,0.00,63.08,50.00
10,005,01,050,0004,0351,878,37,915,1489,0,6,0,6,3,0,3,0.00,61.45,50.00
10,005,01,050,0005,0352,585,24,609,879,0,6,0,6,3,0,3,0.00,69.28,50.00
10,005,01,050,0005,0353,666,31,697,1192,0,6,0,6,3,0,3,0.00,58.47,50.00
10,005,01,050,0005,0354,854,40,894,1387,0,6,0,6,3,0,3,0.00,64.46,50.00
10,005,01,050,0005,0355,489,24,513,890,0,6,0,6,3,0,3,0.00,57.64,50.00
10,005,01,060,0001,0000,834,133,967,1342,0,3,1,4,3,1,4,0.00,72.06,100.00
10,005,01,060,0002,0000,443,100,543,699,0,3,1,4,3,1,4,0.00,77.68,100.00
10,005,01,060,0003,0000,721,141,862,1189,0,3,1,4,3,1,4,0.00,72.50,100.00
10,005,01,060,0004,0000,2401,351,2752,4126,0,3,1,4,3,1,4,0.00,66.70,100.00
10,005,01,060,0011,0000,819,71,890,1394,0,3,1,4,3,1,4,0.00,63.85,100.00
10,005,01,060,0013,0000,683,64,747,1156,0,3,1,4,3,1,4,0.00,64.62,100.00
10,005,01,060,0014,0000,622,71,693,932,0,3,1,4,3,1,4,0.00,74.36,100.00
10,005,01,060,0001,0229,326,58,384,547,0,3,1,4,3,1,4,0.00,70.20,100.00
10,005,01,060,0001,0230,508,75,583,795,0,3,1,4,3,1,4,0.00,73.33,100.00
10,005,01,060,0002,0231,443,100,543,699,0,3,1,4,3,1,4,0.00,77.68,100.00
10,005,01,060,0003,0232,348,75,423,583,0,3,1,4,3,1,4,0.00,72.56,100.00
10,005,01,060,0003,0233,373,66,439,606,0,3,1,4,3,1,4,0.00,72.44,100.00
10,005,01,060,0004,0234,649,79,728,1089,0,3,1,4,3,1,4,0.00,66.85,100.00
10,005,01,060,0004,0235,726,112,838,1243,0,3,1,4,3,1,4,0.00,67.42,100.00
10,005,01,060,0004,0236,561,86,647,956,0,3,1,4,3,1,4,0.00,67.68,100.00
10,005,01,060,0004,0237,465,74,539,838,0,3,1,4,3,1,4,0.00,64.32,100.00
10,005,01,060,0011,0238,375,23,398,634,0,3,1,4,3,1,4,0.00,62.78,100.00
10,005,01,060,0011,0239,444,48,492,760,0,3,1,4,3,1,4,0.00,64.74,100.00
10,005,01,060,0013,0240,683,64,747,1156,0,3,1,4,3,1,4,0.00,64.62,100.00
10,005,01,060,0014,0241,622,71,693,932,0,3,1,4,3,1,4,0.00,74.36,100.00
10,005,01,070,0001,0000,478,11,489,658,0,3,2,5,3,1,4,0.00,74.32,80.00
10,005,01,070,0002,0000,954,35,989,1410,0,3,2,5,3,1,4,0.00,70.14,80.00
10,005,01,070,0007,0000,1246,33,1279,1794,0,3,2,5,3,1,4,0.00,71.29,80.00
10,005,01,070,0008,0000,682,11,693,1008,0,3,2,5,3,1,4,0.00,68.75,80.00
10,005,01,070,0007,0456,606,23,629,873,0,3,2,5,3,1,4,0.00,72.05,80.00
10,005,01,070,0007,0457,640,10,650,921,0,3,2,5,3,1,4,0.00,70.58,80.00
10,005,01,070,0008,0458,682,11,693,1008,0,3,2,5,3,1,4,0.00,68.75,80.00
10,005,01,070,0001,0459,478,11,489,658,0,3,2,5,3,1,4,0.00,74.32,80.00
10,005,01,070,0002,0460,487,19,506,729,0,3,2,5,3,1,4,0.00,69.41,80.00
10,005,01,070,0002,0461,467,16,483,681,0,3,2,5,3,1,4,0.00,70.93,80.00
10,005,01,080,0001,0000,1129,38,1167,1503,0,5,0,5,3,0,3,0.00,77.64,60.00
10,005,01,080,0002,0000,402,7,409,526,0,5,0,5,3,0,3,0.00,77.76,60.00
10,005,01,080,0006,0000,810,21,831,1124,0,5,0,5,3,0,3,0.00,73.93,60.00
10,005,01,080,0001,0434,514,17,531,681,0,5,0,5,3,0,3,0.00,77.97,60.00
10,005,01,080,0001,0435,615,21,636,822,0,5,0,5,3,0,3,0.00,77.37,60.00
10,005,01,080,0002,0436,402,7,409,526,0,5,0,5,3,0,3,0.00,77.76,60.00
10,005,01,080,0006,0437,810,21,831,1124,0,5,0,5,3,0,3,0.00,73.93,60.00
10,005,01,090,0001,0000,1029,23,1052,1458,0,6,2,8,3,2,5,0.00,72.15,62.50
10,005,01,090,0002,0000,1451,38,1489,2241,0,6,2,8,3,2,5,0.00,66.44,62.50
10,005,01,090,0003,0000,2116,64,2180,3290,0,6,2,8,3,2,5,0.00,66.26,62.50
10,005,01,090,0004,0000,549,19,568,893,0,6,2,8,3,2,5,0.00,63.61,62.50
10,005,01,090,0005,0000,1411,38,1449,2154,0,6,2,8,3,2,5,0.00,67.27,62.50
10,005,01,090,0006,0000,1424,48,1472,2266,0,6,2,8,3,2,5,0.00,64.96,62.50
10,005,01,090,0001,0070,495,14,509,706,0,6,2,8,3,2,5,0.00,72.10,62.50
10,005,01,090,0001,0071,534,9,543,752,0,6,2,8,3,2,5,0.00,72.21,62.50
10,005,01,090,0002,0072,683,12,695,1042,0,6,2,8,3,2,5,0.00,66.70,62.50
10,005,01,090,0002,0073,768,26,794,1199,0,6,2,8,3,2,5,0.00,66.22,62.50
10,005,01,090,0003,0074,717,14,731,1103,0,6,2,8,3,2,5,0.00,66.27,62.50
10,005,01,090,0003,0075,706,27,733,1125,0,6,2,8,3,2,5,0.00,65.16,62.50
10,005,01,090,0003,0076,693,23,716,1062,0,6,2,8,3,2,5,0.00,67.42,62.50
10,005,01,090,0005,0077,729,17,746,1127,0,6,2,8,3,2,5,0.00,66.19,62.50
10,005,01,090,0005,0078,682,21,703,1027,0,6,2,8,3,2,5,0.00,68.45,62.50
10,005,01,090,0006,0079,786,28,814,1251,0,6,2,8,3,2,5,0.00,65.07,62.50
10,005,01,090,0006,0080,638,20,658,1015,0,6,2,8,3,2,5,0.00,64.83,62.50
10,005,01,090,0004,0081,549,19,568,893,0,6,2,8,3,2,5,0.00,63.61,62.50
10,005,01,100,0002,0000,2836,52,2888,4145,0,3,3,6,1,2,3,0.00,69.67,50.00
10,005,01,100,0002,0114,551,12,563,814,0,3,3,6,1,2,3,0.00,69.16,50.00
10,005,01,100,0002,0115,703,9,712,987,0,3,3,6,1,2,3,0.00,72.14,50.00
10,005,01,100,0002,0116,867,12,879,1227,0,3,3,6,1,2,3,0.00,71.64,50.00
10,005,01,100,0002,0117,715,19,734,1117,0,3,3,6,1,2,3,0.00,65.71,50.00
10,005,01,110,0001,0000,661,17,678,1005,0,4,1,5,2,1,3,0.00,67.46,60.00
10,005,01,110,0002,0000,388,7,395,536,0,4,1,5,2,1,3,0.00,73.69,60.00
10,005,01,110,0003,0000,627,12,639,917,0,4,1,5,2,1,3,0.00,69.68,60.00
10,005,01,110,0008,0000,269,9,278,422,0,4,1,5,2,1,3,0.00,65.88,60.00
10,005,01,110,0009,0000,165,2,167,270,0,4,1,5,2,1,3,0.00,61.85,60.00
10,005,01,110,0001,0425,661,17,678,1005,0,4,1,5,2,1,3,0.00,67.46,60.00
10,005,01,110,0002,0426,388,7,395,536,0,4,1,5,2,1,3,0.00,73.69,60.00
10,005,01,110,0003,0427,627,12,639,917,0,4,1,5,2,1,3,0.00,69.68,60.00
10,005,01,110,0008,0432,269,9,278,422,0,4,1,5,2,1,3,0.00,65.88,60.00
10,005,01,110,0009,0433,165,2,167,270,0,4,1,5,2,1,3,0.00,61.85,60.00
10,005,01,120,0001,0000,1760,58,1818,2394,0,6,2,8,4,2,6,0.00,75.94,75.00
10,005,01,120,0003,0000,509,15,524,658,0,6,2,8,4,2,6,0.00,79.64,75.00
10,005,01,120,0004,0000,1192,22,1214,1570,0,6,2,8,4,2,6,0.00,77.32,75.00
10,005,01,120,0001,0102,894,33,927,1260,0,6,2,8,4,2,6,0.00,73.57,75.00
10,005,01,120,0001,0103,866,25,891,1134,0,6,2,8,4,2,6,0.00,78.57,75.00
10,005,01,120,0004,0104,526,15,541,729,0,6,2,8,4,2,6,0.00,74.21,75.00
10,005,01,120,0004,0105,666,7,673,841,0,6,2,8,4,2,6,0.00,80.02,75.00
10,005,01,120,0003,0106,509,15,524,658,0,6,2,8,4,2,6,0.00,79.64,75.00
10,005,01,130,0001,0000,2176,196,2372,3736,0,3,0,3,3,0,3,0.00,63.49,100.00
10,005,01,130,0001,0130,435,33,468,763,0,3,0,3,3,0,3,0.00,61.34,100.00
10,005,01,130,0001,0131,543,38,581,877,0,3,0,3,3,0,3,0.00,66.25,100.00
10,005,01,130,0001,0132,574,45,619,979,0,3,0,3,3,0,3,0.00,63.23,100.00
10,005,01,130,0001,0133,624,80,704,1117,0,3,0,3,3,0,3,0.00,63.03,100.00
10,005,01,140,0001,0000,390,10,400,572,0,3,2,5,1,2,3,0.00,69.93,60.00
10,005,01,140,0002,0000,359,6,365,529,0,3,2,5,1,2,3,0.00,69.00,60.00
10,005,01,140,0003,0000,524,11,535,753,0,3,2,5,1,2,3,0.00,71.05,60.00
10,005,01,140,0004,0000,466,29,495,590,0,3,2,5,1,2,3,0.00,83.90,60.00
10,005,01,140,0001,0146,390,10,400,572,0,3,2,5,1,2,3,0.00,69.93,60.00
10,005,01,140,0002,0147,359,6,365,529,0,3,2,5,1,2,3,0.00,69.00,60.00
10,005,01,140,0003,0148,524,11,535,753,0,3,2,5,1,2,3,0.00,71.05,60.00
10,005,01,140,0004,0149,466,29,495,590,0,3,2,5,1,2,3,0.00,83.90,60.00
10,005,01,150,0001,0000,1250,53,1303,1899,0,3,0,3,2,0,2,0.00,68.62,66.67
10,005,01,150,0001,0265,703,28,731,1082,0,3,0,3,2,0,2,0.00,67.56,66.67
10,005,01,150,0001,0266,547,25,572,817,0,3,0,3,2,0,2,0.00,70.01,66.67
10,005,01,160,0001,0000,1576,29,1605,2093,0,5,2,7,3,2,5,0.00,76.68,71.43
10,005,01,160,0002,0000,462,9,471,592,0,5,2,7,3,2,5,0.00,79.56,71.43
10,005,01,160,0003,0000,606,12,618,784,0,5,2,7,3,2,5,0.00,78.83,71.43
10,005,01,160,0001,0416,712,6,718,928,0,5,2,7,3,2,5,0.00,77.37,71.43
10,005,01,160,0001,0417,864,23,887,1165,0,5,2,7,3,2,5,0.00,76.14,71.43
10,005,01,160,0002,0418,462,9,471,592,0,5,2,7,3,2,5,0.00,79.56,71.43
10,005,01,160,0003,0419,606,12,618,784,0,5,2,7,3,2,5,0.00,78.83,71.43
10,005,01,170,0001,0000,277,3,280,315,0,3,1,4,3,0,3,0.00,88.89,75.00
10,005,01,170,0002,0000,401,12,413,509,0,3,1,4,3,0,3,0.00,81.14,75.00
10,005,01,170,0003,0000,736,11,747,892,0,3,1,4,3,0,3,0.00,83.74,75.00
10,005,01,170,0001,0449,277,3,280,315,0,3,1,4,3,0,3,0.00,88.89,75.00
10,005,01,170,0002,0450,401,12,413,509,0,3,1,4,3,0,3,0.00,81.14,75.00
10,005,01,170,0003,0451,736,11,747,892,0,3,1,4,3,0,3,0.00,83.74,75.00
10,005,01,180,0001,0000,259,8,267,319,0,4,1,5,1,1,2,0.00,83.70,40.00
10,005,01,180,0002,0000,850,14,864,1036,0,4,1,5,1,1,2,0.00,83.40,40.00
10,005,01,180,0001,0475,259,8,267,319,0,4,1,5,1,1,2,0.00,83.70,40.00
10,005,01,180,0002,0476,346,5,351,435,0,4,1,5,1,1,2,0.00,80.69,40.00
10,005,01,180,0002,0477,504,9,513,601,0,4,1,5,1,1,2,0.00,85.36,40.00
10,005,00,020,0000,0000,25104,795,25899,37196,43965,16,3,19,10,1,11,84.60,69.63,57.89
10,005,01,020,0000,0000,13764,457,14221,20714,24776,7,3,10,5,1,6,83.61,68.65,60.00
10,005,02,020,0000,0000,4138,119,4257,6136,7057,4,0,4,2,0,2,86.95,69.38,50.00
10,005,03,020,0000,0000,7202,219,7421,10346,12132,5,0,5,3,0,3,85.28,71.73,60.00
10,005,02,010,0008,0014,450,31,481,772,0,6,1,7,3,0,3,0.00,62.31,42.86
10,005,02,010,0009,0015,536,27,563,985,0,6,1,7,3,0,3,0.00,57.16,42.86
10,005,02,010,0009,0016,544,21,565,976,0,6,1,7,3,0,3,0.00,57.89,42.86
10,005,02,010,0009,0017,701,22,723,1098,0,6,1,7,3,0,3,0.00,65.85,42.86
10,005,02,010,0012,0018,469,32,501,793,0,6,1,7,3,0,3,0.00,63.18,42.86
10,005,02,010,0010,0019,514,33,547,794,0,6,1,7,3,0,3,0.00,68.89,42.86
10,005,02,010,0011,0020,305,14,319,470,0,6,1,7,3,0,3,0.00,67.87,42.86
10,005,02,010,0014,0021,788,64,852,1279,0,6,1,7,3,0,3,0.00,66.61,42.86
10,005,02,010,0023,0022,694,25,719,1209,0,6,1,7,3,0,3,0.00,59.47,42.86
10,005,02,010,0023,0023,685,20,705,1141,0,6,1,7,3,0,3,0.00,61.79,42.86
10,005,02,010,0013,0024,699,37,736,1149,0,6,1,7,3,0,3,0.00,64.06,42.86
10,005,02,010,0013,0025,663,37,700,1103,0,6,1,7,3,0,3,0.00,63.46,42.86
10,005,02,010,0013,0026,448,20,468,710,0,6,1,7,3,0,3,0.00,65.92,42.86
10,005,02,010,0013,0027,407,18,425,718,0,6,1,7,3,0,3,0.00,59.19,42.86
10,005,02,010,0008,0000,450,31,481,772,0,6,1,7,3,0,3,0.00,62.31,42.86
10,005,02,010,0009,0000,1781,70,1851,3059,0,6,1,7,3,0,3,0.00,60.51,42.86
10,005,02,010,0010,0000,514,33,547,794,0,6,1,7,3,0,3,0.00,68.89,42.86
10,005,02,010,0011,0000,305,14,319,470,0,6,1,7,3,0,3,0.00,67.87,42.86
10,005,02,010,0012,0000,469,32,501,793,0,6,1,7,3,0,3,0.00,63.18,42.86
10,005,02,010,0013,0000,2217,112,2329,3680,0,6,1,7,3,0,3,0.00,63.29,42.86
10,005,02,010,0014,0000,788,64,852,1279,0,6,1,7,3,0,3,0.00,66.61,42.86
10,005,02,010,0023,0000,1379,45,1424,2350,0,6,1,7,3,0,3,0.00,60.60,42.86
10,005,02,020,0014,0000,840,29,869,1280,0,4,0,4,2,0,2,0.00,67.89,50.00
10,005,02,020,0015,0000,1160,25,1185,1736,0,4,0,4,2,0,2,0.00,68.26,50.00
10,005,02,020,0016,0000,838,30,868,1193,0,4,0,4,2,0,2,0.00,72.76,50.00
10,005,02,020,0017,0000,342,4,346,504,0,4,0,4,2,0,2,0.00,68.65,50.00
10,005,02,020,0018,0000,470,15,485,738,0,4,0,4,2,0,2,0.00,65.72,50.00
10,005,02,020,0014,0210,407,14,421,617,0,4,0,4,2,0,2,0.00,68.23,50.00
10,005,02,020,0014,0211,433,15,448,663,0,4,0,4,2,0,2,0.00,67.57,50.00
10,005,02,020,0015,0212,584,17,601,880,0,4,0,4,2,0,2,0.00,68.30,50.00
10,005,02,020,0015,0213,576,8,584,856,0,4,0,4,2,0,2,0.00,68.22,50.00
10,005,02,020,0016,0214,838,30,868,1193,0,4,0,4,2,0,2,0.00,72.76,50.00
10,005,02,020,0017,0215,342,4,346,504,0,4,0,4,2,0,2,0.00,68.65,50.00
10,005,02,020,0018,0216,470,15,485,738,0,4,0,4,2,0,2,0.00,65.72,50.00
10,005,02,020,0023,0217,488,16,504,685,0,4,0,4,2,0,2,0.00,73.58,50.00
10,005,02,020,0023,0000,488,16,504,685,0,4,0,4,2,0,2,0.00,73.58,50.00
10,005,02,030,0014,0000,1188,35,1223,1771,0,3,0,3,2,0,2,0.00,69.06,66.67
10,005,02,030,0015,0000,302,5,307,398,0,3,0,3,2,0,2,0.00,77.14,66.67
10,005,02,030,0016,0000,572,11,583,814,0,3,0,3,2,0,2,0.00,71.62,66.67
10,005,02,030,0014,0168,497,12,509,711,0,3,0,3,2,0,2,0.00,71.59,66.67
10,005,02,030,0014,0169,691,23,714,1060,0,3,0,3,2,0,2,0.00,67.36,66.67
10,005,02,030,0017,0000,254,6,260,361,0,3,0,3,2,0,2,0.00,72.02,66.67
10,005,02,030,0015,0170,302,5,307,398,0,3,0,3,2,0,2,0.00,77.14,66.67
10,005,02,030,0016,0171,572,11,583,814,0,3,0,3,2,0,2,0.00,71.62,66.67
10,005,02,030,0017,0172,254,6,260,361,0,3,0,3,2,0,2,0.00,72.02,66.67
10,005,02,030,0018,0173,511,19,530,743,0,3,0,3,2,0,2,0.00,71.33,66.67
10,005,02,030,0018,0000,511,19,530,743,0,3,0,3,2,0,2,0.00,71.33,66.67
10,005,02,040,0006,0000,2052,103,2155,3366,0,8,3,11,4,1,5,0.00,64.02,45.45
10,005,02,040,0007,0000,2044,101,2145,3233,0,8,3,11,4,1,5,0.00,66.35,45.45
10,005,02,040,0008,0000,1752,104,1856,3148,0,8,3,11,4,1,5,0.00,58.96,45.45
10,005,02,040,0009,0000,1202,53,1255,1953,0,8,3,11,4,1,5,0.00,64.26,45.45
10,005,02,040,0010,0000,2666,111,2777,4755,0,8,3,11,4,1,5,0.00,58.40,45.45
10,005,02,040,0023,0000,1743,133,1876,3121,0,8,3,11,4,1,5,0.00,60.11,45.45
10,005,02,040,0024,0000,1359,48,1407,2110,0,8,3,11,4,1,5,0.00,66.68,45.45
10,005,02,040,0025,0000,1444,56,1500,2276,0,8,3,11,4,1,5,0.00,65.91,45.45
10,005,02,040,0006,0293,621,28,649,1003,0,8,3,11,4,1,5,0.00,64.71,45.45
10,005,02,040,0006,0294,663,41,704,1093,0,8,3,11,4,1,5,0.00,64.41,45.45
10,005,02,040,0006,0295,768,34,802,1270,0,8,3,11,4,1,5,0.00,63.15,45.45
10,005,02,040,0007,0296,673,41,714,1124,0,8,3,11,4,1,5,0.00,63.52,45.45
10,005,02,040,0007,0297,671,34,705,1032,0,8,3,11,4,1,5,0.00,68.31,45.45
10,005,02,040,0007,0298,700,26,726,1077,0,8,3,11,4,1,5,0.00,67.41,45.45
10,005,02,040,0008,0299,689,34,723,1211,0,8,3,11,4,1,5,0.00,59.70,45.45
10,005,02,040,0008,0300,522,29,551,915,0,8,3,11,4,1,5,0.00,60.22,45.45
10,005,02,040,0008,0301,541,41,582,1022,0,8,3,11,4,1,5,0.00,56.95,45.45
10,005,02,040,0025,0302,728,31,759,1141,0,8,3,11,4,1,5,0.00,66.52,45.45
10,005,02,040,0025,0303,716,25,741,1135,0,8,3,11,4,1,5,0.00,65.29,45.45
10,005,02,040,0024,0304,819,31,850,1283,0,8,3,11,4,1,5,0.00,66.25,45.45
10,005,02,040,0024,0305,540,17,557,827,0,8,3,11,4,1,5,0.00,67.35,45.45
10,005,02,040,0009,0306,596,23,619,995,0,8,3,11,4,1,5,0.00,62.21,45.45
10,005,02,040,0009,0307,606,30,636,958,0,8,3,11,4,1,5,0.00,66.39,45.45
10,005,02,040,0010,0308,628,28,656,1206,0,8,3,11,4,1,5,0.00,54.39,45.45
10,005,02,040,0010,0309,618,31,649,992,0,8,3,11,4,1,5,0.00,65.42,45.45
10,005,02,040,0010,0310,698,27,725,1297,0,8,3,11,4,1,5,0.00,55.90,45.45
10,005,02,040,0010,0311,722,25,747,1260,0,8,3,11,4,1,5,0.00,59.29,45.45
10,005,02,040,0023,0312,617,59,676,1080,0,8,3,11,4,1,5,0.00,62.59,45.45
10,005,02,040,0023,0313,585,37,622,1066,0,8,3,11,4,1,5,0.00,58.35,45.45
10,005,02,040,0023,0314,541,37,578,975,0,8,3,11,4,1,5,0.00,59.28,45.45
10,005,02,050,0006,0000,1410,58,1468,2458,0,4,2,6,2,1,3,0.00,59.72,50.00
10,005,02,050,0007,0000,708,23,731,1007,0,4,2,6,2,1,3,0.00,72.59,50.00
10,005,02,050,0008,0000,1859,63,1922,3149,0,4,2,6,2,1,3,0.00,61.04,50.00
10,005,02,050,0009,0000,1872,91,1963,2967,0,4,2,6,2,1,3,0.00,66.16,50.00
10,005,02,050,0010,0000,858,45,903,1475,0,4,2,6,2,1,3,0.00,61.22,50.00
10,005,02,050,0011,0000,421,8,429,947,0,4,2,6,2,1,3,0.00,45.30,50.00
10,005,02,050,0012,0000,684,25,709,997,0,4,2,6,2,1,3,0.00,71.11,50.00
10,005,02,050,0020,0000,1136,37,1173,2137,0,4,2,6,2,1,3,0.00,54.89,50.00
10,005,02,050,0021,0000,1541,50,1591,2429,0,4,2,6,2,1,3,0.00,65.50,50.00
10,005,02,050,0030,0000,1042,42,1084,1849,0,4,2,6,2,1,3,0.00,58.63,50.00
10,005,02,050,0006,0356,795,28,823,1300,0,4,2,6,2,1,3,0.00,63.31,50.00
10,005,02,050,0006,0357,615,30,645,1158,0,4,2,6,2,1,3,0.00,55.70,50.00
10,005,02,050,0007,0358,708,23,731,1007,0,4,2,6,2,1,3,0.00,72.59,50.00
10,005,02,050,0008,0359,622,23,645,1030,0,4,2,6,2,1,3,0.00,62.62,50.00
10,005,02,050,0008,0360,591,24,615,1005,0,4,2,6,2,1,3,0.00,61.19,50.00
10,005,02,050,0008,0361,646,16,662,1114,0,4,2,6,2,1,3,0.00,59.43,50.00
10,005,02,050,0009,0362,653,16,669,974,0,4,2,6,2,1,3,0.00,68.69,50.00
10,005,02,050,0009,0363,654,33,687,1060,0,4,2,6,2,1,3,0.00,64.81,50.00
10,005,02,050,0009,0364,565,42,607,933,0,4,2,6,2,1,3,0.00,65.06,50.00
10,005,02,050,0030,0365,509,26,535,882,0,4,2,6,2,1,3,0.00,60.66,50.00
10,005,02,050,0030,0366,533,16,549,967,0,4,2,6,2,1,3,0.00,56.77,50.00
10,005,02,050,0011,0367,421,8,429,947,0,4,2,6,2,1,3,0.00,45.30,50.00
10,005,02,050,0010,0368,427,21,448,713,0,4,2,6,2,1,3,0.00,62.83,50.00
10,005,02,050,0010,0369,431,24,455,762,0,4,2,6,2,1,3,0.00,59.71,50.00
10,005,02,050,0020,0370,665,21,686,1010,0,4,2,6,2,1,3,0.00,67.92,50.00
10,005,02,050,0020,0371,471,16,487,1127,0,4,2,6,2,1,3,0.00,43.21,50.00
10,005,02,050,0021,0372,745,22,767,1152,0,4,2,6,2,1,3,0.00,66.58,50.00
10,005,02,050,0021,0373,796,28,824,1277,0,4,2,6,2,1,3,0.00,64.53,50.00
10,005,02,050,0012,0374,684,25,709,997,0,4,2,6,2,1,3,0.00,71.11,50.00
10,005,02,060,0006,0000,819,20,839,1178,0,5,0,5,3,0,3,0.00,71.22,60.00
10,005,02,060,0007,0000,754,48,802,1135,0,5,0,5,3,0,3,0.00,70.66,60.00
10,005,02,060,0008,0000,1866,50,1916,2553,0,5,0,5,3,0,3,0.00,75.05,60.00
10,005,02,060,0009,0000,897,25,922,1236,0,5,0,5,3,0,3,0.00,74.60,60.00
10,005,02,060,0010,0000,516,19,535,661,0,5,0,5,3,0,3,0.00,80.94,60.00
10,005,02,060,0006,0242,819,20,839,1178,0,5,0,5,3,0,3,0.00,71.22,60.00
10,005,02,060,0007,0243,754,48,802,1135,0,5,0,5,3,0,3,0.00,70.66,60.00
10,005,02,060,0008,0244,654,13,667,888,0,5,0,5,3,0,3,0.00,75.11,60.00
10,005,02,060,0008,0245,652,17,669,854,0,5,0,5,3,0,3,0.00,78.34,60.00
10,005,02,060,0008,0246,560,20,580,811,0,5,0,5,3,0,3,0.00,71.52,60.00
10,005,02,060,0009,0247,467,15,482,641,0,5,0,5,3,0,3,0.00,75.20,60.00
10,005,02,060,0009,0248,430,10,440,595,0,5,0,5,3,0,3,0.00,73.95,60.00
10,005,02,060,0010,0249,516,19,535,661,0,5,0,5,3,0,3,0.00,80.94,60.00
10,005,02,070,0004,0000,635,13,648,877,0,3,0,3,2,0,2,0.00,73.89,66.67
10,005,02,070,0005,0000,511,11,522,730,0,3,0,3,2,0,2,0.00,71.51,66.67
10,005,02,070,0010,0000,486,16,502,671,0,3,0,3,2,0,2,0.00,74.81,66.67
10,005,02,070,0004,0462,635,13,648,877,0,3,0,3,2,0,2,0.00,73.89,66.67
10,005,02,070,0005,0463,459,9,468,646,0,3,0,3,2,0,2,0.00,72.45,66.67
10,005,02,070,0010,0464,486,16,502,671,0,3,0,3,2,0,2,0.00,74.81,66.67
10,005,02,070,0005,0473,52,2,54,84,0,3,0,3,2,0,2,0.00,64.29,66.67
10,005,02,080,0003,0000,1098,29,1127,1647,0,4,0,4,3,0,3,0.00,68.43,75.00
10,005,02,080,0004,0000,822,20,842,1266,0,4,0,4,3,0,3,0.00,66.51,75.00
10,005,02,080,0005,0000,352,11,363,487,0,4,0,4,3,0,3,0.00,74.54,75.00
10,005,02,080,0003,0438,540,13,553,818,0,4,0,4,3,0,3,0.00,67.60,75.00
10,005,02,080,0003,0439,558,16,574,829,0,4,0,4,3,0,3,0.00,69.24,75.00
10,005,02,080,0004,0440,822,20,842,1266,0,4,0,4,3,0,3,0.00,66.51,75.00
10,005,02,080,0005,0441,352,11,363,487,0,4,0,4,3,0,3,0.00,74.54,75.00
10,005,02,090,0007,0000,808,46,854,1380,0,1,1,2,1,1,2,0.00,61.88,100.00
10,005,02,090,0008,0000,579,42,621,941,0,1,1,2,1,1,2,0.00,65.99,100.00
10,005,02,090,0008,0082,579,42,621,941,0,1,1,2,1,1,2,0.00,65.99,100.00
10,005,02,090,0011,0083,183,34,217,324,0,1,1,2,1,1,2,0.00,66.98,100.00
10,005,02,090,0009,0084,476,45,521,787,0,1,1,2,1,1,2,0.00,66.20,100.00
10,005,02,090,0009,0085,679,52,731,1167,0,1,1,2,1,1,2,0.00,62.64,100.00
10,005,02,090,0007,0086,403,17,420,648,0,1,1,2,1,1,2,0.00,64.81,100.00
10,005,02,090,0007,0087,405,29,434,732,0,1,1,2,1,1,2,0.00,59.29,100.00
10,005,02,090,0010,0088,146,22,168,259,0,1,1,2,1,1,2,0.00,64.86,100.00
10,005,02,090,0009,0000,1155,97,1252,1954,0,1,1,2,1,1,2,0.00,64.07,100.00
10,005,02,090,0010,0000,146,22,168,259,0,1,1,2,1,1,2,0.00,64.86,100.00
10,005,02,090,0011,0000,183,34,217,324,0,1,1,2,1,1,2,0.00,66.98,100.00
10,005,02,100,0004,0000,932,23,955,1190,0,2,1,3,1,1,2,0.00,80.25,66.67
10,005,02,100,0005,0000,796,34,830,1081,0,2,1,3,1,1,2,0.00,76.78,66.67
10,005,02,100,0004,0118,932,23,955,1190,0,2,1,3,1,1,2,0.00,80.25,66.67
10,005,02,100,0005,0119,796,34,830,1081,0,2,1,3,1,1,2,0.00,76.78,66.67
10,005,02,110,0004,0000,474,22,496,732,0,2,0,2,1,0,1,0.00,67.76,50.00
10,005,02,110,0005,0000,450,22,472,711,0,2,0,2,1,0,1,0.00,66.39,50.00
10,005,02,110,0004,0428,474,22,496,732,0,2,0,2,1,0,1,0.00,67.76,50.00
10,005,02,110,0005,0429,450,22,472,711,0,2,0,2,1,0,1,0.00,66.39,50.00
10,005,02,120,0005,0000,652,22,674,821,0,2,0,2,1,0,1,0.00,82.10,50.00
10,005,02,120,0006,0000,312,2,314,368,0,2,0,2,1,0,1,0.00,85.33,50.00
10,005,02,120,0005,0107,652,22,674,821,0,2,0,2,1,0,1,0.00,82.10,50.00
10,005,02,120,0006,0108,312,2,314,368,0,2,0,2,1,0,1,0.00,85.33,50.00
10,005,02,130,0004,0000,2108,47,2155,3143,0,3,1,4,2,1,3,0.00,68.57,75.00
10,005,02,130,0006,0000,322,6,328,394,0,3,1,4,2,1,3,0.00,83.25,75.00
10,005,02,130,0004,0134,654,16,670,943,0,3,1,4,2,1,3,0.00,71.05,75.00
10,005,02,130,0004,0135,700,14,714,1071,0,3,1,4,2,1,3,0.00,66.67,75.00
10,005,02,130,0004,0136,754,17,771,1129,0,3,1,4,2,1,3,0.00,68.29,75.00
10,005,02,130,0006,0143,322,6,328,394,0,3,1,4,2,1,3,0.00,83.25,75.00
10,005,02,140,0005,0000,371,7,378,459,0,4,1,5,3,1,4,0.00,82.35,80.00
10,005,02,140,0006,0000,330,12,342,431,0,4,1,5,3,1,4,0.00,79.35,80.00
10,005,02,140,0007,0000,637,11,648,839,0,4,1,5,3,1,4,0.00,77.23,80.00
10,005,02,140,0008,0000,839,15,854,1084,0,4,1,5,3,1,4,0.00,78.78,80.00
10,005,02,140,0009,0000,485,14,499,618,0,4,1,5,3,1,4,0.00,80.74,80.00
10,005,02,140,0007,0150,637,11,648,839,0,4,1,5,3,1,4,0.00,77.23,80.00
10,005,02,140,0006,0151,330,12,342,431,0,4,1,5,3,1,4,0.00,79.35,80.00
10,005,02,140,0005,0152,371,7,378,459,0,4,1,5,3,1,4,0.00,82.35,80.00
10,005,02,140,0008,0153,839,15,854,1084,0,4,1,5,3,1,4,0.00,78.78,80.00
10,005,02,140,0009,0154,485,14,499,618,0,4,1,5,3,1,4,0.00,80.74,80.00
10,005,02,150,0002,0000,242,23,265,408,0,1,0,1,1,0,1,0.00,64.95,100.00
10,005,02,150,0003,0000,598,72,670,916,0,1,0,1,1,0,1,0.00,73.14,100.00
10,005,02,150,0002,0267,242,23,265,408,0,1,0,1,1,0,1,0.00,64.95,100.00
10,005,02,150,0003,0268,598,72,670,916,0,1,0,1,1,0,1,0.00,73.14,100.00
10,005,02,160,0004,0000,150,2,152,209,0,0,2,2,0,1,1,0.00,72.73,50.00
10,005,02,160,0005,0000,393,9,402,506,0,0,2,2,0,1,1,0.00,79.45,50.00
10,005,02,160,0004,0420,150,2,152,209,0,0,2,2,0,1,1,0.00,72.73,50.00
10,005,02,160,0005,0421,393,9,402,506,0,0,2,2,0,1,1,0.00,79.45,50.00
10,005,02,170,0004,0000,468,10,478,539,0,3,0,3,2,0,2,0.00,88.68,66.67
10,005,02,170,0005,0000,490,5,495,568,0,3,0,3,2,0,2,0.00,87.15,66.67
10,005,02,170,0004,0452,468,10,478,539,0,3,0,3,2,0,2,0.00,88.68,66.67
10,005,02,170,0005,0453,490,5,495,568,0,3,0,3,2,0,2,0.00,87.15,66.67
10,005,02,180,0003,0000,696,17,713,835,0,2,1,3,1,1,2,0.00,85.39,66.67
10,005,02,180,0004,0000,396,5,401,483,0,2,1,3,1,1,2,0.00,83.02,66.67
10,005,02,180,0005,0000,410,7,417,498,0,2,1,3,1,1,2,0.00,83.73,66.67
10,005,02,180,0003,0478,447,8,455,538,0,2,1,3,1,1,2,0.00,84.57,66.67
10,005,02,180,0003,0479,249,9,258,297,0,2,1,3,1,1,2,0.00,86.87,66.67
10,005,02,180,0004,0480,396,5,401,483,0,2,1,3,1,1,2,0.00,83.02,66.67
10,005,02,180,0005,0481,410,7,417,498,0,2,1,3,1,1,2,0.00,83.73,66.67
10,005,00,030,0000,0000,18887,716,19603,27703,31939,14,5,19,8,3,11,86.74,70.76,57.89
10,005,01,030,0000,0000,7740,252,7992,11209,13081,5,3,8,3,1,4,85.69,71.30,50.00
10,005,02,030,0000,0000,2827,76,2903,4087,4672,3,0,3,2,0,2,87.48,71.03,66.67
10,005,03,030,0000,0000,4516,215,4731,6519,7391,4,1,5,2,1,3,88.20,72.57,60.00
10,005,04,030,0000,0000,3804,173,3977,5888,6795,2,1,3,1,1,2,86.65,67.54,66.67
10,005,03,010,0017,0028,546,46,592,953,0,7,3,10,3,2,5,0.00,62.12,50.00
10,005,03,010,0017,0029,611,46,657,1062,0,7,3,10,3,2,5,0.00,61.86,50.00
10,005,03,010,0017,0030,558,12,570,926,0,7,3,10,3,2,5,0.00,61.56,50.00
10,005,03,010,0015,0031,335,19,354,548,0,7,3,10,3,2,5,0.00,64.60,50.00
10,005,03,010,0015,0032,488,42,530,894,0,7,3,10,3,2,5,0.00,59.28,50.00
10,005,03,010,0016,0033,686,34,720,1130,0,7,3,10,3,2,5,0.00,63.72,50.00
10,005,03,010,0016,0034,770,55,825,1322,0,7,3,10,3,2,5,0.00,62.41,50.00
10,005,03,010,0016,0035,683,43,726,1224,0,7,3,10,3,2,5,0.00,59.31,50.00
10,005,03,010,0016,0036,653,71,724,1198,0,7,3,10,3,2,5,0.00,60.43,50.00
10,005,03,010,0018,0037,734,41,775,1160,0,7,3,10,3,2,5,0.00,66.81,50.00
10,005,03,010,0018,0038,638,35,673,1034,0,7,3,10,3,2,5,0.00,65.09,50.00
10,005,03,010,0018,0039,661,37,698,1092,0,7,3,10,3,2,5,0.00,63.92,50.00
10,005,03,010,0019,0040,573,22,595,1056,0,7,3,10,3,2,5,0.00,56.34,50.00
10,005,03,010,0019,0041,672,29,701,1064,0,7,3,10,3,2,5,0.00,65.88,50.00
10,005,03,010,0019,0042,557,20,577,945,0,7,3,10,3,2,5,0.00,61.06,50.00
10,005,03,010,0019,0043,572,34,606,963,0,7,3,10,3,2,5,0.00,62.93,50.00
10,005,03,010,0025,0044,747,41,788,1202,0,7,3,10,3,2,5,0.00,65.56,50.00
10,005,03,010,0025,0045,617,28,645,933,0,7,3,10,3,2,5,0.00,69.13,50.00
10,005,03,010,0025,0046,639,46,685,1206,0,7,3,10,3,2,5,0.00,56.80,50.00
10,005,03,010,0026,0047,603,33,636,960,0,7,3,10,3,2,5,0.00,66.25,50.00
10,005,03,010,0026,0048,535,22,557,791,0,7,3,10,3,2,5,0.00,70.42,50.00
10,005,03,010,0026,0049,610,27,637,928,0,7,3,10,3,2,5,0.00,68.64,50.00
10,005,03,010,0015,0000,823,61,884,1442,0,7,3,10,3,2,5,0.00,61.30,50.00
10,005,03,010,0016,0000,2792,203,2995,4874,0,7,3,10,3,2,5,0.00,61.45,50.00
10,005,03,010,0017,0000,1715,104,1819,2941,0,7,3,10,3,2,5,0.00,61.85,50.00
10,005,03,010,0018,0000,2033,113,2146,3286,0,7,3,10,3,2,5,0.00,65.31,50.00
10,005,03,010,0019,0000,2374,105,2479,4028,0,7,3,10,3,2,5,0.00,61.54,50.00
10,005,03,010,0025,0000,2003,115,2118,3341,0,7,3,10,3,2,5,0.00,63.39,50.00
10,005,03,010,0026,0000,1748,82,1830,2679,0,7,3,10,3,2,5,0.00,68.31,50.00
10,005,03,020,0019,0000,1630,39,1669,2360,0,5,0,5,3,0,3,0.00,70.72,60.00
10,005,03,020,0020,0000,1118,48,1166,1595,0,5,0,5,3,0,3,0.00,73.10,60.00
10,005,03,020,0021,0000,1039,27,1066,1537,0,5,0,5,3,0,3,0.00,69.36,60.00
10,005,03,020,0020,0218,581,25,606,860,0,5,0,5,3,0,3,0.00,70.47,60.00
10,005,03,020,0020,0219,537,23,560,735,0,5,0,5,3,0,3,0.00,76.19,60.00
10,005,03,020,0022,0000,1171,40,1211,1671,0,5,0,5,3,0,3,0.00,72.47,60.00
10,005,03,020,0021,0220,519,10,529,754,0,5,0,5,3,0,3,0.00,70.16,60.00
10,005,03,020,0021,0221,520,17,537,783,0,5,0,5,3,0,3,0.00,68.58,60.00
10,005,03,020,0022,0222,564,22,586,793,0,5,0,5,3,0,3,0.00,73.90,60.00
10,005,03,020,0022,0223,607,18,625,878,0,5,0,5,3,0,3,0.00,71.18,60.00
10,005,03,020,0019,0224,798,14,812,1102,0,5,0,5,3,0,3,0.00,73.68,60.00
10,005,03,020,0019,0225,832,25,857,1258,0,5,0,5,3,0,3,0.00,68.12,60.00
10,005,03,020,0024,0226,904,17,921,1362,0,5,0,5,3,0,3,0.00,67.62,60.00
10,005,03,020,0025,0227,709,21,730,948,0,5,0,5,3,0,3,0.00,77.00,60.00
10,005,03,020,0025,0228,631,27,658,873,0,5,0,5,3,0,3,0.00,75.37,60.00
10,005,03,020,0024,0000,904,17,921,1362,0,5,0,5,3,0,3,0.00,67.62,60.00
10,005,03,020,0025,0000,1340,48,1388,1821,0,5,0,5,3,0,3,0.00,76.22,60.00
10,005,03,030,0007,0000,385,24,409,613,0,4,1,5,2,1,3,0.00,66.72,60.00
10,005,03,030,0008,0000,603,21,624,846,0,4,1,5,2,1,3,0.00,73.76,60.00
10,005,03,030,0009,0000,456,28,484,728,0,4,1,5,2,1,3,0.00,66.48,60.00
10,005,03,030,0010,0000,411,11,422,606,0,4,1,5,2,1,3,0.00,69.64,60.00
10,005,03,030,0011,0000,766,33,799,1148,0,4,1,5,2,1,3,0.00,69.60,60.00
10,005,03,030,0012,0000,990,62,1052,1288,0,4,1,5,2,1,3,0.00,81.68,60.00
10,005,03,030,0013,0000,905,36,941,1290,0,4,1,5,2,1,3,0.00,72.95,60.00
10,005,03,030,0007,0174,385,24,409,613,0,4,1,5,2,1,3,0.00,66.72,60.00
10,005,03,030,0008,0175,603,21,624,846,0,4,1,5,2,1,3,0.00,73.76,60.00
10,005,03,030,0009,0176,456,28,484,728,0,4,1,5,2,1,3,0.00,66.48,60.00
10,005,03,030,0010,0177,411,11,422,606,0,4,1,5,2,1,3,0.00,69.64,60.00
10,005,03,030,0011,0178,766,33,799,1148,0,4,1,5,2,1,3,0.00,69.60,60.00
10,005,03,030,0012,0179,990,62,1052,1288,0,4,1,5,2,1,3,0.00,81.68,60.00
10,005,03,030,0013,0180,406,22,428,588,0,4,1,5,2,1,3,0.00,72.79,60.00
10,005,03,030,0013,0181,499,14,513,702,0,4,1,5,2,1,3,0.00,73.08,60.00
10,005,03,040,0011,0000,679,38,717,1038,0,4,0,4,3,0,3,0.00,69.08,75.00
10,005,03,040,0012,0000,1633,144,1777,2654,0,4,0,4,3,0,3,0.00,66.96,75.00
10,005,03,040,0013,0000,825,76,901,1473,0,4,0,4,3,0,3,0.00,61.17,75.00
10,005,03,040,0014,0000,1248,52,1300,1850,0,4,0,4,3,0,3,0.00,70.27,75.00
10,005,03,040,0015,0000,707,35,742,1190,0,4,0,4,3,0,3,0.00,62.35,75.00
10,005,03,040,0016,0000,2438,130,2568,3959,0,4,0,4,3,0,3,0.00,64.86,75.00
10,005,03,040,0017,0000,1361,89,1450,2150,0,4,0,4,3,0,3,0.00,67.44,75.00
10,005,03,040,0018,0000,780,43,823,1104,0,4,0,4,3,0,3,0.00,74.55,75.00
10,005,03,040,0011,0315,679,38,717,1038,0,4,0,4,3,0,3,0.00,69.08,75.00
10,005,03,040,0012,0316,497,42,539,793,0,4,0,4,3,0,3,0.00,67.97,75.00
10,005,03,040,0012,0317,461,22,483,738,0,4,0,4,3,0,3,0.00,65.45,75.00
10,005,03,040,0012,0318,675,80,755,1123,0,4,0,4,3,0,3,0.00,67.23,75.00
10,005,03,040,0013,0319,447,40,487,801,0,4,0,4,3,0,3,0.00,60.80,75.00
10,005,03,040,0013,0320,378,36,414,672,0,4,0,4,3,0,3,0.00,61.61,75.00
10,005,03,040,0014,0321,651,16,667,924,0,4,0,4,3,0,3,0.00,72.19,75.00
10,005,03,040,0014,0322,597,36,633,926,0,4,0,4,3,0,3,0.00,68.36,75.00
10,005,03,040,0015,0323,707,35,742,1190,0,4,0,4,3,0,3,0.00,62.35,75.00
10,005,03,040,0016,0324,869,62,931,1412,0,4,0,4,3,0,3,0.00,65.93,75.00
10,005,03,040,0016,0325,821,35,856,1359,0,4,0,4,3,0,3,0.00,62.99,75.00
10,005,03,040,0016,0326,748,33,781,1188,0,4,0,4,3,0,3,0.00,65.74,75.00
10,005,03,040,0017,0327,524,40,564,904,0,4,0,4,3,0,3,0.00,62.39,75.00
10,005,03,040,0017,0328,503,27,530,740,0,4,0,4,3,0,3,0.00,71.62,75.00
10,005,03,040,0017,0329,334,22,356,506,0,4,0,4,3,0,3,0.00,70.36,75.00
10,005,03,040,0018,0330,780,43,823,1104,0,4,0,4,3,0,3,0.00,74.55,75.00
10,005,03,050,0015,0000,2640,135,2775,4357,0,6,2,8,4,1,5,0.00,63.69,62.50
10,005,03,050,0016,0000,2512,80,2592,3960,0,6,2,8,4,1,5,0.00,65.45,62.50
10,005,03,050,0017,0000,1825,97,1922,3235,0,6,2,8,4,1,5,0.00,59.41,62.50
10,005,03,050,0028,0000,1985,78,2063,3261,0,6,2,8,4,1,5,0.00,63.26,62.50
10,005,03,050,0029,0000,1971,124,2095,3454,0,6,2,8,4,1,5,0.00,60.65,62.50
10,005,03,050,0031,0000,1532,61,1593,2472,0,6,2,8,4,1,5,0.00,64.44,62.50
10,005,03,050,0032,0000,2047,76,2123,3377,0,6,2,8,4,1,5,0.00,62.87,62.50
10,005,03,050,0033,0000,1534,86,1620,2748,0,6,2,8,4,1,5,0.00,58.95,62.50
10,005,03,050,0016,0375,812,21,833,1248,0,6,2,8,4,1,5,0.00,66.75,62.50
10,005,03,050,0016,0376,878,35,913,1428,0,6,2,8,4,1,5,0.00,63.94,62.50
10,005,03,050,0016,0377,822,24,846,1284,0,6,2,8,4,1,5,0.00,65.89,62.50
10,005,03,050,0015,0378,798,42,840,1309,0,6,2,8,4,1,5,0.00,64.17,62.50
10,005,03,050,0015,0379,868,44,912,1490,0,6,2,8,4,1,5,0.00,61.21,62.50
10,005,03,050,0015,0380,974,49,1023,1558,0,6,2,8,4,1,5,0.00,65.66,62.50
10,005,03,050,0031,0381,731,33,764,1178,0,6,2,8,4,1,5,0.00,64.86,62.50
10,005,03,050,0031,0382,801,28,829,1294,0,6,2,8,4,1,5,0.00,64.06,62.50
10,005,03,050,0032,0383,629,24,653,1050,0,6,2,8,4,1,5,0.00,62.19,62.50
10,005,03,050,0032,0384,677,28,705,1090,0,6,2,8,4,1,5,0.00,64.68,62.50
10,005,03,050,0032,0385,741,24,765,1237,0,6,2,8,4,1,5,0.00,61.84,62.50
10,005,03,050,0033,0386,795,47,842,1398,0,6,2,8,4,1,5,0.00,60.23,62.50
10,005,03,050,0033,0387,739,39,778,1350,0,6,2,8,4,1,5,0.00,57.63,62.50
10,005,03,050,0017,0388,682,30,712,1105,0,6,2,8,4,1,5,0.00,64.43,62.50
10,005,03,050,0017,0389,662,32,694,1122,0,6,2,8,4,1,5,0.00,61.85,62.50
10,005,03,050,0017,0390,481,35,516,1008,0,6,2,8,4,1,5,0.00,51.19,62.50
10,005,03,050,0028,0391,699,31,730,1199,0,6,2,8,4,1,5,0.00,60.88,62.50
10,005,03,050,0028,0392,681,27,708,1076,0,6,2,8,4,1,5,0.00,65.80,62.50
10,005,03,050,0028,0393,605,20,625,986,0,6,2,8,4,1,5,0.00,63.39,62.50
10,005,03,050,0029,0394,637,31,668,1105,0,6,2,8,4,1,5,0.00,60.45,62.50
10,005,03,050,0029,0395,744,50,794,1236,0,6,2,8,4,1,5,0.00,64.24,62.50
10,005,03,050,0029,0396,590,43,633,1113,0,6,2,8,4,1,5,0.00,56.87,62.50
10,005,03,060,0005,0000,1571,50,1621,2156,0,2,2,4,0,2,2,0.00,75.19,50.00
10,005,03,060,0012,0000,968,35,1003,1418,0,2,2,4,0,2,2,0.00,70.73,50.00
10,005,03,060,0015,0000,725,29,754,943,0,2,2,4,0,2,2,0.00,79.96,50.00
10,005,03,060,0016,0000,657,24,681,862,0,2,2,4,0,2,2,0.00,79.00,50.00
10,005,03,060,0017,0000,471,10,481,640,0,2,2,4,0,2,2,0.00,75.16,50.00
10,005,03,060,0018,0000,759,22,781,984,0,2,2,4,0,2,2,0.00,79.37,50.00
10,005,03,060,0012,0250,474,23,497,690,0,2,2,4,0,2,2,0.00,72.03,50.00
10,005,03,060,0012,0251,494,12,506,728,0,2,2,4,0,2,2,0.00,69.51,50.00
10,005,03,060,0005,0252,759,23,782,1026,0,2,2,4,0,2,2,0.00,76.22,50.00
10,005,03,060,0005,0253,812,27,839,1130,0,2,2,4,0,2,2,0.00,74.25,50.00
10,005,03,060,0015,0254,725,29,754,943,0,2,2,4,0,2,2,0.00,79.96,50.00
10,005,03,060,0016,0255,657,24,681,862,0,2,2,4,0,2,2,0.00,79.00,50.00
10,005,03,060,0017,0256,471,10,481,640,0,2,2,4,0,2,2,0.00,75.16,50.00
10,005,03,060,0018,0257,759,22,781,984,0,2,2,4,0,2,2,0.00,79.37,50.00
10,005,03,070,0003,0000,1250,40,1290,1903,0,4,2,6,3,0,3,0.00,67.79,50.00
10,005,03,070,0009,0000,1357,22,1379,1979,0,4,2,6,3,0,3,0.00,69.68,50.00
10,005,03,070,0003,0465,529,21,550,801,0,4,2,6,3,0,3,0.00,68.66,50.00
10,005,03,070,0003,0466,497,14,511,755,0,4,2,6,3,0,3,0.00,67.68,50.00
10,005,03,070,0003,0467,224,5,229,347,0,4,2,6,3,0,3,0.00,65.99,50.00
10,005,03,070,0009,0468,427,5,432,626,0,4,2,6,3,0,3,0.00,69.01,50.00
10,005,03,070,0009,0469,497,5,502,712,0,4,2,6,3,0,3,0.00,70.51,50.00
10,005,03,070,0009,0470,433,12,445,641,0,4,2,6,3,0,3,0.00,69.42,50.00
10,005,03,080,0007,0000,378,15,393,569,0,2,1,3,1,1,2,0.00,69.07,66.67
10,005,03,080,0009,0000,480,18,498,687,0,2,1,3,1,1,2,0.00,72.49,66.67
10,005,03,080,0010,0000,330,7,337,452,0,2,1,3,1,1,2,0.00,74.56,66.67
10,005,03,080,0007,0442,378,15,393,569,0,2,1,3,1,1,2,0.00,69.07,66.67
10,005,03,080,0009,0443,480,18,498,687,0,2,1,3,1,1,2,0.00,72.49,66.67
10,005,03,080,0010,0444,330,7,337,452,0,2,1,3,1,1,2,0.00,74.56,66.67
10,005,03,090,0012,0089,818,36,854,1265,0,4,2,6,2,2,4,0.00,67.51,66.67
10,005,03,090,0012,0090,557,24,581,874,0,4,2,6,2,2,4,0.00,66.48,66.67
10,005,03,090,0013,0091,494,16,510,698,0,4,2,6,2,2,4,0.00,73.07,66.67
10,005,03,090,0013,0092,394,24,418,693,0,4,2,6,2,2,4,0.00,60.32,66.67
10,005,03,090,0014,0093,544,23,567,842,0,4,2,6,2,2,4,0.00,67.34,66.67
10,005,03,090,0014,0094,455,25,480,674,0,4,2,6,2,2,4,0.00,71.22,66.67
10,005,03,090,0015,0095,417,16,433,637,0,4,2,6,2,2,4,0.00,67.97,66.67
10,005,03,090,0015,0096,436,19,455,729,0,4,2,6,2,2,4,0.00,62.41,66.67
10,005,03,090,0017,0097,429,17,446,655,0,4,2,6,2,2,4,0.00,68.09,66.67
10,005,03,090,0017,0098,475,17,492,681,0,4,2,6,2,2,4,0.00,72.25,66.67
10,005,03,090,0016,0099,864,35,899,1246,0,4,2,6,2,2,4,0.00,72.15,66.67
10,005,03,090,0018,0100,169,5,174,195,0,4,2,6,2,2,4,0.00,89.23,66.67
10,005,03,090,0019,0101,216,8,224,306,0,4,2,6,2,2,4,0.00,73.20,66.67
10,005,03,090,0012,0000,1375,60,1435,2139,0,4,2,6,2,2,4,0.00,67.09,66.67
10,005,03,090,0013,0000,888,40,928,1391,0,4,2,6,2,2,4,0.00,66.71,66.67
10,005,03,090,0014,0000,999,48,1047,1516,0,4,2,6,2,2,4,0.00,69.06,66.67
10,005,03,090,0015,0000,853,35,888,1366,0,4,2,6,2,2,4,0.00,65.01,66.67
10,005,03,090,0016,0000,864,35,899,1246,0,4,2,6,2,2,4,0.00,72.15,66.67
10,005,03,090,0017,0000,904,34,938,1336,0,4,2,6,2,2,4,0.00,70.21,66.67
10,005,03,090,0018,0000,169,5,174,195,0,4,2,6,2,2,4,0.00,89.23,66.67
10,005,03,090,0019,0000,216,8,224,306,0,4,2,6,2,2,4,0.00,73.20,66.67
10,005,03,100,0001,0000,598,11,609,926,0,6,0,6,3,0,3,0.00,65.77,50.00
10,005,03,100,0003,0000,1093,18,1111,1561,0,6,0,6,3,0,3,0.00,71.17,50.00
10,005,03,100,0006,0000,692,13,705,985,0,6,0,6,3,0,3,0.00,71.57,50.00
10,005,03,100,0001,0120,598,11,609,926,0,6,0,6,3,0,3,0.00,65.77,50.00
10,005,03,100,0003,0121,626,9,635,894,0,6,0,6,3,0,3,0.00,71.03,50.00
10,005,03,100,0003,0122,467,9,476,667,0,6,0,6,3,0,3,0.00,71.36,50.00
10,005,03,100,0006,0123,692,13,705,985,0,6,0,6,3,0,3,0.00,71.57,50.00
10,005,03,110,0006,0000,724,16,740,993,0,3,1,4,2,0,2,0.00,74.52,50.00
10,005,03,110,0007,0000,670,21,691,932,0,3,1,4,2,0,2,0.00,74.14,50.00
10,005,03,110,0006,0430,724,16,740,993,0,3,1,4,2,0,2,0.00,74.52,50.00
10,005,03,110,0007,0431,670,21,691,932,0,3,1,4,2,0,2,0.00,74.14,50.00
10,005,03,120,0002,0000,1356,32,1388,1711,0,3,0,3,2,0,2,0.00,81.12,66.67
10,005,03,120,0002,0109,608,13,621,777,0,3,0,3,2,0,2,0.00,79.92,66.67
10,005,03,120,0002,0110,748,19,767,934,0,3,0,3,2,0,2,0.00,82.12,66.67
10,005,03,130,0002,0000,1187,12,1199,1741,0,3,1,4,2,1,3,0.00,68.87,75.00
10,005,03,130,0003,0000,890,25,915,1247,0,3,1,4,2,1,3,0.00,73.38,75.00
10,005,03,130,0003,0137,424,7,431,562,0,3,1,4,2,1,3,0.00,76.69,75.00
10,005,03,130,0003,0138,466,18,484,685,0,3,1,4,2,1,3,0.00,70.66,75.00
10,005,03,130,0002,0139,635,9,644,940,0,3,1,4,2,1,3,0.00,68.51,75.00
10,005,03,130,0002,0140,552,3,555,801,0,3,1,4,2,1,3,0.00,69.29,75.00
10,005,03,150,0004,0000,2240,74,2314,3172,0,4,3,7,4,1,5,0.00,72.95,71.43
10,005,03,150,0005,0000,331,10,341,448,0,4,3,7,4,1,5,0.00,76.12,71.43
10,005,03,150,0006,0000,348,3,351,450,0,4,3,7,4,1,5,0.00,78.00,71.43
10,005,03,150,0004,0269,774,27,801,1116,0,4,3,7,4,1,5,0.00,71.77,71.43
10,005,03,150,0004,0270,723,19,742,997,0,4,3,7,4,1,5,0.00,74.42,71.43
10,005,03,150,0004,0271,743,28,771,1059,0,4,3,7,4,1,5,0.00,72.80,71.43
10,005,03,150,0005,0272,331,10,341,448,0,4,3,7,4,1,5,0.00,76.12,71.43
10,005,03,150,0006,0273,348,3,351,450,0,4,3,7,4,1,5,0.00,78.00,71.43
10,005,03,160,0006,0000,382,9,391,524,0,2,0,2,1,0,1,0.00,74.62,50.00
10,005,03,160,0007,0000,298,11,309,376,0,2,0,2,1,0,1,0.00,82.18,50.00
10,005,03,160,0008,0000,231,16,247,357,0,2,0,2,1,0,1,0.00,69.19,50.00
10,005,03,160,0006,0422,382,9,391,524,0,2,0,2,1,0,1,0.00,74.62,50.00
10,005,03,160,0007,0423,298,11,309,376,0,2,0,2,1,0,1,0.00,82.18,50.00
10,005,03,160,0008,0424,231,16,247,357,0,2,0,2,1,0,1,0.00,69.19,50.00
10,005,03,170,0006,0000,274,2,276,312,0,2,1,3,1,1,2,0.00,88.46,66.67
10,005,03,170,0007,0000,543,16,559,644,0,2,1,3,1,1,2,0.00,86.80,66.67
10,005,03,170,0006,0454,274,2,276,312,0,2,1,3,1,1,2,0.00,88.46,66.67
10,005,03,170,0007,0455,543,16,559,644,0,2,1,3,1,1,2,0.00,86.80,66.67
10,005,03,180,0006,0000,425,7,432,482,0,6,0,6,3,0,3,0.00,89.63,50.00
10,005,03,180,0007,0000,577,8,585,645,0,6,0,6,3,0,3,0.00,90.70,50.00
10,005,03,180,0008,0000,503,9,512,588,0,6,0,6,3,0,3,0.00,87.07,50.00
10,005,03,180,0006,0482,425,7,432,482,0,6,0,6,3,0,3,0.00,89.63,50.00
10,005,03,180,0007,0483,577,8,585,645,0,6,0,6,3,0,3,0.00,90.70,50.00
10,005,03,180,0008,0484,503,9,512,588,0,6,0,6,3,0,3,0.00,87.07,50.00
10,005,00,040,0000,0000,41300,2110,43410,68404,88074,18,7,25,10,3,13,77.67,63.46,52.00
10,005,01,040,0000,0000,10334,530,10864,17509,22929,4,2,6,2,1,3,76.36,62.05,50.00
10,005,02,040,0000,0000,14262,709,14971,23962,32283,8,3,11,4,1,5,74.22,62.48,45.45
10,005,03,040,0000,0000,9671,607,10278,15418,19104,4,0,4,3,0,3,80.71,66.66,75.00
10,005,04,040,0000,0000,7033,264,7297,11515,13758,2,2,4,1,1,2,83.70,63.37,50.00
10,005,04,010,0002,0000,2209,160,2369,3843,0,7,2,9,4,1,5,0.00,61.64,55.56
10,005,04,010,0002,0050,579,41,620,935,0,7,2,9,4,1,5,0.00,66.31,55.56
10,005,04,010,0002,0051,568,27,595,936,0,7,2,9,4,1,5,0.00,63.57,55.56
10,005,04,010,0002,0052,531,43,574,1022,0,7,2,9,4,1,5,0.00,56.16,55.56
10,005,04,010,0002,0053,531,49,580,950,0,7,2,9,4,1,5,0.00,61.05,55.56
10,005,04,010,0022,0054,642,42,684,1091,0,7,2,9,4,1,5,0.00,62.69,55.56
10,005,04,010,0022,0055,708,36,744,1249,0,7,2,9,4,1,5,0.00,59.57,55.56
10,005,04,010,0022,0056,758,58,816,1294,0,7,2,9,4,1,5,0.00,63.06,55.56
10,005,04,010,0022,0057,803,49,852,1535,0,7,2,9,4,1,5,0.00,55.50,55.56
10,005,04,010,0021,0058,648,28,676,1054,0,7,2,9,4,1,5,0.00,64.14,55.56
10,005,04,010,0021,0059,612,47,659,992,0,7,2,9,4,1,5,0.00,66.43,55.56
10,005,04,010,0021,0060,581,47,628,1031,0,7,2,9,4,1,5,0.00,60.91,55.56
10,005,04,010,0021,0061,587,40,627,1017,0,7,2,9,4,1,5,0.00,61.65,55.56
10,005,04,010,0028,0062,839,46,885,1229,0,7,2,9,4,1,5,0.00,72.01,55.56
10,005,04,010,0028,0063,847,34,881,1366,0,7,2,9,4,1,5,0.00,64.49,55.56
10,005,04,010,0028,0064,494,33,527,844,0,7,2,9,4,1,5,0.00,62.44,55.56
10,005,04,010,0020,0065,752,44,796,1105,0,7,2,9,4,1,5,0.00,72.04,55.56
10,005,04,010,0027,0066,575,33,608,1006,0,7,2,9,4,1,5,0.00,60.44,55.56
10,005,04,010,0027,0067,444,37,481,839,0,7,2,9,4,1,5,0.00,57.33,55.56
10,005,04,010,0024,0068,420,17,437,749,0,7,2,9,4,1,5,0.00,58.34,55.56
10,005,04,010,0024,0069,424,29,453,809,0,7,2,9,4,1,5,0.00,56.00,55.56
10,005,04,010,0020,0000,752,44,796,1105,0,7,2,9,4,1,5,0.00,72.04,55.56
10,005,04,010,0021,0000,2428,162,2590,4094,0,7,2,9,4,1,5,0.00,63.26,55.56
10,005,04,010,0022,0000,2911,185,3096,5169,0,7,2,9,4,1,5,0.00,59.90,55.56
10,005,04,010,0024,0000,844,46,890,1558,0,7,2,9,4,1,5,0.00,57.12,55.56
10,005,04,010,0027,0000,1019,70,1089,1845,0,7,2,9,4,1,5,0.00,59.02,55.56
10,005,04,010,0028,0000,2180,113,2293,3439,0,7,2,9,4,1,5,0.00,66.68,55.56
10,005,04,030,0019,0182,678,14,692,1033,0,2,1,3,1,1,2,0.00,66.99,66.67
10,005,04,030,0019,0183,680,19,699,1080,0,2,1,3,1,1,2,0.00,64.72,66.67
10,005,04,030,0020,0184,675,33,708,1037,0,2,1,3,1,1,2,0.00,68.27,66.67
10,005,04,030,0021,0185,501,27,528,693,0,2,1,3,1,1,2,0.00,76.19,66.67
10,005,04,030,0022,0186,346,27,373,584,0,2,1,3,1,1,2,0.00,63.87,66.67
10,005,04,030,0022,0187,419,16,435,765,0,2,1,3,1,1,2,0.00,56.86,66.67
10,005,04,030,0023,0188,505,37,542,696,0,2,1,3,1,1,2,0.00,77.87,66.67
10,005,04,030,0019,0000,1358,33,1391,2113,0,2,1,3,1,1,2,0.00,65.83,66.67
10,005,04,030,0020,0000,675,33,708,1037,0,2,1,3,1,1,2,0.00,68.27,66.67
10,005,04,030,0021,0000,501,27,528,693,0,2,1,3,1,1,2,0.00,76.19,66.67
10,005,04,030,0022,0000,765,43,808,1349,0,2,1,3,1,1,2,0.00,59.90,66.67
10,005,04,030,0023,0000,505,37,542,696,0,2,1,3,1,1,2,0.00,77.87,66.67
10,005,04,040,0019,0000,2863,106,2969,4899,0,2,2,4,1,1,2,0.00,60.60,50.00
10,005,04,040,0020,0000,1320,42,1362,1991,0,2,2,4,1,1,2,0.00,68.41,50.00
10,005,04,040,0021,0000,2194,98,2292,3669,0,2,2,4,1,1,2,0.00,62.47,50.00
10,005,04,040,0022,0000,656,18,674,956,0,2,2,4,1,1,2,0.00,70.50,50.00
10,005,04,040,0019,0331,632,36,668,1252,0,2,2,4,1,1,2,0.00,53.35,50.00
10,005,04,040,0019,0332,737,29,766,1242,0,2,2,4,1,1,2,0.00,61.67,50.00
10,005,04,040,0019,0333,752,29,781,1300,0,2,2,4,1,1,2,0.00,60.08,50.00
10,005,04,040,0019,0334,742,12,754,1105,0,2,2,4,1,1,2,0.00,68.24,50.00
10,005,04,040,0020,0335,723,20,743,1056,0,2,2,4,1,1,2,0.00,70.36,50.00
10,005,04,040,0020,0336,597,22,619,935,0,2,2,4,1,1,2,0.00,66.20,50.00
10,005,04,040,0021,0337,325,16,341,509,0,2,2,4,1,1,2,0.00,66.99,50.00
10,005,04,040,0021,0338,596,27,623,1012,0,2,2,4,1,1,2,0.00,61.56,50.00
10,005,04,040,0021,0339,528,19,547,801,0,2,2,4,1,1,2,0.00,68.29,50.00
10,005,04,040,0021,0340,745,36,781,1347,0,2,2,4,1,1,2,0.00,57.98,50.00
10,005,04,040,0022,0341,656,18,674,956,0,2,2,4,1,1,2,0.00,70.50,50.00
10,005,04,050,0013,0000,1073,96,1169,1951,0,4,0,4,2,0,2,0.00,59.92,50.00
10,005,04,050,0014,0000,2267,219,2486,4518,0,4,0,4,2,0,2,0.00,55.02,50.00
10,005,04,050,0018,0000,2185,144,2329,3821,0,4,0,4,2,0,2,0.00,60.95,50.00
10,005,04,050,0026,0000,1338,81,1419,2216,0,4,0,4,2,0,2,0.00,64.03,50.00
10,005,04,050,0013,0397,509,48,557,954,0,4,0,4,2,0,2,0.00,58.39,50.00
10,005,04,050,0013,0398,564,48,612,997,0,4,0,4,2,0,2,0.00,61.38,50.00
10,005,04,050,0026,0399,690,41,731,1119,0,4,0,4,2,0,2,0.00,65.33,50.00
10,005,04,050,0026,0400,648,40,688,1097,0,4,0,4,2,0,2,0.00,62.72,50.00
10,005,04,050,0014,0401,757,62,819,1540,0,4,0,4,2,0,2,0.00,53.18,50.00
10,005,04,050,0014,0402,779,72,851,1481,0,4,0,4,2,0,2,0.00,57.46,50.00
10,005,04,050,0014,0403,731,85,816,1497,0,4,0,4,2,0,2,0.00,54.51,50.00
10,005,04,050,0018,0404,684,41,725,1195,0,4,0,4,2,0,2,0.00,60.67,50.00
10,005,04,050,0018,0405,794,47,841,1313,0,4,0,4,2,0,2,0.00,64.05,50.00
10,005,04,050,0018,0406,707,56,763,1313,0,4,0,4,2,0,2,0.00,58.11,50.00
10,005,04,060,0019,0000,400,15,415,545,0,3,0,3,2,0,2,0.00,76.15,66.67
10,005,04,060,0020,0000,763,31,794,1208,0,3,0,3,2,0,2,0.00,65.73,66.67
10,005,04,060,0021,0000,447,10,457,673,0,3,0,3,2,0,2,0.00,67.90,66.67
10,005,04,060,0022,0000,628,22,650,945,0,3,0,3,2,0,2,0.00,68.78,66.67
10,005,04,060,0023,0000,795,35,830,1139,0,3,0,3,2,0,2,0.00,72.87,66.67
10,005,04,060,0019,0258,400,15,415,545,0,3,0,3,2,0,2,0.00,76.15,66.67
10,005,04,060,0020,0259,763,31,794,1208,0,3,0,3,2,0,2,0.00,65.73,66.67
10,005,04,060,0021,0260,447,10,457,673,0,3,0,3,2,0,2,0.00,67.90,66.67
10,005,04,060,0022,0261,231,8,239,371,0,3,0,3,2,0,2,0.00,64.42,66.67
10,005,04,060,0022,0262,397,14,411,574,0,3,0,3,2,0,2,0.00,71.60,66.67
10,005,04,060,0023,0263,459,22,481,687,0,3,0,3,2,0,2,0.00,70.01,66.67
10,005,04,060,0023,0264,336,13,349,452,0,3,0,3,2,0,2,0.00,77.21,66.67
10,005,04,070,0006,0000,593,26,619,892,0,3,0,3,2,0,2,0.00,69.39,66.67
10,005,04,070,0011,0000,1189,25,1214,1630,0,3,0,3,2,0,2,0.00,74.48,66.67
10,005,04,070,0011,0471,751,17,768,1025,0,3,0,3,2,0,2,0.00,74.93,66.67
10,005,04,070,0011,0472,438,8,446,605,0,3,0,3,2,0,2,0.00,73.72,66.67
10,005,04,070,0006,0474,593,26,619,892,0,3,0,3,2,0,2,0.00,69.39,66.67
10,005,04,080,0008,0000,943,27,970,1367,0,4,0,4,3,0,3,0.00,70.96,75.00
10,005,04,080,0011,0000,635,12,647,950,0,4,0,4,3,0,3,0.00,68.11,75.00
10,005,04,080,0012,0000,734,34,768,948,0,4,0,4,3,0,3,0.00,81.01,75.00
10,005,04,080,0008,0445,372,15,387,575,0,4,0,4,3,0,3,0.00,67.30,75.00
10,005,04,080,0008,0446,571,12,583,792,0,4,0,4,3,0,3,0.00,73.61,75.00
10,005,04,080,0011,0447,635,12,647,950,0,4,0,4,3,0,3,0.00,68.11,75.00
10,005,04,080,0012,0448,734,34,768,948,0,4,0,4,3,0,3,0.00,81.01,75.00
10,005,04,100,0007,0000,1924,40,1964,2990,0,2,1,3,2,0,2,0.00,65.69,66.67
10,005,04,100,0007,0124,657,14,671,1022,0,2,1,3,2,0,2,0.00,65.66,66.67
10,005,04,100,0007,0125,545,15,560,796,0,2,1,3,2,0,2,0.00,70.35,66.67
10,005,04,100,0007,0126,722,11,733,1172,0,2,1,3,2,0,2,0.00,62.54,66.67
10,005,04,120,0007,0000,686,25,711,895,0,2,0,2,1,0,1,0.00,79.44,50.00
10,005,04,120,0007,0111,532,23,555,703,0,2,0,2,1,0,1,0.00,78.95,50.00
10,005,04,120,0007,0112,154,2,156,192,0,2,0,2,1,0,1,0.00,81.25,50.00
10,005,04,130,0005,0000,1067,24,1091,1366,0,3,0,3,2,0,2,0.00,79.87,66.67
10,005,04,130,0007,0000,884,25,909,1224,0,3,0,3,2,0,2,0.00,74.26,66.67
10,005,04,130,0005,0141,521,11,532,665,0,3,0,3,2,0,2,0.00,80.00,66.67
10,005,04,130,0005,0142,546,13,559,701,0,3,0,3,2,0,2,0.00,79.74,66.67
10,005,04,130,0007,0144,424,10,434,608,0,3,0,3,2,0,2,0.00,71.38,66.67
10,005,04,130,0007,0145,460,15,475,616,0,3,0,3,2,0,2,0.00,77.11,66.67
10,005,04,150,0007,0000,895,24,919,1192,0,4,0,4,3,0,3,0.00,77.10,75.00
10,005,04,150,0008,0000,561,23,584,827,0,4,0,4,3,0,3,0.00,70.62,75.00
10,005,04,150,0009,0000,651,29,680,896,0,4,0,4,3,0,3,0.00,75.89,75.00
10,005,04,150,0007,0274,895,24,919,1192,0,4,0,4,3,0,3,0.00,77.10,75.00
10,005,04,150,0008,0275,561,23,584,827,0,4,0,4,3,0,3,0.00,70.62,75.00
10,005,04,150,0009,0276,651,29,680,896,0,4,0,4,3,0,3,0.00,75.89,75.00
10,005,00,050,0000,0000,49540,2343,51883,83212,105164,26,4,30,13,2,15,79.13,62.35,50.00
10,005,01,050,0000,0000,8800,326,9126,14343,17164,6,0,6,3,0,3,83.56,63.63,50.00
10,005,02,050,0000,0000,11531,442,11973,19415,24089,4,2,6,2,1,3,80.60,61.67,50.00
10,005,03,050,0000,0000,16046,737,16783,26864,35804,6,2,8,4,1,5,75.03,62.47,62.50
10,005,04,050,0000,0000,6863,540,7403,12506,16094,4,0,4,2,0,2,77.71,59.20,50.00
10,005,05,050,0000,0000,6300,298,6598,10084,12013,6,0,6,2,0,2,83.94,65.43,33.33
10,005,05,050,0019,0000,784,57,841,1226,0,6,0,6,2,0,2,0.00,68.60,33.33
10,005,05,050,0022,0000,756,33,789,1229,0,6,0,6,2,0,2,0.00,64.20,33.33
10,005,05,050,0023,0000,1420,48,1468,2388,0,6,0,6,2,0,2,0.00,61.47,33.33
10,005,05,050,0024,0000,629,27,656,853,0,6,0,6,2,0,2,0.00,76.91,33.33
10,005,05,050,0025,0000,1362,39,1401,2095,0,6,0,6,2,0,2,0.00,66.87,33.33
10,005,05,050,0027,0000,1349,94,1443,2293,0,6,0,6,2,0,2,0.00,62.93,33.33
10,005,05,050,0027,0407,699,38,737,1190,0,6,0,6,2,0,2,0.00,61.93,33.33
10,005,05,050,0027,0408,650,56,706,1103,0,6,0,6,2,0,2,0.00,64.01,33.33
10,005,05,050,0019,0409,784,57,841,1226,0,6,0,6,2,0,2,0.00,68.60,33.33
10,005,05,050,0022,0410,756,33,789,1229,0,6,0,6,2,0,2,0.00,64.20,33.33
10,005,05,050,0024,0411,629,27,656,853,0,6,0,6,2,0,2,0.00,76.91,33.33
10,005,05,050,0023,0412,738,23,761,1214,0,6,0,6,2,0,2,0.00,62.69,33.33
10,005,05,050,0023,0413,682,25,707,1174,0,6,0,6,2,0,2,0.00,60.22,33.33
10,005,05,050,0025,0414,672,15,687,1026,0,6,0,6,2,0,2,0.00,66.96,33.33
10,005,05,050,0025,0415,690,24,714,1069,0,6,0,6,2,0,2,0.00,66.79,33.33
10,005,05,100,0008,0000,386,8,394,515,0,2,0,2,1,0,1,0.00,76.50,50.00
10,005,05,100,0009,0000,318,7,325,400,0,2,0,2,1,0,1,0.00,81.25,50.00
10,005,05,100,0010,0000,404,14,418,505,0,2,0,2,1,0,1,0.00,82.77,50.00
10,005,05,100,0008,0127,386,8,394,515,0,2,0,2,1,0,1,0.00,76.50,50.00
10,005,05,100,0009,0128,318,7,325,400,0,2,0,2,1,0,1,0.00,81.25,50.00
10,005,05,100,0010,0129,404,14,418,505,0,2,0,2,1,0,1,0.00,82.77,50.00
10,005,05,120,0008,0000,272,3,275,305,0,2,0,2,1,0,1,0.00,90.16,50.00
10,005,05,120,0008,0113,272,3,275,305,0,2,0,2,1,0,1,0.00,90.16,50.00
10,005,00,060,0000,0000,19559,1376,20935,29114,34426,13,3,16,8,3,11,84.57,71.91,68.75
10,005,01,060,0000,0000,6523,931,7454,10838,13145,3,1,4,3,1,4,82.45,68.78,100.00
10,005,02,060,0000,0000,4852,162,5014,6763,8157,5,0,5,3,0,3,82.91,74.14,60.00
10,005,03,060,0000,0000,5151,170,5321,7003,7981,2,2,4,0,2,2,87.75,75.98,50.00
10,005,04,060,0000,0000,3033,113,3146,4510,5143,3,0,3,2,0,2,87.69,69.76,66.67
10,005,00,070,0000,0000,9381,243,9624,13552,15544,13,4,17,10,1,11,87.18,71.02,64.71
10,005,01,070,0000,0000,3360,90,3450,4870,5527,3,2,5,3,1,4,88.11,70.84,80.00
10,005,02,070,0000,0000,1632,40,1672,2278,2556,3,0,3,2,0,2,89.12,73.40,66.67
10,005,03,070,0000,0000,2607,62,2669,3882,4463,4,2,6,3,0,3,86.98,68.75,50.00
10,005,04,070,0000,0000,1782,51,1833,2522,2998,3,0,3,2,0,2,84.12,72.68,66.67
10,005,00,080,0000,0000,8113,239,8352,11526,13277,15,1,16,10,1,11,86.81,72.46,68.75
10,005,01,080,0000,0000,2341,66,2407,3153,3600,5,0,5,3,0,3,87.58,76.34,60.00
10,005,02,080,0000,0000,2272,60,2332,3400,3929,4,0,4,3,0,3,86.54,68.59,75.00
10,005,03,080,0000,0000,1188,40,1228,1708,1956,2,1,3,1,1,2,87.32,71.90,66.67
10,005,04,080,0000,0000,2312,73,2385,3265,3792,4,0,4,3,0,3,86.10,73.05,75.00
10,005,00,090,0000,0000,17119,736,17855,26655,31502,11,5,16,6,5,11,84.61,66.99,68.75
10,005,01,090,0000,0000,7980,230,8210,12302,14929,6,2,8,3,2,5,82.40,66.74,62.50
10,005,02,090,0000,0000,2871,241,3112,4858,5663,1,1,2,1,1,2,85.78,64.06,100.00
10,005,03,090,0000,0000,6268,265,6533,9495,10910,4,2,6,2,2,4,87.03,68.80,66.67
10,005,00,100,0000,0000,9979,220,10199,14298,16721,15,5,20,8,3,11,85.51,71.33,55.00
10,005,01,100,0000,0000,2836,52,2888,4145,4931,3,3,6,1,2,3,84.06,69.67,50.00
10,005,02,100,0000,0000,1728,57,1785,2271,2651,2,1,3,1,1,2,85.67,78.60,66.67
10,005,03,100,0000,0000,2383,42,2425,3472,4049,6,0,6,3,0,3,85.75,69.84,50.00
10,005,04,100,0000,0000,1924,40,1964,2990,3468,2,1,3,2,0,2,86.22,65.69,66.67
10,005,05,100,0000,0000,1108,29,1137,1420,1622,2,0,2,1,0,1,87.55,80.07,50.00
10,005,00,110,0000,0000,4428,128,4556,6518,7289,9,2,11,5,1,6,89.42,69.90,54.55
10,005,01,110,0000,0000,2110,47,2157,3150,3554,4,1,5,2,1,3,88.63,68.48,60.00
10,005,02,110,0000,0000,924,44,968,1443,1598,2,0,2,1,0,1,90.30,67.08,50.00
10,005,03,110,0000,0000,1394,37,1431,1925,2137,3,1,4,2,0,2,90.08,74.34,50.00
10,005,00,120,0000,0000,6739,179,6918,8722,9965,15,2,17,9,2,11,87.53,79.32,64.71
10,005,01,120,0000,0000,3461,95,3556,4622,5385,6,2,8,4,2,6,85.83,76.94,75.00
10,005,02,120,0000,0000,964,24,988,1189,1341,2,0,2,1,0,1,88.67,83.10,50.00
10,005,03,120,0000,0000,1356,32,1388,1711,1954,3,0,3,2,0,2,87.56,81.12,66.67
10,005,04,120,0000,0000,686,25,711,895,971,2,0,2,1,0,1,92.17,79.44,50.00
10,005,05,120,0000,0000,272,3,275,305,314,2,0,2,1,0,1,97.13,90.16,50.00
10,005,00,130,0000,0000,8634,335,8969,12851,15179,12,2,14,9,2,11,84.66,69.79,78.57
10,005,01,130,0000,0000,2176,196,2372,3736,4433,3,0,3,3,0,3,84.28,63.49,100.00
10,005,02,130,0000,0000,2430,53,2483,3537,4244,3,1,4,2,1,3,83.34,70.20,75.00
10,005,03,130,0000,0000,2077,37,2114,2988,3526,3,1,4,2,1,3,84.74,70.75,75.00
10,005,04,130,0000,0000,1951,49,2000,2590,2976,3,0,3,2,0,2,87.03,77.22,66.67
10,005,00,140,0000,0000,4401,115,4516,5875,6471,7,3,10,4,3,7,90.79,76.87,70.00
10,005,01,140,0000,0000,1739,56,1795,2444,2655,3,2,5,1,2,3,92.05,73.45,60.00
10,005,02,140,0000,0000,2662,59,2721,3431,3816,4,1,5,3,1,4,89.91,79.31,80.00
10,005,00,150,0000,0000,7116,311,7427,10208,11734,12,3,15,10,1,11,87.00,72.76,73.33
10,005,01,150,0000,0000,1250,53,1303,1899,2206,3,0,3,2,0,2,86.08,68.62,66.67
10,005,02,150,0000,0000,840,95,935,1324,1510,1,0,1,1,0,1,87.68,70.62,100.00
10,005,03,150,0000,0000,2919,87,3006,4070,4733,4,3,7,4,1,5,85.99,73.86,71.43
10,005,04,150,0000,0000,2107,76,2183,2915,3285,4,0,4,3,0,3,88.74,74.89,75.00
10,005,00,160,0000,0000,4098,97,4195,5441,6199,7,4,11,4,3,7,87.77,77.10,63.64
10,005,01,160,0000,0000,2644,50,2694,3469,4019,5,2,7,3,2,5,86.32,77.66,71.43
10,005,02,160,0000,0000,543,11,554,715,809,0,2,2,0,1,1,88.38,77.48,50.00
10,005,03,160,0000,0000,911,36,947,1257,1371,2,0,2,1,0,1,91.68,75.34,50.00
10,005,00,170,0000,0000,3189,59,3248,3779,4163,8,2,10,6,1,7,90.78,85.95,70.00
10,005,01,170,0000,0000,1414,26,1440,1716,1893,3,1,4,3,0,3,90.65,83.92,75.00
10,005,02,170,0000,0000,958,15,973,1107,1232,3,0,3,2,0,2,89.85,87.90,66.67
10,005,03,170,0000,0000,817,18,835,956,1038,2,1,3,1,1,2,92.10,87.34,66.67
10,005,00,180,0000,0000,4116,75,4191,4886,5760,12,2,14,5,2,7,84.83,85.78,50.00
10,005,01,180,0000,0000,1109,22,1131,1355,1585,4,1,5,1,1,2,85.49,83.47,40.00
10,005,02,180,0000,0000,1502,29,1531,1816,2058,2,1,3,1,1,2,88.24,84.31,66.67
10,005,03,180,0000,0000,1505,24,1529,1715,2117,6,0,6,3,0,3,81.01,89.15,50.00
10,007,00,000,0000,0000,640097,26066,666163,1025269,1245445,362,125,487,223,93,316,82.32,64.97,64.89
10,007,00,010,0000,0000,108502,5122,113624,182847,226380,27,13,40,16,8,24,80.77,62.14,60.00
10,007,01,010,0000,0000,29143,1314,30457,50704,63208,9,4,13,5,2,7,80.22,60.07,53.85
10,007,02,010,0000,0000,27911,1179,29090,46694,57160,6,3,9,4,2,6,81.69,62.30,66.67
10,007,03,010,0000,0000,17422,1156,18578,29785,37815,4,3,7,1,3,4,78.77,62.37,57.14
10,007,04,010,0000,0000,34026,1473,35499,55664,68197,8,3,11,6,1,7,81.62,63.77,63.64
10,007,01,010,0032,0001,551,19,570,843,0,9,4,13,5,2,7,0.00,67.62,53.85
10,007,01,010,0032,0002,323,26,349,635,0,9,4,13,5,2,7,0.00,54.96,53.85
10,007,01,010,0032,0003,548,17,565,856,0,9,4,13,5,2,7,0.00,66.00,53.85
10,007,01,010,0034,0004,408,20,428,718,0,9,4,13,5,2,7,0.00,59.61,53.85
10,007,01,010,0034,0005,408,24,432,722,0,9,4,13,5,2,7,0.00,59.83,53.85
10,007,01,010,0038,0006,399,27,426,670,0,9,4,13,5,2,7,0.00,63.58,53.85
10,007,01,010,0038,0007,416,13,429,697,0,9,4,13,5,2,7,0.00,61.55,53.85
10,007,01,010,0037,0008,375,19,394,709,0,9,4,13,5,2,7,0.00,55.57,53.85
10,007,01,010,0037,0009,545,38,583,1005,0,9,4,13,5,2,7,0.00,58.01,53.85
10,007,01,010,0035,0010,583,32,615,952,0,9,4,13,5,2,7,0.00,64.60,53.85
10,007,01,010,0036,0011,638,46,684,1130,0,9,4,13,5,2,7,0.00,60.53,53.85
10,007,01,010,0048,0012,631,31,662,1045,0,9,4,13,5,2,7,0.00,63.35,53.85
10,007,01,010,0048,0013,658,21,679,1080,0,9,4,13,5,2,7,0.00,62.87,53.85
10,007,01,010,0045,0014,428,21,449,755,0,9,4,13,5,2,7,0.00,59.47,53.85
10,007,01,010,0045,0015,339,13,352,570,0,9,4,13,5,2,7,0.00,61.75,53.85
10,007,01,010,0046,0016,679,32,711,1139,0,9,4,13,5,2,7,0.00,62.42,53.85
10,007,01,010,0046,0017,461,23,484,1359,0,9,4,13,5,2,7,0.00,35.61,53.85
10,007,01,010,0047,0018,679,31,710,1265,0,9,4,13,5,2,7,0.00,56.13,53.85
10,007,01,010,0047,0019,678,31,709,1198,0,9,4,13,5,2,7,0.00,59.18,53.85
10,007,01,010,0047,0020,628,25,653,1139,0,9,4,13,5,2,7,0.00,57.33,53.85
10,007,01,010,0047,0021,685,26,711,1246,0,9,4,13,5,2,7,0.00,57.06,53.85
10,007,01,010,0047,0022,451,24,475,744,0,9,4,13,5,2,7,0.00,63.84,53.85
10,007,01,010,0047,0023,443,20,463,786,0,9,4,13,5,2,7,0.00,58.91,53.85
10,007,01,010,0047,0024,630,30,660,1128,0,9,4,13,5,2,7,0.00,58.51,53.85
10,007,01,010,0047,0025,685,34,719,1282,0,9,4,13,5,2,7,0.00,56.08,53.85
10,007,01,010,0041,0026,728,22,750,1133,0,9,4,13,5,2,7,0.00,66.20,53.85
10,007,01,010,0041,0027,750,24,774,1197,0,9,4,13,5,2,7,0.00,64.66,53.85
10,007,01,010,0041,0028,756,30,786,1253,0,9,4,13,5,2,7,0.00,62.73,53.85
10,007,01,010,0041,0029,693,32,725,1197,0,9,4,13,5,2,7,0.00,60.57,53.85
10,007,01,010,0042,0030,817,27,844,1335,0,9,4,13,5,2,7,0.00,63.22,53.85
10,007,01,010,0042,0031,631,13,644,1019,0,9,4,13,5,2,7,0.00,63.20,53.85
10,007,01,010,0042,0032,776,24,800,1291,0,9,4,13,5,2,7,0.00,61.97,53.85
10,007,01,010,0042,0033,682,29,711,1200,0,9,4,13,5,2,7,0.00,59.25,53.85
10,007,01,010,0042,0034,763,19,782,1285,0,9,4,13,5,2,7,0.00,60.86,53.85
10,007,01,010,0042,0035,698,32,730,1242,0,9,4,13,5,2,7,0.00,58.78,53.85
10,007,01,010,0039,0036,551,13,564,982,0,9,4,13,5,2,7,0.00,57.43,53.85
10,007,01,010,0039,0037,559,35,594,1041,0,9,4,13,5,2,7,0.00,57.06,53.85
10,007,01,010,0039,0038,655,40,695,1158,0,9,4,13,5,2,7,0.00,60.02,53.85
10,007,01,010,0039,0039,592,24,616,1054,0,9,4,13,5,2,7,0.00,58.44,53.85
10,007,01,010,0039,0040,623,20,643,1061,0,9,4,13,5,2,7,0.00,60.60,53.85
10,007,01,010,0039,0041,591,19,610,979,0,9,4,13,5,2,7,0.00,62.31,53.85
10,007,01,010,0039,0042,537,24,561,905,0,9,4,13,5,2,7,0.00,61.99,53.85
10,007,01,010,0040,0043,420,21,441,660,0,9,4,13,5,2,7,0.00,66.82,53.85
10,007,01,010,0040,0044,434,22,456,756,0,9,4,13,5,2,7,0.00,60.32,53.85
10,007,01,010,0049,0045,535,36,571,925,0,9,4,13,5,2,7,0.00,61.73,53.85
10,007,01,010,0043,0046,451,30,481,801,0,9,4,13,5,2,7,0.00,60.05,53.85
10,007,01,010,0043,0047,513,29,542,863,0,9,4,13,5,2,7,0.00,62.80,53.85
10,007,01,010,0043,0048,524,36,560,986,0,9,4,13,5,2,7,0.00,56.80,53.85
10,007,01,010,0044,0049,553,23,576,960,0,9,4,13,5,2,7,0.00,60.00,53.85
10,007,01,010,0044,0050,496,22,518,839,0,9,4,13,5,2,7,0.00,61.74,53.85
10,007,01,010,0044,0051,546,25,571,909,0,9,4,13,5,2,7,0.00,62.82,53.85
10,007,01,010,0032,0000,1422,62,1484,2334,0,9,4,13,5,2,7,0.00,63.58,53.85
10,007,01,010,0034,0000,816,44,860,1440,0,9,4,13,5,2,7,0.00,59.72,53.85
10,007,01,010,0035,0000,583,32,615,952,0,9,4,13,5,2,7,0.00,64.60,53.85
10,007,01,010,0036,0000,638,46,684,1130,0,9,4,13,5,2,7,0.00,60.53,53.85
10,007,01,010,0037,0000,920,57,977,1714,0,9,4,13,5,2,7,0.00,57.00,53.85
10,007,01,010,0038,0000,815,40,855,1367,0,9,4,13,5,2,7,0.00,62.55,53.85
10,007,01,010,0039,0000,4108,175,4283,7180,0,9,4,13,5,2,7,0.00,59.65,53.85
10,007,01,010,0040,0000,854,43,897,1416,0,9,4,13,5,2,7,0.00,63.35,53.85
10,007,01,010,0041,0000,2927,108,3035,4780,0,9,4,13,5,2,7,0.00,63.49,53.85
10,007,01,010,0042,0000,4367,144,4511,7372,0,9,4,13,5,2,7,0.00,61.19,53.85
10,007,01,010,0043,0000,1488,95,1583,2650,0,9,4,13,5,2,7,0.00,59.74,53.85
10,007,01,010,0044,0000,1595,70,1665,2708,0,9,4,13,5,2,7,0.00,61.48,53.85
10,007,01,010,0045,0000,767,34,801,1325,0,9,4,13,5,2,7,0.00,60.45,53.85
10,007,01,010,0046,0000,1140,55,1195,2498,0,9,4,13,5,2,7,0.00,47.84,53.85
10,007,01,010,0047,0000,4879,221,5100,8788,0,9,4,13,5,2,7,0.00,58.03,53.85
10,007,01,010,0048,0000,1289,52,1341,2125,0,9,4,13,5,2,7,0.00,63.11,53.85
10,007,01,010,0049,0000,535,36,571,925,0,9,4,13,5,2,7,0.00,61.73,53.85
10,007,01,020,0001,0000,638,27,665,1054,0,3,2,5,2,2,4,0.00,63.09,80.00
10,007,01,020,0002,0000,276,19,295,481,0,3,2,5,2,2,4,0.00,61.33,80.00
10,007,01,020,0003,0000,508,29,537,826,0,3,2,5,2,2,4,0.00,65.01,80.00
10,007,01,020,0004,0000,632,32,664,878,0,3,2,5,2,2,4,0.00,75.63,80.00
10,007,01,020,0007,0000,2882,115,2997,4897,0,3,2,5,2,2,4,0.00,61.20,80.00
10,007,01,020,0008,0000,2597,67,2664,4240,0,3,2,5,2,2,4,0.00,62.83,80.00
10,007,01,020,0009,0000,310,17,327,504,0,3,2,5,2,2,4,0.00,64.88,80.00
10,007,01,020,0010,0000,554,25,579,802,0,3,2,5,2,2,4,0.00,72.19,80.00
10,007,01,020,0011,0000,661,20,681,1096,0,3,2,5,2,2,4,0.00,62.14,80.00
10,007,01,020,0001,0248,638,27,665,1054,0,3,2,5,2,2,4,0.00,63.09,80.00
10,007,01,020,0002,0249,276,19,295,481,0,3,2,5,2,2,4,0.00,61.33,80.00
10,007,01,020,0003,0250,508,29,537,826,0,3,2,5,2,2,4,0.00,65.01,80.00
10,007,01,020,0004,0251,632,32,664,878,0,3,2,5,2,2,4,0.00,75.63,80.00
10,007,01,020,0007,0252,527,22,549,947,0,3,2,5,2,2,4,0.00,57.97,80.00
10,007,01,020,0007,0253,646,32,678,1083,0,3,2,5,2,2,4,0.00,62.60,80.00
10,007,01,020,0007,0254,457,17,474,805,0,3,2,5,2,2,4,0.00,58.88,80.00
10,007,01,020,0007,0255,420,14,434,698,0,3,2,5,2,2,4,0.00,62.18,80.00
10,007,01,020,0007,0256,832,30,862,1364,0,3,2,5,2,2,4,0.00,63.20,80.00
10,007,01,020,0010,0257,554,25,579,802,0,3,2,5,2,2,4,0.00,72.19,80.00
10,007,01,020,0011,0258,661,20,681,1096,0,3,2,5,2,2,4,0.00,62.14,80.00
10,007,01,020,0008,0259,609,14,623,1000,0,3,2,5,2,2,4,0.00,62.30,80.00
10,007,01,020,0008,0260,665,13,678,1070,0,3,2,5,2,2,4,0.00,63.36,80.00
10,007,01,020,0008,0261,635,16,651,1023,0,3,2,5,2,2,4,0.00,63.64,80.00
10,007,01,020,0008,0262,688,24,712,1147,0,3,2,5,2,2,4,0.00,62.07,80.00
10,007,01,020,0009,0263,310,17,327,504,0,3,2,5,2,2,4,0.00,64.88,80.00
10,007,01,020,0029,0264,665,20,685,1137,0,3,2,5,2,2,4,0.00,60.25,80.00
10,007,01,020,0029,0265,672,27,699,1109,0,3,2,5,2,2,4,0.00,63.03,80.00
10,007,01,020,0029,0266,628,30,658,1037,0,3,2,5,2,2,4,0.00,63.45,80.00
10,007,01,020,0029,0267,604,31,635,985,0,3,2,5,2,2,4,0.00,64.47,80.00
10,007,01,020,0029,0000,2569,108,2677,4268,0,3,2,5,2,2,4,0.00,62.72,80.00
10,007,01,030,0001,0000,3167,120,3287,5897,0,4,2,6,3,2,5,0.00,55.74,83.33
10,007,01,030,0002,0000,2328,117,2445,4209,0,4,2,6,3,2,5,0.00,58.09,83.33
10,007,01,030,0003,0000,248,16,264,380,0,4,2,6,3,2,5,0.00,69.47,83.33
10,007,01,030,0004,0000,978,39,1017,1769,0,4,2,6,3,2,5,0.00,57.49,83.33
10,007,01,030,0005,0000,1754,80,1834,3048,0,4,2,6,3,2,5,0.00,60.17,83.33
10,007,01,030,0006,0000,1578,65,1643,2716,0,4,2,6,3,2,5,0.00,60.49,83.33
10,007,01,030,0007,0000,943,20,963,1615,0,4,2,6,3,2,5,0.00,59.63,83.33
10,007,01,030,0009,0000,1232,59,1291,2071,0,4,2,6,3,2,5,0.00,62.34,83.33
10,007,01,030,0001,0389,678,22,700,1250,0,4,2,6,3,2,5,0.00,56.00,83.33
10,007,01,030,0001,0390,611,24,635,1152,0,4,2,6,3,2,5,0.00,55.12,83.33
10,007,01,030,0001,0391,679,29,708,1239,0,4,2,6,3,2,5,0.00,57.14,83.33
10,007,01,030,0001,0392,622,24,646,1161,0,4,2,6,3,2,5,0.00,55.64,83.33
10,007,01,030,0001,0393,577,21,598,1095,0,4,2,6,3,2,5,0.00,54.61,83.33
10,007,01,030,0002,0394,560,27,587,1026,0,4,2,6,3,2,5,0.00,57.21,83.33
10,007,01,030,0002,0395,516,31,547,986,0,4,2,6,3,2,5,0.00,55.48,83.33
10,007,01,030,0002,0396,545,36,581,971,0,4,2,6,3,2,5,0.00,59.84,83.33
10,007,01,030,0002,0397,707,23,730,1226,0,4,2,6,3,2,5,0.00,59.54,83.33
10,007,01,030,0003,0398,248,16,264,380,0,4,2,6,3,2,5,0.00,69.47,83.33
10,007,01,030,0004,0399,451,16,467,827,0,4,2,6,3,2,5,0.00,56.47,83.33
10,007,01,030,0004,0400,527,23,550,942,0,4,2,6,3,2,5,0.00,58.39,83.33
10,007,01,030,0005,0401,541,30,571,988,0,4,2,6,3,2,5,0.00,57.79,83.33
10,007,01,030,0005,0402,637,29,666,1068,0,4,2,6,3,2,5,0.00,62.36,83.33
10,007,01,030,0005,0403,576,21,597,992,0,4,2,6,3,2,5,0.00,60.18,83.33
10,007,01,030,0006,0404,814,35,849,1390,0,4,2,6,3,2,5,0.00,61.08,83.33
10,007,01,030,0006,0405,764,30,794,1326,0,4,2,6,3,2,5,0.00,59.88,83.33
10,007,01,030,0007,0406,464,11,475,783,0,4,2,6,3,2,5,0.00,60.66,83.33
10,007,01,030,0007,0407,479,9,488,832,0,4,2,6,3,2,5,0.00,58.65,83.33
10,007,01,030,0009,0408,783,38,821,1332,0,4,2,6,3,2,5,0.00,61.64,83.33
10,007,01,030,0009,0409,449,21,470,739,0,4,2,6,3,2,5,0.00,63.60,83.33
10,007,01,040,0001,0000,1399,36,1435,2179,0,5,2,7,3,2,5,0.00,65.86,71.43
10,007,01,040,0002,0000,844,24,868,1196,0,5,2,7,3,2,5,0.00,72.58,71.43
10,007,01,040,0003,0000,1491,47,1538,2213,0,5,2,7,3,2,5,0.00,69.50,71.43
10,007,01,040,0001,0487,635,17,652,1010,0,5,2,7,3,2,5,0.00,64.55,71.43
10,007,01,040,0001,0488,764,19,783,1169,0,5,2,7,3,2,5,0.00,66.98,71.43
10,007,01,040,0002,0489,844,24,868,1196,0,5,2,7,3,2,5,0.00,72.58,71.43
10,007,01,040,0003,0490,736,28,764,1137,0,5,2,7,3,2,5,0.00,67.19,71.43
10,007,01,040,0003,0491,755,19,774,1076,0,5,2,7,3,2,5,0.00,71.93,71.43
10,007,01,050,0007,0000,1211,50,1261,1767,0,3,0,3,2,0,2,0.00,71.36,66.67
10,007,01,050,0008,0000,1184,29,1213,1630,0,3,0,3,2,0,2,0.00,74.42,66.67
10,007,01,050,0012,0000,1712,59,1771,2639,0,3,0,3,2,0,2,0.00,67.11,66.67
10,007,01,050,0012,0459,743,28,771,1153,0,3,0,3,2,0,2,0.00,66.87,66.67
10,007,01,050,0012,0460,969,31,1000,1486,0,3,0,3,2,0,2,0.00,67.29,66.67
10,007,01,050,0007,0461,645,31,676,918,0,3,0,3,2,0,2,0.00,73.64,66.67
10,007,01,050,0007,0462,566,19,585,849,0,3,0,3,2,0,2,0.00,68.90,66.67
10,007,01,050,0008,0463,584,14,598,788,0,3,0,3,2,0,2,0.00,75.89,66.67
10,007,01,050,0008,0464,600,15,615,842,0,3,0,3,2,0,2,0.00,73.04,66.67
10,007,01,060,0003,0000,798,18,816,1193,0,5,1,6,2,1,3,0.00,68.40,50.00
10,007,01,060,0004,0000,859,28,887,1453,0,5,1,6,2,1,3,0.00,61.05,50.00
10,007,01,060,0005,0000,830,23,853,1126,0,5,1,6,2,1,3,0.00,75.75,50.00
10,007,01,060,0006,0000,734,19,753,1226,0,5,1,6,2,1,3,0.00,61.42,50.00
10,007,01,060,0007,0000,866,32,898,1312,0,5,1,6,2,1,3,0.00,68.45,50.00
10,007,01,060,0008,0000,539,20,559,797,0,5,1,6,2,1,3,0.00,70.14,50.00
10,007,01,060,0009,0000,1398,47,1445,2349,0,5,1,6,2,1,3,0.00,61.52,50.00
10,007,01,060,0007,0317,866,32,898,1312,0,5,1,6,2,1,3,0.00,68.45,50.00
10,007,01,060,0008,0318,539,20,559,797,0,5,1,6,2,1,3,0.00,70.14,50.00
10,007,01,060,0006,0319,734,19,753,1226,0,5,1,6,2,1,3,0.00,61.42,50.00
10,007,01,060,0005,0320,830,23,853,1126,0,5,1,6,2,1,3,0.00,75.75,50.00
10,007,01,060,0004,0321,392,14,406,689,0,5,1,6,2,1,3,0.00,58.93,50.00
10,007,01,060,0004,0322,467,14,481,764,0,5,1,6,2,1,3,0.00,62.96,50.00
10,007,01,060,0003,0323,798,18,816,1193,0,5,1,6,2,1,3,0.00,68.40,50.00
10,007,01,060,0009,0324,804,33,837,1405,0,5,1,6,2,1,3,0.00,59.57,50.00
10,007,01,060,0009,0325,594,14,608,944,0,5,1,6,2,1,3,0.00,64.41,50.00
10,007,01,070,0001,0000,991,43,1034,1614,0,5,3,8,3,2,5,0.00,64.06,62.50
10,007,01,070,0002,0000,1298,68,1366,1986,0,5,3,8,3,2,5,0.00,68.78,62.50
10,007,01,070,0003,0000,1649,47,1696,2570,0,5,3,8,3,2,5,0.00,65.99,62.50
10,007,01,070,0004,0000,1062,25,1087,1775,0,5,3,8,3,2,5,0.00,61.24,62.50
10,007,01,070,0005,0000,874,24,898,1385,0,5,3,8,3,2,5,0.00,64.84,62.50
10,007,01,070,0006,0000,2126,90,2216,3704,0,5,3,8,3,2,5,0.00,59.83,62.50
10,007,01,070,0001,0351,473,21,494,770,0,5,3,8,3,2,5,0.00,64.16,62.50
10,007,01,070,0001,0352,518,22,540,844,0,5,3,8,3,2,5,0.00,63.98,62.50
10,007,01,070,0002,0353,643,24,667,986,0,5,3,8,3,2,5,0.00,67.65,62.50
10,007,01,070,0002,0354,655,44,699,1000,0,5,3,8,3,2,5,0.00,69.90,62.50
10,007,01,070,0003,0355,607,20,627,941,0,5,3,8,3,2,5,0.00,66.63,62.50
10,007,01,070,0003,0356,477,14,491,789,0,5,3,8,3,2,5,0.00,62.23,62.50
10,007,01,070,0003,0357,565,13,578,840,0,5,3,8,3,2,5,0.00,68.81,62.50
10,007,01,070,0005,0358,444,9,453,660,0,5,3,8,3,2,5,0.00,68.64,62.50
10,007,01,070,0005,0359,430,15,445,725,0,5,3,8,3,2,5,0.00,61.38,62.50
10,007,01,070,0004,0360,544,18,562,897,0,5,3,8,3,2,5,0.00,62.65,62.50
10,007,01,070,0004,0361,518,7,525,878,0,5,3,8,3,2,5,0.00,59.79,62.50
10,007,01,070,0006,0362,479,11,490,821,0,5,3,8,3,2,5,0.00,59.68,62.50
10,007,01,070,0006,0363,450,25,475,840,0,5,3,8,3,2,5,0.00,56.55,62.50
10,007,01,070,0006,0364,563,22,585,996,0,5,3,8,3,2,5,0.00,58.73,62.50
10,007,01,070,0006,0365,634,32,666,1047,0,5,3,8,3,2,5,0.00,63.61,62.50
10,007,01,080,0001,0000,1942,79,2021,3068,0,3,1,4,2,1,3,0.00,65.87,75.00
10,007,01,080,0002,0000,1104,39,1143,1662,0,3,1,4,2,1,3,0.00,68.77,75.00
10,007,01,080,0003,0000,1532,39,1571,2250,0,3,1,4,2,1,3,0.00,69.82,75.00
10,007,01,080,0004,0000,744,27,771,1025,0,3,1,4,2,1,3,0.00,75.22,75.00
10,007,01,080,0005,0000,991,23,1014,1379,0,3,1,4,2,1,3,0.00,73.53,75.00
10,007,01,080,0006,0000,1071,66,1137,1845,0,3,1,4,2,1,3,0.00,61.63,75.00
10,007,01,080,0001,0189,546,18,564,857,0,3,1,4,2,1,3,0.00,65.81,75.00
10,007,01,080,0001,0190,583,30,613,931,0,3,1,4,2,1,3,0.00,65.84,75.00
10,007,01,080,0001,0191,813,31,844,1280,0,3,1,4,2,1,3,0.00,65.94,75.00
10,007,01,080,0002,0192,515,14,529,761,0,3,1,4,2,1,3,0.00,69.51,75.00
10,007,01,080,0002,0193,589,25,614,901,0,3,1,4,2,1,3,0.00,68.15,75.00
10,007,01,080,0003,0194,716,16,732,1066,0,3,1,4,2,1,3,0.00,68.67,75.00
10,007,01,080,0003,0195,816,23,839,1184,0,3,1,4,2,1,3,0.00,70.86,75.00
10,007,01,080,0005,0196,991,23,1014,1379,0,3,1,4,2,1,3,0.00,73.53,75.00
10,007,01,080,0004,0197,744,27,771,1025,0,3,1,4,2,1,3,0.00,75.22,75.00
10,007,01,080,0006,0198,502,28,530,875,0,3,1,4,2,1,3,0.00,60.57,75.00
10,007,01,080,0006,0199,569,38,607,970,0,3,1,4,2,1,3,0.00,62.58,75.00
10,007,01,090,0001,0000,1159,25,1184,1682,0,3,1,4,2,1,3,0.00,70.39,75.00
10,007,01,090,0002,0000,949,11,960,1291,0,3,1,4,2,1,3,0.00,74.36,75.00
10,007,01,090,0003,0000,1149,42,1191,1688,0,3,1,4,2,1,3,0.00,70.56,75.00
10,007,01,090,0001,0226,627,12,639,916,0,3,1,4,2,1,3,0.00,69.76,75.00
10,007,01,090,0001,0227,532,13,545,766,0,3,1,4,2,1,3,0.00,71.15,75.00
10,007,01,090,0002,0228,446,9,455,622,0,3,1,4,2,1,3,0.00,73.15,75.00
10,007,01,090,0002,0229,503,2,505,669,0,3,1,4,2,1,3,0.00,75.49,75.00
10,007,01,090,0003,0230,633,18,651,902,0,3,1,4,2,1,3,0.00,72.17,75.00
10,007,01,090,0003,0231,516,24,540,786,0,3,1,4,2,1,3,0.00,68.70,75.00
10,007,01,100,0025,0000,1486,45,1531,2220,0,4,2,6,2,2,4,0.00,68.96,66.67
10,007,01,100,0026,0000,1505,50,1555,2590,0,4,2,6,2,2,4,0.00,60.04,66.67
10,007,01,100,0027,0000,1552,57,1609,2667,0,4,2,6,2,2,4,0.00,60.33,66.67
10,007,01,100,0028,0000,1092,35,1127,1674,0,4,2,6,2,2,4,0.00,67.32,66.67
10,007,01,100,0029,0000,792,31,823,1131,0,4,2,6,2,2,4,0.00,72.77,66.67
10,007,01,100,0030,0000,464,20,484,677,0,4,2,6,2,2,4,0.00,71.49,66.67
10,007,01,100,0031,0000,1205,47,1252,1873,0,4,2,6,2,2,4,0.00,66.84,66.67
10,007,01,100,0032,0000,1260,45,1305,2122,0,4,2,6,2,2,4,0.00,61.50,66.67
10,007,01,100,0033,0000,1066,47,1113,1835,0,4,2,6,2,2,4,0.00,60.65,66.67
10,007,01,100,0034,0000,1069,38,1107,1686,0,4,2,6,2,2,4,0.00,65.66,66.67
10,007,01,100,0035,0000,1018,32,1050,1667,0,4,2,6,2,2,4,0.00,62.99,66.67
10,007,01,100,0036,0000,1347,33,1380,2154,0,4,2,6,2,2,4,0.00,64.07,66.67
10,007,01,100,0025,0499,659,25,684,972,0,4,2,6,2,2,4,0.00,70.37,66.67
10,007,01,100,0025,0500,827,20,847,1248,0,4,2,6,2,2,4,0.00,67.87,66.67
10,007,01,100,0026,0501,783,30,813,1322,0,4,2,6,2,2,4,0.00,61.50,66.67
10,007,01,100,0026,0502,722,20,742,1268,0,4,2,6,2,2,4,0.00,58.52,66.67
10,007,01,100,0027,0503,601,24,625,1010,0,4,2,6,2,2,4,0.00,61.88,66.67
10,007,01,100,0027,0504,529,22,551,913,0,4,2,6,2,2,4,0.00,60.35,66.67
10,007,01,100,0027,0505,422,11,433,744,0,4,2,6,2,2,4,0.00,58.20,66.67
10,007,01,100,0028,0506,578,17,595,897,0,4,2,6,2,2,4,0.00,66.33,66.67
10,007,01,100,0028,0507,514,18,532,777,0,4,2,6,2,2,4,0.00,68.47,66.67
10,007,01,100,0029,0508,792,31,823,1131,0,4,2,6,2,2,4,0.00,72.77,66.67
10,007,01,100,0030,0509,464,20,484,677,0,4,2,6,2,2,4,0.00,71.49,66.67
10,007,01,100,0031,0510,666,26,692,1060,0,4,2,6,2,2,4,0.00,65.28,66.67
10,007,01,100,0031,0511,539,21,560,813,0,4,2,6,2,2,4,0.00,68.88,66.67
10,007,01,100,0032,0512,575,26,601,1000,0,4,2,6,2,2,4,0.00,60.10,66.67
10,007,01,100,0032,0513,685,19,704,1122,0,4,2,6,2,2,4,0.00,62.75,66.67
10,007,01,100,0033,0514,511,16,527,904,0,4,2,6,2,2,4,0.00,58.30,66.67
10,007,01,100,0033,0515,555,31,586,931,0,4,2,6,2,2,4,0.00,62.94,66.67
10,007,01,100,0034,0516,599,19,618,938,0,4,2,6,2,2,4,0.00,65.88,66.67
10,007,01,100,0034,0517,470,19,489,748,0,4,2,6,2,2,4,0.00,65.37,66.67
10,007,01,100,0035,0518,525,17,542,827,0,4,2,6,2,2,4,0.00,65.54,66.67
10,007,01,100,0035,0519,493,15,508,840,0,4,2,6,2,2,4,0.00,60.48,66.67
10,007,01,100,0036,0520,662,16,678,995,0,4,2,6,2,2,4,0.00,68.14,66.67
10,007,01,100,0036,0521,685,17,702,1159,0,4,2,6,2,2,4,0.00,60.57,66.67
10,007,01,110,0001,0000,682,18,700,1104,0,2,3,5,2,2,4,0.00,63.41,80.00
10,007,01,110,0002,0000,346,31,377,584,0,2,3,5,2,2,4,0.00,64.55,80.00
10,007,01,110,0003,0000,969,36,1005,1693,0,2,3,5,2,2,4,0.00,59.36,80.00
10,007,01,110,0004,0000,233,12,245,398,0,2,3,5,2,2,4,0.00,61.56,80.00
10,007,01,110,0014,0000,1535,46,1581,2207,0,2,3,5,2,2,4,0.00,71.64,80.00
10,007,01,110,0015,0000,572,14,586,768,0,2,3,5,2,2,4,0.00,76.30,80.00
10,007,01,110,0017,0000,1076,35,1111,1750,0,2,3,5,2,2,4,0.00,63.49,80.00
10,007,01,110,0018,0000,2699,72,2771,4476,0,2,3,5,2,2,4,0.00,61.91,80.00
10,007,01,110,0001,0665,682,18,700,1104,0,2,3,5,2,2,4,0.00,63.41,80.00
10,007,01,110,0002,0666,346,31,377,584,0,2,3,5,2,2,4,0.00,64.55,80.00
10,007,01,110,0003,0667,431,17,448,766,0,2,3,5,2,2,4,0.00,58.49,80.00
10,007,01,110,0003,0668,538,19,557,927,0,2,3,5,2,2,4,0.00,60.09,80.00
10,007,01,110,0004,0669,233,12,245,398,0,2,3,5,2,2,4,0.00,61.56,80.00
10,007,01,110,0018,0670,612,6,618,1013,0,2,3,5,2,2,4,0.00,61.01,80.00
10,007,01,110,0018,0671,665,11,676,1079,0,2,3,5,2,2,4,0.00,62.65,80.00
10,007,01,110,0018,0672,706,27,733,1155,0,2,3,5,2,2,4,0.00,63.46,80.00
10,007,01,110,0018,0673,716,28,744,1229,0,2,3,5,2,2,4,0.00,60.54,80.00
10,007,01,110,0014,0674,773,20,793,1080,0,2,3,5,2,2,4,0.00,73.43,80.00
10,007,01,110,0014,0675,762,26,788,1127,0,2,3,5,2,2,4,0.00,69.92,80.00
10,007,01,110,0017,0676,500,17,517,878,0,2,3,5,2,2,4,0.00,58.88,80.00
10,007,01,110,0017,0677,576,18,594,872,0,2,3,5,2,2,4,0.00,68.12,80.00
10,007,01,110,0015,0678,572,14,586,768,0,2,3,5,2,2,4,0.00,76.30,80.00
10,007,01,120,0001,0000,497,23,520,799,0,4,0,4,3,0,3,0.00,65.08,75.00
10,007,01,120,0002,0000,536,28,564,991,0,4,0,4,3,0,3,0.00,56.91,75.00
10,007,01,120,0003,0000,410,22,432,721,0,4,0,4,3,0,3,0.00,59.92,75.00
10,007,01,120,0004,0000,871,46,917,1435,0,4,0,4,3,0,3,0.00,63.90,75.00
10,007,01,120,0005,0000,805,30,835,1365,0,4,0,4,3,0,3,0.00,61.17,75.00
10,007,01,120,0006,0000,800,20,820,1188,0,4,0,4,3,0,3,0.00,69.02,75.00
10,007,01,120,0014,0000,1449,58,1507,2319,0,4,0,4,3,0,3,0.00,64.98,75.00
10,007,01,120,0001,0770,497,23,520,799,0,4,0,4,3,0,3,0.00,65.08,75.00
10,007,01,120,0002,0771,536,28,564,991,0,4,0,4,3,0,3,0.00,56.91,75.00
10,007,01,120,0003,0772,410,22,432,721,0,4,0,4,3,0,3,0.00,59.92,75.00
10,007,01,120,0004,0773,433,24,457,737,0,4,0,4,3,0,3,0.00,62.01,75.00
10,007,01,120,0004,0774,438,22,460,698,0,4,0,4,3,0,3,0.00,65.90,75.00
10,007,01,120,0005,0775,395,19,414,687,0,4,0,4,3,0,3,0.00,60.26,75.00
10,007,01,120,0005,0776,410,11,421,678,0,4,0,4,3,0,3,0.00,62.09,75.00
10,007,01,120,0006,0777,800,20,820,1188,0,4,0,4,3,0,3,0.00,69.02,75.00
10,007,01,120,0014,0778,615,24,639,1012,0,4,0,4,3,0,3,0.00,63.14,75.00
10,007,01,120,0014,0779,834,34,868,1307,0,4,0,4,3,0,3,0.00,66.41,75.00
10,007,01,130,0001,0000,2222,69,2291,3491,0,3,3,6,2,2,4,0.00,65.63,66.67
10,007,01,130,0002,0000,1057,30,1087,1497,0,3,3,6,2,2,4,0.00,72.61,66.67
10,007,01,130,0003,0000,1041,17,1058,1448,0,3,3,6,2,2,4,0.00,73.07,66.67
10,007,01,130,0004,0000,818,21,839,1219,0,3,3,6,2,2,4,0.00,68.83,66.67
10,007,01,130,0009,0000,1012,33,1045,1542,0,3,3,6,2,2,4,0.00,67.77,66.67
10,007,01,130,0012,0000,1352,36,1388,1984,0,3,3,6,2,2,4,0.00,69.96,66.67
10,007,01,130,0001,0600,632,18,650,1059,0,3,3,6,2,2,4,0.00,61.38,66.67
10,007,01,130,0001,0601,669,26,695,1040,0,3,3,6,2,2,4,0.00,66.83,66.67
10,007,01,130,0001,0602,921,25,946,1392,0,3,3,6,2,2,4,0.00,67.96,66.67
10,007,01,130,0002,0603,547,15,562,786,0,3,3,6,2,2,4,0.00,71.50,66.67
10,007,01,130,0002,0604,510,15,525,711,0,3,3,6,2,2,4,0.00,73.84,66.67
10,007,01,130,0004,0605,818,21,839,1219,0,3,3,6,2,2,4,0.00,68.83,66.67
10,007,01,130,0009,0606,454,19,473,657,0,3,3,6,2,2,4,0.00,71.99,66.67
10,007,01,130,0009,0607,558,14,572,885,0,3,3,6,2,2,4,0.00,64.63,66.67
10,007,01,130,0003,0608,1041,17,1058,1448,0,3,3,6,2,2,4,0.00,73.07,66.67
10,007,01,130,0012,0609,558,16,574,807,0,3,3,6,2,2,4,0.00,71.13,66.67
10,007,01,130,0012,0610,794,20,814,1177,0,3,3,6,2,2,4,0.00,69.16,66.67
10,007,01,140,0001,0000,1095,39,1134,1603,0,4,2,6,3,1,4,0.00,70.74,66.67
10,007,01,140,0002,0000,1013,31,1044,1485,0,4,2,6,3,1,4,0.00,70.30,66.67
10,007,01,140,0003,0000,865,27,892,1207,0,4,2,6,3,1,4,0.00,73.90,66.67
10,007,01,140,0004,0000,651,21,672,869,0,4,2,6,3,1,4,0.00,77.33,66.67
10,007,01,140,0005,0000,1154,47,1201,1684,0,4,2,6,3,1,4,0.00,71.32,66.67
10,007,01,140,0006,0000,556,15,571,886,0,4,2,6,3,1,4,0.00,64.45,66.67
10,007,01,140,0007,0000,909,31,940,1261,0,4,2,6,3,1,4,0.00,74.54,66.67
10,007,01,140,0008,0000,767,28,795,1041,0,4,2,6,3,1,4,0.00,76.37,66.67
10,007,01,140,0009,0000,496,22,518,639,0,4,2,6,3,1,4,0.00,81.06,66.67
10,007,01,140,0001,0708,608,24,632,870,0,4,2,6,3,1,4,0.00,72.64,66.67
10,007,01,140,0001,0709,487,15,502,733,0,4,2,6,3,1,4,0.00,68.49,66.67
10,007,01,140,0002,0710,489,9,498,717,0,4,2,6,3,1,4,0.00,69.46,66.67
10,007,01,140,0002,0711,524,22,546,768,0,4,2,6,3,1,4,0.00,71.09,66.67
10,007,01,140,0003,0712,865,27,892,1207,0,4,2,6,3,1,4,0.00,73.90,66.67
10,007,01,140,0004,0713,651,21,672,869,0,4,2,6,3,1,4,0.00,77.33,66.67
10,007,01,140,0005,0714,623,19,642,850,0,4,2,6,3,1,4,0.00,75.53,66.67
10,007,01,140,0005,0715,531,28,559,834,0,4,2,6,3,1,4,0.00,67.03,66.67
10,007,01,140,0006,0716,556,15,571,886,0,4,2,6,3,1,4,0.00,64.45,66.67
10,007,01,140,0007,0717,909,31,940,1261,0,4,2,6,3,1,4,0.00,74.54,66.67
10,007,01,140,0008,0718,767,28,795,1041,0,4,2,6,3,1,4,0.00,76.37,66.67
10,007,01,140,0009,0719,496,22,518,639,0,4,2,6,3,1,4,0.00,81.06,66.67
10,007,01,150,0001,0000,2105,65,2170,3381,0,8,4,12,5,2,7,0.00,64.18,58.33
10,007,01,150,0002,0000,851,21,872,1169,0,8,4,12,5,2,7,0.00,74.59,58.33
10,007,01,150,0003,0000,1029,22,1051,1534,0,8,4,12,5,2,7,0.00,68.51,58.33
10,007,01,150,0004,0000,811,25,836,1190,0,8,4,12,5,2,7,0.00,70.25,58.33
10,007,01,150,0005,0000,1146,30,1176,1692,0,8,4,12,5,2,7,0.00,69.50,58.33
10,007,01,150,0006,0000,1137,35,1172,1997,0,8,4,12,5,2,7,0.00,58.69,58.33
10,007,01,150,0007,0000,917,28,945,1394,0,8,4,12,5,2,7,0.00,67.79,58.33
10,007,01,150,0008,0000,1214,30,1244,1919,0,8,4,12,5,2,7,0.00,64.83,58.33
10,007,01,150,0009,0000,1374,44,1418,2284,0,8,4,12,5,2,7,0.00,62.08,58.33
10,007,01,150,0010,0000,435,16,451,618,0,8,4,12,5,2,7,0.00,72.98,58.33
10,007,01,150,0011,0000,811,36,847,1195,0,8,4,12,5,2,7,0.00,70.88,58.33
10,007,01,150,0001,0739,665,19,684,1039,0,8,4,12,5,2,7,0.00,65.83,58.33
10,007,01,150,0001,0740,694,19,713,1112,0,8,4,12,5,2,7,0.00,64.12,58.33
10,007,01,150,0001,0741,746,27,773,1230,0,8,4,12,5,2,7,0.00,62.85,58.33
10,007,01,150,0002,0742,851,21,872,1169,0,8,4,12,5,2,7,0.00,74.59,58.33
10,007,01,150,0003,0743,557,16,573,847,0,8,4,12,5,2,7,0.00,67.65,58.33
10,007,01,150,0003,0744,472,6,478,687,0,8,4,12,5,2,7,0.00,69.58,58.33
10,007,01,150,0004,0745,811,25,836,1190,0,8,4,12,5,2,7,0.00,70.25,58.33
10,007,01,150,0005,0746,421,5,426,585,0,8,4,12,5,2,7,0.00,72.82,58.33
10,007,01,150,0005,0747,725,25,750,1107,0,8,4,12,5,2,7,0.00,67.75,58.33
10,007,01,150,0006,0748,615,24,639,1134,0,8,4,12,5,2,7,0.00,56.35,58.33
10,007,01,150,0006,0749,522,11,533,863,0,8,4,12,5,2,7,0.00,61.76,58.33
10,007,01,150,0007,0750,477,16,493,751,0,8,4,12,5,2,7,0.00,65.65,58.33
10,007,01,150,0007,0751,440,12,452,643,0,8,4,12,5,2,7,0.00,70.30,58.33
10,007,01,150,0009,0752,768,24,792,1324,0,8,4,12,5,2,7,0.00,59.82,58.33
10,007,01,150,0009,0753,606,20,626,960,0,8,4,12,5,2,7,0.00,65.21,58.33
10,007,01,150,0008,0754,613,11,624,934,0,8,4,12,5,2,7,0.00,66.81,58.33
10,007,01,150,0008,0755,601,19,620,985,0,8,4,12,5,2,7,0.00,62.94,58.33
10,007,01,150,0010,0756,435,16,451,618,0,8,4,12,5,2,7,0.00,72.98,58.33
10,007,01,150,0011,0757,811,36,847,1195,0,8,4,12,5,2,7,0.00,70.88,58.33
10,007,01,160,0010,0000,801,39,840,1309,0,4,2,6,2,1,3,0.00,64.17,50.00
10,007,01,160,0011,0000,811,24,835,1164,0,4,2,6,2,1,3,0.00,71.74,50.00
10,007,01,160,0012,0000,934,47,981,1543,0,4,2,6,2,1,3,0.00,63.58,50.00
10,007,01,160,0013,0000,1166,49,1215,1874,0,4,2,6,2,1,3,0.00,64.83,50.00
10,007,01,160,0014,0000,1032,31,1063,1484,0,4,2,6,2,1,3,0.00,71.63,50.00
10,007,01,160,0015,0000,808,33,841,1342,0,4,2,6,2,1,3,0.00,62.67,50.00
10,007,01,160,0011,0631,811,24,835,1164,0,4,2,6,2,1,3,0.00,71.74,50.00
10,007,01,160,0013,0632,578,19,597,862,0,4,2,6,2,1,3,0.00,69.26,50.00
10,007,01,160,0013,0633,588,30,618,1012,0,4,2,6,2,1,3,0.00,61.07,50.00
10,007,01,160,0012,0634,424,15,439,668,0,4,2,6,2,1,3,0.00,65.72,50.00
10,007,01,160,0012,0635,510,32,542,875,0,4,2,6,2,1,3,0.00,61.94,50.00
10,007,01,160,0010,0636,373,23,396,619,0,4,2,6,2,1,3,0.00,63.97,50.00
10,007,01,160,0010,0637,428,16,444,690,0,4,2,6,2,1,3,0.00,64.35,50.00
10,007,01,160,0014,0638,465,22,487,691,0,4,2,6,2,1,3,0.00,70.48,50.00
10,007,01,160,0014,0639,567,9,576,793,0,4,2,6,2,1,3,0.00,72.64,50.00
10,007,01,160,0015,0640,808,33,841,1342,0,4,2,6,2,1,3,0.00,62.67,50.00
10,007,01,170,0001,0000,1478,55,1533,2632,0,8,1,9,5,1,6,0.00,58.24,66.67
10,007,01,170,0002,0000,938,36,974,1415,0,8,1,9,5,1,6,0.00,68.83,66.67
10,007,01,170,0004,0000,2531,75,2606,4265,0,8,1,9,5,1,6,0.00,61.10,66.67
10,007,01,170,0005,0000,639,30,669,874,0,8,1,9,5,1,6,0.00,76.54,66.67
10,007,01,170,0008,0000,1249,56,1305,1977,0,8,1,9,5,1,6,0.00,66.01,66.67
10,007,01,170,0011,0000,944,37,981,1651,0,8,1,9,5,1,6,0.00,59.42,66.67
10,007,01,170,0014,0000,771,31,802,1352,0,8,1,9,5,1,6,0.00,59.32,66.67
10,007,01,170,0017,0000,859,17,876,1204,0,8,1,9,5,1,6,0.00,72.76,66.67
10,007,01,170,0019,0000,1056,39,1095,1551,0,8,1,9,5,1,6,0.00,70.60,66.67
10,007,01,170,0022,0000,617,26,643,1010,0,8,1,9,5,1,6,0.00,63.66,66.67
10,007,01,170,0001,0806,412,21,433,733,0,8,1,9,5,1,6,0.00,59.07,66.67
10,007,01,170,0001,0807,544,18,562,964,0,8,1,9,5,1,6,0.00,58.30,66.67
10,007,01,170,0001,0808,522,16,538,935,0,8,1,9,5,1,6,0.00,57.54,66.67
10,007,01,170,0004,0809,572,12,584,958,0,8,1,9,5,1,6,0.00,60.96,66.67
10,007,01,170,0004,0810,598,24,622,1033,0,8,1,9,5,1,6,0.00,60.21,66.67
10,007,01,170,0004,0811,686,15,701,1153,0,8,1,9,5,1,6,0.00,60.80,66.67
10,007,01,170,0004,0812,675,24,699,1121,0,8,1,9,5,1,6,0.00,62.36,66.67
10,007,01,170,0002,0813,533,22,555,772,0,8,1,9,5,1,6,0.00,71.89,66.67
10,007,01,170,0002,0814,405,14,419,643,0,8,1,9,5,1,6,0.00,65.16,66.67
10,007,01,170,0022,0815,617,26,643,1010,0,8,1,9,5,1,6,0.00,63.66,66.67
10,007,01,170,0019,0816,556,28,584,846,0,8,1,9,5,1,6,0.00,69.03,66.67
10,007,01,170,0019,0817,500,11,511,705,0,8,1,9,5,1,6,0.00,72.48,66.67
10,007,01,170,0005,0818,639,30,669,874,0,8,1,9,5,1,6,0.00,76.54,66.67
10,007,01,170,0008,0819,634,29,663,957,0,8,1,9,5,1,6,0.00,69.28,66.67
10,007,01,170,0008,0820,615,27,642,1020,0,8,1,9,5,1,6,0.00,62.94,66.67
10,007,01,170,0014,0821,403,26,429,708,0,8,1,9,5,1,6,0.00,60.59,66.67
10,007,01,170,0014,0822,368,5,373,644,0,8,1,9,5,1,6,0.00,57.92,66.67
10,007,01,170,0017,0823,859,17,876,1204,0,8,1,9,5,1,6,0.00,72.76,66.67
10,007,01,170,0011,0824,406,22,428,695,0,8,1,9,5,1,6,0.00,61.58,66.67
10,007,01,170,0011,0825,538,15,553,956,0,8,1,9,5,1,6,0.00,57.85,66.67
10,007,01,180,0001,0000,539,11,550,802,0,3,1,4,2,1,3,0.00,68.58,75.00
10,007,01,180,0002,0000,668,19,687,882,0,3,1,4,2,1,3,0.00,77.89,75.00
10,007,01,180,0016,0000,708,13,721,958,0,3,1,4,2,1,3,0.00,75.26,75.00
10,007,01,180,0017,0000,460,8,468,637,0,3,1,4,2,1,3,0.00,73.47,75.00
10,007,01,180,0016,0844,708,13,721,958,0,3,1,4,2,1,3,0.00,75.26,75.00
10,007,01,180,0017,0845,460,8,468,637,0,3,1,4,2,1,3,0.00,73.47,75.00
10,007,01,180,0001,0846,539,11,550,802,0,3,1,4,2,1,3,0.00,68.58,75.00
10,007,01,180,0002,0847,668,19,687,882,0,3,1,4,2,1,3,0.00,77.89,75.00
10,007,01,190,0012,0000,1738,51,1789,2602,0,3,0,3,2,0,2,0.00,68.75,66.67
10,007,01,190,0013,0000,1175,36,1211,1864,0,3,0,3,2,0,2,0.00,64.97,66.67
10,007,01,190,0012,0861,589,19,608,884,0,3,0,3,2,0,2,0.00,68.78,66.67
10,007,01,190,0012,0862,587,19,606,871,0,3,0,3,2,0,2,0.00,69.58,66.67
10,007,01,190,0012,0863,562,13,575,847,0,3,0,3,2,0,2,0.00,67.89,66.67
10,007,01,190,0013,0864,675,18,693,1078,0,3,0,3,2,0,2,0.00,64.29,66.67
10,007,01,190,0013,0865,500,18,518,786,0,3,0,3,2,0,2,0.00,65.90,66.67
10,007,01,200,0001,0000,1252,48,1300,2023,0,1,3,4,1,2,3,0.00,64.26,75.00
10,007,01,200,0002,0000,1803,80,1883,3125,0,1,3,4,1,2,3,0.00,60.26,75.00
10,007,01,200,0003,0000,902,44,946,1453,0,1,3,4,1,2,3,0.00,65.11,75.00
10,007,01,200,0004,0000,1811,83,1894,2882,0,1,3,4,1,2,3,0.00,65.72,75.00
10,007,01,200,0012,0000,1322,57,1379,2426,0,1,3,4,1,2,3,0.00,56.84,75.00
10,007,01,200,0012,0972,374,10,384,685,0,1,3,4,1,2,3,0.00,56.06,75.00
10,007,01,200,0012,0973,574,20,594,995,0,1,3,4,1,2,3,0.00,59.70,75.00
10,007,01,200,0012,0974,374,27,401,746,0,1,3,4,1,2,3,0.00,53.75,75.00
10,007,01,200,0001,0975,469,13,482,802,0,1,3,4,1,2,3,0.00,60.10,75.00
10,007,01,200,0001,0976,783,35,818,1221,0,1,3,4,1,2,3,0.00,66.99,75.00
10,007,01,200,0002,0977,567,34,601,980,0,1,3,4,1,2,3,0.00,61.33,75.00
10,007,01,200,0002,0978,660,19,679,1108,0,1,3,4,1,2,3,0.00,61.28,75.00
10,007,01,200,0002,0979,576,27,603,1037,0,1,3,4,1,2,3,0.00,58.15,75.00
10,007,01,200,0003,0980,902,44,946,1453,0,1,3,4,1,2,3,0.00,65.11,75.00
10,007,01,200,0004,0981,615,26,641,949,0,1,3,4,1,2,3,0.00,67.54,75.00
10,007,01,200,0004,0982,619,22,641,998,0,1,3,4,1,2,3,0.00,64.23,75.00
10,007,01,200,0004,0983,577,35,612,935,0,1,3,4,1,2,3,0.00,65.45,75.00
10,007,01,210,0001,0000,794,19,813,1241,0,4,3,7,3,2,5,0.00,65.51,71.43
10,007,01,210,0003,0000,1619,35,1654,2503,0,4,3,7,3,2,5,0.00,66.08,71.43
10,007,01,210,0010,0000,850,22,872,1260,0,4,3,7,3,2,5,0.00,69.21,71.43
10,007,01,210,0011,0000,957,27,984,1463,0,4,3,7,3,2,5,0.00,67.26,71.43
10,007,01,210,0012,0000,740,22,762,1183,0,4,3,7,3,2,5,0.00,64.41,71.43
10,007,01,210,0013,0000,1127,41,1168,1625,0,4,3,7,3,2,5,0.00,71.88,71.43
10,007,01,210,0020,0000,536,9,545,874,0,4,3,7,3,2,5,0.00,62.36,71.43
10,007,01,210,0001,0891,794,19,813,1241,0,4,3,7,3,2,5,0.00,65.51,71.43
10,007,01,210,0012,0892,740,22,762,1183,0,4,3,7,3,2,5,0.00,64.41,71.43
10,007,01,210,0013,0893,698,22,720,968,0,4,3,7,3,2,5,0.00,74.38,71.43
10,007,01,210,0013,0894,429,19,448,657,0,4,3,7,3,2,5,0.00,68.19,71.43
10,007,01,210,0020,0895,536,9,545,874,0,4,3,7,3,2,5,0.00,62.36,71.43
10,007,01,210,0011,0896,403,15,418,619,0,4,3,7,3,2,5,0.00,67.53,71.43
10,007,01,210,0011,0897,554,12,566,844,0,4,3,7,3,2,5,0.00,67.06,71.43
10,007,01,210,0010,0898,850,22,872,1260,0,4,3,7,3,2,5,0.00,69.21,71.43
10,007,01,210,0003,0899,886,15,901,1356,0,4,3,7,3,2,5,0.00,66.45,71.43
10,007,01,210,0003,0900,733,20,753,1147,0,4,3,7,3,2,5,0.00,65.65,71.43
10,007,01,220,0001,0000,1334,65,1399,2325,0,4,0,4,3,0,3,0.00,60.17,75.00
10,007,01,220,0002,0000,1090,59,1149,1703,0,4,0,4,3,0,3,0.00,67.47,75.00
10,007,01,220,0003,0000,872,60,932,1509,0,4,0,4,3,0,3,0.00,61.76,75.00
10,007,01,220,0001,0916,650,30,680,1068,0,4,0,4,3,0,3,0.00,63.67,75.00
10,007,01,220,0001,0917,684,35,719,1257,0,4,0,4,3,0,3,0.00,57.20,75.00
10,007,01,220,0002,0918,626,32,658,946,0,4,0,4,3,0,3,0.00,69.56,75.00
10,007,01,220,0002,0919,464,27,491,757,0,4,0,4,3,0,3,0.00,64.86,75.00
10,007,01,220,0003,0920,385,28,413,681,0,4,0,4,3,0,3,0.00,60.65,75.00
10,007,01,220,0003,0921,487,32,519,828,0,4,0,4,3,0,3,0.00,62.68,75.00
10,007,01,230,0001,0000,613,28,641,898,0,5,1,6,3,0,3,0.00,71.38,50.00
10,007,01,230,0002,0000,238,16,254,385,0,5,1,6,3,0,3,0.00,65.97,50.00
10,007,01,230,0003,0000,512,21,533,703,0,5,1,6,3,0,3,0.00,75.82,50.00
10,007,01,230,0004,0000,317,13,330,498,0,5,1,6,3,0,3,0.00,66.27,50.00
10,007,01,230,0005,0000,565,19,584,926,0,5,1,6,3,0,3,0.00,63.07,50.00
10,007,01,230,0006,0000,1350,46,1396,1995,0,5,1,6,3,0,3,0.00,69.97,50.00
10,007,01,230,0007,0000,785,24,809,1275,0,5,1,6,3,0,3,0.00,63.45,50.00
10,007,01,230,0014,0000,409,25,434,738,0,5,1,6,3,0,3,0.00,58.81,50.00
10,007,01,230,0001,1031,613,28,641,898,0,5,1,6,3,0,3,0.00,71.38,50.00
10,007,01,230,0002,1032,238,16,254,385,0,5,1,6,3,0,3,0.00,65.97,50.00
10,007,01,230,0003,1033,512,21,533,703,0,5,1,6,3,0,3,0.00,75.82,50.00
10,007,01,230,0004,1034,317,13,330,498,0,5,1,6,3,0,3,0.00,66.27,50.00
10,007,01,230,0005,1035,565,19,584,926,0,5,1,6,3,0,3,0.00,63.07,50.00
10,007,01,230,0006,1036,788,32,820,1183,0,5,1,6,3,0,3,0.00,69.32,50.00
10,007,01,230,0006,1037,562,14,576,812,0,5,1,6,3,0,3,0.00,70.94,50.00
10,007,01,230,0007,1038,426,14,440,666,0,5,1,6,3,0,3,0.00,66.07,50.00
10,007,01,230,0007,1039,359,10,369,609,0,5,1,6,3,0,3,0.00,60.59,50.00
10,007,01,230,0014,1040,409,25,434,738,0,5,1,6,3,0,3,0.00,58.81,50.00
10,007,01,240,0001,0000,695,9,704,1021,0,3,0,3,2,0,2,0.00,68.95,66.67
10,007,01,240,0007,0000,896,22,918,1222,0,3,0,3,2,0,2,0.00,75.12,66.67
10,007,01,240,0007,1014,896,22,918,1222,0,3,0,3,2,0,2,0.00,75.12,66.67
10,007,01,240,0001,1015,695,9,704,1021,0,3,0,3,2,0,2,0.00,68.95,66.67
10,007,01,250,0001,0000,831,14,845,1108,0,3,1,4,3,0,3,0.00,76.26,75.00
10,007,01,250,0002,0000,1366,26,1392,1867,0,3,1,4,3,0,3,0.00,74.56,75.00
10,007,01,250,0003,0000,556,4,560,669,0,3,1,4,3,0,3,0.00,83.71,75.00
10,007,01,250,0001,1067,831,14,845,1108,0,3,1,4,3,0,3,0.00,76.26,75.00
10,007,01,250,0002,1068,687,12,699,924,0,3,1,4,3,0,3,0.00,75.65,75.00
10,007,01,250,0002,1069,679,14,693,943,0,3,1,4,3,0,3,0.00,73.49,75.00
10,007,01,250,0003,1070,556,4,560,669,0,3,1,4,3,0,3,0.00,83.71,75.00
10,007,01,260,0001,0000,1035,34,1069,1759,0,6,0,6,3,0,3,0.00,60.77,50.00
10,007,01,260,0005,0000,435,17,452,678,0,6,0,6,3,0,3,0.00,66.67,50.00
10,007,01,260,0008,0000,613,23,636,861,0,6,0,6,3,0,3,0.00,73.87,50.00
10,007,01,260,0011,0000,923,49,972,1483,0,6,0,6,3,0,3,0.00,65.54,50.00
10,007,01,260,0014,0000,1035,70,1105,1758,0,6,0,6,3,0,3,0.00,62.86,50.00
10,007,01,260,0001,0943,443,16,459,751,0,6,0,6,3,0,3,0.00,61.12,50.00
10,007,01,260,0001,0944,592,18,610,1008,0,6,0,6,3,0,3,0.00,60.52,50.00
10,007,01,260,0005,0945,435,17,452,678,0,6,0,6,3,0,3,0.00,66.67,50.00
10,007,01,260,0008,0946,613,23,636,861,0,6,0,6,3,0,3,0.00,73.87,50.00
10,007,01,260,0011,0947,409,16,425,609,0,6,0,6,3,0,3,0.00,69.79,50.00
10,007,01,260,0011,0948,514,33,547,874,0,6,0,6,3,0,3,0.00,62.59,50.00
10,007,01,260,0014,0949,526,41,567,934,0,6,0,6,3,0,3,0.00,60.71,50.00
10,007,01,260,0014,0950,509,29,538,824,0,6,0,6,3,0,3,0.00,65.29,50.00
10,007,00,020,0000,0000,42466,1719,44185,68232,85339,15,5,20,10,5,15,79.95,64.76,75.00
10,007,01,020,0000,0000,11627,459,12086,19046,23697,3,2,5,2,2,4,80.37,63.46,80.00
10,007,02,020,0000,0000,4210,181,4391,6456,8278,3,0,3,2,0,2,77.99,68.01,66.67
10,007,03,020,0000,0000,9881,372,10253,15935,19243,3,2,5,1,2,3,82.81,64.34,60.00
10,007,04,020,0000,0000,16748,707,17455,26795,34121,6,1,7,5,1,6,78.53,65.14,85.71
10,007,02,010,0017,0052,433,27,460,706,0,6,3,9,4,2,6,0.00,65.16,66.67
10,007,02,010,0018,0053,507,33,540,817,0,6,3,9,4,2,6,0.00,66.10,66.67
10,007,02,010,0019,0054,633,37,670,1004,0,6,3,9,4,2,6,0.00,66.73,66.67
10,007,02,010,0016,0055,513,31,544,793,0,6,3,9,4,2,6,0.00,68.60,66.67
10,007,02,010,0025,0056,601,35,636,865,0,6,3,9,4,2,6,0.00,73.53,66.67
10,007,02,010,0020,0057,614,23,637,982,0,6,3,9,4,2,6,0.00,64.87,66.67
10,007,02,010,0020,0058,780,35,815,1241,0,6,3,9,4,2,6,0.00,65.67,66.67
10,007,02,010,0020,0059,583,24,607,977,0,6,3,9,4,2,6,0.00,62.13,66.67
10,007,02,010,0021,0060,639,28,667,1099,0,6,3,9,4,2,6,0.00,60.69,66.67
10,007,02,010,0021,0061,655,37,692,1216,0,6,3,9,4,2,6,0.00,56.91,66.67
10,007,02,010,0021,0062,715,32,747,1161,0,6,3,9,4,2,6,0.00,64.34,66.67
10,007,02,010,0023,0063,612,30,642,995,0,6,3,9,4,2,6,0.00,64.52,66.67
10,007,02,010,0023,0064,619,25,644,1039,0,6,3,9,4,2,6,0.00,61.98,66.67
10,007,02,010,0023,0065,535,25,560,1012,0,6,3,9,4,2,6,0.00,55.34,66.67
10,007,02,010,0022,0066,654,35,689,1086,0,6,3,9,4,2,6,0.00,63.44,66.67
10,007,02,010,0024,0067,537,21,558,960,0,6,3,9,4,2,6,0.00,58.13,66.67
10,007,02,010,0024,0068,573,31,604,1054,0,6,3,9,4,2,6,0.00,57.31,66.67
10,007,02,010,0024,0069,535,28,563,896,0,6,3,9,4,2,6,0.00,62.83,66.67
10,007,02,010,0024,0070,535,25,560,1091,0,6,3,9,4,2,6,0.00,51.33,66.67
10,007,02,010,0031,0071,606,22,628,945,0,6,3,9,4,2,6,0.00,66.46,66.67
10,007,02,010,0031,0072,737,21,758,1153,0,6,3,9,4,2,6,0.00,65.74,66.67
10,007,02,010,0031,0073,623,19,642,1047,0,6,3,9,4,2,6,0.00,61.32,66.67
10,007,02,010,0031,0074,579,23,602,1001,0,6,3,9,4,2,6,0.00,60.14,66.67
10,007,02,010,0072,0075,711,19,730,1181,0,6,3,9,4,2,6,0.00,61.81,66.67
10,007,02,010,0072,0076,647,29,676,1038,0,6,3,9,4,2,6,0.00,65.13,66.67
10,007,02,010,0072,0077,566,16,582,977,0,6,3,9,4,2,6,0.00,59.57,66.67
10,007,02,010,0072,0078,540,29,569,935,0,6,3,9,4,2,6,0.00,60.86,66.67
10,007,02,010,0072,0079,584,20,604,984,0,6,3,9,4,2,6,0.00,61.38,66.67
10,007,02,010,0073,0080,663,33,696,1125,0,6,3,9,4,2,6,0.00,61.87,66.67
10,007,02,010,0073,0081,502,21,523,913,0,6,3,9,4,2,6,0.00,57.28,66.67
10,007,02,010,0073,0082,602,19,621,965,0,6,3,9,4,2,6,0.00,64.35,66.67
10,007,02,010,0073,0083,576,21,597,975,0,6,3,9,4,2,6,0.00,61.23,66.67
10,007,02,010,0073,0084,602,31,633,1122,0,6,3,9,4,2,6,0.00,56.42,66.67
10,007,02,010,0029,0085,498,22,520,863,0,6,3,9,4,2,6,0.00,60.25,66.67
10,007,02,010,0029,0086,686,20,706,1063,0,6,3,9,4,2,6,0.00,66.42,66.67
10,007,02,010,0029,0087,602,29,631,1034,0,6,3,9,4,2,6,0.00,61.03,66.67
10,007,02,010,0028,0088,467,26,493,817,0,6,3,9,4,2,6,0.00,60.34,66.67
10,007,02,010,0028,0089,588,34,622,1022,0,6,3,9,4,2,6,0.00,60.86,66.67
10,007,02,010,0027,0090,721,22,743,1110,0,6,3,9,4,2,6,0.00,66.94,66.67
10,007,02,010,0027,0091,606,12,618,952,0,6,3,9,4,2,6,0.00,64.92,66.67
10,007,02,010,0026,0092,635,19,654,1120,0,6,3,9,4,2,6,0.00,58.39,66.67
10,007,02,010,0026,0093,642,27,669,1040,0,6,3,9,4,2,6,0.00,64.33,66.67
10,007,02,010,0026,0094,747,20,767,1181,0,6,3,9,4,2,6,0.00,64.94,66.67
10,007,02,010,0030,0095,653,15,668,1123,0,6,3,9,4,2,6,0.00,59.48,66.67
10,007,02,010,0030,0096,608,20,628,979,0,6,3,9,4,2,6,0.00,64.15,66.67
10,007,02,010,0030,0097,647,28,675,1035,0,6,3,9,4,2,6,0.00,65.22,66.67
10,007,02,010,0016,0000,513,31,544,793,0,6,3,9,4,2,6,0.00,68.60,66.67
10,007,02,010,0017,0000,433,27,460,706,0,6,3,9,4,2,6,0.00,65.16,66.67
10,007,02,010,0018,0000,507,33,540,817,0,6,3,9,4,2,6,0.00,66.10,66.67
10,007,02,010,0019,0000,633,37,670,1004,0,6,3,9,4,2,6,0.00,66.73,66.67
10,007,02,010,0020,0000,1977,82,2059,3200,0,6,3,9,4,2,6,0.00,64.34,66.67
10,007,02,010,0021,0000,2009,97,2106,3476,0,6,3,9,4,2,6,0.00,60.59,66.67
10,007,02,010,0022,0000,654,35,689,1086,0,6,3,9,4,2,6,0.00,63.44,66.67
10,007,02,010,0023,0000,1766,80,1846,3046,0,6,3,9,4,2,6,0.00,60.60,66.67
10,007,02,010,0024,0000,2180,105,2285,4001,0,6,3,9,4,2,6,0.00,57.11,66.67
10,007,02,010,0025,0000,601,35,636,865,0,6,3,9,4,2,6,0.00,73.53,66.67
10,007,02,010,0026,0000,2024,66,2090,3341,0,6,3,9,4,2,6,0.00,62.56,66.67
10,007,02,010,0027,0000,1327,34,1361,2062,0,6,3,9,4,2,6,0.00,66.00,66.67
10,007,02,010,0028,0000,1055,60,1115,1839,0,6,3,9,4,2,6,0.00,60.63,66.67
10,007,02,010,0029,0000,1786,71,1857,2960,0,6,3,9,4,2,6,0.00,62.74,66.67
10,007,02,010,0030,0000,1908,63,1971,3137,0,6,3,9,4,2,6,0.00,62.83,66.67
10,007,02,010,0031,0000,2545,85,2630,4146,0,6,3,9,4,2,6,0.00,63.43,66.67
10,007,02,010,0072,0000,3048,113,3161,5115,0,6,3,9,4,2,6,0.00,61.80,66.67
10,007,02,010,0073,0000,2945,125,3070,5100,0,6,3,9,4,2,6,0.00,60.20,66.67
10,007,02,020,0012,0000,659,37,696,1024,0,3,0,3,2,0,2,0.00,67.97,66.67
10,007,02,020,0013,0000,691,28,719,1096,0,3,0,3,2,0,2,0.00,65.60,66.67
10,007,02,020,0014,0000,157,6,163,260,0,3,0,3,2,0,2,0.00,62.69,66.67
10,007,02,020,0015,0000,373,19,392,587,0,3,0,3,2,0,2,0.00,66.78,66.67
10,007,02,020,0016,0000,336,13,349,547,0,3,0,3,2,0,2,0.00,63.80,66.67
10,007,02,020,0017,0000,633,21,654,847,0,3,0,3,2,0,2,0.00,77.21,66.67
10,007,02,020,0018,0000,1361,57,1418,2095,0,3,0,3,2,0,2,0.00,67.68,66.67
10,007,02,020,0012,0268,659,37,696,1024,0,3,0,3,2,0,2,0.00,67.97,66.67
10,007,02,020,0013,0269,691,28,719,1096,0,3,0,3,2,0,2,0.00,65.60,66.67
10,007,02,020,0014,0270,157,6,163,260,0,3,0,3,2,0,2,0.00,62.69,66.67
10,007,02,020,0016,0271,336,13,349,547,0,3,0,3,2,0,2,0.00,63.80,66.67
10,007,02,020,0015,0272,373,19,392,587,0,3,0,3,2,0,2,0.00,66.78,66.67
10,007,02,020,0017,0273,633,21,654,847,0,3,0,3,2,0,2,0.00,77.21,66.67
10,007,02,020,0018,0274,676,28,704,1010,0,3,0,3,2,0,2,0.00,69.70,66.67
10,007,02,020,0018,0275,685,29,714,1085,0,3,0,3,2,0,2,0.00,65.81,66.67
10,007,02,030,0010,0000,1682,56,1738,2742,0,5,2,7,2,2,4,0.00,63.38,57.14
10,007,02,030,0011,0000,813,32,845,1394,0,5,2,7,2,2,4,0.00,60.62,57.14
10,007,02,030,0012,0000,1072,30,1102,1785,0,5,2,7,2,2,4,0.00,61.74,57.14
10,007,02,030,0013,0000,1295,31,1326,2143,0,5,2,7,2,2,4,0.00,61.88,57.14
10,007,02,030,0014,0000,807,39,846,1260,0,5,2,7,2,2,4,0.00,67.14,57.14
10,007,02,030,0015,0000,2980,153,3133,5125,0,5,2,7,2,2,4,0.00,61.13,57.14
10,007,02,030,0016,0000,1147,75,1222,1843,0,5,2,7,2,2,4,0.00,66.30,57.14
10,007,02,030,0018,0000,1081,70,1151,1945,0,5,2,7,2,2,4,0.00,59.18,57.14
10,007,02,030,0032,0000,1402,103,1505,2647,0,5,2,7,2,2,4,0.00,56.86,57.14
10,007,02,030,0010,0410,858,28,886,1411,0,5,2,7,2,2,4,0.00,62.79,57.14
10,007,02,030,0010,0411,824,28,852,1331,0,5,2,7,2,2,4,0.00,64.01,57.14
10,007,02,030,0011,0412,426,21,447,760,0,5,2,7,2,2,4,0.00,58.82,57.14
10,007,02,030,0011,0413,387,11,398,634,0,5,2,7,2,2,4,0.00,62.78,57.14
10,007,02,030,0012,0414,549,16,565,941,0,5,2,7,2,2,4,0.00,60.04,57.14
10,007,02,030,0012,0415,523,14,537,844,0,5,2,7,2,2,4,0.00,63.63,57.14
10,007,02,030,0013,0416,674,12,686,1104,0,5,2,7,2,2,4,0.00,62.14,57.14
10,007,02,030,0013,0417,621,19,640,1039,0,5,2,7,2,2,4,0.00,61.60,57.14
10,007,02,030,0014,0418,807,39,846,1260,0,5,2,7,2,2,4,0.00,67.14,57.14
10,007,02,030,0015,0419,652,36,688,1119,0,5,2,7,2,2,4,0.00,61.48,57.14
10,007,02,030,0015,0420,734,36,770,1250,0,5,2,7,2,2,4,0.00,61.60,57.14
10,007,02,030,0015,0421,726,24,750,1216,0,5,2,7,2,2,4,0.00,61.68,57.14
10,007,02,030,0015,0422,868,57,925,1540,0,5,2,7,2,2,4,0.00,60.06,57.14
10,007,02,030,0032,0423,700,56,756,1330,0,5,2,7,2,2,4,0.00,56.84,57.14
10,007,02,030,0032,0424,702,47,749,1317,0,5,2,7,2,2,4,0.00,56.87,57.14
10,007,02,030,0016,0425,631,40,671,970,0,5,2,7,2,2,4,0.00,69.18,57.14
10,007,02,030,0016,0426,516,35,551,873,0,5,2,7,2,2,4,0.00,63.12,57.14
10,007,02,030,0018,0427,566,41,607,970,0,5,2,7,2,2,4,0.00,62.58,57.14
10,007,02,030,0018,0428,515,29,544,975,0,5,2,7,2,2,4,0.00,55.79,57.14
10,007,02,040,0004,0000,862,15,877,1194,0,3,0,3,2,0,2,0.00,73.45,66.67
10,007,02,040,0005,0000,792,22,814,1180,0,3,0,3,2,0,2,0.00,68.98,66.67
10,007,02,040,0004,0492,862,15,877,1194,0,3,0,3,2,0,2,0.00,73.45,66.67
10,007,02,040,0005,0493,792,22,814,1180,0,3,0,3,2,0,2,0.00,68.98,66.67
10,007,02,050,0004,0000,1285,24,1309,2003,0,3,0,3,2,0,2,0.00,65.35,66.67
10,007,02,050,0009,0000,1574,47,1621,2579,0,3,0,3,2,0,2,0.00,62.85,66.67
10,007,02,050,0004,0465,587,8,595,866,0,3,0,3,2,0,2,0.00,68.71,66.67
10,007,02,050,0004,0466,698,16,714,1137,0,3,0,3,2,0,2,0.00,62.80,66.67
10,007,02,050,0009,0467,867,19,886,1351,0,3,0,3,2,0,2,0.00,65.58,66.67
10,007,02,050,0009,0468,707,28,735,1228,0,3,0,3,2,0,2,0.00,59.85,66.67
10,007,02,060,0001,0000,916,42,958,1414,0,4,0,4,3,0,3,0.00,67.75,75.00
10,007,02,060,0002,0000,884,54,938,1388,0,4,0,4,3,0,3,0.00,67.58,75.00
10,007,02,060,0010,0000,1554,81,1635,2538,0,4,0,4,3,0,3,0.00,64.42,75.00
10,007,02,060,0011,0000,1766,85,1851,2480,0,4,0,4,3,0,3,0.00,74.64,75.00
10,007,02,060,0021,0000,1457,41,1498,2261,0,4,0,4,3,0,3,0.00,66.25,75.00
10,007,02,060,0022,0000,1156,55,1211,1818,0,4,0,4,3,0,3,0.00,66.61,75.00
10,007,02,060,0010,0326,751,39,790,1248,0,4,0,4,3,0,3,0.00,63.30,75.00
10,007,02,060,0010,0327,803,42,845,1290,0,4,0,4,3,0,3,0.00,65.50,75.00
10,007,02,060,0002,0328,884,54,938,1388,0,4,0,4,3,0,3,0.00,67.58,75.00
10,007,02,060,0001,0329,916,42,958,1414,0,4,0,4,3,0,3,0.00,67.75,75.00
10,007,02,060,0022,0330,550,21,571,839,0,4,0,4,3,0,3,0.00,68.06,75.00
10,007,02,060,0022,0331,606,34,640,979,0,4,0,4,3,0,3,0.00,65.37,75.00
10,007,02,060,0021,0332,657,17,674,984,0,4,0,4,3,0,3,0.00,68.50,75.00
10,007,02,060,0021,0333,800,24,824,1277,0,4,0,4,3,0,3,0.00,64.53,75.00
10,007,02,060,0011,0334,748,38,786,1037,0,4,0,4,3,0,3,0.00,75.80,75.00
10,007,02,060,0011,0335,1018,47,1065,1443,0,4,0,4,3,0,3,0.00,73.80,75.00
10,007,02,070,0007,0000,1930,60,1990,3048,0,3,0,3,2,0,2,0.00,65.29,66.67
10,007,02,070,0008,0000,1356,37,1393,2147,0,3,0,3,2,0,2,0.00,64.88,66.67
10,007,02,070,0009,0000,810,34,844,1415,0,3,0,3,2,0,2,0.00,59.65,66.67
10,007,02,070,0007,0366,439,19,458,718,0,3,0,3,2,0,2,0.00,63.79,66.67
10,007,02,070,0007,0367,614,17,631,964,0,3,0,3,2,0,2,0.00,65.46,66.67
10,007,02,070,0007,0368,476,9,485,740,0,3,0,3,2,0,2,0.00,65.54,66.67
10,007,02,070,0007,0369,401,15,416,626,0,3,0,3,2,0,2,0.00,66.45,66.67
10,007,02,070,0008,0370,427,18,445,673,0,3,0,3,2,0,2,0.00,66.12,66.67
10,007,02,070,0008,0371,394,8,402,645,0,3,0,3,2,0,2,0.00,62.33,66.67
10,007,02,070,0008,0372,535,11,546,829,0,3,0,3,2,0,2,0.00,65.86,66.67
10,007,02,070,0009,0373,370,11,381,686,0,3,0,3,2,0,2,0.00,55.54,66.67
10,007,02,070,0009,0374,440,23,463,729,0,3,0,3,2,0,2,0.00,63.51,66.67
10,007,02,080,0007,0000,542,16,558,699,0,2,4,6,2,3,5,0.00,79.83,83.33
10,007,02,080,0008,0000,1089,47,1136,1738,0,2,4,6,2,3,5,0.00,65.36,83.33
10,007,02,080,0009,0000,2710,92,2802,4766,0,2,4,6,2,3,5,0.00,58.79,83.33
10,007,02,080,0010,0000,1908,52,1960,3018,0,2,4,6,2,3,5,0.00,64.94,83.33
10,007,02,080,0011,0000,2575,100,2675,4428,0,2,4,6,2,3,5,0.00,60.41,83.33
10,007,02,080,0012,0000,860,21,881,1283,0,2,4,6,2,3,5,0.00,68.67,83.33
10,007,02,080,0008,0200,672,27,699,1070,0,2,4,6,2,3,5,0.00,65.33,83.33
10,007,02,080,0008,0201,417,20,437,668,0,2,4,6,2,3,5,0.00,65.42,83.33
10,007,02,080,0007,0202,542,16,558,699,0,2,4,6,2,3,5,0.00,79.83,83.33
10,007,02,080,0010,0203,608,24,632,967,0,2,4,6,2,3,5,0.00,65.36,83.33
10,007,02,080,0010,0204,566,14,580,932,0,2,4,6,2,3,5,0.00,62.23,83.33
10,007,02,080,0010,0205,734,14,748,1119,0,2,4,6,2,3,5,0.00,66.85,83.33
10,007,02,080,0011,0206,679,20,699,1090,0,2,4,6,2,3,5,0.00,64.13,83.33
10,007,02,080,0011,0207,610,16,626,1052,0,2,4,6,2,3,5,0.00,59.51,83.33
10,007,02,080,0011,0208,749,29,778,1227,0,2,4,6,2,3,5,0.00,63.41,83.33
10,007,02,080,0011,0209,537,35,572,1059,0,2,4,6,2,3,5,0.00,54.01,83.33
10,007,02,080,0012,0210,860,21,881,1283,0,2,4,6,2,3,5,0.00,68.67,83.33
10,007,02,080,0009,0211,610,21,631,1098,0,2,4,6,2,3,5,0.00,57.47,83.33
10,007,02,080,0009,0212,709,28,737,1265,0,2,4,6,2,3,5,0.00,58.26,83.33
10,007,02,080,0009,0213,702,26,728,1229,0,2,4,6,2,3,5,0.00,59.24,83.33
10,007,02,080,0009,0214,689,17,706,1174,0,2,4,6,2,3,5,0.00,60.14,83.33
10,007,02,090,0004,0000,1556,70,1626,2366,0,3,2,5,2,2,4,0.00,68.72,80.00
10,007,02,090,0005,0000,1482,57,1539,2270,0,3,2,5,2,2,4,0.00,67.80,80.00
10,007,02,090,0006,0000,1143,45,1188,1570,0,3,2,5,2,2,4,0.00,75.67,80.00
10,007,02,090,0007,0000,532,25,557,832,0,3,2,5,2,2,4,0.00,66.95,80.00
10,007,02,090,0015,0000,435,20,455,552,0,3,2,5,2,2,4,0.00,82.43,80.00
10,007,02,090,0015,0232,435,20,455,552,0,3,2,5,2,2,4,0.00,82.43,80.00
10,007,02,090,0004,0233,760,39,799,1175,0,3,2,5,2,2,4,0.00,68.00,80.00
10,007,02,090,0004,0234,796,31,827,1191,0,3,2,5,2,2,4,0.00,69.44,80.00
10,007,02,090,0005,0235,708,29,737,1151,0,3,2,5,2,2,4,0.00,64.03,80.00
10,007,02,090,0005,0236,774,28,802,1119,0,3,2,5,2,2,4,0.00,71.67,80.00
10,007,02,090,0006,0237,731,34,765,1008,0,3,2,5,2,2,4,0.00,75.89,80.00
10,007,02,090,0006,0238,412,11,423,562,0,3,2,5,2,2,4,0.00,75.27,80.00
10,007,02,090,0007,0239,532,25,557,832,0,3,2,5,2,2,4,0.00,66.95,80.00
10,007,02,100,0001,0000,553,52,605,999,0,4,2,6,3,2,5,0.00,60.56,83.33
10,007,02,100,0002,0000,1537,97,1634,2559,0,4,2,6,3,2,5,0.00,63.85,83.33
10,007,02,100,0009,0000,968,72,1040,1711,0,4,2,6,3,2,5,0.00,60.78,83.33
10,007,02,100,0010,0000,3051,191,3242,5396,0,4,2,6,3,2,5,0.00,60.08,83.33
10,007,02,100,0020,0000,1242,62,1304,1885,0,4,2,6,3,2,5,0.00,69.18,83.33
10,007,02,100,0021,0000,1472,70,1542,2475,0,4,2,6,3,2,5,0.00,62.30,83.33
10,007,02,100,0022,0000,1942,61,2003,3218,0,4,2,6,3,2,5,0.00,62.24,83.33
10,007,02,100,0023,0000,1395,57,1452,2261,0,4,2,6,3,2,5,0.00,64.22,83.33
10,007,02,100,0024,0000,2138,102,2240,3567,0,4,2,6,3,2,5,0.00,62.80,83.33
10,007,02,100,0001,0522,553,52,605,999,0,4,2,6,3,2,5,0.00,60.56,83.33
10,007,02,100,0002,0523,487,30,517,834,0,4,2,6,3,2,5,0.00,61.99,83.33
10,007,02,100,0002,0524,500,29,529,870,0,4,2,6,3,2,5,0.00,60.80,83.33
10,007,02,100,0002,0525,550,38,588,855,0,4,2,6,3,2,5,0.00,68.77,83.33
10,007,02,100,0009,0526,453,33,486,808,0,4,2,6,3,2,5,0.00,60.15,83.33
10,007,02,100,0009,0527,515,39,554,903,0,4,2,6,3,2,5,0.00,61.35,83.33
10,007,02,100,0010,0528,579,34,613,1034,0,4,2,6,3,2,5,0.00,59.28,83.33
10,007,02,100,0010,0529,587,41,628,1024,0,4,2,6,3,2,5,0.00,61.33,83.33
10,007,02,100,0010,0530,577,31,608,1020,0,4,2,6,3,2,5,0.00,59.61,83.33
10,007,02,100,0010,0531,708,43,751,1243,0,4,2,6,3,2,5,0.00,60.42,83.33
10,007,02,100,0010,0532,600,42,642,1075,0,4,2,6,3,2,5,0.00,59.72,83.33
10,007,02,100,0020,0533,699,42,741,1041,0,4,2,6,3,2,5,0.00,71.18,83.33
10,007,02,100,0020,0534,543,20,563,844,0,4,2,6,3,2,5,0.00,66.71,83.33
10,007,02,100,0021,0535,763,40,803,1308,0,4,2,6,3,2,5,0.00,61.39,83.33
10,007,02,100,0021,0536,709,30,739,1167,0,4,2,6,3,2,5,0.00,63.32,83.33
10,007,02,100,0022,0537,632,17,649,1006,0,4,2,6,3,2,5,0.00,64.51,83.33
10,007,02,100,0022,0538,607,21,628,1022,0,4,2,6,3,2,5,0.00,61.45,83.33
10,007,02,100,0022,0539,703,23,726,1190,0,4,2,6,3,2,5,0.00,61.01,83.33
10,007,02,100,0023,0540,796,26,822,1220,0,4,2,6,3,2,5,0.00,67.38,83.33
10,007,02,100,0023,0541,599,31,630,1041,0,4,2,6,3,2,5,0.00,60.52,83.33
10,007,02,100,0024,0542,464,29,493,822,0,4,2,6,3,2,5,0.00,59.98,83.33
10,007,02,100,0024,0543,668,22,690,1105,0,4,2,6,3,2,5,0.00,62.44,83.33
10,007,02,100,0024,0544,487,26,513,786,0,4,2,6,3,2,5,0.00,65.27,83.33
10,007,02,100,0024,0545,519,25,544,854,0,4,2,6,3,2,5,0.00,63.70,83.33
10,007,02,110,0005,0000,1883,66,1949,3355,0,4,3,7,2,3,5,0.00,58.09,71.43
10,007,02,110,0006,0000,1420,39,1459,2119,0,4,3,7,2,3,5,0.00,68.85,71.43
10,007,02,110,0007,0000,1994,58,2052,3341,0,4,3,7,2,3,5,0.00,61.42,71.43
10,007,02,110,0008,0000,999,31,1030,1386,0,4,3,7,2,3,5,0.00,74.31,71.43
10,007,02,110,0009,0000,1856,53,1909,2916,0,4,3,7,2,3,5,0.00,65.47,71.43
10,007,02,110,0010,0000,1461,59,1520,2378,0,4,3,7,2,3,5,0.00,63.92,71.43
10,007,02,110,0011,0000,1247,40,1287,2201,0,4,3,7,2,3,5,0.00,58.47,71.43
10,007,02,110,0012,0000,592,25,617,780,0,4,3,7,2,3,5,0.00,79.10,71.43
10,007,02,110,0013,0000,1193,28,1221,1731,0,4,3,7,2,3,5,0.00,70.54,71.43
10,007,02,110,0005,0679,717,28,745,1208,0,4,3,7,2,3,5,0.00,61.67,71.43
10,007,02,110,0005,0680,568,17,585,1076,0,4,3,7,2,3,5,0.00,54.37,71.43
10,007,02,110,0005,0681,598,21,619,1071,0,4,3,7,2,3,5,0.00,57.80,71.43
10,007,02,110,0006,0682,766,21,787,1160,0,4,3,7,2,3,5,0.00,67.84,71.43
10,007,02,110,0006,0683,654,18,672,959,0,4,3,7,2,3,5,0.00,70.07,71.43
10,007,02,110,0007,0684,722,17,739,1139,0,4,3,7,2,3,5,0.00,64.88,71.43
10,007,02,110,0007,0685,593,19,612,987,0,4,3,7,2,3,5,0.00,62.01,71.43
10,007,02,110,0007,0686,679,22,701,1215,0,4,3,7,2,3,5,0.00,57.70,71.43
10,007,02,110,0008,0687,999,31,1030,1386,0,4,3,7,2,3,5,0.00,74.31,71.43
10,007,02,110,0009,0688,625,28,653,978,0,4,3,7,2,3,5,0.00,66.77,71.43
10,007,02,110,0009,0689,630,13,643,980,0,4,3,7,2,3,5,0.00,65.61,71.43
10,007,02,110,0009,0690,601,12,613,958,0,4,3,7,2,3,5,0.00,63.99,71.43
10,007,02,110,0010,0691,767,30,797,1269,0,4,3,7,2,3,5,0.00,62.81,71.43
10,007,02,110,0010,0692,694,29,723,1109,0,4,3,7,2,3,5,0.00,65.19,71.43
10,007,02,110,0011,0693,643,25,668,1101,0,4,3,7,2,3,5,0.00,60.67,71.43
10,007,02,110,0011,0694,604,15,619,1100,0,4,3,7,2,3,5,0.00,56.27,71.43
10,007,02,110,0012,0695,592,25,617,780,0,4,3,7,2,3,5,0.00,79.10,71.43
10,007,02,110,0013,0696,621,12,633,886,0,4,3,7,2,3,5,0.00,71.44,71.43
10,007,02,110,0013,0697,572,16,588,845,0,4,3,7,2,3,5,0.00,69.59,71.43
10,007,02,120,0007,0000,1038,46,1084,1688,0,4,2,6,3,1,4,0.00,64.22,66.67
10,007,02,120,0008,0000,339,21,360,550,0,4,2,6,3,1,4,0.00,65.45,66.67
10,007,02,120,0009,0000,1998,47,2045,3190,0,4,2,6,3,1,4,0.00,64.11,66.67
10,007,02,120,0010,0000,1444,32,1476,2301,0,4,2,6,3,1,4,0.00,64.15,66.67
10,007,02,120,0011,0000,635,28,663,990,0,4,2,6,3,1,4,0.00,66.97,66.67
10,007,02,120,0012,0000,673,12,685,1056,0,4,2,6,3,1,4,0.00,64.87,66.67
10,007,02,120,0013,0000,1160,59,1219,1863,0,4,2,6,3,1,4,0.00,65.43,66.67
10,007,02,120,0019,0000,825,37,862,1239,0,4,2,6,3,1,4,0.00,69.57,66.67
10,007,02,120,0007,0780,477,29,506,787,0,4,2,6,3,1,4,0.00,64.29,66.67
10,007,02,120,0007,0781,561,17,578,901,0,4,2,6,3,1,4,0.00,64.15,66.67
10,007,02,120,0008,0782,339,21,360,550,0,4,2,6,3,1,4,0.00,65.45,66.67
10,007,02,120,0009,0783,624,13,637,1037,0,4,2,6,3,1,4,0.00,61.43,66.67
10,007,02,120,0009,0784,691,15,706,1088,0,4,2,6,3,1,4,0.00,64.89,66.67
10,007,02,120,0009,0785,683,19,702,1065,0,4,2,6,3,1,4,0.00,65.92,66.67
10,007,02,120,0010,0786,771,9,780,1235,0,4,2,6,3,1,4,0.00,63.16,66.67
10,007,02,120,0010,0787,673,23,696,1066,0,4,2,6,3,1,4,0.00,65.29,66.67
10,007,02,120,0011,0788,635,28,663,990,0,4,2,6,3,1,4,0.00,66.97,66.67
10,007,02,120,0012,0789,673,12,685,1056,0,4,2,6,3,1,4,0.00,64.87,66.67
10,007,02,120,0013,0790,556,19,575,891,0,4,2,6,3,1,4,0.00,64.53,66.67
10,007,02,120,0013,0791,604,40,644,972,0,4,2,6,3,1,4,0.00,66.26,66.67
10,007,02,120,0019,0792,825,37,862,1239,0,4,2,6,3,1,4,0.00,69.57,66.67
10,007,02,130,0005,0000,772,20,792,1154,0,2,0,2,1,0,1,0.00,68.63,50.00
10,007,02,130,0010,0000,1113,35,1148,1574,0,2,0,2,1,0,1,0.00,72.94,50.00
10,007,02,130,0013,0000,1185,45,1230,1633,0,2,0,2,1,0,1,0.00,75.32,50.00
10,007,02,130,0010,0611,503,12,515,694,0,2,0,2,1,0,1,0.00,74.21,50.00
10,007,02,130,0010,0612,610,23,633,880,0,2,0,2,1,0,1,0.00,71.93,50.00
10,007,02,130,0013,0613,589,25,614,833,0,2,0,2,1,0,1,0.00,73.71,50.00
10,007,02,130,0013,0614,596,20,616,800,0,2,0,2,1,0,1,0.00,77.00,50.00
10,007,02,130,0005,0615,772,20,792,1154,0,2,0,2,1,0,1,0.00,68.63,50.00
10,007,02,140,0010,0000,853,24,877,1182,0,4,5,9,1,3,4,0.00,74.20,44.44
10,007,02,140,0011,0000,1210,31,1241,1769,0,4,5,9,1,3,4,0.00,70.15,44.44
10,007,02,140,0012,0000,1454,22,1476,1963,0,4,5,9,1,3,4,0.00,75.19,44.44
10,007,02,140,0013,0000,803,21,824,1135,0,4,5,9,1,3,4,0.00,72.60,44.44
10,007,02,140,0014,0000,346,5,351,433,0,4,5,9,1,3,4,0.00,81.06,44.44
10,007,02,140,0015,0000,772,24,796,1061,0,4,5,9,1,3,4,0.00,75.02,44.44
10,007,02,140,0016,0000,614,15,629,811,0,4,5,9,1,3,4,0.00,77.56,44.44
10,007,02,140,0010,0720,853,24,877,1182,0,4,5,9,1,3,4,0.00,74.20,44.44
10,007,02,140,0011,0721,580,15,595,831,0,4,5,9,1,3,4,0.00,71.60,44.44
10,007,02,140,0011,0722,630,16,646,938,0,4,5,9,1,3,4,0.00,68.87,44.44
10,007,02,140,0012,0723,704,13,717,943,0,4,5,9,1,3,4,0.00,76.03,44.44
10,007,02,140,0012,0724,750,9,759,1020,0,4,5,9,1,3,4,0.00,74.41,44.44
10,007,02,140,0013,0725,803,21,824,1135,0,4,5,9,1,3,4,0.00,72.60,44.44
10,007,02,140,0014,0726,346,5,351,433,0,4,5,9,1,3,4,0.00,81.06,44.44
10,007,02,140,0015,0727,772,24,796,1061,0,4,5,9,1,3,4,0.00,75.02,44.44
10,007,02,140,0016,0728,614,15,629,811,0,4,5,9,1,3,4,0.00,77.56,44.44
10,007,02,150,0012,0000,959,37,996,1445,0,3,2,5,2,1,3,0.00,68.93,60.00
10,007,02,150,0013,0000,664,30,694,1018,0,3,2,5,2,1,3,0.00,68.17,60.00
10,007,02,150,0014,0000,554,18,572,931,0,3,2,5,2,1,3,0.00,61.44,60.00
10,007,02,150,0015,0000,881,34,915,1258,0,3,2,5,2,1,3,0.00,72.73,60.00
10,007,02,150,0016,0000,1209,38,1247,1832,0,3,2,5,2,1,3,0.00,68.07,60.00
10,007,02,150,0012,0758,486,19,505,719,0,3,2,5,2,1,3,0.00,70.24,60.00
10,007,02,150,0012,0759,473,18,491,726,0,3,2,5,2,1,3,0.00,67.63,60.00
10,007,02,150,0013,0760,664,30,694,1018,0,3,2,5,2,1,3,0.00,68.17,60.00
10,007,02,150,0014,0761,554,18,572,931,0,3,2,5,2,1,3,0.00,61.44,60.00
10,007,02,150,0016,0762,577,12,589,907,0,3,2,5,2,1,3,0.00,64.94,60.00
10,007,02,150,0016,0763,632,26,658,925,0,3,2,5,2,1,3,0.00,71.14,60.00
10,007,02,150,0015,0764,461,14,475,633,0,3,2,5,2,1,3,0.00,75.04,60.00
10,007,02,150,0015,0765,420,20,440,625,0,3,2,5,2,1,3,0.00,70.40,60.00
10,007,02,160,0001,0000,493,17,510,733,0,8,3,11,3,2,5,0.00,69.58,45.45
10,007,02,160,0002,0000,942,31,973,1445,0,8,3,11,3,2,5,0.00,67.34,45.45
10,007,02,160,0003,0000,1098,34,1132,1723,0,8,3,11,3,2,5,0.00,65.70,45.45
10,007,02,160,0004,0000,1400,47,1447,2084,0,8,3,11,3,2,5,0.00,69.43,45.45
10,007,02,160,0005,0000,1086,32,1118,1604,0,8,3,11,3,2,5,0.00,69.70,45.45
10,007,02,160,0006,0000,903,38,941,1382,0,8,3,11,3,2,5,0.00,68.09,45.45
10,007,02,160,0007,0000,710,23,733,1038,0,8,3,11,3,2,5,0.00,70.62,45.45
10,007,02,160,0008,0000,627,38,665,1018,0,8,3,11,3,2,5,0.00,65.32,45.45
10,007,02,160,0009,0000,1736,36,1772,2603,0,8,3,11,3,2,5,0.00,68.08,45.45
10,007,02,160,0001,0641,493,17,510,733,0,8,3,11,3,2,5,0.00,69.58,45.45
10,007,02,160,0002,0642,423,17,440,661,0,8,3,11,3,2,5,0.00,66.57,45.45
10,007,02,160,0002,0643,519,14,533,784,0,8,3,11,3,2,5,0.00,67.98,45.45
10,007,02,160,0003,0644,620,17,637,967,0,8,3,11,3,2,5,0.00,65.87,45.45
10,007,02,160,0003,0645,478,17,495,756,0,8,3,11,3,2,5,0.00,65.48,45.45
10,007,02,160,0004,0646,687,25,712,1037,0,8,3,11,3,2,5,0.00,68.66,45.45
10,007,02,160,0004,0647,713,22,735,1047,0,8,3,11,3,2,5,0.00,70.20,45.45
10,007,02,160,0005,0648,594,18,612,858,0,8,3,11,3,2,5,0.00,71.33,45.45
10,007,02,160,0005,0649,492,14,506,746,0,8,3,11,3,2,5,0.00,67.83,45.45
10,007,02,160,0006,0650,521,24,545,784,0,8,3,11,3,2,5,0.00,69.52,45.45
10,007,02,160,0006,0651,382,14,396,598,0,8,3,11,3,2,5,0.00,66.22,45.45
10,007,02,160,0007,0652,710,23,733,1038,0,8,3,11,3,2,5,0.00,70.62,45.45
10,007,02,160,0008,0653,627,38,665,1018,0,8,3,11,3,2,5,0.00,65.32,45.45
10,007,02,160,0009,0654,928,25,953,1396,0,8,3,11,3,2,5,0.00,68.27,45.45
10,007,02,160,0009,0655,808,11,819,1207,0,8,3,11,3,2,5,0.00,67.85,45.45
10,007,02,170,0007,0000,1641,70,1711,2671,0,3,0,3,2,0,2,0.00,64.06,66.67
10,007,02,170,0010,0000,593,19,612,875,0,3,0,3,2,0,2,0.00,69.94,66.67
10,007,02,170,0013,0000,822,32,854,1212,0,3,0,3,2,0,2,0.00,70.46,66.67
10,007,02,170,0016,0000,690,37,727,945,0,3,0,3,2,0,2,0.00,76.93,66.67
10,007,02,170,0007,0826,445,26,471,720,0,3,0,3,2,0,2,0.00,65.42,66.67
10,007,02,170,0007,0827,513,16,529,858,0,3,0,3,2,0,2,0.00,61.66,66.67
10,007,02,170,0007,0828,683,28,711,1093,0,3,0,3,2,0,2,0.00,65.05,66.67
10,007,02,170,0016,0829,690,37,727,945,0,3,0,3,2,0,2,0.00,76.93,66.67
10,007,02,170,0013,0830,822,32,854,1212,0,3,0,3,2,0,2,0.00,70.46,66.67
10,007,02,170,0010,0831,593,19,612,875,0,3,0,3,2,0,2,0.00,69.94,66.67
10,007,02,180,0003,0000,412,7,419,576,0,5,2,7,4,1,5,0.00,72.74,71.43
10,007,02,180,0004,0000,445,3,448,611,0,5,2,7,4,1,5,0.00,73.32,71.43
10,007,02,180,0005,0000,604,29,633,863,0,5,2,7,4,1,5,0.00,73.35,71.43
10,007,02,180,0006,0000,641,26,667,911,0,5,2,7,4,1,5,0.00,73.22,71.43
10,007,02,180,0007,0000,571,17,588,759,0,5,2,7,4,1,5,0.00,77.47,71.43
10,007,02,180,0008,0000,309,3,312,411,0,5,2,7,4,1,5,0.00,75.91,71.43
10,007,02,180,0009,0000,602,24,626,970,0,5,2,7,4,1,5,0.00,64.54,71.43
10,007,02,180,0010,0000,558,12,570,771,0,5,2,7,4,1,5,0.00,73.93,71.43
10,007,02,180,0003,0848,412,7,419,576,0,5,2,7,4,1,5,0.00,72.74,71.43
10,007,02,180,0004,0849,445,3,448,611,0,5,2,7,4,1,5,0.00,73.32,71.43
10,007,02,180,0006,0850,641,26,667,911,0,5,2,7,4,1,5,0.00,73.22,71.43
10,007,02,180,0005,0851,604,29,633,863,0,5,2,7,4,1,5,0.00,73.35,71.43
10,007,02,180,0008,0852,309,3,312,411,0,5,2,7,4,1,5,0.00,75.91,71.43
10,007,02,180,0007,0853,571,17,588,759,0,5,2,7,4,1,5,0.00,77.47,71.43
10,007,02,180,0010,0854,558,12,570,771,0,5,2,7,4,1,5,0.00,73.93,71.43
10,007,02,180,0009,0855,602,24,626,970,0,5,2,7,4,1,5,0.00,64.54,71.43
10,007,02,190,0010,0000,2608,101,2709,4386,0,3,1,4,1,1,2,0.00,61.76,50.00
10,007,02,190,0011,0000,956,57,1013,1678,0,3,1,4,1,1,2,0.00,60.37,50.00
10,007,02,190,0010,0866,614,19,633,1051,0,3,1,4,1,1,2,0.00,60.23,50.00
10,007,02,190,0010,0867,641,34,675,1037,0,3,1,4,1,1,2,0.00,65.09,50.00
10,007,02,190,0010,0868,697,30,727,1157,0,3,1,4,1,1,2,0.00,62.83,50.00
10,007,02,190,0010,0869,656,18,674,1141,0,3,1,4,1,1,2,0.00,59.07,50.00
10,007,02,190,0011,0870,420,26,446,762,0,3,1,4,1,1,2,0.00,58.53,50.00
10,007,02,190,0011,0871,536,31,567,916,0,3,1,4,1,1,2,0.00,61.90,50.00
10,007,02,200,0005,0000,837,21,858,1531,0,4,1,5,2,1,3,0.00,56.04,60.00
10,007,02,200,0006,0000,740,27,767,1275,0,4,1,5,2,1,3,0.00,60.16,60.00
10,007,02,200,0007,0000,585,29,614,999,0,4,1,5,2,1,3,0.00,61.46,60.00
10,007,02,200,0008,0000,555,11,566,916,0,4,1,5,2,1,3,0.00,61.79,60.00
10,007,02,200,0009,0000,645,23,668,1118,0,4,1,5,2,1,3,0.00,59.75,60.00
10,007,02,200,0010,0000,1045,32,1077,1563,0,4,1,5,2,1,3,0.00,68.91,60.00
10,007,02,200,0011,0000,1961,74,2035,3276,0,4,1,5,2,1,3,0.00,62.12,60.00
10,007,02,200,0005,0984,362,9,371,623,0,4,1,5,2,1,3,0.00,59.55,60.00
10,007,02,200,0005,0985,475,12,487,908,0,4,1,5,2,1,3,0.00,53.63,60.00
10,007,02,200,0006,0986,740,27,767,1275,0,4,1,5,2,1,3,0.00,60.16,60.00
10,007,02,200,0007,0987,585,29,614,999,0,4,1,5,2,1,3,0.00,61.46,60.00
10,007,02,200,0008,0988,555,11,566,916,0,4,1,5,2,1,3,0.00,61.79,60.00
10,007,02,200,0009,0989,645,23,668,1118,0,4,1,5,2,1,3,0.00,59.75,60.00
10,007,02,200,0010,0990,530,17,547,755,0,4,1,5,2,1,3,0.00,72.45,60.00
10,007,02,200,0010,0991,515,15,530,808,0,4,1,5,2,1,3,0.00,65.59,60.00
10,007,02,200,0011,0992,530,23,553,942,0,4,1,5,2,1,3,0.00,58.70,60.00
10,007,02,200,0011,0993,646,15,661,1038,0,4,1,5,2,1,3,0.00,63.68,60.00
10,007,02,200,0011,0994,785,36,821,1296,0,4,1,5,2,1,3,0.00,63.35,60.00
10,007,02,210,0002,0000,507,24,531,740,0,1,1,2,1,1,2,0.00,71.76,100.00
10,007,02,210,0017,0000,939,46,985,1518,0,1,1,2,1,1,2,0.00,64.89,100.00
10,007,02,210,0018,0000,164,16,180,247,0,1,1,2,1,1,2,0.00,72.87,100.00
10,007,02,210,0019,0000,380,22,402,588,0,1,1,2,1,1,2,0.00,68.37,100.00
10,007,02,210,0002,0901,507,24,531,740,0,1,1,2,1,1,2,0.00,71.76,100.00
10,007,02,210,0017,0902,386,12,398,609,0,1,1,2,1,1,2,0.00,65.35,100.00
10,007,02,210,0017,0903,553,34,587,909,0,1,1,2,1,1,2,0.00,64.58,100.00
10,007,02,210,0018,0904,164,16,180,247,0,1,1,2,1,1,2,0.00,72.87,100.00
10,007,02,210,0019,0905,380,22,402,588,0,1,1,2,1,1,2,0.00,68.37,100.00
10,007,02,220,0004,0000,1485,87,1572,2154,0,4,2,6,3,2,5,0.00,72.98,83.33
10,007,02,220,0005,0000,748,28,776,1199,0,4,2,6,3,2,5,0.00,64.72,83.33
10,007,02,220,0007,0000,1830,68,1898,3122,0,4,2,6,3,2,5,0.00,60.79,83.33
10,007,02,220,0008,0000,1370,45,1415,2186,0,4,2,6,3,2,5,0.00,64.73,83.33
10,007,02,220,0009,0000,549,31,580,709,0,4,2,6,3,2,5,0.00,81.81,83.33
10,007,02,220,0018,0000,1014,56,1070,1523,0,4,2,6,3,2,5,0.00,70.26,83.33
10,007,02,220,0004,0922,708,36,744,1061,0,4,2,6,3,2,5,0.00,70.12,83.33
10,007,02,220,0004,0923,777,51,828,1093,0,4,2,6,3,2,5,0.00,75.75,83.33
10,007,02,220,0005,0924,748,28,776,1199,0,4,2,6,3,2,5,0.00,64.72,83.33
10,007,02,220,0018,0925,567,27,594,873,0,4,2,6,3,2,5,0.00,68.04,83.33
10,007,02,220,0018,0926,447,29,476,650,0,4,2,6,3,2,5,0.00,73.23,83.33
10,007,02,220,0007,0927,584,15,599,973,0,4,2,6,3,2,5,0.00,61.56,83.33
10,007,02,220,0007,0928,735,34,769,1287,0,4,2,6,3,2,5,0.00,59.75,83.33
10,007,02,220,0007,0929,511,19,530,862,0,4,2,6,3,2,5,0.00,61.48,83.33
10,007,02,220,0008,0930,617,16,633,969,0,4,2,6,3,2,5,0.00,65.33,83.33
10,007,02,220,0008,0931,753,29,782,1217,0,4,2,6,3,2,5,0.00,64.26,83.33
10,007,02,220,0009,0932,549,31,580,709,0,4,2,6,3,2,5,0.00,81.81,83.33
10,007,02,230,0009,0000,369,11,380,599,0,2,0,2,1,0,1,0.00,63.44,50.00
10,007,02,230,0010,0000,561,21,582,768,0,2,0,2,1,0,1,0.00,75.78,50.00
10,007,02,230,0011,0000,627,27,654,942,0,2,0,2,1,0,1,0.00,69.43,50.00
10,007,02,230,0012,0000,376,6,382,535,0,2,0,2,1,0,1,0.00,71.40,50.00
10,007,02,230,0013,0000,376,8,384,523,0,2,0,2,1,0,1,0.00,73.42,50.00
10,007,02,230,0009,1041,369,11,380,599,0,2,0,2,1,0,1,0.00,63.44,50.00
10,007,02,230,0010,1042,561,21,582,768,0,2,0,2,1,0,1,0.00,75.78,50.00
10,007,02,230,0011,1043,627,27,654,942,0,2,0,2,1,0,1,0.00,69.43,50.00
10,007,02,230,0012,1044,376,6,382,535,0,2,0,2,1,0,1,0.00,71.40,50.00
10,007,02,230,0013,1045,376,8,384,523,0,2,0,2,1,0,1,0.00,73.42,50.00
10,007,02,240,0002,0000,617,14,631,998,0,3,2,5,2,2,4,0.00,63.23,80.00
10,007,02,240,0003,0000,829,16,845,1243,0,3,2,5,2,2,4,0.00,67.98,80.00
10,007,02,240,0004,0000,486,23,509,750,0,3,2,5,2,2,4,0.00,67.87,80.00
10,007,02,240,0005,0000,630,15,645,939,0,3,2,5,2,2,4,0.00,68.69,80.00
10,007,02,240,0008,0000,500,21,521,659,0,3,2,5,2,2,4,0.00,79.06,80.00
10,007,02,240,0010,0000,543,27,570,973,0,3,2,5,2,2,4,0.00,58.58,80.00
10,007,02,240,0005,1016,630,15,645,939,0,3,2,5,2,2,4,0.00,68.69,80.00
10,007,02,240,0003,1017,829,16,845,1243,0,3,2,5,2,2,4,0.00,67.98,80.00
10,007,02,240,0004,1018,486,23,509,750,0,3,2,5,2,2,4,0.00,67.87,80.00
10,007,02,240,0002,1019,278,7,285,480,0,3,2,5,2,2,4,0.00,59.38,80.00
10,007,02,240,0002,1020,339,7,346,518,0,3,2,5,2,2,4,0.00,66.80,80.00
10,007,02,240,0008,1021,500,21,521,659,0,3,2,5,2,2,4,0.00,79.06,80.00
10,007,02,240,0010,1022,203,13,216,352,0,3,2,5,2,2,4,0.00,61.36,80.00
10,007,02,240,0010,1023,340,14,354,621,0,3,2,5,2,2,4,0.00,57.00,80.00
10,007,02,250,0004,0000,492,14,506,713,0,3,1,4,2,0,2,0.00,70.97,50.00
10,007,02,250,0005,0000,1117,25,1142,1460,0,3,1,4,2,0,2,0.00,78.22,50.00
10,007,02,250,0004,1071,492,14,506,713,0,3,1,4,2,0,2,0.00,70.97,50.00
10,007,02,250,0005,1072,566,16,582,742,0,3,1,4,2,0,2,0.00,78.44,50.00
10,007,02,250,0005,1073,551,9,560,718,0,3,1,4,2,0,2,0.00,77.99,50.00
10,007,02,260,0002,0000,847,43,890,1401,0,5,0,5,2,0,2,0.00,63.53,40.00
10,007,02,260,0006,0000,819,42,861,1404,0,5,0,5,2,0,2,0.00,61.32,40.00
10,007,02,260,0017,0000,1138,40,1178,1884,0,5,0,5,2,0,2,0.00,62.53,40.00
10,007,02,260,0017,0951,621,24,645,1086,0,5,0,5,2,0,2,0.00,59.39,40.00
10,007,02,260,0017,0952,517,16,533,798,0,5,0,5,2,0,2,0.00,66.79,40.00
10,007,02,260,0002,0953,371,24,395,618,0,5,0,5,2,0,2,0.00,63.92,40.00
10,007,02,260,0002,0954,476,19,495,783,0,5,0,5,2,0,2,0.00,63.22,40.00
10,007,02,260,0006,0955,449,20,469,755,0,5,0,5,2,0,2,0.00,62.12,40.00
10,007,02,260,0006,0956,370,22,392,649,0,5,0,5,2,0,2,0.00,60.40,40.00
10,007,00,030,0000,0000,42792,1805,44597,72540,88706,16,7,23,9,6,15,81.78,61.48,65.22
10,007,01,030,0000,0000,12228,516,12744,21705,27008,4,2,6,3,2,5,80.37,58.71,83.33
10,007,02,030,0000,0000,12279,589,12868,20884,25517,5,2,7,2,2,4,81.84,61.62,57.14
10,007,03,030,0000,0000,11503,441,11944,19254,23459,3,3,6,2,2,4,82.08,62.03,66.67
10,007,04,030,0000,0000,6782,259,7041,10697,12722,4,0,4,2,0,2,84.08,65.82,50.00
10,007,03,010,0001,0000,669,34,703,1190,0,4,3,7,1,3,4,0.00,59.08,57.14
10,007,03,010,0002,0000,2840,148,2988,4814,0,4,3,7,1,3,4,0.00,62.07,57.14
10,007,03,010,0003,0000,881,68,949,1549,0,4,3,7,1,3,4,0.00,61.27,57.14
10,007,03,010,0004,0000,447,28,475,693,0,4,3,7,1,3,4,0.00,68.54,57.14
10,007,03,010,0005,0000,786,48,834,1255,0,4,3,7,1,3,4,0.00,66.45,57.14
10,007,03,010,0006,0000,969,70,1039,1627,0,4,3,7,1,3,4,0.00,63.86,57.14
10,007,03,010,0007,0000,2109,127,2236,3636,0,4,3,7,1,3,4,0.00,61.50,57.14
10,007,03,010,0008,0000,2832,217,3049,5029,0,4,3,7,1,3,4,0.00,60.63,57.14
10,007,03,010,0009,0000,981,62,1043,1643,0,4,3,7,1,3,4,0.00,63.48,57.14
10,007,03,010,0033,0098,655,48,703,1133,0,4,3,7,1,3,4,0.00,62.05,57.14
10,007,03,010,0033,0099,680,52,732,1213,0,4,3,7,1,3,4,0.00,60.35,57.14
10,007,03,010,0010,0000,1013,63,1076,1833,0,4,3,7,1,3,4,0.00,58.70,57.14
10,007,03,010,0014,0100,416,29,445,611,0,4,3,7,1,3,4,0.00,72.83,57.14
10,007,03,010,0013,0101,501,35,536,808,0,4,3,7,1,3,4,0.00,66.34,57.14
10,007,03,010,0015,0102,381,39,420,665,0,4,3,7,1,3,4,0.00,63.16,57.14
10,007,03,010,0012,0103,401,26,427,623,0,4,3,7,1,3,4,0.00,68.54,57.14
10,007,03,010,0012,0104,366,32,398,691,0,4,3,7,1,3,4,0.00,57.60,57.14
10,007,03,010,0011,0105,495,30,525,772,0,4,3,7,1,3,4,0.00,68.01,57.14
10,007,03,010,0010,0106,521,30,551,974,0,4,3,7,1,3,4,0.00,56.57,57.14
10,007,03,010,0010,0107,492,33,525,859,0,4,3,7,1,3,4,0.00,61.12,57.14
10,007,03,010,0008,0108,625,49,674,1135,0,4,3,7,1,3,4,0.00,59.38,57.14
10,007,03,010,0008,0109,553,40,593,892,0,4,3,7,1,3,4,0.00,66.48,57.14
10,007,03,010,0011,0000,495,30,525,772,0,4,3,7,1,3,4,0.00,68.01,57.14
10,007,03,010,0008,0110,523,31,554,912,0,4,3,7,1,3,4,0.00,60.75,57.14
10,007,03,010,0008,0111,615,41,656,1136,0,4,3,7,1,3,4,0.00,57.75,57.14
10,007,03,010,0008,0112,516,56,572,954,0,4,3,7,1,3,4,0.00,59.96,57.14
10,007,03,010,0009,0113,470,37,507,813,0,4,3,7,1,3,4,0.00,62.36,57.14
10,007,03,010,0009,0114,511,25,536,830,0,4,3,7,1,3,4,0.00,64.58,57.14
10,007,03,010,0003,0115,404,37,441,724,0,4,3,7,1,3,4,0.00,60.91,57.14
10,007,03,010,0003,0116,477,31,508,825,0,4,3,7,1,3,4,0.00,61.58,57.14
10,007,03,010,0004,0117,447,28,475,693,0,4,3,7,1,3,4,0.00,68.54,57.14
10,007,03,010,0005,0118,384,24,408,603,0,4,3,7,1,3,4,0.00,67.66,57.14
10,007,03,010,0005,0119,402,24,426,652,0,4,3,7,1,3,4,0.00,65.34,57.14
10,007,03,010,0012,0000,767,58,825,1314,0,4,3,7,1,3,4,0.00,62.79,57.14
10,007,03,010,0001,0120,366,18,384,624,0,4,3,7,1,3,4,0.00,61.54,57.14
10,007,03,010,0001,0121,303,16,319,566,0,4,3,7,1,3,4,0.00,56.36,57.14
10,007,03,010,0006,0122,519,34,553,847,0,4,3,7,1,3,4,0.00,65.29,57.14
10,007,03,010,0006,0123,450,36,486,780,0,4,3,7,1,3,4,0.00,62.31,57.14
10,007,03,010,0007,0124,544,34,578,917,0,4,3,7,1,3,4,0.00,63.03,57.14
10,007,03,010,0007,0125,529,28,557,901,0,4,3,7,1,3,4,0.00,61.82,57.14
10,007,03,010,0007,0126,449,33,482,779,0,4,3,7,1,3,4,0.00,61.87,57.14
10,007,03,010,0007,0127,587,32,619,1039,0,4,3,7,1,3,4,0.00,59.58,57.14
10,007,03,010,0002,0128,624,26,650,1074,0,4,3,7,1,3,4,0.00,60.52,57.14
10,007,03,010,0002,0129,583,28,611,985,0,4,3,7,1,3,4,0.00,62.03,57.14
10,007,03,010,0013,0000,501,35,536,808,0,4,3,7,1,3,4,0.00,66.34,57.14
10,007,03,010,0002,0130,597,30,627,986,0,4,3,7,1,3,4,0.00,63.59,57.14
10,007,03,010,0002,0131,478,33,511,857,0,4,3,7,1,3,4,0.00,59.63,57.14
10,007,03,010,0002,0132,558,31,589,912,0,4,3,7,1,3,4,0.00,64.58,57.14
10,007,03,010,0014,0000,416,29,445,611,0,4,3,7,1,3,4,0.00,72.83,57.14
10,007,03,010,0015,0000,381,39,420,665,0,4,3,7,1,3,4,0.00,63.16,57.14
10,007,03,010,0033,0000,1335,100,1435,2346,0,4,3,7,1,3,4,0.00,61.17,57.14
10,007,03,020,0023,0000,1827,63,1890,3074,0,3,2,5,1,2,3,0.00,61.48,60.00
10,007,03,020,0024,0000,1320,72,1392,2124,0,3,2,5,1,2,3,0.00,65.54,60.00
10,007,03,020,0025,0000,1842,55,1897,2895,0,3,2,5,1,2,3,0.00,65.53,60.00
10,007,03,020,0026,0000,2161,93,2254,3466,0,3,2,5,1,2,3,0.00,65.03,60.00
10,007,03,020,0027,0000,1220,55,1275,2021,0,3,2,5,1,2,3,0.00,63.09,60.00
10,007,03,020,0027,0276,778,38,816,1304,0,3,2,5,1,2,3,0.00,62.58,60.00
10,007,03,020,0027,0277,442,17,459,717,0,3,2,5,1,2,3,0.00,64.02,60.00
10,007,03,020,0026,0278,695,21,716,1087,0,3,2,5,1,2,3,0.00,65.87,60.00
10,007,03,020,0026,0279,730,44,774,1184,0,3,2,5,1,2,3,0.00,65.37,60.00
10,007,03,020,0028,0000,1511,34,1545,2355,0,3,2,5,1,2,3,0.00,65.61,60.00
10,007,03,020,0026,0280,736,28,764,1195,0,3,2,5,1,2,3,0.00,63.93,60.00
10,007,03,020,0028,0281,633,14,647,927,0,3,2,5,1,2,3,0.00,69.80,60.00
10,007,03,020,0028,0282,430,9,439,715,0,3,2,5,1,2,3,0.00,61.40,60.00
10,007,03,020,0028,0283,448,11,459,713,0,3,2,5,1,2,3,0.00,64.38,60.00
10,007,03,020,0023,0284,594,27,621,947,0,3,2,5,1,2,3,0.00,65.58,60.00
10,007,03,020,0023,0285,605,17,622,1005,0,3,2,5,1,2,3,0.00,61.89,60.00
10,007,03,020,0023,0286,628,19,647,1122,0,3,2,5,1,2,3,0.00,57.66,60.00
10,007,03,020,0024,0287,718,37,755,1168,0,3,2,5,1,2,3,0.00,64.64,60.00
10,007,03,020,0024,0288,602,35,637,956,0,3,2,5,1,2,3,0.00,66.63,60.00
10,007,03,020,0025,0289,584,26,610,996,0,3,2,5,1,2,3,0.00,61.24,60.00
10,007,03,020,0025,0290,657,14,671,955,0,3,2,5,1,2,3,0.00,70.26,60.00
10,007,03,020,0025,0291,601,15,616,944,0,3,2,5,1,2,3,0.00,65.25,60.00
10,007,03,030,0017,0000,1541,57,1598,2550,0,3,3,6,2,2,4,0.00,62.67,66.67
10,007,03,030,0019,0000,1915,42,1957,3309,0,3,3,6,2,2,4,0.00,59.14,66.67
10,007,03,030,0020,0000,680,34,714,896,0,3,3,6,2,2,4,0.00,79.69,66.67
10,007,03,030,0021,0000,1530,53,1583,2291,0,3,3,6,2,2,4,0.00,69.10,66.67
10,007,03,030,0022,0000,1395,55,1450,2193,0,3,3,6,2,2,4,0.00,66.12,66.67
10,007,03,030,0023,0000,590,31,621,1064,0,3,3,6,2,2,4,0.00,58.36,66.67
10,007,03,030,0024,0000,1667,59,1726,2745,0,3,3,6,2,2,4,0.00,62.88,66.67
10,007,03,030,0025,0000,2185,110,2295,4206,0,3,3,6,2,2,4,0.00,54.56,66.67
10,007,03,030,0017,0429,802,22,824,1271,0,3,3,6,2,2,4,0.00,64.83,66.67
10,007,03,030,0017,0430,739,35,774,1279,0,3,3,6,2,2,4,0.00,60.52,66.67
10,007,03,030,0019,0431,672,13,685,1090,0,3,3,6,2,2,4,0.00,62.84,66.67
10,007,03,030,0019,0432,620,13,633,1060,0,3,3,6,2,2,4,0.00,59.72,66.67
10,007,03,030,0019,0433,623,16,639,1159,0,3,3,6,2,2,4,0.00,55.13,66.67
10,007,03,030,0020,0434,680,34,714,896,0,3,3,6,2,2,4,0.00,79.69,66.67
10,007,03,030,0021,0435,697,20,717,1072,0,3,3,6,2,2,4,0.00,66.88,66.67
10,007,03,030,0021,0436,833,33,866,1219,0,3,3,6,2,2,4,0.00,71.04,66.67
10,007,03,030,0022,0437,636,30,666,1033,0,3,3,6,2,2,4,0.00,64.47,66.67
10,007,03,030,0022,0438,759,25,784,1160,0,3,3,6,2,2,4,0.00,67.59,66.67
10,007,03,030,0023,0439,590,31,621,1064,0,3,3,6,2,2,4,0.00,58.36,66.67
10,007,03,030,0024,0440,547,13,560,875,0,3,3,6,2,2,4,0.00,64.00,66.67
10,007,03,030,0024,0441,532,23,555,932,0,3,3,6,2,2,4,0.00,59.55,66.67
10,007,03,030,0024,0442,588,23,611,938,0,3,3,6,2,2,4,0.00,65.14,66.67
10,007,03,030,0025,0443,509,22,531,932,0,3,3,6,2,2,4,0.00,56.97,66.67
10,007,03,030,0025,0444,530,34,564,1030,0,3,3,6,2,2,4,0.00,54.76,66.67
10,007,03,030,0025,0445,611,31,642,1162,0,3,3,6,2,2,4,0.00,55.25,66.67
10,007,03,030,0025,0446,535,23,558,1082,0,3,3,6,2,2,4,0.00,51.57,66.67
10,007,03,040,0006,0000,1132,40,1172,1834,0,5,3,8,2,2,4,0.00,63.90,50.00
10,007,03,040,0007,0000,1591,57,1648,2459,0,5,3,8,2,2,4,0.00,67.02,50.00
10,007,03,040,0008,0000,885,41,926,1308,0,5,3,8,2,2,4,0.00,70.80,50.00
10,007,03,040,0006,0494,590,22,612,938,0,5,3,8,2,2,4,0.00,65.25,50.00
10,007,03,040,0006,0495,542,18,560,896,0,5,3,8,2,2,4,0.00,62.50,50.00
10,007,03,040,0007,0496,803,27,830,1195,0,5,3,8,2,2,4,0.00,69.46,50.00
10,007,03,040,0007,0497,788,30,818,1264,0,5,3,8,2,2,4,0.00,64.72,50.00
10,007,03,040,0008,0498,885,41,926,1308,0,5,3,8,2,2,4,0.00,70.80,50.00
10,007,03,050,0001,0000,1086,41,1127,1670,0,5,0,5,3,0,3,0.00,67.49,60.00
10,007,03,050,0002,0000,696,41,737,1121,0,5,0,5,3,0,3,0.00,65.74,60.00
10,007,03,050,0005,0000,1273,54,1327,1916,0,5,0,5,3,0,3,0.00,69.26,60.00
10,007,03,050,0006,0000,833,48,881,1216,0,5,0,5,3,0,3,0.00,72.45,60.00
10,007,03,050,0011,0000,1564,65,1629,2388,0,5,0,5,3,0,3,0.00,68.22,60.00
10,007,03,050,0011,0469,736,19,755,1061,0,5,0,5,3,0,3,0.00,71.16,60.00
10,007,03,050,0011,0470,828,46,874,1327,0,5,0,5,3,0,3,0.00,65.86,60.00
10,007,03,050,0005,0471,721,23,744,1034,0,5,0,5,3,0,3,0.00,71.95,60.00
10,007,03,050,0005,0472,552,31,583,882,0,5,0,5,3,0,3,0.00,66.10,60.00
10,007,03,050,0006,0473,833,48,881,1216,0,5,0,5,3,0,3,0.00,72.45,60.00
10,007,03,050,0001,0474,538,28,566,841,0,5,0,5,3,0,3,0.00,67.30,60.00
10,007,03,050,0001,0475,548,13,561,829,0,5,0,5,3,0,3,0.00,67.67,60.00
10,007,03,050,0002,0476,696,41,737,1121,0,5,0,5,3,0,3,0.00,65.74,60.00
10,007,03,060,0012,0000,801,25,826,1132,0,6,2,8,3,2,5,0.00,72.97,62.50
10,007,03,060,0013,0000,713,22,735,994,0,6,2,8,3,2,5,0.00,73.94,62.50
10,007,03,060,0014,0000,1391,33,1424,2101,0,6,2,8,3,2,5,0.00,67.78,62.50
10,007,03,060,0015,0000,1244,25,1269,1800,0,6,2,8,3,2,5,0.00,70.50,62.50
10,007,03,060,0016,0000,1443,29,1472,2206,0,6,2,8,3,2,5,0.00,66.73,62.50
10,007,03,060,0017,0000,771,16,787,1196,0,6,2,8,3,2,5,0.00,65.80,62.50
10,007,03,060,0018,0000,898,24,922,1223,0,6,2,8,3,2,5,0.00,75.39,62.50
10,007,03,060,0019,0000,2215,53,2268,3522,0,6,2,8,3,2,5,0.00,64.40,62.50
10,007,03,060,0020,0000,1484,31,1515,2482,0,6,2,8,3,2,5,0.00,61.04,62.50
10,007,03,060,0019,0336,736,24,760,1213,0,6,2,8,3,2,5,0.00,62.65,62.50
10,007,03,060,0019,0337,822,20,842,1237,0,6,2,8,3,2,5,0.00,68.07,62.50
10,007,03,060,0019,0338,657,9,666,1072,0,6,2,8,3,2,5,0.00,62.13,62.50
10,007,03,060,0020,0339,640,16,656,1101,0,6,2,8,3,2,5,0.00,59.58,62.50
10,007,03,060,0020,0340,844,15,859,1381,0,6,2,8,3,2,5,0.00,62.20,62.50
10,007,03,060,0012,0341,801,25,826,1132,0,6,2,8,3,2,5,0.00,72.97,62.50
10,007,03,060,0013,0342,713,22,735,994,0,6,2,8,3,2,5,0.00,73.94,62.50
10,007,03,060,0018,0343,898,24,922,1223,0,6,2,8,3,2,5,0.00,75.39,62.50
10,007,03,060,0017,0344,771,16,787,1196,0,6,2,8,3,2,5,0.00,65.80,62.50
10,007,03,060,0016,0345,634,9,643,963,0,6,2,8,3,2,5,0.00,66.77,62.50
10,007,03,060,0016,0346,809,20,829,1243,0,6,2,8,3,2,5,0.00,66.69,62.50
10,007,03,060,0015,0347,595,11,606,856,0,6,2,8,3,2,5,0.00,70.79,62.50
10,007,03,060,0015,0348,649,14,663,944,0,6,2,8,3,2,5,0.00,70.23,62.50
10,007,03,060,0014,0349,692,15,707,1014,0,6,2,8,3,2,5,0.00,69.72,62.50
10,007,03,060,0014,0350,699,18,717,1087,0,6,2,8,3,2,5,0.00,65.96,62.50
10,007,03,070,0010,0000,2583,111,2694,4396,0,3,2,5,2,2,4,0.00,61.28,80.00
10,007,03,070,0011,0000,1218,36,1254,1875,0,3,2,5,2,2,4,0.00,66.88,80.00
10,007,03,070,0012,0000,1157,29,1186,1601,0,3,2,5,2,2,4,0.00,74.08,80.00
10,007,03,070,0013,0000,1058,31,1089,1667,0,3,2,5,2,2,4,0.00,65.33,80.00
10,007,03,070,0014,0000,1323,35,1358,2083,0,3,2,5,2,2,4,0.00,65.19,80.00
10,007,03,070,0010,0375,545,30,575,884,0,3,2,5,2,2,4,0.00,65.05,80.00
10,007,03,070,0010,0376,458,26,484,793,0,3,2,5,2,2,4,0.00,61.03,80.00
10,007,03,070,0010,0377,491,17,508,811,0,3,2,5,2,2,4,0.00,62.64,80.00
10,007,03,070,0010,0378,557,17,574,995,0,3,2,5,2,2,4,0.00,57.69,80.00
10,007,03,070,0010,0379,532,21,553,913,0,3,2,5,2,2,4,0.00,60.57,80.00
10,007,03,070,0011,0380,538,18,556,816,0,3,2,5,2,2,4,0.00,68.14,80.00
10,007,03,070,0011,0381,680,18,698,1059,0,3,2,5,2,2,4,0.00,65.91,80.00
10,007,03,070,0012,0382,609,15,624,847,0,3,2,5,2,2,4,0.00,73.67,80.00
10,007,03,070,0012,0383,548,14,562,754,0,3,2,5,2,2,4,0.00,74.54,80.00
10,007,03,070,0013,0384,506,11,517,777,0,3,2,5,2,2,4,0.00,66.54,80.00
10,007,03,070,0013,0385,552,20,572,890,0,3,2,5,2,2,4,0.00,64.27,80.00
10,007,03,070,0014,0386,428,13,441,651,0,3,2,5,2,2,4,0.00,67.74,80.00
10,007,03,070,0014,0387,412,7,419,621,0,3,2,5,2,2,4,0.00,67.47,80.00
10,007,03,070,0014,0388,483,15,498,811,0,3,2,5,2,2,4,0.00,61.41,80.00
10,007,03,080,0013,0000,1830,65,1895,3153,0,3,2,5,2,1,3,0.00,60.10,60.00
10,007,03,080,0014,0000,582,17,599,831,0,3,2,5,2,1,3,0.00,72.08,60.00
10,007,03,080,0015,0000,577,14,591,879,0,3,2,5,2,1,3,0.00,67.24,60.00
10,007,03,080,0016,0000,1142,33,1175,1856,0,3,2,5,2,1,3,0.00,63.31,60.00
10,007,03,080,0017,0000,1065,28,1093,1815,0,3,2,5,2,1,3,0.00,60.22,60.00
10,007,03,080,0018,0000,976,21,997,1545,0,3,2,5,2,1,3,0.00,64.53,60.00
10,007,03,080,0013,0215,658,18,676,1100,0,3,2,5,2,1,3,0.00,61.45,60.00
10,007,03,080,0013,0216,565,23,588,978,0,3,2,5,2,1,3,0.00,60.12,60.00
10,007,03,080,0013,0217,607,24,631,1075,0,3,2,5,2,1,3,0.00,58.70,60.00
10,007,03,080,0014,0218,582,17,599,831,0,3,2,5,2,1,3,0.00,72.08,60.00
10,007,03,080,0015,0219,577,14,591,879,0,3,2,5,2,1,3,0.00,67.24,60.00
10,007,03,080,0016,0220,604,25,629,951,0,3,2,5,2,1,3,0.00,66.14,60.00
10,007,03,080,0016,0221,538,8,546,905,0,3,2,5,2,1,3,0.00,60.33,60.00
10,007,03,080,0017,0222,613,13,626,949,0,3,2,5,2,1,3,0.00,65.96,60.00
10,007,03,080,0017,0223,452,15,467,866,0,3,2,5,2,1,3,0.00,53.93,60.00
10,007,03,080,0018,0224,551,13,564,862,0,3,2,5,2,1,3,0.00,65.43,60.00
10,007,03,080,0018,0225,425,8,433,683,0,3,2,5,2,1,3,0.00,63.40,60.00
10,007,03,090,0008,0000,760,30,790,1091,0,3,0,3,2,0,2,0.00,72.41,66.67
10,007,03,090,0009,0000,400,16,416,620,0,3,0,3,2,0,2,0.00,67.10,66.67
10,007,03,090,0010,0000,1068,37,1105,1609,0,3,0,3,2,0,2,0.00,68.68,66.67
10,007,03,090,0008,0240,760,30,790,1091,0,3,0,3,2,0,2,0.00,72.41,66.67
10,007,03,090,0009,0241,400,16,416,620,0,3,0,3,2,0,2,0.00,67.10,66.67
10,007,03,090,0010,0242,556,16,572,811,0,3,0,3,2,0,2,0.00,70.53,66.67
10,007,03,090,0010,0243,512,21,533,798,0,3,0,3,2,0,2,0.00,66.79,66.67
10,007,03,100,0003,0000,1672,62,1734,2941,0,7,3,10,3,3,6,0.00,58.96,60.00
10,007,03,100,0004,0000,1378,37,1415,2405,0,7,3,10,3,3,6,0.00,58.84,60.00
10,007,03,100,0005,0000,423,8,431,655,0,7,3,10,3,3,6,0.00,65.80,60.00
10,007,03,100,0006,0000,1559,56,1615,2675,0,7,3,10,3,3,6,0.00,60.37,60.00
10,007,03,100,0007,0000,482,11,493,726,0,7,3,10,3,3,6,0.00,67.91,60.00
10,007,03,100,0008,0000,357,9,366,546,0,7,3,10,3,3,6,0.00,67.03,60.00
10,007,03,100,0017,0000,1682,55,1737,2639,0,7,3,10,3,3,6,0.00,65.82,60.00
10,007,03,100,0018,0000,3454,96,3550,5895,0,7,3,10,3,3,6,0.00,60.22,60.00
10,007,03,100,0019,0000,1844,37,1881,2826,0,7,3,10,3,3,6,0.00,66.56,60.00
10,007,03,100,0037,0000,1717,46,1763,2867,0,7,3,10,3,3,6,0.00,61.49,60.00
10,007,03,100,0038,0000,1340,38,1378,2166,0,7,3,10,3,3,6,0.00,63.62,60.00
10,007,03,100,0039,0000,1527,32,1559,2460,0,7,3,10,3,3,6,0.00,63.37,60.00
10,007,03,100,0040,0000,837,16,853,1268,0,7,3,10,3,3,6,0.00,67.27,60.00
10,007,03,100,0041,0000,1163,47,1210,2113,0,7,3,10,3,3,6,0.00,57.26,60.00
10,007,03,100,0003,0546,451,19,470,788,0,7,3,10,3,3,6,0.00,59.64,60.00
10,007,03,100,0003,0547,626,26,652,1112,0,7,3,10,3,3,6,0.00,58.63,60.00
10,007,03,100,0003,0548,595,17,612,1041,0,7,3,10,3,3,6,0.00,58.79,60.00
10,007,03,100,0004,0549,448,12,460,791,0,7,3,10,3,3,6,0.00,58.15,60.00
10,007,03,100,0004,0550,479,13,492,839,0,7,3,10,3,3,6,0.00,58.64,60.00
10,007,03,100,0004,0551,451,12,463,775,0,7,3,10,3,3,6,0.00,59.74,60.00
10,007,03,100,0005,0552,423,8,431,655,0,7,3,10,3,3,6,0.00,65.80,60.00
10,007,03,100,0006,0553,471,19,490,818,0,7,3,10,3,3,6,0.00,59.90,60.00
10,007,03,100,0006,0554,491,21,512,846,0,7,3,10,3,3,6,0.00,60.52,60.00
10,007,03,100,0006,0555,597,16,613,1011,0,7,3,10,3,3,6,0.00,60.63,60.00
10,007,03,100,0007,0556,482,11,493,726,0,7,3,10,3,3,6,0.00,67.91,60.00
10,007,03,100,0008,0557,357,9,366,546,0,7,3,10,3,3,6,0.00,67.03,60.00
10,007,03,100,0017,0558,807,23,830,1263,0,7,3,10,3,3,6,0.00,65.72,60.00
10,007,03,100,0017,0559,875,32,907,1376,0,7,3,10,3,3,6,0.00,65.92,60.00
10,007,03,100,0041,0560,686,24,710,1249,0,7,3,10,3,3,6,0.00,56.85,60.00
10,007,03,100,0041,0561,477,23,500,864,0,7,3,10,3,3,6,0.00,57.87,60.00
10,007,03,100,0040,0562,469,2,471,681,0,7,3,10,3,3,6,0.00,69.16,60.00
10,007,03,100,0040,0563,368,14,382,587,0,7,3,10,3,3,6,0.00,65.08,60.00
10,007,03,100,0018,0564,682,19,701,1072,0,7,3,10,3,3,6,0.00,65.39,60.00
10,007,03,100,0018,0565,463,11,474,807,0,7,3,10,3,3,6,0.00,58.74,60.00
10,007,03,100,0018,0566,646,25,671,1107,0,7,3,10,3,3,6,0.00,60.61,60.00
10,007,03,100,0018,0567,591,19,610,1145,0,7,3,10,3,3,6,0.00,53.28,60.00
10,007,03,100,0018,0568,566,14,580,918,0,7,3,10,3,3,6,0.00,63.18,60.00
10,007,03,100,0018,0569,506,8,514,846,0,7,3,10,3,3,6,0.00,60.76,60.00
10,007,03,100,0019,0570,597,13,610,907,0,7,3,10,3,3,6,0.00,67.25,60.00
10,007,03,100,0019,0571,643,16,659,996,0,7,3,10,3,3,6,0.00,66.16,60.00
10,007,03,100,0019,0572,604,8,612,923,0,7,3,10,3,3,6,0.00,66.31,60.00
10,007,03,100,0037,0573,517,8,525,903,0,7,3,10,3,3,6,0.00,58.14,60.00
10,007,03,100,0037,0574,502,19,521,813,0,7,3,10,3,3,6,0.00,64.08,60.00
10,007,03,100,0037,0575,698,19,717,1151,0,7,3,10,3,3,6,0.00,62.29,60.00
10,007,03,100,0038,0576,713,17,730,1168,0,7,3,10,3,3,6,0.00,62.50,60.00
10,007,03,100,0038,0577,627,21,648,998,0,7,3,10,3,3,6,0.00,64.93,60.00
10,007,03,100,0039,0578,742,15,757,1258,0,7,3,10,3,3,6,0.00,60.17,60.00
10,007,03,100,0039,0579,785,17,802,1202,0,7,3,10,3,3,6,0.00,66.72,60.00
10,007,03,110,0016,0000,873,51,924,1297,0,4,1,5,2,1,3,0.00,71.24,60.00
10,007,03,110,0019,0000,391,18,409,643,0,4,1,5,2,1,3,0.00,63.61,60.00
10,007,03,110,0020,0000,767,32,799,1200,0,4,1,5,2,1,3,0.00,66.58,60.00
10,007,03,110,0021,0000,479,20,499,663,0,4,1,5,2,1,3,0.00,75.26,60.00
10,007,03,110,0022,0000,818,21,839,1293,0,4,1,5,2,1,3,0.00,64.89,60.00
10,007,03,110,0023,0000,720,24,744,1214,0,4,1,5,2,1,3,0.00,61.29,60.00
10,007,03,110,0024,0000,1240,29,1269,2098,0,4,1,5,2,1,3,0.00,60.49,60.00
10,007,03,110,0025,0000,1127,33,1160,1700,0,4,1,5,2,1,3,0.00,68.24,60.00
10,007,03,110,0019,0698,391,18,409,643,0,4,1,5,2,1,3,0.00,63.61,60.00
10,007,03,110,0020,0699,767,32,799,1200,0,4,1,5,2,1,3,0.00,66.58,60.00
10,007,03,110,0021,0700,479,20,499,663,0,4,1,5,2,1,3,0.00,75.26,60.00
10,007,03,110,0022,0701,818,21,839,1293,0,4,1,5,2,1,3,0.00,64.89,60.00
10,007,03,110,0023,0702,720,24,744,1214,0,4,1,5,2,1,3,0.00,61.29,60.00
10,007,03,110,0025,0703,644,18,662,933,0,4,1,5,2,1,3,0.00,70.95,60.00
10,007,03,110,0025,0704,483,15,498,767,0,4,1,5,2,1,3,0.00,64.93,60.00
10,007,03,110,0024,0705,605,12,617,1024,0,4,1,5,2,1,3,0.00,60.25,60.00
10,007,03,110,0024,0706,635,17,652,1074,0,4,1,5,2,1,3,0.00,60.71,60.00
10,007,03,110,0016,0707,873,51,924,1297,0,4,1,5,2,1,3,0.00,71.24,60.00
10,007,03,120,0015,0000,966,25,991,1489,0,4,1,5,3,1,4,0.00,66.55,80.00
10,007,03,120,0016,0000,833,23,856,1255,0,4,1,5,3,1,4,0.00,68.21,80.00
10,007,03,120,0017,0000,1113,44,1157,1792,0,4,1,5,3,1,4,0.00,64.56,80.00
10,007,03,120,0018,0000,2519,76,2595,4064,0,4,1,5,3,1,4,0.00,63.85,80.00
10,007,03,120,0020,0000,866,41,907,1506,0,4,1,5,3,1,4,0.00,60.23,80.00
10,007,03,120,0021,0000,533,22,555,868,0,4,1,5,3,1,4,0.00,63.94,80.00
10,007,03,120,0022,0000,540,24,564,821,0,4,1,5,3,1,4,0.00,68.70,80.00
10,007,03,120,0015,0793,517,10,527,777,0,4,1,5,3,1,4,0.00,67.82,80.00
10,007,03,120,0015,0794,449,15,464,712,0,4,1,5,3,1,4,0.00,65.17,80.00
10,007,03,120,0016,0795,833,23,856,1255,0,4,1,5,3,1,4,0.00,68.21,80.00
10,007,03,120,0017,0796,533,20,553,835,0,4,1,5,3,1,4,0.00,66.23,80.00
10,007,03,120,0017,0797,580,24,604,957,0,4,1,5,3,1,4,0.00,63.11,80.00
10,007,03,120,0018,0798,649,16,665,1037,0,4,1,5,3,1,4,0.00,64.13,80.00
10,007,03,120,0018,0799,600,15,615,965,0,4,1,5,3,1,4,0.00,63.73,80.00
10,007,03,120,0018,0800,659,19,678,1034,0,4,1,5,3,1,4,0.00,65.57,80.00
10,007,03,120,0018,0801,611,26,637,1028,0,4,1,5,3,1,4,0.00,61.96,80.00
10,007,03,120,0020,0802,421,21,442,738,0,4,1,5,3,1,4,0.00,59.89,80.00
10,007,03,120,0020,0803,445,20,465,768,0,4,1,5,3,1,4,0.00,60.55,80.00
10,007,03,120,0021,0804,533,22,555,868,0,4,1,5,3,1,4,0.00,63.94,80.00
10,007,03,120,0022,0805,540,24,564,821,0,4,1,5,3,1,4,0.00,68.70,80.00
10,007,03,130,0006,0000,1892,78,1970,3144,0,2,2,4,1,2,3,0.00,62.66,75.00
10,007,03,130,0011,0000,904,35,939,1450,0,2,2,4,1,2,3,0.00,64.76,75.00
10,007,03,130,0014,0000,1723,48,1771,2628,0,2,2,4,1,2,3,0.00,67.39,75.00
10,007,03,130,0014,0616,808,25,833,1364,0,2,2,4,1,2,3,0.00,61.07,75.00
10,007,03,130,0014,0617,915,23,938,1264,0,2,2,4,1,2,3,0.00,74.21,75.00
10,007,03,130,0006,0618,725,16,741,1127,0,2,2,4,1,2,3,0.00,65.75,75.00
10,007,03,130,0006,0619,571,21,592,889,0,2,2,4,1,2,3,0.00,66.59,75.00
10,007,03,130,0006,0620,596,41,637,1128,0,2,2,4,1,2,3,0.00,56.47,75.00
10,007,03,130,0011,0621,904,35,939,1450,0,2,2,4,1,2,3,0.00,64.76,75.00
10,007,03,140,0017,0000,932,20,952,1370,0,5,0,5,3,0,3,0.00,69.49,60.00
10,007,03,140,0018,0000,592,23,615,803,0,5,0,5,3,0,3,0.00,76.59,60.00
10,007,03,140,0019,0000,995,23,1018,1481,0,5,0,5,3,0,3,0.00,68.74,60.00
10,007,03,140,0020,0000,920,30,950,1447,0,5,0,5,3,0,3,0.00,65.65,60.00
10,007,03,140,0021,0000,884,23,907,1312,0,5,0,5,3,0,3,0.00,69.13,60.00
10,007,03,140,0022,0000,747,36,783,1273,0,5,0,5,3,0,3,0.00,61.51,60.00
10,007,03,140,0017,0729,483,11,494,709,0,5,0,5,3,0,3,0.00,69.68,60.00
10,007,03,140,0017,0730,449,9,458,661,0,5,0,5,3,0,3,0.00,69.29,60.00
10,007,03,140,0018,0731,592,23,615,803,0,5,0,5,3,0,3,0.00,76.59,60.00
10,007,03,140,0019,0732,513,8,521,778,0,5,0,5,3,0,3,0.00,66.97,60.00
10,007,03,140,0019,0733,482,15,497,703,0,5,0,5,3,0,3,0.00,70.70,60.00
10,007,03,140,0020,0734,446,12,458,689,0,5,0,5,3,0,3,0.00,66.47,60.00
10,007,03,140,0020,0735,474,18,492,758,0,5,0,5,3,0,3,0.00,64.91,60.00
10,007,03,140,0021,0736,467,13,480,673,0,5,0,5,3,0,3,0.00,71.32,60.00
10,007,03,140,0021,0737,417,10,427,639,0,5,0,5,3,0,3,0.00,66.82,60.00
10,007,03,140,0022,0738,747,36,783,1273,0,5,0,5,3,0,3,0.00,61.51,60.00
10,007,03,150,0017,0000,1000,23,1023,1389,0,2,0,2,1,0,1,0.00,73.65,50.00
10,007,03,150,0018,0000,516,12,528,860,0,2,0,2,1,0,1,0.00,61.40,50.00
10,007,03,150,0019,0000,497,10,507,696,0,2,0,2,1,0,1,0.00,72.84,50.00
10,007,03,150,0020,0000,561,17,578,882,0,2,0,2,1,0,1,0.00,65.53,50.00
10,007,03,150,0018,0766,516,12,528,860,0,2,0,2,1,0,1,0.00,61.40,50.00
10,007,03,150,0017,0767,1000,23,1023,1389,0,2,0,2,1,0,1,0.00,73.65,50.00
10,007,03,150,0019,0768,497,10,507,696,0,2,0,2,1,0,1,0.00,72.84,50.00
10,007,03,150,0020,0769,561,17,578,882,0,2,0,2,1,0,1,0.00,65.53,50.00
10,007,03,160,0016,0000,563,15,578,792,0,8,0,8,3,0,3,0.00,72.98,37.50
10,007,03,160,0017,0000,465,29,494,674,0,8,0,8,3,0,3,0.00,73.29,37.50
10,007,03,160,0018,0000,536,26,562,729,0,8,0,8,3,0,3,0.00,77.09,37.50
10,007,03,160,0019,0000,438,17,455,650,0,8,0,8,3,0,3,0.00,70.00,37.50
10,007,03,160,0020,0000,551,18,569,813,0,8,0,8,3,0,3,0.00,69.99,37.50
10,007,03,160,0021,0000,494,21,515,775,0,8,0,8,3,0,3,0.00,66.45,37.50
10,007,03,160,0022,0000,375,24,399,594,0,8,0,8,3,0,3,0.00,67.17,37.50
10,007,03,160,0023,0000,692,27,719,1028,0,8,0,8,3,0,3,0.00,69.94,37.50
10,007,03,160,0024,0000,800,36,836,1229,0,8,0,8,3,0,3,0.00,68.02,37.50
10,007,03,160,0016,0656,563,15,578,792,0,8,0,8,3,0,3,0.00,72.98,37.50
10,007,03,160,0017,0657,465,29,494,674,0,8,0,8,3,0,3,0.00,73.29,37.50
10,007,03,160,0018,0658,536,26,562,729,0,8,0,8,3,0,3,0.00,77.09,37.50
10,007,03,160,0019,0659,438,17,455,650,0,8,0,8,3,0,3,0.00,70.00,37.50
10,007,03,160,0020,0660,551,18,569,813,0,8,0,8,3,0,3,0.00,69.99,37.50
10,007,03,160,0021,0661,494,21,515,775,0,8,0,8,3,0,3,0.00,66.45,37.50
10,007,03,160,0022,0662,375,24,399,594,0,8,0,8,3,0,3,0.00,67.17,37.50
10,007,03,160,0023,0663,692,27,719,1028,0,8,0,8,3,0,3,0.00,69.94,37.50
10,007,03,160,0024,0664,800,36,836,1229,0,8,0,8,3,0,3,0.00,68.02,37.50
10,007,03,170,0003,0000,672,41,713,1102,0,2,0,2,1,0,1,0.00,64.70,50.00
10,007,03,170,0020,0000,677,32,709,934,0,2,0,2,1,0,1,0.00,75.91,50.00
10,007,03,170,0023,0000,868,34,902,1212,0,2,0,2,1,0,1,0.00,74.42,50.00
10,007,03,170,0023,0832,868,34,902,1212,0,2,0,2,1,0,1,0.00,74.42,50.00
10,007,03,170,0003,0833,672,41,713,1102,0,2,0,2,1,0,1,0.00,64.70,50.00
10,007,03,170,0020,0834,677,32,709,934,0,2,0,2,1,0,1,0.00,75.91,50.00
10,007,03,180,0011,0000,508,26,534,748,0,3,0,3,3,0,3,0.00,71.39,100.00
10,007,03,180,0012,0000,497,28,525,755,0,3,0,3,3,0,3,0.00,69.54,100.00
10,007,03,180,0013,0000,394,30,424,639,0,3,0,3,3,0,3,0.00,66.35,100.00
10,007,03,180,0014,0000,400,32,432,581,0,3,0,3,3,0,3,0.00,74.35,100.00
10,007,03,180,0015,0000,381,15,396,540,0,3,0,3,3,0,3,0.00,73.33,100.00
10,007,03,180,0011,0856,508,26,534,748,0,3,0,3,3,0,3,0.00,71.39,100.00
10,007,03,180,0012,0857,497,28,525,755,0,3,0,3,3,0,3,0.00,69.54,100.00
10,007,03,180,0013,0858,394,30,424,639,0,3,0,3,3,0,3,0.00,66.35,100.00
10,007,03,180,0014,0859,400,32,432,581,0,3,0,3,3,0,3,0.00,74.35,100.00
10,007,03,180,0015,0860,381,15,396,540,0,3,0,3,3,0,3,0.00,73.33,100.00
10,007,03,190,0001,0000,1047,39,1086,1722,0,5,1,6,4,1,5,0.00,63.07,83.33
10,007,03,190,0002,0000,419,24,443,740,0,5,1,6,4,1,5,0.00,59.86,83.33
10,007,03,190,0003,0000,325,15,340,518,0,5,1,6,4,1,5,0.00,65.64,83.33
10,007,03,190,0004,0000,378,17,395,620,0,5,1,6,4,1,5,0.00,63.71,83.33
10,007,03,190,0005,0000,815,37,852,1349,0,5,1,6,4,1,5,0.00,63.16,83.33
10,007,03,190,0006,0000,799,31,830,1212,0,5,1,6,4,1,5,0.00,68.48,83.33
10,007,03,190,0007,0000,1263,67,1330,2224,0,5,1,6,4,1,5,0.00,59.80,83.33
10,007,03,190,0008,0000,1872,56,1928,3070,0,5,1,6,4,1,5,0.00,62.80,83.33
10,007,03,190,0001,0872,483,18,501,776,0,5,1,6,4,1,5,0.00,64.56,83.33
10,007,03,190,0001,0873,564,21,585,946,0,5,1,6,4,1,5,0.00,61.84,83.33
10,007,03,190,0002,0874,419,24,443,740,0,5,1,6,4,1,5,0.00,59.86,83.33
10,007,03,190,0003,0875,325,15,340,518,0,5,1,6,4,1,5,0.00,65.64,83.33
10,007,03,190,0004,0876,378,17,395,620,0,5,1,6,4,1,5,0.00,63.71,83.33
10,007,03,190,0005,0877,379,20,399,625,0,5,1,6,4,1,5,0.00,63.84,83.33
10,007,03,190,0005,0878,436,17,453,724,0,5,1,6,4,1,5,0.00,62.57,83.33
10,007,03,190,0006,0879,386,13,399,599,0,5,1,6,4,1,5,0.00,66.61,83.33
10,007,03,190,0006,0880,413,18,431,613,0,5,1,6,4,1,5,0.00,70.31,83.33
10,007,03,190,0007,0881,657,31,688,1120,0,5,1,6,4,1,5,0.00,61.43,83.33
10,007,03,190,0007,0882,606,36,642,1104,0,5,1,6,4,1,5,0.00,58.15,83.33
10,007,03,190,0008,0883,609,18,627,957,0,5,1,6,4,1,5,0.00,65.52,83.33
10,007,03,190,0008,0884,646,15,661,1060,0,5,1,6,4,1,5,0.00,62.36,83.33
10,007,03,190,0008,0885,617,23,640,1053,0,5,1,6,4,1,5,0.00,60.78,83.33
10,007,03,200,0013,0000,635,47,682,1236,0,4,1,5,3,0,3,0.00,55.18,60.00
10,007,03,200,0014,0000,956,38,994,1479,0,4,1,5,3,0,3,0.00,67.21,60.00
10,007,03,200,0015,0000,780,22,802,1111,0,4,1,5,3,0,3,0.00,72.19,60.00
10,007,03,200,0016,0000,487,17,504,734,0,4,1,5,3,0,3,0.00,68.66,60.00
10,007,03,200,0017,0000,907,26,933,1432,0,4,1,5,3,0,3,0.00,65.15,60.00
10,007,03,200,0018,0000,775,37,812,1214,0,4,1,5,3,0,3,0.00,66.89,60.00
10,007,03,200,0019,0000,754,20,774,1070,0,4,1,5,3,0,3,0.00,72.34,60.00
10,007,03,200,0020,0000,2001,56,2057,3395,0,4,1,5,3,0,3,0.00,60.59,60.00
10,007,03,200,0022,0000,717,46,763,1050,0,4,1,5,3,0,3,0.00,72.67,60.00
10,007,03,200,0013,0995,635,47,682,1236,0,4,1,5,3,0,3,0.00,55.18,60.00
10,007,03,200,0014,0996,469,23,492,688,0,4,1,5,3,0,3,0.00,71.51,60.00
10,007,03,200,0014,0997,487,15,502,791,0,4,1,5,3,0,3,0.00,63.46,60.00
10,007,03,200,0015,0998,780,22,802,1111,0,4,1,5,3,0,3,0.00,72.19,60.00
10,007,03,200,0016,0999,487,17,504,734,0,4,1,5,3,0,3,0.00,68.66,60.00
10,007,03,200,0017,1000,512,12,524,814,0,4,1,5,3,0,3,0.00,64.37,60.00
10,007,03,200,0017,1001,395,14,409,618,0,4,1,5,3,0,3,0.00,66.18,60.00
10,007,03,200,0018,1002,775,37,812,1214,0,4,1,5,3,0,3,0.00,66.89,60.00
10,007,03,200,0019,1003,754,20,774,1070,0,4,1,5,3,0,3,0.00,72.34,60.00
10,007,03,200,0020,1004,639,23,662,1130,0,4,1,5,3,0,3,0.00,58.58,60.00
10,007,03,200,0020,1005,731,18,749,1264,0,4,1,5,3,0,3,0.00,59.26,60.00
10,007,03,200,0020,1006,631,15,646,1001,0,4,1,5,3,0,3,0.00,64.54,60.00
10,007,03,200,0022,1007,717,46,763,1050,0,4,1,5,3,0,3,0.00,72.67,60.00
10,007,03,210,0014,0000,474,106,580,916,0,1,0,1,1,0,1,0.00,63.32,100.00
10,007,03,210,0015,0000,521,143,664,859,0,1,0,1,1,0,1,0.00,77.30,100.00
10,007,03,210,0016,0000,635,124,759,1301,0,1,0,1,1,0,1,0.00,58.34,100.00
10,007,03,210,0014,0906,474,106,580,916,0,1,0,1,1,0,1,0.00,63.32,100.00
10,007,03,210,0015,0907,521,143,664,859,0,1,0,1,1,0,1,0.00,77.30,100.00
10,007,03,210,0016,0908,399,45,444,762,0,1,0,1,1,0,1,0.00,58.27,100.00
10,007,03,210,0016,0909,236,79,315,539,0,1,0,1,1,0,1,0.00,58.44,100.00
10,007,03,220,0010,0000,383,17,400,537,0,1,1,2,1,0,1,0.00,74.49,50.00
10,007,03,220,0011,0000,984,36,1020,1394,0,1,1,2,1,0,1,0.00,73.17,50.00
10,007,03,220,0012,0000,623,29,652,955,0,1,1,2,1,0,1,0.00,68.27,50.00
10,007,03,220,0010,0933,383,17,400,537,0,1,1,2,1,0,1,0.00,74.49,50.00
10,007,03,220,0011,0934,497,13,510,702,0,1,1,2,1,0,1,0.00,72.65,50.00
10,007,03,220,0011,0935,487,23,510,692,0,1,1,2,1,0,1,0.00,73.70,50.00
10,007,03,220,0012,0936,623,29,652,955,0,1,1,2,1,0,1,0.00,68.27,50.00
10,007,03,230,0008,0000,307,25,332,460,0,3,0,3,3,0,3,0.00,72.17,100.00
10,007,03,230,0015,0000,1166,150,1316,2020,0,3,0,3,3,0,3,0.00,65.15,100.00
10,007,03,230,0016,0000,417,47,464,642,0,3,0,3,3,0,3,0.00,72.27,100.00
10,007,03,230,0017,0000,342,60,402,698,0,3,0,3,3,0,3,0.00,57.59,100.00
10,007,03,230,0018,0000,342,47,389,627,0,3,0,3,3,0,3,0.00,62.04,100.00
10,007,03,230,0019,0000,769,58,827,1232,0,3,0,3,3,0,3,0.00,67.13,100.00
10,007,03,230,0020,0000,829,103,932,1553,0,3,0,3,3,0,3,0.00,60.01,100.00
10,007,03,230,0015,1046,588,72,660,1015,0,3,0,3,3,0,3,0.00,65.02,100.00
10,007,03,230,0015,1047,578,78,656,1005,0,3,0,3,3,0,3,0.00,65.27,100.00
10,007,03,230,0016,1048,417,47,464,642,0,3,0,3,3,0,3,0.00,72.27,100.00
10,007,03,230,0017,1049,342,60,402,698,0,3,0,3,3,0,3,0.00,57.59,100.00
10,007,03,230,0019,1050,355,28,383,552,0,3,0,3,3,0,3,0.00,69.38,100.00
10,007,03,230,0019,1051,414,30,444,680,0,3,0,3,3,0,3,0.00,65.29,100.00
10,007,03,230,0018,1052,342,47,389,627,0,3,0,3,3,0,3,0.00,62.04,100.00
10,007,03,230,0020,1053,402,52,454,827,0,3,0,3,3,0,3,0.00,54.90,100.00
10,007,03,230,0020,1054,427,51,478,726,0,3,0,3,3,0,3,0.00,65.84,100.00
10,007,03,230,0008,1055,307,25,332,460,0,3,0,3,3,0,3,0.00,72.17,100.00
10,007,03,240,0006,0000,645,52,697,998,0,2,0,2,2,0,2,0.00,69.84,100.00
10,007,03,240,0014,0000,430,53,483,803,0,2,0,2,2,0,2,0.00,60.15,100.00
10,007,03,240,0015,0000,310,51,361,583,0,2,0,2,2,0,2,0.00,61.92,100.00
10,007,03,240,0014,1024,430,53,483,803,0,2,0,2,2,0,2,0.00,60.15,100.00
10,007,03,240,0015,1025,310,51,361,583,0,2,0,2,2,0,2,0.00,61.92,100.00
10,007,03,240,0006,1026,645,52,697,998,0,2,0,2,2,0,2,0.00,69.84,100.00
10,007,03,250,0006,0000,448,48,496,627,0,2,1,3,2,1,3,0.00,79.11,100.00
10,007,03,250,0007,0000,634,51,685,1019,0,2,1,3,2,1,3,0.00,67.22,100.00
10,007,03,250,0008,0000,552,26,578,1030,0,2,1,3,2,1,3,0.00,56.12,100.00
10,007,03,250,0006,1074,448,48,496,627,0,2,1,3,2,1,3,0.00,79.11,100.00
10,007,03,250,0007,1075,634,51,685,1019,0,2,1,3,2,1,3,0.00,67.22,100.00
10,007,03,250,0008,1076,552,26,578,1030,0,2,1,3,2,1,3,0.00,56.12,100.00
10,007,03,260,0003,0000,611,25,636,1068,0,4,1,5,3,1,4,0.00,59.55,80.00
10,007,03,260,0007,0000,557,22,579,800,0,4,1,5,3,1,4,0.00,72.38,80.00
10,007,03,260,0009,0000,1233,57,1290,1902,0,4,1,5,3,1,4,0.00,67.82,80.00
10,007,03,260,0010,0000,417,16,433,645,0,4,1,5,3,1,4,0.00,67.13,80.00
10,007,03,260,0012,0000,1108,36,1144,1736,0,4,1,5,3,1,4,0.00,65.90,80.00
10,007,03,260,0015,0000,1014,43,1057,1793,0,4,1,5,3,1,4,0.00,58.95,80.00
10,007,03,260,0018,0000,529,30,559,816,0,4,1,5,3,1,4,0.00,68.50,80.00
10,007,03,260,0009,0957,695,32,727,1022,0,4,1,5,3,1,4,0.00,71.14,80.00
10,007,03,260,0009,0958,538,25,563,880,0,4,1,5,3,1,4,0.00,63.98,80.00
10,007,03,260,0003,0959,611,25,636,1068,0,4,1,5,3,1,4,0.00,59.55,80.00
10,007,03,260,0012,0960,586,16,602,908,0,4,1,5,3,1,4,0.00,66.30,80.00
10,007,03,260,0012,0961,522,20,542,828,0,4,1,5,3,1,4,0.00,65.46,80.00
10,007,03,260,0015,0962,476,21,497,820,0,4,1,5,3,1,4,0.00,60.61,80.00
10,007,03,260,0015,0963,538,22,560,973,0,4,1,5,3,1,4,0.00,57.55,80.00
10,007,03,260,0018,0964,529,30,559,816,0,4,1,5,3,1,4,0.00,68.50,80.00
10,007,03,260,0007,0965,557,22,579,800,0,4,1,5,3,1,4,0.00,72.38,80.00
10,007,03,260,0010,0966,417,16,433,645,0,4,1,5,3,1,4,0.00,67.13,80.00
10,007,00,040,0000,0000,8996,282,9278,13563,16315,13,5,18,7,4,11,83.13,68.41,61.11
10,007,01,040,0000,0000,3734,107,3841,5588,6840,5,2,7,3,2,5,81.70,68.74,71.43
10,007,02,040,0000,0000,1654,37,1691,2374,2846,3,0,3,2,0,2,83.42,71.23,66.67
10,007,03,040,0000,0000,3608,138,3746,5601,6629,5,3,8,2,2,4,84.49,66.88,50.00
10,007,04,010,0060,0133,533,28,561,892,0,8,3,11,6,1,7,0.00,62.89,63.64
10,007,04,010,0061,0134,569,26,595,881,0,8,3,11,6,1,7,0.00,67.54,63.64
10,007,04,010,0061,0135,610,28,638,927,0,8,3,11,6,1,7,0.00,68.82,63.64
10,007,04,010,0061,0136,569,23,592,974,0,8,3,11,6,1,7,0.00,60.78,63.64
10,007,04,010,0059,0137,808,41,849,1182,0,8,3,11,6,1,7,0.00,71.83,63.64
10,007,04,010,0063,0138,510,17,527,750,0,8,3,11,6,1,7,0.00,70.27,63.64
10,007,04,010,0063,0139,516,15,531,854,0,8,3,11,6,1,7,0.00,62.18,63.64
10,007,04,010,0063,0140,435,12,447,667,0,8,3,11,6,1,7,0.00,67.02,63.64
10,007,04,010,0062,0141,697,30,727,1123,0,8,3,11,6,1,7,0.00,64.74,63.64
10,007,04,010,0062,0142,701,39,740,1252,0,8,3,11,6,1,7,0.00,59.11,63.64
10,007,04,010,0062,0143,639,42,681,1143,0,8,3,11,6,1,7,0.00,59.58,63.64
10,007,04,010,0062,0144,658,37,695,1081,0,8,3,11,6,1,7,0.00,64.29,63.64
10,007,04,010,0062,0145,642,38,680,1220,0,8,3,11,6,1,7,0.00,55.74,63.64
10,007,04,010,0062,0146,600,26,626,1108,0,8,3,11,6,1,7,0.00,56.50,63.64
10,007,04,010,0062,0147,703,34,737,1164,0,8,3,11,6,1,7,0.00,63.32,63.64
10,007,04,010,0065,0148,508,21,529,802,0,8,3,11,6,1,7,0.00,65.96,63.64
10,007,04,010,0065,0149,449,21,470,809,0,8,3,11,6,1,7,0.00,58.10,63.64
10,007,04,010,0065,0150,534,29,563,904,0,8,3,11,6,1,7,0.00,62.28,63.64
10,007,04,010,0064,0151,517,44,561,912,0,8,3,11,6,1,7,0.00,61.51,63.64
10,007,04,010,0064,0152,508,38,546,900,0,8,3,11,6,1,7,0.00,60.67,63.64
10,007,04,010,0064,0153,540,41,581,1062,0,8,3,11,6,1,7,0.00,54.71,63.64
10,007,04,010,0064,0154,576,46,622,1042,0,8,3,11,6,1,7,0.00,59.69,63.64
10,007,04,010,0056,0155,670,25,695,1269,0,8,3,11,6,1,7,0.00,54.77,63.64
10,007,04,010,0056,0156,606,37,643,1048,0,8,3,11,6,1,7,0.00,61.35,63.64
10,007,04,010,0051,0157,462,18,480,767,0,8,3,11,6,1,7,0.00,62.58,63.64
10,007,04,010,0051,0158,496,22,518,829,0,8,3,11,6,1,7,0.00,62.48,63.64
10,007,04,010,0053,0159,663,24,687,938,0,8,3,11,6,1,7,0.00,73.24,63.64
10,007,04,010,0053,0160,780,18,798,1129,0,8,3,11,6,1,7,0.00,70.68,63.64
10,007,04,010,0053,0161,655,21,676,1129,0,8,3,11,6,1,7,0.00,59.88,63.64
10,007,04,010,0054,0162,562,22,584,864,0,8,3,11,6,1,7,0.00,67.59,63.64
10,007,04,010,0054,0163,578,24,602,1023,0,8,3,11,6,1,7,0.00,58.85,63.64
10,007,04,010,0054,0164,634,9,643,953,0,8,3,11,6,1,7,0.00,67.47,63.64
10,007,04,010,0071,0165,608,21,629,979,0,8,3,11,6,1,7,0.00,64.25,63.64
10,007,04,010,0071,0166,651,20,671,1078,0,8,3,11,6,1,7,0.00,62.24,63.64
10,007,04,010,0071,0167,667,21,688,1069,0,8,3,11,6,1,7,0.00,64.36,63.64
10,007,04,010,0071,0168,654,13,667,1072,0,8,3,11,6,1,7,0.00,62.22,63.64
10,007,04,010,0058,0169,440,15,455,718,0,8,3,11,6,1,7,0.00,63.37,63.64
10,007,04,010,0058,0170,541,23,564,852,0,8,3,11,6,1,7,0.00,66.20,63.64
10,007,04,010,0058,0171,442,16,458,755,0,8,3,11,6,1,7,0.00,60.66,63.64
10,007,04,010,0055,0172,638,21,659,1084,0,8,3,11,6,1,7,0.00,60.79,63.64
10,007,04,010,0055,0173,684,31,715,1199,0,8,3,11,6,1,7,0.00,59.63,63.64
10,007,04,010,0055,0174,665,36,701,1114,0,8,3,11,6,1,7,0.00,62.93,63.64
10,007,04,010,0055,0175,648,29,677,1111,0,8,3,11,6,1,7,0.00,60.94,63.64
10,007,04,010,0055,0176,645,30,675,1056,0,8,3,11,6,1,7,0.00,63.92,63.64
10,007,04,010,0055,0177,542,24,566,897,0,8,3,11,6,1,7,0.00,63.10,63.64
10,007,04,010,0052,0178,643,23,666,893,0,8,3,11,6,1,7,0.00,74.58,63.64
10,007,04,010,0052,0179,591,15,606,899,0,8,3,11,6,1,7,0.00,67.41,63.64
10,007,04,010,0057,0180,707,24,731,1128,0,8,3,11,6,1,7,0.00,64.80,63.64
10,007,04,010,0050,0181,603,19,622,943,0,8,3,11,6,1,7,0.00,65.96,63.64
10,007,04,010,0050,0182,658,34,692,1062,0,8,3,11,6,1,7,0.00,65.16,63.64
10,007,04,010,0050,0183,622,24,646,1084,0,8,3,11,6,1,7,0.00,59.59,63.64
10,007,04,010,0069,0184,604,23,627,859,0,8,3,11,6,1,7,0.00,72.99,63.64
10,007,04,010,0070,0185,660,34,694,1093,0,8,3,11,6,1,7,0.00,63.49,63.64
10,007,04,010,0068,0186,613,16,629,818,0,8,3,11,6,1,7,0.00,76.89,63.64
10,007,04,010,0067,0187,828,33,861,1214,0,8,3,11,6,1,7,0.00,70.92,63.64
10,007,04,010,0066,0188,744,32,776,1089,0,8,3,11,6,1,7,0.00,71.26,63.64
10,007,04,010,0050,0000,1883,77,1960,3089,0,8,3,11,6,1,7,0.00,63.45,63.64
10,007,04,010,0051,0000,958,40,998,1596,0,8,3,11,6,1,7,0.00,62.53,63.64
10,007,04,010,0052,0000,1234,38,1272,1792,0,8,3,11,6,1,7,0.00,70.98,63.64
10,007,04,010,0053,0000,2098,63,2161,3196,0,8,3,11,6,1,7,0.00,67.62,63.64
10,007,04,010,0054,0000,1774,55,1829,2840,0,8,3,11,6,1,7,0.00,64.40,63.64
10,007,04,010,0055,0000,3822,171,3993,6461,0,8,3,11,6,1,7,0.00,61.80,63.64
10,007,04,010,0056,0000,1276,62,1338,2317,0,8,3,11,6,1,7,0.00,57.75,63.64
10,007,04,010,0057,0000,707,24,731,1128,0,8,3,11,6,1,7,0.00,64.80,63.64
10,007,04,010,0058,0000,1423,54,1477,2325,0,8,3,11,6,1,7,0.00,63.53,63.64
10,007,04,010,0059,0000,808,41,849,1182,0,8,3,11,6,1,7,0.00,71.83,63.64
10,007,04,010,0060,0000,533,28,561,892,0,8,3,11,6,1,7,0.00,62.89,63.64
10,007,04,010,0061,0000,1748,77,1825,2782,0,8,3,11,6,1,7,0.00,65.60,63.64
10,007,04,010,0062,0000,4640,246,4886,8091,0,8,3,11,6,1,7,0.00,60.39,63.64
10,007,04,010,0063,0000,1461,44,1505,2271,0,8,3,11,6,1,7,0.00,66.27,63.64
10,007,04,010,0064,0000,2141,169,2310,3916,0,8,3,11,6,1,7,0.00,58.99,63.64
10,007,04,010,0065,0000,1491,71,1562,2515,0,8,3,11,6,1,7,0.00,62.11,63.64
10,007,04,010,0066,0000,744,32,776,1089,0,8,3,11,6,1,7,0.00,71.26,63.64
10,007,04,010,0067,0000,828,33,861,1214,0,8,3,11,6,1,7,0.00,70.92,63.64
10,007,04,010,0068,0000,613,16,629,818,0,8,3,11,6,1,7,0.00,76.89,63.64
10,007,04,010,0069,0000,604,23,627,859,0,8,3,11,6,1,7,0.00,72.99,63.64
10,007,04,010,0070,0000,660,34,694,1093,0,8,3,11,6,1,7,0.00,63.49,63.64
10,007,04,010,0071,0000,2580,75,2655,4198,0,8,3,11,6,1,7,0.00,63.24,63.64
10,007,04,020,0005,0000,1720,90,1810,2881,0,6,1,7,5,1,6,0.00,62.83,85.71
10,007,04,020,0006,0000,2934,119,3053,5035,0,6,1,7,5,1,6,0.00,60.64,85.71
10,007,04,020,0019,0000,2185,79,2264,3698,0,6,1,7,5,1,6,0.00,61.22,85.71
10,007,04,020,0020,0000,1577,64,1641,2495,0,6,1,7,5,1,6,0.00,65.77,85.71
10,007,04,020,0021,0000,2565,84,2649,3998,0,6,1,7,5,1,6,0.00,66.26,85.71
10,007,04,020,0022,0000,2730,99,2829,3934,0,6,1,7,5,1,6,0.00,71.91,85.71
10,007,04,020,0019,0292,465,18,483,825,0,6,1,7,5,1,6,0.00,58.55,85.71
10,007,04,020,0019,0293,350,18,368,619,0,6,1,7,5,1,6,0.00,59.45,85.71
10,007,04,020,0019,0294,658,14,672,1056,0,6,1,7,5,1,6,0.00,63.64,85.71
10,007,04,020,0019,0295,712,29,741,1198,0,6,1,7,5,1,6,0.00,61.85,85.71
10,007,04,020,0020,0296,478,29,507,815,0,6,1,7,5,1,6,0.00,62.21,85.71
10,007,04,020,0020,0297,436,13,449,700,0,6,1,7,5,1,6,0.00,64.14,85.71
10,007,04,020,0020,0298,663,22,685,980,0,6,1,7,5,1,6,0.00,69.90,85.71
10,007,04,020,0022,0299,625,27,652,880,0,6,1,7,5,1,6,0.00,74.09,85.71
10,007,04,020,0030,0000,1392,69,1461,2254,0,6,1,7,5,1,6,0.00,64.82,85.71
10,007,04,020,0022,0300,733,23,756,1047,0,6,1,7,5,1,6,0.00,72.21,85.71
10,007,04,020,0022,0301,620,15,635,850,0,6,1,7,5,1,6,0.00,74.71,85.71
10,007,04,020,0022,0302,752,34,786,1157,0,6,1,7,5,1,6,0.00,67.93,85.71
10,007,04,020,0021,0303,894,30,924,1353,0,6,1,7,5,1,6,0.00,68.29,85.71
10,007,04,020,0021,0304,797,20,817,1205,0,6,1,7,5,1,6,0.00,67.80,85.71
10,007,04,020,0021,0305,874,34,908,1440,0,6,1,7,5,1,6,0.00,63.06,85.71
10,007,04,020,0006,0306,698,22,720,1151,0,6,1,7,5,1,6,0.00,62.55,85.71
10,007,04,020,0006,0307,704,28,732,1149,0,6,1,7,5,1,6,0.00,63.71,85.71
10,007,04,020,0006,0308,793,25,818,1281,0,6,1,7,5,1,6,0.00,63.86,85.71
10,007,04,020,0006,0309,739,44,783,1454,0,6,1,7,5,1,6,0.00,53.85,85.71
10,007,04,020,0031,0000,1645,103,1748,2500,0,6,1,7,5,1,6,0.00,69.92,85.71
10,007,04,020,0031,0310,905,55,960,1432,0,6,1,7,5,1,6,0.00,67.04,85.71
10,007,04,020,0031,0311,740,48,788,1068,0,6,1,7,5,1,6,0.00,73.78,85.71
10,007,04,020,0005,0312,683,31,714,1126,0,6,1,7,5,1,6,0.00,63.41,85.71
10,007,04,020,0005,0313,522,23,545,882,0,6,1,7,5,1,6,0.00,61.79,85.71
10,007,04,020,0005,0314,515,36,551,873,0,6,1,7,5,1,6,0.00,63.12,85.71
10,007,04,020,0030,0315,700,40,740,1133,0,6,1,7,5,1,6,0.00,65.31,85.71
10,007,04,020,0030,0316,692,29,721,1121,0,6,1,7,5,1,6,0.00,64.32,85.71
10,007,04,030,0008,0000,584,7,591,811,0,4,0,4,2,0,2,0.00,72.87,50.00
10,007,04,030,0026,0000,1045,48,1093,1650,0,4,0,4,2,0,2,0.00,66.24,50.00
10,007,04,030,0027,0000,493,24,517,795,0,4,0,4,2,0,2,0.00,65.03,50.00
10,007,04,030,0028,0000,765,36,801,1158,0,4,0,4,2,0,2,0.00,69.17,50.00
10,007,04,030,0029,0000,1134,50,1184,1929,0,4,0,4,2,0,2,0.00,61.38,50.00
10,007,04,030,0030,0000,1866,58,1924,2899,0,4,0,4,2,0,2,0.00,66.37,50.00
10,007,04,030,0031,0000,895,36,931,1455,0,4,0,4,2,0,2,0.00,63.99,50.00
10,007,04,030,0008,0447,584,7,591,811,0,4,0,4,2,0,2,0.00,72.87,50.00
10,007,04,030,0026,0448,515,31,546,815,0,4,0,4,2,0,2,0.00,66.99,50.00
10,007,04,030,0026,0449,530,17,547,835,0,4,0,4,2,0,2,0.00,65.51,50.00
10,007,04,030,0027,0450,493,24,517,795,0,4,0,4,2,0,2,0.00,65.03,50.00
10,007,04,030,0028,0451,765,36,801,1158,0,4,0,4,2,0,2,0.00,69.17,50.00
10,007,04,030,0029,0452,621,32,653,1023,0,4,0,4,2,0,2,0.00,63.83,50.00
10,007,04,030,0029,0453,513,18,531,906,0,4,0,4,2,0,2,0.00,58.61,50.00
10,007,04,030,0030,0454,645,15,660,976,0,4,0,4,2,0,2,0.00,67.62,50.00
10,007,04,030,0030,0455,616,24,640,960,0,4,0,4,2,0,2,0.00,66.67,50.00
10,007,04,030,0030,0456,605,19,624,963,0,4,0,4,2,0,2,0.00,64.80,50.00
10,007,04,030,0031,0457,416,12,428,652,0,4,0,4,2,0,2,0.00,65.64,50.00
10,007,04,030,0031,0458,479,24,503,803,0,4,0,4,2,0,2,0.00,62.64,50.00
10,007,04,050,0003,0000,898,27,925,1459,0,6,2,8,3,1,4,0.00,63.40,50.00
10,007,04,050,0010,0000,3155,137,3292,5066,0,6,2,8,3,1,4,0.00,64.98,50.00
10,007,04,050,0013,0000,1873,56,1929,2941,0,6,2,8,3,1,4,0.00,65.59,50.00
10,007,04,050,0014,0000,1414,38,1452,2152,0,6,2,8,3,1,4,0.00,67.47,50.00
10,007,04,050,0010,0477,880,27,907,1351,0,6,2,8,3,1,4,0.00,67.14,50.00
10,007,04,050,0010,0478,809,31,840,1282,0,6,2,8,3,1,4,0.00,65.52,50.00
10,007,04,050,0010,0479,734,32,766,1163,0,6,2,8,3,1,4,0.00,65.86,50.00
10,007,04,050,0010,0480,732,47,779,1270,0,6,2,8,3,1,4,0.00,61.34,50.00
10,007,04,050,0003,0481,898,27,925,1459,0,6,2,8,3,1,4,0.00,63.40,50.00
10,007,04,050,0013,0482,611,20,631,964,0,6,2,8,3,1,4,0.00,65.46,50.00
10,007,04,050,0013,0483,656,20,676,994,0,6,2,8,3,1,4,0.00,68.01,50.00
10,007,04,050,0013,0484,606,16,622,983,0,6,2,8,3,1,4,0.00,63.28,50.00
10,007,04,050,0014,0485,697,25,722,1059,0,6,2,8,3,1,4,0.00,68.18,50.00
10,007,04,050,0014,0486,717,13,730,1093,0,6,2,8,3,1,4,0.00,66.79,50.00
10,007,04,090,0011,0000,521,104,625,915,0,1,1,2,1,1,2,0.00,68.31,100.00
10,007,04,090,0012,0000,669,143,812,1105,0,1,1,2,1,1,2,0.00,73.48,100.00
10,007,04,090,0013,0000,514,60,574,807,0,1,1,2,1,1,2,0.00,71.13,100.00
10,007,04,090,0014,0000,640,86,726,940,0,1,1,2,1,1,2,0.00,77.23,100.00
10,007,04,090,0011,0244,521,104,625,915,0,1,1,2,1,1,2,0.00,68.31,100.00
10,007,04,090,0012,0245,669,143,812,1105,0,1,1,2,1,1,2,0.00,73.48,100.00
10,007,04,090,0013,0246,514,60,574,807,0,1,1,2,1,1,2,0.00,71.13,100.00
10,007,04,090,0014,0247,640,86,726,940,0,1,1,2,1,1,2,0.00,77.23,100.00
10,007,04,100,0011,0000,1419,72,1491,2339,0,4,2,6,2,2,4,0.00,63.75,66.67
10,007,04,100,0012,0000,2442,74,2516,3909,0,4,2,6,2,2,4,0.00,64.36,66.67
10,007,04,100,0013,0000,3082,112,3194,5166,0,4,2,6,2,2,4,0.00,61.83,66.67
10,007,04,100,0014,0000,2762,73,2835,4584,0,4,2,6,2,2,4,0.00,61.85,66.67
10,007,04,100,0015,0000,1013,30,1043,1628,0,4,2,6,2,2,4,0.00,64.07,66.67
10,007,04,100,0016,0000,1363,32,1395,1999,0,4,2,6,2,2,4,0.00,69.78,66.67
10,007,04,100,0011,0580,698,38,736,1131,0,4,2,6,2,2,4,0.00,65.08,66.67
10,007,04,100,0011,0581,721,34,755,1208,0,4,2,6,2,2,4,0.00,62.50,66.67
10,007,04,100,0012,0582,830,15,845,1294,0,4,2,6,2,2,4,0.00,65.30,66.67
10,007,04,100,0012,0583,600,17,617,992,0,4,2,6,2,2,4,0.00,62.20,66.67
10,007,04,100,0012,0584,509,20,529,780,0,4,2,6,2,2,4,0.00,67.82,66.67
10,007,04,100,0012,0585,503,22,525,843,0,4,2,6,2,2,4,0.00,62.28,66.67
10,007,04,100,0013,0586,661,36,697,1127,0,4,2,6,2,2,4,0.00,61.85,66.67
10,007,04,100,0013,0587,735,18,753,1235,0,4,2,6,2,2,4,0.00,60.97,66.67
10,007,04,100,0013,0588,550,25,575,1064,0,4,2,6,2,2,4,0.00,54.04,66.67
10,007,04,100,0013,0589,578,14,592,871,0,4,2,6,2,2,4,0.00,67.97,66.67
10,007,04,100,0013,0590,558,19,577,869,0,4,2,6,2,2,4,0.00,66.40,66.67
10,007,04,100,0014,0591,515,12,527,852,0,4,2,6,2,2,4,0.00,61.85,66.67
10,007,04,100,0014,0592,506,15,521,818,0,4,2,6,2,2,4,0.00,63.69,66.67
10,007,04,100,0014,0593,549,17,566,884,0,4,2,6,2,2,4,0.00,64.03,66.67
10,007,04,100,0014,0594,560,17,577,971,0,4,2,6,2,2,4,0.00,59.42,66.67
10,007,04,100,0014,0595,632,12,644,1059,0,4,2,6,2,2,4,0.00,60.81,66.67
10,007,04,100,0015,0596,555,17,572,865,0,4,2,6,2,2,4,0.00,66.13,66.67
10,007,04,100,0015,0597,458,13,471,763,0,4,2,6,2,2,4,0.00,61.73,66.67
10,007,04,100,0016,0598,690,17,707,1004,0,4,2,6,2,2,4,0.00,70.42,66.67
10,007,04,100,0016,0599,673,15,688,995,0,4,2,6,2,2,4,0.00,69.15,66.67
10,007,04,130,0007,0000,1883,79,1962,3052,0,6,1,7,2,1,3,0.00,64.29,42.86
10,007,04,130,0008,0000,1577,40,1617,2536,0,6,1,7,2,1,3,0.00,63.76,42.86
10,007,04,130,0015,0000,1480,59,1539,2451,0,6,1,7,2,1,3,0.00,62.79,42.86
10,007,04,130,0016,0000,1397,44,1441,2151,0,6,1,7,2,1,3,0.00,66.99,42.86
10,007,04,130,0007,0622,642,34,676,1017,0,6,1,7,2,1,3,0.00,66.47,42.86
10,007,04,130,0007,0623,632,21,653,1053,0,6,1,7,2,1,3,0.00,62.01,42.86
10,007,04,130,0007,0624,609,24,633,982,0,6,1,7,2,1,3,0.00,64.46,42.86
10,007,04,130,0015,0625,684,26,710,1098,0,6,1,7,2,1,3,0.00,64.66,42.86
10,007,04,130,0015,0626,796,33,829,1353,0,6,1,7,2,1,3,0.00,61.27,42.86
10,007,04,130,0016,0627,698,19,717,1045,0,6,1,7,2,1,3,0.00,68.61,42.86
10,007,04,130,0016,0628,699,25,724,1106,0,6,1,7,2,1,3,0.00,65.46,42.86
10,007,04,130,0008,0629,788,19,807,1215,0,6,1,7,2,1,3,0.00,66.42,42.86
10,007,04,130,0008,0630,789,21,810,1321,0,6,1,7,2,1,3,0.00,61.32,42.86
10,007,04,170,0006,0000,711,22,733,1071,0,2,1,3,2,0,2,0.00,68.44,66.67
10,007,04,170,0009,0000,501,24,525,742,0,2,1,3,2,0,2,0.00,70.75,66.67
10,007,04,170,0012,0000,645,25,670,953,0,2,1,3,2,0,2,0.00,70.30,66.67
10,007,04,170,0015,0000,612,14,626,927,0,2,1,3,2,0,2,0.00,67.53,66.67
10,007,04,170,0018,0000,548,26,574,765,0,2,1,3,2,0,2,0.00,75.03,66.67
10,007,04,170,0021,0000,892,31,923,1409,0,2,1,3,2,0,2,0.00,65.51,66.67
10,007,04,170,0024,0000,1227,67,1294,2088,0,2,1,3,2,0,2,0.00,61.97,66.67
10,007,04,170,0009,0835,501,24,525,742,0,2,1,3,2,0,2,0.00,70.75,66.67
10,007,04,170,0015,0836,612,14,626,927,0,2,1,3,2,0,2,0.00,67.53,66.67
10,007,04,170,0024,0837,670,32,702,1056,0,2,1,3,2,0,2,0.00,66.48,66.67
10,007,04,170,0024,0838,557,35,592,1032,0,2,1,3,2,0,2,0.00,57.36,66.67
10,007,04,170,0012,0839,645,25,670,953,0,2,1,3,2,0,2,0.00,70.30,66.67
10,007,04,170,0006,0840,711,22,733,1071,0,2,1,3,2,0,2,0.00,68.44,66.67
10,007,04,170,0018,0841,548,26,574,765,0,2,1,3,2,0,2,0.00,75.03,66.67
10,007,04,170,0021,0842,476,15,491,729,0,2,1,3,2,0,2,0.00,67.35,66.67
10,007,04,170,0021,0843,416,16,432,680,0,2,1,3,2,0,2,0.00,63.53,66.67
10,007,04,190,0009,0000,862,20,882,1255,0,2,1,3,1,1,2,0.00,70.28,66.67
10,007,04,190,0014,0000,1150,45,1195,1972,0,2,1,3,1,1,2,0.00,60.60,66.67
10,007,04,190,0015,0000,1028,26,1054,1735,0,2,1,3,1,1,2,0.00,60.75,66.67
10,007,04,190,0009,0886,862,20,882,1255,0,2,1,3,1,1,2,0.00,70.28,66.67
10,007,04,190,0014,0887,603,23,626,1051,0,2,1,3,1,1,2,0.00,59.56,66.67
10,007,04,190,0014,0888,547,22,569,921,0,2,1,3,1,1,2,0.00,61.78,66.67
10,007,04,190,0015,0889,484,9,493,813,0,2,1,3,1,1,2,0.00,60.64,66.67
10,007,04,190,0015,0890,544,17,561,922,0,2,1,3,1,1,2,0.00,60.85,66.67
10,007,04,200,0021,0000,666,24,690,924,0,3,0,3,2,0,2,0.00,74.68,66.67
10,007,04,200,0023,0000,511,17,528,829,0,3,0,3,2,0,2,0.00,63.69,66.67
10,007,04,200,0024,0000,753,20,773,1183,0,3,0,3,2,0,2,0.00,65.34,66.67
10,007,04,200,0025,0000,686,38,724,1003,0,3,0,3,2,0,2,0.00,72.18,66.67
10,007,04,200,0026,0000,616,18,634,931,0,3,0,3,2,0,2,0.00,68.10,66.67
10,007,04,200,0027,0000,423,17,440,667,0,3,0,3,2,0,2,0.00,65.97,66.67
10,007,04,200,0021,1008,666,24,690,924,0,3,0,3,2,0,2,0.00,74.68,66.67
10,007,04,200,0023,1009,511,17,528,829,0,3,0,3,2,0,2,0.00,63.69,66.67
10,007,04,200,0024,1010,753,20,773,1183,0,3,0,3,2,0,2,0.00,65.34,66.67
10,007,04,200,0025,1011,686,38,724,1003,0,3,0,3,2,0,2,0.00,72.18,66.67
10,007,04,200,0026,1012,616,18,634,931,0,3,0,3,2,0,2,0.00,68.10,66.67
10,007,04,200,0027,1013,423,17,440,667,0,3,0,3,2,0,2,0.00,65.97,66.67
10,007,04,210,0004,0000,707,20,727,1017,0,5,0,5,3,0,3,0.00,71.48,60.00
10,007,04,210,0005,0000,494,29,523,722,0,5,0,5,3,0,3,0.00,72.44,60.00
10,007,04,210,0006,0000,626,29,655,994,0,5,0,5,3,0,3,0.00,65.90,60.00
10,007,04,210,0007,0000,694,24,718,1159,0,5,0,5,3,0,3,0.00,61.95,60.00
10,007,04,210,0008,0000,435,17,452,586,0,5,0,5,3,0,3,0.00,77.13,60.00
10,007,04,210,0009,0000,866,26,892,1286,0,5,0,5,3,0,3,0.00,69.36,60.00
10,007,04,210,0004,0910,707,20,727,1017,0,5,0,5,3,0,3,0.00,71.48,60.00
10,007,04,210,0009,0911,866,26,892,1286,0,5,0,5,3,0,3,0.00,69.36,60.00
10,007,04,210,0007,0912,694,24,718,1159,0,5,0,5,3,0,3,0.00,61.95,60.00
10,007,04,210,0008,0913,435,17,452,586,0,5,0,5,3,0,3,0.00,77.13,60.00
10,007,04,210,0005,0914,494,29,523,722,0,5,0,5,3,0,3,0.00,72.44,60.00
10,007,04,210,0006,0915,626,29,655,994,0,5,0,5,3,0,3,0.00,65.90,60.00
10,007,04,220,0013,0000,500,73,573,765,0,1,1,2,1,1,2,0.00,74.90,100.00
10,007,04,220,0014,0000,683,81,764,1034,0,1,1,2,1,1,2,0.00,73.89,100.00
10,007,04,220,0015,0000,780,115,895,1403,0,1,1,2,1,1,2,0.00,63.79,100.00
10,007,04,220,0016,0000,549,68,617,1023,0,1,1,2,1,1,2,0.00,60.31,100.00
10,007,04,220,0017,0000,410,68,478,868,0,1,1,2,1,1,2,0.00,55.07,100.00
10,007,04,220,0013,0937,500,73,573,765,0,1,1,2,1,1,2,0.00,74.90,100.00
10,007,04,220,0014,0938,683,81,764,1034,0,1,1,2,1,1,2,0.00,73.89,100.00
10,007,04,220,0015,0939,399,38,437,685,0,1,1,2,1,1,2,0.00,63.80,100.00
10,007,04,220,0015,0940,381,77,458,718,0,1,1,2,1,1,2,0.00,63.79,100.00
10,007,04,220,0016,0941,549,68,617,1023,0,1,1,2,1,1,2,0.00,60.31,100.00
10,007,04,220,0017,0942,410,68,478,868,0,1,1,2,1,1,2,0.00,55.07,100.00
10,007,04,230,0021,0000,919,75,994,1375,0,2,2,4,2,2,4,0.00,72.29,100.00
10,007,04,230,0022,0000,557,60,617,996,0,2,2,4,2,2,4,0.00,61.95,100.00
10,007,04,230,0023,0000,1147,103,1250,1959,0,2,2,4,2,2,4,0.00,63.81,100.00
10,007,04,230,0024,0000,538,36,574,727,0,2,2,4,2,2,4,0.00,78.95,100.00
10,007,04,230,0025,0000,813,40,853,1253,0,2,2,4,2,2,4,0.00,68.08,100.00
10,007,04,230,0026,0000,1724,88,1812,3023,0,2,2,4,2,2,4,0.00,59.94,100.00
10,007,04,230,0021,1056,731,62,793,1082,0,2,2,4,2,2,4,0.00,73.29,100.00
10,007,04,230,0021,1057,188,13,201,293,0,2,2,4,2,2,4,0.00,68.60,100.00
10,007,04,230,0023,1058,638,63,701,1045,0,2,2,4,2,2,4,0.00,67.08,100.00
10,007,04,230,0023,1059,509,40,549,914,0,2,2,4,2,2,4,0.00,60.07,100.00
10,007,04,230,0024,1060,538,36,574,727,0,2,2,4,2,2,4,0.00,78.95,100.00
10,007,04,230,0022,1061,557,60,617,996,0,2,2,4,2,2,4,0.00,61.95,100.00
10,007,04,230,0025,1062,339,15,354,528,0,2,2,4,2,2,4,0.00,67.05,100.00
10,007,04,230,0025,1063,474,25,499,725,0,2,2,4,2,2,4,0.00,68.83,100.00
10,007,04,230,0026,1064,453,19,472,821,0,2,2,4,2,2,4,0.00,57.49,100.00
10,007,04,230,0026,1065,701,38,739,1146,0,2,2,4,2,2,4,0.00,64.49,100.00
10,007,04,230,0026,1066,570,31,601,1056,0,2,2,4,2,2,4,0.00,56.91,100.00
10,007,04,240,0009,0000,353,19,372,626,0,5,0,5,3,0,3,0.00,59.42,60.00
10,007,04,240,0011,0000,487,15,502,811,0,5,0,5,3,0,3,0.00,61.90,60.00
10,007,04,240,0012,0000,799,27,826,1135,0,5,0,5,3,0,3,0.00,72.78,60.00
10,007,04,240,0013,0000,573,12,585,836,0,5,0,5,3,0,3,0.00,69.98,60.00
10,007,04,240,0012,1027,799,27,826,1135,0,5,0,5,3,0,3,0.00,72.78,60.00
10,007,04,240,0013,1028,573,12,585,836,0,5,0,5,3,0,3,0.00,69.98,60.00
10,007,04,240,0009,1029,353,19,372,626,0,5,0,5,3,0,3,0.00,59.42,60.00
10,007,04,240,0011,1030,487,15,502,811,0,5,0,5,3,0,3,0.00,61.90,60.00
10,007,04,250,0009,0000,377,5,382,443,0,6,1,7,3,0,3,0.00,86.23,42.86
10,007,04,250,0010,0000,581,14,595,755,0,6,1,7,3,0,3,0.00,78.81,42.86
10,007,04,250,0011,0000,461,10,471,600,0,6,1,7,3,0,3,0.00,78.50,42.86
10,007,04,250,0012,0000,380,8,388,501,0,6,1,7,3,0,3,0.00,77.45,42.86
10,007,04,250,0013,0000,525,11,536,721,0,6,1,7,3,0,3,0.00,74.34,42.86
10,007,04,250,0014,0000,393,7,400,511,0,6,1,7,3,0,3,0.00,78.28,42.86
10,007,04,250,0009,1077,377,5,382,443,0,6,1,7,3,0,3,0.00,86.23,42.86
10,007,04,250,0010,1078,581,14,595,755,0,6,1,7,3,0,3,0.00,78.81,42.86
10,007,04,250,0011,1079,461,10,471,600,0,6,1,7,3,0,3,0.00,78.50,42.86
10,007,04,250,0012,1080,380,8,388,501,0,6,1,7,3,0,3,0.00,77.45,42.86
10,007,04,250,0013,1081,525,11,536,721,0,6,1,7,3,0,3,0.00,74.34,42.86
10,007,04,250,0014,1082,393,7,400,511,0,6,1,7,3,0,3,0.00,78.28,42.86
10,007,04,260,0004,0000,993,41,1034,1445,0,4,0,4,2,0,2,0.00,71.56,50.00
10,007,04,260,0013,0000,549,20,569,796,0,4,0,4,2,0,2,0.00,71.48,50.00
10,007,04,260,0016,0000,800,25,825,1211,0,4,0,4,2,0,2,0.00,68.13,50.00
10,007,04,260,0019,0000,497,18,515,798,0,4,0,4,2,0,2,0.00,64.54,50.00
10,007,04,260,0013,0967,549,20,569,796,0,4,0,4,2,0,2,0.00,71.48,50.00
10,007,04,260,0019,0968,497,18,515,798,0,4,0,4,2,0,2,0.00,64.54,50.00
10,007,04,260,0016,0969,800,25,825,1211,0,4,0,4,2,0,2,0.00,68.13,50.00
10,007,04,260,0004,0970,442,14,456,654,0,4,0,4,2,0,2,0.00,69.72,50.00
10,007,04,260,0004,0971,551,27,578,791,0,4,0,4,2,0,2,0.00,73.07,50.00
10,007,00,050,0000,0000,19758,716,20474,30547,37911,17,2,19,10,1,11,80.58,67.02,57.89
10,007,01,050,0000,0000,4107,138,4245,6036,7682,3,0,3,2,0,2,78.57,70.33,66.67
10,007,02,050,0000,0000,2859,71,2930,4582,5613,3,0,3,2,0,2,81.63,63.95,66.67
10,007,03,050,0000,0000,5452,249,5701,8311,10142,5,0,5,3,0,3,81.95,68.60,60.00
10,007,04,050,0000,0000,7340,258,7598,11618,14474,6,2,8,3,1,4,80.27,65.40,50.00
10,007,00,060,0000,0000,24717,803,25520,38011,45450,15,3,18,8,3,11,83.63,67.14,61.11
10,007,01,060,0000,0000,6024,187,6211,9456,11194,5,1,6,2,1,3,84.47,65.68,50.00
10,007,02,060,0000,0000,7733,358,8091,11899,14266,4,0,4,3,0,3,83.41,68.00,75.00
10,007,03,060,0000,0000,10960,258,11218,16656,19990,6,2,8,3,2,5,83.32,67.35,62.50
10,007,00,070,0000,0000,19435,670,20105,31266,38282,11,5,16,7,4,11,81.67,64.30,68.75
10,007,01,070,0000,0000,8000,297,8297,13034,15899,5,3,8,3,2,5,81.98,63.66,62.50
10,007,02,070,0000,0000,4096,131,4227,6610,7729,3,0,3,2,0,2,85.52,63.95,66.67
10,007,03,070,0000,0000,7339,242,7581,11622,14654,3,2,5,2,2,4,79.31,65.23,80.00
10,007,00,080,0000,0000,23240,779,24019,37240,44299,8,7,15,6,5,11,84.07,64.50,73.33
10,007,01,080,0000,0000,7384,273,7657,11229,13283,3,1,4,2,1,3,84.54,68.19,75.00
10,007,02,080,0000,0000,9684,328,10012,15932,18915,2,4,6,2,3,5,84.23,62.84,83.33
10,007,03,080,0000,0000,6172,178,6350,10079,12101,3,2,5,2,1,3,83.29,63.00,60.00
10,007,00,090,0000,0000,12977,771,13748,19338,22545,10,4,14,7,4,11,85.78,71.09,78.57
10,007,01,090,0000,0000,3257,78,3335,4661,5456,3,1,4,2,1,3,85.43,71.55,75.00
10,007,02,090,0000,0000,5148,217,5365,7590,8912,3,2,5,2,2,4,85.17,70.69,80.00
10,007,03,090,0000,0000,2228,83,2311,3320,3808,3,0,3,2,0,2,87.18,69.61,66.67
10,007,04,090,0000,0000,2344,393,2737,3767,4369,1,1,2,1,1,2,86.22,72.66,100.00
10,007,00,100,0000,0000,59670,2187,61857,98174,122195,19,9,28,10,9,19,80.34,63.01,67.86
10,007,01,100,0000,0000,13856,480,14336,22296,26692,4,2,6,2,2,4,83.53,64.30,66.67
10,007,02,100,0000,0000,14298,764,15062,24071,29103,4,2,6,3,2,5,82.71,62.57,83.33
10,007,03,100,0000,0000,19435,550,19985,32182,41100,7,3,10,3,3,6,78.30,62.10,60.00
10,007,04,100,0000,0000,12081,393,12474,19625,25300,4,2,6,2,2,4,77.57,63.56,66.67
10,007,00,110,0000,0000,27172,891,28063,43295,54044,10,7,17,6,6,12,80.11,64.82,70.59
10,007,01,110,0000,0000,8112,264,8376,12980,16560,2,3,5,2,2,4,78.38,64.53,80.00
10,007,02,110,0000,0000,12645,399,13044,20207,25420,4,3,7,2,3,5,79.49,64.55,71.43
10,007,03,110,0000,0000,6415,228,6643,10108,12064,4,1,5,2,1,3,83.79,65.72,60.00
10,007,00,120,0000,0000,20850,764,21614,33490,39689,12,3,15,9,2,11,84.38,64.54,73.33
10,007,01,120,0000,0000,5368,227,5595,8818,10221,4,0,4,3,0,3,86.27,63.45,75.00
10,007,02,120,0000,0000,8112,282,8394,12877,15449,4,2,6,3,1,4,83.35,65.19,66.67
10,007,03,120,0000,0000,7370,255,7625,11795,14019,4,1,5,3,1,4,84.14,64.65,80.00
10,007,00,130,0000,0000,21428,689,22117,32954,40259,13,6,19,6,5,11,81.85,67.11,57.89
10,007,01,130,0000,0000,7502,206,7708,11181,13917,3,3,6,2,2,4,80.34,68.94,66.67
10,007,02,130,0000,0000,3070,100,3170,4361,5105,2,0,2,1,0,1,85.43,72.69,50.00
10,007,03,130,0000,0000,4519,161,4680,7222,8888,2,2,4,1,2,3,81.26,64.80,75.00
10,007,04,130,0000,0000,6337,222,6559,10190,12349,6,1,7,2,1,3,82.52,64.37,42.86
10,007,00,140,0000,0000,18628,558,19186,26715,31352,13,7,20,7,4,11,85.21,71.82,55.00
10,007,01,140,0000,0000,7506,261,7767,10675,12515,4,2,6,3,1,4,85.30,72.76,66.67
10,007,02,140,0000,0000,6052,142,6194,8354,9960,4,5,9,1,3,4,83.88,74.14,44.44
10,007,03,140,0000,0000,5070,155,5225,7686,8877,5,0,5,3,0,3,86.58,67.98,60.00
10,007,00,150,0000,0000,18671,571,19242,28684,33864,13,6,19,8,3,11,84.70,67.08,57.89
10,007,01,150,0000,0000,11830,352,12182,18373,21734,8,4,12,5,2,7,84.54,66.30,58.33
10,007,02,150,0000,0000,4267,157,4424,6484,7694,3,2,5,2,1,3,84.27,68.23,60.00
10,007,03,150,0000,0000,2574,62,2636,3827,4436,2,0,2,1,0,1,86.27,68.88,50.00
10,007,00,160,0000,0000,19461,732,20193,29630,35514,20,5,25,8,3,11,83.43,68.15,44.00
10,007,01,160,0000,0000,5552,223,5775,8716,10263,4,2,6,2,1,3,84.93,66.26,50.00
10,007,02,160,0000,0000,8995,296,9291,13630,16792,8,3,11,3,2,5,81.17,68.17,45.45
10,007,03,160,0000,0000,4914,213,5127,7284,8459,8,0,8,3,0,3,86.11,70.39,37.50
10,007,00,170,0000,0000,22181,876,23057,34837,41622,15,2,17,10,1,11,83.70,66.19,64.71
10,007,01,170,0000,0000,11082,402,11484,17931,21491,8,1,9,5,1,6,83.43,64.05,66.67
10,007,02,170,0000,0000,3746,158,3904,5703,7051,3,0,3,2,0,2,80.88,68.46,66.67
10,007,03,170,0000,0000,2217,107,2324,3248,3800,2,0,2,1,0,1,85.47,71.55,50.00
10,007,04,170,0000,0000,5136,209,5345,7955,9280,2,1,3,2,0,2,85.72,67.19,66.67
10,007,00,180,0000,0000,8697,303,9000,12414,14213,11,3,14,9,2,11,87.34,72.50,78.57
10,007,01,180,0000,0000,2375,51,2426,3279,3735,3,1,4,2,1,3,87.79,73.99,75.00
10,007,02,180,0000,0000,4142,121,4263,5872,6744,5,2,7,4,1,5,87.07,72.60,71.43
10,007,03,180,0000,0000,2180,131,2311,3263,3734,3,0,3,3,0,3,87.39,70.82,100.00
10,007,00,190,0000,0000,16435,622,17057,26947,33237,13,3,16,8,3,11,81.08,63.30,68.75
10,007,01,190,0000,0000,2913,87,3000,4466,5609,3,0,3,2,0,2,79.62,67.17,66.67
10,007,02,190,0000,0000,3564,158,3722,6064,7557,3,1,4,1,1,2,80.24,61.38,50.00
10,007,03,190,0000,0000,6918,286,7204,11455,14175,5,1,6,4,1,5,80.81,62.89,83.33
10,007,04,190,0000,0000,3040,91,3131,4962,5896,2,1,3,1,1,2,84.16,63.10,66.67
10,007,00,200,0000,0000,25125,972,26097,40845,48500,12,5,17,8,3,11,84.22,63.89,64.71
10,007,01,200,0000,0000,7090,312,7402,11909,14680,1,3,4,1,2,3,81.12,62.15,75.00
10,007,02,200,0000,0000,6368,217,6585,10678,12942,4,1,5,2,1,3,82.51,61.67,60.00
10,007,03,200,0000,0000,8012,309,8321,12721,14633,4,1,5,3,0,3,86.93,65.41,60.00
10,007,04,200,0000,0000,3655,134,3789,5537,6245,3,0,3,2,0,2,88.66,68.43,66.67
10,007,00,210,0000,0000,14065,801,14866,22082,26114,11,4,15,8,3,11,84.56,67.32,73.33
10,007,01,210,0000,0000,6623,175,6798,10149,12147,4,3,7,3,2,5,83.55,66.98,71.43
10,007,02,210,0000,0000,1990,108,2098,3093,3649,1,1,2,1,1,2,84.76,67.83,100.00
10,007,03,210,0000,0000,1630,373,2003,3076,3550,1,0,1,1,0,1,86.65,65.12,100.00
10,007,04,210,0000,0000,3822,145,3967,5764,6768,5,0,5,3,0,3,85.17,68.82,60.00
10,007,00,220,0000,0000,15204,986,16190,24409,29318,10,4,14,8,3,11,83.26,66.33,78.57
10,007,01,220,0000,0000,3296,184,3480,5537,6631,4,0,4,3,0,3,83.50,62.85,75.00
10,007,02,220,0000,0000,6996,315,7311,10893,13292,4,2,6,3,2,5,81.95,67.12,83.33
10,007,03,220,0000,0000,1990,82,2072,2886,3351,1,1,2,1,0,1,86.12,71.79,50.00
10,007,04,220,0000,0000,2922,405,3327,5093,6044,1,1,2,1,1,2,84.27,65.32,100.00
10,007,00,230,0000,0000,16968,1157,18125,27350,31694,12,3,15,9,2,11,86.29,66.27,73.33
10,007,01,230,0000,0000,4789,192,4981,7418,8718,5,1,6,3,0,3,85.09,67.15,50.00
10,007,02,230,0000,0000,2309,73,2382,3367,3757,2,0,2,1,0,1,89.62,70.75,50.00
10,007,03,230,0000,0000,4172,490,4662,7232,8374,3,0,3,3,0,3,86.36,64.46,100.00
10,007,04,230,0000,0000,5698,402,6100,9333,10845,2,2,4,2,2,4,86.06,65.36,100.00
10,007,00,240,0000,0000,8793,376,9169,13597,15516,13,2,15,9,2,11,87.63,67.43,73.33
10,007,01,240,0000,0000,1591,31,1622,2243,2535,3,0,3,2,0,2,88.48,72.31,66.67
10,007,02,240,0000,0000,3605,116,3721,5562,6396,3,2,5,2,2,4,86.96,66.90,80.00
10,007,03,240,0000,0000,1385,156,1541,2384,2748,2,0,2,2,0,2,86.75,64.64,100.00
10,007,04,240,0000,0000,2212,73,2285,3408,3837,5,0,5,3,0,3,88.82,67.05,60.00
10,007,00,250,0000,0000,8713,263,8976,12024,14402,14,4,18,10,1,11,83.49,74.65,61.11
10,007,01,250,0000,0000,2753,44,2797,3644,4500,3,1,4,3,0,3,80.98,76.76,75.00
10,007,02,250,0000,0000,1609,39,1648,2173,2588,3,1,4,2,0,2,83.96,75.84,50.00
10,007,03,250,0000,0000,1634,125,1759,2676,3201,2,1,3,2,1,3,83.60,65.73,100.00
10,007,04,250,0000,0000,2717,55,2772,3531,4113,6,1,7,3,0,3,85.85,78.50,42.86
10,007,00,260,0000,0000,15153,651,15804,24238,28685,19,1,20,10,1,11,84.50,65.20,55.00
10,007,01,260,0000,0000,4041,193,4234,6539,7790,6,0,6,3,0,3,83.94,64.75,50.00
10,007,02,260,0000,0000,2804,125,2929,4689,5595,5,0,5,2,0,2,83.81,62.47,40.00
10,007,03,260,0000,0000,5469,229,5698,8760,10291,4,1,5,3,1,4,85.12,65.05,80.00
10,007,04,260,0000,0000,2839,104,2943,4250,5009,4,0,4,2,0,2,84.85,69.25,50.00
10,008,00,000,0000,0000,269058,10981,280039,405165,479889,187,65,252,119,44,163,84.43,69.12,64.68
10,008,00,010,0000,0000,53230,2337,55567,80639,97394,20,10,30,11,7,18,82.80,68.91,60.00
10,008,01,010,0000,0000,12585,612,13197,19277,23328,5,2,7,3,1,4,82.63,68.46,57.14
10,008,02,010,0000,0000,21379,952,22331,32189,39546,7,3,10,5,2,7,81.40,69.37,70.00
10,008,03,010,0000,0000,16336,647,16983,25039,29843,7,4,11,3,3,6,83.90,67.83,54.55
10,008,04,010,0000,0000,2930,126,3056,4134,4677,1,1,2,0,1,1,88.39,73.92,50.00
10,008,01,010,0001,0001,595,29,624,870,0,5,2,7,3,1,4,0.00,71.72,57.14
10,008,01,010,0002,0002,456,16,472,601,0,5,2,7,3,1,4,0.00,78.54,57.14
10,008,01,010,0002,0003,466,32,498,716,0,5,2,7,3,1,4,0.00,69.55,57.14
10,008,01,010,0003,0004,512,35,547,771,0,5,2,7,3,1,4,0.00,70.95,57.14
10,008,01,010,0004,0005,337,16,353,471,0,5,2,7,3,1,4,0.00,74.95,57.14
10,008,01,010,0005,0006,338,28,366,533,0,5,2,7,3,1,4,0.00,68.67,57.14
10,008,01,010,0006,0007,245,15,260,328,0,5,2,7,3,1,4,0.00,79.27,57.14
10,008,01,010,0007,0008,576,29,605,879,0,5,2,7,3,1,4,0.00,68.83,57.14
10,008,01,010,0015,0009,593,33,626,1050,0,5,2,7,3,1,4,0.00,59.62,57.14
10,008,01,010,0001,0000,595,29,624,870,0,5,2,7,3,1,4,0.00,71.72,57.14
10,008,01,010,0015,0010,750,30,780,1143,0,5,2,7,3,1,4,0.00,68.24,57.14
10,008,01,010,0015,0011,740,26,766,1112,0,5,2,7,3,1,4,0.00,68.88,57.14
10,008,01,010,0015,0012,553,32,585,880,0,5,2,7,3,1,4,0.00,66.48,57.14
10,008,01,010,0015,0013,596,29,625,991,0,5,2,7,3,1,4,0.00,63.07,57.14
10,008,01,010,0016,0014,644,27,671,975,0,5,2,7,3,1,4,0.00,68.82,57.14
10,008,01,010,0016,0015,399,16,415,624,0,5,2,7,3,1,4,0.00,66.51,57.14
10,008,01,010,0016,0016,678,35,713,1001,0,5,2,7,3,1,4,0.00,71.23,57.14
10,008,01,010,0017,0017,725,41,766,1091,0,5,2,7,3,1,4,0.00,70.21,57.14
10,008,01,010,0017,0018,615,24,639,942,0,5,2,7,3,1,4,0.00,67.83,57.14
10,008,01,010,0018,0019,736,31,767,1066,0,5,2,7,3,1,4,0.00,71.95,57.14
10,008,01,010,0002,0000,922,48,970,1317,0,5,2,7,3,1,4,0.00,73.65,57.14
10,008,01,010,0018,0020,613,23,636,930,0,5,2,7,3,1,4,0.00,68.39,57.14
10,008,01,010,0018,0021,753,27,780,1132,0,5,2,7,3,1,4,0.00,68.90,57.14
10,008,01,010,0018,0022,665,38,703,1171,0,5,2,7,3,1,4,0.00,60.03,57.14
10,008,01,010,0003,0000,512,35,547,771,0,5,2,7,3,1,4,0.00,70.95,57.14
10,008,01,010,0004,0000,337,16,353,471,0,5,2,7,3,1,4,0.00,74.95,57.14
10,008,01,010,0005,0000,338,28,366,533,0,5,2,7,3,1,4,0.00,68.67,57.14
10,008,01,010,0006,0000,245,15,260,328,0,5,2,7,3,1,4,0.00,79.27,57.14
10,008,01,010,0007,0000,576,29,605,879,0,5,2,7,3,1,4,0.00,68.83,57.14
10,008,01,010,0015,0000,3232,150,3382,5176,0,5,2,7,3,1,4,0.00,65.34,57.14
10,008,01,010,0016,0000,1721,78,1799,2600,0,5,2,7,3,1,4,0.00,69.19,57.14
10,008,01,010,0017,0000,1340,65,1405,2033,0,5,2,7,3,1,4,0.00,69.11,57.14
10,008,01,010,0018,0000,2767,119,2886,4299,0,5,2,7,3,1,4,0.00,67.13,57.14
10,008,01,020,0001,0000,1544,76,1620,2462,0,4,2,6,3,2,5,0.00,65.80,83.33
10,008,01,020,0001,0085,447,27,474,734,0,4,2,6,3,2,5,0.00,64.58,83.33
10,008,01,020,0001,0086,487,18,505,757,0,4,2,6,3,2,5,0.00,66.71,83.33
10,008,01,020,0001,0087,610,31,641,971,0,4,2,6,3,2,5,0.00,66.01,83.33
10,008,01,020,0031,0088,806,28,834,1266,0,4,2,6,3,2,5,0.00,65.88,83.33
10,008,01,020,0031,0089,764,35,799,1210,0,4,2,6,3,2,5,0.00,66.03,83.33
10,008,01,020,0010,0090,741,38,779,1220,0,4,2,6,3,2,5,0.00,63.85,83.33
10,008,01,020,0010,0091,493,16,509,816,0,4,2,6,3,2,5,0.00,62.38,83.33
10,008,01,020,0010,0092,749,17,766,1268,0,4,2,6,3,2,5,0.00,60.41,83.33
10,008,01,020,0010,0093,763,25,788,1267,0,4,2,6,3,2,5,0.00,62.19,83.33
10,008,01,020,0010,0094,757,38,795,1350,0,4,2,6,3,2,5,0.00,58.89,83.33
10,008,01,020,0010,0095,805,23,828,1278,0,4,2,6,3,2,5,0.00,64.79,83.33
10,008,01,020,0011,0096,687,25,712,1108,0,4,2,6,3,2,5,0.00,64.26,83.33
10,008,01,020,0011,0097,681,15,696,1162,0,4,2,6,3,2,5,0.00,59.90,83.33
10,008,01,020,0011,0098,327,9,336,489,0,4,2,6,3,2,5,0.00,68.71,83.33
10,008,01,020,0011,0099,615,18,633,916,0,4,2,6,3,2,5,0.00,69.10,83.33
10,008,01,020,0010,0000,4308,157,4465,7199,0,4,2,6,3,2,5,0.00,62.02,83.33
10,008,01,020,0012,0100,603,14,617,966,0,4,2,6,3,2,5,0.00,63.87,83.33
10,008,01,020,0013,0101,739,18,757,1067,0,4,2,6,3,2,5,0.00,70.95,83.33
10,008,01,020,0014,0102,688,23,711,1052,0,4,2,6,3,2,5,0.00,67.59,83.33
10,008,01,020,0011,0000,2310,67,2377,3675,0,4,2,6,3,2,5,0.00,64.68,83.33
10,008,01,020,0012,0000,603,14,617,966,0,4,2,6,3,2,5,0.00,63.87,83.33
10,008,01,020,0013,0000,739,18,757,1067,0,4,2,6,3,2,5,0.00,70.95,83.33
10,008,01,020,0014,0000,688,23,711,1052,0,4,2,6,3,2,5,0.00,67.59,83.33
10,008,01,020,0031,0000,1570,63,1633,2476,0,4,2,6,3,2,5,0.00,65.95,83.33
10,008,01,030,0001,0000,1298,71,1369,2010,0,5,1,6,3,1,4,0.00,68.11,66.67
10,008,01,030,0002,0000,1134,89,1223,1957,0,5,1,6,3,1,4,0.00,62.49,66.67
10,008,01,030,0003,0000,665,36,701,1023,0,5,1,6,3,1,4,0.00,68.52,66.67
10,008,01,030,0004,0000,3897,176,4073,6222,0,5,1,6,3,1,4,0.00,65.46,66.67
10,008,01,030,0001,0154,604,34,638,927,0,5,1,6,3,1,4,0.00,68.82,66.67
10,008,01,030,0001,0155,694,37,731,1083,0,5,1,6,3,1,4,0.00,67.50,66.67
10,008,01,030,0026,0156,787,77,864,1353,0,5,1,6,3,1,4,0.00,63.86,66.67
10,008,01,030,0026,0157,602,37,639,1035,0,5,1,6,3,1,4,0.00,61.74,66.67
10,008,01,030,0026,0158,726,32,758,1189,0,5,1,6,3,1,4,0.00,63.75,66.67
10,008,01,030,0002,0159,550,41,591,980,0,5,1,6,3,1,4,0.00,60.31,66.67
10,008,01,030,0002,0160,584,48,632,977,0,5,1,6,3,1,4,0.00,64.69,66.67
10,008,01,030,0024,0161,421,36,457,632,0,5,1,6,3,1,4,0.00,72.31,66.67
10,008,01,030,0003,0162,665,36,701,1023,0,5,1,6,3,1,4,0.00,68.52,66.67
10,008,01,030,0025,0163,646,55,701,1094,0,5,1,6,3,1,4,0.00,64.08,66.67
10,008,01,030,0025,0164,714,49,763,1177,0,5,1,6,3,1,4,0.00,64.83,66.67
10,008,01,030,0004,0165,762,30,792,1203,0,5,1,6,3,1,4,0.00,65.84,66.67
10,008,01,030,0004,0166,696,39,735,1195,0,5,1,6,3,1,4,0.00,61.51,66.67
10,008,01,030,0004,0167,740,40,780,1198,0,5,1,6,3,1,4,0.00,65.11,66.67
10,008,01,030,0004,0168,885,44,929,1406,0,5,1,6,3,1,4,0.00,66.07,66.67
10,008,01,030,0004,0169,814,23,837,1220,0,5,1,6,3,1,4,0.00,68.61,66.67
10,008,01,030,0024,0000,421,36,457,632,0,5,1,6,3,1,4,0.00,72.31,66.67
10,008,01,030,0025,0000,1360,104,1464,2271,0,5,1,6,3,1,4,0.00,64.46,66.67
10,008,01,030,0026,0000,2115,146,2261,3577,0,5,1,6,3,1,4,0.00,63.21,66.67
10,008,01,040,0001,0000,1243,34,1277,1869,0,8,2,10,5,1,6,0.00,68.33,60.00
10,008,01,040,0002,0000,399,20,419,572,0,8,2,10,5,1,6,0.00,73.25,60.00
10,008,01,040,0003,0000,2874,82,2956,4458,0,8,2,10,5,1,6,0.00,66.31,60.00
10,008,01,040,0004,0000,2097,83,2180,3348,0,8,2,10,5,1,6,0.00,65.11,60.00
10,008,01,040,0006,0000,715,37,752,1130,0,8,2,10,5,1,6,0.00,66.55,60.00
10,008,01,040,0007,0000,2252,59,2311,3504,0,8,2,10,5,1,6,0.00,65.95,60.00
10,008,01,040,0008,0000,600,19,619,862,0,8,2,10,5,1,6,0.00,71.81,60.00
10,008,01,040,0009,0000,828,41,869,1366,0,8,2,10,5,1,6,0.00,63.62,60.00
10,008,01,040,0019,0000,218,9,227,375,0,8,2,10,5,1,6,0.00,60.53,60.00
10,008,01,040,0001,0231,719,19,738,1100,0,8,2,10,5,1,6,0.00,67.09,60.00
10,008,01,040,0001,0232,524,15,539,769,0,8,2,10,5,1,6,0.00,70.09,60.00
10,008,01,040,0002,0233,399,20,419,572,0,8,2,10,5,1,6,0.00,73.25,60.00
10,008,01,040,0003,0234,549,16,565,843,0,8,2,10,5,1,6,0.00,67.02,60.00
10,008,01,040,0003,0235,691,22,713,1111,0,8,2,10,5,1,6,0.00,64.18,60.00
10,008,01,040,0003,0236,727,23,750,1176,0,8,2,10,5,1,6,0.00,63.78,60.00
10,008,01,040,0003,0237,907,21,928,1328,0,8,2,10,5,1,6,0.00,69.88,60.00
10,008,01,040,0004,0238,673,20,693,1076,0,8,2,10,5,1,6,0.00,64.41,60.00
10,008,01,040,0004,0239,619,22,641,1016,0,8,2,10,5,1,6,0.00,63.09,60.00
10,008,01,040,0004,0240,805,41,846,1256,0,8,2,10,5,1,6,0.00,67.36,60.00
10,008,01,040,0028,0241,663,24,687,1042,0,8,2,10,5,1,6,0.00,65.93,60.00
10,008,01,040,0028,0242,680,25,705,1117,0,8,2,10,5,1,6,0.00,63.12,60.00
10,008,01,040,0007,0243,791,18,809,1237,0,8,2,10,5,1,6,0.00,65.40,60.00
10,008,01,040,0007,0244,824,33,857,1266,0,8,2,10,5,1,6,0.00,67.69,60.00
10,008,01,040,0007,0245,637,8,645,1001,0,8,2,10,5,1,6,0.00,64.44,60.00
10,008,01,040,0006,0246,305,13,318,463,0,8,2,10,5,1,6,0.00,68.68,60.00
10,008,01,040,0006,0247,410,24,434,667,0,8,2,10,5,1,6,0.00,65.07,60.00
10,008,01,040,0008,0248,600,19,619,862,0,8,2,10,5,1,6,0.00,71.81,60.00
10,008,01,040,0009,0249,828,41,869,1366,0,8,2,10,5,1,6,0.00,63.62,60.00
10,008,01,040,0026,0250,123,4,127,190,0,8,2,10,5,1,6,0.00,66.84,60.00
10,008,01,040,0026,0251,284,19,303,431,0,8,2,10,5,1,6,0.00,70.30,60.00
10,008,01,040,0019,0252,218,9,227,375,0,8,2,10,5,1,6,0.00,60.53,60.00
10,008,01,040,0026,0000,407,23,430,621,0,8,2,10,5,1,6,0.00,69.24,60.00
10,008,01,040,0028,0000,1343,49,1392,2159,0,8,2,10,5,1,6,0.00,64.47,60.00
10,008,01,050,0001,0000,763,20,783,1030,0,5,1,6,2,1,3,0.00,76.02,50.00
10,008,01,050,0002,0000,643,12,655,853,0,5,1,6,2,1,3,0.00,76.79,50.00
10,008,01,050,0003,0000,372,8,380,531,0,5,1,6,2,1,3,0.00,71.56,50.00
10,008,01,050,0001,0284,763,20,783,1030,0,5,1,6,2,1,3,0.00,76.02,50.00
10,008,01,050,0002,0285,643,12,655,853,0,5,1,6,2,1,3,0.00,76.79,50.00
10,008,01,050,0003,0286,372,8,380,531,0,5,1,6,2,1,3,0.00,71.56,50.00
10,008,01,060,0001,0000,622,32,654,954,0,7,1,8,5,1,6,0.00,68.55,75.00
10,008,01,060,0002,0000,2234,94,2328,3255,0,7,1,8,5,1,6,0.00,71.52,75.00
10,008,01,060,0003,0000,1386,65,1451,2105,0,7,1,8,5,1,6,0.00,68.93,75.00
10,008,01,060,0004,0000,947,75,1022,1481,0,7,1,8,5,1,6,0.00,69.01,75.00
10,008,01,060,0005,0000,632,42,674,920,0,7,1,8,5,1,6,0.00,73.26,75.00
10,008,01,060,0006,0000,698,25,723,931,0,7,1,8,5,1,6,0.00,77.66,75.00
10,008,01,060,0007,0000,2626,157,2783,4042,0,7,1,8,5,1,6,0.00,68.85,75.00
10,008,01,060,0008,0000,996,69,1065,1545,0,7,1,8,5,1,6,0.00,68.93,75.00
10,008,01,060,0009,0000,657,31,688,891,0,7,1,8,5,1,6,0.00,77.22,75.00
10,008,01,060,0023,0000,586,30,616,820,0,7,1,8,5,1,6,0.00,75.12,75.00
10,008,01,060,0001,0298,622,32,654,954,0,7,1,8,5,1,6,0.00,68.55,75.00
10,008,01,060,0002,0299,574,23,597,868,0,7,1,8,5,1,6,0.00,68.78,75.00
10,008,01,060,0002,0300,452,23,475,654,0,7,1,8,5,1,6,0.00,72.63,75.00
10,008,01,060,0002,0301,587,27,614,830,0,7,1,8,5,1,6,0.00,73.98,75.00
10,008,01,060,0002,0302,621,21,642,903,0,7,1,8,5,1,6,0.00,71.10,75.00
10,008,01,060,0003,0303,607,28,635,1000,0,7,1,8,5,1,6,0.00,63.50,75.00
10,008,01,060,0003,0304,779,37,816,1105,0,7,1,8,5,1,6,0.00,73.85,75.00
10,008,01,060,0004,0305,453,40,493,749,0,7,1,8,5,1,6,0.00,65.82,75.00
10,008,01,060,0004,0306,494,35,529,732,0,7,1,8,5,1,6,0.00,72.27,75.00
10,008,01,060,0006,0307,698,25,723,931,0,7,1,8,5,1,6,0.00,77.66,75.00
10,008,01,060,0005,0308,632,42,674,920,0,7,1,8,5,1,6,0.00,73.26,75.00
10,008,01,060,0007,0309,577,31,608,906,0,7,1,8,5,1,6,0.00,67.11,75.00
10,008,01,060,0007,0310,656,37,693,985,0,7,1,8,5,1,6,0.00,70.36,75.00
10,008,01,060,0007,0311,616,43,659,963,0,7,1,8,5,1,6,0.00,68.43,75.00
10,008,01,060,0007,0312,777,46,823,1188,0,7,1,8,5,1,6,0.00,69.28,75.00
10,008,01,060,0008,0313,433,33,466,687,0,7,1,8,5,1,6,0.00,67.83,75.00
10,008,01,060,0008,0314,563,36,599,858,0,7,1,8,5,1,6,0.00,69.81,75.00
10,008,01,060,0023,0315,586,30,616,820,0,7,1,8,5,1,6,0.00,75.12,75.00
10,008,01,060,0009,0316,657,31,688,891,0,7,1,8,5,1,6,0.00,77.22,75.00
10,008,01,070,0001,0000,1113,40,1153,1735,0,5,2,7,4,2,6,0.00,66.46,85.71
10,008,01,070,0003,0000,863,30,893,1224,0,5,2,7,4,2,6,0.00,72.96,85.71
10,008,01,070,0004,0000,1161,59,1220,1844,0,5,2,7,4,2,6,0.00,66.16,85.71
10,008,01,070,0009,0000,836,24,860,1270,0,5,2,7,4,2,6,0.00,67.72,85.71
10,008,01,070,0010,0000,993,39,1032,1508,0,5,2,7,4,2,6,0.00,68.44,85.71
10,008,01,070,0001,0335,560,16,576,892,0,5,2,7,4,2,6,0.00,64.57,85.71
10,008,01,070,0001,0336,553,24,577,843,0,5,2,7,4,2,6,0.00,68.45,85.71
10,008,01,070,0003,0337,562,17,579,805,0,5,2,7,4,2,6,0.00,71.93,85.71
10,008,01,070,0003,0338,301,13,314,419,0,5,2,7,4,2,6,0.00,74.94,85.71
10,008,01,070,0004,0339,507,21,528,771,0,5,2,7,4,2,6,0.00,68.48,85.71
10,008,01,070,0004,0340,654,38,692,1073,0,5,2,7,4,2,6,0.00,64.49,85.71
10,008,01,070,0010,0341,470,13,483,708,0,5,2,7,4,2,6,0.00,68.22,85.71
10,008,01,070,0010,0342,523,26,549,800,0,5,2,7,4,2,6,0.00,68.63,85.71
10,008,01,070,0009,0343,490,15,505,762,0,5,2,7,4,2,6,0.00,66.27,85.71
10,008,01,070,0009,0344,346,9,355,508,0,5,2,7,4,2,6,0.00,69.88,85.71
10,008,01,080,0001,0000,559,14,573,753,0,4,1,5,2,1,3,0.00,76.10,60.00
10,008,01,080,0002,0000,297,10,307,438,0,4,1,5,2,1,3,0.00,70.09,60.00
10,008,01,080,0003,0000,511,15,526,720,0,4,1,5,2,1,3,0.00,73.06,60.00
10,008,01,080,0004,0000,403,9,412,605,0,4,1,5,2,1,3,0.00,68.10,60.00
10,008,01,080,0005,0000,464,10,474,646,0,4,1,5,2,1,3,0.00,73.37,60.00
10,008,01,080,0007,0000,198,6,204,276,0,4,1,5,2,1,3,0.00,73.91,60.00
10,008,01,080,0001,0356,559,14,573,753,0,4,1,5,2,1,3,0.00,76.10,60.00
10,008,01,080,0002,0357,165,5,170,234,0,4,1,5,2,1,3,0.00,72.65,60.00
10,008,01,080,0002,0358,132,5,137,204,0,4,1,5,2,1,3,0.00,67.16,60.00
10,008,01,080,0003,0359,239,9,248,324,0,4,1,5,2,1,3,0.00,76.54,60.00
10,008,01,080,0003,0360,272,6,278,396,0,4,1,5,2,1,3,0.00,70.20,60.00
10,008,01,080,0005,0361,256,5,261,354,0,4,1,5,2,1,3,0.00,73.73,60.00
10,008,01,080,0005,0362,208,5,213,292,0,4,1,5,2,1,3,0.00,72.95,60.00
10,008,01,080,0004,0363,403,9,412,605,0,4,1,5,2,1,3,0.00,68.10,60.00
10,008,01,080,0007,0364,198,6,204,276,0,4,1,5,2,1,3,0.00,73.91,60.00
10,008,01,090,0001,0000,1031,36,1067,1509,0,5,3,8,4,2,6,0.00,70.71,75.00
10,008,01,090,0002,0000,1249,35,1284,1863,0,5,3,8,4,2,6,0.00,68.92,75.00
10,008,01,090,0005,0000,719,7,726,1012,0,5,3,8,4,2,6,0.00,71.74,75.00
10,008,01,090,0006,0000,858,8,866,1186,0,5,3,8,4,2,6,0.00,73.02,75.00
10,008,01,090,0007,0000,733,17,750,959,0,5,3,8,4,2,6,0.00,78.21,75.00
10,008,01,090,0002,0380,578,17,595,864,0,5,3,8,4,2,6,0.00,68.87,75.00
10,008,01,090,0002,0381,671,18,689,999,0,5,3,8,4,2,6,0.00,68.97,75.00
10,008,01,090,0001,0382,467,16,483,695,0,5,3,8,4,2,6,0.00,69.50,75.00
10,008,01,090,0001,0383,564,20,584,814,0,5,3,8,4,2,6,0.00,71.74,75.00
10,008,01,090,0005,0384,332,4,336,467,0,5,3,8,4,2,6,0.00,71.95,75.00
10,008,01,090,0005,0385,387,3,390,545,0,5,3,8,4,2,6,0.00,71.56,75.00
10,008,01,090,0006,0386,407,7,414,564,0,5,3,8,4,2,6,0.00,73.40,75.00
10,008,01,090,0006,0387,451,1,452,622,0,5,3,8,4,2,6,0.00,72.67,75.00
10,008,01,090,0007,0388,214,2,216,281,0,5,3,8,4,2,6,0.00,76.87,75.00
10,008,01,090,0007,0389,378,10,388,489,0,5,3,8,4,2,6,0.00,79.35,75.00
10,008,01,090,0007,0390,141,5,146,189,0,5,3,8,4,2,6,0.00,77.25,75.00
10,008,01,100,0001,0000,988,129,1117,1584,0,0,2,2,0,2,2,0.00,70.52,100.00
10,008,01,100,0002,0000,982,172,1154,1634,0,0,2,2,0,2,2,0.00,70.62,100.00
10,008,01,100,0001,0406,568,82,650,903,0,0,2,2,0,2,2,0.00,71.98,100.00
10,008,01,100,0001,0407,420,47,467,681,0,0,2,2,0,2,2,0.00,68.58,100.00
10,008,01,100,0002,0408,470,72,542,753,0,0,2,2,0,2,2,0.00,71.98,100.00
10,008,01,100,0002,0409,512,100,612,881,0,0,2,2,0,2,2,0.00,69.47,100.00
10,008,01,110,0001,0000,462,16,478,686,0,3,2,5,3,1,4,0.00,69.68,80.00
10,008,01,110,0002,0000,276,8,284,395,0,3,2,5,3,1,4,0.00,71.90,80.00
10,008,01,110,0003,0000,968,20,988,1406,0,3,2,5,3,1,4,0.00,70.27,80.00
10,008,01,110,0004,0000,396,12,408,558,0,3,2,5,3,1,4,0.00,73.12,80.00
10,008,01,110,0005,0000,644,13,657,841,0,3,2,5,3,1,4,0.00,78.12,80.00
10,008,01,110,0010,0000,319,8,327,417,0,3,2,5,3,1,4,0.00,78.42,80.00
10,008,01,110,0011,0000,463,13,476,599,0,3,2,5,3,1,4,0.00,79.47,80.00
10,008,01,110,0001,0426,462,16,478,686,0,3,2,5,3,1,4,0.00,69.68,80.00
10,008,01,110,0003,0427,349,6,355,497,0,3,2,5,3,1,4,0.00,71.43,80.00
10,008,01,110,0003,0428,619,14,633,909,0,3,2,5,3,1,4,0.00,69.64,80.00
10,008,01,110,0004,0429,396,12,408,558,0,3,2,5,3,1,4,0.00,73.12,80.00
10,008,01,110,0005,0430,644,13,657,841,0,3,2,5,3,1,4,0.00,78.12,80.00
10,008,01,110,0002,0431,276,8,284,395,0,3,2,5,3,1,4,0.00,71.90,80.00
10,008,01,110,0010,0432,319,8,327,417,0,3,2,5,3,1,4,0.00,78.42,80.00
10,008,01,110,0011,0433,463,13,476,599,0,3,2,5,3,1,4,0.00,79.47,80.00
10,008,01,120,0004,0000,993,21,1014,1408,0,3,2,5,2,1,3,0.00,72.02,60.00
10,008,01,120,0005,0000,321,11,332,462,0,3,2,5,2,1,3,0.00,71.86,60.00
10,008,01,120,0006,0000,509,6,515,679,0,3,2,5,2,1,3,0.00,75.85,60.00
10,008,01,120,0014,0000,402,15,417,607,0,3,2,5,2,1,3,0.00,68.70,60.00
10,008,01,120,0004,0448,372,11,383,526,0,3,2,5,2,1,3,0.00,72.81,60.00
10,008,01,120,0004,0449,399,7,406,584,0,3,2,5,2,1,3,0.00,69.52,60.00
10,008,01,120,0004,0450,222,3,225,298,0,3,2,5,2,1,3,0.00,75.50,60.00
10,008,01,120,0005,0451,321,11,332,462,0,3,2,5,2,1,3,0.00,71.86,60.00
10,008,01,120,0006,0452,285,5,290,383,0,3,2,5,2,1,3,0.00,75.72,60.00
10,008,01,120,0006,0453,224,1,225,296,0,3,2,5,2,1,3,0.00,76.01,60.00
10,008,01,120,0014,0454,402,15,417,607,0,3,2,5,2,1,3,0.00,68.70,60.00
10,008,01,130,0009,0000,1136,17,1153,1586,0,3,2,5,2,1,3,0.00,72.70,60.00
10,008,01,130,0010,0000,907,22,929,1204,0,3,2,5,2,1,3,0.00,77.16,60.00
10,008,01,130,0014,0000,27,0,27,47,0,3,2,5,2,1,3,0.00,57.45,60.00
10,008,01,130,0010,0470,660,12,672,856,0,3,2,5,2,1,3,0.00,78.50,60.00
10,008,01,130,0010,0471,247,10,257,348,0,3,2,5,2,1,3,0.00,73.85,60.00
10,008,01,130,0009,0472,583,13,596,815,0,3,2,5,2,1,3,0.00,73.13,60.00
10,008,01,130,0009,0473,320,1,321,463,0,3,2,5,2,1,3,0.00,69.33,60.00
10,008,01,130,0009,0474,233,3,236,308,0,3,2,5,2,1,3,0.00,76.62,60.00
10,008,01,130,0014,0475,27,0,27,47,0,3,2,5,2,1,3,0.00,57.45,60.00
10,008,00,020,0000,0000,41347,1678,43025,65006,77340,16,7,23,11,5,16,84.05,66.19,69.57
10,008,01,020,0000,0000,11762,418,12180,18897,22882,4,2,6,3,2,5,82.58,64.45,83.33
10,008,02,020,0000,0000,11166,519,11685,18008,21504,4,3,7,3,2,5,83.74,64.89,71.43
10,008,03,020,0000,0000,8786,402,9188,14235,16630,4,1,5,2,1,3,85.60,64.55,60.00
10,008,04,020,0000,0000,9633,339,9972,13866,16324,4,1,5,3,0,3,84.94,71.92,60.00
10,008,02,010,0012,0023,546,33,579,952,0,7,3,10,5,2,7,0.00,60.82,70.00
10,008,02,010,0012,0024,521,23,544,832,0,7,3,10,5,2,7,0.00,65.38,70.00
10,008,02,010,0012,0025,597,25,622,885,0,7,3,10,5,2,7,0.00,70.28,70.00
10,008,02,010,0012,0026,763,40,803,1130,0,7,3,10,5,2,7,0.00,71.06,70.00
10,008,02,010,0012,0027,563,43,606,919,0,7,3,10,5,2,7,0.00,65.94,70.00
10,008,02,010,0012,0028,681,32,713,1164,0,7,3,10,5,2,7,0.00,61.25,70.00
10,008,02,010,0013,0029,387,20,407,556,0,7,3,10,5,2,7,0.00,73.20,70.00
10,008,02,010,0013,0030,536,21,557,710,0,7,3,10,5,2,7,0.00,78.45,70.00
10,008,02,010,0013,0031,494,26,520,680,0,7,3,10,5,2,7,0.00,76.47,70.00
10,008,02,010,0014,0032,687,39,726,981,0,7,3,10,5,2,7,0.00,74.01,70.00
10,008,02,010,0010,0033,834,38,872,1263,0,7,3,10,5,2,7,0.00,69.04,70.00
10,008,02,010,0010,0034,929,40,969,1357,0,7,3,10,5,2,7,0.00,71.41,70.00
10,008,02,010,0010,0035,924,32,956,1464,0,7,3,10,5,2,7,0.00,65.30,70.00
10,008,02,010,0011,0036,226,10,236,344,0,7,3,10,5,2,7,0.00,68.60,70.00
10,008,02,010,0028,0037,792,26,818,1101,0,7,3,10,5,2,7,0.00,74.30,70.00
10,008,02,010,0028,0038,872,30,902,1235,0,7,3,10,5,2,7,0.00,73.04,70.00
10,008,02,010,0027,0039,610,33,643,890,0,7,3,10,5,2,7,0.00,72.25,70.00
10,008,02,010,0027,0040,598,32,630,895,0,7,3,10,5,2,7,0.00,70.39,70.00
10,008,02,010,0027,0041,649,23,672,977,0,7,3,10,5,2,7,0.00,68.78,70.00
10,008,02,010,0027,0042,679,23,702,1015,0,7,3,10,5,2,7,0.00,69.16,70.00
10,008,02,010,0027,0043,705,31,736,1059,0,7,3,10,5,2,7,0.00,69.50,70.00
10,008,02,010,0027,0044,549,23,572,805,0,7,3,10,5,2,7,0.00,71.06,70.00
10,008,02,010,0029,0045,445,15,460,615,0,7,3,10,5,2,7,0.00,74.80,70.00
10,008,02,010,0029,0046,601,25,626,942,0,7,3,10,5,2,7,0.00,66.45,70.00
10,008,02,010,0029,0047,716,32,748,1159,0,7,3,10,5,2,7,0.00,64.54,70.00
10,008,02,010,0029,0048,689,33,722,1120,0,7,3,10,5,2,7,0.00,64.46,70.00
10,008,02,010,0029,0049,709,35,744,1115,0,7,3,10,5,2,7,0.00,66.73,70.00
10,008,02,010,0030,0050,761,25,786,1045,0,7,3,10,5,2,7,0.00,75.22,70.00
10,008,02,010,0030,0051,761,29,790,1093,0,7,3,10,5,2,7,0.00,72.28,70.00
10,008,02,010,0030,0052,736,25,761,1048,0,7,3,10,5,2,7,0.00,72.61,70.00
10,008,02,010,0034,0053,320,21,341,471,0,7,3,10,5,2,7,0.00,72.40,70.00
10,008,02,010,0032,0054,597,20,617,915,0,7,3,10,5,2,7,0.00,67.43,70.00
10,008,02,010,0033,0055,495,19,514,793,0,7,3,10,5,2,7,0.00,64.82,70.00
10,008,02,010,0031,0056,407,30,437,659,0,7,3,10,5,2,7,0.00,66.31,70.00
10,008,02,010,0010,0000,2687,110,2797,4084,0,7,3,10,5,2,7,0.00,68.49,70.00
10,008,02,010,0011,0000,226,10,236,344,0,7,3,10,5,2,7,0.00,68.60,70.00
10,008,02,010,0012,0000,3671,196,3867,5882,0,7,3,10,5,2,7,0.00,65.74,70.00
10,008,02,010,0013,0000,1417,67,1484,1946,0,7,3,10,5,2,7,0.00,76.26,70.00
10,008,02,010,0014,0000,687,39,726,981,0,7,3,10,5,2,7,0.00,74.01,70.00
10,008,02,010,0027,0000,3790,165,3955,5641,0,7,3,10,5,2,7,0.00,70.11,70.00
10,008,02,010,0028,0000,1664,56,1720,2336,0,7,3,10,5,2,7,0.00,73.63,70.00
10,008,02,010,0029,0000,3160,140,3300,4951,0,7,3,10,5,2,7,0.00,66.65,70.00
10,008,02,010,0030,0000,2258,79,2337,3186,0,7,3,10,5,2,7,0.00,73.35,70.00
10,008,02,010,0031,0000,407,30,437,659,0,7,3,10,5,2,7,0.00,66.31,70.00
10,008,02,010,0032,0000,597,20,617,915,0,7,3,10,5,2,7,0.00,67.43,70.00
10,008,02,010,0033,0000,495,19,514,793,0,7,3,10,5,2,7,0.00,64.82,70.00
10,008,02,010,0034,0000,320,21,341,471,0,7,3,10,5,2,7,0.00,72.40,70.00
10,008,02,020,0002,0000,510,33,543,743,0,4,3,7,3,2,5,0.00,73.08,71.43
10,008,02,020,0003,0000,1714,93,1807,2824,0,4,3,7,3,2,5,0.00,63.99,71.43
10,008,02,020,0004,0000,1324,80,1404,2367,0,4,3,7,3,2,5,0.00,59.32,71.43
10,008,02,020,0003,0103,483,25,508,820,0,4,3,7,3,2,5,0.00,61.95,71.43
10,008,02,020,0003,0104,544,23,567,908,0,4,3,7,3,2,5,0.00,62.44,71.43
10,008,02,020,0003,0105,687,45,732,1096,0,4,3,7,3,2,5,0.00,66.79,71.43
10,008,02,020,0002,0106,510,33,543,743,0,4,3,7,3,2,5,0.00,73.08,71.43
10,008,02,020,0004,0107,577,42,619,1170,0,4,3,7,3,2,5,0.00,52.91,71.43
10,008,02,020,0004,0108,747,38,785,1197,0,4,3,7,3,2,5,0.00,65.58,71.43
10,008,02,020,0030,0109,590,19,609,912,0,4,3,7,3,2,5,0.00,66.78,71.43
10,008,02,020,0030,0110,700,21,721,1093,0,4,3,7,3,2,5,0.00,65.97,71.43
10,008,02,020,0030,0111,656,32,688,999,0,4,3,7,3,2,5,0.00,68.87,71.43
10,008,02,020,0032,0112,614,27,641,976,0,4,3,7,3,2,5,0.00,65.68,71.43
10,008,02,020,0032,0113,577,38,615,1000,0,4,3,7,3,2,5,0.00,61.50,71.43
10,008,02,020,0032,0114,681,22,703,1048,0,4,3,7,3,2,5,0.00,67.08,71.43
10,008,02,020,0033,0115,680,26,706,1022,0,4,3,7,3,2,5,0.00,69.08,71.43
10,008,02,020,0033,0116,613,23,636,976,0,4,3,7,3,2,5,0.00,65.16,71.43
10,008,02,020,0027,0117,478,25,503,715,0,4,3,7,3,2,5,0.00,70.35,71.43
10,008,02,020,0027,0118,628,29,657,918,0,4,3,7,3,2,5,0.00,71.57,71.43
10,008,02,020,0028,0119,635,31,666,1123,0,4,3,7,3,2,5,0.00,59.31,71.43
10,008,02,020,0028,0120,518,15,533,890,0,4,3,7,3,2,5,0.00,59.89,71.43
10,008,02,020,0028,0121,248,5,253,402,0,4,3,7,3,2,5,0.00,62.94,71.43
10,008,02,020,0027,0000,1106,54,1160,1633,0,4,3,7,3,2,5,0.00,71.03,71.43
10,008,02,020,0028,0000,1401,51,1452,2415,0,4,3,7,3,2,5,0.00,60.12,71.43
10,008,02,020,0030,0000,1946,72,2018,3004,0,4,3,7,3,2,5,0.00,67.18,71.43
10,008,02,020,0032,0000,1872,87,1959,3024,0,4,3,7,3,2,5,0.00,64.78,71.43
10,008,02,020,0033,0000,1293,49,1342,1998,0,4,3,7,3,2,5,0.00,67.17,71.43
10,008,02,030,0005,0000,4482,213,4695,7343,0,6,1,7,4,1,5,0.00,63.94,71.43
10,008,02,030,0009,0000,2757,91,2848,4405,0,6,1,7,4,1,5,0.00,64.65,71.43
10,008,02,030,0010,0000,1618,44,1662,2399,0,6,1,7,4,1,5,0.00,69.28,71.43
10,008,02,030,0011,0000,1711,64,1775,2780,0,6,1,7,4,1,5,0.00,63.85,71.43
10,008,02,030,0012,0000,1982,68,2050,3064,0,6,1,7,4,1,5,0.00,66.91,71.43
10,008,02,030,0005,0170,753,36,789,1197,0,6,1,7,4,1,5,0.00,65.91,71.43
10,008,02,030,0005,0171,680,43,723,1196,0,6,1,7,4,1,5,0.00,60.45,71.43
10,008,02,030,0005,0172,679,18,697,1130,0,6,1,7,4,1,5,0.00,61.68,71.43
10,008,02,030,0005,0173,681,32,713,1128,0,6,1,7,4,1,5,0.00,63.21,71.43
10,008,02,030,0005,0174,882,42,924,1388,0,6,1,7,4,1,5,0.00,66.57,71.43
10,008,02,030,0005,0175,807,42,849,1304,0,6,1,7,4,1,5,0.00,65.11,71.43
10,008,02,030,0027,0176,640,30,670,940,0,6,1,7,4,1,5,0.00,71.28,71.43
10,008,02,030,0027,0177,848,38,886,1296,0,6,1,7,4,1,5,0.00,68.36,71.43
10,008,02,030,0027,0178,585,30,615,876,0,6,1,7,4,1,5,0.00,70.21,71.43
10,008,02,030,0012,0179,740,28,768,1105,0,6,1,7,4,1,5,0.00,69.50,71.43
10,008,02,030,0012,0180,624,18,642,986,0,6,1,7,4,1,5,0.00,65.11,71.43
10,008,02,030,0012,0181,618,22,640,973,0,6,1,7,4,1,5,0.00,65.78,71.43
10,008,02,030,0009,0182,625,30,655,1015,0,6,1,7,4,1,5,0.00,64.53,71.43
10,008,02,030,0009,0183,685,17,702,1019,0,6,1,7,4,1,5,0.00,68.89,71.43
10,008,02,030,0009,0184,672,27,699,1130,0,6,1,7,4,1,5,0.00,61.86,71.43
10,008,02,030,0009,0185,775,17,792,1241,0,6,1,7,4,1,5,0.00,63.82,71.43
10,008,02,030,0010,0186,990,16,1006,1392,0,6,1,7,4,1,5,0.00,72.27,71.43
10,008,02,030,0010,0187,628,28,656,1007,0,6,1,7,4,1,5,0.00,65.14,71.43
10,008,02,030,0011,0188,670,22,692,1039,0,6,1,7,4,1,5,0.00,66.60,71.43
10,008,02,030,0011,0189,506,22,528,814,0,6,1,7,4,1,5,0.00,64.86,71.43
10,008,02,030,0011,0190,535,20,555,927,0,6,1,7,4,1,5,0.00,59.87,71.43
10,008,02,030,0027,0000,2073,98,2171,3112,0,6,1,7,4,1,5,0.00,69.76,71.43
10,008,02,040,0011,0000,1712,70,1782,2665,0,5,3,8,2,3,5,0.00,66.87,62.50
10,008,02,040,0012,0000,1004,36,1040,1606,0,5,3,8,2,3,5,0.00,64.76,62.50
10,008,02,040,0013,0000,495,29,524,793,0,5,3,8,2,3,5,0.00,66.08,62.50
10,008,02,040,0014,0000,2876,130,3006,4683,0,5,3,8,2,3,5,0.00,64.19,62.50
10,008,02,040,0015,0000,1183,42,1225,1735,0,5,3,8,2,3,5,0.00,70.61,62.50
10,008,02,040,0016,0000,849,22,871,1261,0,5,3,8,2,3,5,0.00,69.07,62.50
10,008,02,040,0017,0000,762,29,791,1081,0,5,3,8,2,3,5,0.00,73.17,62.50
10,008,02,040,0018,0000,389,20,409,571,0,5,3,8,2,3,5,0.00,71.63,62.50
10,008,02,040,0014,0253,835,50,885,1384,0,5,3,8,2,3,5,0.00,63.95,62.50
10,008,02,040,0014,0254,795,31,826,1245,0,5,3,8,2,3,5,0.00,66.35,62.50
10,008,02,040,0014,0255,637,22,659,1041,0,5,3,8,2,3,5,0.00,63.30,62.50
10,008,02,040,0014,0256,609,27,636,1013,0,5,3,8,2,3,5,0.00,62.78,62.50
10,008,02,040,0027,0257,816,26,842,1268,0,5,3,8,2,3,5,0.00,66.40,62.50
10,008,02,040,0027,0258,625,20,645,996,0,5,3,8,2,3,5,0.00,64.76,62.50
10,008,02,040,0027,0259,772,34,806,1181,0,5,3,8,2,3,5,0.00,68.25,62.50
10,008,02,040,0012,0260,532,14,546,850,0,5,3,8,2,3,5,0.00,64.24,62.50
10,008,02,040,0012,0261,472,22,494,756,0,5,3,8,2,3,5,0.00,65.34,62.50
10,008,02,040,0011,0262,762,43,805,1253,0,5,3,8,2,3,5,0.00,64.25,62.50
10,008,02,040,0011,0263,591,18,609,895,0,5,3,8,2,3,5,0.00,68.04,62.50
10,008,02,040,0011,0264,359,9,368,517,0,5,3,8,2,3,5,0.00,71.18,62.50
10,008,02,040,0013,0265,495,29,524,793,0,5,3,8,2,3,5,0.00,66.08,62.50
10,008,02,040,0015,0266,767,27,794,1115,0,5,3,8,2,3,5,0.00,71.21,62.50
10,008,02,040,0015,0267,416,15,431,620,0,5,3,8,2,3,5,0.00,69.52,62.50
10,008,02,040,0016,0268,849,22,871,1261,0,5,3,8,2,3,5,0.00,69.07,62.50
10,008,02,040,0017,0269,762,29,791,1081,0,5,3,8,2,3,5,0.00,73.17,62.50
10,008,02,040,0027,0000,2213,80,2293,3445,0,5,3,8,2,3,5,0.00,66.56,62.50
10,008,02,040,0018,0270,389,20,409,571,0,5,3,8,2,3,5,0.00,71.63,62.50
10,008,02,050,0004,0000,776,14,790,1075,0,2,2,4,0,2,2,0.00,73.49,50.00
10,008,02,050,0005,0000,332,18,350,450,0,2,2,4,0,2,2,0.00,77.78,50.00
10,008,02,050,0004,0287,415,11,426,584,0,2,2,4,0,2,2,0.00,72.95,50.00
10,008,02,050,0004,0288,361,3,364,491,0,2,2,4,0,2,2,0.00,74.13,50.00
10,008,02,050,0005,0289,332,18,350,450,0,2,2,4,0,2,2,0.00,77.78,50.00
10,008,02,060,0010,0000,788,151,939,1192,0,2,0,2,2,0,2,0.00,78.78,100.00
10,008,02,060,0011,0000,1098,176,1274,1737,0,2,0,2,2,0,2,0.00,73.34,100.00
10,008,02,060,0012,0000,657,37,694,885,0,2,0,2,2,0,2,0.00,78.42,100.00
10,008,02,060,0013,0000,380,72,452,690,0,2,0,2,2,0,2,0.00,65.51,100.00
10,008,02,060,0010,0317,788,151,939,1192,0,2,0,2,2,0,2,0.00,78.78,100.00
10,008,02,060,0013,0318,380,72,452,690,0,2,0,2,2,0,2,0.00,65.51,100.00
10,008,02,060,0011,0319,571,86,657,915,0,2,0,2,2,0,2,0.00,71.80,100.00
10,008,02,060,0011,0320,527,90,617,822,0,2,0,2,2,0,2,0.00,75.06,100.00
10,008,02,060,0012,0321,657,37,694,885,0,2,0,2,2,0,2,0.00,78.42,100.00
10,008,02,070,0005,0000,694,19,713,945,0,3,2,5,2,1,3,0.00,75.45,60.00
10,008,02,070,0006,0000,1002,24,1026,1396,0,3,2,5,2,1,3,0.00,73.50,60.00
10,008,02,070,0007,0000,600,16,616,865,0,3,2,5,2,1,3,0.00,71.21,60.00
10,008,02,070,0008,0000,406,7,413,593,0,3,2,5,2,1,3,0.00,69.65,60.00
10,008,02,070,0005,0345,371,10,381,530,0,3,2,5,2,1,3,0.00,71.89,60.00
10,008,02,070,0005,0346,323,9,332,415,0,3,2,5,2,1,3,0.00,80.00,60.00
10,008,02,070,0008,0347,406,7,413,593,0,3,2,5,2,1,3,0.00,69.65,60.00
10,008,02,070,0006,0348,477,14,491,675,0,3,2,5,2,1,3,0.00,72.74,60.00
10,008,02,070,0006,0349,525,10,535,721,0,3,2,5,2,1,3,0.00,74.20,60.00
10,008,02,070,0007,0350,600,16,616,865,0,3,2,5,2,1,3,0.00,71.21,60.00
10,008,02,080,0006,0000,1221,31,1252,1656,0,4,2,6,3,1,4,0.00,75.60,66.67
10,008,02,080,0008,0000,426,10,436,596,0,4,2,6,3,1,4,0.00,73.15,66.67
10,008,02,080,0009,0000,337,14,351,470,0,4,2,6,3,1,4,0.00,74.68,66.67
10,008,02,080,0010,0000,927,26,953,1287,0,4,2,6,3,1,4,0.00,74.05,66.67
10,008,02,080,0011,0000,703,22,725,995,0,4,2,6,3,1,4,0.00,72.86,66.67
10,008,02,080,0006,0365,692,17,709,932,0,4,2,6,3,1,4,0.00,76.07,66.67
10,008,02,080,0006,0366,529,14,543,724,0,4,2,6,3,1,4,0.00,75.00,66.67
10,008,02,080,0008,0367,426,10,436,596,0,4,2,6,3,1,4,0.00,73.15,66.67
10,008,02,080,0009,0368,337,14,351,470,0,4,2,6,3,1,4,0.00,74.68,66.67
10,008,02,080,0010,0369,230,3,233,306,0,4,2,6,3,1,4,0.00,76.14,66.67
10,008,02,080,0010,0370,697,23,720,981,0,4,2,6,3,1,4,0.00,73.39,66.67
10,008,02,080,0011,0371,314,13,327,420,0,4,2,6,3,1,4,0.00,77.86,66.67
10,008,02,080,0011,0372,389,9,398,575,0,4,2,6,3,1,4,0.00,69.22,66.67
10,008,02,090,0003,0000,526,22,548,925,0,3,0,3,3,0,3,0.00,59.24,100.00
10,008,02,090,0004,0000,722,61,783,1297,0,3,0,3,3,0,3,0.00,60.37,100.00
10,008,02,090,0008,0000,376,27,403,590,0,3,0,3,3,0,3,0.00,68.31,100.00
10,008,02,090,0009,0000,465,17,482,668,0,3,0,3,3,0,3,0.00,72.16,100.00
10,008,02,090,0004,0391,423,38,461,784,0,3,0,3,3,0,3,0.00,58.80,100.00
10,008,02,090,0004,0392,153,19,172,263,0,3,0,3,3,0,3,0.00,65.40,100.00
10,008,02,090,0004,0393,146,4,150,250,0,3,0,3,3,0,3,0.00,60.00,100.00
10,008,02,090,0008,0394,166,13,179,260,0,3,0,3,3,0,3,0.00,68.85,100.00
10,008,02,090,0008,0395,210,14,224,330,0,3,0,3,3,0,3,0.00,67.88,100.00
10,008,02,090,0009,0396,359,12,371,508,0,3,0,3,3,0,3,0.00,73.03,100.00
10,008,02,090,0009,0397,106,5,111,160,0,3,0,3,3,0,3,0.00,69.38,100.00
10,008,02,090,0003,0398,314,12,326,533,0,3,0,3,3,0,3,0.00,61.16,100.00
10,008,02,090,0003,0399,212,10,222,392,0,3,0,3,3,0,3,0.00,56.63,100.00
10,008,02,100,0003,0000,469,21,490,625,0,3,3,6,3,1,4,0.00,78.40,66.67
10,008,02,100,0004,0000,1283,22,1305,1768,0,3,3,6,3,1,4,0.00,73.81,66.67
10,008,02,100,0005,0000,943,18,961,1307,0,3,3,6,3,1,4,0.00,73.53,66.67
10,008,02,100,0006,0000,520,12,532,666,0,3,3,6,3,1,4,0.00,79.88,66.67
10,008,02,100,0013,0000,549,13,562,729,0,3,3,6,3,1,4,0.00,77.09,66.67
10,008,02,100,0003,0410,469,21,490,625,0,3,3,6,3,1,4,0.00,78.40,66.67
10,008,02,100,0005,0411,446,6,452,621,0,3,3,6,3,1,4,0.00,72.79,66.67
10,008,02,100,0005,0412,497,12,509,686,0,3,3,6,3,1,4,0.00,74.20,66.67
10,008,02,100,0013,0413,549,13,562,729,0,3,3,6,3,1,4,0.00,77.09,66.67
10,008,02,100,0006,0414,520,12,532,666,0,3,3,6,3,1,4,0.00,79.88,66.67
10,008,02,100,0004,0415,675,10,685,953,0,3,3,6,3,1,4,0.00,71.88,66.67
10,008,02,100,0004,0416,608,12,620,815,0,3,3,6,3,1,4,0.00,76.07,66.67
10,008,02,110,0006,0000,694,20,714,976,0,5,3,8,3,2,5,0.00,73.16,62.50
10,008,02,110,0007,0000,617,16,633,865,0,5,3,8,3,2,5,0.00,73.18,62.50
10,008,02,110,0008,0000,944,26,970,1277,0,5,3,8,3,2,5,0.00,75.96,62.50
10,008,02,110,0009,0000,796,9,805,1126,0,5,3,8,3,2,5,0.00,71.49,62.50
10,008,02,110,0015,0000,572,13,585,809,0,5,3,8,3,2,5,0.00,72.31,62.50
10,008,02,110,0019,0000,1089,22,1111,1484,0,5,3,8,3,2,5,0.00,74.87,62.50
10,008,02,110,0006,0434,694,20,714,976,0,5,3,8,3,2,5,0.00,73.16,62.50
10,008,02,110,0019,0435,508,11,519,697,0,5,3,8,3,2,5,0.00,74.46,62.50
10,008,02,110,0019,0436,581,11,592,787,0,5,3,8,3,2,5,0.00,75.22,62.50
10,008,02,110,0007,0437,617,16,633,865,0,5,3,8,3,2,5,0.00,73.18,62.50
10,008,02,110,0008,0438,533,16,549,728,0,5,3,8,3,2,5,0.00,75.41,62.50
10,008,02,110,0008,0439,411,10,421,549,0,5,3,8,3,2,5,0.00,76.68,62.50
10,008,02,110,0015,0440,572,13,585,809,0,5,3,8,3,2,5,0.00,72.31,62.50
10,008,02,110,0009,0441,796,9,805,1126,0,5,3,8,3,2,5,0.00,71.49,62.50
10,008,02,120,0007,0000,949,17,966,1290,0,5,0,5,3,0,3,0.00,74.88,60.00
10,008,02,120,0008,0000,660,20,680,950,0,5,0,5,3,0,3,0.00,71.58,60.00
10,008,02,120,0013,0000,432,13,445,569,0,5,0,5,3,0,3,0.00,78.21,60.00
10,008,02,120,0015,0000,410,7,417,501,0,5,0,5,3,0,3,0.00,83.23,60.00
10,008,02,120,0013,0455,432,13,445,569,0,5,0,5,3,0,3,0.00,78.21,60.00
10,008,02,120,0007,0456,446,8,454,622,0,5,0,5,3,0,3,0.00,72.99,60.00
10,008,02,120,0007,0457,503,9,512,668,0,5,0,5,3,0,3,0.00,76.65,60.00
10,008,02,120,0008,0458,660,20,680,950,0,5,0,5,3,0,3,0.00,71.58,60.00
10,008,02,120,0015,0459,410,7,417,501,0,5,0,5,3,0,3,0.00,83.23,60.00
10,008,02,130,0005,0000,393,5,398,502,0,5,2,7,3,1,4,0.00,79.28,57.14
10,008,02,130,0006,0000,520,10,530,727,0,5,2,7,3,1,4,0.00,72.90,57.14
10,008,02,130,0011,0000,713,13,726,933,0,5,2,7,3,1,4,0.00,77.81,57.14
10,008,02,130,0012,0000,486,15,501,629,0,5,2,7,3,1,4,0.00,79.65,57.14
10,008,02,130,0015,0000,270,5,275,481,0,5,2,7,3,1,4,0.00,57.17,57.14
10,008,02,130,0016,0000,443,4,447,584,0,5,2,7,3,1,4,0.00,76.54,57.14
10,008,02,130,0017,0000,460,9,469,599,0,5,2,7,3,1,4,0.00,78.30,57.14
10,008,02,130,0011,0476,713,13,726,933,0,5,2,7,3,1,4,0.00,77.81,57.14
10,008,02,130,0012,0477,486,15,501,629,0,5,2,7,3,1,4,0.00,79.65,57.14
10,008,02,130,0016,0478,443,4,447,584,0,5,2,7,3,1,4,0.00,76.54,57.14
10,008,02,130,0017,0479,460,9,469,599,0,5,2,7,3,1,4,0.00,78.30,57.14
10,008,02,130,0006,0480,266,8,274,358,0,5,2,7,3,1,4,0.00,76.54,57.14
10,008,02,130,0006,0481,254,2,256,369,0,5,2,7,3,1,4,0.00,69.38,57.14
10,008,02,130,0005,0482,393,5,398,502,0,5,2,7,3,1,4,0.00,79.28,57.14
10,008,02,130,0015,0483,196,4,200,312,0,5,2,7,3,1,4,0.00,64.10,57.14
10,008,02,130,0015,0484,74,1,75,169,0,5,2,7,3,1,4,0.00,44.38,57.14
10,008,00,030,0000,0000,50735,2365,53100,80510,96450,19,7,26,12,5,17,83.47,65.95,65.38
10,008,01,030,0000,0000,10890,658,11548,17692,21720,5,1,6,3,1,4,81.45,65.27,66.67
10,008,02,030,0000,0000,14623,578,15201,23103,27618,6,1,7,4,1,5,83.65,65.80,71.43
10,008,03,030,0000,0000,12600,577,13177,19820,23472,5,3,8,3,1,4,84.44,66.48,50.00
10,008,04,030,0000,0000,12622,552,13174,19895,23640,3,2,5,2,2,4,84.16,66.22,80.00
10,008,03,010,0008,0057,934,41,975,1292,0,7,4,11,3,3,6,0.00,75.46,54.55
10,008,03,010,0008,0058,790,43,833,1190,0,7,4,11,3,3,6,0.00,70.00,54.55
10,008,03,010,0009,0059,868,39,907,1344,0,7,4,11,3,3,6,0.00,67.49,54.55
10,008,03,010,0009,0060,670,31,701,986,0,7,4,11,3,3,6,0.00,71.10,54.55
10,008,03,010,0009,0061,835,29,864,1258,0,7,4,11,3,3,6,0.00,68.68,54.55
10,008,03,010,0009,0062,711,37,748,1130,0,7,4,11,3,3,6,0.00,66.19,54.55
10,008,03,010,0009,0063,652,29,681,1014,0,7,4,11,3,3,6,0.00,67.16,54.55
10,008,03,010,0009,0064,779,23,802,1091,0,7,4,11,3,3,6,0.00,73.51,54.55
10,008,03,010,0023,0065,673,21,694,1004,0,7,4,11,3,3,6,0.00,69.12,54.55
10,008,03,010,0023,0066,593,25,618,1001,0,7,4,11,3,3,6,0.00,61.74,54.55
10,008,03,010,0023,0067,681,38,719,1025,0,7,4,11,3,3,6,0.00,70.15,54.55
10,008,03,010,0023,0068,665,32,697,1048,0,7,4,11,3,3,6,0.00,66.51,54.55
10,008,03,010,0023,0069,680,24,704,1135,0,7,4,11,3,3,6,0.00,62.03,54.55
10,008,03,010,0024,0070,653,25,678,1029,0,7,4,11,3,3,6,0.00,65.89,54.55
10,008,03,010,0024,0071,732,26,758,1170,0,7,4,11,3,3,6,0.00,64.79,54.55
10,008,03,010,0024,0072,749,30,779,1287,0,7,4,11,3,3,6,0.00,60.53,54.55
10,008,03,010,0024,0073,882,22,904,1383,0,7,4,11,3,3,6,0.00,65.37,54.55
10,008,03,010,0025,0074,562,14,576,799,0,7,4,11,3,3,6,0.00,72.09,54.55
10,008,03,010,0025,0075,676,14,690,1017,0,7,4,11,3,3,6,0.00,67.85,54.55
10,008,03,010,0025,0076,611,26,637,928,0,7,4,11,3,3,6,0.00,68.64,54.55
10,008,03,010,0026,0077,645,18,663,1032,0,7,4,11,3,3,6,0.00,64.24,54.55
10,008,03,010,0026,0078,625,37,662,925,0,7,4,11,3,3,6,0.00,71.57,54.55
10,008,03,010,0026,0079,670,23,693,951,0,7,4,11,3,3,6,0.00,72.87,54.55
10,008,03,010,0008,0000,1724,84,1808,2482,0,7,4,11,3,3,6,0.00,72.84,54.55
10,008,03,010,0009,0000,4515,188,4703,6823,0,7,4,11,3,3,6,0.00,68.93,54.55
10,008,03,010,0023,0000,3292,140,3432,5213,0,7,4,11,3,3,6,0.00,65.84,54.55
10,008,03,010,0024,0000,3016,103,3119,4869,0,7,4,11,3,3,6,0.00,64.06,54.55
10,008,03,010,0025,0000,1849,54,1903,2744,0,7,4,11,3,3,6,0.00,69.35,54.55
10,008,03,010,0026,0000,1940,78,2018,2908,0,7,4,11,3,3,6,0.00,69.39,54.55
10,008,03,020,0005,0000,1279,66,1345,2078,0,4,1,5,2,1,3,0.00,64.73,60.00
10,008,03,020,0006,0000,682,32,714,967,0,4,1,5,2,1,3,0.00,73.84,60.00
10,008,03,020,0007,0000,2157,82,2239,3505,0,4,1,5,2,1,3,0.00,63.88,60.00
10,008,03,020,0008,0000,3218,164,3382,5568,0,4,1,5,2,1,3,0.00,60.74,60.00
10,008,03,020,0009,0000,646,30,676,893,0,4,1,5,2,1,3,0.00,75.70,60.00
10,008,03,020,0005,0122,672,33,705,1058,0,4,1,5,2,1,3,0.00,66.64,60.00
10,008,03,020,0005,0123,607,33,640,1020,0,4,1,5,2,1,3,0.00,62.75,60.00
10,008,03,020,0007,0124,688,27,715,1074,0,4,1,5,2,1,3,0.00,66.57,60.00
10,008,03,020,0007,0125,721,33,754,1193,0,4,1,5,2,1,3,0.00,63.20,60.00
10,008,03,020,0007,0126,748,22,770,1238,0,4,1,5,2,1,3,0.00,62.20,60.00
10,008,03,020,0006,0127,682,32,714,967,0,4,1,5,2,1,3,0.00,73.84,60.00
10,008,03,020,0008,0128,495,23,518,895,0,4,1,5,2,1,3,0.00,57.88,60.00
10,008,03,020,0008,0129,520,21,541,907,0,4,1,5,2,1,3,0.00,59.65,60.00
10,008,03,020,0008,0130,618,32,650,985,0,4,1,5,2,1,3,0.00,65.99,60.00
10,008,03,020,0008,0131,505,27,532,840,0,4,1,5,2,1,3,0.00,63.33,60.00
10,008,03,020,0008,0132,548,31,579,971,0,4,1,5,2,1,3,0.00,59.63,60.00
10,008,03,020,0008,0133,532,30,562,970,0,4,1,5,2,1,3,0.00,57.94,60.00
10,008,03,020,0009,0134,646,30,676,893,0,4,1,5,2,1,3,0.00,75.70,60.00
10,008,03,020,0015,0135,636,22,658,953,0,4,1,5,2,1,3,0.00,69.05,60.00
10,008,03,020,0016,0136,168,6,174,271,0,4,1,5,2,1,3,0.00,64.21,60.00
10,008,03,020,0015,0000,636,22,658,953,0,4,1,5,2,1,3,0.00,69.05,60.00
10,008,03,020,0016,0000,168,6,174,271,0,4,1,5,2,1,3,0.00,64.21,60.00
10,008,03,030,0007,0000,3577,169,3746,5885,0,5,3,8,3,1,4,0.00,63.65,50.00
10,008,03,030,0008,0000,2394,139,2533,3871,0,5,3,8,3,1,4,0.00,65.44,50.00
10,008,03,030,0013,0000,2269,97,2366,3602,0,5,3,8,3,1,4,0.00,65.69,50.00
10,008,03,030,0014,0000,1875,75,1950,2866,0,5,3,8,3,1,4,0.00,68.04,50.00
10,008,03,030,0015,0000,932,42,974,1445,0,5,3,8,3,1,4,0.00,67.40,50.00
10,008,03,030,0016,0000,1553,55,1608,2151,0,5,3,8,3,1,4,0.00,74.76,50.00
10,008,03,030,0007,0191,851,29,880,1370,0,5,3,8,3,1,4,0.00,64.23,50.00
10,008,03,030,0007,0192,722,30,752,1109,0,5,3,8,3,1,4,0.00,67.81,50.00
10,008,03,030,0007,0193,749,38,787,1279,0,5,3,8,3,1,4,0.00,61.53,50.00
10,008,03,030,0007,0194,502,30,532,819,0,5,3,8,3,1,4,0.00,64.96,50.00
10,008,03,030,0007,0195,753,42,795,1308,0,5,3,8,3,1,4,0.00,60.78,50.00
10,008,03,030,0008,0196,594,34,628,956,0,5,3,8,3,1,4,0.00,65.69,50.00
10,008,03,030,0008,0197,627,42,669,1020,0,5,3,8,3,1,4,0.00,65.59,50.00
10,008,03,030,0008,0198,592,21,613,951,0,5,3,8,3,1,4,0.00,64.46,50.00
10,008,03,030,0008,0199,581,42,623,944,0,5,3,8,3,1,4,0.00,66.00,50.00
10,008,03,030,0013,0200,753,30,783,1159,0,5,3,8,3,1,4,0.00,67.56,50.00
10,008,03,030,0013,0201,709,24,733,1084,0,5,3,8,3,1,4,0.00,67.62,50.00
10,008,03,030,0013,0202,807,43,850,1359,0,5,3,8,3,1,4,0.00,62.55,50.00
10,008,03,030,0016,0203,662,13,675,894,0,5,3,8,3,1,4,0.00,75.50,50.00
10,008,03,030,0016,0204,891,42,933,1257,0,5,3,8,3,1,4,0.00,74.22,50.00
10,008,03,030,0015,0205,469,24,493,735,0,5,3,8,3,1,4,0.00,67.07,50.00
10,008,03,030,0015,0206,463,18,481,710,0,5,3,8,3,1,4,0.00,67.75,50.00
10,008,03,030,0014,0207,651,30,681,921,0,5,3,8,3,1,4,0.00,73.94,50.00
10,008,03,030,0014,0208,540,22,562,926,0,5,3,8,3,1,4,0.00,60.69,50.00
10,008,03,030,0014,0209,684,23,707,1019,0,5,3,8,3,1,4,0.00,69.38,50.00
10,008,03,040,0005,0000,1177,35,1212,1716,0,3,0,3,2,0,2,0.00,70.63,66.67
10,008,03,040,0010,0000,573,28,601,841,0,3,0,3,2,0,2,0.00,71.46,66.67
10,008,03,040,0020,0000,394,17,411,543,0,3,0,3,2,0,2,0.00,75.69,66.67
10,008,03,040,0021,0000,438,24,462,558,0,3,0,3,2,0,2,0.00,82.80,66.67
10,008,03,040,0022,0000,457,14,471,693,0,3,0,3,2,0,2,0.00,67.97,66.67
10,008,03,040,0023,0000,378,9,387,547,0,3,0,3,2,0,2,0.00,70.75,66.67
10,008,03,040,0024,0000,314,10,324,431,0,3,0,3,2,0,2,0.00,75.17,66.67
10,008,03,040,0025,0000,513,25,538,809,0,3,0,3,2,0,2,0.00,66.50,66.67
10,008,03,040,0020,0271,394,17,411,543,0,3,0,3,2,0,2,0.00,75.69,66.67
10,008,03,040,0005,0272,515,18,533,755,0,3,0,3,2,0,2,0.00,70.60,66.67
10,008,03,040,0005,0273,662,17,679,961,0,3,0,3,2,0,2,0.00,70.66,66.67
10,008,03,040,0010,0274,237,16,253,350,0,3,0,3,2,0,2,0.00,72.29,66.67
10,008,03,040,0010,0275,336,12,348,491,0,3,0,3,2,0,2,0.00,70.88,66.67
10,008,03,040,0021,0276,136,9,145,172,0,3,0,3,2,0,2,0.00,84.30,66.67
10,008,03,040,0021,0277,302,15,317,386,0,3,0,3,2,0,2,0.00,82.12,66.67
10,008,03,040,0022,0278,293,10,303,435,0,3,0,3,2,0,2,0.00,69.66,66.67
10,008,03,040,0022,0279,164,4,168,258,0,3,0,3,2,0,2,0.00,65.12,66.67
10,008,03,040,0024,0280,314,10,324,431,0,3,0,3,2,0,2,0.00,75.17,66.67
10,008,03,040,0023,0281,378,9,387,547,0,3,0,3,2,0,2,0.00,70.75,66.67
10,008,03,040,0025,0282,298,17,315,453,0,3,0,3,2,0,2,0.00,69.54,66.67
10,008,03,040,0025,0283,215,8,223,356,0,3,0,3,2,0,2,0.00,62.64,66.67
10,008,03,050,0006,0000,367,5,372,452,0,3,0,3,2,0,2,0.00,82.30,66.67
10,008,03,050,0007,0000,650,22,672,843,0,3,0,3,2,0,2,0.00,79.72,66.67
10,008,03,050,0006,0290,367,5,372,452,0,3,0,3,2,0,2,0.00,82.30,66.67
10,008,03,050,0007,0291,650,22,672,843,0,3,0,3,2,0,2,0.00,79.72,66.67
10,008,03,060,0014,0000,595,19,614,859,0,1,1,2,1,0,1,0.00,71.48,50.00
10,008,03,060,0015,0000,755,14,769,1104,0,1,1,2,1,0,1,0.00,69.66,50.00
10,008,03,060,0016,0000,1046,39,1085,1480,0,1,1,2,1,0,1,0.00,73.31,50.00
10,008,03,060,0015,0322,440,7,447,619,0,1,1,2,1,0,1,0.00,72.21,50.00
10,008,03,060,0015,0323,315,7,322,485,0,1,1,2,1,0,1,0.00,66.39,50.00
10,008,03,060,0014,0324,595,19,614,859,0,1,1,2,1,0,1,0.00,71.48,50.00
10,008,03,060,0016,0325,761,25,786,1065,0,1,1,2,1,0,1,0.00,73.80,50.00
10,008,03,060,0016,0326,285,14,299,415,0,1,1,2,1,0,1,0.00,72.05,50.00
10,008,03,070,0002,0000,892,28,920,1351,0,3,0,3,2,0,2,0.00,68.10,66.67
10,008,03,070,0011,0000,450,9,459,725,0,3,0,3,2,0,2,0.00,63.31,66.67
10,008,03,070,0012,0000,518,11,529,648,0,3,0,3,2,0,2,0.00,81.64,66.67
10,008,03,070,0013,0000,504,12,516,672,0,3,0,3,2,0,2,0.00,76.79,66.67
10,008,03,070,0002,0351,436,19,455,684,0,3,0,3,2,0,2,0.00,66.52,66.67
10,008,03,070,0002,0352,456,9,465,667,0,3,0,3,2,0,2,0.00,69.72,66.67
10,008,03,070,0011,0353,450,9,459,725,0,3,0,3,2,0,2,0.00,63.31,66.67
10,008,03,070,0012,0354,518,11,529,648,0,3,0,3,2,0,2,0.00,81.64,66.67
10,008,03,070,0013,0355,504,12,516,672,0,3,0,3,2,0,2,0.00,76.79,66.67
10,008,03,080,0012,0000,640,21,661,832,0,3,0,3,2,0,2,0.00,79.45,66.67
10,008,03,080,0013,0000,511,16,527,649,0,3,0,3,2,0,2,0.00,81.20,66.67
10,008,03,080,0016,0000,284,11,295,420,0,3,0,3,2,0,2,0.00,70.24,66.67
10,008,03,080,0012,0373,640,21,661,832,0,3,0,3,2,0,2,0.00,79.45,66.67
10,008,03,080,0016,0374,284,11,295,420,0,3,0,3,2,0,2,0.00,70.24,66.67
10,008,03,080,0013,0375,511,16,527,649,0,3,0,3,2,0,2,0.00,81.20,66.67
10,008,03,090,0010,0000,573,20,593,778,0,4,0,4,2,0,2,0.00,76.22,50.00
10,008,03,090,0011,0000,640,8,648,873,0,4,0,4,2,0,2,0.00,74.23,50.00
10,008,03,090,0012,0000,375,7,382,531,0,4,0,4,2,0,2,0.00,71.94,50.00
10,008,03,090,0013,0000,625,17,642,823,0,4,0,4,2,0,2,0.00,78.01,50.00
10,008,03,090,0010,0400,573,20,593,778,0,4,0,4,2,0,2,0.00,76.22,50.00
10,008,03,090,0013,0401,625,17,642,823,0,4,0,4,2,0,2,0.00,78.01,50.00
10,008,03,090,0011,0402,259,4,263,374,0,4,0,4,2,0,2,0.00,70.32,50.00
10,008,03,090,0011,0403,381,4,385,499,0,4,0,4,2,0,2,0.00,77.15,50.00
10,008,03,090,0012,0404,226,5,231,314,0,4,0,4,2,0,2,0.00,73.57,50.00
10,008,03,090,0012,0405,149,2,151,217,0,4,0,4,2,0,2,0.00,69.59,50.00
10,008,03,100,0007,0000,1281,21,1302,1708,0,3,0,3,2,0,2,0.00,76.23,66.67
10,008,03,100,0008,0000,482,24,506,739,0,3,0,3,2,0,2,0.00,68.47,66.67
10,008,03,100,0009,0000,803,18,821,1067,0,3,0,3,2,0,2,0.00,76.94,66.67
10,008,03,100,0007,0417,662,14,676,857,0,3,0,3,2,0,2,0.00,78.88,66.67
10,008,03,100,0007,0418,619,7,626,851,0,3,0,3,2,0,2,0.00,73.56,66.67
10,008,03,100,0008,0419,482,24,506,739,0,3,0,3,2,0,2,0.00,68.47,66.67
10,008,03,100,0009,0420,803,18,821,1067,0,3,0,3,2,0,2,0.00,76.94,66.67
10,008,03,110,0012,0000,128,1,129,179,0,2,0,2,1,0,1,0.00,72.07,50.00
10,008,03,110,0013,0000,256,4,260,306,0,2,0,2,1,0,1,0.00,84.97,50.00
10,008,03,110,0014,0000,801,12,813,1040,0,2,0,2,1,0,1,0.00,78.17,50.00
10,008,03,110,0012,0442,128,1,129,179,0,2,0,2,1,0,1,0.00,72.07,50.00
10,008,03,110,0013,0443,256,4,260,306,0,2,0,2,1,0,1,0.00,84.97,50.00
10,008,03,110,0014,0444,801,12,813,1040,0,2,0,2,1,0,1,0.00,78.17,50.00
10,008,03,120,0009,0000,1073,16,1089,1373,0,4,0,4,2,0,2,0.00,79.32,50.00
10,008,03,120,0010,0000,450,9,459,600,0,4,0,4,2,0,2,0.00,76.50,50.00
10,008,03,120,0011,0000,700,7,707,950,0,4,0,4,2,0,2,0.00,74.42,50.00
10,008,03,120,0009,0460,726,13,739,914,0,4,0,4,2,0,2,0.00,80.85,50.00
10,008,03,120,0009,0461,347,3,350,459,0,4,0,4,2,0,2,0.00,76.25,50.00
10,008,03,120,0010,0462,346,7,353,462,0,4,0,4,2,0,2,0.00,76.41,50.00
10,008,03,120,0010,0463,104,2,106,138,0,4,0,4,2,0,2,0.00,76.81,50.00
10,008,03,120,0011,0464,700,7,707,950,0,4,0,4,2,0,2,0.00,74.42,50.00
10,008,03,130,0001,0000,615,4,619,792,0,5,0,5,3,0,3,0.00,78.16,60.00
10,008,03,130,0002,0000,652,9,661,858,0,5,0,5,3,0,3,0.00,77.04,60.00
10,008,03,130,0008,0000,878,12,890,1110,0,5,0,5,3,0,3,0.00,80.18,60.00
10,008,03,130,0013,0000,453,8,461,624,0,5,0,5,3,0,3,0.00,73.88,60.00
10,008,03,130,0008,0485,496,2,498,605,0,5,0,5,3,0,3,0.00,82.31,60.00
10,008,03,130,0008,0486,290,8,298,377,0,5,0,5,3,0,3,0.00,79.05,60.00
10,008,03,130,0008,0487,92,2,94,128,0,5,0,5,3,0,3,0.00,73.44,60.00
10,008,03,130,0013,0488,453,8,461,624,0,5,0,5,3,0,3,0.00,73.88,60.00
10,008,03,130,0001,0489,615,4,619,792,0,5,0,5,3,0,3,0.00,78.16,60.00
10,008,03,130,0002,0490,652,9,661,858,0,5,0,5,3,0,3,0.00,77.04,60.00
10,008,00,040,0000,0000,28703,1076,29779,44242,51943,16,5,21,9,4,13,85.17,67.31,61.90
10,008,01,040,0000,0000,12976,456,13432,20264,23870,8,2,10,5,1,6,84.89,66.29,60.00
10,008,02,040,0000,0000,11483,458,11941,17840,21051,5,3,8,2,3,5,84.75,66.93,62.50
10,008,03,040,0000,0000,4244,162,4406,6138,7022,3,0,3,2,0,2,87.41,71.78,66.67
10,008,04,010,0022,0080,650,31,681,997,0,1,1,2,0,1,1,0.00,68.30,50.00
10,008,04,010,0020,0081,563,20,583,738,0,1,1,2,0,1,1,0.00,79.00,50.00
10,008,04,010,0021,0082,415,19,434,582,0,1,1,2,0,1,1,0.00,74.57,50.00
10,008,04,010,0019,0083,658,24,682,948,0,1,1,2,0,1,1,0.00,71.94,50.00
10,008,04,010,0019,0084,644,32,676,869,0,1,1,2,0,1,1,0.00,77.79,50.00
10,008,04,010,0019,0000,1302,56,1358,1817,0,1,1,2,0,1,1,0.00,74.74,50.00
10,008,04,010,0020,0000,563,20,583,738,0,1,1,2,0,1,1,0.00,79.00,50.00
10,008,04,010,0021,0000,415,19,434,582,0,1,1,2,0,1,1,0.00,74.57,50.00
10,008,04,010,0022,0000,650,31,681,997,0,1,1,2,0,1,1,0.00,68.30,50.00
10,008,04,020,0017,0137,856,33,889,1283,0,4,1,5,3,0,3,0.00,69.29,60.00
10,008,04,020,0018,0138,432,22,454,649,0,4,1,5,3,0,3,0.00,69.95,60.00
10,008,04,020,0018,0139,424,12,436,702,0,4,1,5,3,0,3,0.00,62.11,60.00
10,008,04,020,0019,0140,514,28,542,720,0,4,1,5,3,0,3,0.00,75.28,60.00
10,008,04,020,0019,0141,595,19,614,874,0,4,1,5,3,0,3,0.00,70.25,60.00
10,008,04,020,0020,0142,633,26,659,912,0,4,1,5,3,0,3,0.00,72.26,60.00
10,008,04,020,0020,0143,249,10,259,368,0,4,1,5,3,0,3,0.00,70.38,60.00
10,008,04,020,0021,0144,483,19,502,636,0,4,1,5,3,0,3,0.00,78.93,60.00
10,008,04,020,0022,0145,720,11,731,926,0,4,1,5,3,0,3,0.00,78.94,60.00
10,008,04,020,0029,0146,917,31,948,1259,0,4,1,5,3,0,3,0.00,75.30,60.00
10,008,04,020,0029,0147,182,12,194,291,0,4,1,5,3,0,3,0.00,66.67,60.00
10,008,04,020,0023,0148,691,34,725,1082,0,4,1,5,3,0,3,0.00,67.01,60.00
10,008,04,020,0024,0149,389,8,397,540,0,4,1,5,3,0,3,0.00,73.52,60.00
10,008,04,020,0025,0150,657,16,673,917,0,4,1,5,3,0,3,0.00,73.39,60.00
10,008,04,020,0026,0151,614,18,632,888,0,4,1,5,3,0,3,0.00,71.17,60.00
10,008,04,020,0026,0152,634,21,655,867,0,4,1,5,3,0,3,0.00,75.55,60.00
10,008,04,020,0026,0153,643,19,662,952,0,4,1,5,3,0,3,0.00,69.54,60.00
10,008,04,020,0017,0000,856,33,889,1283,0,4,1,5,3,0,3,0.00,69.29,60.00
10,008,04,020,0018,0000,856,34,890,1351,0,4,1,5,3,0,3,0.00,65.88,60.00
10,008,04,020,0019,0000,1109,47,1156,1594,0,4,1,5,3,0,3,0.00,72.52,60.00
10,008,04,020,0020,0000,882,36,918,1280,0,4,1,5,3,0,3,0.00,71.72,60.00
10,008,04,020,0021,0000,483,19,502,636,0,4,1,5,3,0,3,0.00,78.93,60.00
10,008,04,020,0022,0000,720,11,731,926,0,4,1,5,3,0,3,0.00,78.94,60.00
10,008,04,020,0023,0000,691,34,725,1082,0,4,1,5,3,0,3,0.00,67.01,60.00
10,008,04,020,0024,0000,389,8,397,540,0,4,1,5,3,0,3,0.00,73.52,60.00
10,008,04,020,0025,0000,657,16,673,917,0,4,1,5,3,0,3,0.00,73.39,60.00
10,008,04,020,0026,0000,1891,58,1949,2707,0,4,1,5,3,0,3,0.00,72.00,60.00
10,008,04,020,0029,0000,1099,43,1142,1550,0,4,1,5,3,0,3,0.00,73.68,60.00
10,008,04,030,0006,0000,3858,194,4052,6480,0,3,2,5,2,2,4,0.00,62.53,80.00
10,008,04,030,0017,0000,1193,35,1228,1734,0,3,2,5,2,2,4,0.00,70.82,80.00
10,008,04,030,0018,0000,1329,60,1389,1955,0,3,2,5,2,2,4,0.00,71.05,80.00
10,008,04,030,0019,0000,2430,130,2560,3970,0,3,2,5,2,2,4,0.00,64.48,80.00
10,008,04,030,0020,0000,914,49,963,1579,0,3,2,5,2,2,4,0.00,60.99,80.00
10,008,04,030,0021,0000,661,31,692,977,0,3,2,5,2,2,4,0.00,70.83,80.00
10,008,04,030,0006,0210,953,52,1005,1559,0,3,2,5,2,2,4,0.00,64.46,80.00
10,008,04,030,0006,0211,758,34,792,1221,0,3,2,5,2,2,4,0.00,64.86,80.00
10,008,04,030,0006,0212,581,30,611,966,0,3,2,5,2,2,4,0.00,63.25,80.00
10,008,04,030,0006,0213,507,22,529,991,0,3,2,5,2,2,4,0.00,53.38,80.00
10,008,04,030,0006,0214,649,36,685,1110,0,3,2,5,2,2,4,0.00,61.71,80.00
10,008,04,030,0006,0215,410,20,430,633,0,3,2,5,2,2,4,0.00,67.93,80.00
10,008,04,030,0017,0216,463,8,471,641,0,3,2,5,2,2,4,0.00,73.48,80.00
10,008,04,030,0017,0217,422,18,440,632,0,3,2,5,2,2,4,0.00,69.62,80.00
10,008,04,030,0017,0218,308,9,317,461,0,3,2,5,2,2,4,0.00,68.76,80.00
10,008,04,030,0018,0219,733,36,769,1115,0,3,2,5,2,2,4,0.00,68.97,80.00
10,008,04,030,0022,0000,1439,31,1470,2172,0,3,2,5,2,2,4,0.00,67.68,80.00
10,008,04,030,0018,0220,596,24,620,840,0,3,2,5,2,2,4,0.00,73.81,80.00
10,008,04,030,0019,0221,638,30,668,1052,0,3,2,5,2,2,4,0.00,63.50,80.00
10,008,04,030,0019,0222,547,25,572,911,0,3,2,5,2,2,4,0.00,62.79,80.00
10,008,04,030,0019,0223,610,31,641,964,0,3,2,5,2,2,4,0.00,66.49,80.00
10,008,04,030,0019,0224,635,44,679,1043,0,3,2,5,2,2,4,0.00,65.10,80.00
10,008,04,030,0021,0225,661,31,692,977,0,3,2,5,2,2,4,0.00,70.83,80.00
10,008,04,030,0020,0226,369,20,389,620,0,3,2,5,2,2,4,0.00,62.74,80.00
10,008,04,030,0020,0227,545,29,574,959,0,3,2,5,2,2,4,0.00,59.85,80.00
10,008,04,030,0023,0228,798,22,820,1028,0,3,2,5,2,2,4,0.00,79.77,80.00
10,008,04,030,0022,0229,722,19,741,1127,0,3,2,5,2,2,4,0.00,65.75,80.00
10,008,04,030,0023,0000,798,22,820,1028,0,3,2,5,2,2,4,0.00,79.77,80.00
10,008,04,030,0022,0230,717,12,729,1045,0,3,2,5,2,2,4,0.00,69.76,80.00
10,008,04,050,0008,0000,1041,23,1064,1368,0,4,4,8,2,2,4,0.00,77.78,50.00
10,008,04,050,0009,0000,670,14,684,916,0,4,4,8,2,2,4,0.00,74.67,50.00
10,008,04,050,0010,0000,385,5,390,522,0,4,4,8,2,2,4,0.00,74.71,50.00
10,008,04,050,0011,0000,601,16,617,842,0,4,4,8,2,2,4,0.00,73.28,50.00
10,008,04,050,0008,0292,564,11,575,728,0,4,4,8,2,2,4,0.00,78.98,50.00
10,008,04,050,0008,0293,477,12,489,640,0,4,4,8,2,2,4,0.00,76.41,50.00
10,008,04,050,0009,0294,670,14,684,916,0,4,4,8,2,2,4,0.00,74.67,50.00
10,008,04,050,0011,0295,322,10,332,457,0,4,4,8,2,2,4,0.00,72.65,50.00
10,008,04,050,0011,0296,279,6,285,385,0,4,4,8,2,2,4,0.00,74.03,50.00
10,008,04,050,0010,0297,385,5,390,522,0,4,4,8,2,2,4,0.00,74.71,50.00
10,008,04,060,0017,0000,1045,46,1091,1411,0,3,0,3,2,0,2,0.00,77.32,66.67
10,008,04,060,0018,0000,765,25,790,1092,0,3,0,3,2,0,2,0.00,72.34,66.67
10,008,04,060,0019,0000,581,36,617,809,0,3,0,3,2,0,2,0.00,76.27,66.67
10,008,04,060,0020,0000,579,24,603,813,0,3,0,3,2,0,2,0.00,74.17,66.67
10,008,04,060,0021,0000,464,24,488,706,0,3,0,3,2,0,2,0.00,69.12,66.67
10,008,04,060,0022,0000,1121,51,1172,1669,0,3,0,3,2,0,2,0.00,70.22,66.67
10,008,04,060,0017,0327,630,26,656,837,0,3,0,3,2,0,2,0.00,78.38,66.67
10,008,04,060,0017,0328,415,20,435,574,0,3,0,3,2,0,2,0.00,75.78,66.67
10,008,04,060,0018,0329,765,25,790,1092,0,3,0,3,2,0,2,0.00,72.34,66.67
10,008,04,060,0020,0330,579,24,603,813,0,3,0,3,2,0,2,0.00,74.17,66.67
10,008,04,060,0019,0331,581,36,617,809,0,3,0,3,2,0,2,0.00,76.27,66.67
10,008,04,060,0021,0332,464,24,488,706,0,3,0,3,2,0,2,0.00,69.12,66.67
10,008,04,060,0022,0333,468,25,493,721,0,3,0,3,2,0,2,0.00,68.38,66.67
10,008,04,060,0022,0334,653,26,679,948,0,3,0,3,2,0,2,0.00,71.62,66.67
10,008,04,080,0014,0000,489,13,502,603,0,2,1,3,1,1,2,0.00,83.25,66.67
10,008,04,080,0015,0000,361,10,371,481,0,2,1,3,1,1,2,0.00,77.13,66.67
10,008,04,080,0017,0000,386,5,391,440,0,2,1,3,1,1,2,0.00,88.86,66.67
10,008,04,080,0018,0000,348,13,361,452,0,2,1,3,1,1,2,0.00,79.87,66.67
10,008,04,080,0018,0376,348,13,361,452,0,2,1,3,1,1,2,0.00,79.87,66.67
10,008,04,080,0014,0377,489,13,502,603,0,2,1,3,1,1,2,0.00,83.25,66.67
10,008,04,080,0017,0378,386,5,391,440,0,2,1,3,1,1,2,0.00,88.86,66.67
10,008,04,080,0015,0379,361,10,371,481,0,2,1,3,1,1,2,0.00,77.13,66.67
10,008,04,100,0010,0000,904,41,945,1385,0,3,0,3,3,0,3,0.00,68.23,100.00
10,008,04,100,0011,0000,886,80,966,1491,0,3,0,3,3,0,3,0.00,64.79,100.00
10,008,04,100,0012,0000,402,26,428,649,0,3,0,3,3,0,3,0.00,65.95,100.00
10,008,04,100,0012,0421,402,26,428,649,0,3,0,3,3,0,3,0.00,65.95,100.00
10,008,04,100,0010,0422,681,33,714,1004,0,3,0,3,3,0,3,0.00,71.12,100.00
10,008,04,100,0010,0423,223,8,231,381,0,3,0,3,3,0,3,0.00,60.63,100.00
10,008,04,100,0011,0424,551,51,602,969,0,3,0,3,3,0,3,0.00,62.13,100.00
10,008,04,100,0011,0425,335,29,364,522,0,3,0,3,3,0,3,0.00,69.73,100.00
10,008,04,110,0016,0000,236,4,240,300,0,2,0,2,1,0,1,0.00,80.00,50.00
10,008,04,110,0017,0000,594,32,626,803,0,2,0,2,1,0,1,0.00,77.96,50.00
10,008,04,110,0018,0000,191,5,196,266,0,2,0,2,1,0,1,0.00,73.68,50.00
10,008,04,110,0018,0445,191,5,196,266,0,2,0,2,1,0,1,0.00,73.68,50.00
10,008,04,110,0016,0446,236,4,240,300,0,2,0,2,1,0,1,0.00,80.00,50.00
10,008,04,110,0017,0447,594,32,626,803,0,2,0,2,1,0,1,0.00,77.96,50.00
10,008,04,120,0001,0000,747,16,763,1127,0,5,0,5,3,0,3,0.00,67.70,60.00
10,008,04,120,0002,0000,603,6,609,888,0,5,0,5,3,0,3,0.00,68.58,60.00
10,008,04,120,0003,0000,424,8,432,548,0,5,0,5,3,0,3,0.00,78.83,60.00
10,008,04,120,0012,0000,428,10,438,575,0,5,0,5,3,0,3,0.00,76.17,60.00
10,008,04,120,0001,0465,605,12,617,884,0,5,0,5,3,0,3,0.00,69.80,60.00
10,008,04,120,0001,0466,142,4,146,243,0,5,0,5,3,0,3,0.00,60.08,60.00
10,008,04,120,0002,0467,603,6,609,888,0,5,0,5,3,0,3,0.00,68.58,60.00
10,008,04,120,0012,0468,428,10,438,575,0,5,0,5,3,0,3,0.00,76.17,60.00
10,008,04,120,0003,0469,424,8,432,548,0,5,0,5,3,0,3,0.00,78.83,60.00
10,008,04,130,0003,0000,867,8,875,1111,0,2,0,2,1,0,1,0.00,78.76,50.00
10,008,04,130,0004,0000,337,4,341,387,0,2,0,2,1,0,1,0.00,88.11,50.00
10,008,04,130,0003,0491,540,4,544,687,0,2,0,2,1,0,1,0.00,79.18,50.00
10,008,04,130,0003,0492,327,4,331,424,0,2,0,2,1,0,1,0.00,78.07,50.00
10,008,04,130,0004,0493,337,4,341,387,0,2,0,2,1,0,1,0.00,88.11,50.00
10,008,00,050,0000,0000,6600,157,6757,8882,10111,14,7,21,6,5,11,87.84,76.08,52.38
10,008,01,050,0000,0000,1778,40,1818,2414,2758,5,1,6,2,1,3,87.53,75.31,50.00
10,008,02,050,0000,0000,1108,32,1140,1525,1746,2,2,4,0,2,2,87.34,74.75,50.00
10,008,03,050,0000,0000,1017,27,1044,1295,1470,3,0,3,2,0,2,88.10,80.62,66.67
10,008,04,050,0000,0000,2697,58,2755,3648,4137,4,4,8,2,2,4,88.18,75.52,50.00
10,008,00,060,0000,0000,21258,1334,22592,31391,36274,13,2,15,10,1,11,86.54,71.97,73.33
10,008,01,060,0000,0000,11384,620,12004,16944,19666,7,1,8,5,1,6,86.16,70.85,75.00
10,008,02,060,0000,0000,2923,436,3359,4504,5087,2,0,2,2,0,2,88.54,74.58,100.00
10,008,03,060,0000,0000,2396,72,2468,3443,3950,1,1,2,1,0,1,87.16,71.68,50.00
10,008,04,060,0000,0000,4555,206,4761,6500,7571,3,0,3,2,0,2,85.85,73.25,66.67
10,008,00,070,0000,0000,10032,318,10350,14776,16520,11,4,15,8,3,11,89.44,70.05,73.33
10,008,01,070,0000,0000,4966,192,5158,7581,8470,5,2,7,4,2,6,89.50,68.04,85.71
10,008,02,070,0000,0000,2702,66,2768,3799,4291,3,2,5,2,1,3,88.53,72.86,60.00
10,008,03,070,0000,0000,2364,60,2424,3396,3759,3,0,3,2,0,2,90.34,71.38,66.67
10,008,00,080,0000,0000,9065,256,9321,12319,13884,13,4,17,8,3,11,88.73,75.66,64.71
10,008,01,080,0000,0000,2432,64,2496,3438,3804,4,1,5,2,1,3,90.38,72.60,60.00
10,008,02,080,0000,0000,3614,103,3717,5004,5709,4,2,6,3,1,4,87.65,74.28,66.67
10,008,03,080,0000,0000,1435,48,1483,1901,2133,3,0,3,2,0,2,89.12,78.01,66.67
10,008,04,080,0000,0000,1584,41,1625,1976,2238,2,1,3,1,1,2,88.29,82.24,66.67
10,008,00,090,0000,0000,8892,282,9174,13014,14894,12,3,15,9,2,11,87.38,70.49,73.33
10,008,01,090,0000,0000,4590,103,4693,6529,7493,5,3,8,4,2,6,87.13,71.88,75.00
10,008,02,090,0000,0000,2089,127,2216,3480,4005,3,0,3,3,0,3,86.89,63.68,100.00
10,008,03,090,0000,0000,2213,52,2265,3005,3396,4,0,4,2,0,2,88.49,75.37,50.00
10,008,00,100,0000,0000,10492,597,11089,15352,17313,9,5,14,8,3,11,88.67,72.23,78.57
10,008,01,100,0000,0000,1970,301,2271,3218,3781,0,2,2,0,2,2,85.11,70.57,100.00
10,008,02,100,0000,0000,3764,86,3850,5095,5675,3,3,6,3,1,4,89.78,75.56,66.67
10,008,03,100,0000,0000,2566,63,2629,3514,3921,3,0,3,2,0,2,89.62,74.82,66.67
10,008,04,100,0000,0000,2192,147,2339,3525,3936,3,0,3,3,0,3,89.56,66.35,100.00
10,008,00,110,0000,0000,10446,254,10700,14333,16421,12,5,17,8,3,11,87.28,74.65,64.71
10,008,01,110,0000,0000,3528,90,3618,4902,5569,3,2,5,3,1,4,88.02,73.81,80.00
10,008,02,110,0000,0000,4712,106,4818,6537,7653,5,3,8,3,2,5,85.42,73.70,62.50
10,008,03,110,0000,0000,1185,17,1202,1525,1683,2,0,2,1,0,1,90.61,78.82,50.00
10,008,04,110,0000,0000,1021,41,1062,1369,1516,2,0,2,1,0,1,90.30,77.57,50.00
10,008,00,120,0000,0000,9101,182,9283,12527,15616,17,2,19,10,1,11,80.22,74.10,57.89
10,008,01,120,0000,0000,2225,53,2278,3156,3644,3,2,5,2,1,3,86.61,72.18,60.00
10,008,02,120,0000,0000,2451,57,2508,3310,4295,5,0,5,3,0,3,77.07,75.77,60.00
10,008,03,120,0000,0000,2223,32,2255,2923,3522,4,0,4,2,0,2,82.99,77.15,50.00
10,008,04,120,0000,0000,2202,40,2242,3138,4155,5,0,5,3,0,3,75.52,71.45,60.00
10,008,00,130,0000,0000,9157,145,9302,12174,15729,15,4,19,9,2,11,77.40,76.41,57.89
10,008,01,130,0000,0000,2070,39,2109,2837,3454,3,2,5,2,1,3,82.14,74.34,60.00
10,008,02,130,0000,0000,3285,61,3346,4455,5711,5,2,7,3,1,4,78.01,75.11,57.14
10,008,03,130,0000,0000,2598,33,2631,3384,4653,5,0,5,3,0,3,72.73,77.75,60.00
10,008,04,130,0000,0000,1204,12,1216,1498,1911,2,0,2,1,0,1,78.39,81.17,50.00
10,009,00,000,0000,0000,358730,17403,376133,558026,664604,284,69,353,177,51,228,83.96,67.40,64.59
10,009,00,010,0000,0000,53634,2139,55773,87249,107711,18,9,27,13,4,17,81.00,63.92,62.96
10,009,01,010,0000,0000,14715,580,15295,24060,30440,6,2,8,4,1,5,79.04,63.57,62.50
10,009,02,010,0000,0000,15567,672,16239,25477,31843,5,2,7,4,1,5,80.01,63.74,71.43
10,009,03,010,0000,0000,12400,470,12870,20220,24391,3,4,7,3,1,4,82.90,63.65,57.14
10,009,04,010,0000,0000,10952,417,11369,17492,21037,4,1,5,2,1,3,83.15,65.00,60.00
10,009,01,010,0003,0000,386,18,404,573,0,6,2,8,4,1,5,0.00,70.51,62.50
10,009,01,010,0004,0000,357,20,377,533,0,6,2,8,4,1,5,0.00,70.73,62.50
10,009,01,010,0005,0000,484,20,504,726,0,6,2,8,4,1,5,0.00,69.42,62.50
10,009,01,010,0006,0000,510,23,533,753,0,6,2,8,4,1,5,0.00,70.78,62.50
10,009,01,010,0007,0000,431,22,453,674,0,6,2,8,4,1,5,0.00,67.21,62.50
10,009,01,010,0008,0000,2790,135,2925,4641,0,6,2,8,4,1,5,0.00,63.03,62.50
10,009,01,010,0010,0000,1617,60,1677,2589,0,6,2,8,4,1,5,0.00,64.77,62.50
10,009,01,010,0032,0000,1427,41,1468,2193,0,6,2,8,4,1,5,0.00,66.94,62.50
10,009,01,010,0033,0000,2064,58,2122,3555,0,6,2,8,4,1,5,0.00,59.69,62.50
10,009,01,010,0036,0000,1269,35,1304,2047,0,6,2,8,4,1,5,0.00,63.70,62.50
10,009,01,010,0037,0000,2093,101,2194,3579,0,6,2,8,4,1,5,0.00,61.30,62.50
10,009,01,010,0039,0000,1287,47,1334,2197,0,6,2,8,4,1,5,0.00,60.72,62.50
10,009,01,010,0003,0450,386,18,404,573,0,6,2,8,4,1,5,0.00,70.51,62.50
10,009,01,010,0004,0451,357,20,377,533,0,6,2,8,4,1,5,0.00,70.73,62.50
10,009,01,010,0005,0452,484,20,504,726,0,6,2,8,4,1,5,0.00,69.42,62.50
10,009,01,010,0006,0453,510,23,533,753,0,6,2,8,4,1,5,0.00,70.78,62.50
10,009,01,010,0007,0454,431,22,453,674,0,6,2,8,4,1,5,0.00,67.21,62.50
10,009,01,010,0033,0455,504,17,521,874,0,6,2,8,4,1,5,0.00,59.61,62.50
10,009,01,010,0033,0456,534,16,550,863,0,6,2,8,4,1,5,0.00,63.73,62.50
10,009,01,010,0033,0457,482,13,495,960,0,6,2,8,4,1,5,0.00,51.56,62.50
10,009,01,010,0033,0458,544,12,556,858,0,6,2,8,4,1,5,0.00,64.80,62.50
10,009,01,010,0032,0459,777,23,800,1178,0,6,2,8,4,1,5,0.00,67.91,62.50
10,009,01,010,0032,0460,650,18,668,1015,0,6,2,8,4,1,5,0.00,65.81,62.50
10,009,01,010,0039,0461,618,31,649,1091,0,6,2,8,4,1,5,0.00,59.49,62.50
10,009,01,010,0039,0462,669,16,685,1106,0,6,2,8,4,1,5,0.00,61.93,62.50
10,009,01,010,0008,0463,910,58,968,1584,0,6,2,8,4,1,5,0.00,61.11,62.50
10,009,01,010,0008,0464,736,34,770,1239,0,6,2,8,4,1,5,0.00,62.15,62.50
10,009,01,010,0008,0465,499,22,521,787,0,6,2,8,4,1,5,0.00,66.20,62.50
10,009,01,010,0008,0466,645,21,666,1031,0,6,2,8,4,1,5,0.00,64.60,62.50
10,009,01,010,0037,0467,583,21,604,946,0,6,2,8,4,1,5,0.00,63.85,62.50
10,009,01,010,0037,0468,884,52,936,1537,0,6,2,8,4,1,5,0.00,60.90,62.50
10,009,01,010,0037,0469,626,28,654,1096,0,6,2,8,4,1,5,0.00,59.67,62.50
10,009,01,010,0010,0470,689,16,705,1125,0,6,2,8,4,1,5,0.00,62.67,62.50
10,009,01,010,0010,0471,426,19,445,716,0,6,2,8,4,1,5,0.00,62.15,62.50
10,009,01,010,0010,0472,502,25,527,748,0,6,2,8,4,1,5,0.00,70.45,62.50
10,009,01,010,0036,0473,562,16,578,931,0,6,2,8,4,1,5,0.00,62.08,62.50
10,009,01,010,0036,0474,707,19,726,1116,0,6,2,8,4,1,5,0.00,65.05,62.50
10,009,01,020,0001,0000,763,25,788,1084,0,5,1,6,3,0,3,0.00,72.69,50.00
10,009,01,020,0002,0000,1263,43,1306,2023,0,5,1,6,3,0,3,0.00,64.56,50.00
10,009,01,020,0003,0000,1206,85,1291,2095,0,5,1,6,3,0,3,0.00,61.62,50.00
10,009,01,020,0004,0000,897,48,945,1372,0,5,1,6,3,0,3,0.00,68.88,50.00
10,009,01,020,0005,0000,794,51,845,1179,0,5,1,6,3,0,3,0.00,71.67,50.00
10,009,01,020,0023,0000,1740,77,1817,2782,0,5,1,6,3,0,3,0.00,65.31,50.00
10,009,01,020,0001,0553,763,25,788,1084,0,5,1,6,3,0,3,0.00,72.69,50.00
10,009,01,020,0002,0554,711,30,741,1085,0,5,1,6,3,0,3,0.00,68.29,50.00
10,009,01,020,0002,0555,552,13,565,938,0,5,1,6,3,0,3,0.00,60.23,50.00
10,009,01,020,0023,0556,585,29,614,907,0,5,1,6,3,0,3,0.00,67.70,50.00
10,009,01,020,0023,0557,597,28,625,949,0,5,1,6,3,0,3,0.00,65.86,50.00
10,009,01,020,0023,0558,558,20,578,926,0,5,1,6,3,0,3,0.00,62.42,50.00
10,009,01,020,0003,0559,636,50,686,1120,0,5,1,6,3,0,3,0.00,61.25,50.00
10,009,01,020,0003,0560,570,35,605,975,0,5,1,6,3,0,3,0.00,62.05,50.00
10,009,01,020,0004,0561,897,48,945,1372,0,5,1,6,3,0,3,0.00,68.88,50.00
10,009,01,020,0005,0562,794,51,845,1179,0,5,1,6,3,0,3,0.00,71.67,50.00
10,009,01,030,0001,0000,561,23,584,867,0,8,6,14,3,4,7,0.00,67.36,50.00
10,009,01,030,0002,0000,863,48,911,1596,0,8,6,14,3,4,7,0.00,57.08,50.00
10,009,01,030,0003,0000,1464,69,1533,2423,0,8,6,14,3,4,7,0.00,63.27,50.00
10,009,01,030,0004,0000,1605,74,1679,2648,0,8,6,14,3,4,7,0.00,63.41,50.00
10,009,01,030,0005,0000,1362,67,1429,2365,0,8,6,14,3,4,7,0.00,60.42,50.00
10,009,01,030,0006,0000,1758,102,1860,3027,0,8,6,14,3,4,7,0.00,61.45,50.00
10,009,01,030,0007,0000,782,38,820,1279,0,8,6,14,3,4,7,0.00,64.11,50.00
10,009,01,030,0008,0000,2706,123,2829,4446,0,8,6,14,3,4,7,0.00,63.63,50.00
10,009,01,030,0009,0000,1372,53,1425,2242,0,8,6,14,3,4,7,0.00,63.56,50.00
10,009,01,030,0010,0000,2147,108,2255,3697,0,8,6,14,3,4,7,0.00,61.00,50.00
10,009,01,030,0011,0000,1284,56,1340,1952,0,8,6,14,3,4,7,0.00,68.65,50.00
10,009,01,030,0012,0000,728,32,760,1080,0,8,6,14,3,4,7,0.00,70.37,50.00
10,009,01,030,0003,0121,773,37,810,1255,0,8,6,14,3,4,7,0.00,64.54,50.00
10,009,01,030,0003,0122,691,32,723,1168,0,8,6,14,3,4,7,0.00,61.90,50.00
10,009,01,030,0002,0123,422,23,445,699,0,8,6,14,3,4,7,0.00,63.66,50.00
10,009,01,030,0002,0124,441,25,466,897,0,8,6,14,3,4,7,0.00,51.95,50.00
10,009,01,030,0004,0125,561,25,586,942,0,8,6,14,3,4,7,0.00,62.21,50.00
10,009,01,030,0004,0126,523,24,547,852,0,8,6,14,3,4,7,0.00,64.20,50.00
10,009,01,030,0004,0127,521,25,546,854,0,8,6,14,3,4,7,0.00,63.93,50.00
10,009,01,030,0005,0128,636,35,671,1171,0,8,6,14,3,4,7,0.00,57.30,50.00
10,009,01,030,0005,0129,726,32,758,1194,0,8,6,14,3,4,7,0.00,63.48,50.00
10,009,01,030,0001,0130,561,23,584,867,0,8,6,14,3,4,7,0.00,67.36,50.00
10,009,01,030,0006,0131,569,24,593,941,0,8,6,14,3,4,7,0.00,63.02,50.00
10,009,01,030,0006,0132,592,28,620,996,0,8,6,14,3,4,7,0.00,62.25,50.00
10,009,01,030,0006,0133,597,50,647,1090,0,8,6,14,3,4,7,0.00,59.36,50.00
10,009,01,030,0028,0134,660,38,698,1111,0,8,6,14,3,4,7,0.00,62.83,50.00
10,009,01,030,0028,0135,756,36,792,1195,0,8,6,14,3,4,7,0.00,66.28,50.00
10,009,01,030,0028,0136,687,28,715,1196,0,8,6,14,3,4,7,0.00,59.78,50.00
10,009,01,030,0007,0137,782,38,820,1279,0,8,6,14,3,4,7,0.00,64.11,50.00
10,009,01,030,0008,0138,708,27,735,1096,0,8,6,14,3,4,7,0.00,67.06,50.00
10,009,01,030,0008,0139,639,26,665,1064,0,8,6,14,3,4,7,0.00,62.50,50.00
10,009,01,030,0008,0140,700,43,743,1178,0,8,6,14,3,4,7,0.00,63.07,50.00
10,009,01,030,0008,0141,659,27,686,1108,0,8,6,14,3,4,7,0.00,61.91,50.00
10,009,01,030,0009,0142,766,37,803,1253,0,8,6,14,3,4,7,0.00,64.09,50.00
10,009,01,030,0009,0143,606,16,622,989,0,8,6,14,3,4,7,0.00,62.89,50.00
10,009,01,030,0010,0144,766,32,798,1285,0,8,6,14,3,4,7,0.00,62.10,50.00
10,009,01,030,0010,0145,716,33,749,1284,0,8,6,14,3,4,7,0.00,58.33,50.00
10,009,01,030,0010,0146,665,43,708,1128,0,8,6,14,3,4,7,0.00,62.77,50.00
10,009,01,030,0011,0147,747,25,772,1096,0,8,6,14,3,4,7,0.00,70.44,50.00
10,009,01,030,0011,0148,537,31,568,856,0,8,6,14,3,4,7,0.00,66.36,50.00
10,009,01,030,0012,0149,728,32,760,1080,0,8,6,14,3,4,7,0.00,70.37,50.00
10,009,01,030,0027,0150,293,18,311,481,0,8,6,14,3,4,7,0.00,64.66,50.00
10,009,01,030,0027,0000,293,18,311,481,0,8,6,14,3,4,7,0.00,64.66,50.00
10,009,01,030,0028,0000,2103,102,2205,3502,0,8,6,14,3,4,7,0.00,62.96,50.00
10,009,01,040,0001,0000,954,34,988,1453,0,3,4,7,3,3,6,0.00,68.00,85.71
10,009,01,040,0002,0000,1047,45,1092,1654,0,3,4,7,3,3,6,0.00,66.02,85.71
10,009,01,040,0003,0000,1319,30,1349,1976,0,3,4,7,3,3,6,0.00,68.27,85.71
10,009,01,040,0004,0000,1824,51,1875,2790,0,3,4,7,3,3,6,0.00,67.20,85.71
10,009,01,040,0005,0000,209,12,221,298,0,3,4,7,3,3,6,0.00,74.16,85.71
10,009,01,040,0006,0000,310,19,329,521,0,3,4,7,3,3,6,0.00,63.15,85.71
10,009,01,040,0007,0000,383,11,394,544,0,3,4,7,3,3,6,0.00,72.43,85.71
10,009,01,040,0008,0000,618,20,638,964,0,3,4,7,3,3,6,0.00,66.18,85.71
10,009,01,040,0009,0000,1754,54,1808,2804,0,3,4,7,3,3,6,0.00,64.48,85.71
10,009,01,040,0010,0000,2655,85,2740,4452,0,3,4,7,3,3,6,0.00,61.55,85.71
10,009,01,040,0011,0000,761,36,797,1218,0,3,4,7,3,3,6,0.00,65.44,85.71
10,009,01,040,0012,0000,870,30,900,1408,0,3,4,7,3,3,6,0.00,63.92,85.71
10,009,01,040,0001,0369,461,14,475,716,0,3,4,7,3,3,6,0.00,66.34,85.71
10,009,01,040,0001,0370,493,20,513,737,0,3,4,7,3,3,6,0.00,69.61,85.71
10,009,01,040,0002,0371,491,24,515,779,0,3,4,7,3,3,6,0.00,66.11,85.71
10,009,01,040,0002,0372,556,21,577,875,0,3,4,7,3,3,6,0.00,65.94,85.71
10,009,01,040,0003,0373,683,17,700,995,0,3,4,7,3,3,6,0.00,70.35,85.71
10,009,01,040,0003,0374,636,13,649,981,0,3,4,7,3,3,6,0.00,66.16,85.71
10,009,01,040,0004,0375,632,13,645,942,0,3,4,7,3,3,6,0.00,68.47,85.71
10,009,01,040,0004,0376,559,11,570,816,0,3,4,7,3,3,6,0.00,69.85,85.71
10,009,01,040,0004,0377,633,27,660,1032,0,3,4,7,3,3,6,0.00,63.95,85.71
10,009,01,040,0005,0378,209,12,221,298,0,3,4,7,3,3,6,0.00,74.16,85.71
10,009,01,040,0006,0379,310,19,329,521,0,3,4,7,3,3,6,0.00,63.15,85.71
10,009,01,040,0007,0380,383,11,394,544,0,3,4,7,3,3,6,0.00,72.43,85.71
10,009,01,040,0008,0381,618,20,638,964,0,3,4,7,3,3,6,0.00,66.18,85.71
10,009,01,040,0009,0382,909,42,951,1432,0,3,4,7,3,3,6,0.00,66.41,85.71
10,009,01,040,0009,0383,845,12,857,1372,0,3,4,7,3,3,6,0.00,62.46,85.71
10,009,01,040,0010,0384,625,24,649,1061,0,3,4,7,3,3,6,0.00,61.17,85.71
10,009,01,040,0010,0385,632,25,657,1085,0,3,4,7,3,3,6,0.00,60.55,85.71
10,009,01,040,0010,0386,653,15,668,1066,0,3,4,7,3,3,6,0.00,62.66,85.71
10,009,01,040,0010,0387,745,21,766,1240,0,3,4,7,3,3,6,0.00,61.77,85.71
10,009,01,040,0011,0388,761,36,797,1218,0,3,4,7,3,3,6,0.00,65.44,85.71
10,009,01,040,0012,0389,870,30,900,1408,0,3,4,7,3,3,6,0.00,63.92,85.71
10,009,01,050,0001,0000,519,15,534,736,0,3,2,5,2,2,4,0.00,72.55,80.00
10,009,01,050,0002,0000,560,21,581,824,0,3,2,5,2,2,4,0.00,70.51,80.00
10,009,01,050,0003,0000,874,34,908,1280,0,3,2,5,2,2,4,0.00,70.94,80.00
10,009,01,050,0004,0000,721,27,748,1033,0,3,2,5,2,2,4,0.00,72.41,80.00
10,009,01,050,0005,0000,805,22,827,1055,0,3,2,5,2,2,4,0.00,78.39,80.00
10,009,01,050,0001,0091,519,15,534,736,0,3,2,5,2,2,4,0.00,72.55,80.00
10,009,01,050,0002,0092,560,21,581,824,0,3,2,5,2,2,4,0.00,70.51,80.00
10,009,01,050,0003,0093,393,22,415,611,0,3,2,5,2,2,4,0.00,67.92,80.00
10,009,01,050,0003,0094,481,12,493,669,0,3,2,5,2,2,4,0.00,73.69,80.00
10,009,01,050,0004,0095,721,27,748,1033,0,3,2,5,2,2,4,0.00,72.41,80.00
10,009,01,050,0005,0096,483,16,499,648,0,3,2,5,2,2,4,0.00,77.01,80.00
10,009,01,050,0005,0097,322,6,328,407,0,3,2,5,2,2,4,0.00,80.59,80.00
10,009,01,050,0010,0098,577,15,592,888,0,3,2,5,2,2,4,0.00,66.67,80.00
10,009,01,050,0010,0099,615,17,632,958,0,3,2,5,2,2,4,0.00,65.97,80.00
10,009,01,050,0010,0000,1804,57,1861,2788,0,3,2,5,2,2,4,0.00,66.75,80.00
10,009,01,050,0010,0100,612,25,637,942,0,3,2,5,2,2,4,0.00,67.62,80.00
10,009,01,060,0001,0000,475,35,510,671,0,3,3,6,2,3,5,0.00,76.01,83.33
10,009,01,060,0002,0000,509,25,534,649,0,3,3,6,2,3,5,0.00,82.28,83.33
10,009,01,060,0003,0000,280,3,283,406,0,3,3,6,2,3,5,0.00,69.70,83.33
10,009,01,060,0004,0000,530,28,558,770,0,3,3,6,2,3,5,0.00,72.47,83.33
10,009,01,060,0005,0000,206,16,222,318,0,3,3,6,2,3,5,0.00,69.81,83.33
10,009,01,060,0006,0000,232,9,241,359,0,3,3,6,2,3,5,0.00,67.13,83.33
10,009,01,060,0007,0000,257,17,274,350,0,3,3,6,2,3,5,0.00,78.29,83.33
10,009,01,060,0008,0000,539,30,569,871,0,3,3,6,2,3,5,0.00,65.33,83.33
10,009,01,060,0009,0000,276,14,290,425,0,3,3,6,2,3,5,0.00,68.24,83.33
10,009,01,060,0010,0000,191,16,207,289,0,3,3,6,2,3,5,0.00,71.63,83.33
10,009,01,060,0011,0000,316,15,331,491,0,3,3,6,2,3,5,0.00,67.41,83.33
10,009,01,060,0012,0000,693,32,725,1083,0,3,3,6,2,3,5,0.00,66.94,83.33
10,009,01,060,0013,0000,279,16,295,398,0,3,3,6,2,3,5,0.00,74.12,83.33
10,009,01,060,0014,0000,2931,154,3085,4599,0,3,3,6,2,3,5,0.00,67.08,83.33
10,009,01,060,0015,0000,1011,51,1062,1597,0,3,3,6,2,3,5,0.00,66.50,83.33
10,009,01,060,0026,0000,585,19,604,916,0,3,3,6,2,3,5,0.00,65.94,83.33
10,009,01,060,0027,0000,346,11,357,453,0,3,3,6,2,3,5,0.00,78.81,83.33
10,009,01,060,0001,0278,475,35,510,671,0,3,3,6,2,3,5,0.00,76.01,83.33
10,009,01,060,0002,0279,509,25,534,649,0,3,3,6,2,3,5,0.00,82.28,83.33
10,009,01,060,0003,0280,280,3,283,406,0,3,3,6,2,3,5,0.00,69.70,83.33
10,009,01,060,0004,0281,530,28,558,770,0,3,3,6,2,3,5,0.00,72.47,83.33
10,009,01,060,0005,0282,206,16,222,318,0,3,3,6,2,3,5,0.00,69.81,83.33
10,009,01,060,0006,0283,232,9,241,359,0,3,3,6,2,3,5,0.00,67.13,83.33
10,009,01,060,0007,0284,257,17,274,350,0,3,3,6,2,3,5,0.00,78.29,83.33
10,009,01,060,0008,0285,539,30,569,871,0,3,3,6,2,3,5,0.00,65.33,83.33
10,009,01,060,0009,0286,276,14,290,425,0,3,3,6,2,3,5,0.00,68.24,83.33
10,009,01,060,0010,0287,191,16,207,289,0,3,3,6,2,3,5,0.00,71.63,83.33
10,009,01,060,0011,0288,316,15,331,491,0,3,3,6,2,3,5,0.00,67.41,83.33
10,009,01,060,0012,0289,257,11,268,398,0,3,3,6,2,3,5,0.00,67.34,83.33
10,009,01,060,0012,0290,436,21,457,685,0,3,3,6,2,3,5,0.00,66.72,83.33
10,009,01,060,0013,0291,279,16,295,398,0,3,3,6,2,3,5,0.00,74.12,83.33
10,009,01,060,0014,0292,703,33,736,1084,0,3,3,6,2,3,5,0.00,67.90,83.33
10,009,01,060,0014,0293,722,29,751,1140,0,3,3,6,2,3,5,0.00,65.88,83.33
10,009,01,060,0014,0294,694,43,737,1122,0,3,3,6,2,3,5,0.00,65.69,83.33
10,009,01,060,0014,0295,812,49,861,1253,0,3,3,6,2,3,5,0.00,68.72,83.33
10,009,01,060,0015,0296,414,29,443,664,0,3,3,6,2,3,5,0.00,66.72,83.33
10,009,01,060,0015,0297,597,22,619,933,0,3,3,6,2,3,5,0.00,66.35,83.33
10,009,01,060,0026,0298,585,19,604,916,0,3,3,6,2,3,5,0.00,65.94,83.33
10,009,01,060,0027,0299,346,11,357,453,0,3,3,6,2,3,5,0.00,78.81,83.33
10,009,01,070,0003,0000,807,27,834,1082,0,4,1,5,3,1,4,0.00,77.08,80.00
10,009,01,070,0004,0000,939,15,954,1331,0,4,1,5,3,1,4,0.00,71.68,80.00
10,009,01,070,0005,0000,1818,73,1891,2997,0,4,1,5,3,1,4,0.00,63.10,80.00
10,009,01,070,0006,0000,1029,33,1062,1406,0,4,1,5,3,1,4,0.00,75.53,80.00
10,009,01,070,0007,0000,1284,51,1335,1959,0,4,1,5,3,1,4,0.00,68.15,80.00
10,009,01,070,0007,0589,666,27,693,1036,0,4,1,5,3,1,4,0.00,66.89,80.00
10,009,01,070,0007,0590,618,24,642,923,0,4,1,5,3,1,4,0.00,69.56,80.00
10,009,01,070,0006,0591,546,14,560,723,0,4,1,5,3,1,4,0.00,77.46,80.00
10,009,01,070,0006,0592,483,19,502,683,0,4,1,5,3,1,4,0.00,73.50,80.00
10,009,01,070,0005,0593,574,23,597,898,0,4,1,5,3,1,4,0.00,66.48,80.00
10,009,01,070,0005,0594,682,28,710,1090,0,4,1,5,3,1,4,0.00,65.14,80.00
10,009,01,070,0005,0595,562,22,584,1009,0,4,1,5,3,1,4,0.00,57.88,80.00
10,009,01,070,0004,0596,753,14,767,1047,0,4,1,5,3,1,4,0.00,73.26,80.00
10,009,01,070,0004,0597,186,1,187,284,0,4,1,5,3,1,4,0.00,65.85,80.00
10,009,01,070,0003,0598,807,27,834,1082,0,4,1,5,3,1,4,0.00,77.08,80.00
10,009,01,080,0001,0000,422,71,493,702,0,1,1,2,1,1,2,0.00,70.23,100.00
10,009,01,080,0009,0000,427,71,498,666,0,1,1,2,1,1,2,0.00,74.77,100.00
10,009,01,080,0010,0000,348,28,376,559,0,1,1,2,1,1,2,0.00,67.26,100.00
10,009,01,080,0011,0000,667,56,723,1012,0,1,1,2,1,1,2,0.00,71.44,100.00
10,009,01,080,0001,0532,422,71,493,702,0,1,1,2,1,1,2,0.00,70.23,100.00
10,009,01,080,0009,0533,427,71,498,666,0,1,1,2,1,1,2,0.00,74.77,100.00
10,009,01,080,0010,0534,348,28,376,559,0,1,1,2,1,1,2,0.00,67.26,100.00
10,009,01,080,0011,0535,667,56,723,1012,0,1,1,2,1,1,2,0.00,71.44,100.00
10,009,01,090,0001,0000,2389,196,2585,4017,0,4,1,5,3,1,4,0.00,64.35,80.00
10,009,01,090,0002,0000,624,19,643,811,0,4,1,5,3,1,4,0.00,79.28,80.00
10,009,01,090,0003,0000,897,38,935,1453,0,4,1,5,3,1,4,0.00,64.35,80.00
10,009,01,090,0004,0000,796,20,816,1107,0,4,1,5,3,1,4,0.00,73.71,80.00
10,009,01,090,0005,0000,682,32,714,1022,0,4,1,5,3,1,4,0.00,69.86,80.00
10,009,01,090,0001,0407,563,44,607,957,0,4,1,5,3,1,4,0.00,63.43,80.00
10,009,01,090,0001,0408,467,41,508,867,0,4,1,5,3,1,4,0.00,58.59,80.00
10,009,01,090,0001,0409,598,47,645,933,0,4,1,5,3,1,4,0.00,69.13,80.00
10,009,01,090,0001,0410,761,64,825,1260,0,4,1,5,3,1,4,0.00,65.48,80.00
10,009,01,090,0002,0411,624,19,643,811,0,4,1,5,3,1,4,0.00,79.28,80.00
10,009,01,090,0003,0412,471,13,484,728,0,4,1,5,3,1,4,0.00,66.48,80.00
10,009,01,090,0003,0413,426,25,451,725,0,4,1,5,3,1,4,0.00,62.21,80.00
10,009,01,090,0004,0414,365,14,379,544,0,4,1,5,3,1,4,0.00,69.67,80.00
10,009,01,090,0004,0415,431,6,437,563,0,4,1,5,3,1,4,0.00,77.62,80.00
10,009,01,090,0005,0416,682,32,714,1022,0,4,1,5,3,1,4,0.00,69.86,80.00
10,009,01,100,0001,0000,679,21,700,953,0,4,1,5,2,1,3,0.00,73.45,60.00
10,009,01,100,0002,0000,2296,62,2358,3422,0,4,1,5,2,1,3,0.00,68.91,60.00
10,009,01,100,0001,0434,679,21,700,953,0,4,1,5,2,1,3,0.00,73.45,60.00
10,009,01,100,0002,0435,793,22,815,1185,0,4,1,5,2,1,3,0.00,68.78,60.00
10,009,01,100,0002,0436,556,14,570,829,0,4,1,5,2,1,3,0.00,68.76,60.00
10,009,01,100,0002,0437,520,14,534,781,0,4,1,5,2,1,3,0.00,68.37,60.00
10,009,01,100,0002,0438,427,12,439,627,0,4,1,5,2,1,3,0.00,70.02,60.00
10,009,01,110,0001,0000,897,51,948,1391,0,3,0,3,2,0,2,0.00,68.15,66.67
10,009,01,110,0002,0000,1090,51,1141,1663,0,3,0,3,2,0,2,0.00,68.61,66.67
10,009,01,110,0003,0000,978,29,1007,1511,0,3,0,3,2,0,2,0.00,66.64,66.67
10,009,01,110,0001,0342,530,25,555,810,0,3,0,3,2,0,2,0.00,68.52,66.67
10,009,01,110,0001,0343,367,26,393,581,0,3,0,3,2,0,2,0.00,67.64,66.67
10,009,01,110,0002,0344,590,31,621,894,0,3,0,3,2,0,2,0.00,69.46,66.67
10,009,01,110,0002,0345,500,20,520,769,0,3,0,3,2,0,2,0.00,67.62,66.67
10,009,01,110,0003,0346,377,11,388,581,0,3,0,3,2,0,2,0.00,66.78,66.67
10,009,01,110,0003,0347,601,18,619,930,0,3,0,3,2,0,2,0.00,66.56,66.67
10,009,01,120,0001,0000,713,8,721,1064,0,4,0,4,3,0,3,0.00,67.76,75.00
10,009,01,120,0002,0000,913,24,937,1389,0,4,0,4,3,0,3,0.00,67.46,75.00
10,009,01,120,0003,0000,1477,43,1520,2226,0,4,0,4,3,0,3,0.00,68.28,75.00
10,009,01,120,0001,0321,713,8,721,1064,0,4,0,4,3,0,3,0.00,67.76,75.00
10,009,01,120,0002,0322,913,24,937,1389,0,4,0,4,3,0,3,0.00,67.46,75.00
10,009,01,120,0003,0323,681,29,710,1084,0,4,0,4,3,0,3,0.00,65.50,75.00
10,009,01,120,0003,0324,796,14,810,1142,0,4,0,4,3,0,3,0.00,70.93,75.00
10,009,01,130,0002,0001,844,37,881,1337,0,4,2,6,4,1,5,0.00,65.89,83.33
10,009,01,130,0002,0002,735,41,776,1226,0,4,2,6,4,1,5,0.00,63.30,83.33
10,009,01,130,0002,0003,811,31,842,1283,0,4,2,6,4,1,5,0.00,65.63,83.33
10,009,01,130,0002,0004,930,32,962,1492,0,4,2,6,4,1,5,0.00,64.48,83.33
10,009,01,130,0002,0005,746,34,780,1068,0,4,2,6,4,1,5,0.00,73.03,83.33
10,009,01,130,0002,0006,627,27,654,1030,0,4,2,6,4,1,5,0.00,63.50,83.33
10,009,01,130,0001,0007,713,20,733,1123,0,4,2,6,4,1,5,0.00,65.27,83.33
10,009,01,130,0001,0008,580,23,603,942,0,4,2,6,4,1,5,0.00,64.01,83.33
10,009,01,130,0001,0009,765,14,779,1174,0,4,2,6,4,1,5,0.00,66.35,83.33
10,009,01,130,0001,0000,2584,83,2667,4229,0,4,2,6,4,1,5,0.00,63.06,83.33
10,009,01,130,0001,0010,526,26,552,990,0,4,2,6,4,1,5,0.00,55.76,83.33
10,009,01,130,0003,0011,466,13,479,726,0,4,2,6,4,1,5,0.00,65.98,83.33
10,009,01,130,0003,0012,803,44,847,1235,0,4,2,6,4,1,5,0.00,68.58,83.33
10,009,01,130,0004,0013,693,39,732,1180,0,4,2,6,4,1,5,0.00,62.03,83.33
10,009,01,130,0004,0014,618,31,649,999,0,4,2,6,4,1,5,0.00,64.96,83.33
10,009,01,130,0004,0015,434,33,467,683,0,4,2,6,4,1,5,0.00,68.37,83.33
10,009,01,130,0007,0016,744,35,779,1221,0,4,2,6,4,1,5,0.00,63.80,83.33
10,009,01,130,0007,0017,619,12,631,987,0,4,2,6,4,1,5,0.00,63.93,83.33
10,009,01,130,0002,0000,4693,202,4895,7436,0,4,2,6,4,1,5,0.00,65.83,83.33
10,009,01,130,0003,0000,1269,57,1326,1961,0,4,2,6,4,1,5,0.00,67.62,83.33
10,009,01,130,0004,0000,1745,103,1848,2862,0,4,2,6,4,1,5,0.00,64.57,83.33
10,009,01,130,0007,0000,1363,47,1410,2208,0,4,2,6,4,1,5,0.00,63.86,83.33
10,009,01,140,0003,0000,1033,53,1086,1465,0,4,0,4,3,0,3,0.00,74.13,75.00
10,009,01,140,0004,0000,354,22,376,510,0,4,0,4,3,0,3,0.00,73.73,75.00
10,009,01,140,0005,0000,687,37,724,1101,0,4,0,4,3,0,3,0.00,65.76,75.00
10,009,01,140,0005,0061,687,37,724,1101,0,4,0,4,3,0,3,0.00,65.76,75.00
10,009,01,140,0004,0062,354,22,376,510,0,4,0,4,3,0,3,0.00,73.73,75.00
10,009,01,140,0003,0063,583,27,610,827,0,4,0,4,3,0,3,0.00,73.76,75.00
10,009,01,140,0003,0064,450,26,476,638,0,4,0,4,3,0,3,0.00,74.61,75.00
10,009,01,150,0001,0000,1269,31,1300,1803,0,3,1,4,3,0,3,0.00,72.10,75.00
10,009,01,150,0002,0000,979,20,999,1376,0,3,1,4,3,0,3,0.00,72.60,75.00
10,009,01,150,0001,0077,609,12,621,836,0,3,1,4,3,0,3,0.00,74.28,75.00
10,009,01,150,0001,0078,660,19,679,967,0,3,1,4,3,0,3,0.00,70.22,75.00
10,009,01,150,0002,0079,493,12,505,691,0,3,1,4,3,0,3,0.00,73.08,75.00
10,009,01,150,0002,0080,486,8,494,685,0,3,1,4,3,0,3,0.00,72.12,75.00
10,009,01,160,0001,0000,778,25,803,1179,0,4,0,4,3,0,3,0.00,68.11,75.00
10,009,01,160,0002,0000,793,35,828,1067,0,4,0,4,3,0,3,0.00,77.60,75.00
10,009,01,160,0003,0000,751,23,774,1053,0,4,0,4,3,0,3,0.00,73.50,75.00
10,009,01,160,0001,0037,778,25,803,1179,0,4,0,4,3,0,3,0.00,68.11,75.00
10,009,01,160,0003,0038,751,23,774,1053,0,4,0,4,3,0,3,0.00,73.50,75.00
10,009,01,160,0002,0039,793,35,828,1067,0,4,0,4,3,0,3,0.00,77.60,75.00
10,009,01,160,0004,0000,1229,43,1272,1895,0,4,0,4,3,0,3,0.00,67.12,75.00
10,009,01,160,0004,0040,582,20,602,955,0,4,0,4,3,0,3,0.00,63.04,75.00
10,009,01,160,0004,0041,647,23,670,940,0,4,0,4,3,0,3,0.00,71.28,75.00
10,009,01,160,0010,0042,502,20,522,787,0,4,0,4,3,0,3,0.00,66.33,75.00
10,009,01,160,0010,0000,502,20,522,787,0,4,0,4,3,0,3,0.00,66.33,75.00
10,009,01,170,0001,0000,1938,77,2015,3152,0,4,2,6,4,1,5,0.00,63.93,83.33
10,009,01,170,0002,0000,847,24,871,1409,0,4,2,6,4,1,5,0.00,61.82,83.33
10,009,01,170,0003,0000,783,22,805,1250,0,4,2,6,4,1,5,0.00,64.40,83.33
10,009,01,170,0004,0000,472,32,504,671,0,4,2,6,4,1,5,0.00,75.11,83.33
10,009,01,170,0005,0000,532,22,554,884,0,4,2,6,4,1,5,0.00,62.67,83.33
10,009,01,170,0006,0000,612,23,635,976,0,4,2,6,4,1,5,0.00,65.06,83.33
10,009,01,170,0007,0000,519,19,538,837,0,4,2,6,4,1,5,0.00,64.28,83.33
10,009,01,170,0008,0000,463,16,479,701,0,4,2,6,4,1,5,0.00,68.33,83.33
10,009,01,170,0009,0000,360,12,372,546,0,4,2,6,4,1,5,0.00,68.13,83.33
10,009,01,170,0001,0200,490,23,513,859,0,4,2,6,4,1,5,0.00,59.72,83.33
10,009,01,170,0001,0201,819,27,846,1233,0,4,2,6,4,1,5,0.00,68.61,83.33
10,009,01,170,0001,0202,629,27,656,1060,0,4,2,6,4,1,5,0.00,61.89,83.33
10,009,01,170,0002,0203,414,11,425,666,0,4,2,6,4,1,5,0.00,63.81,83.33
10,009,01,170,0002,0204,433,13,446,743,0,4,2,6,4,1,5,0.00,60.03,83.33
10,009,01,170,0003,0205,783,22,805,1250,0,4,2,6,4,1,5,0.00,64.40,83.33
10,009,01,170,0004,0206,472,32,504,671,0,4,2,6,4,1,5,0.00,75.11,83.33
10,009,01,170,0005,0207,532,22,554,884,0,4,2,6,4,1,5,0.00,62.67,83.33
10,009,01,170,0006,0208,612,23,635,976,0,4,2,6,4,1,5,0.00,65.06,83.33
10,009,01,170,0007,0209,519,19,538,837,0,4,2,6,4,1,5,0.00,64.28,83.33
10,009,01,170,0008,0210,463,16,479,701,0,4,2,6,4,1,5,0.00,68.33,83.33
10,009,01,170,0009,0211,360,12,372,546,0,4,2,6,4,1,5,0.00,68.13,83.33
10,009,01,180,0001,0000,1138,19,1157,1656,0,6,2,8,4,1,5,0.00,69.87,62.50
10,009,01,180,0002,0000,393,10,403,597,0,6,2,8,4,1,5,0.00,67.50,62.50
10,009,01,180,0003,0000,702,15,717,911,0,6,2,8,4,1,5,0.00,78.70,62.50
10,009,01,180,0004,0000,548,9,557,843,0,6,2,8,4,1,5,0.00,66.07,62.50
10,009,01,180,0005,0000,1514,33,1547,2138,0,6,2,8,4,1,5,0.00,72.36,62.50
10,009,01,180,0006,0000,701,17,718,1118,0,6,2,8,4,1,5,0.00,64.22,62.50
10,009,01,180,0007,0000,496,13,509,689,0,6,2,8,4,1,5,0.00,73.88,62.50
10,009,01,180,0008,0000,651,7,658,833,0,6,2,8,4,1,5,0.00,78.99,62.50
10,009,01,180,0001,0175,656,12,668,994,0,6,2,8,4,1,5,0.00,67.20,62.50
10,009,01,180,0001,0176,482,7,489,662,0,6,2,8,4,1,5,0.00,73.87,62.50
10,009,01,180,0005,0177,586,10,596,824,0,6,2,8,4,1,5,0.00,72.33,62.50
10,009,01,180,0005,0178,291,5,296,440,0,6,2,8,4,1,5,0.00,67.27,62.50
10,009,01,180,0005,0179,637,18,655,874,0,6,2,8,4,1,5,0.00,74.94,62.50
10,009,01,180,0002,0180,393,10,403,597,0,6,2,8,4,1,5,0.00,67.50,62.50
10,009,01,180,0003,0181,702,15,717,911,0,6,2,8,4,1,5,0.00,78.70,62.50
10,009,01,180,0004,0182,548,9,557,843,0,6,2,8,4,1,5,0.00,66.07,62.50
10,009,01,180,0008,0183,651,7,658,833,0,6,2,8,4,1,5,0.00,78.99,62.50
10,009,01,180,0007,0184,496,13,509,689,0,6,2,8,4,1,5,0.00,73.88,62.50
10,009,01,180,0006,0185,701,17,718,1118,0,6,2,8,4,1,5,0.00,64.22,62.50
10,009,01,190,0001,0000,778,32,810,1155,0,5,0,5,3,0,3,0.00,70.13,60.00
10,009,01,190,0002,0000,734,37,771,1060,0,5,0,5,3,0,3,0.00,72.74,60.00
10,009,01,190,0003,0000,454,12,466,613,0,5,0,5,3,0,3,0.00,76.02,60.00
10,009,01,190,0004,0000,576,26,602,853,0,5,0,5,3,0,3,0.00,70.57,60.00
10,009,01,190,0005,0000,461,16,477,665,0,5,0,5,3,0,3,0.00,71.73,60.00
10,009,01,190,0006,0000,658,29,687,954,0,5,0,5,3,0,3,0.00,72.01,60.00
10,009,01,190,0007,0000,720,19,739,1342,0,5,0,5,3,0,3,0.00,55.07,60.00
10,009,01,190,0002,0226,734,37,771,1060,0,5,0,5,3,0,3,0.00,72.74,60.00
10,009,01,190,0001,0227,778,32,810,1155,0,5,0,5,3,0,3,0.00,70.13,60.00
10,009,01,190,0003,0228,454,12,466,613,0,5,0,5,3,0,3,0.00,76.02,60.00
10,009,01,190,0005,0229,461,16,477,665,0,5,0,5,3,0,3,0.00,71.73,60.00
10,009,01,190,0004,0230,576,26,602,853,0,5,0,5,3,0,3,0.00,70.57,60.00
10,009,01,190,0006,0231,658,29,687,954,0,5,0,5,3,0,3,0.00,72.01,60.00
10,009,01,190,0007,0232,720,19,739,1342,0,5,0,5,3,0,3,0.00,55.07,60.00
10,009,01,200,0001,0000,1266,31,1297,2042,0,5,2,7,3,2,5,0.00,63.52,71.43
10,009,01,200,0002,0000,1332,29,1361,1913,0,5,2,7,3,2,5,0.00,71.14,71.43
10,009,01,200,0011,0000,482,11,493,649,0,5,2,7,3,2,5,0.00,75.96,71.43
10,009,01,200,0012,0000,526,14,540,651,0,5,2,7,3,2,5,0.00,82.95,71.43
10,009,01,200,0013,0000,763,15,778,994,0,5,2,7,3,2,5,0.00,78.27,71.43
10,009,01,200,0014,0000,620,13,633,930,0,5,2,7,3,2,5,0.00,68.06,71.43
10,009,01,200,0015,0000,519,15,534,756,0,5,2,7,3,2,5,0.00,70.63,71.43
10,009,01,200,0023,0000,412,13,425,615,0,5,2,7,3,2,5,0.00,69.11,71.43
10,009,01,200,0001,0252,743,20,763,1224,0,5,2,7,3,2,5,0.00,62.34,71.43
10,009,01,200,0001,0253,523,11,534,818,0,5,2,7,3,2,5,0.00,65.28,71.43
10,009,01,200,0002,0254,832,17,849,1201,0,5,2,7,3,2,5,0.00,70.69,71.43
10,009,01,200,0002,0255,500,12,512,712,0,5,2,7,3,2,5,0.00,71.91,71.43
10,009,01,200,0011,0256,482,11,493,649,0,5,2,7,3,2,5,0.00,75.96,71.43
10,009,01,200,0012,0257,526,14,540,651,0,5,2,7,3,2,5,0.00,82.95,71.43
10,009,01,200,0014,0258,620,13,633,930,0,5,2,7,3,2,5,0.00,68.06,71.43
10,009,01,200,0015,0259,519,15,534,756,0,5,2,7,3,2,5,0.00,70.63,71.43
10,009,01,200,0013,0260,763,15,778,994,0,5,2,7,3,2,5,0.00,78.27,71.43
10,009,01,200,0023,0261,412,13,425,615,0,5,2,7,3,2,5,0.00,69.11,71.43
10,009,00,020,0000,0000,23867,940,24807,36432,43263,17,5,22,7,4,11,84.21,68.09,50.00
10,009,01,020,0000,0000,6663,329,6992,10535,12743,5,1,6,3,0,3,82.67,66.37,50.00
10,009,02,020,0000,0000,4838,170,5008,6953,7911,3,0,3,2,0,2,87.89,72.03,66.67
10,009,03,020,0000,0000,7733,286,8019,11832,14213,5,3,8,1,3,4,83.25,67.77,50.00
10,009,04,020,0000,0000,4633,155,4788,7112,8396,4,1,5,1,1,2,84.71,67.32,40.00
10,009,02,010,0001,0000,851,36,887,1314,0,5,2,7,4,1,5,0.00,67.50,71.43
10,009,02,010,0002,0000,663,23,686,1017,0,5,2,7,4,1,5,0.00,67.45,71.43
10,009,02,010,0009,0000,1728,77,1805,3013,0,5,2,7,4,1,5,0.00,59.91,71.43
10,009,02,010,0011,0000,1077,71,1148,1695,0,5,2,7,4,1,5,0.00,67.73,71.43
10,009,02,010,0012,0000,1978,87,2065,3312,0,5,2,7,4,1,5,0.00,62.35,71.43
10,009,02,010,0013,0000,2445,86,2531,4011,0,5,2,7,4,1,5,0.00,63.10,71.43
10,009,02,010,0014,0000,1425,47,1472,2266,0,5,2,7,4,1,5,0.00,64.96,71.43
10,009,02,010,0019,0000,945,33,978,1441,0,5,2,7,4,1,5,0.00,67.87,71.43
10,009,02,010,0034,0000,1622,73,1695,2723,0,5,2,7,4,1,5,0.00,62.25,71.43
10,009,02,010,0035,0000,1279,69,1348,2150,0,5,2,7,4,1,5,0.00,62.70,71.43
10,009,02,010,0038,0000,1554,70,1624,2535,0,5,2,7,4,1,5,0.00,64.06,71.43
10,009,02,010,0001,0475,851,36,887,1314,0,5,2,7,4,1,5,0.00,67.50,71.43
10,009,02,010,0002,0476,663,23,686,1017,0,5,2,7,4,1,5,0.00,67.45,71.43
10,009,02,010,0009,0477,521,22,543,828,0,5,2,7,4,1,5,0.00,65.58,71.43
10,009,02,010,0009,0478,612,24,636,1103,0,5,2,7,4,1,5,0.00,57.66,71.43
10,009,02,010,0009,0479,595,31,626,1082,0,5,2,7,4,1,5,0.00,57.86,71.43
10,009,02,010,0034,0480,785,40,825,1380,0,5,2,7,4,1,5,0.00,59.78,71.43
10,009,02,010,0034,0481,837,33,870,1343,0,5,2,7,4,1,5,0.00,64.78,71.43
10,009,02,010,0014,0482,744,28,772,1106,0,5,2,7,4,1,5,0.00,69.80,71.43
10,009,02,010,0014,0483,681,19,700,1160,0,5,2,7,4,1,5,0.00,60.34,71.43
10,009,02,010,0013,0484,914,28,942,1401,0,5,2,7,4,1,5,0.00,67.24,71.43
10,009,02,010,0013,0485,742,27,769,1268,0,5,2,7,4,1,5,0.00,60.65,71.43
10,009,02,010,0013,0486,789,31,820,1342,0,5,2,7,4,1,5,0.00,61.10,71.43
10,009,02,010,0038,0487,702,33,735,1151,0,5,2,7,4,1,5,0.00,63.86,71.43
10,009,02,010,0038,0488,852,37,889,1384,0,5,2,7,4,1,5,0.00,64.23,71.43
10,009,02,010,0012,0489,620,37,657,1019,0,5,2,7,4,1,5,0.00,64.47,71.43
10,009,02,010,0012,0490,729,28,757,1208,0,5,2,7,4,1,5,0.00,62.67,71.43
10,009,02,010,0012,0491,629,22,651,1085,0,5,2,7,4,1,5,0.00,60.00,71.43
10,009,02,010,0035,0492,476,20,496,799,0,5,2,7,4,1,5,0.00,62.08,71.43
10,009,02,010,0035,0493,803,49,852,1351,0,5,2,7,4,1,5,0.00,63.06,71.43
10,009,02,010,0011,0494,623,34,657,956,0,5,2,7,4,1,5,0.00,68.72,71.43
10,009,02,010,0011,0495,454,37,491,739,0,5,2,7,4,1,5,0.00,66.44,71.43
10,009,02,010,0019,0496,945,33,978,1441,0,5,2,7,4,1,5,0.00,67.87,71.43
10,009,02,020,0007,0000,847,30,877,1248,0,3,0,3,2,0,2,0.00,70.27,66.67
10,009,02,020,0008,0000,550,10,560,714,0,3,0,3,2,0,2,0.00,78.43,66.67
10,009,02,020,0009,0000,584,18,602,824,0,3,0,3,2,0,2,0.00,73.06,66.67
10,009,02,020,0010,0000,450,16,466,687,0,3,0,3,2,0,2,0.00,67.83,66.67
10,009,02,020,0011,0000,801,28,829,1074,0,3,0,3,2,0,2,0.00,77.19,66.67
10,009,02,020,0012,0000,1062,56,1118,1629,0,3,0,3,2,0,2,0.00,68.63,66.67
10,009,02,020,0022,0000,544,12,556,777,0,3,0,3,2,0,2,0.00,71.56,66.67
10,009,02,020,0007,0563,847,30,877,1248,0,3,0,3,2,0,2,0.00,70.27,66.67
10,009,02,020,0008,0564,550,10,560,714,0,3,0,3,2,0,2,0.00,78.43,66.67
10,009,02,020,0022,0565,544,12,556,777,0,3,0,3,2,0,2,0.00,71.56,66.67
10,009,02,020,0009,0566,584,18,602,824,0,3,0,3,2,0,2,0.00,73.06,66.67
10,009,02,020,0010,0567,450,16,466,687,0,3,0,3,2,0,2,0.00,67.83,66.67
10,009,02,020,0011,0568,801,28,829,1074,0,3,0,3,2,0,2,0.00,77.19,66.67
10,009,02,020,0012,0569,574,26,600,825,0,3,0,3,2,0,2,0.00,72.73,66.67
10,009,02,020,0012,0570,488,30,518,804,0,3,0,3,2,0,2,0.00,64.43,66.67
10,009,02,030,0018,0151,785,127,912,1325,0,2,0,2,2,0,2,0.00,68.83,100.00
10,009,02,030,0018,0152,757,108,865,1197,0,2,0,2,2,0,2,0.00,72.26,100.00
10,009,02,030,0019,0153,488,77,565,809,0,2,0,2,2,0,2,0.00,69.84,100.00
10,009,02,030,0020,0154,439,96,535,826,0,2,0,2,2,0,2,0.00,64.77,100.00
10,009,02,030,0020,0155,460,71,531,857,0,2,0,2,2,0,2,0.00,61.96,100.00
10,009,02,030,0021,0156,470,114,584,795,0,2,0,2,2,0,2,0.00,73.46,100.00
10,009,02,030,0021,0157,467,111,578,790,0,2,0,2,2,0,2,0.00,73.16,100.00
10,009,02,030,0022,0158,591,123,714,1108,0,2,0,2,2,0,2,0.00,64.44,100.00
10,009,02,030,0022,0159,612,106,718,1114,0,2,0,2,2,0,2,0.00,64.45,100.00
10,009,02,030,0022,0160,690,131,821,1225,0,2,0,2,2,0,2,0.00,67.02,100.00
10,009,02,030,0018,0000,1542,235,1777,2522,0,2,0,2,2,0,2,0.00,70.46,100.00
10,009,02,030,0019,0000,488,77,565,809,0,2,0,2,2,0,2,0.00,69.84,100.00
10,009,02,030,0020,0000,899,167,1066,1683,0,2,0,2,2,0,2,0.00,63.34,100.00
10,009,02,030,0021,0000,937,225,1162,1585,0,2,0,2,2,0,2,0.00,73.31,100.00
10,009,02,030,0022,0000,1893,360,2253,3447,0,2,0,2,2,0,2,0.00,65.36,100.00
10,009,02,040,0017,0000,939,143,1082,1520,0,2,0,2,2,0,2,0.00,71.18,100.00
10,009,02,040,0018,0000,477,46,523,834,0,2,0,2,2,0,2,0.00,62.71,100.00
10,009,02,040,0019,0000,547,76,623,900,0,2,0,2,2,0,2,0.00,69.22,100.00
10,009,02,040,0020,0000,524,93,617,820,0,2,0,2,2,0,2,0.00,75.24,100.00
10,009,02,040,0021,0000,823,167,990,1410,0,2,0,2,2,0,2,0.00,70.21,100.00
10,009,02,040,0022,0000,561,61,622,906,0,2,0,2,2,0,2,0.00,68.65,100.00
10,009,02,040,0017,0390,494,63,557,784,0,2,0,2,2,0,2,0.00,71.05,100.00
10,009,02,040,0017,0391,445,80,525,736,0,2,0,2,2,0,2,0.00,71.33,100.00
10,009,02,040,0018,0392,477,46,523,834,0,2,0,2,2,0,2,0.00,62.71,100.00
10,009,02,040,0019,0393,547,76,623,900,0,2,0,2,2,0,2,0.00,69.22,100.00
10,009,02,040,0021,0394,823,167,990,1410,0,2,0,2,2,0,2,0.00,70.21,100.00
10,009,02,040,0020,0395,524,93,617,820,0,2,0,2,2,0,2,0.00,75.24,100.00
10,009,02,040,0022,0396,561,61,622,906,0,2,0,2,2,0,2,0.00,68.65,100.00
10,009,02,050,0006,0000,810,108,918,1337,0,2,0,2,2,0,2,0.00,68.66,100.00
10,009,02,050,0007,0000,710,66,776,1214,0,2,0,2,2,0,2,0.00,63.92,100.00
10,009,02,050,0008,0000,729,39,768,1148,0,2,0,2,2,0,2,0.00,66.90,100.00
10,009,02,050,0006,0101,371,52,423,591,0,2,0,2,2,0,2,0.00,71.57,100.00
10,009,02,050,0006,0102,439,56,495,746,0,2,0,2,2,0,2,0.00,66.35,100.00
10,009,02,050,0007,0103,391,37,428,696,0,2,0,2,2,0,2,0.00,61.49,100.00
10,009,02,050,0007,0104,319,29,348,518,0,2,0,2,2,0,2,0.00,67.18,100.00
10,009,02,050,0008,0105,401,19,420,657,0,2,0,2,2,0,2,0.00,63.93,100.00
10,009,02,050,0008,0106,328,20,348,491,0,2,0,2,2,0,2,0.00,70.88,100.00
10,009,02,060,0016,0000,3623,246,3869,6063,0,3,2,5,2,2,4,0.00,63.81,80.00
10,009,02,060,0017,0000,651,46,697,1078,0,3,2,5,2,2,4,0.00,64.66,80.00
10,009,02,060,0018,0000,474,20,494,762,0,3,2,5,2,2,4,0.00,64.83,80.00
10,009,02,060,0019,0000,845,46,891,1270,0,3,2,5,2,2,4,0.00,70.16,80.00
10,009,02,060,0021,0000,597,15,612,933,0,3,2,5,2,2,4,0.00,65.59,80.00
10,009,02,060,0028,0000,309,18,327,385,0,3,2,5,2,2,4,0.00,84.94,80.00
10,009,02,060,0016,0300,798,49,847,1312,0,3,2,5,2,2,4,0.00,64.56,80.00
10,009,02,060,0016,0301,616,45,661,1044,0,3,2,5,2,2,4,0.00,63.31,80.00
10,009,02,060,0016,0302,437,31,468,743,0,3,2,5,2,2,4,0.00,62.99,80.00
10,009,02,060,0016,0303,484,28,512,770,0,3,2,5,2,2,4,0.00,66.49,80.00
10,009,02,060,0016,0304,617,60,677,1089,0,3,2,5,2,2,4,0.00,62.17,80.00
10,009,02,060,0016,0305,671,33,704,1105,0,3,2,5,2,2,4,0.00,63.71,80.00
10,009,02,060,0017,0306,651,46,697,1078,0,3,2,5,2,2,4,0.00,64.66,80.00
10,009,02,060,0021,0307,304,6,310,507,0,3,2,5,2,2,4,0.00,61.14,80.00
10,009,02,060,0021,0308,293,9,302,426,0,3,2,5,2,2,4,0.00,70.89,80.00
10,009,02,060,0028,0309,309,18,327,385,0,3,2,5,2,2,4,0.00,84.94,80.00
10,009,02,060,0018,0310,474,20,494,762,0,3,2,5,2,2,4,0.00,64.83,80.00
10,009,02,060,0019,0311,404,27,431,575,0,3,2,5,2,2,4,0.00,74.96,80.00
10,009,02,060,0019,0312,441,19,460,695,0,3,2,5,2,2,4,0.00,66.19,80.00
10,009,02,070,0001,0000,745,18,763,1145,0,4,2,6,2,2,4,0.00,66.64,66.67
10,009,02,070,0002,0000,712,28,740,1042,0,4,2,6,2,2,4,0.00,71.02,66.67
10,009,02,070,0017,0000,1394,40,1434,2181,0,4,2,6,2,2,4,0.00,65.75,66.67
10,009,02,070,0018,0000,1274,37,1311,1994,0,4,2,6,2,2,4,0.00,65.75,66.67
10,009,02,070,0019,0000,1089,30,1119,1560,0,4,2,6,2,2,4,0.00,71.73,66.67
10,009,02,070,0020,0000,432,16,448,676,0,4,2,6,2,2,4,0.00,66.27,66.67
10,009,02,070,0001,0599,745,18,763,1145,0,4,2,6,2,2,4,0.00,66.64,66.67
10,009,02,070,0002,0600,712,28,740,1042,0,4,2,6,2,2,4,0.00,71.02,66.67
10,009,02,070,0017,0601,696,25,721,1088,0,4,2,6,2,2,4,0.00,66.27,66.67
10,009,02,070,0017,0602,698,15,713,1093,0,4,2,6,2,2,4,0.00,65.23,66.67
10,009,02,070,0018,0603,575,20,595,909,0,4,2,6,2,2,4,0.00,65.46,66.67
10,009,02,070,0018,0604,699,17,716,1085,0,4,2,6,2,2,4,0.00,65.99,66.67
10,009,02,070,0019,0605,1089,30,1119,1560,0,4,2,6,2,2,4,0.00,71.73,66.67
10,009,02,070,0020,0606,432,16,448,676,0,4,2,6,2,2,4,0.00,66.27,66.67
10,009,02,080,0002,0000,1488,31,1519,2059,0,6,2,8,2,2,4,0.00,73.77,50.00
10,009,02,080,0003,0000,676,15,691,921,0,6,2,8,2,2,4,0.00,75.03,50.00
10,009,02,080,0004,0000,626,9,635,863,0,6,2,8,2,2,4,0.00,73.58,50.00
10,009,02,080,0007,0000,1038,29,1067,1496,0,6,2,8,2,2,4,0.00,71.32,50.00
10,009,02,080,0002,0536,647,11,658,912,0,6,2,8,2,2,4,0.00,72.15,50.00
10,009,02,080,0002,0537,411,9,420,569,0,6,2,8,2,2,4,0.00,73.81,50.00
10,009,02,080,0002,0538,430,11,441,578,0,6,2,8,2,2,4,0.00,76.30,50.00
10,009,02,080,0003,0539,676,15,691,921,0,6,2,8,2,2,4,0.00,75.03,50.00
10,009,02,080,0004,0540,626,9,635,863,0,6,2,8,2,2,4,0.00,73.58,50.00
10,009,02,080,0007,0541,426,7,433,549,0,6,2,8,2,2,4,0.00,78.87,50.00
10,009,02,080,0007,0542,612,22,634,947,0,6,2,8,2,2,4,0.00,66.95,50.00
10,009,02,090,0006,0000,1372,26,1398,1936,0,3,2,5,3,1,4,0.00,72.21,80.00
10,009,02,090,0007,0000,1932,41,1973,2948,0,3,2,5,3,1,4,0.00,66.93,80.00
10,009,02,090,0008,0000,899,14,913,1182,0,3,2,5,3,1,4,0.00,77.24,80.00
10,009,02,090,0010,0000,1337,20,1357,1795,0,3,2,5,3,1,4,0.00,75.60,80.00
10,009,02,090,0006,0417,702,18,720,980,0,3,2,5,3,1,4,0.00,73.47,80.00
10,009,02,090,0006,0418,670,8,678,956,0,3,2,5,3,1,4,0.00,70.92,80.00
10,009,02,090,0007,0419,719,12,731,1051,0,3,2,5,3,1,4,0.00,69.55,80.00
10,009,02,090,0007,0420,588,12,600,885,0,3,2,5,3,1,4,0.00,67.80,80.00
10,009,02,090,0007,0421,625,17,642,1012,0,3,2,5,3,1,4,0.00,63.44,80.00
10,009,02,090,0008,0422,899,14,913,1182,0,3,2,5,3,1,4,0.00,77.24,80.00
10,009,02,090,0010,0423,628,8,636,827,0,3,2,5,3,1,4,0.00,76.90,80.00
10,009,02,090,0010,0424,709,12,721,968,0,3,2,5,3,1,4,0.00,74.48,80.00
10,009,02,100,0003,0000,1388,40,1428,1998,0,5,0,5,2,0,2,0.00,71.47,40.00
10,009,02,100,0004,0000,360,11,371,479,0,5,0,5,2,0,2,0.00,77.45,40.00
10,009,02,100,0003,0439,908,32,940,1320,0,5,0,5,2,0,2,0.00,71.21,40.00
10,009,02,100,0003,0440,480,8,488,678,0,5,0,5,2,0,2,0.00,71.98,40.00
10,009,02,100,0004,0441,360,11,371,479,0,5,0,5,2,0,2,0.00,77.45,40.00
10,009,02,110,0004,0000,812,17,829,1404,0,4,0,4,2,0,2,0.00,59.05,50.00
10,009,02,110,0005,0000,741,41,782,1096,0,4,0,4,2,0,2,0.00,71.35,50.00
10,009,02,110,0006,0000,1168,27,1195,1771,0,4,0,4,2,0,2,0.00,67.48,50.00
10,009,02,110,0004,0348,240,1,241,418,0,4,0,4,2,0,2,0.00,57.66,50.00
10,009,02,110,0004,0349,572,16,588,986,0,4,0,4,2,0,2,0.00,59.63,50.00
10,009,02,110,0005,0350,741,41,782,1096,0,4,0,4,2,0,2,0.00,71.35,50.00
10,009,02,110,0006,0351,611,17,628,980,0,4,0,4,2,0,2,0.00,64.08,50.00
10,009,02,110,0006,0352,557,10,567,791,0,4,0,4,2,0,2,0.00,71.68,50.00
10,009,02,120,0004,0000,1167,34,1201,1970,0,4,0,4,3,0,3,0.00,60.96,75.00
10,009,02,120,0005,0000,1251,68,1319,1968,0,4,0,4,3,0,3,0.00,67.02,75.00
10,009,02,120,0006,0000,738,19,757,1214,0,4,0,4,3,0,3,0.00,62.36,75.00
10,009,02,120,0004,0325,644,17,661,1024,0,4,0,4,3,0,3,0.00,64.55,75.00
10,009,02,120,0004,0326,523,17,540,946,0,4,0,4,3,0,3,0.00,57.08,75.00
10,009,02,120,0005,0327,610,27,637,928,0,4,0,4,3,0,3,0.00,68.64,75.00
10,009,02,120,0005,0328,641,41,682,1040,0,4,0,4,3,0,3,0.00,65.58,75.00
10,009,02,120,0006,0329,738,19,757,1214,0,4,0,4,3,0,3,0.00,62.36,75.00
10,009,02,130,0006,0018,632,33,665,1073,0,3,0,3,2,0,2,0.00,61.98,66.67
10,009,02,130,0006,0019,528,28,556,922,0,3,0,3,2,0,2,0.00,60.30,66.67
10,009,02,130,0006,0020,601,40,641,1017,0,3,0,3,2,0,2,0.00,63.03,66.67
10,009,02,130,0013,0021,459,27,486,794,0,3,0,3,2,0,2,0.00,61.21,66.67
10,009,02,130,0013,0022,462,22,484,729,0,3,0,3,2,0,2,0.00,66.39,66.67
10,009,02,130,0008,0023,540,57,597,989,0,3,0,3,2,0,2,0.00,60.36,66.67
10,009,02,130,0008,0024,660,55,715,1128,0,3,0,3,2,0,2,0.00,63.39,66.67
10,009,02,130,0006,0000,1761,101,1862,3012,0,3,0,3,2,0,2,0.00,61.82,66.67
10,009,02,130,0008,0000,1200,112,1312,2117,0,3,0,3,2,0,2,0.00,61.97,66.67
10,009,02,130,0013,0000,921,49,970,1523,0,3,0,3,2,0,2,0.00,63.69,66.67
10,009,02,140,0001,0000,973,39,1012,1395,0,2,2,4,1,2,3,0.00,72.54,75.00
10,009,02,140,0002,0000,802,24,826,1119,0,2,2,4,1,2,3,0.00,73.82,75.00
10,009,02,140,0006,0000,446,13,459,543,0,2,2,4,1,2,3,0.00,84.53,75.00
10,009,02,140,0001,0065,594,26,620,829,0,2,2,4,1,2,3,0.00,74.79,75.00
10,009,02,140,0001,0066,379,13,392,566,0,2,2,4,1,2,3,0.00,69.26,75.00
10,009,02,140,0002,0067,802,24,826,1119,0,2,2,4,1,2,3,0.00,73.82,75.00
10,009,02,140,0007,0068,588,16,604,766,0,2,2,4,1,2,3,0.00,78.85,75.00
10,009,02,140,0006,0069,446,13,459,543,0,2,2,4,1,2,3,0.00,84.53,75.00
10,009,02,140,0007,0000,588,16,604,766,0,2,2,4,1,2,3,0.00,78.85,75.00
10,009,02,150,0003,0000,1027,31,1058,1396,0,3,3,6,2,2,4,0.00,75.79,66.67
10,009,02,150,0004,0000,889,19,908,1127,0,3,3,6,2,2,4,0.00,80.57,66.67
10,009,02,150,0005,0000,1016,29,1045,1363,0,3,3,6,2,2,4,0.00,76.67,66.67
10,009,02,150,0003,0081,517,19,536,705,0,3,3,6,2,2,4,0.00,76.03,66.67
10,009,02,150,0003,0082,510,12,522,691,0,3,3,6,2,2,4,0.00,75.54,66.67
10,009,02,150,0005,0083,334,10,344,446,0,3,3,6,2,2,4,0.00,77.13,66.67
10,009,02,150,0005,0084,682,19,701,917,0,3,3,6,2,2,4,0.00,76.44,66.67
10,009,02,150,0004,0085,358,9,367,435,0,3,3,6,2,2,4,0.00,84.37,66.67
10,009,02,150,0004,0086,531,10,541,692,0,3,3,6,2,2,4,0.00,78.18,66.67
10,009,02,160,0005,0043,446,12,458,671,0,4,1,5,2,1,3,0.00,68.26,60.00
10,009,02,160,0005,0044,510,9,519,697,0,4,1,5,2,1,3,0.00,74.46,60.00
10,009,02,160,0006,0045,714,16,730,1072,0,4,1,5,2,1,3,0.00,68.10,60.00
10,009,02,160,0006,0046,407,20,427,665,0,4,1,5,2,1,3,0.00,64.21,60.00
10,009,02,160,0007,0047,434,5,439,586,0,4,1,5,2,1,3,0.00,74.91,60.00
10,009,02,160,0009,0048,261,8,269,426,0,4,1,5,2,1,3,0.00,63.15,60.00
10,009,02,160,0008,0049,458,31,489,639,0,4,1,5,2,1,3,0.00,76.53,60.00
10,009,02,160,0005,0000,956,21,977,1368,0,4,1,5,2,1,3,0.00,71.42,60.00
10,009,02,160,0006,0000,1121,36,1157,1737,0,4,1,5,2,1,3,0.00,66.61,60.00
10,009,02,160,0007,0000,434,5,439,586,0,4,1,5,2,1,3,0.00,74.91,60.00
10,009,02,160,0008,0000,458,31,489,639,0,4,1,5,2,1,3,0.00,76.53,60.00
10,009,02,160,0009,0000,261,8,269,426,0,4,1,5,2,1,3,0.00,63.15,60.00
10,009,02,170,0010,0000,551,16,567,794,0,5,0,5,3,0,3,0.00,71.41,60.00
10,009,02,170,0011,0000,200,4,204,320,0,5,0,5,3,0,3,0.00,63.75,60.00
10,009,02,170,0012,0000,673,18,691,1068,0,5,0,5,3,0,3,0.00,64.70,60.00
10,009,02,170,0013,0000,974,19,993,1413,0,5,0,5,3,0,3,0.00,70.28,60.00
10,009,02,170,0014,0000,598,7,605,906,0,5,0,5,3,0,3,0.00,66.78,60.00
10,009,02,170,0015,0000,605,18,623,795,0,5,0,5,3,0,3,0.00,78.36,60.00
10,009,02,170,0010,0212,551,16,567,794,0,5,0,5,3,0,3,0.00,71.41,60.00
10,009,02,170,0011,0213,200,4,204,320,0,5,0,5,3,0,3,0.00,63.75,60.00
10,009,02,170,0012,0214,673,18,691,1068,0,5,0,5,3,0,3,0.00,64.70,60.00
10,009,02,170,0013,0215,364,6,370,536,0,5,0,5,3,0,3,0.00,69.03,60.00
10,009,02,170,0013,0216,610,13,623,877,0,5,0,5,3,0,3,0.00,71.04,60.00
10,009,02,170,0014,0217,598,7,605,906,0,5,0,5,3,0,3,0.00,66.78,60.00
10,009,02,170,0015,0218,605,18,623,795,0,5,0,5,3,0,3,0.00,78.36,60.00
10,009,02,180,0009,0000,408,26,434,798,0,2,0,2,2,0,2,0.00,54.39,100.00
10,009,02,180,0010,0000,256,11,267,351,0,2,0,2,2,0,2,0.00,76.07,100.00
10,009,02,180,0011,0000,409,73,482,706,0,2,0,2,2,0,2,0.00,68.27,100.00
10,009,02,180,0012,0000,446,52,498,862,0,2,0,2,2,0,2,0.00,57.77,100.00
10,009,02,180,0012,0186,446,52,498,862,0,2,0,2,2,0,2,0.00,57.77,100.00
10,009,02,180,0011,0187,409,73,482,706,0,2,0,2,2,0,2,0.00,68.27,100.00
10,009,02,180,0020,0188,257,22,279,506,0,2,0,2,2,0,2,0.00,55.14,100.00
10,009,02,180,0009,0189,408,26,434,798,0,2,0,2,2,0,2,0.00,54.39,100.00
10,009,02,180,0010,0190,256,11,267,351,0,2,0,2,2,0,2,0.00,76.07,100.00
10,009,02,180,0020,0000,257,22,279,506,0,2,0,2,2,0,2,0.00,55.14,100.00
10,009,02,190,0008,0000,1133,21,1154,1924,0,7,0,7,3,0,3,0.00,59.98,42.86
10,009,02,190,0009,0000,880,19,899,1431,0,7,0,7,3,0,3,0.00,62.82,42.86
10,009,02,190,0010,0000,960,10,970,1388,0,7,0,7,3,0,3,0.00,69.88,42.86
10,009,02,190,0011,0000,266,10,276,480,0,7,0,7,3,0,3,0.00,57.50,42.86
10,009,02,190,0008,0233,449,7,456,806,0,7,0,7,3,0,3,0.00,56.58,42.86
10,009,02,190,0008,0234,684,14,698,1118,0,7,0,7,3,0,3,0.00,62.43,42.86
10,009,02,190,0009,0235,431,10,441,700,0,7,0,7,3,0,3,0.00,63.00,42.86
10,009,02,190,0009,0236,449,9,458,731,0,7,0,7,3,0,3,0.00,62.65,42.86
10,009,02,190,0010,0237,960,10,970,1388,0,7,0,7,3,0,3,0.00,69.88,42.86
10,009,02,190,0011,0238,266,10,276,480,0,7,0,7,3,0,3,0.00,57.50,42.86
10,009,02,200,0005,0000,598,24,622,893,0,3,1,4,2,0,2,0.00,69.65,50.00
10,009,02,200,0006,0000,385,16,401,570,0,3,1,4,2,0,2,0.00,70.35,50.00
10,009,02,200,0007,0000,292,22,314,560,0,3,1,4,2,0,2,0.00,56.07,50.00
10,009,02,200,0008,0000,557,14,571,919,0,3,1,4,2,0,2,0.00,62.13,50.00
10,009,02,200,0009,0000,336,5,341,567,0,3,1,4,2,0,2,0.00,60.14,50.00
10,009,02,200,0010,0000,469,14,483,858,0,3,1,4,2,0,2,0.00,56.29,50.00
10,009,02,200,0005,0262,598,24,622,893,0,3,1,4,2,0,2,0.00,69.65,50.00
10,009,02,200,0006,0263,385,16,401,570,0,3,1,4,2,0,2,0.00,70.35,50.00
10,009,02,200,0007,0264,292,22,314,560,0,3,1,4,2,0,2,0.00,56.07,50.00
10,009,02,200,0008,0265,557,14,571,919,0,3,1,4,2,0,2,0.00,62.13,50.00
10,009,02,200,0009,0266,336,5,341,567,0,3,1,4,2,0,2,0.00,60.14,50.00
10,009,02,200,0010,0267,469,14,483,858,0,3,1,4,2,0,2,0.00,56.29,50.00
10,009,00,030,0000,0000,34563,2463,37026,56571,70255,18,6,24,9,4,13,80.52,65.45,54.17
10,009,01,030,0000,0000,19028,913,19941,31605,40272,8,6,14,3,4,7,78.48,63.09,50.00
10,009,02,030,0000,0000,5759,1064,6823,10046,11926,2,0,2,2,0,2,84.24,67.92,100.00
10,009,03,030,0000,0000,5122,233,5355,7399,8702,4,0,4,2,0,2,85.03,72.37,50.00
10,009,04,030,0000,0000,4654,253,4907,7521,9355,4,0,4,2,0,2,80.40,65.24,50.00
10,009,03,010,0015,0000,423,20,443,626,0,3,4,7,3,1,4,0.00,70.77,57.14
10,009,03,010,0016,0000,1245,34,1279,2130,0,3,4,7,3,1,4,0.00,60.05,57.14
10,009,03,010,0017,0000,303,17,320,516,0,3,4,7,3,1,4,0.00,62.02,57.14
10,009,03,010,0018,0000,1401,55,1456,2369,0,3,4,7,3,1,4,0.00,61.46,57.14
10,009,03,010,0020,0000,1433,49,1482,2308,0,3,4,7,3,1,4,0.00,64.21,57.14
10,009,03,010,0021,0000,1145,62,1207,1837,0,3,4,7,3,1,4,0.00,65.70,57.14
10,009,03,010,0022,0000,3267,126,3393,5270,0,3,4,7,3,1,4,0.00,64.38,57.14
10,009,03,010,0023,0000,2038,65,2103,3283,0,3,4,7,3,1,4,0.00,64.06,57.14
10,009,03,010,0040,0000,1145,42,1187,1881,0,3,4,7,3,1,4,0.00,63.10,57.14
10,009,03,010,0018,0497,644,23,667,1080,0,3,4,7,3,1,4,0.00,61.76,57.14
10,009,03,010,0018,0498,757,32,789,1289,0,3,4,7,3,1,4,0.00,61.21,57.14
10,009,03,010,0015,0499,423,20,443,626,0,3,4,7,3,1,4,0.00,70.77,57.14
10,009,03,010,0016,0500,492,13,505,725,0,3,4,7,3,1,4,0.00,69.66,57.14
10,009,03,010,0016,0501,753,21,774,1405,0,3,4,7,3,1,4,0.00,55.09,57.14
10,009,03,010,0017,0502,303,17,320,516,0,3,4,7,3,1,4,0.00,62.02,57.14
10,009,03,010,0020,0503,856,25,881,1370,0,3,4,7,3,1,4,0.00,64.31,57.14
10,009,03,010,0020,0504,577,24,601,938,0,3,4,7,3,1,4,0.00,64.07,57.14
10,009,03,010,0040,0505,1145,42,1187,1881,0,3,4,7,3,1,4,0.00,63.10,57.14
10,009,03,010,0023,0506,962,36,998,1590,0,3,4,7,3,1,4,0.00,62.77,57.14
10,009,03,010,0023,0507,635,21,656,1026,0,3,4,7,3,1,4,0.00,63.94,57.14
10,009,03,010,0023,0508,441,8,449,667,0,3,4,7,3,1,4,0.00,67.32,57.14
10,009,03,010,0022,0509,844,41,885,1420,0,3,4,7,3,1,4,0.00,62.32,57.14
10,009,03,010,0022,0510,893,33,926,1365,0,3,4,7,3,1,4,0.00,67.84,57.14
10,009,03,010,0022,0511,738,20,758,1227,0,3,4,7,3,1,4,0.00,61.78,57.14
10,009,03,010,0022,0512,792,32,824,1258,0,3,4,7,3,1,4,0.00,65.50,57.14
10,009,03,010,0021,0513,840,44,884,1355,0,3,4,7,3,1,4,0.00,65.24,57.14
10,009,03,010,0021,0514,305,18,323,482,0,3,4,7,3,1,4,0.00,67.01,57.14
10,009,03,020,0006,0000,1636,61,1697,2550,0,5,3,8,1,3,4,0.00,66.55,50.00
10,009,03,020,0016,0000,2075,72,2147,3286,0,5,3,8,1,3,4,0.00,65.34,50.00
10,009,03,020,0017,0000,602,18,620,842,0,5,3,8,1,3,4,0.00,73.63,50.00
10,009,03,020,0018,0000,560,19,579,772,0,5,3,8,1,3,4,0.00,75.00,50.00
10,009,03,020,0019,0000,537,18,555,795,0,5,3,8,1,3,4,0.00,69.81,50.00
10,009,03,020,0020,0000,974,32,1006,1411,0,5,3,8,1,3,4,0.00,71.30,50.00
10,009,03,020,0024,0000,1349,66,1415,2176,0,5,3,8,1,3,4,0.00,65.03,50.00
10,009,03,020,0006,0571,829,30,859,1250,0,5,3,8,1,3,4,0.00,68.72,50.00
10,009,03,020,0006,0572,807,31,838,1300,0,5,3,8,1,3,4,0.00,64.46,50.00
10,009,03,020,0016,0573,688,27,715,1074,0,5,3,8,1,3,4,0.00,66.57,50.00
10,009,03,020,0016,0574,675,19,694,1114,0,5,3,8,1,3,4,0.00,62.30,50.00
10,009,03,020,0016,0575,712,26,738,1098,0,5,3,8,1,3,4,0.00,67.21,50.00
10,009,03,020,0024,0576,543,25,568,878,0,5,3,8,1,3,4,0.00,64.69,50.00
10,009,03,020,0024,0577,806,41,847,1298,0,5,3,8,1,3,4,0.00,65.25,50.00
10,009,03,020,0017,0578,602,18,620,842,0,5,3,8,1,3,4,0.00,73.63,50.00
10,009,03,020,0018,0579,560,19,579,772,0,5,3,8,1,3,4,0.00,75.00,50.00
10,009,03,020,0019,0580,537,18,555,795,0,5,3,8,1,3,4,0.00,69.81,50.00
10,009,03,020,0020,0581,536,17,553,798,0,5,3,8,1,3,4,0.00,69.30,50.00
10,009,03,020,0020,0582,438,15,453,613,0,5,3,8,1,3,4,0.00,73.90,50.00
10,009,03,030,0023,0161,772,33,805,1219,0,4,0,4,2,0,2,0.00,66.04,50.00
10,009,03,030,0023,0162,708,26,734,1016,0,4,0,4,2,0,2,0.00,72.24,50.00
10,009,03,030,0024,0163,863,38,901,1253,0,4,0,4,2,0,2,0.00,71.91,50.00
10,009,03,030,0024,0164,815,32,847,1189,0,4,0,4,2,0,2,0.00,71.24,50.00
10,009,03,030,0025,0165,874,48,922,1267,0,4,0,4,2,0,2,0.00,72.77,50.00
10,009,03,030,0026,0166,427,26,453,564,0,4,0,4,2,0,2,0.00,80.32,50.00
10,009,03,030,0026,0167,663,30,693,891,0,4,0,4,2,0,2,0.00,77.78,50.00
10,009,03,030,0023,0000,1480,59,1539,2235,0,4,0,4,2,0,2,0.00,68.86,50.00
10,009,03,030,0024,0000,1678,70,1748,2442,0,4,0,4,2,0,2,0.00,71.58,50.00
10,009,03,030,0025,0000,874,48,922,1267,0,4,0,4,2,0,2,0.00,72.77,50.00
10,009,03,030,0026,0000,1090,56,1146,1455,0,4,0,4,2,0,2,0.00,78.76,50.00
10,009,03,040,0023,0000,608,11,619,782,0,3,0,3,1,0,1,0.00,79.16,33.33
10,009,03,040,0024,0000,446,28,474,684,0,3,0,3,1,0,1,0.00,69.30,33.33
10,009,03,040,0025,0000,801,37,838,1251,0,3,0,3,1,0,1,0.00,66.99,33.33
10,009,03,040,0026,0000,596,33,629,844,0,3,0,3,1,0,1,0.00,74.53,33.33
10,009,03,040,0027,0000,854,65,919,1283,0,3,0,3,1,0,1,0.00,71.63,33.33
10,009,03,040,0025,0397,801,37,838,1251,0,3,0,3,1,0,1,0.00,66.99,33.33
10,009,03,040,0024,0398,446,28,474,684,0,3,0,3,1,0,1,0.00,69.30,33.33
10,009,03,040,0023,0399,608,11,619,782,0,3,0,3,1,0,1,0.00,79.16,33.33
10,009,03,040,0026,0400,596,33,629,844,0,3,0,3,1,0,1,0.00,74.53,33.33
10,009,03,040,0027,0401,854,65,919,1283,0,3,0,3,1,0,1,0.00,71.63,33.33
10,009,03,050,0009,0000,633,14,647,833,0,4,0,4,2,0,2,0.00,77.67,50.00
10,009,03,050,0015,0107,763,17,780,1133,0,4,0,4,2,0,2,0.00,68.84,50.00
10,009,03,050,0015,0108,710,17,727,1051,0,4,0,4,2,0,2,0.00,69.17,50.00
10,009,03,050,0016,0109,555,22,577,783,0,4,0,4,2,0,2,0.00,73.69,50.00
10,009,03,050,0016,0110,435,9,444,659,0,4,0,4,2,0,2,0.00,67.37,50.00
10,009,03,050,0009,0111,633,14,647,833,0,4,0,4,2,0,2,0.00,77.67,50.00
10,009,03,050,0015,0000,1473,34,1507,2184,0,4,0,4,2,0,2,0.00,69.00,50.00
10,009,03,050,0016,0000,990,31,1021,1442,0,4,0,4,2,0,2,0.00,70.80,50.00
10,009,03,060,0020,0000,604,122,726,1071,0,2,0,2,2,0,2,0.00,67.79,100.00
10,009,03,060,0022,0000,405,47,452,725,0,2,0,2,2,0,2,0.00,62.34,100.00
10,009,03,060,0023,0000,331,50,381,529,0,2,0,2,2,0,2,0.00,72.02,100.00
10,009,03,060,0024,0000,935,202,1137,1527,0,2,0,2,2,0,2,0.00,74.46,100.00
10,009,03,060,0025,0000,1535,319,1854,2820,0,2,0,2,2,0,2,0.00,65.74,100.00
10,009,03,060,0020,0313,604,122,726,1071,0,2,0,2,2,0,2,0.00,67.79,100.00
10,009,03,060,0022,0314,405,47,452,725,0,2,0,2,2,0,2,0.00,62.34,100.00
10,009,03,060,0023,0315,331,50,381,529,0,2,0,2,2,0,2,0.00,72.02,100.00
10,009,03,060,0024,0316,569,144,713,981,0,2,0,2,2,0,2,0.00,72.68,100.00
10,009,03,060,0024,0317,366,58,424,546,0,2,0,2,2,0,2,0.00,77.66,100.00
10,009,03,060,0025,0318,483,79,562,854,0,2,0,2,2,0,2,0.00,65.81,100.00
10,009,03,060,0025,0319,506,124,630,977,0,2,0,2,2,0,2,0.00,64.48,100.00
10,009,03,060,0025,0320,546,116,662,989,0,2,0,2,2,0,2,0.00,66.94,100.00
10,009,03,070,0010,0000,1233,60,1293,2034,0,3,0,3,2,0,2,0.00,63.57,66.67
10,009,03,070,0012,0000,783,24,807,1182,0,3,0,3,2,0,2,0.00,68.27,66.67
10,009,03,070,0015,0000,1209,61,1270,1962,0,3,0,3,2,0,2,0.00,64.73,66.67
10,009,03,070,0016,0000,458,27,485,711,0,3,0,3,2,0,2,0.00,68.21,66.67
10,009,03,070,0010,0607,571,33,604,957,0,3,0,3,2,0,2,0.00,63.11,66.67
10,009,03,070,0010,0608,662,27,689,1077,0,3,0,3,2,0,2,0.00,63.97,66.67
10,009,03,070,0015,0609,646,34,680,1054,0,3,0,3,2,0,2,0.00,64.52,66.67
10,009,03,070,0015,0610,563,27,590,908,0,3,0,3,2,0,2,0.00,64.98,66.67
10,009,03,070,0016,0611,458,27,485,711,0,3,0,3,2,0,2,0.00,68.21,66.67
10,009,03,070,0012,0612,783,24,807,1182,0,3,0,3,2,0,2,0.00,68.27,66.67
10,009,03,080,0005,0000,1297,39,1336,1892,0,4,1,5,3,0,3,0.00,70.61,60.00
10,009,03,080,0006,0000,1241,22,1263,1744,0,4,1,5,3,0,3,0.00,72.42,60.00
10,009,03,080,0008,0000,818,15,833,1140,0,4,1,5,3,0,3,0.00,73.07,60.00
10,009,03,080,0005,0543,425,13,438,670,0,4,1,5,3,0,3,0.00,65.37,60.00
10,009,03,080,0005,0544,561,19,580,793,0,4,1,5,3,0,3,0.00,73.14,60.00
10,009,03,080,0005,0545,311,7,318,429,0,4,1,5,3,0,3,0.00,74.13,60.00
10,009,03,080,0006,0546,910,18,928,1256,0,4,1,5,3,0,3,0.00,73.89,60.00
10,009,03,080,0006,0547,331,4,335,488,0,4,1,5,3,0,3,0.00,68.65,60.00
10,009,03,080,0008,0548,818,15,833,1140,0,4,1,5,3,0,3,0.00,73.07,60.00
10,009,03,090,0009,0000,651,83,734,1090,0,3,0,3,3,0,3,0.00,67.34,100.00
10,009,03,090,0011,0000,892,186,1078,1650,0,3,0,3,3,0,3,0.00,65.33,100.00
10,009,03,090,0012,0000,881,92,973,1382,0,3,0,3,3,0,3,0.00,70.41,100.00
10,009,03,090,0013,0000,783,69,852,1238,0,3,0,3,3,0,3,0.00,68.82,100.00
10,009,03,090,0014,0000,1239,54,1293,1705,0,3,0,3,3,0,3,0.00,75.84,100.00
10,009,03,090,0009,0425,651,83,734,1090,0,3,0,3,3,0,3,0.00,67.34,100.00
10,009,03,090,0011,0426,424,110,534,813,0,3,0,3,3,0,3,0.00,65.68,100.00
10,009,03,090,0011,0427,468,76,544,837,0,3,0,3,3,0,3,0.00,64.99,100.00
10,009,03,090,0012,0428,545,58,603,877,0,3,0,3,3,0,3,0.00,68.76,100.00
10,009,03,090,0012,0429,336,34,370,505,0,3,0,3,3,0,3,0.00,73.27,100.00
10,009,03,090,0013,0430,281,22,303,428,0,3,0,3,3,0,3,0.00,70.79,100.00
10,009,03,090,0013,0431,502,47,549,810,0,3,0,3,3,0,3,0.00,67.78,100.00
10,009,03,090,0014,0432,777,24,801,1090,0,3,0,3,3,0,3,0.00,73.49,100.00
10,009,03,090,0014,0433,462,30,492,615,0,3,0,3,3,0,3,0.00,80.00,100.00
10,009,03,100,0005,0000,543,23,566,777,0,5,1,6,2,1,3,0.00,72.84,50.00
10,009,03,100,0006,0000,1746,53,1799,2499,0,5,1,6,2,1,3,0.00,71.99,50.00
10,009,03,100,0007,0000,469,14,483,605,0,5,1,6,2,1,3,0.00,79.83,50.00
10,009,03,100,0005,0442,543,23,566,777,0,5,1,6,2,1,3,0.00,72.84,50.00
10,009,03,100,0006,0443,916,24,940,1273,0,5,1,6,2,1,3,0.00,73.84,50.00
10,009,03,100,0006,0444,830,29,859,1226,0,5,1,6,2,1,3,0.00,70.07,50.00
10,009,03,100,0007,0445,469,14,483,605,0,5,1,6,2,1,3,0.00,79.83,50.00
10,009,03,110,0007,0000,511,104,615,833,0,2,1,3,2,1,3,0.00,73.83,100.00
10,009,03,110,0008,0000,413,75,488,830,0,2,1,3,2,1,3,0.00,58.80,100.00
10,009,03,110,0009,0000,418,30,448,708,0,2,1,3,2,1,3,0.00,63.28,100.00
10,009,03,110,0010,0000,848,78,926,1397,0,2,1,3,2,1,3,0.00,66.28,100.00
10,009,03,110,0018,0000,774,82,856,1346,0,2,1,3,2,1,3,0.00,63.60,100.00
10,009,03,110,0007,0353,511,104,615,833,0,2,1,3,2,1,3,0.00,73.83,100.00
10,009,03,110,0018,0354,449,46,495,774,0,2,1,3,2,1,3,0.00,63.95,100.00
10,009,03,110,0018,0355,325,36,361,572,0,2,1,3,2,1,3,0.00,63.11,100.00
10,009,03,110,0008,0356,413,75,488,830,0,2,1,3,2,1,3,0.00,58.80,100.00
10,009,03,110,0009,0357,418,30,448,708,0,2,1,3,2,1,3,0.00,63.28,100.00
10,009,03,110,0010,0358,367,23,390,625,0,2,1,3,2,1,3,0.00,62.40,100.00
10,009,03,110,0010,0359,481,55,536,772,0,2,1,3,2,1,3,0.00,69.43,100.00
10,009,03,120,0007,0000,1210,78,1288,1933,0,3,0,3,2,0,2,0.00,66.63,66.67
10,009,03,120,0008,0000,490,27,517,738,0,3,0,3,2,0,2,0.00,70.05,66.67
10,009,03,120,0009,0000,951,41,992,1425,0,3,0,3,2,0,2,0.00,69.61,66.67
10,009,03,120,0007,0330,594,40,634,964,0,3,0,3,2,0,2,0.00,65.77,66.67
10,009,03,120,0007,0331,616,38,654,969,0,3,0,3,2,0,2,0.00,67.49,66.67
10,009,03,120,0008,0332,490,27,517,738,0,3,0,3,2,0,2,0.00,70.05,66.67
10,009,03,120,0009,0333,441,13,454,648,0,3,0,3,2,0,2,0.00,70.06,66.67
10,009,03,120,0009,0334,510,28,538,777,0,3,0,3,2,0,2,0.00,69.24,66.67
10,009,03,130,0005,0025,861,29,890,1341,0,4,0,4,2,0,2,0.00,66.37,50.00
10,009,03,130,0005,0026,845,38,883,1358,0,4,0,4,2,0,2,0.00,65.02,50.00
10,009,03,130,0009,0027,792,25,817,1203,0,4,0,4,2,0,2,0.00,67.91,50.00
10,009,03,130,0009,0028,661,27,688,972,0,4,0,4,2,0,2,0.00,70.78,50.00
10,009,03,130,0009,0029,580,33,613,892,0,4,0,4,2,0,2,0.00,68.72,50.00
10,009,03,130,0009,0030,585,32,617,909,0,4,0,4,2,0,2,0.00,67.88,50.00
10,009,03,130,0005,0000,1706,67,1773,2699,0,4,0,4,2,0,2,0.00,65.69,50.00
10,009,03,130,0009,0000,2618,117,2735,3976,0,4,0,4,2,0,2,0.00,68.79,50.00
10,009,03,140,0009,0070,550,18,568,787,0,4,0,4,3,0,3,0.00,72.17,75.00
10,009,03,140,0008,0071,537,16,553,769,0,4,0,4,3,0,3,0.00,71.91,75.00
10,009,03,140,0010,0072,679,14,693,874,0,4,0,4,3,0,3,0.00,79.29,75.00
10,009,03,140,0010,0073,723,17,740,964,0,4,0,4,3,0,3,0.00,76.76,75.00
10,009,03,140,0008,0000,537,16,553,769,0,4,0,4,3,0,3,0.00,71.91,75.00
10,009,03,140,0009,0000,550,18,568,787,0,4,0,4,3,0,3,0.00,72.17,75.00
10,009,03,140,0010,0000,1402,31,1433,1838,0,4,0,4,3,0,3,0.00,77.97,75.00
10,009,03,150,0006,0000,603,17,620,786,0,2,1,3,2,0,2,0.00,78.88,66.67
10,009,03,150,0007,0000,528,14,542,728,0,2,1,3,2,0,2,0.00,74.45,66.67
10,009,03,150,0006,0087,603,17,620,786,0,2,1,3,2,0,2,0.00,78.88,66.67
10,009,03,150,0007,0088,528,14,542,728,0,2,1,3,2,0,2,0.00,74.45,66.67
10,009,03,160,0015,0050,835,17,852,1180,0,4,0,4,2,0,2,0.00,72.20,50.00
10,009,03,160,0015,0051,382,5,387,524,0,4,0,4,2,0,2,0.00,73.85,50.00
10,009,03,160,0011,0052,708,16,724,997,0,4,0,4,2,0,2,0.00,72.62,50.00
10,009,03,160,0011,0053,276,12,288,435,0,4,0,4,2,0,2,0.00,66.21,50.00
10,009,03,160,0011,0000,984,28,1012,1432,0,4,0,4,2,0,2,0.00,70.67,50.00
10,009,03,160,0015,0000,1217,22,1239,1704,0,4,0,4,2,0,2,0.00,72.71,50.00
10,009,03,170,0016,0000,695,26,721,1055,0,5,0,5,3,0,3,0.00,68.34,60.00
10,009,03,170,0017,0000,543,27,570,775,0,5,0,5,3,0,3,0.00,73.55,60.00
10,009,03,170,0018,0000,903,37,940,1389,0,5,0,5,3,0,3,0.00,67.67,60.00
10,009,03,170,0019,0000,398,9,407,547,0,5,0,5,3,0,3,0.00,74.41,60.00
10,009,03,170,0020,0000,587,23,610,767,0,5,0,5,3,0,3,0.00,79.53,60.00
10,009,03,170,0021,0000,464,12,476,666,0,5,0,5,3,0,3,0.00,71.47,60.00
10,009,03,170,0016,0219,695,26,721,1055,0,5,0,5,3,0,3,0.00,68.34,60.00
10,009,03,170,0017,0220,543,27,570,775,0,5,0,5,3,0,3,0.00,73.55,60.00
10,009,03,170,0018,0221,398,19,417,613,0,5,0,5,3,0,3,0.00,68.03,60.00
10,009,03,170,0018,0222,505,18,523,776,0,5,0,5,3,0,3,0.00,67.40,60.00
10,009,03,170,0019,0223,398,9,407,547,0,5,0,5,3,0,3,0.00,74.41,60.00
10,009,03,170,0020,0224,587,23,610,767,0,5,0,5,3,0,3,0.00,79.53,60.00
10,009,03,170,0021,0225,464,12,476,666,0,5,0,5,3,0,3,0.00,71.47,60.00
10,009,03,180,0013,0000,1140,24,1164,1605,0,5,0,5,3,0,3,0.00,72.52,60.00
10,009,03,180,0014,0000,436,15,451,765,0,5,0,5,3,0,3,0.00,58.95,60.00
10,009,03,180,0015,0000,366,9,375,642,0,5,0,5,3,0,3,0.00,58.41,60.00
10,009,03,180,0016,0000,555,20,575,841,0,5,0,5,3,0,3,0.00,68.37,60.00
10,009,03,180,0013,0191,581,13,594,827,0,5,0,5,3,0,3,0.00,71.83,60.00
10,009,03,180,0013,0192,559,11,570,778,0,5,0,5,3,0,3,0.00,73.26,60.00
10,009,03,180,0014,0193,436,15,451,765,0,5,0,5,3,0,3,0.00,58.95,60.00
10,009,03,180,0015,0194,366,9,375,642,0,5,0,5,3,0,3,0.00,58.41,60.00
10,009,03,180,0016,0195,555,20,575,841,0,5,0,5,3,0,3,0.00,68.37,60.00
10,009,03,180,0021,0196,609,12,621,972,0,5,0,5,3,0,3,0.00,63.89,60.00
10,009,03,180,0021,0000,609,12,621,972,0,5,0,5,3,0,3,0.00,63.89,60.00
10,009,03,190,0012,0000,795,23,818,1408,0,4,0,4,2,0,2,0.00,58.10,50.00
10,009,03,190,0013,0000,543,20,563,797,0,4,0,4,2,0,2,0.00,70.64,50.00
10,009,03,190,0014,0000,1360,71,1431,1810,0,4,0,4,2,0,2,0.00,79.06,50.00
10,009,03,190,0015,0000,565,27,592,853,0,4,0,4,2,0,2,0.00,69.40,50.00
10,009,03,190,0012,0239,795,23,818,1408,0,4,0,4,2,0,2,0.00,58.10,50.00
10,009,03,190,0013,0240,543,20,563,797,0,4,0,4,2,0,2,0.00,70.64,50.00
10,009,03,190,0014,0241,265,12,277,346,0,4,0,4,2,0,2,0.00,80.06,50.00
10,009,03,190,0014,0242,523,28,551,719,0,4,0,4,2,0,2,0.00,76.63,50.00
10,009,03,190,0014,0243,572,31,603,745,0,4,0,4,2,0,2,0.00,80.94,50.00
10,009,03,190,0015,0244,565,27,592,853,0,4,0,4,2,0,2,0.00,69.40,50.00
10,009,03,200,0016,0000,649,7,656,902,0,5,1,6,2,1,3,0.00,72.73,50.00
10,009,03,200,0017,0000,504,10,514,741,0,5,1,6,2,1,3,0.00,69.37,50.00
10,009,03,200,0018,0000,660,16,676,940,0,5,1,6,2,1,3,0.00,71.91,50.00
10,009,03,200,0019,0000,358,11,369,471,0,5,1,6,2,1,3,0.00,78.34,50.00
10,009,03,200,0020,0000,403,20,423,603,0,5,1,6,2,1,3,0.00,70.15,50.00
10,009,03,200,0021,0000,383,7,390,630,0,5,1,6,2,1,3,0.00,61.90,50.00
10,009,03,200,0022,0000,372,6,378,633,0,5,1,6,2,1,3,0.00,59.72,50.00
10,009,03,200,0016,0268,649,7,656,902,0,5,1,6,2,1,3,0.00,72.73,50.00
10,009,03,200,0017,0269,504,10,514,741,0,5,1,6,2,1,3,0.00,69.37,50.00
10,009,03,200,0018,0270,660,16,676,940,0,5,1,6,2,1,3,0.00,71.91,50.00
10,009,03,200,0019,0271,358,11,369,471,0,5,1,6,2,1,3,0.00,78.34,50.00
10,009,03,200,0020,0272,403,20,423,603,0,5,1,6,2,1,3,0.00,70.15,50.00
10,009,03,200,0021,0273,383,7,390,630,0,5,1,6,2,1,3,0.00,61.90,50.00
10,009,03,200,0022,0274,372,6,378,633,0,5,1,6,2,1,3,0.00,59.72,50.00
10,009,00,040,0000,0000,23263,1292,24555,36469,44595,10,5,15,7,4,11,81.78,67.33,73.33
10,009,01,040,0000,0000,12704,427,13131,20082,25181,3,4,7,3,3,6,79.75,65.39,85.71
10,009,02,040,0000,0000,3871,586,4457,6390,7475,2,0,2,2,0,2,85.48,69.75,100.00
10,009,03,040,0000,0000,3305,174,3479,4844,5685,3,0,3,1,0,1,85.21,71.82,33.33
10,009,04,040,0000,0000,3383,105,3488,5153,6254,2,1,3,1,1,2,82.40,67.69,66.67
10,009,04,010,0024,0000,1160,52,1212,1765,0,4,1,5,2,1,3,0.00,68.67,60.00
10,009,04,010,0025,0000,743,39,782,1054,0,4,1,5,2,1,3,0.00,74.19,60.00
10,009,04,010,0026,0000,2546,88,2634,4255,0,4,1,5,2,1,3,0.00,61.90,60.00
10,009,04,010,0027,0000,646,13,659,1041,0,4,1,5,2,1,3,0.00,63.30,60.00
10,009,04,010,0028,0000,1340,53,1393,2096,0,4,1,5,2,1,3,0.00,66.46,60.00
10,009,04,010,0029,0000,1791,79,1870,3120,0,4,1,5,2,1,3,0.00,59.94,60.00
10,009,04,010,0030,0000,2015,71,2086,3065,0,4,1,5,2,1,3,0.00,68.06,60.00
10,009,04,010,0031,0000,711,22,733,1096,0,4,1,5,2,1,3,0.00,66.88,60.00
10,009,04,010,0026,0515,657,19,676,1051,0,4,1,5,2,1,3,0.00,64.32,60.00
10,009,04,010,0026,0516,650,17,667,1053,0,4,1,5,2,1,3,0.00,63.34,60.00
10,009,04,010,0026,0517,574,18,592,1049,0,4,1,5,2,1,3,0.00,56.43,60.00
10,009,04,010,0026,0518,665,34,699,1102,0,4,1,5,2,1,3,0.00,63.43,60.00
10,009,04,010,0027,0519,646,13,659,1041,0,4,1,5,2,1,3,0.00,63.30,60.00
10,009,04,010,0028,0520,604,15,619,880,0,4,1,5,2,1,3,0.00,70.34,60.00
10,009,04,010,0028,0521,736,38,774,1216,0,4,1,5,2,1,3,0.00,63.65,60.00
10,009,04,010,0024,0522,452,20,472,652,0,4,1,5,2,1,3,0.00,72.39,60.00
10,009,04,010,0024,0523,708,32,740,1113,0,4,1,5,2,1,3,0.00,66.49,60.00
10,009,04,010,0025,0524,743,39,782,1054,0,4,1,5,2,1,3,0.00,74.19,60.00
10,009,04,010,0030,0525,952,18,970,1386,0,4,1,5,2,1,3,0.00,69.99,60.00
10,009,04,010,0030,0526,641,41,682,1017,0,4,1,5,2,1,3,0.00,67.06,60.00
10,009,04,010,0030,0527,422,12,434,662,0,4,1,5,2,1,3,0.00,65.56,60.00
10,009,04,010,0029,0528,637,27,664,1058,0,4,1,5,2,1,3,0.00,62.76,60.00
10,009,04,010,0029,0529,618,28,646,1081,0,4,1,5,2,1,3,0.00,59.76,60.00
10,009,04,010,0029,0530,536,24,560,981,0,4,1,5,2,1,3,0.00,57.08,60.00
10,009,04,010,0031,0531,711,22,733,1096,0,4,1,5,2,1,3,0.00,66.88,60.00
10,009,04,020,0013,0000,593,21,614,920,0,4,1,5,1,1,2,0.00,66.74,40.00
10,009,04,020,0014,0000,1718,52,1770,2713,0,4,1,5,1,1,2,0.00,65.24,40.00
10,009,04,020,0015,0000,1378,44,1422,2097,0,4,1,5,1,1,2,0.00,67.81,40.00
10,009,04,020,0021,0000,944,38,982,1382,0,4,1,5,1,1,2,0.00,71.06,40.00
10,009,04,020,0013,0583,593,21,614,920,0,4,1,5,1,1,2,0.00,66.74,40.00
10,009,04,020,0014,0584,855,21,876,1324,0,4,1,5,1,1,2,0.00,66.16,40.00
10,009,04,020,0014,0585,863,31,894,1389,0,4,1,5,1,1,2,0.00,64.36,40.00
10,009,04,020,0015,0586,773,27,800,1171,0,4,1,5,1,1,2,0.00,68.32,40.00
10,009,04,020,0015,0587,605,17,622,926,0,4,1,5,1,1,2,0.00,67.17,40.00
10,009,04,020,0021,0588,944,38,982,1382,0,4,1,5,1,1,2,0.00,71.06,40.00
10,009,04,030,0013,0000,832,39,871,1290,0,4,0,4,2,0,2,0.00,67.52,50.00
10,009,04,030,0014,0000,494,32,526,808,0,4,0,4,2,0,2,0.00,65.10,50.00
10,009,04,030,0015,0000,1030,70,1100,1974,0,4,0,4,2,0,2,0.00,55.72,50.00
10,009,04,030,0016,0000,965,48,1013,1409,0,4,0,4,2,0,2,0.00,71.89,50.00
10,009,04,030,0029,0168,792,40,832,1172,0,4,0,4,2,0,2,0.00,70.99,50.00
10,009,04,030,0016,0169,965,48,1013,1409,0,4,0,4,2,0,2,0.00,71.89,50.00
10,009,04,030,0017,0000,541,24,565,868,0,4,0,4,2,0,2,0.00,65.09,50.00
10,009,04,030,0017,0170,541,24,565,868,0,4,0,4,2,0,2,0.00,65.09,50.00
10,009,04,030,0015,0171,554,26,580,922,0,4,0,4,2,0,2,0.00,62.91,50.00
10,009,04,030,0015,0172,476,44,520,1052,0,4,0,4,2,0,2,0.00,49.43,50.00
10,009,04,030,0014,0173,494,32,526,808,0,4,0,4,2,0,2,0.00,65.10,50.00
10,009,04,030,0013,0174,832,39,871,1290,0,4,0,4,2,0,2,0.00,67.52,50.00
10,009,04,030,0029,0000,792,40,832,1172,0,4,0,4,2,0,2,0.00,70.99,50.00
10,009,04,040,0013,0000,587,30,617,931,0,2,1,3,1,1,2,0.00,66.27,66.67
10,009,04,040,0014,0000,648,23,671,1080,0,2,1,3,1,1,2,0.00,62.13,66.67
10,009,04,040,0015,0000,1141,22,1163,1723,0,2,1,3,1,1,2,0.00,67.50,66.67
10,009,04,040,0016,0000,1007,30,1037,1419,0,2,1,3,1,1,2,0.00,73.08,66.67
10,009,04,040,0013,0402,587,30,617,931,0,2,1,3,1,1,2,0.00,66.27,66.67
10,009,04,040,0014,0403,648,23,671,1080,0,2,1,3,1,1,2,0.00,62.13,66.67
10,009,04,040,0015,0404,616,10,626,901,0,2,1,3,1,1,2,0.00,69.48,66.67
10,009,04,040,0015,0405,525,12,537,822,0,2,1,3,1,1,2,0.00,65.33,66.67
10,009,04,040,0016,0406,1007,30,1037,1419,0,2,1,3,1,1,2,0.00,73.08,66.67
10,009,04,050,0011,0000,1264,119,1383,1792,0,2,1,3,2,1,3,0.00,77.18,100.00
10,009,04,050,0011,0112,609,47,656,853,0,2,1,3,2,1,3,0.00,76.91,100.00
10,009,04,050,0011,0113,655,72,727,939,0,2,1,3,2,1,3,0.00,77.42,100.00
10,009,04,050,0012,0114,514,45,559,849,0,2,1,3,2,1,3,0.00,65.84,100.00
10,009,04,050,0012,0115,494,56,550,829,0,2,1,3,2,1,3,0.00,66.34,100.00
10,009,04,050,0014,0116,487,43,530,852,0,2,1,3,2,1,3,0.00,62.21,100.00
10,009,04,050,0014,0117,472,47,519,836,0,2,1,3,2,1,3,0.00,62.08,100.00
10,009,04,050,0013,0118,450,49,499,784,0,2,1,3,2,1,3,0.00,63.65,100.00
10,009,04,050,0017,0119,446,31,477,708,0,2,1,3,2,1,3,0.00,67.37,100.00
10,009,04,050,0012,0000,1008,101,1109,1678,0,2,1,3,2,1,3,0.00,66.09,100.00
10,009,04,050,0017,0120,399,31,430,628,0,2,1,3,2,1,3,0.00,68.47,100.00
10,009,04,050,0013,0000,450,49,499,784,0,2,1,3,2,1,3,0.00,63.65,100.00
10,009,04,050,0014,0000,959,90,1049,1688,0,2,1,3,2,1,3,0.00,62.14,100.00
10,009,04,050,0017,0000,845,62,907,1336,0,2,1,3,2,1,3,0.00,67.89,100.00
10,009,04,070,0008,0000,405,33,438,666,0,3,0,3,1,0,1,0.00,65.77,33.33
10,009,04,070,0009,0000,170,2,172,254,0,3,0,3,1,0,1,0.00,67.72,33.33
10,009,04,070,0011,0000,628,33,661,1024,0,3,0,3,1,0,1,0.00,64.55,33.33
10,009,04,070,0013,0000,315,25,340,428,0,3,0,3,1,0,1,0.00,79.44,33.33
10,009,04,070,0014,0000,340,14,354,516,0,3,0,3,1,0,1,0.00,68.60,33.33
10,009,04,070,0009,0613,170,2,172,254,0,3,0,3,1,0,1,0.00,67.72,33.33
10,009,04,070,0008,0614,405,33,438,666,0,3,0,3,1,0,1,0.00,65.77,33.33
10,009,04,070,0011,0615,628,33,661,1024,0,3,0,3,1,0,1,0.00,64.55,33.33
10,009,04,070,0013,0616,315,25,340,428,0,3,0,3,1,0,1,0.00,79.44,33.33
10,009,04,070,0014,0617,340,14,354,516,0,3,0,3,1,0,1,0.00,68.60,33.33
10,009,04,080,0012,0000,507,9,516,707,0,3,0,3,2,0,2,0.00,72.98,66.67
10,009,04,080,0013,0000,486,12,498,650,0,3,0,3,2,0,2,0.00,76.62,66.67
10,009,04,080,0014,0000,501,14,515,642,0,3,0,3,2,0,2,0.00,80.22,66.67
10,009,04,080,0015,0000,452,11,463,669,0,3,0,3,2,0,2,0.00,69.21,66.67
10,009,04,080,0012,0549,507,9,516,707,0,3,0,3,2,0,2,0.00,72.98,66.67
10,009,04,080,0013,0550,486,12,498,650,0,3,0,3,2,0,2,0.00,76.62,66.67
10,009,04,080,0014,0551,501,14,515,642,0,3,0,3,2,0,2,0.00,80.22,66.67
10,009,04,080,0015,0552,452,11,463,669,0,3,0,3,2,0,2,0.00,69.21,66.67
10,009,04,100,0008,0000,748,16,764,1066,0,4,2,6,1,2,3,0.00,71.67,50.00
10,009,04,100,0009,0000,726,12,738,992,0,4,2,6,1,2,3,0.00,74.40,50.00
10,009,04,100,0010,0000,1260,23,1283,1711,0,4,2,6,1,2,3,0.00,74.99,50.00
10,009,04,100,0008,0446,748,16,764,1066,0,4,2,6,1,2,3,0.00,71.67,50.00
10,009,04,100,0009,0447,726,12,738,992,0,4,2,6,1,2,3,0.00,74.40,50.00
10,009,04,100,0010,0448,675,18,693,905,0,4,2,6,1,2,3,0.00,76.57,50.00
10,009,04,100,0010,0449,585,5,590,806,0,4,2,6,1,2,3,0.00,73.20,50.00
10,009,04,110,0011,0000,956,62,1018,1706,0,2,0,2,2,0,2,0.00,59.67,100.00
10,009,04,110,0012,0000,450,27,477,794,0,2,0,2,2,0,2,0.00,60.08,100.00
10,009,04,110,0013,0000,920,108,1028,1649,0,2,0,2,2,0,2,0.00,62.34,100.00
10,009,04,110,0011,0360,581,44,625,1085,0,2,0,2,2,0,2,0.00,57.60,100.00
10,009,04,110,0011,0361,375,18,393,621,0,2,0,2,2,0,2,0.00,63.29,100.00
10,009,04,110,0012,0362,450,27,477,794,0,2,0,2,2,0,2,0.00,60.08,100.00
10,009,04,110,0013,0363,586,69,655,1007,0,2,0,2,2,0,2,0.00,65.04,100.00
10,009,04,110,0013,0364,334,39,373,642,0,2,0,2,2,0,2,0.00,58.10,100.00
10,009,04,120,0010,0000,924,29,953,1617,0,4,1,5,2,1,3,0.00,58.94,60.00
10,009,04,120,0011,0000,891,32,923,1332,0,4,1,5,2,1,3,0.00,69.29,60.00
10,009,04,120,0012,0000,622,24,646,1052,0,4,1,5,2,1,3,0.00,61.41,60.00
10,009,04,120,0013,0000,640,40,680,1136,0,4,1,5,2,1,3,0.00,59.86,60.00
10,009,04,120,0014,0000,497,29,526,710,0,4,1,5,2,1,3,0.00,74.08,60.00
10,009,04,120,0010,0335,485,11,496,818,0,4,1,5,2,1,3,0.00,60.64,60.00
10,009,04,120,0010,0336,439,18,457,799,0,4,1,5,2,1,3,0.00,57.20,60.00
10,009,04,120,0011,0337,420,18,438,633,0,4,1,5,2,1,3,0.00,69.19,60.00
10,009,04,120,0011,0338,471,14,485,699,0,4,1,5,2,1,3,0.00,69.38,60.00
10,009,04,120,0012,0339,622,24,646,1052,0,4,1,5,2,1,3,0.00,61.41,60.00
10,009,04,120,0013,0340,640,40,680,1136,0,4,1,5,2,1,3,0.00,59.86,60.00
10,009,04,120,0014,0341,497,29,526,710,0,4,1,5,2,1,3,0.00,74.08,60.00
10,009,04,130,0010,0031,895,21,916,1145,0,3,0,3,2,0,2,0.00,80.00,66.67
10,009,04,130,0011,0032,791,18,809,1084,0,3,0,3,2,0,2,0.00,74.63,66.67
10,009,04,130,0011,0033,899,15,914,1132,0,3,0,3,2,0,2,0.00,80.74,66.67
10,009,04,130,0011,0034,1042,36,1078,1405,0,3,0,3,2,0,2,0.00,76.73,66.67
10,009,04,130,0012,0035,928,25,953,1169,0,3,0,3,2,0,2,0.00,81.52,66.67
10,009,04,130,0012,0036,786,23,809,1024,0,3,0,3,2,0,2,0.00,79.00,66.67
10,009,04,130,0010,0000,895,21,916,1145,0,3,0,3,2,0,2,0.00,80.00,66.67
10,009,04,130,0011,0000,2732,69,2801,3621,0,3,0,3,2,0,2,0.00,77.35,66.67
10,009,04,130,0012,0000,1714,48,1762,2193,0,3,0,3,2,0,2,0.00,80.35,66.67
10,009,04,140,0012,0074,313,71,384,551,0,2,0,2,2,0,2,0.00,69.69,100.00
10,009,04,140,0012,0075,210,37,247,379,0,2,0,2,2,0,2,0.00,65.17,100.00
10,009,04,140,0011,0076,534,102,636,981,0,2,0,2,2,0,2,0.00,64.83,100.00
10,009,04,140,0011,0000,534,102,636,981,0,2,0,2,2,0,2,0.00,64.83,100.00
10,009,04,140,0012,0000,523,108,631,930,0,2,0,2,2,0,2,0.00,67.85,100.00
10,009,04,150,0008,0000,691,188,879,1148,0,2,0,2,2,0,2,0.00,76.57,100.00
10,009,04,150,0008,0089,691,188,879,1148,0,2,0,2,2,0,2,0.00,76.57,100.00
10,009,04,150,0009,0000,406,160,566,821,0,2,0,2,2,0,2,0.00,68.94,100.00
10,009,04,150,0009,0090,406,160,566,821,0,2,0,2,2,0,2,0.00,68.94,100.00
10,009,04,160,0012,0054,479,29,508,746,0,4,0,4,3,0,3,0.00,68.10,75.00
10,009,04,160,0012,0055,339,16,355,531,0,4,0,4,3,0,3,0.00,66.85,75.00
10,009,04,160,0013,0056,641,28,669,997,0,4,0,4,3,0,3,0.00,67.10,75.00
10,009,04,160,0013,0057,603,30,633,931,0,4,0,4,3,0,3,0.00,67.99,75.00
10,009,04,160,0013,0058,501,21,522,886,0,4,0,4,3,0,3,0.00,58.92,75.00
10,009,04,160,0014,0059,757,26,783,1102,0,4,0,4,3,0,3,0.00,71.05,75.00
10,009,04,160,0014,0060,394,15,409,544,0,4,0,4,3,0,3,0.00,75.18,75.00
10,009,04,160,0012,0000,818,45,863,1277,0,4,0,4,3,0,3,0.00,67.58,75.00
10,009,04,160,0013,0000,1745,79,1824,2814,0,4,0,4,3,0,3,0.00,64.82,75.00
10,009,04,160,0014,0000,1151,41,1192,1646,0,4,0,4,3,0,3,0.00,72.42,75.00
10,009,04,180,0017,0000,620,26,646,979,0,4,0,4,1,0,1,0.00,65.99,25.00
10,009,04,180,0018,0000,479,7,486,907,0,4,0,4,1,0,1,0.00,53.58,25.00
10,009,04,180,0019,0000,377,22,399,713,0,4,0,4,1,0,1,0.00,55.96,25.00
10,009,04,180,0017,0197,620,26,646,979,0,4,0,4,1,0,1,0.00,65.99,25.00
10,009,04,180,0018,0198,479,7,486,907,0,4,0,4,1,0,1,0.00,53.58,25.00
10,009,04,180,0019,0199,377,22,399,713,0,4,0,4,1,0,1,0.00,55.96,25.00
10,009,04,190,0016,0000,601,29,630,951,0,5,1,6,2,1,3,0.00,66.25,50.00
10,009,04,190,0017,0000,610,11,621,897,0,5,1,6,2,1,3,0.00,69.23,50.00
10,009,04,190,0018,0000,432,22,454,655,0,5,1,6,2,1,3,0.00,69.31,50.00
10,009,04,190,0019,0000,1146,34,1180,1699,0,5,1,6,2,1,3,0.00,69.45,50.00
10,009,04,190,0020,0000,798,27,825,1112,0,5,1,6,2,1,3,0.00,74.19,50.00
10,009,04,190,0021,0000,324,19,343,599,0,5,1,6,2,1,3,0.00,57.26,50.00
10,009,04,190,0019,0245,587,11,598,880,0,5,1,6,2,1,3,0.00,67.95,50.00
10,009,04,190,0019,0246,559,23,582,819,0,5,1,6,2,1,3,0.00,71.06,50.00
10,009,04,190,0020,0247,798,27,825,1112,0,5,1,6,2,1,3,0.00,74.19,50.00
10,009,04,190,0017,0248,610,11,621,897,0,5,1,6,2,1,3,0.00,69.23,50.00
10,009,04,190,0018,0249,432,22,454,655,0,5,1,6,2,1,3,0.00,69.31,50.00
10,009,04,190,0016,0250,601,29,630,951,0,5,1,6,2,1,3,0.00,66.25,50.00
10,009,04,190,0021,0251,324,19,343,599,0,5,1,6,2,1,3,0.00,57.26,50.00
10,009,04,200,0003,0000,557,19,576,910,0,2,0,2,1,0,1,0.00,63.30,50.00
10,009,04,200,0004,0000,672,30,702,1130,0,2,0,2,1,0,1,0.00,62.12,50.00
10,009,04,200,0024,0000,585,23,608,755,0,2,0,2,1,0,1,0.00,80.53,50.00
10,009,04,200,0003,0275,557,19,576,910,0,2,0,2,1,0,1,0.00,63.30,50.00
10,009,04,200,0004,0276,672,30,702,1130,0,2,0,2,1,0,1,0.00,62.12,50.00
10,009,04,200,0024,0277,585,23,608,755,0,2,0,2,1,0,1,0.00,80.53,50.00
10,009,00,050,0000,0000,15154,889,16043,23152,27692,11,3,14,8,3,11,83.61,69.29,78.57
10,009,01,050,0000,0000,5283,176,5459,7716,9709,3,2,5,2,2,4,79.47,70.75,80.00
10,009,02,050,0000,0000,2249,213,2462,3699,4272,2,0,2,2,0,2,86.59,66.56,100.00
10,009,03,050,0000,0000,3096,79,3175,4459,5258,4,0,4,2,0,2,84.80,71.20,50.00
10,009,04,050,0000,0000,4526,421,4947,7278,8453,2,1,3,2,1,3,86.10,67.97,100.00
10,009,05,110,0014,0000,720,76,796,1173,0,1,1,2,1,1,2,0.00,67.86,100.00
10,009,05,110,0015,0000,433,33,466,867,0,1,1,2,1,1,2,0.00,53.75,100.00
10,009,05,110,0016,0000,468,56,524,790,0,1,1,2,1,1,2,0.00,66.33,100.00
10,009,05,110,0017,0000,608,41,649,957,0,1,1,2,1,1,2,0.00,67.82,100.00
10,009,05,110,0014,0365,720,76,796,1173,0,1,1,2,1,1,2,0.00,67.86,100.00
10,009,05,110,0015,0366,433,33,466,867,0,1,1,2,1,1,2,0.00,53.75,100.00
10,009,05,110,0016,0367,468,56,524,790,0,1,1,2,1,1,2,0.00,66.33,100.00
10,009,05,110,0017,0368,608,41,649,957,0,1,1,2,1,1,2,0.00,67.82,100.00
10,009,00,060,0000,0000,19965,1622,21587,31808,37876,8,5,13,6,5,11,83.98,67.87,84.62
10,009,01,060,0000,0000,9656,491,10147,14645,17388,3,3,6,2,3,5,84.22,69.29,83.33
10,009,02,060,0000,0000,6499,391,6890,10491,12719,3,2,5,2,2,4,82.48,65.68,80.00
10,009,03,060,0000,0000,3810,740,4550,6672,7769,2,0,2,2,0,2,85.88,68.20,100.00
10,009,00,070,0000,0000,17064,647,17711,26150,30157,14,3,17,8,3,11,86.71,67.73,64.71
10,009,01,070,0000,0000,5877,199,6076,8775,10205,4,1,5,3,1,4,85.99,69.24,80.00
10,009,02,070,0000,0000,5646,169,5815,8598,9947,4,2,6,2,2,4,86.44,67.63,66.67
10,009,03,070,0000,0000,3683,172,3855,5889,6797,3,0,3,2,0,2,86.64,65.46,66.67
10,009,04,070,0000,0000,1858,107,1965,2888,3208,3,0,3,1,0,1,90.02,68.04,33.33
10,009,00,080,0000,0000,10994,432,11426,15722,18276,14,4,18,8,3,11,86.03,72.68,61.11
10,009,01,080,0000,0000,1864,226,2090,2939,3394,1,1,2,1,1,2,86.59,71.11,100.00
10,009,02,080,0000,0000,3828,84,3912,5339,6311,6,2,8,2,2,4,84.60,73.27,50.00
10,009,03,080,0000,0000,3356,76,3432,4776,5519,4,1,5,3,0,3,86.54,71.86,60.00
10,009,04,080,0000,0000,1946,46,1992,2668,3052,3,0,3,2,0,2,87.42,74.66,66.67
10,009,00,090,0000,0000,15374,890,16264,23336,27575,10,3,13,9,2,11,84.63,69.69,84.62
10,009,01,090,0000,0000,5388,305,5693,8410,9987,4,1,5,3,1,4,84.21,67.69,80.00
10,009,02,090,0000,0000,5540,101,5641,7861,9280,3,2,5,3,1,4,84.71,71.76,80.00
10,009,03,090,0000,0000,4446,484,4930,7065,8308,3,0,3,3,0,3,85.04,69.78,100.00
10,009,00,100,0000,0000,10215,275,10490,14502,17003,18,4,22,7,4,11,85.29,72.33,50.00
10,009,01,100,0000,0000,2975,83,3058,4375,5327,4,1,5,2,1,3,82.13,69.90,60.00
10,009,02,100,0000,0000,1748,51,1799,2477,2869,5,0,5,2,0,2,86.34,72.63,40.00
10,009,03,100,0000,0000,2758,90,2848,3881,4457,5,1,6,2,1,3,87.08,73.38,50.00
10,009,04,100,0000,0000,2734,51,2785,3769,4350,4,2,6,1,2,3,86.64,73.89,50.00
10,009,00,110,0000,0000,13205,988,14193,21886,25299,12,2,14,9,2,11,86.51,64.85,78.57
10,009,01,110,0000,0000,2965,131,3096,4565,5372,3,0,3,2,0,2,84.98,67.82,66.67
10,009,02,110,0000,0000,2721,85,2806,4271,4829,4,0,4,2,0,2,88.44,65.70,50.00
10,009,03,110,0000,0000,2964,369,3333,5114,6001,2,1,3,2,1,3,85.22,65.17,100.00
10,009,04,110,0000,0000,2326,197,2523,4149,4746,2,0,2,2,0,2,87.42,60.81,100.00
10,009,05,110,0000,0000,2229,206,2435,3787,4351,1,1,2,1,1,2,87.04,64.30,100.00
10,009,00,120,0000,0000,12484,496,12980,19774,23140,15,1,16,10,1,11,85.45,65.64,68.75
10,009,01,120,0000,0000,3103,75,3178,4679,5580,4,0,4,3,0,3,83.85,67.92,75.00
10,009,02,120,0000,0000,3156,121,3277,5152,6049,4,0,4,3,0,3,85.17,63.61,75.00
10,009,03,120,0000,0000,2651,146,2797,4096,4778,3,0,3,2,0,2,85.73,68.29,66.67
10,009,04,120,0000,0000,3574,154,3728,5847,6733,4,1,5,2,1,3,86.84,63.76,60.00
10,009,00,130,0000,0000,25201,1076,26277,38982,49134,14,2,16,10,1,11,79.34,67.41,68.75
10,009,01,130,0000,0000,11654,492,12146,18696,23935,4,2,6,4,1,5,78.11,64.97,83.33
10,009,02,130,0000,0000,3882,262,4144,6652,8271,3,0,3,2,0,2,80.43,62.30,66.67
10,009,03,130,0000,0000,4324,184,4508,6675,8239,4,0,4,2,0,2,81.02,67.54,50.00
10,009,04,130,0000,0000,5341,138,5479,6959,8689,3,0,3,2,0,2,80.09,78.73,66.67
10,009,00,140,0000,0000,8429,479,8908,12204,13738,12,2,14,9,2,11,88.83,72.99,78.57
10,009,01,140,0000,0000,2074,112,2186,3076,3483,4,0,4,3,0,3,88.31,71.07,75.00
10,009,02,140,0000,0000,2809,92,2901,3823,4372,2,2,4,1,2,3,87.44,75.88,75.00
10,009,03,140,0000,0000,2489,65,2554,3394,3802,4,0,4,3,0,3,89.27,75.25,75.00
10,009,04,140,0000,0000,1057,210,1267,1911,2081,2,0,2,2,0,2,91.83,66.30,100.00
10,009,00,150,0000,0000,7408,509,7917,10548,12176,10,5,15,9,2,11,86.63,75.06,73.33
10,009,01,150,0000,0000,2248,51,2299,3179,3791,3,1,4,3,0,3,83.86,72.32,75.00
10,009,02,150,0000,0000,2932,79,3011,3886,4482,3,3,6,2,2,4,86.70,77.48,66.67
10,009,03,150,0000,0000,1131,31,1162,1514,1704,2,1,3,2,0,2,88.85,76.75,66.67
10,009,04,150,0000,0000,1097,348,1445,1969,2199,2,0,2,2,0,2,89.54,73.39,100.00
10,009,00,160,0000,0000,13198,462,13660,19610,22224,16,1,17,10,1,11,88.24,69.66,64.71
10,009,01,160,0000,0000,4053,146,4199,5981,6848,4,0,4,3,0,3,87.34,70.21,75.00
10,009,02,160,0000,0000,3230,101,3331,4756,5366,4,1,5,2,1,3,88.63,70.04,60.00
10,009,03,160,0000,0000,2201,50,2251,3136,3582,4,0,4,2,0,2,87.55,71.78,50.00
10,009,04,160,0000,0000,3714,165,3879,5737,6428,4,0,4,3,0,3,89.25,67.61,75.00
10,009,00,170,0000,0000,13717,463,14180,20921,23825,14,2,16,10,1,11,87.81,67.78,68.75
10,009,01,170,0000,0000,6526,247,6773,10426,11925,4,2,6,4,1,5,87.43,64.96,83.33
10,009,02,170,0000,0000,3601,82,3683,5296,6003,5,0,5,3,0,3,88.22,69.54,60.00
10,009,03,170,0000,0000,3590,134,3724,5199,5897,5,0,5,3,0,3,88.16,71.63,60.00
10,009,00,180,0000,0000,12501,442,12943,19432,21652,17,2,19,10,1,11,89.75,66.61,57.89
10,009,01,180,0000,0000,6143,123,6266,8785,9956,6,2,8,4,1,5,88.24,71.33,62.50
10,009,02,180,0000,0000,1776,184,1960,3223,3538,2,0,2,2,0,2,91.10,60.81,100.00
10,009,03,180,0000,0000,3106,80,3186,4825,5299,5,0,5,3,0,3,91.05,66.03,60.00
10,009,04,180,0000,0000,1476,55,1531,2599,2859,4,0,4,1,0,1,90.91,58.91,25.00
10,009,00,190,0000,0000,14794,514,15308,22646,25687,21,1,22,10,1,11,88.16,67.60,50.00
10,009,01,190,0000,0000,4381,171,4552,6642,7538,5,0,5,3,0,3,88.11,68.53,60.00
10,009,02,190,0000,0000,3239,60,3299,5223,5896,7,0,7,3,0,3,88.59,63.16,42.86
10,009,03,190,0000,0000,3263,141,3404,4868,5537,4,0,4,2,0,2,87.92,69.93,50.00
10,009,04,190,0000,0000,3911,142,4053,5913,6716,5,1,6,2,1,3,88.04,68.54,50.00
10,009,00,200,0000,0000,13700,385,14085,20632,23326,15,4,19,8,3,11,88.45,68.27,57.89
10,009,01,200,0000,0000,5920,141,6061,8550,9689,5,2,7,3,2,5,88.24,70.89,71.43
10,009,02,200,0000,0000,2637,95,2732,4367,4844,3,1,4,2,0,2,90.15,62.56,50.00
10,009,03,200,0000,0000,3329,77,3406,4920,5587,5,1,6,2,1,3,88.06,69.23,50.00
10,009,04,200,0000,0000,1814,72,1886,2795,3206,2,0,2,1,0,1,87.18,67.48,50.00
10,010,00,000,0000,0000,273272,11010,284282,421987,488920,212,81,293,131,61,192,86.31,67.37,65.53
10,010,00,010,0000,0000,20883,624,21507,31474,38830,11,5,16,7,4,11,81.06,68.33,68.75
10,010,01,010,0000,0000,8691,283,8974,13159,16539,3,3,6,3,2,5,79.56,68.20,83.33
10,010,02,010,0000,0000,3318,102,3420,4912,5765,2,0,2,1,0,1,85.20,69.63,50.00
10,010,03,010,0000,0000,8874,239,9113,13403,16526,6,2,8,3,2,5,81.10,67.99,62.50
10,010,01,010,0001,0001,850,22,872,1246,0,3,3,6,3,2,5,0.00,69.98,83.33
10,010,01,010,0001,0002,685,26,711,1041,0,3,3,6,3,2,5,0.00,68.30,83.33
10,010,01,010,0002,0003,285,8,293,434,0,3,3,6,3,2,5,0.00,67.51,83.33
10,010,01,010,0003,0004,471,16,487,688,0,3,3,6,3,2,5,0.00,70.78,83.33
10,010,01,010,0003,0005,462,16,478,706,0,3,3,6,3,2,5,0.00,67.71,83.33
10,010,01,010,0004,0006,543,9,552,729,0,3,3,6,3,2,5,0.00,75.72,83.33
10,010,01,010,0004,0007,629,11,640,918,0,3,3,6,3,2,5,0.00,69.72,83.33
10,010,01,010,0005,0008,543,9,552,727,0,3,3,6,3,2,5,0.00,75.93,83.33
10,010,01,010,0005,0009,268,11,279,373,0,3,3,6,3,2,5,0.00,74.80,83.33
10,010,01,010,0001,0000,1535,48,1583,2287,0,3,3,6,3,2,5,0.00,69.22,83.33
10,010,01,010,0006,0010,772,37,809,1121,0,3,3,6,3,2,5,0.00,72.17,83.33
10,010,01,010,0007,0011,536,18,554,788,0,3,3,6,3,2,5,0.00,70.30,83.33
10,010,01,010,0018,0012,116,2,118,187,0,3,3,6,3,2,5,0.00,63.10,83.33
10,010,01,010,0018,0013,416,14,430,683,0,3,3,6,3,2,5,0.00,62.96,83.33
10,010,01,010,0018,0014,524,22,546,915,0,3,3,6,3,2,5,0.00,59.67,83.33
10,010,01,010,0018,0015,451,41,492,804,0,3,3,6,3,2,5,0.00,61.19,83.33
10,010,01,010,0008,0016,646,7,653,916,0,3,3,6,3,2,5,0.00,71.29,83.33
10,010,01,010,0008,0017,494,14,508,883,0,3,3,6,3,2,5,0.00,57.53,83.33
10,010,01,010,0002,0000,285,8,293,434,0,3,3,6,3,2,5,0.00,67.51,83.33
10,010,01,010,0003,0000,933,32,965,1394,0,3,3,6,3,2,5,0.00,69.23,83.33
10,010,01,010,0004,0000,1172,20,1192,1647,0,3,3,6,3,2,5,0.00,72.37,83.33
10,010,01,010,0005,0000,811,20,831,1100,0,3,3,6,3,2,5,0.00,75.55,83.33
10,010,01,010,0006,0000,772,37,809,1121,0,3,3,6,3,2,5,0.00,72.17,83.33
10,010,01,010,0007,0000,536,18,554,788,0,3,3,6,3,2,5,0.00,70.30,83.33
10,010,01,010,0008,0000,1140,21,1161,1799,0,3,3,6,3,2,5,0.00,64.54,83.33
10,010,01,010,0018,0000,1507,79,1586,2589,0,3,3,6,3,2,5,0.00,61.26,83.33
10,010,01,020,0001,0000,1155,36,1191,1844,0,7,2,9,3,2,5,0.00,64.59,55.56
10,010,01,020,0002,0000,1424,62,1486,2277,0,7,2,9,3,2,5,0.00,65.26,55.56
10,010,01,020,0003,0000,699,26,725,1046,0,7,2,9,3,2,5,0.00,69.31,55.56
10,010,01,020,0004,0000,240,8,248,346,0,7,2,9,3,2,5,0.00,71.68,55.56
10,010,01,020,0005,0000,393,15,408,596,0,7,2,9,3,2,5,0.00,68.46,55.56
10,010,01,020,0006,0000,388,10,398,571,0,7,2,9,3,2,5,0.00,69.70,55.56
10,010,01,020,0007,0000,583,15,598,821,0,7,2,9,3,2,5,0.00,72.84,55.56
10,010,01,020,0008,0000,997,37,1034,1602,0,7,2,9,3,2,5,0.00,64.54,55.56
10,010,01,020,0009,0000,1581,24,1605,2412,0,7,2,9,3,2,5,0.00,66.54,55.56
10,010,01,020,0010,0000,2745,98,2843,4123,0,7,2,9,3,2,5,0.00,68.95,55.56
10,010,01,020,0001,0262,701,26,727,1126,0,7,2,9,3,2,5,0.00,64.56,55.56
10,010,01,020,0001,0263,454,10,464,718,0,7,2,9,3,2,5,0.00,64.62,55.56
10,010,01,020,0002,0264,735,40,775,1209,0,7,2,9,3,2,5,0.00,64.10,55.56
10,010,01,020,0002,0265,689,22,711,1068,0,7,2,9,3,2,5,0.00,66.57,55.56
10,010,01,020,0003,0266,699,26,725,1046,0,7,2,9,3,2,5,0.00,69.31,55.56
10,010,01,020,0004,0267,240,8,248,346,0,7,2,9,3,2,5,0.00,71.68,55.56
10,010,01,020,0006,0268,388,10,398,571,0,7,2,9,3,2,5,0.00,69.70,55.56
10,010,01,020,0005,0269,393,15,408,596,0,7,2,9,3,2,5,0.00,68.46,55.56
10,010,01,020,0007,0270,583,15,598,821,0,7,2,9,3,2,5,0.00,72.84,55.56
10,010,01,020,0008,0271,434,13,447,711,0,7,2,9,3,2,5,0.00,62.87,55.56
10,010,01,020,0008,0272,563,24,587,891,0,7,2,9,3,2,5,0.00,65.88,55.56
10,010,01,020,0009,0273,820,9,829,1265,0,7,2,9,3,2,5,0.00,65.53,55.56
10,010,01,020,0009,0274,761,15,776,1147,0,7,2,9,3,2,5,0.00,67.65,55.56
10,010,01,020,0010,0275,979,32,1011,1489,0,7,2,9,3,2,5,0.00,67.90,55.56
10,010,01,020,0010,0276,796,36,832,1191,0,7,2,9,3,2,5,0.00,69.86,55.56
10,010,01,020,0010,0277,970,30,1000,1443,0,7,2,9,3,2,5,0.00,69.30,55.56
10,010,01,030,0001,0000,399,16,415,571,0,2,3,5,2,2,4,0.00,72.68,80.00
10,010,01,030,0002,0000,227,5,232,344,0,2,3,5,2,2,4,0.00,67.44,80.00
10,010,01,030,0003,0000,1377,54,1431,2047,0,2,3,5,2,2,4,0.00,69.91,80.00
10,010,01,030,0004,0000,610,18,628,1019,0,2,3,5,2,2,4,0.00,61.63,80.00
10,010,01,030,0005,0000,1012,23,1035,1538,0,2,3,5,2,2,4,0.00,67.30,80.00
10,010,01,030,0006,0000,534,15,549,820,0,2,3,5,2,2,4,0.00,66.95,80.00
10,010,01,030,0007,0000,405,17,422,658,0,2,3,5,2,2,4,0.00,64.13,80.00
10,010,01,030,0008,0000,474,11,485,702,0,2,3,5,2,2,4,0.00,69.09,80.00
10,010,01,030,0018,0000,413,10,423,676,0,2,3,5,2,2,4,0.00,62.57,80.00
10,010,01,030,0001,0355,399,16,415,571,0,2,3,5,2,2,4,0.00,72.68,80.00
10,010,01,030,0002,0356,227,5,232,344,0,2,3,5,2,2,4,0.00,67.44,80.00
10,010,01,030,0003,0357,576,23,599,890,0,2,3,5,2,2,4,0.00,67.30,80.00
10,010,01,030,0003,0358,801,31,832,1157,0,2,3,5,2,2,4,0.00,71.91,80.00
10,010,01,030,0004,0359,610,18,628,1019,0,2,3,5,2,2,4,0.00,61.63,80.00
10,010,01,030,0005,0360,588,11,599,908,0,2,3,5,2,2,4,0.00,65.97,80.00
10,010,01,030,0005,0361,424,12,436,630,0,2,3,5,2,2,4,0.00,69.21,80.00
10,010,01,030,0006,0362,534,15,549,820,0,2,3,5,2,2,4,0.00,66.95,80.00
10,010,01,030,0007,0363,405,17,422,658,0,2,3,5,2,2,4,0.00,64.13,80.00
10,010,01,030,0008,0364,474,11,485,702,0,2,3,5,2,2,4,0.00,69.09,80.00
10,010,01,030,0018,0365,413,10,423,676,0,2,3,5,2,2,4,0.00,62.57,80.00
10,010,01,040,0001,0000,277,12,289,456,0,7,2,9,4,2,6,0.00,63.38,66.67
10,010,01,040,0002,0000,1173,35,1208,1759,0,7,2,9,4,2,6,0.00,68.68,66.67
10,010,01,040,0003,0000,578,20,598,859,0,7,2,9,4,2,6,0.00,69.62,66.67
10,010,01,040,0004,0000,3560,108,3668,5763,0,7,2,9,4,2,6,0.00,63.65,66.67
10,010,01,040,0005,0000,767,27,794,1084,0,7,2,9,4,2,6,0.00,73.25,66.67
10,010,01,040,0006,0000,1039,48,1087,1785,0,7,2,9,4,2,6,0.00,60.90,66.67
10,010,01,040,0007,0000,333,17,350,552,0,7,2,9,4,2,6,0.00,63.41,66.67
10,010,01,040,0008,0000,471,22,493,675,0,7,2,9,4,2,6,0.00,73.04,66.67
10,010,01,040,0009,0000,431,17,448,593,0,7,2,9,4,2,6,0.00,75.55,66.67
10,010,01,040,0010,0000,92,3,95,171,0,7,2,9,4,2,6,0.00,55.56,66.67
10,010,01,040,0001,0194,277,12,289,456,0,7,2,9,4,2,6,0.00,63.38,66.67
10,010,01,040,0002,0195,544,17,561,853,0,7,2,9,4,2,6,0.00,65.77,66.67
10,010,01,040,0002,0196,629,18,647,906,0,7,2,9,4,2,6,0.00,71.41,66.67
10,010,01,040,0003,0197,578,20,598,859,0,7,2,9,4,2,6,0.00,69.62,66.67
10,010,01,040,0004,0198,840,31,871,1363,0,7,2,9,4,2,6,0.00,63.90,66.67
10,010,01,040,0004,0199,831,23,854,1334,0,7,2,9,4,2,6,0.00,64.02,66.67
10,010,01,040,0004,0200,893,23,916,1483,0,7,2,9,4,2,6,0.00,61.77,66.67
10,010,01,040,0004,0201,996,31,1027,1583,0,7,2,9,4,2,6,0.00,64.88,66.67
10,010,01,040,0005,0202,767,27,794,1084,0,7,2,9,4,2,6,0.00,73.25,66.67
10,010,01,040,0006,0203,1039,48,1087,1785,0,7,2,9,4,2,6,0.00,60.90,66.67
10,010,01,040,0007,0204,333,17,350,552,0,7,2,9,4,2,6,0.00,63.41,66.67
10,010,01,040,0008,0205,471,22,493,675,0,7,2,9,4,2,6,0.00,73.04,66.67
10,010,01,040,0009,0206,431,17,448,593,0,7,2,9,4,2,6,0.00,75.55,66.67
10,010,01,040,0010,0207,92,3,95,171,0,7,2,9,4,2,6,0.00,55.56,66.67
10,010,01,050,0001,0000,1266,69,1335,2187,0,3,3,6,2,2,4,0.00,61.04,66.67
10,010,01,050,0002,0000,956,37,993,1461,0,3,3,6,2,2,4,0.00,67.97,66.67
10,010,01,050,0003,0000,1951,92,2043,3254,0,3,3,6,2,2,4,0.00,62.78,66.67
10,010,01,050,0004,0000,1371,86,1457,2082,0,3,3,6,2,2,4,0.00,69.98,66.67
10,010,01,050,0005,0000,1043,45,1088,1511,0,3,3,6,2,2,4,0.00,72.01,66.67
10,010,01,050,0006,0000,1113,70,1183,1753,0,3,3,6,2,2,4,0.00,67.48,66.67
10,010,01,050,0007,0000,952,41,993,1418,0,3,3,6,2,2,4,0.00,70.03,66.67
10,010,01,050,0008,0000,1130,57,1187,1633,0,3,3,6,2,2,4,0.00,72.69,66.67
10,010,01,050,0009,0000,631,45,676,955,0,3,3,6,2,2,4,0.00,70.79,66.67
10,010,01,050,0010,0000,557,30,587,792,0,3,3,6,2,2,4,0.00,74.12,66.67
10,010,01,050,0001,0108,740,46,786,1210,0,3,3,6,2,2,4,0.00,64.96,66.67
10,010,01,050,0001,0109,526,23,549,977,0,3,3,6,2,2,4,0.00,56.19,66.67
10,010,01,050,0011,0000,565,32,597,811,0,3,3,6,2,2,4,0.00,73.61,66.67
10,010,01,050,0002,0110,956,37,993,1461,0,3,3,6,2,2,4,0.00,67.97,66.67
10,010,01,050,0003,0111,990,42,1032,1643,0,3,3,6,2,2,4,0.00,62.81,66.67
10,010,01,050,0003,0112,961,50,1011,1611,0,3,3,6,2,2,4,0.00,62.76,66.67
10,010,01,050,0004,0113,743,38,781,1048,0,3,3,6,2,2,4,0.00,74.52,66.67
10,010,01,050,0004,0114,628,48,676,1034,0,3,3,6,2,2,4,0.00,65.38,66.67
10,010,01,050,0005,0115,1043,45,1088,1511,0,3,3,6,2,2,4,0.00,72.01,66.67
10,010,01,050,0006,0116,425,42,467,672,0,3,3,6,2,2,4,0.00,69.49,66.67
10,010,01,050,0006,0117,688,28,716,1081,0,3,3,6,2,2,4,0.00,66.23,66.67
10,010,01,050,0007,0118,952,41,993,1418,0,3,3,6,2,2,4,0.00,70.03,66.67
10,010,01,050,0008,0119,625,39,664,913,0,3,3,6,2,2,4,0.00,72.73,66.67
10,010,01,050,0008,0120,505,18,523,720,0,3,3,6,2,2,4,0.00,72.64,66.67
10,010,01,050,0009,0121,631,45,676,955,0,3,3,6,2,2,4,0.00,70.79,66.67
10,010,01,050,0010,0122,557,30,587,792,0,3,3,6,2,2,4,0.00,74.12,66.67
10,010,01,050,0011,0123,565,32,597,811,0,3,3,6,2,2,4,0.00,73.61,66.67
10,010,01,060,0001,0000,799,19,818,1213,0,6,3,9,3,3,6,0.00,67.44,66.67
10,010,01,060,0002,0000,444,6,450,630,0,6,3,9,3,3,6,0.00,71.43,66.67
10,010,01,060,0003,0000,446,12,458,603,0,6,3,9,3,3,6,0.00,75.95,66.67
10,010,01,060,0011,0000,815,28,843,1225,0,6,3,9,3,3,6,0.00,68.82,66.67
10,010,01,060,0012,0000,661,25,686,972,0,6,3,9,3,3,6,0.00,70.58,66.67
10,010,01,060,0013,0000,443,18,461,648,0,6,3,9,3,3,6,0.00,71.14,66.67
10,010,01,060,0014,0000,627,11,638,849,0,6,3,9,3,3,6,0.00,75.15,66.67
10,010,01,060,0001,0221,799,19,818,1213,0,6,3,9,3,3,6,0.00,67.44,66.67
10,010,01,060,0002,0222,444,6,450,630,0,6,3,9,3,3,6,0.00,71.43,66.67
10,010,01,060,0003,0223,289,9,298,369,0,6,3,9,3,3,6,0.00,80.76,66.67
10,010,01,060,0003,0224,157,3,160,234,0,6,3,9,3,3,6,0.00,68.38,66.67
10,010,01,060,0011,0225,568,19,587,854,0,6,3,9,3,3,6,0.00,68.74,66.67
10,010,01,060,0011,0226,247,9,256,371,0,6,3,9,3,3,6,0.00,69.00,66.67
10,010,01,060,0012,0227,661,25,686,972,0,6,3,9,3,3,6,0.00,70.58,66.67
10,010,01,060,0013,0228,443,18,461,648,0,6,3,9,3,3,6,0.00,71.14,66.67
10,010,01,060,0014,0229,627,11,638,849,0,6,3,9,3,3,6,0.00,75.15,66.67
10,010,01,070,0001,0000,1540,36,1576,2153,0,6,3,9,5,1,6,0.00,73.20,66.67
10,010,01,070,0002,0000,999,39,1038,1493,0,6,3,9,5,1,6,0.00,69.52,66.67
10,010,01,070,0003,0000,941,28,969,1358,0,6,3,9,5,1,6,0.00,71.35,66.67
10,010,01,070,0004,0000,1083,41,1124,1584,0,6,3,9,5,1,6,0.00,70.96,66.67
10,010,01,070,0005,0000,952,36,988,1305,0,6,3,9,5,1,6,0.00,75.71,66.67
10,010,01,070,0006,0000,1074,47,1121,1529,0,6,3,9,5,1,6,0.00,73.32,66.67
10,010,01,070,0007,0000,1107,42,1149,1584,0,6,3,9,5,1,6,0.00,72.54,66.67
10,010,01,070,0008,0000,598,17,615,879,0,6,3,9,5,1,6,0.00,69.97,66.67
10,010,01,070,0009,0000,366,14,380,508,0,6,3,9,5,1,6,0.00,74.80,66.67
10,010,01,070,0010,0000,594,24,618,841,0,6,3,9,5,1,6,0.00,73.48,66.67
10,010,01,070,0011,0000,371,12,383,458,0,6,3,9,5,1,6,0.00,83.62,66.67
10,010,01,070,0012,0000,377,10,387,471,0,6,3,9,5,1,6,0.00,82.17,66.67
10,010,01,070,0001,0160,718,18,736,1026,0,6,3,9,5,1,6,0.00,71.73,66.67
10,010,01,070,0001,0161,822,18,840,1127,0,6,3,9,5,1,6,0.00,74.53,66.67
10,010,01,070,0002,0162,470,15,485,681,0,6,3,9,5,1,6,0.00,71.22,66.67
10,010,01,070,0002,0163,529,24,553,812,0,6,3,9,5,1,6,0.00,68.10,66.67
10,010,01,070,0003,0164,423,9,432,623,0,6,3,9,5,1,6,0.00,69.34,66.67
10,010,01,070,0003,0165,518,19,537,735,0,6,3,9,5,1,6,0.00,73.06,66.67
10,010,01,070,0004,0166,530,23,553,772,0,6,3,9,5,1,6,0.00,71.63,66.67
10,010,01,070,0004,0167,553,18,571,812,0,6,3,9,5,1,6,0.00,70.32,66.67
10,010,01,070,0005,0168,463,19,482,641,0,6,3,9,5,1,6,0.00,75.20,66.67
10,010,01,070,0005,0169,489,17,506,664,0,6,3,9,5,1,6,0.00,76.20,66.67
10,010,01,070,0006,0170,513,28,541,708,0,6,3,9,5,1,6,0.00,76.41,66.67
10,010,01,070,0006,0171,561,19,580,821,0,6,3,9,5,1,6,0.00,70.65,66.67
10,010,01,070,0007,0172,539,24,563,769,0,6,3,9,5,1,6,0.00,73.21,66.67
10,010,01,070,0007,0173,568,18,586,815,0,6,3,9,5,1,6,0.00,71.90,66.67
10,010,01,070,0008,0174,598,17,615,879,0,6,3,9,5,1,6,0.00,69.97,66.67
10,010,01,070,0009,0175,366,14,380,508,0,6,3,9,5,1,6,0.00,74.80,66.67
10,010,01,070,0010,0176,594,24,618,841,0,6,3,9,5,1,6,0.00,73.48,66.67
10,010,01,070,0011,0177,371,12,383,458,0,6,3,9,5,1,6,0.00,83.62,66.67
10,010,01,070,0012,0178,377,10,387,471,0,6,3,9,5,1,6,0.00,82.17,66.67
10,010,01,080,0001,0000,730,22,752,1090,0,7,1,8,4,1,5,0.00,68.99,62.50
10,010,01,080,0002,0000,571,29,600,769,0,7,1,8,4,1,5,0.00,78.02,62.50
10,010,01,080,0003,0000,621,29,650,832,0,7,1,8,4,1,5,0.00,78.13,62.50
10,010,01,080,0004,0000,150,3,153,194,0,7,1,8,4,1,5,0.00,78.87,62.50
10,010,01,080,0005,0000,774,43,817,1101,0,7,1,8,4,1,5,0.00,74.21,62.50
10,010,01,080,0006,0000,809,17,826,1100,0,7,1,8,4,1,5,0.00,75.09,62.50
10,010,01,080,0007,0000,550,31,581,824,0,7,1,8,4,1,5,0.00,70.51,62.50
10,010,01,080,0008,0000,377,26,403,595,0,7,1,8,4,1,5,0.00,67.73,62.50
10,010,01,080,0009,0000,461,18,479,675,0,7,1,8,4,1,5,0.00,70.96,62.50
10,010,01,080,0019,0000,808,54,862,1316,0,7,1,8,4,1,5,0.00,65.50,62.50
10,010,01,080,0020,0000,383,18,401,550,0,7,1,8,4,1,5,0.00,72.91,62.50
10,010,01,080,0001,0298,730,22,752,1090,0,7,1,8,4,1,5,0.00,68.99,62.50
10,010,01,080,0002,0299,571,29,600,769,0,7,1,8,4,1,5,0.00,78.02,62.50
10,010,01,080,0003,0300,621,29,650,832,0,7,1,8,4,1,5,0.00,78.13,62.50
10,010,01,080,0004,0301,150,3,153,194,0,7,1,8,4,1,5,0.00,78.87,62.50
10,010,01,080,0005,0302,774,43,817,1101,0,7,1,8,4,1,5,0.00,74.21,62.50
10,010,01,080,0006,0303,809,17,826,1100,0,7,1,8,4,1,5,0.00,75.09,62.50
10,010,01,080,0007,0304,550,31,581,824,0,7,1,8,4,1,5,0.00,70.51,62.50
10,010,01,080,0008,0305,377,26,403,595,0,7,1,8,4,1,5,0.00,67.73,62.50
10,010,01,080,0009,0306,363,15,378,522,0,7,1,8,4,1,5,0.00,72.41,62.50
10,010,01,080,0009,0307,98,3,101,153,0,7,1,8,4,1,5,0.00,66.01,62.50
10,010,01,080,0019,0308,128,6,134,199,0,7,1,8,4,1,5,0.00,67.34,62.50
10,010,01,080,0019,0309,127,3,130,222,0,7,1,8,4,1,5,0.00,58.56,62.50
10,010,01,080,0019,0310,217,12,229,339,0,7,1,8,4,1,5,0.00,67.55,62.50
10,010,01,080,0019,0311,336,33,369,556,0,7,1,8,4,1,5,0.00,66.37,62.50
10,010,01,080,0020,0312,383,18,401,550,0,7,1,8,4,1,5,0.00,72.91,62.50
10,010,01,090,0001,0000,1266,69,1335,1857,0,3,0,3,3,0,3,0.00,71.89,100.00
10,010,01,090,0002,0000,534,46,580,886,0,3,0,3,3,0,3,0.00,65.46,100.00
10,010,01,090,0003,0000,746,89,835,1289,0,3,0,3,3,0,3,0.00,64.78,100.00
10,010,01,090,0004,0000,1009,85,1094,1568,0,3,0,3,3,0,3,0.00,69.77,100.00
10,010,01,090,0001,0328,1266,69,1335,1857,0,3,0,3,3,0,3,0.00,71.89,100.00
10,010,01,090,0002,0329,534,46,580,886,0,3,0,3,3,0,3,0.00,65.46,100.00
10,010,01,090,0003,0330,746,89,835,1289,0,3,0,3,3,0,3,0.00,64.78,100.00
10,010,01,090,0004,0331,1009,85,1094,1568,0,3,0,3,3,0,3,0.00,69.77,100.00
10,010,01,100,0001,0000,486,16,502,624,0,4,3,7,2,3,5,0.00,80.45,71.43
10,010,01,100,0002,0000,979,35,1014,1387,0,4,3,7,2,3,5,0.00,73.11,71.43
10,010,01,100,0003,0000,785,15,800,1097,0,4,3,7,2,3,5,0.00,72.93,71.43
10,010,01,100,0004,0000,608,17,625,823,0,4,3,7,2,3,5,0.00,75.94,71.43
10,010,01,100,0005,0000,515,15,530,707,0,4,3,7,2,3,5,0.00,74.96,71.43
10,010,01,100,0006,0000,868,18,886,1149,0,4,3,7,2,3,5,0.00,77.11,71.43
10,010,01,100,0007,0000,274,12,286,354,0,4,3,7,2,3,5,0.00,80.79,71.43
10,010,01,100,0008,0000,260,6,266,390,0,4,3,7,2,3,5,0.00,68.21,71.43
10,010,01,100,0009,0000,549,13,562,689,0,4,3,7,2,3,5,0.00,81.57,71.43
10,010,01,100,0001,0384,322,11,333,425,0,4,3,7,2,3,5,0.00,78.35,71.43
10,010,01,100,0001,0385,164,5,169,199,0,4,3,7,2,3,5,0.00,84.92,71.43
10,010,01,100,0002,0386,558,17,575,776,0,4,3,7,2,3,5,0.00,74.10,71.43
10,010,01,100,0002,0387,421,18,439,611,0,4,3,7,2,3,5,0.00,71.85,71.43
10,010,01,100,0003,0388,785,15,800,1097,0,4,3,7,2,3,5,0.00,72.93,71.43
10,010,01,100,0004,0389,608,17,625,823,0,4,3,7,2,3,5,0.00,75.94,71.43
10,010,01,100,0005,0390,515,15,530,707,0,4,3,7,2,3,5,0.00,74.96,71.43
10,010,01,100,0006,0391,868,18,886,1149,0,4,3,7,2,3,5,0.00,77.11,71.43
10,010,01,100,0007,0392,274,12,286,354,0,4,3,7,2,3,5,0.00,80.79,71.43
10,010,01,100,0008,0393,188,5,193,300,0,4,3,7,2,3,5,0.00,64.33,71.43
10,010,01,100,0008,0394,72,1,73,90,0,4,3,7,2,3,5,0.00,81.11,71.43
10,010,01,100,0009,0395,549,13,562,689,0,4,3,7,2,3,5,0.00,81.57,71.43
10,010,01,110,0001,0000,366,12,378,485,0,5,3,8,3,2,5,0.00,77.94,62.50
10,010,01,110,0002,0000,367,12,379,521,0,5,3,8,3,2,5,0.00,72.74,62.50
10,010,01,110,0003,0000,894,21,915,1228,0,5,3,8,3,2,5,0.00,74.51,62.50
10,010,01,110,0004,0000,880,25,905,1271,0,5,3,8,3,2,5,0.00,71.20,62.50
10,010,01,110,0001,0042,366,12,378,485,0,5,3,8,3,2,5,0.00,77.94,62.50
10,010,01,110,0002,0043,367,12,379,521,0,5,3,8,3,2,5,0.00,72.74,62.50
10,010,01,110,0003,0044,894,21,915,1228,0,5,3,8,3,2,5,0.00,74.51,62.50
10,010,01,110,0004,0045,880,25,905,1271,0,5,3,8,3,2,5,0.00,71.20,62.50
10,010,01,110,0005,0046,237,3,240,309,0,5,3,8,3,2,5,0.00,77.67,62.50
10,010,01,110,0005,0047,109,1,110,381,0,5,3,8,3,2,5,0.00,28.87,62.50
10,010,01,110,0006,0048,662,8,670,976,0,5,3,8,3,2,5,0.00,68.65,62.50
10,010,01,110,0007,0049,264,8,272,414,0,5,3,8,3,2,5,0.00,65.70,62.50
10,010,01,110,0005,0000,346,4,350,690,0,5,3,8,3,2,5,0.00,50.72,62.50
10,010,01,110,0006,0000,662,8,670,976,0,5,3,8,3,2,5,0.00,68.65,62.50
10,010,01,110,0007,0000,264,8,272,414,0,5,3,8,3,2,5,0.00,65.70,62.50
10,010,01,120,0001,0000,2093,107,2200,3909,0,5,1,6,2,1,3,0.00,56.28,50.00
10,010,01,120,0002,0000,1391,54,1445,2411,0,5,1,6,2,1,3,0.00,59.93,50.00
10,010,01,120,0006,0000,860,52,912,1466,0,5,1,6,2,1,3,0.00,62.21,50.00
10,010,01,120,0001,0062,456,25,481,975,0,5,1,6,2,1,3,0.00,49.33,50.00
10,010,01,120,0001,0063,618,28,646,1069,0,5,1,6,2,1,3,0.00,60.43,50.00
10,010,01,120,0001,0064,561,24,585,1022,0,5,1,6,2,1,3,0.00,57.24,50.00
10,010,01,120,0001,0065,458,30,488,843,0,5,1,6,2,1,3,0.00,57.89,50.00
10,010,01,120,0002,0066,630,22,652,1119,0,5,1,6,2,1,3,0.00,58.27,50.00
10,010,01,120,0002,0067,761,32,793,1292,0,5,1,6,2,1,3,0.00,61.38,50.00
10,010,01,120,0006,0068,664,41,705,1171,0,5,1,6,2,1,3,0.00,60.20,50.00
10,010,01,120,0006,0069,196,11,207,295,0,5,1,6,2,1,3,0.00,70.17,50.00
10,010,01,120,0007,0000,1030,34,1064,1790,0,5,1,6,2,1,3,0.00,59.44,50.00
10,010,01,120,0007,0070,327,19,346,624,0,5,1,6,2,1,3,0.00,55.45,50.00
10,010,01,120,0007,0071,703,15,718,1166,0,5,1,6,2,1,3,0.00,61.58,50.00
10,010,01,120,0008,0072,521,21,542,949,0,5,1,6,2,1,3,0.00,57.11,50.00
10,010,01,120,0008,0073,447,22,469,705,0,5,1,6,2,1,3,0.00,66.52,50.00
10,010,01,120,0009,0074,245,12,257,406,0,5,1,6,2,1,3,0.00,63.30,50.00
10,010,01,120,0008,0000,968,43,1011,1654,0,5,1,6,2,1,3,0.00,61.12,50.00
10,010,01,120,0009,0000,245,12,257,406,0,5,1,6,2,1,3,0.00,63.30,50.00
10,010,01,130,0006,0000,1525,68,1593,2801,0,4,3,7,3,2,5,0.00,56.87,71.43
10,010,01,130,0007,0000,1706,87,1793,3213,0,4,3,7,3,2,5,0.00,55.80,71.43
10,010,01,130,0008,0000,3563,174,3737,6793,0,4,3,7,3,2,5,0.00,55.01,71.43
10,010,01,130,0009,0000,3148,111,3259,5481,0,4,3,7,3,2,5,0.00,59.46,71.43
10,010,01,130,0006,0412,510,26,536,1003,0,4,3,7,3,2,5,0.00,53.44,71.43
10,010,01,130,0006,0413,431,15,446,786,0,4,3,7,3,2,5,0.00,56.74,71.43
10,010,01,130,0006,0414,584,27,611,1012,0,4,3,7,3,2,5,0.00,60.38,71.43
10,010,01,130,0007,0415,640,38,678,1236,0,4,3,7,3,2,5,0.00,54.85,71.43
10,010,01,130,0007,0416,473,19,492,863,0,4,3,7,3,2,5,0.00,57.01,71.43
10,010,01,130,0007,0417,593,30,623,1114,0,4,3,7,3,2,5,0.00,55.92,71.43
10,010,01,130,0008,0418,684,31,715,1336,0,4,3,7,3,2,5,0.00,53.52,71.43
10,010,01,130,0008,0419,691,35,726,1220,0,4,3,7,3,2,5,0.00,59.51,71.43
10,010,01,130,0008,0420,519,17,536,1037,0,4,3,7,3,2,5,0.00,51.69,71.43
10,010,01,130,0008,0421,647,27,674,1251,0,4,3,7,3,2,5,0.00,53.88,71.43
10,010,01,130,0008,0422,383,16,399,758,0,4,3,7,3,2,5,0.00,52.64,71.43
10,010,01,130,0008,0423,639,48,687,1191,0,4,3,7,3,2,5,0.00,57.68,71.43
10,010,01,130,0009,0424,603,22,625,1126,0,4,3,7,3,2,5,0.00,55.51,71.43
10,010,01,130,0009,0425,745,20,765,1290,0,4,3,7,3,2,5,0.00,59.30,71.43
10,010,01,130,0009,0426,511,20,531,946,0,4,3,7,3,2,5,0.00,56.13,71.43
10,010,01,130,0009,0427,576,22,598,971,0,4,3,7,3,2,5,0.00,61.59,71.43
10,010,01,130,0009,0428,713,27,740,1148,0,4,3,7,3,2,5,0.00,64.46,71.43
10,010,01,140,0001,0000,1503,47,1550,2401,0,5,2,7,3,2,5,0.00,64.56,71.43
10,010,01,140,0002,0000,1218,48,1266,2094,0,5,2,7,3,2,5,0.00,60.46,71.43
10,010,01,140,0003,0000,458,14,472,731,0,5,2,7,3,2,5,0.00,64.57,71.43
10,010,01,140,0004,0000,521,10,531,796,0,5,2,7,3,2,5,0.00,66.71,71.43
10,010,01,140,0005,0000,762,24,786,1153,0,5,2,7,3,2,5,0.00,68.17,71.43
10,010,01,140,0006,0000,410,22,432,597,0,5,2,7,3,2,5,0.00,72.36,71.43
10,010,01,140,0007,0000,632,21,653,974,0,5,2,7,3,2,5,0.00,67.04,71.43
10,010,01,140,0008,0000,2765,80,2845,5028,0,5,2,7,3,2,5,0.00,56.58,71.43
10,010,01,140,0001,0456,764,24,788,1242,0,5,2,7,3,2,5,0.00,63.45,71.43
10,010,01,140,0001,0457,739,23,762,1159,0,5,2,7,3,2,5,0.00,65.75,71.43
10,010,01,140,0002,0458,554,29,583,959,0,5,2,7,3,2,5,0.00,60.79,71.43
10,010,01,140,0002,0459,664,19,683,1135,0,5,2,7,3,2,5,0.00,60.18,71.43
10,010,01,140,0003,0460,458,14,472,731,0,5,2,7,3,2,5,0.00,64.57,71.43
10,010,01,140,0004,0461,521,10,531,796,0,5,2,7,3,2,5,0.00,66.71,71.43
10,010,01,140,0005,0462,762,24,786,1153,0,5,2,7,3,2,5,0.00,68.17,71.43
10,010,01,140,0006,0463,410,22,432,597,0,5,2,7,3,2,5,0.00,72.36,71.43
10,010,01,140,0007,0464,632,21,653,974,0,5,2,7,3,2,5,0.00,67.04,71.43
10,010,01,140,0008,0465,715,23,738,1247,0,5,2,7,3,2,5,0.00,59.18,71.43
10,010,01,140,0008,0466,735,23,758,1315,0,5,2,7,3,2,5,0.00,57.64,71.43
10,010,01,140,0008,0467,358,8,366,609,0,5,2,7,3,2,5,0.00,60.10,71.43
10,010,01,140,0008,0468,684,19,703,1313,0,5,2,7,3,2,5,0.00,53.54,71.43
10,010,01,140,0008,0469,273,7,280,544,0,5,2,7,3,2,5,0.00,51.47,71.43
10,010,01,150,0001,0000,1394,49,1443,2124,0,6,4,10,4,2,6,0.00,67.94,60.00
10,010,01,150,0002,0000,587,21,608,841,0,6,4,10,4,2,6,0.00,72.29,60.00
10,010,01,150,0003,0000,388,17,405,511,0,6,4,10,4,2,6,0.00,79.26,60.00
10,010,01,150,0004,0000,2867,62,2929,4199,0,6,4,10,4,2,6,0.00,69.75,60.00
10,010,01,150,0005,0000,275,10,285,382,0,6,4,10,4,2,6,0.00,74.61,60.00
10,010,01,150,0008,0000,413,11,424,551,0,6,4,10,4,2,6,0.00,76.95,60.00
10,010,01,150,0001,0238,583,25,608,926,0,6,4,10,4,2,6,0.00,65.66,60.00
10,010,01,150,0001,0239,811,24,835,1198,0,6,4,10,4,2,6,0.00,69.70,60.00
10,010,01,150,0002,0240,587,21,608,841,0,6,4,10,4,2,6,0.00,72.29,60.00
10,010,01,150,0004,0241,773,17,790,1119,0,6,4,10,4,2,6,0.00,70.60,60.00
10,010,01,150,0004,0242,663,15,678,972,0,6,4,10,4,2,6,0.00,69.75,60.00
10,010,01,150,0004,0243,819,14,833,1192,0,6,4,10,4,2,6,0.00,69.88,60.00
10,010,01,150,0004,0244,612,16,628,916,0,6,4,10,4,2,6,0.00,68.56,60.00
10,010,01,150,0003,0245,388,17,405,511,0,6,4,10,4,2,6,0.00,79.26,60.00
10,010,01,150,0005,0246,275,10,285,382,0,6,4,10,4,2,6,0.00,74.61,60.00
10,010,01,150,0008,0247,413,11,424,551,0,6,4,10,4,2,6,0.00,76.95,60.00
10,010,01,160,0001,0000,837,15,852,1138,0,6,2,8,5,2,7,0.00,74.87,87.50
10,010,01,160,0002,0000,321,8,329,433,0,6,2,8,5,2,7,0.00,75.98,87.50
10,010,01,160,0003,0000,894,8,902,1242,0,6,2,8,5,2,7,0.00,72.62,87.50
10,010,01,160,0004,0000,1305,29,1334,1710,0,6,2,8,5,2,7,0.00,78.01,87.50
10,010,01,160,0005,0000,607,8,615,799,0,6,2,8,5,2,7,0.00,76.97,87.50
10,010,01,160,0006,0000,688,9,697,840,0,6,2,8,5,2,7,0.00,82.98,87.50
10,010,01,160,0001,0494,837,15,852,1138,0,6,2,8,5,2,7,0.00,74.87,87.50
10,010,01,160,0002,0495,321,8,329,433,0,6,2,8,5,2,7,0.00,75.98,87.50
10,010,01,160,0003,0496,547,6,553,737,0,6,2,8,5,2,7,0.00,75.03,87.50
10,010,01,160,0003,0497,347,2,349,505,0,6,2,8,5,2,7,0.00,69.11,87.50
10,010,01,160,0004,0498,689,15,704,899,0,6,2,8,5,2,7,0.00,78.31,87.50
10,010,01,160,0004,0499,616,14,630,811,0,6,2,8,5,2,7,0.00,77.68,87.50
10,010,01,160,0005,0500,607,8,615,799,0,6,2,8,5,2,7,0.00,76.97,87.50
10,010,01,160,0006,0501,688,9,697,840,0,6,2,8,5,2,7,0.00,82.98,87.50
10,010,01,170,0001,0000,1003,22,1025,1431,0,3,2,5,2,2,4,0.00,71.63,80.00
10,010,01,170,0002,0000,464,13,477,626,0,3,2,5,2,2,4,0.00,76.20,80.00
10,010,01,170,0003,0000,314,2,316,397,0,3,2,5,2,2,4,0.00,79.60,80.00
10,010,01,170,0001,0510,469,12,481,714,0,3,2,5,2,2,4,0.00,67.37,80.00
10,010,01,170,0001,0511,534,10,544,717,0,3,2,5,2,2,4,0.00,75.87,80.00
10,010,01,170,0002,0512,235,11,246,322,0,3,2,5,2,2,4,0.00,76.40,80.00
10,010,01,170,0002,0513,229,2,231,304,0,3,2,5,2,2,4,0.00,75.99,80.00
10,010,01,170,0003,0514,122,2,124,168,0,3,2,5,2,2,4,0.00,73.81,80.00
10,010,01,170,0003,0515,192,0,192,229,0,3,2,5,2,2,4,0.00,83.84,80.00
10,010,01,180,0001,0000,174,3,177,352,0,2,0,2,2,0,2,0.00,50.28,100.00
10,010,01,180,0002,0000,79,6,85,168,0,2,0,2,2,0,2,0.00,50.60,100.00
10,010,01,180,0003,0000,61,3,64,126,0,2,0,2,2,0,2,0.00,50.79,100.00
10,010,01,180,0004,0000,144,7,151,301,0,2,0,2,2,0,2,0.00,50.17,100.00
10,010,01,180,0006,0000,179,3,182,287,0,2,0,2,2,0,2,0.00,63.41,100.00
10,010,01,180,0001,0520,174,3,177,352,0,2,0,2,2,0,2,0.00,50.28,100.00
10,010,01,180,0002,0521,79,6,85,168,0,2,0,2,2,0,2,0.00,50.60,100.00
10,010,01,180,0003,0522,61,3,64,126,0,2,0,2,2,0,2,0.00,50.79,100.00
10,010,01,180,0004,0523,117,3,120,225,0,2,0,2,2,0,2,0.00,53.33,100.00
10,010,01,180,0004,0524,27,4,31,76,0,2,0,2,2,0,2,0.00,40.79,100.00
10,010,01,180,0006,0525,179,3,182,287,0,2,0,2,2,0,2,0.00,63.41,100.00
10,010,00,020,0000,0000,22176,916,23092,33753,40858,18,4,22,8,3,11,82.61,68.41,50.00
10,010,01,020,0000,0000,10205,331,10536,15638,19028,7,2,9,3,2,5,82.18,67.37,55.56
10,010,02,020,0000,0000,7400,319,7719,11407,14152,8,2,10,3,1,4,80.60,67.67,40.00
10,010,03,020,0000,0000,4571,266,4837,6708,7678,3,0,3,2,0,2,87.37,72.11,66.67
10,010,02,010,0009,0018,437,16,453,615,0,2,0,2,1,0,1,0.00,73.66,50.00
10,010,02,010,0009,0019,418,11,429,594,0,2,0,2,1,0,1,0.00,72.22,50.00
10,010,02,010,0010,0020,527,12,539,790,0,2,0,2,1,0,1,0.00,68.23,50.00
10,010,02,010,0010,0021,574,25,599,921,0,2,0,2,1,0,1,0.00,65.04,50.00
10,010,02,010,0010,0022,473,17,490,781,0,2,0,2,1,0,1,0.00,62.74,50.00
10,010,02,010,0011,0023,307,4,311,457,0,2,0,2,1,0,1,0.00,68.05,50.00
10,010,02,010,0011,0024,138,7,145,229,0,2,0,2,1,0,1,0.00,63.32,50.00
10,010,02,010,0012,0025,235,5,240,283,0,2,0,2,1,0,1,0.00,84.81,50.00
10,010,02,010,0012,0026,209,5,214,242,0,2,0,2,1,0,1,0.00,88.43,50.00
10,010,02,010,0009,0000,855,27,882,1209,0,2,0,2,1,0,1,0.00,72.95,50.00
10,010,02,010,0010,0000,1574,54,1628,2492,0,2,0,2,1,0,1,0.00,65.33,50.00
10,010,02,010,0011,0000,445,11,456,686,0,2,0,2,1,0,1,0.00,66.47,50.00
10,010,02,010,0012,0000,444,10,454,525,0,2,0,2,1,0,1,0.00,86.48,50.00
10,010,02,020,0011,0000,520,19,539,648,0,8,2,10,3,1,4,0.00,83.18,40.00
10,010,02,020,0012,0000,435,19,454,584,0,8,2,10,3,1,4,0.00,77.74,40.00
10,010,02,020,0013,0000,576,19,595,750,0,8,2,10,3,1,4,0.00,79.33,40.00
10,010,02,020,0014,0000,684,23,707,984,0,8,2,10,3,1,4,0.00,71.85,40.00
10,010,02,020,0015,0000,942,51,993,1779,0,8,2,10,3,1,4,0.00,55.82,40.00
10,010,02,020,0016,0000,1963,81,2044,3093,0,8,2,10,3,1,4,0.00,66.08,40.00
10,010,02,020,0017,0000,1816,91,1907,2865,0,8,2,10,3,1,4,0.00,66.56,40.00
10,010,02,020,0018,0000,464,16,480,704,0,8,2,10,3,1,4,0.00,68.18,40.00
10,010,02,020,0011,0278,520,19,539,648,0,8,2,10,3,1,4,0.00,83.18,40.00
10,010,02,020,0012,0279,435,19,454,584,0,8,2,10,3,1,4,0.00,77.74,40.00
10,010,02,020,0013,0280,576,19,595,750,0,8,2,10,3,1,4,0.00,79.33,40.00
10,010,02,020,0014,0281,684,23,707,984,0,8,2,10,3,1,4,0.00,71.85,40.00
10,010,02,020,0015,0282,942,51,993,1779,0,8,2,10,3,1,4,0.00,55.82,40.00
10,010,02,020,0016,0283,853,39,892,1332,0,8,2,10,3,1,4,0.00,66.97,40.00
10,010,02,020,0016,0284,529,17,546,865,0,8,2,10,3,1,4,0.00,63.12,40.00
10,010,02,020,0016,0285,581,25,606,896,0,8,2,10,3,1,4,0.00,67.63,40.00
10,010,02,020,0017,0286,1030,28,1058,1529,0,8,2,10,3,1,4,0.00,69.20,40.00
10,010,02,020,0017,0287,786,63,849,1336,0,8,2,10,3,1,4,0.00,63.55,40.00
10,010,02,020,0018,0288,464,16,480,704,0,8,2,10,3,1,4,0.00,68.18,40.00
10,010,02,030,0019,0000,699,20,719,1072,0,4,0,4,2,0,2,0.00,67.07,50.00
10,010,02,030,0020,0000,812,15,827,1240,0,4,0,4,2,0,2,0.00,66.69,50.00
10,010,02,030,0021,0000,849,29,878,1308,0,4,0,4,2,0,2,0.00,67.13,50.00
10,010,02,030,0022,0000,437,19,456,528,0,4,0,4,2,0,2,0.00,86.36,50.00
10,010,02,030,0023,0000,461,22,483,607,0,4,0,4,2,0,2,0.00,79.57,50.00
10,010,02,030,0019,0366,699,20,719,1072,0,4,0,4,2,0,2,0.00,67.07,50.00
10,010,02,030,0021,0367,849,29,878,1308,0,4,0,4,2,0,2,0.00,67.13,50.00
10,010,02,030,0020,0368,812,15,827,1240,0,4,0,4,2,0,2,0.00,66.69,50.00
10,010,02,030,0022,0369,251,8,259,295,0,4,0,4,2,0,2,0.00,87.80,50.00
10,010,02,030,0022,0370,186,11,197,233,0,4,0,4,2,0,2,0.00,84.55,50.00
10,010,02,030,0023,0371,461,22,483,607,0,4,0,4,2,0,2,0.00,79.57,50.00
10,010,02,040,0011,0000,901,27,928,1471,0,6,2,8,3,2,5,0.00,63.09,62.50
10,010,02,040,0012,0000,931,33,964,1366,0,6,2,8,3,2,5,0.00,70.57,62.50
10,010,02,040,0013,0000,841,29,870,1273,0,6,2,8,3,2,5,0.00,68.34,62.50
10,010,02,040,0014,0000,538,17,555,756,0,6,2,8,3,2,5,0.00,73.41,62.50
10,010,02,040,0015,0000,988,31,1019,1466,0,6,2,8,3,2,5,0.00,69.51,62.50
10,010,02,040,0016,0000,1266,54,1320,1964,0,6,2,8,3,2,5,0.00,67.21,62.50
10,010,02,040,0017,0000,570,18,588,856,0,6,2,8,3,2,5,0.00,68.69,62.50
10,010,02,040,0018,0000,428,12,440,622,0,6,2,8,3,2,5,0.00,70.74,62.50
10,010,02,040,0019,0000,460,24,484,613,0,6,2,8,3,2,5,0.00,78.96,62.50
10,010,02,040,0020,0000,527,26,553,771,0,6,2,8,3,2,5,0.00,71.73,62.50
10,010,02,040,0011,0208,901,27,928,1471,0,6,2,8,3,2,5,0.00,63.09,62.50
10,010,02,040,0012,0209,931,33,964,1366,0,6,2,8,3,2,5,0.00,70.57,62.50
10,010,02,040,0021,0000,470,25,495,769,0,6,2,8,3,2,5,0.00,64.37,62.50
10,010,02,040,0013,0210,620,23,643,943,0,6,2,8,3,2,5,0.00,68.19,62.50
10,010,02,040,0013,0211,221,6,227,330,0,6,2,8,3,2,5,0.00,68.79,62.50
10,010,02,040,0014,0212,538,17,555,756,0,6,2,8,3,2,5,0.00,73.41,62.50
10,010,02,040,0015,0213,988,31,1019,1466,0,6,2,8,3,2,5,0.00,69.51,62.50
10,010,02,040,0016,0214,584,32,616,968,0,6,2,8,3,2,5,0.00,63.64,62.50
10,010,02,040,0016,0215,682,22,704,996,0,6,2,8,3,2,5,0.00,70.68,62.50
10,010,02,040,0017,0216,570,18,588,856,0,6,2,8,3,2,5,0.00,68.69,62.50
10,010,02,040,0018,0217,428,12,440,622,0,6,2,8,3,2,5,0.00,70.74,62.50
10,010,02,040,0019,0218,460,24,484,613,0,6,2,8,3,2,5,0.00,78.96,62.50
10,010,02,040,0020,0219,527,26,553,771,0,6,2,8,3,2,5,0.00,71.73,62.50
10,010,02,040,0021,0220,470,25,495,769,0,6,2,8,3,2,5,0.00,64.37,62.50
10,010,02,050,0012,0000,1309,66,1375,2112,0,8,3,11,4,2,6,0.00,65.10,54.55
10,010,02,050,0012,0124,1076,56,1132,1712,0,8,3,11,4,2,6,0.00,66.12,54.55
10,010,02,050,0012,0125,233,10,243,400,0,8,3,11,4,2,6,0.00,60.75,54.55
10,010,02,050,0013,0126,854,58,912,1291,0,8,3,11,4,2,6,0.00,70.64,54.55
10,010,02,050,0014,0127,350,31,381,490,0,8,3,11,4,2,6,0.00,77.76,54.55
10,010,02,050,0015,0128,807,54,861,1218,0,8,3,11,4,2,6,0.00,70.69,54.55
10,010,02,050,0022,0129,905,52,957,1429,0,8,3,11,4,2,6,0.00,66.97,54.55
10,010,02,050,0013,0000,854,58,912,1291,0,8,3,11,4,2,6,0.00,70.64,54.55
10,010,02,050,0022,0130,910,46,956,1579,0,8,3,11,4,2,6,0.00,60.54,54.55
10,010,02,050,0022,0131,457,17,474,714,0,8,3,11,4,2,6,0.00,66.39,54.55
10,010,02,050,0022,0132,735,47,782,1355,0,8,3,11,4,2,6,0.00,57.71,54.55
10,010,02,050,0023,0133,784,45,829,1177,0,8,3,11,4,2,6,0.00,70.43,54.55
10,010,02,050,0023,0134,728,55,783,1198,0,8,3,11,4,2,6,0.00,65.36,54.55
10,010,02,050,0028,0135,691,34,725,1254,0,8,3,11,4,2,6,0.00,57.81,54.55
10,010,02,050,0028,0136,722,27,749,1320,0,8,3,11,4,2,6,0.00,56.74,54.55
10,010,02,050,0028,0137,730,50,780,1328,0,8,3,11,4,2,6,0.00,58.73,54.55
10,010,02,050,0028,0138,722,37,759,1238,0,8,3,11,4,2,6,0.00,61.31,54.55
10,010,02,050,0028,0139,775,51,826,1285,0,8,3,11,4,2,6,0.00,64.28,54.55
10,010,02,050,0014,0000,350,31,381,490,0,8,3,11,4,2,6,0.00,77.76,54.55
10,010,02,050,0024,0140,566,32,598,974,0,8,3,11,4,2,6,0.00,61.40,54.55
10,010,02,050,0024,0141,778,39,817,1296,0,8,3,11,4,2,6,0.00,63.04,54.55
10,010,02,050,0025,0142,1008,64,1072,1600,0,8,3,11,4,2,6,0.00,67.00,54.55
10,010,02,050,0025,0143,599,26,625,945,0,8,3,11,4,2,6,0.00,66.14,54.55
10,010,02,050,0026,0144,616,42,658,1015,0,8,3,11,4,2,6,0.00,64.83,54.55
10,010,02,050,0026,0145,364,17,381,626,0,8,3,11,4,2,6,0.00,60.86,54.55
10,010,02,050,0015,0000,807,54,861,1218,0,8,3,11,4,2,6,0.00,70.69,54.55
10,010,02,050,0022,0000,3007,162,3169,5077,0,8,3,11,4,2,6,0.00,62.42,54.55
10,010,02,050,0023,0000,1512,100,1612,2375,0,8,3,11,4,2,6,0.00,67.87,54.55
10,010,02,050,0024,0000,1344,71,1415,2270,0,8,3,11,4,2,6,0.00,62.33,54.55
10,010,02,050,0025,0000,1607,90,1697,2545,0,8,3,11,4,2,6,0.00,66.68,54.55
10,010,02,050,0026,0000,980,59,1039,1641,0,8,3,11,4,2,6,0.00,63.32,54.55
10,010,02,050,0028,0000,3640,199,3839,6425,0,8,3,11,4,2,6,0.00,59.75,54.55
10,010,02,060,0004,0000,555,19,574,913,0,4,2,6,3,2,5,0.00,62.87,83.33
10,010,02,060,0005,0000,390,17,407,629,0,4,2,6,3,2,5,0.00,64.71,83.33
10,010,02,060,0006,0000,494,9,503,727,0,4,2,6,3,2,5,0.00,69.19,83.33
10,010,02,060,0007,0000,444,14,458,753,0,4,2,6,3,2,5,0.00,60.82,83.33
10,010,02,060,0008,0000,717,22,739,1081,0,4,2,6,3,2,5,0.00,68.36,83.33
10,010,02,060,0009,0000,609,10,619,930,0,4,2,6,3,2,5,0.00,66.56,83.33
10,010,02,060,0010,0000,536,19,555,861,0,4,2,6,3,2,5,0.00,64.46,83.33
10,010,02,060,0006,0230,494,9,503,727,0,4,2,6,3,2,5,0.00,69.19,83.33
10,010,02,060,0007,0231,444,14,458,753,0,4,2,6,3,2,5,0.00,60.82,83.33
10,010,02,060,0008,0232,717,22,739,1081,0,4,2,6,3,2,5,0.00,68.36,83.33
10,010,02,060,0009,0233,609,10,619,930,0,4,2,6,3,2,5,0.00,66.56,83.33
10,010,02,060,0010,0234,331,10,341,514,0,4,2,6,3,2,5,0.00,66.34,83.33
10,010,02,060,0010,0235,205,9,214,347,0,4,2,6,3,2,5,0.00,61.67,83.33
10,010,02,060,0005,0236,390,17,407,629,0,4,2,6,3,2,5,0.00,64.71,83.33
10,010,02,060,0004,0237,555,19,574,913,0,4,2,6,3,2,5,0.00,62.87,83.33
10,010,02,070,0013,0000,1165,42,1207,1572,0,6,2,8,3,2,5,0.00,76.78,62.50
10,010,02,070,0014,0000,1020,39,1059,1458,0,6,2,8,3,2,5,0.00,72.63,62.50
10,010,02,070,0015,0000,881,39,920,1242,0,6,2,8,3,2,5,0.00,74.07,62.50
10,010,02,070,0016,0000,1059,57,1116,1431,0,6,2,8,3,2,5,0.00,77.99,62.50
10,010,02,070,0017,0000,699,29,728,977,0,6,2,8,3,2,5,0.00,74.51,62.50
10,010,02,070,0013,0179,564,16,580,749,0,6,2,8,3,2,5,0.00,77.44,62.50
10,010,02,070,0018,0000,610,23,633,902,0,6,2,8,3,2,5,0.00,70.18,62.50
10,010,02,070,0013,0180,601,26,627,823,0,6,2,8,3,2,5,0.00,76.18,62.50
10,010,02,070,0014,0181,511,19,530,749,0,6,2,8,3,2,5,0.00,70.76,62.50
10,010,02,070,0014,0182,509,20,529,709,0,6,2,8,3,2,5,0.00,74.61,62.50
10,010,02,070,0015,0183,424,24,448,596,0,6,2,8,3,2,5,0.00,75.17,62.50
10,010,02,070,0015,0184,457,15,472,646,0,6,2,8,3,2,5,0.00,73.07,62.50
10,010,02,070,0018,0185,610,23,633,902,0,6,2,8,3,2,5,0.00,70.18,62.50
10,010,02,070,0017,0186,699,29,728,977,0,6,2,8,3,2,5,0.00,74.51,62.50
10,010,02,070,0016,0187,403,24,427,576,0,6,2,8,3,2,5,0.00,74.13,62.50
10,010,02,070,0016,0188,656,33,689,855,0,6,2,8,3,2,5,0.00,80.58,62.50
10,010,02,070,0019,0189,679,36,715,941,0,6,2,8,3,2,5,0.00,75.98,62.50
10,010,02,070,0019,0000,679,36,715,941,0,6,2,8,3,2,5,0.00,75.98,62.50
10,010,02,070,0020,0190,771,27,798,1073,0,6,2,8,3,2,5,0.00,74.37,62.50
10,010,02,070,0021,0191,705,40,745,984,0,6,2,8,3,2,5,0.00,75.71,62.50
10,010,02,070,0022,0192,353,14,367,519,0,6,2,8,3,2,5,0.00,70.71,62.50
10,010,02,070,0023,0193,638,21,659,834,0,6,2,8,3,2,5,0.00,79.02,62.50
10,010,02,070,0020,0000,771,27,798,1073,0,6,2,8,3,2,5,0.00,74.37,62.50
10,010,02,070,0021,0000,705,40,745,984,0,6,2,8,3,2,5,0.00,75.71,62.50
10,010,02,070,0022,0000,353,14,367,519,0,6,2,8,3,2,5,0.00,70.71,62.50
10,010,02,070,0023,0000,638,21,659,834,0,6,2,8,3,2,5,0.00,79.02,62.50
10,010,02,080,0010,0000,441,22,463,655,0,6,2,8,2,2,4,0.00,70.69,50.00
10,010,02,080,0011,0000,710,26,736,944,0,6,2,8,2,2,4,0.00,77.97,50.00
10,010,02,080,0012,0000,549,16,565,846,0,6,2,8,2,2,4,0.00,66.78,50.00
10,010,02,080,0013,0000,619,31,650,979,0,6,2,8,2,2,4,0.00,66.39,50.00
10,010,02,080,0014,0000,878,36,914,1381,0,6,2,8,2,2,4,0.00,66.18,50.00
10,010,02,080,0015,0000,422,7,429,564,0,6,2,8,2,2,4,0.00,76.06,50.00
10,010,02,080,0016,0000,325,12,337,444,0,6,2,8,2,2,4,0.00,75.90,50.00
10,010,02,080,0017,0000,385,16,401,579,0,6,2,8,2,2,4,0.00,69.26,50.00
10,010,02,080,0010,0313,441,22,463,655,0,6,2,8,2,2,4,0.00,70.69,50.00
10,010,02,080,0011,0314,710,26,736,944,0,6,2,8,2,2,4,0.00,77.97,50.00
10,010,02,080,0012,0315,549,16,565,846,0,6,2,8,2,2,4,0.00,66.78,50.00
10,010,02,080,0013,0316,619,31,650,979,0,6,2,8,2,2,4,0.00,66.39,50.00
10,010,02,080,0014,0317,878,36,914,1381,0,6,2,8,2,2,4,0.00,66.18,50.00
10,010,02,080,0015,0318,422,7,429,564,0,6,2,8,2,2,4,0.00,76.06,50.00
10,010,02,080,0016,0319,325,12,337,444,0,6,2,8,2,2,4,0.00,75.90,50.00
10,010,02,080,0017,0320,385,16,401,579,0,6,2,8,2,2,4,0.00,69.26,50.00
10,010,02,090,0005,0000,694,40,734,1090,0,2,2,4,2,2,4,0.00,67.34,100.00
10,010,02,090,0006,0000,531,17,548,695,0,2,2,4,2,2,4,0.00,78.85,100.00
10,010,02,090,0007,0000,245,38,283,370,0,2,2,4,2,2,4,0.00,76.49,100.00
10,010,02,090,0008,0000,527,36,563,823,0,2,2,4,2,2,4,0.00,68.41,100.00
10,010,02,090,0009,0000,568,41,609,846,0,2,2,4,2,2,4,0.00,71.99,100.00
10,010,02,090,0010,0000,425,38,463,683,0,2,2,4,2,2,4,0.00,67.79,100.00
10,010,02,090,0011,0000,309,24,333,382,0,2,2,4,2,2,4,0.00,87.17,100.00
10,010,02,090,0012,0000,583,68,651,942,0,2,2,4,2,2,4,0.00,69.11,100.00
10,010,02,090,0022,0000,142,20,162,278,0,2,2,4,2,2,4,0.00,58.27,100.00
10,010,02,090,0023,0000,799,48,847,1188,0,2,2,4,2,2,4,0.00,71.30,100.00
10,010,02,090,0005,0332,694,40,734,1090,0,2,2,4,2,2,4,0.00,67.34,100.00
10,010,02,090,0006,0333,531,17,548,695,0,2,2,4,2,2,4,0.00,78.85,100.00
10,010,02,090,0007,0334,245,38,283,370,0,2,2,4,2,2,4,0.00,76.49,100.00
10,010,02,090,0008,0335,527,36,563,823,0,2,2,4,2,2,4,0.00,68.41,100.00
10,010,02,090,0009,0336,568,41,609,846,0,2,2,4,2,2,4,0.00,71.99,100.00
10,010,02,090,0010,0337,425,38,463,683,0,2,2,4,2,2,4,0.00,67.79,100.00
10,010,02,090,0011,0338,118,7,125,156,0,2,2,4,2,2,4,0.00,80.13,100.00
10,010,02,090,0011,0339,191,17,208,226,0,2,2,4,2,2,4,0.00,92.04,100.00
10,010,02,090,0012,0340,583,68,651,942,0,2,2,4,2,2,4,0.00,69.11,100.00
10,010,02,090,0022,0341,142,20,162,278,0,2,2,4,2,2,4,0.00,58.27,100.00
10,010,02,090,0023,0342,644,44,688,972,0,2,2,4,2,2,4,0.00,70.78,100.00
10,010,02,090,0023,0343,155,4,159,216,0,2,2,4,2,2,4,0.00,73.61,100.00
10,010,02,100,0010,0000,324,16,340,404,0,5,2,7,4,2,6,0.00,84.16,85.71
10,010,02,100,0011,0000,249,25,274,400,0,5,2,7,4,2,6,0.00,68.50,85.71
10,010,02,100,0012,0000,330,20,350,558,0,5,2,7,4,2,6,0.00,62.72,85.71
10,010,02,100,0013,0000,906,36,942,1391,0,5,2,7,4,2,6,0.00,67.72,85.71
10,010,02,100,0014,0000,585,12,597,795,0,5,2,7,4,2,6,0.00,75.09,85.71
10,010,02,100,0015,0000,553,33,586,779,0,5,2,7,4,2,6,0.00,75.22,85.71
10,010,02,100,0016,0000,518,15,533,764,0,5,2,7,4,2,6,0.00,69.76,85.71
10,010,02,100,0017,0000,292,20,312,401,0,5,2,7,4,2,6,0.00,77.81,85.71
10,010,02,100,0018,0000,359,17,376,501,0,5,2,7,4,2,6,0.00,75.05,85.71
10,010,02,100,0019,0000,486,15,501,675,0,5,2,7,4,2,6,0.00,74.22,85.71
10,010,02,100,0020,0000,274,10,284,367,0,5,2,7,4,2,6,0.00,77.38,85.71
10,010,02,100,0021,0000,410,19,429,530,0,5,2,7,4,2,6,0.00,80.94,85.71
10,010,02,100,0022,0000,462,9,471,607,0,5,2,7,4,2,6,0.00,77.59,85.71
10,010,02,100,0010,0396,324,16,340,404,0,5,2,7,4,2,6,0.00,84.16,85.71
10,010,02,100,0011,0397,249,25,274,400,0,5,2,7,4,2,6,0.00,68.50,85.71
10,010,02,100,0012,0398,330,20,350,558,0,5,2,7,4,2,6,0.00,62.72,85.71
10,010,02,100,0013,0399,334,12,346,513,0,5,2,7,4,2,6,0.00,67.45,85.71
10,010,02,100,0013,0400,572,24,596,878,0,5,2,7,4,2,6,0.00,67.88,85.71
10,010,02,100,0014,0401,585,12,597,795,0,5,2,7,4,2,6,0.00,75.09,85.71
10,010,02,100,0015,0402,553,33,586,779,0,5,2,7,4,2,6,0.00,75.22,85.71
10,010,02,100,0016,0403,518,15,533,764,0,5,2,7,4,2,6,0.00,69.76,85.71
10,010,02,100,0017,0404,292,20,312,401,0,5,2,7,4,2,6,0.00,77.81,85.71
10,010,02,100,0018,0405,359,17,376,501,0,5,2,7,4,2,6,0.00,75.05,85.71
10,010,02,100,0019,0406,403,14,417,548,0,5,2,7,4,2,6,0.00,76.09,85.71
10,010,02,100,0019,0407,83,1,84,127,0,5,2,7,4,2,6,0.00,66.14,85.71
10,010,02,100,0020,0408,274,10,284,367,0,5,2,7,4,2,6,0.00,77.38,85.71
10,010,02,100,0021,0409,410,19,429,530,0,5,2,7,4,2,6,0.00,80.94,85.71
10,010,02,100,0022,0410,374,7,381,491,0,5,2,7,4,2,6,0.00,77.60,85.71
10,010,02,100,0022,0411,88,2,90,116,0,5,2,7,4,2,6,0.00,77.59,85.71
10,010,02,110,0008,0050,474,15,489,771,0,4,3,7,3,1,4,0.00,63.42,57.14
10,010,02,110,0009,0051,629,19,648,965,0,4,3,7,3,1,4,0.00,67.15,57.14
10,010,02,110,0010,0052,607,18,625,892,0,4,3,7,3,1,4,0.00,70.07,57.14
10,010,02,110,0011,0053,524,16,540,889,0,4,3,7,3,1,4,0.00,60.74,57.14
10,010,02,110,0012,0054,502,14,516,626,0,4,3,7,3,1,4,0.00,82.43,57.14
10,010,02,110,0012,0055,176,4,180,237,0,4,3,7,3,1,4,0.00,75.95,57.14
10,010,02,110,0008,0000,474,15,489,771,0,4,3,7,3,1,4,0.00,63.42,57.14
10,010,02,110,0009,0000,629,19,648,965,0,4,3,7,3,1,4,0.00,67.15,57.14
10,010,02,110,0010,0000,607,18,625,892,0,4,3,7,3,1,4,0.00,70.07,57.14
10,010,02,110,0011,0000,524,16,540,889,0,4,3,7,3,1,4,0.00,60.74,57.14
10,010,02,110,0012,0000,678,18,696,863,0,4,3,7,3,1,4,0.00,80.65,57.14
10,010,02,120,0003,0000,1168,37,1205,1581,0,5,0,5,3,0,3,0.00,76.22,60.00
10,010,02,120,0004,0000,1331,50,1381,1986,0,5,0,5,3,0,3,0.00,69.54,60.00
10,010,02,120,0005,0000,472,21,493,761,0,5,0,5,3,0,3,0.00,64.78,60.00
10,010,02,120,0003,0075,447,19,466,606,0,5,0,5,3,0,3,0.00,76.90,60.00
10,010,02,120,0003,0076,471,10,481,626,0,5,0,5,3,0,3,0.00,76.84,60.00
10,010,02,120,0003,0077,250,8,258,349,0,5,0,5,3,0,3,0.00,73.93,60.00
10,010,02,120,0004,0078,674,27,701,995,0,5,0,5,3,0,3,0.00,70.45,60.00
10,010,02,120,0004,0079,657,23,680,991,0,5,0,5,3,0,3,0.00,68.62,60.00
10,010,02,120,0005,0080,472,21,493,761,0,5,0,5,3,0,3,0.00,64.78,60.00
10,010,02,120,0013,0081,652,21,673,1009,0,5,0,5,3,0,3,0.00,66.70,60.00
10,010,02,120,0013,0082,539,25,564,846,0,5,0,5,3,0,3,0.00,66.67,60.00
10,010,02,120,0014,0083,671,32,703,1000,0,5,0,5,3,0,3,0.00,70.30,60.00
10,010,02,120,0010,0084,342,22,364,601,0,5,0,5,3,0,3,0.00,60.57,60.00
10,010,02,120,0011,0085,273,11,284,365,0,5,0,5,3,0,3,0.00,77.81,60.00
10,010,02,120,0012,0086,498,18,516,717,0,5,0,5,3,0,3,0.00,71.97,60.00
10,010,02,120,0012,0087,340,15,355,561,0,5,0,5,3,0,3,0.00,63.28,60.00
10,010,02,120,0010,0000,342,22,364,601,0,5,0,5,3,0,3,0.00,60.57,60.00
10,010,02,120,0011,0000,273,11,284,365,0,5,0,5,3,0,3,0.00,77.81,60.00
10,010,02,120,0012,0000,838,33,871,1278,0,5,0,5,3,0,3,0.00,68.15,60.00
10,010,02,120,0013,0000,1191,46,1237,1855,0,5,0,5,3,0,3,0.00,66.68,60.00
10,010,02,120,0014,0000,671,32,703,1000,0,5,0,5,3,0,3,0.00,70.30,60.00
10,010,02,130,0001,0000,903,42,945,1720,0,4,1,5,2,1,3,0.00,54.94,60.00
10,010,02,130,0002,0000,531,31,562,898,0,4,1,5,2,1,3,0.00,62.58,60.00
10,010,02,130,0005,0000,831,62,893,1428,0,4,1,5,2,1,3,0.00,62.54,60.00
10,010,02,130,0010,0000,1085,29,1114,1758,0,4,1,5,2,1,3,0.00,63.37,60.00
10,010,02,130,0011,0000,884,35,919,1440,0,4,1,5,2,1,3,0.00,63.82,60.00
10,010,02,130,0012,0000,1165,37,1202,2019,0,4,1,5,2,1,3,0.00,59.53,60.00
10,010,02,130,0013,0000,633,15,648,982,0,4,1,5,2,1,3,0.00,65.99,60.00
10,010,02,130,0001,0429,346,9,355,636,0,4,1,5,2,1,3,0.00,55.82,60.00
10,010,02,130,0001,0430,557,33,590,1084,0,4,1,5,2,1,3,0.00,54.43,60.00
10,010,02,130,0002,0431,531,31,562,898,0,4,1,5,2,1,3,0.00,62.58,60.00
10,010,02,130,0005,0432,436,43,479,737,0,4,1,5,2,1,3,0.00,64.99,60.00
10,010,02,130,0005,0433,395,19,414,691,0,4,1,5,2,1,3,0.00,59.91,60.00
10,010,02,130,0010,0434,460,12,472,740,0,4,1,5,2,1,3,0.00,63.78,60.00
10,010,02,130,0010,0435,625,17,642,1018,0,4,1,5,2,1,3,0.00,63.06,60.00
10,010,02,130,0011,0436,346,7,353,562,0,4,1,5,2,1,3,0.00,62.81,60.00
10,010,02,130,0011,0437,538,28,566,878,0,4,1,5,2,1,3,0.00,64.46,60.00
10,010,02,130,0012,0438,224,8,232,402,0,4,1,5,2,1,3,0.00,57.71,60.00
10,010,02,130,0012,0439,432,14,446,749,0,4,1,5,2,1,3,0.00,59.55,60.00
10,010,02,130,0012,0440,509,15,524,868,0,4,1,5,2,1,3,0.00,60.37,60.00
10,010,02,130,0013,0441,633,15,648,982,0,4,1,5,2,1,3,0.00,65.99,60.00
10,010,02,140,0009,0000,851,61,912,1347,0,4,3,7,2,1,3,0.00,67.71,42.86
10,010,02,140,0010,0000,893,33,926,1319,0,4,3,7,2,1,3,0.00,70.20,42.86
10,010,02,140,0011,0000,1022,38,1060,1502,0,4,3,7,2,1,3,0.00,70.57,42.86
10,010,02,140,0012,0000,1068,39,1107,1674,0,4,3,7,2,1,3,0.00,66.13,42.86
10,010,02,140,0013,0000,417,25,442,578,0,4,3,7,2,1,3,0.00,76.47,42.86
10,010,02,140,0014,0000,634,24,658,956,0,4,3,7,2,1,3,0.00,68.83,42.86
10,010,02,140,0015,0000,521,19,540,811,0,4,3,7,2,1,3,0.00,66.58,42.86
10,010,02,140,0016,0000,476,28,504,615,0,4,3,7,2,1,3,0.00,81.95,42.86
10,010,02,140,0009,0470,851,61,912,1347,0,4,3,7,2,1,3,0.00,67.71,42.86
10,010,02,140,0010,0471,893,33,926,1319,0,4,3,7,2,1,3,0.00,70.20,42.86
10,010,02,140,0011,0472,1022,38,1060,1502,0,4,3,7,2,1,3,0.00,70.57,42.86
10,010,02,140,0012,0473,464,15,479,745,0,4,3,7,2,1,3,0.00,64.30,42.86
10,010,02,140,0012,0474,604,24,628,929,0,4,3,7,2,1,3,0.00,67.60,42.86
10,010,02,140,0014,0475,218,2,220,318,0,4,3,7,2,1,3,0.00,69.18,42.86
10,010,02,140,0014,0476,416,22,438,638,0,4,3,7,2,1,3,0.00,68.65,42.86
10,010,02,140,0013,0477,417,25,442,578,0,4,3,7,2,1,3,0.00,76.47,42.86
10,010,02,140,0015,0478,300,13,313,442,0,4,3,7,2,1,3,0.00,70.81,42.86
10,010,02,140,0015,0479,221,6,227,369,0,4,3,7,2,1,3,0.00,61.52,42.86
10,010,02,140,0016,0480,476,28,504,615,0,4,3,7,2,1,3,0.00,81.95,42.86
10,010,02,150,0006,0000,344,8,352,466,0,3,1,4,2,0,2,0.00,75.54,50.00
10,010,02,150,0007,0000,251,6,257,333,0,3,1,4,2,0,2,0.00,77.18,50.00
10,010,02,150,0009,0000,1177,10,1187,1538,0,3,1,4,2,0,2,0.00,77.18,50.00
10,010,02,150,0010,0000,421,7,428,520,0,3,1,4,2,0,2,0.00,82.31,50.00
10,010,02,150,0011,0000,545,19,564,780,0,3,1,4,2,0,2,0.00,72.31,50.00
10,010,02,150,0010,0248,421,7,428,520,0,3,1,4,2,0,2,0.00,82.31,50.00
10,010,02,150,0009,0249,627,6,633,813,0,3,1,4,2,0,2,0.00,77.86,50.00
10,010,02,150,0009,0250,550,4,554,725,0,3,1,4,2,0,2,0.00,76.41,50.00
10,010,02,150,0011,0251,545,19,564,780,0,3,1,4,2,0,2,0.00,72.31,50.00
10,010,02,150,0006,0252,344,8,352,466,0,3,1,4,2,0,2,0.00,75.54,50.00
10,010,02,150,0007,0253,251,6,257,333,0,3,1,4,2,0,2,0.00,77.18,50.00
10,010,02,160,0007,0000,739,30,769,1187,0,2,3,5,2,2,4,0.00,64.79,80.00
10,010,02,160,0008,0000,476,11,487,599,0,2,3,5,2,2,4,0.00,81.30,80.00
10,010,02,160,0009,0000,583,17,600,911,0,2,3,5,2,2,4,0.00,65.86,80.00
10,010,02,160,0010,0000,292,13,305,475,0,2,3,5,2,2,4,0.00,64.21,80.00
10,010,02,160,0011,0000,281,4,285,348,0,2,3,5,2,2,4,0.00,81.90,80.00
10,010,02,160,0007,0502,398,13,411,766,0,2,3,5,2,2,4,0.00,53.66,80.00
10,010,02,160,0007,0503,341,17,358,421,0,2,3,5,2,2,4,0.00,85.04,80.00
10,010,02,160,0008,0504,476,11,487,599,0,2,3,5,2,2,4,0.00,81.30,80.00
10,010,02,160,0009,0505,185,7,192,290,0,2,3,5,2,2,4,0.00,66.21,80.00
10,010,02,160,0009,0506,398,10,408,621,0,2,3,5,2,2,4,0.00,65.70,80.00
10,010,02,160,0010,0507,292,13,305,475,0,2,3,5,2,2,4,0.00,64.21,80.00
10,010,02,160,0011,0508,122,0,122,152,0,2,3,5,2,2,4,0.00,80.26,80.00
10,010,02,160,0011,0509,159,4,163,196,0,2,3,5,2,2,4,0.00,83.16,80.00
10,010,02,170,0004,0000,684,15,699,897,0,4,0,4,3,0,3,0.00,77.93,75.00
10,010,02,170,0005,0000,405,6,411,547,0,4,0,4,3,0,3,0.00,75.14,75.00
10,010,02,170,0004,0516,348,9,357,474,0,4,0,4,3,0,3,0.00,75.32,75.00
10,010,02,170,0004,0517,140,3,143,183,0,4,0,4,3,0,3,0.00,78.14,75.00
10,010,02,170,0004,0518,196,3,199,240,0,4,0,4,3,0,3,0.00,82.92,75.00
10,010,02,170,0005,0519,405,6,411,547,0,4,0,4,3,0,3,0.00,75.14,75.00
10,010,02,180,0005,0000,200,1,201,292,0,5,0,5,3,0,3,0.00,68.84,60.00
10,010,02,180,0007,0000,491,13,504,802,0,5,0,5,3,0,3,0.00,62.84,60.00
10,010,02,180,0008,0000,643,13,656,918,0,5,0,5,3,0,3,0.00,71.46,60.00
10,010,02,180,0005,0526,200,1,201,292,0,5,0,5,3,0,3,0.00,68.84,60.00
10,010,02,180,0008,0527,643,13,656,918,0,5,0,5,3,0,3,0.00,71.46,60.00
10,010,02,180,0007,0528,491,13,504,802,0,5,0,5,3,0,3,0.00,62.84,60.00
10,010,00,030,0000,0000,14558,458,15016,22313,25130,10,5,15,8,3,11,88.79,67.30,73.33
10,010,01,030,0000,0000,5451,169,5620,8375,9507,2,3,5,2,2,4,88.09,67.10,80.00
10,010,02,030,0000,0000,3258,105,3363,4755,5281,4,0,4,2,0,2,90.04,70.73,50.00
10,010,03,030,0000,0000,5849,184,6033,9183,10342,4,2,6,4,1,5,88.79,65.70,83.33
10,010,03,010,0013,0027,723,18,741,1056,0,6,2,8,3,2,5,0.00,70.17,62.50
10,010,03,010,0013,0028,503,15,518,802,0,6,2,8,3,2,5,0.00,64.59,62.50
10,010,03,010,0013,0029,603,21,624,982,0,6,2,8,3,2,5,0.00,63.54,62.50
10,010,03,010,0013,0030,417,11,428,592,0,6,2,8,3,2,5,0.00,72.30,62.50
10,010,03,010,0014,0031,522,19,541,912,0,6,2,8,3,2,5,0.00,59.32,62.50
10,010,03,010,0014,0032,573,15,588,871,0,6,2,8,3,2,5,0.00,67.51,62.50
10,010,03,010,0014,0033,521,13,534,905,0,6,2,8,3,2,5,0.00,59.01,62.50
10,010,03,010,0014,0034,598,20,618,967,0,6,2,8,3,2,5,0.00,63.91,62.50
10,010,03,010,0014,0035,590,18,608,870,0,6,2,8,3,2,5,0.00,69.89,62.50
10,010,03,010,0015,0036,581,11,592,796,0,6,2,8,3,2,5,0.00,74.37,62.50
10,010,03,010,0015,0037,716,15,731,983,0,6,2,8,3,2,5,0.00,74.36,62.50
10,010,03,010,0016,0038,807,23,830,1149,0,6,2,8,3,2,5,0.00,72.24,62.50
10,010,03,010,0016,0039,744,11,755,1114,0,6,2,8,3,2,5,0.00,67.77,62.50
10,010,03,010,0016,0040,488,17,505,756,0,6,2,8,3,2,5,0.00,66.80,62.50
10,010,03,010,0017,0041,488,12,500,648,0,6,2,8,3,2,5,0.00,77.16,62.50
10,010,03,010,0013,0000,2246,65,2311,3432,0,6,2,8,3,2,5,0.00,67.34,62.50
10,010,03,010,0014,0000,2804,85,2889,4525,0,6,2,8,3,2,5,0.00,63.85,62.50
10,010,03,010,0015,0000,1297,26,1323,1779,0,6,2,8,3,2,5,0.00,74.37,62.50
10,010,03,010,0016,0000,2039,51,2090,3019,0,6,2,8,3,2,5,0.00,69.23,62.50
10,010,03,010,0017,0000,488,12,500,648,0,6,2,8,3,2,5,0.00,77.16,62.50
10,010,03,020,0019,0000,712,74,786,1016,0,3,0,3,2,0,2,0.00,77.36,66.67
10,010,03,020,0020,0000,578,22,600,832,0,3,0,3,2,0,2,0.00,72.12,66.67
10,010,03,020,0021,0000,160,9,169,226,0,3,0,3,2,0,2,0.00,74.78,66.67
10,010,03,020,0022,0000,474,29,503,681,0,3,0,3,2,0,2,0.00,73.86,66.67
10,010,03,020,0023,0000,508,23,531,724,0,3,0,3,2,0,2,0.00,73.34,66.67
10,010,03,020,0024,0000,465,17,482,644,0,3,0,3,2,0,2,0.00,74.84,66.67
10,010,03,020,0025,0000,596,29,625,963,0,3,0,3,2,0,2,0.00,64.90,66.67
10,010,03,020,0026,0000,758,42,800,1161,0,3,0,3,2,0,2,0.00,68.91,66.67
10,010,03,020,0027,0000,320,21,341,461,0,3,0,3,2,0,2,0.00,73.97,66.67
10,010,03,020,0019,0289,712,74,786,1016,0,3,0,3,2,0,2,0.00,77.36,66.67
10,010,03,020,0020,0290,578,22,600,832,0,3,0,3,2,0,2,0.00,72.12,66.67
10,010,03,020,0022,0291,474,29,503,681,0,3,0,3,2,0,2,0.00,73.86,66.67
10,010,03,020,0021,0292,160,9,169,226,0,3,0,3,2,0,2,0.00,74.78,66.67
10,010,03,020,0023,0293,508,23,531,724,0,3,0,3,2,0,2,0.00,73.34,66.67
10,010,03,020,0024,0294,465,17,482,644,0,3,0,3,2,0,2,0.00,74.84,66.67
10,010,03,020,0025,0295,596,29,625,963,0,3,0,3,2,0,2,0.00,64.90,66.67
10,010,03,020,0026,0296,758,42,800,1161,0,3,0,3,2,0,2,0.00,68.91,66.67
10,010,03,020,0027,0297,320,21,341,461,0,3,0,3,2,0,2,0.00,73.97,66.67
10,010,03,030,0009,0000,570,17,587,876,0,4,2,6,4,1,5,0.00,67.01,83.33
10,010,03,030,0010,0000,853,27,880,1272,0,4,2,6,4,1,5,0.00,69.18,83.33
10,010,03,030,0011,0000,1326,27,1353,2211,0,4,2,6,4,1,5,0.00,61.19,83.33
10,010,03,030,0012,0000,782,29,811,1073,0,4,2,6,4,1,5,0.00,75.58,83.33
10,010,03,030,0013,0000,683,22,705,1054,0,4,2,6,4,1,5,0.00,66.89,83.33
10,010,03,030,0014,0000,1104,40,1144,1805,0,4,2,6,4,1,5,0.00,63.38,83.33
10,010,03,030,0015,0000,171,9,180,264,0,4,2,6,4,1,5,0.00,68.18,83.33
10,010,03,030,0016,0000,216,9,225,365,0,4,2,6,4,1,5,0.00,61.64,83.33
10,010,03,030,0017,0000,144,4,148,263,0,4,2,6,4,1,5,0.00,56.27,83.33
10,010,03,030,0013,0372,683,22,705,1054,0,4,2,6,4,1,5,0.00,66.89,83.33
10,010,03,030,0014,0373,575,20,595,903,0,4,2,6,4,1,5,0.00,65.89,83.33
10,010,03,030,0014,0374,529,20,549,902,0,4,2,6,4,1,5,0.00,60.86,83.33
10,010,03,030,0015,0375,171,9,180,264,0,4,2,6,4,1,5,0.00,68.18,83.33
10,010,03,030,0016,0376,216,9,225,365,0,4,2,6,4,1,5,0.00,61.64,83.33
10,010,03,030,0017,0377,58,2,60,110,0,4,2,6,4,1,5,0.00,54.55,83.33
10,010,03,030,0017,0378,86,2,88,153,0,4,2,6,4,1,5,0.00,57.52,83.33
10,010,03,030,0009,0379,570,17,587,876,0,4,2,6,4,1,5,0.00,67.01,83.33
10,010,03,030,0010,0380,853,27,880,1272,0,4,2,6,4,1,5,0.00,69.18,83.33
10,010,03,030,0011,0381,611,12,623,1033,0,4,2,6,4,1,5,0.00,60.31,83.33
10,010,03,030,0011,0382,715,15,730,1178,0,4,2,6,4,1,5,0.00,61.97,83.33
10,010,03,030,0012,0383,782,29,811,1073,0,4,2,6,4,1,5,0.00,75.58,83.33
10,010,03,050,0016,0146,519,33,552,902,0,4,1,5,2,1,3,0.00,61.20,60.00
10,010,03,050,0016,0147,564,31,595,835,0,4,1,5,2,1,3,0.00,71.26,60.00
10,010,03,050,0017,0148,751,60,811,1259,0,4,1,5,2,1,3,0.00,64.42,60.00
10,010,03,050,0017,0149,691,74,765,1385,0,4,1,5,2,1,3,0.00,55.23,60.00
10,010,03,050,0027,0150,779,61,840,1328,0,4,1,5,2,1,3,0.00,63.25,60.00
10,010,03,050,0027,0151,883,72,955,1530,0,4,1,5,2,1,3,0.00,62.42,60.00
10,010,03,050,0018,0152,628,48,676,906,0,4,1,5,2,1,3,0.00,74.61,60.00
10,010,03,050,0018,0153,615,35,650,1043,0,4,1,5,2,1,3,0.00,62.32,60.00
10,010,03,050,0019,0154,819,75,894,1341,0,4,1,5,2,1,3,0.00,66.67,60.00
10,010,03,050,0019,0155,616,49,665,1051,0,4,1,5,2,1,3,0.00,63.27,60.00
10,010,03,050,0020,0156,783,31,814,1187,0,4,1,5,2,1,3,0.00,68.58,60.00
10,010,03,050,0020,0157,764,28,792,1091,0,4,1,5,2,1,3,0.00,72.59,60.00
10,010,03,050,0020,0158,609,44,653,1096,0,4,1,5,2,1,3,0.00,59.58,60.00
10,010,03,050,0021,0159,744,67,811,1228,0,4,1,5,2,1,3,0.00,66.04,60.00
10,010,03,050,0016,0000,1083,64,1147,1737,0,4,1,5,2,1,3,0.00,66.03,60.00
10,010,03,050,0017,0000,1442,134,1576,2644,0,4,1,5,2,1,3,0.00,59.61,60.00
10,010,03,050,0018,0000,1243,83,1326,1949,0,4,1,5,2,1,3,0.00,68.03,60.00
10,010,03,050,0019,0000,1435,124,1559,2392,0,4,1,5,2,1,3,0.00,65.18,60.00
10,010,03,050,0020,0000,2156,103,2259,3374,0,4,1,5,2,1,3,0.00,66.95,60.00
10,010,03,050,0021,0000,744,67,811,1228,0,4,1,5,2,1,3,0.00,66.04,60.00
10,010,03,050,0027,0000,1662,133,1795,2858,0,4,1,5,2,1,3,0.00,62.81,60.00
10,010,03,080,0018,0000,527,16,543,812,0,3,0,3,2,0,2,0.00,66.87,66.67
10,010,03,080,0021,0000,429,36,465,704,0,3,0,3,2,0,2,0.00,66.05,66.67
10,010,03,080,0022,0000,341,19,360,499,0,3,0,3,2,0,2,0.00,72.14,66.67
10,010,03,080,0023,0000,454,13,467,592,0,3,0,3,2,0,2,0.00,78.89,66.67
10,010,03,080,0024,0000,461,23,484,628,0,3,0,3,2,0,2,0.00,77.07,66.67
10,010,03,080,0025,0000,340,19,359,543,0,3,0,3,2,0,2,0.00,66.11,66.67
10,010,03,080,0018,0321,527,16,543,812,0,3,0,3,2,0,2,0.00,66.87,66.67
10,010,03,080,0021,0322,429,36,465,704,0,3,0,3,2,0,2,0.00,66.05,66.67
10,010,03,080,0022,0323,341,19,360,499,0,3,0,3,2,0,2,0.00,72.14,66.67
10,010,03,080,0023,0324,454,13,467,592,0,3,0,3,2,0,2,0.00,78.89,66.67
10,010,03,080,0024,0325,461,23,484,628,0,3,0,3,2,0,2,0.00,77.07,66.67
10,010,03,080,0025,0326,270,16,286,425,0,3,0,3,2,0,2,0.00,67.29,66.67
10,010,03,080,0025,0327,70,3,73,118,0,3,0,3,2,0,2,0.00,61.86,66.67
10,010,03,090,0013,0000,834,22,856,1134,0,3,2,5,3,1,4,0.00,75.49,80.00
10,010,03,090,0014,0000,559,45,604,797,0,3,2,5,3,1,4,0.00,75.78,80.00
10,010,03,090,0015,0000,415,17,432,606,0,3,2,5,3,1,4,0.00,71.29,80.00
10,010,03,090,0016,0000,516,29,545,762,0,3,2,5,3,1,4,0.00,71.52,80.00
10,010,03,090,0017,0000,464,21,485,654,0,3,2,5,3,1,4,0.00,74.16,80.00
10,010,03,090,0018,0000,745,26,771,1047,0,3,2,5,3,1,4,0.00,73.64,80.00
10,010,03,090,0019,0000,695,30,725,876,0,3,2,5,3,1,4,0.00,82.76,80.00
10,010,03,090,0020,0000,708,36,744,1124,0,3,2,5,3,1,4,0.00,66.19,80.00
10,010,03,090,0021,0000,564,31,595,735,0,3,2,5,3,1,4,0.00,80.95,80.00
10,010,03,090,0013,0344,834,22,856,1134,0,3,2,5,3,1,4,0.00,75.49,80.00
10,010,03,090,0014,0345,559,45,604,797,0,3,2,5,3,1,4,0.00,75.78,80.00
10,010,03,090,0015,0346,415,17,432,606,0,3,2,5,3,1,4,0.00,71.29,80.00
10,010,03,090,0016,0347,516,29,545,762,0,3,2,5,3,1,4,0.00,71.52,80.00
10,010,03,090,0017,0348,275,11,286,359,0,3,2,5,3,1,4,0.00,79.67,80.00
10,010,03,090,0017,0349,189,10,199,295,0,3,2,5,3,1,4,0.00,67.46,80.00
10,010,03,090,0018,0350,745,26,771,1047,0,3,2,5,3,1,4,0.00,73.64,80.00
10,010,03,090,0019,0351,695,30,725,876,0,3,2,5,3,1,4,0.00,82.76,80.00
10,010,03,090,0020,0352,708,36,744,1124,0,3,2,5,3,1,4,0.00,66.19,80.00
10,010,03,090,0021,0353,303,16,319,398,0,3,2,5,3,1,4,0.00,80.15,80.00
10,010,03,090,0021,0354,261,15,276,337,0,3,2,5,3,1,4,0.00,81.90,80.00
10,010,03,110,0013,0056,496,12,508,816,0,3,0,3,2,0,2,0.00,62.25,66.67
10,010,03,110,0013,0057,160,5,165,279,0,3,0,3,2,0,2,0.00,59.14,66.67
10,010,03,110,0014,0058,723,19,742,978,0,3,0,3,2,0,2,0.00,75.87,66.67
10,010,03,110,0014,0059,254,4,258,353,0,3,0,3,2,0,2,0.00,73.09,66.67
10,010,03,110,0015,0060,248,8,256,314,0,3,0,3,2,0,2,0.00,81.53,66.67
10,010,03,110,0015,0061,186,6,192,259,0,3,0,3,2,0,2,0.00,74.13,66.67
10,010,03,110,0013,0000,656,17,673,1095,0,3,0,3,2,0,2,0.00,61.46,66.67
10,010,03,110,0014,0000,977,23,1000,1331,0,3,0,3,2,0,2,0.00,75.13,66.67
10,010,03,110,0015,0000,434,14,448,573,0,3,0,3,2,0,2,0.00,78.18,66.67
10,010,03,120,0017,0088,454,21,475,766,0,4,2,6,3,2,5,0.00,62.01,83.33
10,010,03,120,0017,0089,563,23,586,948,0,4,2,6,3,2,5,0.00,61.81,83.33
10,010,03,120,0015,0090,488,16,504,887,0,4,2,6,3,2,5,0.00,56.82,83.33
10,010,03,120,0015,0091,617,18,635,1151,0,4,2,6,3,2,5,0.00,55.17,83.33
10,010,03,120,0016,0092,607,19,626,1032,0,4,2,6,3,2,5,0.00,60.66,83.33
10,010,03,120,0016,0093,430,16,446,896,0,4,2,6,3,2,5,0.00,49.78,83.33
10,010,03,120,0025,0094,735,25,760,1140,0,4,2,6,3,2,5,0.00,66.67,83.33
10,010,03,120,0018,0095,658,28,686,1332,0,4,2,6,3,2,5,0.00,51.50,83.33
10,010,03,120,0018,0096,750,28,778,1422,0,4,2,6,3,2,5,0.00,54.71,83.33
10,010,03,120,0018,0097,646,26,672,1429,0,4,2,6,3,2,5,0.00,47.03,83.33
10,010,03,120,0019,0098,833,25,858,1447,0,4,2,6,3,2,5,0.00,59.30,83.33
10,010,03,120,0019,0099,832,23,855,1405,0,4,2,6,3,2,5,0.00,60.85,83.33
10,010,03,120,0026,0100,568,11,579,782,0,4,2,6,3,2,5,0.00,74.04,83.33
10,010,03,120,0021,0101,673,23,696,1085,0,4,2,6,3,2,5,0.00,64.15,83.33
10,010,03,120,0021,0102,397,18,415,584,0,4,2,6,3,2,5,0.00,71.06,83.33
10,010,03,120,0020,0103,583,14,597,1019,0,4,2,6,3,2,5,0.00,58.59,83.33
10,010,03,120,0020,0104,383,19,402,750,0,4,2,6,3,2,5,0.00,53.60,83.33
10,010,03,120,0022,0105,547,23,570,867,0,4,2,6,3,2,5,0.00,65.74,83.33
10,010,03,120,0023,0106,626,15,641,951,0,4,2,6,3,2,5,0.00,67.40,83.33
10,010,03,120,0024,0107,672,16,688,1173,0,4,2,6,3,2,5,0.00,58.65,83.33
10,010,03,120,0015,0000,1105,34,1139,2038,0,4,2,6,3,2,5,0.00,55.89,83.33
10,010,03,120,0016,0000,1037,35,1072,1928,0,4,2,6,3,2,5,0.00,55.60,83.33
10,010,03,120,0017,0000,1017,44,1061,1714,0,4,2,6,3,2,5,0.00,61.90,83.33
10,010,03,120,0018,0000,2054,82,2136,4183,0,4,2,6,3,2,5,0.00,51.06,83.33
10,010,03,120,0019,0000,1665,48,1713,2852,0,4,2,6,3,2,5,0.00,60.06,83.33
10,010,03,120,0020,0000,966,33,999,1769,0,4,2,6,3,2,5,0.00,56.47,83.33
10,010,03,120,0021,0000,1070,41,1111,1669,0,4,2,6,3,2,5,0.00,66.57,83.33
10,010,03,120,0022,0000,547,23,570,867,0,4,2,6,3,2,5,0.00,65.74,83.33
10,010,03,120,0023,0000,626,15,641,951,0,4,2,6,3,2,5,0.00,67.40,83.33
10,010,03,120,0024,0000,672,16,688,1173,0,4,2,6,3,2,5,0.00,58.65,83.33
10,010,03,120,0025,0000,735,25,760,1140,0,4,2,6,3,2,5,0.00,66.67,83.33
10,010,03,120,0026,0000,568,11,579,782,0,4,2,6,3,2,5,0.00,74.04,83.33
10,010,03,130,0003,0000,463,15,478,756,0,3,2,5,1,2,3,0.00,63.23,60.00
10,010,03,130,0004,0000,545,47,592,846,0,3,2,5,1,2,3,0.00,69.98,60.00
10,010,03,130,0014,0000,617,28,645,1069,0,3,2,5,1,2,3,0.00,60.34,60.00
10,010,03,130,0015,0000,659,38,697,911,0,3,2,5,1,2,3,0.00,76.51,60.00
10,010,03,130,0016,0000,1092,24,1116,1782,0,3,2,5,1,2,3,0.00,62.63,60.00
10,010,03,130,0017,0000,435,10,445,695,0,3,2,5,1,2,3,0.00,64.03,60.00
10,010,03,130,0018,0000,588,11,599,919,0,3,2,5,1,2,3,0.00,65.18,60.00
10,010,03,130,0019,0000,314,18,332,604,0,3,2,5,1,2,3,0.00,54.97,60.00
10,010,03,130,0020,0000,448,14,462,689,0,3,2,5,1,2,3,0.00,67.05,60.00
10,010,03,130,0021,0000,209,6,215,336,0,3,2,5,1,2,3,0.00,63.99,60.00
10,010,03,130,0022,0000,167,5,172,269,0,3,2,5,1,2,3,0.00,63.94,60.00
10,010,03,130,0004,0442,545,47,592,846,0,3,2,5,1,2,3,0.00,69.98,60.00
10,010,03,130,0003,0443,463,15,478,756,0,3,2,5,1,2,3,0.00,63.23,60.00
10,010,03,130,0014,0444,139,9,148,260,0,3,2,5,1,2,3,0.00,56.92,60.00
10,010,03,130,0014,0445,478,19,497,809,0,3,2,5,1,2,3,0.00,61.43,60.00
10,010,03,130,0015,0446,659,38,697,911,0,3,2,5,1,2,3,0.00,76.51,60.00
10,010,03,130,0016,0447,739,19,758,1160,0,3,2,5,1,2,3,0.00,65.34,60.00
10,010,03,130,0016,0448,353,5,358,622,0,3,2,5,1,2,3,0.00,57.56,60.00
10,010,03,130,0020,0449,448,14,462,689,0,3,2,5,1,2,3,0.00,67.05,60.00
10,010,03,130,0019,0450,314,18,332,604,0,3,2,5,1,2,3,0.00,54.97,60.00
10,010,03,130,0017,0451,435,10,445,695,0,3,2,5,1,2,3,0.00,64.03,60.00
10,010,03,130,0018,0452,289,8,297,445,0,3,2,5,1,2,3,0.00,66.74,60.00
10,010,03,130,0018,0453,299,3,302,474,0,3,2,5,1,2,3,0.00,63.71,60.00
10,010,03,130,0021,0454,209,6,215,336,0,3,2,5,1,2,3,0.00,63.99,60.00
10,010,03,130,0022,0455,167,5,172,269,0,3,2,5,1,2,3,0.00,63.94,60.00
10,010,03,140,0017,0000,989,36,1025,1690,0,5,0,5,3,0,3,0.00,60.65,60.00
10,010,03,140,0018,0000,440,20,460,606,0,5,0,5,3,0,3,0.00,75.91,60.00
10,010,03,140,0019,0000,260,13,273,394,0,5,0,5,3,0,3,0.00,69.29,60.00
10,010,03,140,0020,0000,1070,35,1105,1753,0,5,0,5,3,0,3,0.00,63.03,60.00
10,010,03,140,0021,0000,476,13,489,847,0,5,0,5,3,0,3,0.00,57.73,60.00
10,010,03,140,0022,0000,178,12,190,232,0,5,0,5,3,0,3,0.00,81.90,60.00
10,010,03,140,0023,0000,414,11,425,739,0,5,0,5,3,0,3,0.00,57.51,60.00
10,010,03,140,0024,0000,507,10,517,656,0,5,0,5,3,0,3,0.00,78.81,60.00
10,010,03,140,0017,0481,107,6,113,193,0,5,0,5,3,0,3,0.00,58.55,60.00
10,010,03,140,0017,0482,882,30,912,1497,0,5,0,5,3,0,3,0.00,60.92,60.00
10,010,03,140,0018,0483,440,20,460,606,0,5,0,5,3,0,3,0.00,75.91,60.00
10,010,03,140,0019,0484,260,13,273,394,0,5,0,5,3,0,3,0.00,69.29,60.00
10,010,03,140,0020,0485,554,11,565,856,0,5,0,5,3,0,3,0.00,66.00,60.00
10,010,03,140,0020,0486,516,24,540,897,0,5,0,5,3,0,3,0.00,60.20,60.00
10,010,03,140,0021,0487,420,13,433,749,0,5,0,5,3,0,3,0.00,57.81,60.00
10,010,03,140,0021,0488,56,0,56,98,0,5,0,5,3,0,3,0.00,57.14,60.00
10,010,03,140,0022,0489,178,12,190,232,0,5,0,5,3,0,3,0.00,81.90,60.00
10,010,03,140,0023,0490,158,6,164,306,0,5,0,5,3,0,3,0.00,53.59,60.00
10,010,03,140,0023,0491,256,5,261,433,0,5,0,5,3,0,3,0.00,60.28,60.00
10,010,03,140,0024,0492,336,2,338,419,0,5,0,5,3,0,3,0.00,80.67,60.00
10,010,03,140,0024,0493,171,8,179,237,0,5,0,5,3,0,3,0.00,75.53,60.00
10,010,03,150,0012,0000,297,9,306,454,0,4,1,5,3,0,3,0.00,67.40,60.00
10,010,03,150,0013,0000,214,10,224,269,0,4,1,5,3,0,3,0.00,83.27,60.00
10,010,03,150,0014,0000,338,20,358,414,0,4,1,5,3,0,3,0.00,86.47,60.00
10,010,03,150,0015,0000,425,13,438,682,0,4,1,5,3,0,3,0.00,64.22,60.00
10,010,03,150,0016,0000,483,9,492,590,0,4,1,5,3,0,3,0.00,83.39,60.00
10,010,03,150,0017,0000,630,10,640,897,0,4,1,5,3,0,3,0.00,71.35,60.00
10,010,03,150,0018,0000,219,6,225,381,0,4,1,5,3,0,3,0.00,59.06,60.00
10,010,03,150,0012,0254,297,9,306,454,0,4,1,5,3,0,3,0.00,67.40,60.00
10,010,03,150,0014,0255,338,20,358,414,0,4,1,5,3,0,3,0.00,86.47,60.00
10,010,03,150,0018,0256,219,6,225,381,0,4,1,5,3,0,3,0.00,59.06,60.00
10,010,03,150,0013,0257,214,10,224,269,0,4,1,5,3,0,3,0.00,83.27,60.00
10,010,03,150,0015,0258,425,13,438,682,0,4,1,5,3,0,3,0.00,64.22,60.00
10,010,03,150,0016,0259,483,9,492,590,0,4,1,5,3,0,3,0.00,83.39,60.00
10,010,03,150,0017,0260,351,7,358,510,0,4,1,5,3,0,3,0.00,70.20,60.00
10,010,03,150,0017,0261,279,3,282,387,0,4,1,5,3,0,3,0.00,72.87,60.00
10,010,03,180,0009,0000,147,3,150,232,0,4,1,5,1,1,2,0.00,64.66,40.00
10,010,03,180,0010,0000,317,16,333,458,0,4,1,5,1,1,2,0.00,72.71,40.00
10,010,03,180,0011,0000,200,4,204,273,0,4,1,5,1,1,2,0.00,74.73,40.00
10,010,03,180,0012,0000,192,11,203,254,0,4,1,5,1,1,2,0.00,79.92,40.00
10,010,03,180,0009,0529,147,3,150,232,0,4,1,5,1,1,2,0.00,64.66,40.00
10,010,03,180,0010,0530,317,16,333,458,0,4,1,5,1,1,2,0.00,72.71,40.00
10,010,03,180,0011,0531,200,4,204,273,0,4,1,5,1,1,2,0.00,74.73,40.00
10,010,03,180,0012,0532,192,11,203,254,0,4,1,5,1,1,2,0.00,79.92,40.00
10,010,00,040,0000,0000,16641,605,17246,25624,29769,13,4,17,7,4,11,86.08,67.30,64.71
10,010,01,040,0000,0000,8721,309,9030,13697,16109,7,2,9,4,2,6,85.03,65.93,66.67
10,010,02,040,0000,0000,7920,296,8216,11927,13660,6,2,8,3,2,5,87.31,68.89,62.50
10,010,00,050,0000,0000,36710,2202,38912,59483,70318,15,7,22,8,5,13,84.59,65.42,59.09
10,010,01,050,0000,0000,11535,604,12139,17857,21221,3,3,6,2,2,4,84.15,67.98,66.67
10,010,02,050,0000,0000,15410,890,16300,25444,30359,8,3,11,4,2,6,83.81,64.06,54.55
10,010,03,050,0000,0000,9765,708,10473,16182,18738,4,1,5,2,1,3,86.36,64.72,60.00
10,010,00,060,0000,0000,7980,229,8209,12034,13526,10,5,15,6,5,11,88.97,68.22,73.33
10,010,01,060,0000,0000,4235,119,4354,6140,6924,6,3,9,3,3,6,88.68,70.91,66.67
10,010,02,060,0000,0000,3745,110,3855,5894,6602,4,2,6,3,2,5,89.28,65.41,83.33
10,010,00,070,0000,0000,18582,713,19295,26096,30345,12,5,17,8,3,11,86.00,73.94,64.71
10,010,01,070,0000,0000,10002,346,10348,14163,16547,6,3,9,5,1,6,85.59,73.06,66.67
10,010,02,070,0000,0000,8580,367,8947,11933,13798,6,2,8,3,2,5,86.48,74.98,62.50
10,010,00,080,0000,0000,13115,582,13697,19216,21419,16,3,19,8,3,11,89.71,71.28,57.89
10,010,01,080,0000,0000,6234,290,6524,9046,10067,7,1,8,4,1,5,89.86,72.12,62.50
10,010,02,080,0000,0000,4329,166,4495,6392,7166,6,2,8,2,2,4,89.20,70.32,50.00
10,010,03,080,0000,0000,2552,126,2678,3778,4186,3,0,3,2,0,2,90.25,70.88,66.67
10,010,00,090,0000,0000,13878,916,14794,20632,23254,8,4,12,8,3,11,88.72,71.70,91.67
10,010,01,090,0000,0000,3555,289,3844,5600,6451,3,0,3,3,0,3,86.81,68.64,100.00
10,010,02,090,0000,0000,4823,370,5193,7297,8079,2,2,4,2,2,4,90.32,71.17,100.00
10,010,03,090,0000,0000,5500,257,5757,7735,8724,3,2,5,3,1,4,88.66,74.43,80.00
10,010,00,100,0000,0000,11072,394,11466,15392,17059,9,5,14,6,5,11,90.23,74.49,78.57
10,010,01,100,0000,0000,5324,147,5471,7220,8068,4,3,7,2,3,5,89.49,75.78,71.43
10,010,02,100,0000,0000,5748,247,5995,8172,8991,5,2,7,4,2,6,90.89,73.36,85.71
10,010,00,110,0000,0000,8758,230,8988,12964,14498,12,6,18,8,3,11,89.42,69.33,61.11
10,010,01,110,0000,0000,3779,90,3869,5585,6279,5,3,8,3,2,5,88.95,69.27,62.50
10,010,02,110,0000,0000,2912,86,2998,4380,4848,4,3,7,3,1,4,90.35,68.45,57.14
10,010,03,110,0000,0000,2067,54,2121,2999,3371,3,0,3,2,0,2,88.96,70.72,66.67
10,010,00,120,0000,0000,24935,961,25896,42129,47989,14,3,17,8,3,11,87.79,61.47,64.71
10,010,01,120,0000,0000,6587,302,6889,11636,13553,5,1,6,2,1,3,85.86,59.20,50.00
10,010,02,120,0000,0000,6286,252,6538,9427,10753,5,0,5,3,0,3,87.67,69.35,60.00
10,010,03,120,0000,0000,12062,407,12469,21066,23683,4,2,6,3,2,5,88.95,59.19,83.33
10,010,00,130,0000,0000,21511,907,22418,37409,43143,11,6,17,6,5,11,86.71,59.93,64.71
10,010,01,130,0000,0000,9942,440,10382,18288,21110,4,3,7,3,2,5,86.63,56.77,71.43
10,010,02,130,0000,0000,6032,251,6283,10245,11907,4,1,5,2,1,3,86.04,61.33,60.00
10,010,03,130,0000,0000,5537,216,5753,8876,10126,3,2,5,1,2,3,87.66,64.82,60.00
10,010,00,140,0000,0000,18485,683,19168,29493,33820,14,5,19,8,3,11,87.21,64.99,57.89
10,010,01,140,0000,0000,8269,266,8535,13774,15843,5,2,7,3,2,5,86.94,61.96,71.43
10,010,02,140,0000,0000,5882,267,6149,8802,10058,4,3,7,2,1,3,87.51,69.86,42.86
10,010,03,140,0000,0000,4334,150,4484,6917,7919,5,0,5,3,0,3,87.35,64.83,60.00
10,010,00,150,0000,0000,11268,297,11565,15932,18087,13,6,19,9,2,11,88.09,72.59,57.89
10,010,01,150,0000,0000,5924,170,6094,8608,9889,6,4,10,4,2,6,87.05,70.79,60.00
10,010,02,150,0000,0000,2738,50,2788,3637,4092,3,1,4,2,0,2,88.88,76.66,50.00
10,010,03,150,0000,0000,2606,77,2683,3687,4106,4,1,5,3,0,3,89.80,72.77,60.00
10,010,00,160,0000,0000,7023,152,7175,9682,10992,8,5,13,7,4,11,88.08,74.11,84.62
10,010,01,160,0000,0000,4652,77,4729,6162,6998,6,2,8,5,2,7,88.05,76.74,87.50
10,010,02,160,0000,0000,2371,75,2446,3520,3994,2,3,5,2,2,4,88.13,69.49,80.00
10,010,00,170,0000,0000,2870,58,2928,3898,4498,7,2,9,5,2,7,86.66,75.12,77.78
10,010,01,170,0000,0000,1781,37,1818,2454,2883,3,2,5,2,2,4,85.12,74.08,80.00
10,010,02,170,0000,0000,1089,21,1110,1444,1615,4,0,4,3,0,3,89.41,76.87,75.00
10,010,00,180,0000,0000,2827,83,2910,4463,5385,11,1,12,6,1,7,82.88,65.20,58.33
10,010,01,180,0000,0000,637,22,659,1234,1384,2,0,2,2,0,2,89.16,53.40,100.00
10,010,02,180,0000,0000,1334,27,1361,2012,2475,5,0,5,3,0,3,81.29,67.64,60.00
10,010,03,180,0000,0000,856,34,890,1217,1526,4,1,5,1,1,2,79.75,73.13,40.00
10,013,00,000,0000,0000,438140,16430,454570,676125,797653,417,133,550,251,82,333,84.76,67.23,60.55
10,013,00,010,0000,0000,92582,4571,97153,161232,193656,22,16,38,14,9,23,83.26,60.26,60.53
10,013,01,010,0000,0000,4049,504,4553,7065,8342,1,1,2,1,0,1,84.69,64.44,50.00
10,013,02,010,0000,0000,20367,925,21292,35472,42841,2,6,8,2,3,5,82.80,60.02,62.50
10,013,03,010,0000,0000,32317,1466,33783,54600,64828,8,6,14,4,4,8,84.22,61.87,57.14
10,013,04,010,0000,0000,35849,1676,37525,64095,77645,11,3,14,7,2,9,82.55,58.55,64.29
10,013,01,010,0004,0001,462,80,542,845,0,1,1,2,1,0,1,0.00,64.14,50.00
10,013,01,010,0004,0002,431,47,478,738,0,1,1,2,1,0,1,0.00,64.77,50.00
10,013,01,010,0001,0003,508,64,572,823,0,1,1,2,1,0,1,0.00,69.50,50.00
10,013,01,010,0001,0004,449,49,498,717,0,1,1,2,1,0,1,0.00,69.46,50.00
10,013,01,010,0008,0005,511,65,576,856,0,1,1,2,1,0,1,0.00,67.29,50.00
10,013,01,010,0008,0006,400,60,460,683,0,1,1,2,1,0,1,0.00,67.35,50.00
10,013,01,010,0012,0007,643,75,718,1205,0,1,1,2,1,0,1,0.00,59.59,50.00
10,013,01,010,0012,0008,645,64,709,1198,0,1,1,2,1,0,1,0.00,59.18,50.00
10,013,01,010,0001,0000,957,113,1070,1540,0,1,1,2,1,0,1,0.00,69.48,50.00
10,013,01,010,0004,0000,893,127,1020,1583,0,1,1,2,1,0,1,0.00,64.43,50.00
10,013,01,010,0008,0000,911,125,1036,1539,0,1,1,2,1,0,1,0.00,67.32,50.00
10,013,01,010,0012,0000,1288,139,1427,2403,0,1,1,2,1,0,1,0.00,59.38,50.00
10,013,01,020,0001,0000,318,8,326,466,0,4,3,7,3,3,6,0.00,69.96,85.71
10,013,01,020,0002,0000,366,10,376,554,0,4,3,7,3,3,6,0.00,67.87,85.71
10,013,01,020,0005,0000,2476,64,2540,4559,0,4,3,7,3,3,6,0.00,55.71,85.71
10,013,01,020,0006,0000,551,11,562,836,0,4,3,7,3,3,6,0.00,67.22,85.71
10,013,01,020,0007,0000,3050,105,3155,5256,0,4,3,7,3,3,6,0.00,60.03,85.71
10,013,01,020,0008,0000,3578,90,3668,6196,0,4,3,7,3,3,6,0.00,59.20,85.71
10,013,01,020,0009,0000,1157,39,1196,1987,0,4,3,7,3,3,6,0.00,60.19,85.71
10,013,01,020,0001,0138,318,8,326,466,0,4,3,7,3,3,6,0.00,69.96,85.71
10,013,01,020,0005,0139,477,12,489,868,0,4,3,7,3,3,6,0.00,56.34,85.71
10,013,01,020,0005,0140,475,11,486,893,0,4,3,7,3,3,6,0.00,54.42,85.71
10,013,01,020,0005,0141,543,11,554,932,0,4,3,7,3,3,6,0.00,59.44,85.71
10,013,01,020,0005,0142,496,16,512,872,0,4,3,7,3,3,6,0.00,58.72,85.71
10,013,01,020,0005,0143,485,14,499,994,0,4,3,7,3,3,6,0.00,50.20,85.71
10,013,01,020,0002,0144,366,10,376,554,0,4,3,7,3,3,6,0.00,67.87,85.71
10,013,01,020,0006,0145,551,11,562,836,0,4,3,7,3,3,6,0.00,67.22,85.71
10,013,01,020,0007,0146,700,17,717,1225,0,4,3,7,3,3,6,0.00,58.53,85.71
10,013,01,020,0007,0147,426,14,440,780,0,4,3,7,3,3,6,0.00,56.41,85.71
10,013,01,020,0007,0148,513,22,535,917,0,4,3,7,3,3,6,0.00,58.34,85.71
10,013,01,020,0007,0149,726,23,749,1196,0,4,3,7,3,3,6,0.00,62.63,85.71
10,013,01,020,0007,0150,685,29,714,1138,0,4,3,7,3,3,6,0.00,62.74,85.71
10,013,01,020,0008,0151,638,13,651,1072,0,4,3,7,3,3,6,0.00,60.73,85.71
10,013,01,020,0008,0152,535,17,552,962,0,4,3,7,3,3,6,0.00,57.38,85.71
10,013,01,020,0008,0153,649,19,668,1124,0,4,3,7,3,3,6,0.00,59.43,85.71
10,013,01,020,0008,0154,609,11,620,1037,0,4,3,7,3,3,6,0.00,59.79,85.71
10,013,01,020,0008,0155,626,15,641,1092,0,4,3,7,3,3,6,0.00,58.70,85.71
10,013,01,020,0008,0156,521,15,536,909,0,4,3,7,3,3,6,0.00,58.97,85.71
10,013,01,020,0009,0157,482,18,500,806,0,4,3,7,3,3,6,0.00,62.03,85.71
10,013,01,020,0009,0158,675,21,696,1181,0,4,3,7,3,3,6,0.00,58.93,85.71
10,013,01,020,0018,0159,693,21,714,1134,0,4,3,7,3,3,6,0.00,62.96,85.71
10,013,01,020,0018,0160,277,4,281,464,0,4,3,7,3,3,6,0.00,60.56,85.71
10,013,01,020,0018,0000,970,25,995,1598,0,4,3,7,3,3,6,0.00,62.27,85.71
10,013,01,030,0001,0000,1267,43,1310,1905,0,3,2,5,3,1,4,0.00,68.77,80.00
10,013,01,030,0003,0000,935,45,980,1391,0,3,2,5,3,1,4,0.00,70.45,80.00
10,013,01,030,0001,0184,626,18,644,919,0,3,2,5,3,1,4,0.00,70.08,80.00
10,013,01,030,0001,0185,641,25,666,986,0,3,2,5,3,1,4,0.00,67.55,80.00
10,013,01,030,0003,0186,461,18,479,668,0,3,2,5,3,1,4,0.00,71.71,80.00
10,013,01,030,0003,0187,474,27,501,723,0,3,2,5,3,1,4,0.00,69.29,80.00
10,013,01,030,0025,0188,781,26,807,1139,0,3,2,5,3,1,4,0.00,70.85,80.00
10,013,01,030,0025,0189,622,28,650,1011,0,3,2,5,3,1,4,0.00,64.29,80.00
10,013,01,030,0026,0190,621,27,648,992,0,3,2,5,3,1,4,0.00,65.32,80.00
10,013,01,030,0026,0191,624,20,644,982,0,3,2,5,3,1,4,0.00,65.58,80.00
10,013,01,030,0027,0192,664,25,689,1106,0,3,2,5,3,1,4,0.00,62.30,80.00
10,013,01,030,0027,0193,804,29,833,1226,0,3,2,5,3,1,4,0.00,67.94,80.00
10,013,01,030,0027,0194,727,35,762,1195,0,3,2,5,3,1,4,0.00,63.77,80.00
10,013,01,030,0028,0195,494,29,523,840,0,3,2,5,3,1,4,0.00,62.26,80.00
10,013,01,030,0028,0196,479,16,495,753,0,3,2,5,3,1,4,0.00,65.74,80.00
10,013,01,030,0020,0197,884,32,916,1291,0,3,2,5,3,1,4,0.00,70.95,80.00
10,013,01,030,0020,0000,884,32,916,1291,0,3,2,5,3,1,4,0.00,70.95,80.00
10,013,01,030,0025,0000,1403,54,1457,2150,0,3,2,5,3,1,4,0.00,67.77,80.00
10,013,01,030,0026,0000,1245,47,1292,1974,0,3,2,5,3,1,4,0.00,65.45,80.00
10,013,01,030,0027,0000,2195,89,2284,3527,0,3,2,5,3,1,4,0.00,64.76,80.00
10,013,01,030,0028,0000,973,45,1018,1593,0,3,2,5,3,1,4,0.00,63.90,80.00
10,013,01,040,0001,0000,449,13,462,849,0,3,0,3,2,0,2,0.00,54.42,66.67
10,013,01,040,0002,0000,1223,50,1273,2100,0,3,0,3,2,0,2,0.00,60.62,66.67
10,013,01,040,0003,0000,637,22,659,1067,0,3,0,3,2,0,2,0.00,61.76,66.67
10,013,01,040,0001,0225,449,13,462,849,0,3,0,3,2,0,2,0.00,54.42,66.67
10,013,01,040,0002,0226,402,15,417,681,0,3,0,3,2,0,2,0.00,61.23,66.67
10,013,01,040,0002,0227,407,17,424,706,0,3,0,3,2,0,2,0.00,60.06,66.67
10,013,01,040,0002,0228,414,18,432,713,0,3,0,3,2,0,2,0.00,60.59,66.67
10,013,01,040,0003,0229,637,22,659,1067,0,3,0,3,2,0,2,0.00,61.76,66.67
10,013,01,050,0022,0000,1433,63,1496,2022,0,2,1,3,2,0,2,0.00,73.99,66.67
10,013,01,050,0023,0000,995,40,1035,1445,0,2,1,3,2,0,2,0.00,71.63,66.67
10,013,01,050,0025,0000,1355,48,1403,1974,0,2,1,3,2,0,2,0.00,71.07,66.67
10,013,01,050,0023,0254,995,40,1035,1445,0,2,1,3,2,0,2,0.00,71.63,66.67
10,013,01,050,0022,0255,816,37,853,1146,0,2,1,3,2,0,2,0.00,74.43,66.67
10,013,01,050,0022,0256,617,26,643,876,0,2,1,3,2,0,2,0.00,73.40,66.67
10,013,01,050,0025,0257,689,17,706,985,0,2,1,3,2,0,2,0.00,71.68,66.67
10,013,01,050,0025,0258,666,31,697,989,0,2,1,3,2,0,2,0.00,70.48,66.67
10,013,01,050,0029,0259,412,18,430,517,0,2,1,3,2,0,2,0.00,83.17,66.67
10,013,01,050,0027,0260,812,34,846,1106,0,2,1,3,2,0,2,0.00,76.49,66.67
10,013,01,050,0028,0261,549,10,559,779,0,2,1,3,2,0,2,0.00,71.76,66.67
10,013,01,050,0030,0262,241,10,251,360,0,2,1,3,2,0,2,0.00,69.72,66.67
10,013,01,050,0027,0000,812,34,846,1106,0,2,1,3,2,0,2,0.00,76.49,66.67
10,013,01,050,0028,0000,549,10,559,779,0,2,1,3,2,0,2,0.00,71.76,66.67
10,013,01,050,0029,0000,412,18,430,517,0,2,1,3,2,0,2,0.00,83.17,66.67
10,013,01,050,0030,0000,241,10,251,360,0,2,1,3,2,0,2,0.00,69.72,66.67
10,013,01,060,0001,0000,1601,41,1642,2611,0,4,2,6,3,2,5,0.00,62.89,83.33
10,013,01,060,0002,0000,2159,54,2213,3536,0,4,2,6,3,2,5,0.00,62.58,83.33
10,013,01,060,0003,0000,1229,26,1255,1853,0,4,2,6,3,2,5,0.00,67.73,83.33
10,013,01,060,0004,0000,1488,57,1545,2562,0,4,2,6,3,2,5,0.00,60.30,83.33
10,013,01,060,0005,0000,702,21,723,1037,0,4,2,6,3,2,5,0.00,69.72,83.33
10,013,01,060,0001,0298,627,18,645,989,0,4,2,6,3,2,5,0.00,65.22,83.33
10,013,01,060,0001,0299,974,23,997,1622,0,4,2,6,3,2,5,0.00,61.47,83.33
10,013,01,060,0002,0300,1110,30,1140,1807,0,4,2,6,3,2,5,0.00,63.09,83.33
10,013,01,060,0002,0301,1049,24,1073,1729,0,4,2,6,3,2,5,0.00,62.06,83.33
10,013,01,060,0003,0302,607,15,622,935,0,4,2,6,3,2,5,0.00,66.52,83.33
10,013,01,060,0003,0303,622,11,633,918,0,4,2,6,3,2,5,0.00,68.95,83.33
10,013,01,060,0004,0304,449,15,464,700,0,4,2,6,3,2,5,0.00,66.29,83.33
10,013,01,060,0004,0305,1039,42,1081,1862,0,4,2,6,3,2,5,0.00,58.06,83.33
10,013,01,060,0005,0306,702,21,723,1037,0,4,2,6,3,2,5,0.00,69.72,83.33
10,013,01,070,0001,0000,1436,42,1478,2045,0,3,1,4,2,0,2,0.00,72.27,50.00
10,013,01,070,0001,0320,520,11,531,716,0,3,1,4,2,0,2,0.00,74.16,50.00
10,013,01,070,0001,0321,916,31,947,1329,0,3,1,4,2,0,2,0.00,71.26,50.00
10,013,01,080,0001,0000,960,41,1001,1371,0,2,3,5,2,1,3,0.00,73.01,60.00
10,013,01,080,0002,0000,927,36,963,1342,0,2,3,5,2,1,3,0.00,71.76,60.00
10,013,01,080,0003,0000,1151,44,1195,1601,0,2,3,5,2,1,3,0.00,74.64,60.00
10,013,01,080,0005,0000,769,23,792,1111,0,2,3,5,2,1,3,0.00,71.29,60.00
10,013,01,080,0001,0330,960,41,1001,1371,0,2,3,5,2,1,3,0.00,73.01,60.00
10,013,01,080,0002,0331,927,36,963,1342,0,2,3,5,2,1,3,0.00,71.76,60.00
10,013,01,080,0003,0332,1151,44,1195,1601,0,2,3,5,2,1,3,0.00,74.64,60.00
10,013,01,080,0005,0333,769,23,792,1111,0,2,3,5,2,1,3,0.00,71.29,60.00
10,013,01,090,0001,0000,1896,114,2010,3166,0,4,0,4,3,0,3,0.00,63.49,75.00
10,013,01,090,0007,0000,1104,36,1140,1466,0,4,0,4,3,0,3,0.00,77.76,75.00
10,013,01,090,0008,0000,1005,41,1046,1488,0,4,0,4,3,0,3,0.00,70.30,75.00
10,013,01,090,0001,0346,1006,47,1053,1631,0,4,0,4,3,0,3,0.00,64.56,75.00
10,013,01,090,0001,0347,890,67,957,1535,0,4,0,4,3,0,3,0.00,62.35,75.00
10,013,01,090,0007,0348,1104,36,1140,1466,0,4,0,4,3,0,3,0.00,77.76,75.00
10,013,01,090,0008,0349,1005,41,1046,1488,0,4,0,4,3,0,3,0.00,70.30,75.00
10,013,01,100,0002,0000,2024,81,2105,2645,0,4,3,7,4,1,5,0.00,79.58,71.43
10,013,01,100,0003,0000,1197,41,1238,1711,0,4,3,7,4,1,5,0.00,72.36,71.43
10,013,01,100,0004,0000,1535,47,1582,2209,0,4,3,7,4,1,5,0.00,71.62,71.43
10,013,01,100,0005,0000,1167,56,1223,1666,0,4,3,7,4,1,5,0.00,73.41,71.43
10,013,01,100,0006,0000,703,31,734,976,0,4,3,7,4,1,5,0.00,75.20,71.43
10,013,01,100,0003,0366,628,19,647,865,0,4,3,7,4,1,5,0.00,74.80,71.43
10,013,01,100,0003,0367,569,22,591,846,0,4,3,7,4,1,5,0.00,69.86,71.43
10,013,01,100,0004,0368,695,32,727,1015,0,4,3,7,4,1,5,0.00,71.63,71.43
10,013,01,100,0004,0369,840,15,855,1194,0,4,3,7,4,1,5,0.00,71.61,71.43
10,013,01,100,0005,0370,495,19,514,718,0,4,3,7,4,1,5,0.00,71.59,71.43
10,013,01,100,0005,0371,672,37,709,948,0,4,3,7,4,1,5,0.00,74.79,71.43
10,013,01,100,0006,0372,703,31,734,976,0,4,3,7,4,1,5,0.00,75.20,71.43
10,013,01,100,0002,0373,683,25,708,887,0,4,3,7,4,1,5,0.00,79.82,71.43
10,013,01,100,0002,0374,751,35,786,987,0,4,3,7,4,1,5,0.00,79.64,71.43
10,013,01,100,0002,0375,590,21,611,771,0,4,3,7,4,1,5,0.00,79.25,71.43
10,013,01,110,0001,0000,1401,38,1439,2036,0,4,2,6,3,1,4,0.00,70.68,66.67
10,013,01,110,0002,0000,778,19,797,1190,0,4,2,6,3,1,4,0.00,66.97,66.67
10,013,01,110,0003,0000,510,7,517,694,0,4,2,6,3,1,4,0.00,74.50,66.67
10,013,01,110,0004,0000,373,7,380,545,0,4,2,6,3,1,4,0.00,69.72,66.67
10,013,01,110,0005,0000,667,18,685,931,0,4,2,6,3,1,4,0.00,73.58,66.67
10,013,01,110,0006,0000,808,22,830,1108,0,4,2,6,3,1,4,0.00,74.91,66.67
10,013,01,110,0007,0000,411,9,420,572,0,4,2,6,3,1,4,0.00,73.43,66.67
10,013,01,110,0001,0389,597,12,609,865,0,4,2,6,3,1,4,0.00,70.40,66.67
10,013,01,110,0001,0390,804,26,830,1171,0,4,2,6,3,1,4,0.00,70.88,66.67
10,013,01,110,0002,0391,778,19,797,1190,0,4,2,6,3,1,4,0.00,66.97,66.67
10,013,01,110,0003,0392,510,7,517,694,0,4,2,6,3,1,4,0.00,74.50,66.67
10,013,01,110,0004,0393,373,7,380,545,0,4,2,6,3,1,4,0.00,69.72,66.67
10,013,01,110,0005,0394,667,18,685,931,0,4,2,6,3,1,4,0.00,73.58,66.67
10,013,01,110,0006,0395,808,22,830,1108,0,4,2,6,3,1,4,0.00,74.91,66.67
10,013,01,110,0007,0396,411,9,420,572,0,4,2,6,3,1,4,0.00,73.43,66.67
10,013,01,120,0001,0000,776,24,800,1144,0,4,2,6,2,1,3,0.00,69.93,50.00
10,013,01,120,0002,0000,436,10,446,686,0,4,2,6,2,1,3,0.00,65.01,50.00
10,013,01,120,0003,0000,1066,31,1097,1577,0,4,2,6,2,1,3,0.00,69.56,50.00
10,013,01,120,0004,0000,553,26,579,853,0,4,2,6,2,1,3,0.00,67.88,50.00
10,013,01,120,0005,0000,362,14,376,510,0,4,2,6,2,1,3,0.00,73.73,50.00
10,013,01,120,0001,0413,776,24,800,1144,0,4,2,6,2,1,3,0.00,69.93,50.00
10,013,01,120,0002,0414,436,10,446,686,0,4,2,6,2,1,3,0.00,65.01,50.00
10,013,01,120,0003,0415,584,13,597,868,0,4,2,6,2,1,3,0.00,68.78,50.00
10,013,01,120,0003,0416,482,18,500,709,0,4,2,6,2,1,3,0.00,70.52,50.00
10,013,01,120,0004,0417,553,26,579,853,0,4,2,6,2,1,3,0.00,67.88,50.00
10,013,01,120,0005,0418,362,14,376,510,0,4,2,6,2,1,3,0.00,73.73,50.00
10,013,01,130,0001,0000,2014,91,2105,3887,0,3,3,6,3,2,5,0.00,54.15,83.33
10,013,01,130,0002,0000,1674,67,1741,3085,0,3,3,6,3,2,5,0.00,56.43,83.33
10,013,01,130,0003,0000,759,29,788,1197,0,3,3,6,3,2,5,0.00,65.83,83.33
10,013,01,130,0004,0000,324,14,338,525,0,3,3,6,3,2,5,0.00,64.38,83.33
10,013,01,130,0005,0000,1161,41,1202,2120,0,3,3,6,3,2,5,0.00,56.70,83.33
10,013,01,130,0006,0000,1496,57,1553,2779,0,3,3,6,3,2,5,0.00,55.88,83.33
10,013,01,130,0007,0000,2334,74,2408,4156,0,3,3,6,3,2,5,0.00,57.94,83.33
10,013,01,130,0001,0432,630,25,655,1181,0,3,3,6,3,2,5,0.00,55.46,83.33
10,013,01,130,0001,0433,671,28,699,1279,0,3,3,6,3,2,5,0.00,54.65,83.33
10,013,01,130,0001,0434,713,38,751,1427,0,3,3,6,3,2,5,0.00,52.63,83.33
10,013,01,130,0002,0435,794,28,822,1487,0,3,3,6,3,2,5,0.00,55.28,83.33
10,013,01,130,0002,0436,880,39,919,1598,0,3,3,6,3,2,5,0.00,57.51,83.33
10,013,01,130,0003,0437,759,29,788,1197,0,3,3,6,3,2,5,0.00,65.83,83.33
10,013,01,130,0004,0438,324,14,338,525,0,3,3,6,3,2,5,0.00,64.38,83.33
10,013,01,130,0005,0439,601,25,626,1116,0,3,3,6,3,2,5,0.00,56.09,83.33
10,013,01,130,0005,0440,560,16,576,1004,0,3,3,6,3,2,5,0.00,57.37,83.33
10,013,01,130,0006,0441,749,29,778,1385,0,3,3,6,3,2,5,0.00,56.17,83.33
10,013,01,130,0006,0442,747,28,775,1394,0,3,3,6,3,2,5,0.00,55.60,83.33
10,013,01,130,0007,0443,789,30,819,1339,0,3,3,6,3,2,5,0.00,61.17,83.33
10,013,01,130,0007,0444,742,24,766,1372,0,3,3,6,3,2,5,0.00,55.83,83.33
10,013,01,130,0007,0445,803,20,823,1445,0,3,3,6,3,2,5,0.00,56.96,83.33
10,013,01,140,0001,0000,982,34,1016,1403,0,5,3,8,2,3,5,0.00,72.42,62.50
10,013,01,140,0002,0000,613,29,642,828,0,5,3,8,2,3,5,0.00,77.54,62.50
10,013,01,140,0003,0000,494,10,504,666,0,5,3,8,2,3,5,0.00,75.68,62.50
10,013,01,140,0004,0000,397,17,414,546,0,5,3,8,2,3,5,0.00,75.82,62.50
10,013,01,140,0005,0000,879,32,911,1247,0,5,3,8,2,3,5,0.00,73.06,62.50
10,013,01,140,0006,0000,669,19,688,915,0,5,3,8,2,3,5,0.00,75.19,62.50
10,013,01,140,0007,0000,451,18,469,604,0,5,3,8,2,3,5,0.00,77.65,62.50
10,013,01,140,0001,0473,982,34,1016,1403,0,5,3,8,2,3,5,0.00,72.42,62.50
10,013,01,140,0002,0474,613,29,642,828,0,5,3,8,2,3,5,0.00,77.54,62.50
10,013,01,140,0003,0475,494,10,504,666,0,5,3,8,2,3,5,0.00,75.68,62.50
10,013,01,140,0004,0476,397,17,414,546,0,5,3,8,2,3,5,0.00,75.82,62.50
10,013,01,140,0005,0477,879,32,911,1247,0,5,3,8,2,3,5,0.00,73.06,62.50
10,013,01,140,0006,0478,669,19,688,915,0,5,3,8,2,3,5,0.00,75.19,62.50
10,013,01,140,0007,0479,451,18,469,604,0,5,3,8,2,3,5,0.00,77.65,62.50
10,013,01,150,0001,0000,1340,32,1372,1938,0,9,3,12,4,2,6,0.00,70.79,50.00
10,013,01,150,0002,0000,731,8,739,1011,0,9,3,12,4,2,6,0.00,73.10,50.00
10,013,01,150,0003,0000,609,34,643,875,0,9,3,12,4,2,6,0.00,73.49,50.00
10,013,01,150,0004,0000,475,10,485,719,0,9,3,12,4,2,6,0.00,67.45,50.00
10,013,01,150,0001,0489,493,6,499,708,0,9,3,12,4,2,6,0.00,70.48,50.00
10,013,01,150,0001,0490,632,25,657,939,0,9,3,12,4,2,6,0.00,69.97,50.00
10,013,01,150,0001,0491,215,1,216,291,0,9,3,12,4,2,6,0.00,74.23,50.00
10,013,01,150,0002,0492,506,5,511,703,0,9,3,12,4,2,6,0.00,72.69,50.00
10,013,01,150,0002,0493,225,3,228,308,0,9,3,12,4,2,6,0.00,74.03,50.00
10,013,01,150,0003,0494,609,34,643,875,0,9,3,12,4,2,6,0.00,73.49,50.00
10,013,01,150,0004,0495,475,10,485,719,0,9,3,12,4,2,6,0.00,67.45,50.00
10,013,01,160,0001,0000,770,8,778,1155,0,9,2,11,3,2,5,0.00,67.36,45.45
10,013,01,160,0002,0000,547,11,558,831,0,9,2,11,3,2,5,0.00,67.15,45.45
10,013,01,160,0003,0000,664,13,677,879,0,9,2,11,3,2,5,0.00,77.02,45.45
10,013,01,160,0004,0000,446,11,457,570,0,9,2,11,3,2,5,0.00,80.18,45.45
10,013,01,160,0005,0000,1053,19,1072,1494,0,9,2,11,3,2,5,0.00,71.75,45.45
10,013,01,160,0006,0000,2770,49,2819,4016,0,9,2,11,3,2,5,0.00,70.19,45.45
10,013,01,160,0001,0502,770,8,778,1155,0,9,2,11,3,2,5,0.00,67.36,45.45
10,013,01,160,0002,0503,547,11,558,831,0,9,2,11,3,2,5,0.00,67.15,45.45
10,013,01,160,0003,0504,664,13,677,879,0,9,2,11,3,2,5,0.00,77.02,45.45
10,013,01,160,0004,0505,446,11,457,570,0,9,2,11,3,2,5,0.00,80.18,45.45
10,013,01,160,0005,0506,558,14,572,793,0,9,2,11,3,2,5,0.00,72.13,45.45
10,013,01,160,0005,0507,495,5,500,701,0,9,2,11,3,2,5,0.00,71.33,45.45
10,013,01,160,0006,0508,678,12,690,973,0,9,2,11,3,2,5,0.00,70.91,45.45
10,013,01,160,0006,0509,730,5,735,1014,0,9,2,11,3,2,5,0.00,72.49,45.45
10,013,01,160,0006,0510,707,8,715,1044,0,9,2,11,3,2,5,0.00,68.49,45.45
10,013,01,160,0006,0511,655,24,679,985,0,9,2,11,3,2,5,0.00,68.93,45.45
10,013,01,170,0001,0000,1105,16,1121,1572,0,5,0,5,3,0,3,0.00,71.31,60.00
10,013,01,170,0002,0000,1657,41,1698,2401,0,5,0,5,3,0,3,0.00,70.72,60.00
10,013,01,170,0003,0000,1547,33,1580,2098,0,5,0,5,3,0,3,0.00,75.31,60.00
10,013,01,170,0004,0000,619,20,639,787,0,5,0,5,3,0,3,0.00,81.19,60.00
10,013,01,170,0001,0526,547,13,560,774,0,5,0,5,3,0,3,0.00,72.35,60.00
10,013,01,170,0001,0527,558,3,561,798,0,5,0,5,3,0,3,0.00,70.30,60.00
10,013,01,170,0002,0528,806,19,825,1165,0,5,0,5,3,0,3,0.00,70.82,60.00
10,013,01,170,0002,0529,851,22,873,1236,0,5,0,5,3,0,3,0.00,70.63,60.00
10,013,01,170,0003,0530,756,11,767,1012,0,5,0,5,3,0,3,0.00,75.79,60.00
10,013,01,170,0003,0531,791,22,813,1086,0,5,0,5,3,0,3,0.00,74.86,60.00
10,013,01,170,0004,0532,619,20,639,787,0,5,0,5,3,0,3,0.00,81.19,60.00
10,013,01,180,0001,0000,1469,27,1496,2157,0,2,4,6,1,3,4,0.00,69.36,66.67
10,013,01,180,0002,0000,1255,31,1286,1958,0,2,4,6,1,3,4,0.00,65.68,66.67
10,013,01,180,0001,0555,806,20,826,1174,0,2,4,6,1,3,4,0.00,70.36,66.67
10,013,01,180,0001,0556,663,7,670,983,0,2,4,6,1,3,4,0.00,68.16,66.67
10,013,01,180,0002,0557,494,11,505,771,0,2,4,6,1,3,4,0.00,65.50,66.67
10,013,01,180,0002,0558,761,20,781,1187,0,2,4,6,1,3,4,0.00,65.80,66.67
10,013,01,190,0001,0000,996,16,1012,1338,0,6,4,10,4,1,5,0.00,75.64,50.00
10,013,01,190,0002,0000,1108,27,1135,1481,0,6,4,10,4,1,5,0.00,76.64,50.00
10,013,01,190,0004,0000,489,10,499,642,0,6,4,10,4,1,5,0.00,77.73,50.00
10,013,01,190,0005,0000,2250,49,2299,3003,0,6,4,10,4,1,5,0.00,76.56,50.00
10,013,01,190,0001,0567,470,7,477,640,0,6,4,10,4,1,5,0.00,74.53,50.00
10,013,01,190,0001,0568,526,9,535,698,0,6,4,10,4,1,5,0.00,76.65,50.00
10,013,01,190,0002,0569,631,15,646,836,0,6,4,10,4,1,5,0.00,77.27,50.00
10,013,01,190,0002,0570,477,12,489,645,0,6,4,10,4,1,5,0.00,75.81,50.00
10,013,01,190,0005,0571,731,19,750,971,0,6,4,10,4,1,5,0.00,77.24,50.00
10,013,01,190,0005,0572,826,19,845,1089,0,6,4,10,4,1,5,0.00,77.59,50.00
10,013,01,190,0005,0573,693,11,704,943,0,6,4,10,4,1,5,0.00,74.66,50.00
10,013,01,190,0004,0574,489,10,499,642,0,6,4,10,4,1,5,0.00,77.73,50.00
10,013,01,200,0001,0000,1065,22,1087,1593,0,7,6,13,2,3,5,0.00,68.24,38.46
10,013,01,200,0002,0000,642,19,661,866,0,7,6,13,2,3,5,0.00,76.33,38.46
10,013,01,200,0005,0000,692,8,700,980,0,7,6,13,2,3,5,0.00,71.43,38.46
10,013,01,200,0006,0000,718,13,731,940,0,7,6,13,2,3,5,0.00,77.77,38.46
10,013,01,200,0001,0584,543,11,554,820,0,7,6,13,2,3,5,0.00,67.56,38.46
10,013,01,200,0001,0585,522,11,533,773,0,7,6,13,2,3,5,0.00,68.95,38.46
10,013,01,200,0002,0586,642,19,661,866,0,7,6,13,2,3,5,0.00,76.33,38.46
10,013,01,200,0005,0587,692,8,700,980,0,7,6,13,2,3,5,0.00,71.43,38.46
10,013,01,200,0006,0588,718,13,731,940,0,7,6,13,2,3,5,0.00,77.77,38.46
10,013,01,210,0001,0000,965,29,994,1415,0,4,2,6,2,2,4,0.00,70.25,66.67
10,013,01,210,0002,0000,840,25,865,1267,0,4,2,6,2,2,4,0.00,68.27,66.67
10,013,01,210,0003,0000,556,11,567,722,0,4,2,6,2,2,4,0.00,78.53,66.67
10,013,01,210,0004,0000,1159,37,1196,1734,0,4,2,6,2,2,4,0.00,68.97,66.67
10,013,01,210,0001,0595,965,29,994,1415,0,4,2,6,2,2,4,0.00,70.25,66.67
10,013,01,210,0002,0596,840,25,865,1267,0,4,2,6,2,2,4,0.00,68.27,66.67
10,013,01,210,0003,0597,556,11,567,722,0,4,2,6,2,2,4,0.00,78.53,66.67
10,013,01,210,0004,0598,612,18,630,883,0,4,2,6,2,2,4,0.00,71.35,66.67
10,013,01,210,0004,0599,547,19,566,851,0,4,2,6,2,2,4,0.00,66.51,66.67
10,013,01,220,0001,0000,1394,24,1418,2028,0,5,0,5,3,0,3,0.00,69.92,60.00
10,013,01,220,0002,0000,884,21,905,1211,0,5,0,5,3,0,3,0.00,74.73,60.00
10,013,01,220,0001,0611,703,12,715,1054,0,5,0,5,3,0,3,0.00,67.84,60.00
10,013,01,220,0001,0612,691,12,703,974,0,5,0,5,3,0,3,0.00,72.18,60.00
10,013,01,220,0002,0613,884,21,905,1211,0,5,0,5,3,0,3,0.00,74.73,60.00
10,013,01,230,0003,0000,313,156,469,610,0,1,0,1,1,0,1,0.00,76.89,100.00
10,013,01,230,0004,0000,340,115,455,677,0,1,0,1,1,0,1,0.00,67.21,100.00
10,013,01,230,0004,0620,340,115,455,677,0,1,0,1,1,0,1,0.00,67.21,100.00
10,013,01,230,0003,0621,313,156,469,610,0,1,0,1,1,0,1,0.00,76.89,100.00
10,013,01,240,0001,0000,949,17,966,1237,0,4,0,4,2,0,2,0.00,78.09,50.00
10,013,01,240,0002,0000,210,3,213,257,0,4,0,4,2,0,2,0.00,82.88,50.00
10,013,01,240,0005,0000,420,1,421,494,0,4,0,4,2,0,2,0.00,85.22,50.00
10,013,01,240,0001,0633,949,17,966,1237,0,4,0,4,2,0,2,0.00,78.09,50.00
10,013,01,240,0002,0634,210,3,213,257,0,4,0,4,2,0,2,0.00,82.88,50.00
10,013,01,240,0005,0635,420,1,421,494,0,4,0,4,2,0,2,0.00,85.22,50.00
10,013,01,250,0001,0000,798,18,816,972,0,2,0,2,1,0,1,0.00,83.95,50.00
10,013,01,250,0001,0641,475,6,481,560,0,2,0,2,1,0,1,0.00,85.89,50.00
10,013,01,250,0001,0642,323,12,335,412,0,2,0,2,1,0,1,0.00,81.31,50.00
10,013,01,260,0001,0000,1154,18,1172,1438,0,4,3,7,1,2,3,0.00,81.50,42.86
10,013,01,260,0002,0000,279,4,283,326,0,4,3,7,1,2,3,0.00,86.81,42.86
10,013,01,260,0003,0000,466,11,477,565,0,4,3,7,1,2,3,0.00,84.42,42.86
10,013,01,260,0004,0000,495,10,505,628,0,4,3,7,1,2,3,0.00,80.41,42.86
10,013,01,260,0004,0647,495,10,505,628,0,4,3,7,1,2,3,0.00,80.41,42.86
10,013,01,260,0003,0648,466,11,477,565,0,4,3,7,1,2,3,0.00,84.42,42.86
10,013,01,260,0002,0649,279,4,283,326,0,4,3,7,1,2,3,0.00,86.81,42.86
10,013,01,260,0001,0650,1154,18,1172,1438,0,4,3,7,1,2,3,0.00,81.50,42.86
10,013,01,270,0001,0000,987,6,993,1141,0,3,2,5,2,2,4,0.00,87.03,80.00
10,013,01,270,0002,0000,271,0,271,309,0,3,2,5,2,2,4,0.00,87.70,80.00
10,013,01,270,0003,0000,148,1,149,180,0,3,2,5,2,2,4,0.00,82.78,80.00
10,013,01,270,0001,0657,290,1,291,331,0,3,2,5,2,2,4,0.00,87.92,80.00
10,013,01,270,0001,0658,580,5,585,658,0,3,2,5,2,2,4,0.00,88.91,80.00
10,013,01,270,0001,0659,117,0,117,152,0,3,2,5,2,2,4,0.00,76.97,80.00
10,013,01,270,0003,0660,148,1,149,180,0,3,2,5,2,2,4,0.00,82.78,80.00
10,013,01,270,0002,0661,271,0,271,309,0,3,2,5,2,2,4,0.00,87.70,80.00
10,013,01,280,0001,0000,391,2,393,442,0,8,2,10,3,1,4,0.00,88.91,40.00
10,013,01,280,0002,0000,666,5,671,783,0,8,2,10,3,1,4,0.00,85.70,40.00
10,013,01,280,0006,0000,1651,20,1671,2026,0,8,2,10,3,1,4,0.00,82.48,40.00
10,013,01,280,0001,0665,391,2,393,442,0,8,2,10,3,1,4,0.00,88.91,40.00
10,013,01,280,0002,0666,666,5,671,783,0,8,2,10,3,1,4,0.00,85.70,40.00
10,013,01,280,0006,0667,538,7,545,668,0,8,2,10,3,1,4,0.00,81.59,40.00
10,013,01,280,0006,0668,591,9,600,713,0,8,2,10,3,1,4,0.00,84.15,40.00
10,013,01,280,0006,0669,522,4,526,645,0,8,2,10,3,1,4,0.00,81.55,40.00
10,013,01,290,0001,0000,688,6,694,815,0,5,3,8,4,1,5,0.00,85.15,62.50
10,013,01,290,0002,0000,793,8,801,940,0,5,3,8,4,1,5,0.00,85.21,62.50
10,013,01,290,0003,0000,496,12,508,591,0,5,3,8,4,1,5,0.00,85.96,62.50
10,013,01,290,0006,0000,595,12,607,717,0,5,3,8,4,1,5,0.00,84.66,62.50
10,013,01,290,0001,0673,532,5,537,619,0,5,3,8,4,1,5,0.00,86.75,62.50
10,013,01,290,0001,0674,156,1,157,196,0,5,3,8,4,1,5,0.00,80.10,62.50
10,013,01,290,0002,0675,793,8,801,940,0,5,3,8,4,1,5,0.00,85.21,62.50
10,013,01,290,0003,0676,496,12,508,591,0,5,3,8,4,1,5,0.00,85.96,62.50
10,013,01,290,0006,0677,595,12,607,717,0,5,3,8,4,1,5,0.00,84.66,62.50
10,013,01,300,0001,0000,765,7,772,900,0,5,3,8,3,1,4,0.00,85.78,50.00
10,013,01,300,0002,0000,473,5,478,554,0,5,3,8,3,1,4,0.00,86.28,50.00
10,013,01,300,0003,0000,607,7,614,722,0,5,3,8,3,1,4,0.00,85.04,50.00
10,013,01,300,0004,0000,811,8,819,1097,0,5,3,8,3,1,4,0.00,74.66,50.00
10,013,01,300,0001,0680,765,7,772,900,0,5,3,8,3,1,4,0.00,85.78,50.00
10,013,01,300,0002,0681,309,4,313,354,0,5,3,8,3,1,4,0.00,88.42,50.00
10,013,01,300,0002,0682,164,1,165,200,0,5,3,8,3,1,4,0.00,82.50,50.00
10,013,01,300,0003,0683,377,6,383,448,0,5,3,8,3,1,4,0.00,85.49,50.00
10,013,01,300,0003,0684,230,1,231,274,0,5,3,8,3,1,4,0.00,84.31,50.00
10,013,01,300,0004,0685,811,8,819,1097,0,5,3,8,3,1,4,0.00,74.66,50.00
10,013,01,310,0001,0000,709,9,718,878,0,3,1,4,2,1,3,0.00,81.78,75.00
10,013,01,310,0002,0000,510,9,519,659,0,3,1,4,2,1,3,0.00,78.76,75.00
10,013,01,310,0003,0000,252,6,258,292,0,3,1,4,2,1,3,0.00,88.36,75.00
10,013,01,310,0001,0690,709,9,718,878,0,3,1,4,2,1,3,0.00,81.78,75.00
10,013,01,310,0002,0691,510,9,519,659,0,3,1,4,2,1,3,0.00,78.76,75.00
10,013,01,310,0003,0692,252,6,258,292,0,3,1,4,2,1,3,0.00,88.36,75.00
10,013,01,320,0001,0000,568,5,573,711,0,4,2,6,3,1,4,0.00,80.59,66.67
10,013,01,320,0002,0000,582,5,587,745,0,4,2,6,3,1,4,0.00,78.79,66.67
10,013,01,320,0003,0000,487,11,498,628,0,4,2,6,3,1,4,0.00,79.30,66.67
10,013,01,320,0004,0000,166,4,170,221,0,4,2,6,3,1,4,0.00,76.92,66.67
10,013,01,320,0004,0696,166,4,170,221,0,4,2,6,3,1,4,0.00,76.92,66.67
10,013,01,320,0003,0697,487,11,498,628,0,4,2,6,3,1,4,0.00,79.30,66.67
10,013,01,320,0002,0698,582,5,587,745,0,4,2,6,3,1,4,0.00,78.79,66.67
10,013,01,320,0001,0699,568,5,573,711,0,4,2,6,3,1,4,0.00,80.59,66.67
10,013,01,330,0001,0000,1141,29,1170,1546,0,5,2,7,4,1,5,0.00,75.68,71.43
10,013,01,330,0002,0000,465,10,475,640,0,5,2,7,4,1,5,0.00,74.22,71.43
10,013,01,330,0003,0000,335,8,343,424,0,5,2,7,4,1,5,0.00,80.90,71.43
10,013,01,330,0004,0000,292,3,295,348,0,5,2,7,4,1,5,0.00,84.77,71.43
10,013,01,330,0001,0704,559,17,576,740,0,5,2,7,4,1,5,0.00,77.84,71.43
10,013,01,330,0001,0705,371,9,380,501,0,5,2,7,4,1,5,0.00,75.85,71.43
10,013,01,330,0001,0706,211,3,214,305,0,5,2,7,4,1,5,0.00,70.16,71.43
10,013,01,330,0002,0707,465,10,475,640,0,5,2,7,4,1,5,0.00,74.22,71.43
10,013,01,330,0003,0708,335,8,343,424,0,5,2,7,4,1,5,0.00,80.90,71.43
10,013,01,330,0004,0709,292,3,295,348,0,5,2,7,4,1,5,0.00,84.77,71.43
10,013,00,020,0000,0000,26763,824,27587,44974,53117,11,5,16,7,5,12,84.67,61.34,75.00
10,013,01,020,0000,0000,12466,352,12818,21452,25501,4,3,7,3,3,6,84.12,59.75,85.71
10,013,02,020,0000,0000,11150,370,11520,18867,22328,4,2,6,3,2,5,84.50,61.06,83.33
10,013,03,020,0000,0000,3147,102,3249,4655,5288,3,0,3,1,0,1,88.03,69.80,33.33
10,013,02,010,0015,0009,683,36,719,1026,0,2,6,8,2,3,5,0.00,70.08,62.50
10,013,02,010,0015,0010,609,43,652,991,0,2,6,8,2,3,5,0.00,65.79,62.50
10,013,02,010,0018,0011,730,75,805,1110,0,2,6,8,2,3,5,0.00,72.52,62.50
10,013,02,010,0020,0012,831,35,866,1450,0,2,6,8,2,3,5,0.00,59.72,62.50
10,013,02,010,0021,0013,570,26,596,976,0,2,6,8,2,3,5,0.00,61.07,62.50
10,013,02,010,0026,0014,665,31,696,1242,0,2,6,8,2,3,5,0.00,56.04,62.50
10,013,02,010,0026,0015,687,37,724,1295,0,2,6,8,2,3,5,0.00,55.91,62.50
10,013,02,010,0026,0016,752,48,800,1415,0,2,6,8,2,3,5,0.00,56.54,62.50
10,013,02,010,0082,0017,661,29,690,1144,0,2,6,8,2,3,5,0.00,60.31,62.50
10,013,02,010,0082,0018,743,32,775,1259,0,2,6,8,2,3,5,0.00,61.56,62.50
10,013,02,010,0082,0019,634,32,666,1113,0,2,6,8,2,3,5,0.00,59.84,62.50
10,013,02,010,0082,0020,636,26,662,1161,0,2,6,8,2,3,5,0.00,57.02,62.50
10,013,02,010,0025,0021,658,33,691,1198,0,2,6,8,2,3,5,0.00,57.68,62.50
10,013,02,010,0025,0022,652,33,685,1248,0,2,6,8,2,3,5,0.00,54.89,62.50
10,013,02,010,0025,0023,629,31,660,1259,0,2,6,8,2,3,5,0.00,52.42,62.50
10,013,02,010,0023,0024,773,28,801,1245,0,2,6,8,2,3,5,0.00,64.34,62.50
10,013,02,010,0023,0025,656,22,678,1111,0,2,6,8,2,3,5,0.00,61.03,62.50
10,013,02,010,0024,0026,648,23,671,1122,0,2,6,8,2,3,5,0.00,59.80,62.50
10,013,02,010,0024,0027,545,25,570,949,0,2,6,8,2,3,5,0.00,60.06,62.50
10,013,02,010,0024,0028,697,43,740,1192,0,2,6,8,2,3,5,0.00,62.08,62.50
10,013,02,010,0022,0029,528,25,553,953,0,2,6,8,2,3,5,0.00,58.03,62.50
10,013,02,010,0022,0030,368,20,388,646,0,2,6,8,2,3,5,0.00,60.06,62.50
10,013,02,010,0030,0031,729,29,758,1351,0,2,6,8,2,3,5,0.00,56.11,62.50
10,013,02,010,0030,0032,773,25,798,1389,0,2,6,8,2,3,5,0.00,57.45,62.50
10,013,02,010,0030,0033,780,21,801,1426,0,2,6,8,2,3,5,0.00,56.17,62.50
10,013,02,010,0030,0034,672,28,700,1346,0,2,6,8,2,3,5,0.00,52.01,62.50
10,013,02,010,0030,0035,776,21,797,1353,0,2,6,8,2,3,5,0.00,58.91,62.50
10,013,02,010,0028,0036,691,21,712,1016,0,2,6,8,2,3,5,0.00,70.08,62.50
10,013,02,010,0027,0037,920,29,949,1429,0,2,6,8,2,3,5,0.00,66.41,62.50
10,013,02,010,0029,0038,671,18,689,1057,0,2,6,8,2,3,5,0.00,65.18,62.50
10,013,02,010,0015,0000,1292,79,1371,2017,0,2,6,8,2,3,5,0.00,67.97,62.50
10,013,02,010,0018,0000,730,75,805,1110,0,2,6,8,2,3,5,0.00,72.52,62.50
10,013,02,010,0020,0000,831,35,866,1450,0,2,6,8,2,3,5,0.00,59.72,62.50
10,013,02,010,0021,0000,570,26,596,976,0,2,6,8,2,3,5,0.00,61.07,62.50
10,013,02,010,0022,0000,896,45,941,1599,0,2,6,8,2,3,5,0.00,58.85,62.50
10,013,02,010,0023,0000,1429,50,1479,2356,0,2,6,8,2,3,5,0.00,62.78,62.50
10,013,02,010,0024,0000,1890,91,1981,3263,0,2,6,8,2,3,5,0.00,60.71,62.50
10,013,02,010,0025,0000,1939,97,2036,3705,0,2,6,8,2,3,5,0.00,54.95,62.50
10,013,02,010,0026,0000,2104,116,2220,3952,0,2,6,8,2,3,5,0.00,56.17,62.50
10,013,02,010,0027,0000,920,29,949,1429,0,2,6,8,2,3,5,0.00,66.41,62.50
10,013,02,010,0028,0000,691,21,712,1016,0,2,6,8,2,3,5,0.00,70.08,62.50
10,013,02,010,0029,0000,671,18,689,1057,0,2,6,8,2,3,5,0.00,65.18,62.50
10,013,02,010,0030,0000,3730,124,3854,6865,0,2,6,8,2,3,5,0.00,56.14,62.50
10,013,02,010,0082,0000,2674,119,2793,4677,0,2,6,8,2,3,5,0.00,59.72,62.50
10,013,02,020,0003,0000,738,32,770,1187,0,4,2,6,3,2,5,0.00,64.87,83.33
10,013,02,020,0004,0000,554,18,572,918,0,4,2,6,3,2,5,0.00,62.31,83.33
10,013,02,020,0010,0000,866,38,904,1365,0,4,2,6,3,2,5,0.00,66.23,83.33
10,013,02,020,0011,0000,1371,54,1425,2306,0,4,2,6,3,2,5,0.00,61.80,83.33
10,013,02,020,0012,0000,1443,41,1484,2386,0,4,2,6,3,2,5,0.00,62.20,83.33
10,013,02,020,0013,0000,3860,130,3990,6897,0,4,2,6,3,2,5,0.00,57.85,83.33
10,013,02,020,0014,0000,639,13,652,1116,0,4,2,6,3,2,5,0.00,58.42,83.33
10,013,02,020,0015,0000,843,16,859,1390,0,4,2,6,3,2,5,0.00,61.80,83.33
10,013,02,020,0016,0000,535,15,550,867,0,4,2,6,3,2,5,0.00,63.44,83.33
10,013,02,020,0004,0161,554,18,572,918,0,4,2,6,3,2,5,0.00,62.31,83.33
10,013,02,020,0003,0162,738,32,770,1187,0,4,2,6,3,2,5,0.00,64.87,83.33
10,013,02,020,0010,0163,866,38,904,1365,0,4,2,6,3,2,5,0.00,66.23,83.33
10,013,02,020,0011,0164,719,32,751,1245,0,4,2,6,3,2,5,0.00,60.32,83.33
10,013,02,020,0011,0165,652,22,674,1061,0,4,2,6,3,2,5,0.00,63.52,83.33
10,013,02,020,0012,0166,823,30,853,1366,0,4,2,6,3,2,5,0.00,62.45,83.33
10,013,02,020,0012,0167,620,11,631,1020,0,4,2,6,3,2,5,0.00,61.86,83.33
10,013,02,020,0013,0168,590,16,606,1028,0,4,2,6,3,2,5,0.00,58.95,83.33
10,013,02,020,0013,0169,688,21,709,1197,0,4,2,6,3,2,5,0.00,59.23,83.33
10,013,02,020,0017,0000,301,13,314,435,0,4,2,6,3,2,5,0.00,72.18,83.33
10,013,02,020,0013,0170,595,30,625,1086,0,4,2,6,3,2,5,0.00,57.55,83.33
10,013,02,020,0013,0171,651,17,668,1148,0,4,2,6,3,2,5,0.00,58.19,83.33
10,013,02,020,0013,0172,697,27,724,1296,0,4,2,6,3,2,5,0.00,55.86,83.33
10,013,02,020,0013,0173,639,19,658,1142,0,4,2,6,3,2,5,0.00,57.62,83.33
10,013,02,020,0014,0174,639,13,652,1116,0,4,2,6,3,2,5,0.00,58.42,83.33
10,013,02,020,0015,0175,843,16,859,1390,0,4,2,6,3,2,5,0.00,61.80,83.33
10,013,02,020,0016,0176,535,15,550,867,0,4,2,6,3,2,5,0.00,63.44,83.33
10,013,02,020,0017,0177,301,13,314,435,0,4,2,6,3,2,5,0.00,72.18,83.33
10,013,02,030,0007,0000,948,27,975,1502,0,2,0,2,1,0,1,0.00,64.91,50.00
10,013,02,030,0009,0000,734,34,768,1127,0,2,0,2,1,0,1,0.00,68.15,50.00
10,013,02,030,0023,0198,597,24,621,884,0,2,0,2,1,0,1,0.00,70.25,50.00
10,013,02,030,0023,0199,607,18,625,886,0,2,0,2,1,0,1,0.00,70.54,50.00
10,013,02,030,0007,0200,474,17,491,747,0,2,0,2,1,0,1,0.00,65.73,50.00
10,013,02,030,0007,0201,474,10,484,755,0,2,0,2,1,0,1,0.00,64.11,50.00
10,013,02,030,0009,0202,734,34,768,1127,0,2,0,2,1,0,1,0.00,68.15,50.00
10,013,02,030,0023,0000,1204,42,1246,1770,0,2,0,2,1,0,1,0.00,70.40,50.00
10,013,02,040,0005,0000,1731,68,1799,3036,0,5,2,7,2,1,3,0.00,59.26,42.86
10,013,02,040,0006,0000,515,16,531,827,0,5,2,7,2,1,3,0.00,64.21,42.86
10,013,02,040,0007,0000,289,7,296,474,0,5,2,7,2,1,3,0.00,62.45,42.86
10,013,02,040,0008,0000,367,11,378,465,0,5,2,7,2,1,3,0.00,81.29,42.86
10,013,02,040,0009,0000,635,14,649,975,0,5,2,7,2,1,3,0.00,66.56,42.86
10,013,02,040,0010,0000,582,47,629,909,0,5,2,7,2,1,3,0.00,69.20,42.86
10,013,02,040,0005,0230,613,27,640,1074,0,5,2,7,2,1,3,0.00,59.59,42.86
10,013,02,040,0005,0231,546,22,568,957,0,5,2,7,2,1,3,0.00,59.35,42.86
10,013,02,040,0005,0232,572,19,591,1005,0,5,2,7,2,1,3,0.00,58.81,42.86
10,013,02,040,0006,0233,515,16,531,827,0,5,2,7,2,1,3,0.00,64.21,42.86
10,013,02,040,0007,0234,289,7,296,474,0,5,2,7,2,1,3,0.00,62.45,42.86
10,013,02,040,0008,0235,367,11,378,465,0,5,2,7,2,1,3,0.00,81.29,42.86
10,013,02,040,0009,0236,635,14,649,975,0,5,2,7,2,1,3,0.00,66.56,42.86
10,013,02,040,0010,0237,582,47,629,909,0,5,2,7,2,1,3,0.00,69.20,42.86
10,013,02,050,0001,0000,354,13,367,550,0,5,3,8,2,2,4,0.00,66.73,50.00
10,013,02,050,0002,0000,589,20,609,806,0,5,3,8,2,2,4,0.00,75.56,50.00
10,013,02,050,0003,0000,2060,70,2130,3201,0,5,3,8,2,2,4,0.00,66.54,50.00
10,013,02,050,0004,0000,480,14,494,695,0,5,3,8,2,2,4,0.00,71.08,50.00
10,013,02,050,0005,0000,885,40,925,1381,0,5,3,8,2,2,4,0.00,66.98,50.00
10,013,02,050,0006,0000,1489,51,1540,2177,0,5,3,8,2,2,4,0.00,70.74,50.00
10,013,02,050,0007,0000,1337,53,1390,1989,0,5,3,8,2,2,4,0.00,69.88,50.00
10,013,02,050,0008,0000,1024,57,1081,1582,0,5,3,8,2,2,4,0.00,68.33,50.00
10,013,02,050,0010,0000,655,34,689,969,0,5,3,8,2,2,4,0.00,71.10,50.00
10,013,02,050,0021,0000,1166,47,1213,1648,0,5,3,8,2,2,4,0.00,73.60,50.00
10,013,02,050,0002,0263,589,20,609,806,0,5,3,8,2,2,4,0.00,75.56,50.00
10,013,02,050,0003,0264,683,22,705,1088,0,5,3,8,2,2,4,0.00,64.80,50.00
10,013,02,050,0003,0265,671,29,700,1048,0,5,3,8,2,2,4,0.00,66.79,50.00
10,013,02,050,0003,0266,706,19,725,1065,0,5,3,8,2,2,4,0.00,68.08,50.00
10,013,02,050,0004,0267,480,14,494,695,0,5,3,8,2,2,4,0.00,71.08,50.00
10,013,02,050,0001,0268,354,13,367,550,0,5,3,8,2,2,4,0.00,66.73,50.00
10,013,02,050,0005,0269,885,40,925,1381,0,5,3,8,2,2,4,0.00,66.98,50.00
10,013,02,050,0006,0270,683,21,704,1032,0,5,3,8,2,2,4,0.00,68.22,50.00
10,013,02,050,0006,0271,806,30,836,1145,0,5,3,8,2,2,4,0.00,73.01,50.00
10,013,02,050,0007,0272,621,27,648,938,0,5,3,8,2,2,4,0.00,69.08,50.00
10,013,02,050,0007,0273,716,26,742,1051,0,5,3,8,2,2,4,0.00,70.60,50.00
10,013,02,050,0008,0274,508,44,552,816,0,5,3,8,2,2,4,0.00,67.65,50.00
10,013,02,050,0008,0275,516,13,529,766,0,5,3,8,2,2,4,0.00,69.06,50.00
10,013,02,050,0021,0276,578,15,593,783,0,5,3,8,2,2,4,0.00,75.73,50.00
10,013,02,050,0021,0277,588,32,620,865,0,5,3,8,2,2,4,0.00,71.68,50.00
10,013,02,050,0010,0278,655,34,689,969,0,5,3,8,2,2,4,0.00,71.10,50.00
10,013,02,060,0006,0000,624,13,637,873,0,4,0,4,3,0,3,0.00,72.97,75.00
10,013,02,060,0007,0000,710,19,729,995,0,4,0,4,3,0,3,0.00,73.27,75.00
10,013,02,060,0008,0000,951,40,991,1426,0,4,0,4,3,0,3,0.00,69.50,75.00
10,013,02,060,0009,0000,1021,34,1055,1610,0,4,0,4,3,0,3,0.00,65.53,75.00
10,013,02,060,0010,0000,690,26,716,1110,0,4,0,4,3,0,3,0.00,64.50,75.00
10,013,02,060,0011,0000,511,16,527,708,0,4,0,4,3,0,3,0.00,74.44,75.00
10,013,02,060,0009,0307,1021,34,1055,1610,0,4,0,4,3,0,3,0.00,65.53,75.00
10,013,02,060,0010,0308,690,26,716,1110,0,4,0,4,3,0,3,0.00,64.50,75.00
10,013,02,060,0011,0309,511,16,527,708,0,4,0,4,3,0,3,0.00,74.44,75.00
10,013,02,060,0008,0310,951,40,991,1426,0,4,0,4,3,0,3,0.00,69.50,75.00
10,013,02,060,0006,0311,624,13,637,873,0,4,0,4,3,0,3,0.00,72.97,75.00
10,013,02,060,0007,0312,710,19,729,995,0,4,0,4,3,0,3,0.00,73.27,75.00
10,013,02,070,0002,0000,637,14,651,895,0,4,0,4,3,0,3,0.00,72.74,75.00
10,013,02,070,0003,0000,959,32,991,1396,0,4,0,4,3,0,3,0.00,70.99,75.00
10,013,02,070,0002,0322,637,14,651,895,0,4,0,4,3,0,3,0.00,72.74,75.00
10,013,02,070,0003,0323,438,14,452,642,0,4,0,4,3,0,3,0.00,70.40,75.00
10,013,02,070,0003,0324,521,18,539,754,0,4,0,4,3,0,3,0.00,71.49,75.00
10,013,02,080,0004,0000,724,71,795,1196,0,3,1,4,3,1,4,0.00,66.47,100.00
10,013,02,080,0010,0000,2778,265,3043,4512,0,3,1,4,3,1,4,0.00,67.44,100.00
10,013,02,080,0011,0000,1033,89,1122,1523,0,3,1,4,3,1,4,0.00,73.67,100.00
10,013,02,080,0004,0334,724,71,795,1196,0,3,1,4,3,1,4,0.00,66.47,100.00
10,013,02,080,0011,0335,652,70,722,964,0,3,1,4,3,1,4,0.00,74.90,100.00
10,013,02,080,0011,0336,381,19,400,559,0,3,1,4,3,1,4,0.00,71.56,100.00
10,013,02,080,0010,0337,428,41,469,631,0,3,1,4,3,1,4,0.00,74.33,100.00
10,013,02,080,0010,0338,635,60,695,1041,0,3,1,4,3,1,4,0.00,66.76,100.00
10,013,02,080,0010,0339,568,61,629,986,0,3,1,4,3,1,4,0.00,63.79,100.00
10,013,02,080,0010,0340,726,73,799,1151,0,3,1,4,3,1,4,0.00,69.42,100.00
10,013,02,080,0010,0341,421,30,451,703,0,3,1,4,3,1,4,0.00,64.15,100.00
10,013,02,090,0002,0000,674,14,688,1051,0,5,0,5,3,0,3,0.00,65.46,60.00
10,013,02,090,0003,0000,593,12,605,819,0,5,0,5,3,0,3,0.00,73.87,60.00
10,013,02,090,0004,0000,840,25,865,1298,0,5,0,5,3,0,3,0.00,66.64,60.00
10,013,02,090,0005,0000,1280,34,1314,1956,0,5,0,5,3,0,3,0.00,67.18,60.00
10,013,02,090,0002,0350,674,14,688,1051,0,5,0,5,3,0,3,0.00,65.46,60.00
10,013,02,090,0003,0351,593,12,605,819,0,5,0,5,3,0,3,0.00,73.87,60.00
10,013,02,090,0004,0352,840,25,865,1298,0,5,0,5,3,0,3,0.00,66.64,60.00
10,013,02,090,0005,0353,608,17,625,918,0,5,0,5,3,0,3,0.00,68.08,60.00
10,013,02,090,0005,0354,672,17,689,1038,0,5,0,5,3,0,3,0.00,66.38,60.00
10,013,02,100,0007,0000,1234,57,1291,1707,0,2,0,2,1,0,1,0.00,75.63,50.00
10,013,02,100,0009,0000,688,38,726,868,0,2,0,2,1,0,1,0.00,83.64,50.00
10,013,02,100,0007,0376,574,34,608,807,0,2,0,2,1,0,1,0.00,75.34,50.00
10,013,02,100,0007,0377,660,23,683,900,0,2,0,2,1,0,1,0.00,75.89,50.00
10,013,02,100,0009,0378,688,38,726,868,0,2,0,2,1,0,1,0.00,83.64,50.00
10,013,02,110,0008,0000,548,23,571,727,0,3,0,3,2,0,2,0.00,78.54,66.67
10,013,02,110,0009,0000,368,15,383,597,0,3,0,3,2,0,2,0.00,64.15,66.67
10,013,02,110,0010,0000,737,18,755,1129,0,3,0,3,2,0,2,0.00,66.87,66.67
10,013,02,110,0011,0000,918,37,955,1374,0,3,0,3,2,0,2,0.00,69.51,66.67
10,013,02,110,0008,0397,548,23,571,727,0,3,0,3,2,0,2,0.00,78.54,66.67
10,013,02,110,0009,0398,368,15,383,597,0,3,0,3,2,0,2,0.00,64.15,66.67
10,013,02,110,0010,0399,737,18,755,1129,0,3,0,3,2,0,2,0.00,66.87,66.67
10,013,02,110,0011,0400,459,21,480,699,0,3,0,3,2,0,2,0.00,68.67,66.67
10,013,02,110,0011,0401,459,16,475,675,0,3,0,3,2,0,2,0.00,70.37,66.67
10,013,02,120,0006,0000,661,32,693,1041,0,4,0,4,2,0,2,0.00,66.57,50.00
10,013,02,120,0007,0000,614,19,633,941,0,4,0,4,2,0,2,0.00,67.27,50.00
10,013,02,120,0008,0000,809,48,857,1357,0,4,0,4,2,0,2,0.00,63.15,50.00
10,013,02,120,0006,0419,661,32,693,1041,0,4,0,4,2,0,2,0.00,66.57,50.00
10,013,02,120,0007,0420,614,19,633,941,0,4,0,4,2,0,2,0.00,67.27,50.00
10,013,02,120,0008,0421,809,48,857,1357,0,4,0,4,2,0,2,0.00,63.15,50.00
10,013,02,130,0008,0000,1775,58,1833,3059,0,4,1,5,2,1,3,0.00,59.92,60.00
10,013,02,130,0009,0000,987,30,1017,1529,0,4,1,5,2,1,3,0.00,66.51,60.00
10,013,02,130,0010,0000,1013,43,1056,1787,0,4,1,5,2,1,3,0.00,59.09,60.00
10,013,02,130,0011,0000,1052,37,1089,1770,0,4,1,5,2,1,3,0.00,61.53,60.00
10,013,02,130,0008,0446,634,21,655,1076,0,4,1,5,2,1,3,0.00,60.87,60.00
10,013,02,130,0008,0447,611,23,634,992,0,4,1,5,2,1,3,0.00,63.91,60.00
10,013,02,130,0008,0448,530,14,544,991,0,4,1,5,2,1,3,0.00,54.89,60.00
10,013,02,130,0009,0449,458,12,470,712,0,4,1,5,2,1,3,0.00,66.01,60.00
10,013,02,130,0009,0450,529,18,547,817,0,4,1,5,2,1,3,0.00,66.95,60.00
10,013,02,130,0010,0451,523,11,534,905,0,4,1,5,2,1,3,0.00,59.01,60.00
10,013,02,130,0010,0452,490,32,522,882,0,4,1,5,2,1,3,0.00,59.18,60.00
10,013,02,130,0011,0453,321,11,332,513,0,4,1,5,2,1,3,0.00,64.72,60.00
10,013,02,130,0011,0454,731,26,757,1257,0,4,1,5,2,1,3,0.00,60.22,60.00
10,013,02,140,0008,0000,364,5,369,445,0,5,0,5,3,0,3,0.00,82.92,60.00
10,013,02,140,0009,0000,1533,36,1569,2288,0,5,0,5,3,0,3,0.00,68.58,60.00
10,013,02,140,0010,0000,372,9,381,454,0,5,0,5,3,0,3,0.00,83.92,60.00
10,013,02,140,0011,0000,489,24,513,821,0,5,0,5,3,0,3,0.00,62.48,60.00
10,013,02,140,0008,0480,364,5,369,445,0,5,0,5,3,0,3,0.00,82.92,60.00
10,013,02,140,0009,0481,787,17,804,1168,0,5,0,5,3,0,3,0.00,68.84,60.00
10,013,02,140,0009,0482,746,19,765,1120,0,5,0,5,3,0,3,0.00,68.30,60.00
10,013,02,140,0010,0483,372,9,381,454,0,5,0,5,3,0,3,0.00,83.92,60.00
10,013,02,140,0011,0484,489,24,513,821,0,5,0,5,3,0,3,0.00,62.48,60.00
10,013,02,150,0005,0000,1195,36,1231,1723,0,7,2,9,4,1,5,0.00,71.45,55.56
10,013,02,150,0006,0000,818,12,830,1084,0,7,2,9,4,1,5,0.00,76.57,55.56
10,013,02,150,0007,0000,944,18,962,1220,0,7,2,9,4,1,5,0.00,78.85,55.56
10,013,02,150,0005,0496,266,8,274,353,0,7,2,9,4,1,5,0.00,77.62,55.56
10,013,02,150,0005,0497,427,13,440,669,0,7,2,9,4,1,5,0.00,65.77,55.56
10,013,02,150,0005,0498,502,15,517,701,0,7,2,9,4,1,5,0.00,73.75,55.56
10,013,02,150,0007,0499,944,18,962,1220,0,7,2,9,4,1,5,0.00,78.85,55.56
10,013,02,150,0006,0500,395,5,400,528,0,7,2,9,4,1,5,0.00,75.76,55.56
10,013,02,150,0006,0501,423,7,430,556,0,7,2,9,4,1,5,0.00,77.34,55.56
10,013,02,160,0007,0000,1052,103,1155,1815,0,2,2,4,2,2,4,0.00,63.64,100.00
10,013,02,160,0008,0000,829,79,908,1346,0,2,2,4,2,2,4,0.00,67.46,100.00
10,013,02,160,0009,0000,1181,105,1286,1952,0,2,2,4,2,2,4,0.00,65.88,100.00
10,013,02,160,0010,0000,402,44,446,651,0,2,2,4,2,2,4,0.00,68.51,100.00
10,013,02,160,0011,0000,483,36,519,854,0,2,2,4,2,2,4,0.00,60.77,100.00
10,013,02,160,0007,0512,529,51,580,900,0,2,2,4,2,2,4,0.00,64.44,100.00
10,013,02,160,0007,0513,523,52,575,915,0,2,2,4,2,2,4,0.00,62.84,100.00
10,013,02,160,0008,0514,405,47,452,670,0,2,2,4,2,2,4,0.00,67.46,100.00
10,013,02,160,0008,0515,424,32,456,676,0,2,2,4,2,2,4,0.00,67.46,100.00
10,013,02,160,0009,0516,571,43,614,958,0,2,2,4,2,2,4,0.00,64.09,100.00
10,013,02,160,0009,0517,610,62,672,994,0,2,2,4,2,2,4,0.00,67.61,100.00
10,013,02,160,0010,0518,402,44,446,651,0,2,2,4,2,2,4,0.00,68.51,100.00
10,013,02,160,0011,0519,483,36,519,854,0,2,2,4,2,2,4,0.00,60.77,100.00
10,013,02,170,0005,0000,521,22,543,778,0,5,0,5,3,0,3,0.00,69.79,60.00
10,013,02,170,0006,0000,1533,50,1583,2213,0,5,0,5,3,0,3,0.00,71.53,60.00
10,013,02,170,0007,0000,1480,24,1504,2117,0,5,0,5,3,0,3,0.00,71.04,60.00
10,013,02,170,0012,0000,1371,33,1404,1973,0,5,0,5,3,0,3,0.00,71.16,60.00
10,013,02,170,0005,0533,521,22,543,778,0,5,0,5,3,0,3,0.00,69.79,60.00
10,013,02,170,0006,0534,745,30,775,1134,0,5,0,5,3,0,3,0.00,68.34,60.00
10,013,02,170,0006,0535,788,20,808,1079,0,5,0,5,3,0,3,0.00,74.88,60.00
10,013,02,170,0007,0536,688,17,705,1034,0,5,0,5,3,0,3,0.00,68.18,60.00
10,013,02,170,0007,0537,792,7,799,1083,0,5,0,5,3,0,3,0.00,73.78,60.00
10,013,02,170,0012,0538,675,11,686,948,0,5,0,5,3,0,3,0.00,72.36,60.00
10,013,02,170,0012,0539,696,22,718,1025,0,5,0,5,3,0,3,0.00,70.05,60.00
10,013,02,180,0003,0000,823,31,854,1155,0,2,1,3,1,1,2,0.00,73.94,66.67
10,013,02,180,0004,0000,871,20,891,1224,0,2,1,3,1,1,2,0.00,72.79,66.67
10,013,02,180,0004,0559,871,20,891,1224,0,2,1,3,1,1,2,0.00,72.79,66.67
10,013,02,180,0003,0560,823,31,854,1155,0,2,1,3,1,1,2,0.00,73.94,66.67
10,013,02,190,0003,0000,1128,28,1156,1541,0,3,2,5,2,2,4,0.00,75.02,80.00
10,013,02,190,0006,0000,1237,12,1249,1698,0,3,2,5,2,2,4,0.00,73.56,80.00
10,013,02,190,0007,0000,890,14,904,1187,0,3,2,5,2,2,4,0.00,76.16,80.00
10,013,02,190,0008,0000,700,18,718,877,0,3,2,5,2,2,4,0.00,81.87,80.00
10,013,02,190,0003,0575,548,10,558,745,0,3,2,5,2,2,4,0.00,74.90,80.00
10,013,02,190,0003,0576,580,18,598,796,0,3,2,5,2,2,4,0.00,75.13,80.00
10,013,02,190,0008,0577,700,18,718,877,0,3,2,5,2,2,4,0.00,81.87,80.00
10,013,02,190,0007,0578,890,14,904,1187,0,3,2,5,2,2,4,0.00,76.16,80.00
10,013,02,190,0006,0579,507,4,511,710,0,3,2,5,2,2,4,0.00,71.97,80.00
10,013,02,190,0006,0580,730,8,738,988,0,3,2,5,2,2,4,0.00,74.70,80.00
10,013,02,200,0003,0000,307,8,315,459,0,1,1,2,0,1,1,0.00,68.63,50.00
10,013,02,200,0004,0000,488,8,496,646,0,1,1,2,0,1,1,0.00,76.78,50.00
10,013,02,200,0003,0589,307,8,315,459,0,1,1,2,0,1,1,0.00,68.63,50.00
10,013,02,200,0004,0590,488,8,496,646,0,1,1,2,0,1,1,0.00,76.78,50.00
10,013,02,210,0005,0000,1250,41,1291,1847,0,5,0,5,3,0,3,0.00,69.90,60.00
10,013,02,210,0006,0000,1391,39,1430,1988,0,5,0,5,3,0,3,0.00,71.93,60.00
10,013,02,210,0005,0600,613,18,631,894,0,5,0,5,3,0,3,0.00,70.58,60.00
10,013,02,210,0005,0601,637,23,660,953,0,5,0,5,3,0,3,0.00,69.25,60.00
10,013,02,210,0006,0602,559,15,574,797,0,5,0,5,3,0,3,0.00,72.02,60.00
10,013,02,210,0006,0603,832,24,856,1191,0,5,0,5,3,0,3,0.00,71.87,60.00
10,013,02,220,0003,0000,733,7,740,993,0,4,0,4,3,0,3,0.00,74.52,75.00
10,013,02,220,0004,0000,1152,19,1171,1616,0,4,0,4,3,0,3,0.00,72.46,75.00
10,013,02,220,0003,0614,733,7,740,993,0,4,0,4,3,0,3,0.00,74.52,75.00
10,013,02,220,0004,0615,1152,19,1171,1616,0,4,0,4,3,0,3,0.00,72.46,75.00
10,013,02,230,0001,0000,924,25,949,1279,0,5,1,6,3,0,3,0.00,74.20,50.00
10,013,02,230,0002,0000,381,11,392,522,0,5,1,6,3,0,3,0.00,75.10,50.00
10,013,02,230,0005,0000,259,4,263,357,0,5,1,6,3,0,3,0.00,73.67,50.00
10,013,02,230,0006,0000,589,19,608,834,0,5,1,6,3,0,3,0.00,72.90,50.00
10,013,02,230,0001,0622,332,6,338,463,0,5,1,6,3,0,3,0.00,73.00,50.00
10,013,02,230,0001,0623,592,19,611,816,0,5,1,6,3,0,3,0.00,74.88,50.00
10,013,02,230,0002,0624,381,11,392,522,0,5,1,6,3,0,3,0.00,75.10,50.00
10,013,02,230,0005,0625,259,4,263,357,0,5,1,6,3,0,3,0.00,73.67,50.00
10,013,02,230,0006,0626,589,19,608,834,0,5,1,6,3,0,3,0.00,72.90,50.00
10,013,02,240,0003,0000,601,20,621,887,0,2,1,3,1,1,2,0.00,70.01,66.67
10,013,02,240,0004,0000,756,5,761,1026,0,2,1,3,1,1,2,0.00,74.17,66.67
10,013,02,240,0003,0636,601,20,621,887,0,2,1,3,1,1,2,0.00,70.01,66.67
10,013,02,240,0004,0637,756,5,761,1026,0,2,1,3,1,1,2,0.00,74.17,66.67
10,013,02,250,0002,0000,1512,37,1549,1808,0,3,1,4,2,1,3,0.00,85.67,75.00
10,013,02,250,0002,0643,718,20,738,873,0,3,1,4,2,1,3,0.00,84.54,75.00
10,013,02,250,0002,0644,794,17,811,935,0,3,1,4,2,1,3,0.00,86.74,75.00
10,013,02,260,0005,0000,605,15,620,730,0,7,2,9,3,1,4,0.00,84.93,44.44
10,013,02,260,0006,0000,514,3,517,569,0,7,2,9,3,1,4,0.00,90.86,44.44
10,013,02,260,0007,0000,285,4,289,330,0,7,2,9,3,1,4,0.00,87.58,44.44
10,013,02,260,0008,0000,389,8,397,465,0,7,2,9,3,1,4,0.00,85.38,44.44
10,013,02,260,0009,0000,571,9,580,686,0,7,2,9,3,1,4,0.00,84.55,44.44
10,013,02,260,0010,0000,509,12,521,613,0,7,2,9,3,1,4,0.00,84.99,44.44
10,013,02,260,0005,0651,605,15,620,730,0,7,2,9,3,1,4,0.00,84.93,44.44
10,013,02,260,0006,0652,514,3,517,569,0,7,2,9,3,1,4,0.00,90.86,44.44
10,013,02,260,0007,0653,285,4,289,330,0,7,2,9,3,1,4,0.00,87.58,44.44
10,013,02,260,0008,0654,389,8,397,465,0,7,2,9,3,1,4,0.00,85.38,44.44
10,013,02,260,0009,0655,571,9,580,686,0,7,2,9,3,1,4,0.00,84.55,44.44
10,013,02,260,0010,0656,509,12,521,613,0,7,2,9,3,1,4,0.00,84.99,44.44
10,013,02,270,0004,0000,397,6,403,439,0,5,0,5,3,0,3,0.00,91.80,60.00
10,013,02,270,0005,0000,316,4,320,357,0,5,0,5,3,0,3,0.00,89.64,60.00
10,013,02,270,0006,0000,430,7,437,477,0,5,0,5,3,0,3,0.00,91.61,60.00
10,013,02,270,0006,0662,430,7,437,477,0,5,0,5,3,0,3,0.00,91.61,60.00
10,013,02,270,0005,0663,316,4,320,357,0,5,0,5,3,0,3,0.00,89.64,60.00
10,013,02,270,0004,0664,397,6,403,439,0,5,0,5,3,0,3,0.00,91.80,60.00
10,013,02,280,0003,0000,875,11,886,1027,0,6,0,6,3,0,3,0.00,86.27,50.00
10,013,02,280,0004,0000,690,8,698,858,0,6,0,6,3,0,3,0.00,81.35,50.00
10,013,02,280,0005,0000,384,4,388,432,0,6,0,6,3,0,3,0.00,89.81,50.00
10,013,02,280,0003,0670,875,11,886,1027,0,6,0,6,3,0,3,0.00,86.27,50.00
10,013,02,280,0004,0671,690,8,698,858,0,6,0,6,3,0,3,0.00,81.35,50.00
10,013,02,280,0005,0672,384,4,388,432,0,6,0,6,3,0,3,0.00,89.81,50.00
10,013,02,290,0004,0000,330,4,334,397,0,2,1,3,2,0,2,0.00,84.13,66.67
10,013,02,290,0005,0000,624,6,630,746,0,2,1,3,2,0,2,0.00,84.45,66.67
10,013,02,290,0004,0678,330,4,334,397,0,2,1,3,2,0,2,0.00,84.13,66.67
10,013,02,290,0005,0679,624,6,630,746,0,2,1,3,2,0,2,0.00,84.45,66.67
10,013,02,300,0005,0000,643,4,647,809,0,5,0,5,3,0,3,0.00,79.98,60.00
10,013,02,300,0006,0000,690,3,693,843,0,5,0,5,3,0,3,0.00,82.21,60.00
10,013,02,300,0007,0000,905,18,923,1159,0,5,0,5,3,0,3,0.00,79.64,60.00
10,013,02,300,0005,0686,643,4,647,809,0,5,0,5,3,0,3,0.00,79.98,60.00
10,013,02,300,0006,0687,690,3,693,843,0,5,0,5,3,0,3,0.00,82.21,60.00
10,013,02,300,0007,0688,403,10,413,547,0,5,0,5,3,0,3,0.00,75.50,60.00
10,013,02,300,0007,0689,502,8,510,612,0,5,0,5,3,0,3,0.00,83.33,60.00
10,013,02,310,0004,0000,687,23,710,913,0,3,1,4,3,1,4,0.00,77.77,100.00
10,013,02,310,0005,0000,502,9,511,631,0,3,1,4,3,1,4,0.00,80.98,100.00
10,013,02,310,0006,0000,354,13,367,466,0,3,1,4,3,1,4,0.00,78.76,100.00
10,013,02,310,0004,0693,687,23,710,913,0,3,1,4,3,1,4,0.00,77.77,100.00
10,013,02,310,0005,0694,502,9,511,631,0,3,1,4,3,1,4,0.00,80.98,100.00
10,013,02,310,0006,0695,354,13,367,466,0,3,1,4,3,1,4,0.00,78.76,100.00
10,013,02,320,0005,0000,235,7,242,296,0,5,1,6,3,0,3,0.00,81.76,50.00
10,013,02,320,0006,0000,384,10,394,496,0,5,1,6,3,0,3,0.00,79.44,50.00
10,013,02,320,0007,0000,517,5,522,615,0,5,1,6,3,0,3,0.00,84.88,50.00
10,013,02,320,0008,0000,315,4,319,364,0,5,1,6,3,0,3,0.00,87.64,50.00
10,013,02,320,0005,0700,235,7,242,296,0,5,1,6,3,0,3,0.00,81.76,50.00
10,013,02,320,0006,0701,384,10,394,496,0,5,1,6,3,0,3,0.00,79.44,50.00
10,013,02,320,0007,0702,517,5,522,615,0,5,1,6,3,0,3,0.00,84.88,50.00
10,013,02,320,0008,0703,315,4,319,364,0,5,1,6,3,0,3,0.00,87.64,50.00
10,013,02,330,0005,0000,477,5,482,572,0,3,1,4,1,1,2,0.00,84.27,50.00
10,013,02,330,0006,0000,352,5,357,520,0,3,1,4,1,1,2,0.00,68.65,50.00
10,013,02,330,0005,0710,477,5,482,572,0,3,1,4,1,1,2,0.00,84.27,50.00
10,013,02,330,0006,0711,352,5,357,520,0,3,1,4,1,1,2,0.00,68.65,50.00
10,013,00,030,0000,0000,24785,915,25700,37641,45915,16,2,18,10,1,11,81.98,68.28,61.11
10,013,01,030,0000,0000,8902,355,9257,13831,17290,3,2,5,3,1,4,79.99,66.93,80.00
10,013,02,030,0000,0000,2886,103,2989,4399,5158,2,0,2,1,0,1,85.28,67.95,50.00
10,013,03,030,0000,0000,6500,173,6673,9366,11325,5,0,5,3,0,3,82.70,71.25,60.00
10,013,04,030,0000,0000,6497,284,6781,10045,12142,6,0,6,3,0,3,82.73,67.51,50.00
10,013,03,010,0055,0039,767,30,797,1302,0,8,6,14,4,4,8,0.00,61.21,57.14
10,013,03,010,0055,0040,784,28,812,1356,0,8,6,14,4,4,8,0.00,59.88,57.14
10,013,03,010,0055,0041,789,40,829,1312,0,8,6,14,4,4,8,0.00,63.19,57.14
10,013,03,010,0053,0042,651,28,679,1243,0,8,6,14,4,4,8,0.00,54.63,57.14
10,013,03,010,0053,0043,651,26,677,1199,0,8,6,14,4,4,8,0.00,56.46,57.14
10,013,03,010,0053,0044,721,40,761,1309,0,8,6,14,4,4,8,0.00,58.14,57.14
10,013,03,010,0053,0045,798,26,824,1373,0,8,6,14,4,4,8,0.00,60.01,57.14
10,013,03,010,0053,0046,706,39,745,1231,0,8,6,14,4,4,8,0.00,60.52,57.14
10,013,03,010,0053,0047,741,30,771,1337,0,8,6,14,4,4,8,0.00,57.67,57.14
10,013,03,010,0081,0048,707,30,737,1337,0,8,6,14,4,4,8,0.00,55.12,57.14
10,013,03,010,0081,0049,731,45,776,1285,0,8,6,14,4,4,8,0.00,60.39,57.14
10,013,03,010,0081,0050,658,24,682,1229,0,8,6,14,4,4,8,0.00,55.49,57.14
10,013,03,010,0054,0051,861,21,882,1337,0,8,6,14,4,4,8,0.00,65.97,57.14
10,013,03,010,0054,0052,907,32,939,1449,0,8,6,14,4,4,8,0.00,64.80,57.14
10,013,03,010,0050,0053,819,47,866,1395,0,8,6,14,4,4,8,0.00,62.08,57.14
10,013,03,010,0056,0054,719,39,758,1161,0,8,6,14,4,4,8,0.00,65.29,57.14
10,013,03,010,0056,0055,659,52,711,1231,0,8,6,14,4,4,8,0.00,57.76,57.14
10,013,03,010,0051,0056,734,36,770,1110,0,8,6,14,4,4,8,0.00,69.37,57.14
10,013,03,010,0049,0057,528,22,550,890,0,8,6,14,4,4,8,0.00,61.80,57.14
10,013,03,010,0049,0058,606,31,637,1023,0,8,6,14,4,4,8,0.00,62.27,57.14
10,013,03,010,0042,0059,1060,43,1103,1473,0,8,6,14,4,4,8,0.00,74.88,57.14
10,013,03,010,0041,0060,835,28,863,1211,0,8,6,14,4,4,8,0.00,71.26,57.14
10,013,03,010,0041,0061,568,28,596,1177,0,8,6,14,4,4,8,0.00,50.64,57.14
10,013,03,010,0031,0062,865,39,904,1395,0,8,6,14,4,4,8,0.00,64.80,57.14
10,013,03,010,0031,0063,761,36,797,1319,0,8,6,14,4,4,8,0.00,60.42,57.14
10,013,03,010,0031,0064,654,37,691,1241,0,8,6,14,4,4,8,0.00,55.68,57.14
10,013,03,010,0031,0065,686,23,709,1221,0,8,6,14,4,4,8,0.00,58.07,57.14
10,013,03,010,0032,0066,342,25,367,495,0,8,6,14,4,4,8,0.00,74.14,57.14
10,013,03,010,0045,0067,739,35,774,1080,0,8,6,14,4,4,8,0.00,71.67,57.14
10,013,03,010,0046,0068,463,18,481,822,0,8,6,14,4,4,8,0.00,58.52,57.14
10,013,03,010,0046,0069,537,27,564,888,0,8,6,14,4,4,8,0.00,63.51,57.14
10,013,03,010,0043,0070,823,16,839,1167,0,8,6,14,4,4,8,0.00,71.89,57.14
10,013,03,010,0043,0071,607,26,633,975,0,8,6,14,4,4,8,0.00,64.92,57.14
10,013,03,010,0044,0072,992,29,1021,1468,0,8,6,14,4,4,8,0.00,69.55,57.14
10,013,03,010,0035,0073,470,24,494,742,0,8,6,14,4,4,8,0.00,66.58,57.14
10,013,03,010,0035,0074,514,37,551,890,0,8,6,14,4,4,8,0.00,61.91,57.14
10,013,03,010,0033,0075,645,34,679,1168,0,8,6,14,4,4,8,0.00,58.13,57.14
10,013,03,010,0033,0076,846,48,894,1556,0,8,6,14,4,4,8,0.00,57.46,57.14
10,013,03,010,0036,0077,660,42,702,1113,0,8,6,14,4,4,8,0.00,63.07,57.14
10,013,03,010,0036,0078,434,17,451,665,0,8,6,14,4,4,8,0.00,67.82,57.14
10,013,03,010,0038,0079,620,42,662,1054,0,8,6,14,4,4,8,0.00,62.81,57.14
10,013,03,010,0038,0080,371,7,378,611,0,8,6,14,4,4,8,0.00,61.87,57.14
10,013,03,010,0040,0081,874,34,908,1421,0,8,6,14,4,4,8,0.00,63.90,57.14
10,013,03,010,0040,0082,816,36,852,1510,0,8,6,14,4,4,8,0.00,56.42,57.14
10,013,03,010,0040,0083,790,38,828,1435,0,8,6,14,4,4,8,0.00,57.70,57.14
10,013,03,010,0040,0084,808,31,839,1394,0,8,6,14,4,4,8,0.00,60.19,57.14
10,013,03,010,0031,0000,2966,135,3101,5176,0,8,6,14,4,4,8,0.00,59.91,57.14
10,013,03,010,0032,0000,342,25,367,495,0,8,6,14,4,4,8,0.00,74.14,57.14
10,013,03,010,0033,0000,1491,82,1573,2724,0,8,6,14,4,4,8,0.00,57.75,57.14
10,013,03,010,0035,0000,984,61,1045,1632,0,8,6,14,4,4,8,0.00,64.03,57.14
10,013,03,010,0036,0000,1094,59,1153,1778,0,8,6,14,4,4,8,0.00,64.85,57.14
10,013,03,010,0038,0000,991,49,1040,1665,0,8,6,14,4,4,8,0.00,62.46,57.14
10,013,03,010,0040,0000,3288,139,3427,5760,0,8,6,14,4,4,8,0.00,59.50,57.14
10,013,03,010,0041,0000,1403,56,1459,2388,0,8,6,14,4,4,8,0.00,61.10,57.14
10,013,03,010,0042,0000,1060,43,1103,1473,0,8,6,14,4,4,8,0.00,74.88,57.14
10,013,03,010,0043,0000,1430,42,1472,2142,0,8,6,14,4,4,8,0.00,68.72,57.14
10,013,03,010,0044,0000,992,29,1021,1468,0,8,6,14,4,4,8,0.00,69.55,57.14
10,013,03,010,0045,0000,739,35,774,1080,0,8,6,14,4,4,8,0.00,71.67,57.14
10,013,03,010,0046,0000,1000,45,1045,1710,0,8,6,14,4,4,8,0.00,61.11,57.14
10,013,03,010,0049,0000,1134,53,1187,1913,0,8,6,14,4,4,8,0.00,62.05,57.14
10,013,03,010,0050,0000,819,47,866,1395,0,8,6,14,4,4,8,0.00,62.08,57.14
10,013,03,010,0051,0000,734,36,770,1110,0,8,6,14,4,4,8,0.00,69.37,57.14
10,013,03,010,0053,0000,4268,189,4457,7692,0,8,6,14,4,4,8,0.00,57.94,57.14
10,013,03,010,0054,0000,1768,53,1821,2786,0,8,6,14,4,4,8,0.00,65.36,57.14
10,013,03,010,0055,0000,2340,98,2438,3970,0,8,6,14,4,4,8,0.00,61.41,57.14
10,013,03,010,0056,0000,1378,91,1469,2392,0,8,6,14,4,4,8,0.00,61.41,57.14
10,013,03,010,0081,0000,2096,99,2195,3851,0,8,6,14,4,4,8,0.00,57.00,57.14
10,013,03,020,0019,0178,599,29,628,855,0,3,0,3,1,0,1,0.00,73.45,33.33
10,013,03,020,0019,0179,481,15,496,683,0,3,0,3,1,0,1,0.00,72.62,33.33
10,013,03,020,0020,0180,581,11,592,869,0,3,0,3,1,0,1,0.00,68.12,33.33
10,013,03,020,0020,0181,519,11,530,769,0,3,0,3,1,0,1,0.00,68.92,33.33
10,013,03,020,0021,0182,715,29,744,1140,0,3,0,3,1,0,1,0.00,65.26,33.33
10,013,03,020,0021,0183,252,7,259,339,0,3,0,3,1,0,1,0.00,76.40,33.33
10,013,03,020,0019,0000,1080,44,1124,1538,0,3,0,3,1,0,1,0.00,73.08,33.33
10,013,03,020,0020,0000,1100,22,1122,1638,0,3,0,3,1,0,1,0.00,68.50,33.33
10,013,03,020,0021,0000,967,36,1003,1479,0,3,0,3,1,0,1,0.00,67.82,33.33
10,013,03,030,0010,0000,856,25,881,1250,0,5,0,5,3,0,3,0.00,70.48,60.00
10,013,03,030,0011,0000,1274,35,1309,1877,0,5,0,5,3,0,3,0.00,69.74,60.00
10,013,03,030,0012,0000,924,29,953,1416,0,5,0,5,3,0,3,0.00,67.30,60.00
10,013,03,030,0013,0000,1306,37,1343,1998,0,5,0,5,3,0,3,0.00,67.22,60.00
10,013,03,030,0014,0000,997,22,1019,1330,0,5,0,5,3,0,3,0.00,76.62,60.00
10,013,03,030,0015,0000,1143,25,1168,1495,0,5,0,5,3,0,3,0.00,78.13,60.00
10,013,03,030,0010,0203,856,25,881,1250,0,5,0,5,3,0,3,0.00,70.48,60.00
10,013,03,030,0011,0204,626,13,639,900,0,5,0,5,3,0,3,0.00,71.00,60.00
10,013,03,030,0011,0205,648,22,670,977,0,5,0,5,3,0,3,0.00,68.58,60.00
10,013,03,030,0012,0206,479,13,492,750,0,5,0,5,3,0,3,0.00,65.60,60.00
10,013,03,030,0012,0207,445,16,461,666,0,5,0,5,3,0,3,0.00,69.22,60.00
10,013,03,030,0013,0208,582,14,596,900,0,5,0,5,3,0,3,0.00,66.22,60.00
10,013,03,030,0013,0209,724,23,747,1098,0,5,0,5,3,0,3,0.00,68.03,60.00
10,013,03,030,0014,0210,476,6,482,651,0,5,0,5,3,0,3,0.00,74.04,60.00
10,013,03,030,0014,0211,521,16,537,679,0,5,0,5,3,0,3,0.00,79.09,60.00
10,013,03,030,0015,0212,578,17,595,749,0,5,0,5,3,0,3,0.00,79.44,60.00
10,013,03,030,0015,0213,565,8,573,746,0,5,0,5,3,0,3,0.00,76.81,60.00
10,013,03,040,0011,0000,675,41,716,1029,0,5,0,5,3,0,3,0.00,69.58,60.00
10,013,03,040,0012,0000,997,31,1028,1506,0,5,0,5,3,0,3,0.00,68.26,60.00
10,013,03,040,0013,0000,1364,25,1389,2130,0,5,0,5,3,0,3,0.00,65.21,60.00
10,013,03,040,0014,0000,851,33,884,1340,0,5,0,5,3,0,3,0.00,65.97,60.00
10,013,03,040,0011,0238,675,41,716,1029,0,5,0,5,3,0,3,0.00,69.58,60.00
10,013,03,040,0012,0239,498,13,511,731,0,5,0,5,3,0,3,0.00,69.90,60.00
10,013,03,040,0012,0240,499,18,517,775,0,5,0,5,3,0,3,0.00,66.71,60.00
10,013,03,040,0013,0241,700,13,713,1067,0,5,0,5,3,0,3,0.00,66.82,60.00
10,013,03,040,0013,0242,664,12,676,1063,0,5,0,5,3,0,3,0.00,63.59,60.00
10,013,03,040,0014,0243,414,21,435,651,0,5,0,5,3,0,3,0.00,66.82,60.00
10,013,03,040,0014,0244,437,12,449,689,0,5,0,5,3,0,3,0.00,65.17,60.00
10,013,03,050,0011,0000,1069,124,1193,1759,0,2,0,2,2,0,2,0.00,67.82,100.00
10,013,03,050,0012,0000,1026,177,1203,1526,0,2,0,2,2,0,2,0.00,78.83,100.00
10,013,03,050,0013,0000,852,136,988,1340,0,2,0,2,2,0,2,0.00,73.73,100.00
10,013,03,050,0024,0000,643,81,724,939,0,2,0,2,2,0,2,0.00,77.10,100.00
10,013,03,050,0026,0000,801,120,921,1289,0,2,0,2,2,0,2,0.00,71.45,100.00
10,013,03,050,0011,0279,604,56,660,924,0,2,0,2,2,0,2,0.00,71.43,100.00
10,013,03,050,0011,0280,465,68,533,835,0,2,0,2,2,0,2,0.00,63.83,100.00
10,013,03,050,0012,0281,540,84,624,814,0,2,0,2,2,0,2,0.00,76.66,100.00
10,013,03,050,0012,0282,486,93,579,712,0,2,0,2,2,0,2,0.00,81.32,100.00
10,013,03,050,0013,0283,852,136,988,1340,0,2,0,2,2,0,2,0.00,73.73,100.00
10,013,03,050,0024,0284,643,81,724,939,0,2,0,2,2,0,2,0.00,77.10,100.00
10,013,03,050,0026,0285,801,120,921,1289,0,2,0,2,2,0,2,0.00,71.45,100.00
10,013,03,060,0012,0000,1472,33,1505,2267,0,4,0,4,3,0,3,0.00,66.39,75.00
10,013,03,060,0013,0000,1252,18,1270,1675,0,4,0,4,3,0,3,0.00,75.82,75.00
10,013,03,060,0014,0000,885,32,917,1351,0,4,0,4,3,0,3,0.00,67.88,75.00
10,013,03,060,0015,0000,783,31,814,1088,0,4,0,4,3,0,3,0.00,74.82,75.00
10,013,03,060,0016,0000,479,23,502,702,0,4,0,4,3,0,3,0.00,71.51,75.00
10,013,03,060,0013,0313,609,9,618,802,0,4,0,4,3,0,3,0.00,77.06,75.00
10,013,03,060,0013,0314,643,9,652,873,0,4,0,4,3,0,3,0.00,74.68,75.00
10,013,03,060,0014,0315,885,32,917,1351,0,4,0,4,3,0,3,0.00,67.88,75.00
10,013,03,060,0015,0316,783,31,814,1088,0,4,0,4,3,0,3,0.00,74.82,75.00
10,013,03,060,0012,0317,796,20,816,1193,0,4,0,4,3,0,3,0.00,68.40,75.00
10,013,03,060,0012,0318,676,13,689,1074,0,4,0,4,3,0,3,0.00,64.15,75.00
10,013,03,060,0016,0319,479,23,502,702,0,4,0,4,3,0,3,0.00,71.51,75.00
10,013,03,070,0004,0000,1481,71,1552,2464,0,2,2,4,1,2,3,0.00,62.99,75.00
10,013,03,070,0004,0325,699,38,737,1200,0,2,2,4,1,2,3,0.00,61.42,75.00
10,013,03,070,0004,0326,782,33,815,1264,0,2,2,4,1,2,3,0.00,64.48,75.00
10,013,03,080,0006,0000,912,123,1035,1488,0,2,0,2,2,0,2,0.00,69.56,100.00
10,013,03,080,0008,0000,832,111,943,1227,0,2,0,2,2,0,2,0.00,76.85,100.00
10,013,03,080,0006,0342,912,123,1035,1488,0,2,0,2,2,0,2,0.00,69.56,100.00
10,013,03,080,0008,0343,832,111,943,1227,0,2,0,2,2,0,2,0.00,76.85,100.00
10,013,03,090,0006,0000,912,43,955,1383,0,4,0,4,3,0,3,0.00,69.05,75.00
10,013,03,090,0009,0000,1019,32,1051,1453,0,4,0,4,3,0,3,0.00,72.33,75.00
10,013,03,090,0010,0000,1538,41,1579,2201,0,4,0,4,3,0,3,0.00,71.74,75.00
10,013,03,090,0006,0355,912,43,955,1383,0,4,0,4,3,0,3,0.00,69.05,75.00
10,013,03,090,0009,0356,196,4,200,287,0,4,0,4,3,0,3,0.00,69.69,75.00
10,013,03,090,0009,0357,823,28,851,1166,0,4,0,4,3,0,3,0.00,72.98,75.00
10,013,03,090,0010,0358,663,24,687,925,0,4,0,4,3,0,3,0.00,74.27,75.00
10,013,03,090,0010,0359,875,17,892,1276,0,4,0,4,3,0,3,0.00,69.91,75.00
10,013,03,100,0001,0000,2122,54,2176,2955,0,5,0,5,3,0,3,0.00,73.64,60.00
10,013,03,100,0011,0000,2265,87,2352,3298,0,5,0,5,3,0,3,0.00,71.32,60.00
10,013,03,100,0001,0379,651,20,671,938,0,5,0,5,3,0,3,0.00,71.54,60.00
10,013,03,100,0001,0380,796,12,808,1062,0,5,0,5,3,0,3,0.00,76.08,60.00
10,013,03,100,0001,0381,675,22,697,955,0,5,0,5,3,0,3,0.00,72.98,60.00
10,013,03,100,0011,0382,676,18,694,969,0,5,0,5,3,0,3,0.00,71.62,60.00
10,013,03,100,0011,0383,826,36,862,1186,0,5,0,5,3,0,3,0.00,72.68,60.00
10,013,03,100,0011,0384,763,33,796,1143,0,5,0,5,3,0,3,0.00,69.64,60.00
10,013,03,110,0012,0000,1207,51,1258,1753,0,3,1,4,2,1,3,0.00,71.76,75.00
10,013,03,110,0013,0000,867,32,899,1179,0,3,1,4,2,1,3,0.00,76.25,75.00
10,013,03,110,0014,0000,735,17,752,1021,0,3,1,4,2,1,3,0.00,73.65,75.00
10,013,03,110,0015,0000,802,15,817,1066,0,3,1,4,2,1,3,0.00,76.64,75.00
10,013,03,110,0012,0402,590,20,610,855,0,3,1,4,2,1,3,0.00,71.35,75.00
10,013,03,110,0012,0403,617,31,648,898,0,3,1,4,2,1,3,0.00,72.16,75.00
10,013,03,110,0013,0404,867,32,899,1179,0,3,1,4,2,1,3,0.00,76.25,75.00
10,013,03,110,0014,0405,735,17,752,1021,0,3,1,4,2,1,3,0.00,73.65,75.00
10,013,03,110,0015,0406,802,15,817,1066,0,3,1,4,2,1,3,0.00,76.64,75.00
10,013,03,120,0009,0000,1047,87,1134,1896,0,1,1,2,1,1,2,0.00,59.81,100.00
10,013,03,120,0010,0000,832,55,887,1573,0,1,1,2,1,1,2,0.00,56.39,100.00
10,013,03,120,0010,0422,403,29,432,792,0,1,1,2,1,1,2,0.00,54.55,100.00
10,013,03,120,0010,0423,429,26,455,781,0,1,1,2,1,1,2,0.00,58.26,100.00
10,013,03,120,0009,0424,516,46,562,943,0,1,1,2,1,1,2,0.00,59.60,100.00
10,013,03,120,0009,0425,531,41,572,953,0,1,1,2,1,1,2,0.00,60.02,100.00
10,013,03,130,0012,0000,1583,59,1642,2714,0,2,0,2,1,0,1,0.00,60.50,50.00
10,013,03,130,0013,0000,529,21,550,879,0,2,0,2,1,0,1,0.00,62.57,50.00
10,013,03,130,0014,0000,603,35,638,1028,0,2,0,2,1,0,1,0.00,62.06,50.00
10,013,03,130,0012,0455,716,32,748,1219,0,2,0,2,1,0,1,0.00,61.36,50.00
10,013,03,130,0012,0456,867,27,894,1495,0,2,0,2,1,0,1,0.00,59.80,50.00
10,013,03,130,0013,0457,529,21,550,879,0,2,0,2,1,0,1,0.00,62.57,50.00
10,013,03,130,0014,0458,603,35,638,1028,0,2,0,2,1,0,1,0.00,62.06,50.00
10,013,03,140,0012,0000,562,15,577,757,0,3,1,4,3,0,3,0.00,76.22,75.00
10,013,03,140,0013,0000,678,28,706,1049,0,3,1,4,3,0,3,0.00,67.30,75.00
10,013,03,140,0014,0000,880,16,896,1150,0,3,1,4,3,0,3,0.00,77.91,75.00
10,013,03,140,0015,0000,819,10,829,1145,0,3,1,4,3,0,3,0.00,72.40,75.00
10,013,03,140,0012,0485,562,15,577,757,0,3,1,4,3,0,3,0.00,76.22,75.00
10,013,03,140,0013,0486,678,28,706,1049,0,3,1,4,3,0,3,0.00,67.30,75.00
10,013,03,140,0014,0487,880,16,896,1150,0,3,1,4,3,0,3,0.00,77.91,75.00
10,013,03,140,0015,0488,819,10,829,1145,0,3,1,4,3,0,3,0.00,72.40,75.00
10,013,03,160,0012,0000,602,32,634,880,0,2,1,3,1,1,2,0.00,72.05,66.67
10,013,03,160,0013,0000,266,21,287,387,0,2,1,3,1,1,2,0.00,74.16,66.67
10,013,03,160,0014,0000,1762,37,1799,2564,0,2,1,3,1,1,2,0.00,70.16,66.67
10,013,03,160,0015,0000,356,22,378,585,0,2,1,3,1,1,2,0.00,64.62,66.67
10,013,03,160,0014,0520,636,14,650,922,0,2,1,3,1,1,2,0.00,70.50,66.67
10,013,03,160,0014,0521,535,12,547,756,0,2,1,3,1,1,2,0.00,72.35,66.67
10,013,03,160,0014,0522,591,11,602,886,0,2,1,3,1,1,2,0.00,67.95,66.67
10,013,03,160,0015,0523,356,22,378,585,0,2,1,3,1,1,2,0.00,64.62,66.67
10,013,03,160,0012,0524,602,32,634,880,0,2,1,3,1,1,2,0.00,72.05,66.67
10,013,03,160,0013,0525,266,21,287,387,0,2,1,3,1,1,2,0.00,74.16,66.67
10,013,03,170,0008,0000,777,32,809,1155,0,5,0,5,2,0,2,0.00,70.04,40.00
10,013,03,170,0009,0000,1356,55,1411,2016,0,5,0,5,2,0,2,0.00,69.99,40.00
10,013,03,170,0010,0000,969,29,998,1493,0,5,0,5,2,0,2,0.00,66.85,40.00
10,013,03,170,0011,0000,928,36,964,1316,0,5,0,5,2,0,2,0.00,73.25,40.00
10,013,03,170,0008,0540,777,32,809,1155,0,5,0,5,2,0,2,0.00,70.04,40.00
10,013,03,170,0009,0541,718,25,743,1014,0,5,0,5,2,0,2,0.00,73.27,40.00
10,013,03,170,0009,0542,638,30,668,1002,0,5,0,5,2,0,2,0.00,66.67,40.00
10,013,03,170,0010,0543,526,14,540,821,0,5,0,5,2,0,2,0.00,65.77,40.00
10,013,03,170,0010,0544,443,15,458,672,0,5,0,5,2,0,2,0.00,68.15,40.00
10,013,03,170,0011,0545,928,36,964,1316,0,5,0,5,2,0,2,0.00,73.25,40.00
10,013,03,180,0005,0000,667,11,678,1004,0,5,1,6,2,0,2,0.00,67.53,33.33
10,013,03,180,0006,0000,965,28,993,1423,0,5,1,6,2,0,2,0.00,69.78,33.33
10,013,03,180,0005,0561,667,11,678,1004,0,5,1,6,2,0,2,0.00,67.53,33.33
10,013,03,180,0006,0562,511,16,527,739,0,5,1,6,2,0,2,0.00,71.31,33.33
10,013,03,180,0006,0563,454,12,466,684,0,5,1,6,2,0,2,0.00,68.13,33.33
10,013,03,190,0009,0000,1163,34,1197,1804,0,3,0,3,2,0,2,0.00,66.35,66.67
10,013,03,190,0010,0000,680,20,700,1035,0,3,0,3,2,0,2,0.00,67.63,66.67
10,013,03,190,0009,0581,694,16,710,1074,0,3,0,3,2,0,2,0.00,66.11,66.67
10,013,03,190,0009,0582,469,18,487,730,0,3,0,3,2,0,2,0.00,66.71,66.67
10,013,03,190,0010,0583,680,20,700,1035,0,3,0,3,2,0,2,0.00,67.63,66.67
10,013,03,200,0007,0000,732,7,739,991,0,5,1,6,2,1,3,0.00,74.57,50.00
10,013,03,200,0008,0000,722,19,741,1019,0,5,1,6,2,1,3,0.00,72.72,50.00
10,013,03,200,0007,0591,732,7,739,991,0,5,1,6,2,1,3,0.00,74.57,50.00
10,013,03,200,0008,0592,722,19,741,1019,0,5,1,6,2,1,3,0.00,72.72,50.00
10,013,03,210,0007,0000,580,24,604,895,0,3,1,4,2,0,2,0.00,67.49,50.00
10,013,03,210,0008,0000,434,13,447,654,0,3,1,4,2,0,2,0.00,68.35,50.00
10,013,03,210,0009,0000,728,24,752,1101,0,3,1,4,2,0,2,0.00,68.30,50.00
10,013,03,210,0010,0000,636,23,659,1028,0,3,1,4,2,0,2,0.00,64.11,50.00
10,013,03,210,0007,0604,580,24,604,895,0,3,1,4,2,0,2,0.00,67.49,50.00
10,013,03,210,0008,0605,434,13,447,654,0,3,1,4,2,0,2,0.00,68.35,50.00
10,013,03,210,0009,0606,728,24,752,1101,0,3,1,4,2,0,2,0.00,68.30,50.00
10,013,03,210,0010,0607,636,23,659,1028,0,3,1,4,2,0,2,0.00,64.11,50.00
10,013,03,220,0005,0000,631,44,675,1082,0,2,0,2,2,0,2,0.00,62.38,100.00
10,013,03,220,0006,0000,746,48,794,1124,0,2,0,2,2,0,2,0.00,70.64,100.00
10,013,03,220,0005,0616,631,44,675,1082,0,2,0,2,2,0,2,0.00,62.38,100.00
10,013,03,220,0006,0617,746,48,794,1124,0,2,0,2,2,0,2,0.00,70.64,100.00
10,013,03,230,0007,0000,810,26,836,1169,0,2,0,2,1,0,1,0.00,71.51,50.00
10,013,03,230,0007,0627,397,16,413,567,0,2,0,2,1,0,1,0.00,72.84,50.00
10,013,03,230,0007,0628,413,10,423,602,0,2,0,2,1,0,1,0.00,70.27,50.00
10,013,03,240,0006,0000,794,15,809,1058,0,2,2,4,1,1,2,0.00,76.47,50.00
10,013,03,240,0007,0000,260,1,261,309,0,2,2,4,1,1,2,0.00,84.47,50.00
10,013,03,240,0008,0000,237,1,238,273,0,2,2,4,1,1,2,0.00,87.18,50.00
10,013,03,240,0006,0638,794,15,809,1058,0,2,2,4,1,1,2,0.00,76.47,50.00
10,013,03,240,0007,0639,260,1,261,309,0,2,2,4,1,1,2,0.00,84.47,50.00
10,013,03,240,0008,0640,237,1,238,273,0,2,2,4,1,1,2,0.00,87.18,50.00
10,013,03,250,0003,0000,761,21,782,941,0,4,0,4,3,0,3,0.00,83.10,75.00
10,013,03,250,0004,0000,670,9,679,838,0,4,0,4,3,0,3,0.00,81.03,75.00
10,013,03,250,0003,0645,761,21,782,941,0,4,0,4,3,0,3,0.00,83.10,75.00
10,013,03,250,0004,0646,670,9,679,838,0,4,0,4,3,0,3,0.00,81.03,75.00
10,013,00,040,0000,0000,14882,518,15400,24517,29890,18,3,21,10,1,11,82.02,62.81,52.38
10,013,01,040,0000,0000,2309,85,2394,4016,4928,3,0,3,2,0,2,81.49,59.61,66.67
10,013,02,040,0000,0000,4119,163,4282,6686,8166,5,2,7,2,1,3,81.88,64.04,42.86
10,013,03,040,0000,0000,3887,130,4017,6005,7227,5,0,5,3,0,3,83.09,66.89,60.00
10,013,04,040,0000,0000,4567,140,4707,7810,9569,5,1,6,3,0,3,81.62,60.27,50.00
10,013,04,010,0083,0085,781,19,800,1299,0,11,3,14,7,2,9,0.00,61.59,64.29
10,013,04,010,0083,0086,800,37,837,1472,0,11,3,14,7,2,9,0.00,56.86,64.29
10,013,04,010,0083,0087,839,28,867,1469,0,11,3,14,7,2,9,0.00,59.02,64.29
10,013,04,010,0083,0088,658,32,690,1277,0,11,3,14,7,2,9,0.00,54.03,64.29
10,013,04,010,0083,0089,717,27,744,1297,0,11,3,14,7,2,9,0.00,57.36,64.29
10,013,04,010,0073,0090,755,24,779,1358,0,11,3,14,7,2,9,0.00,57.36,64.29
10,013,04,010,0073,0091,644,26,670,1167,0,11,3,14,7,2,9,0.00,57.41,64.29
10,013,04,010,0073,0092,710,34,744,1225,0,11,3,14,7,2,9,0.00,60.73,64.29
10,013,04,010,0073,0093,746,22,768,1341,0,11,3,14,7,2,9,0.00,57.27,64.29
10,013,04,010,0073,0094,719,20,739,1244,0,11,3,14,7,2,9,0.00,59.41,64.29
10,013,04,010,0073,0095,684,18,702,1276,0,11,3,14,7,2,9,0.00,55.02,64.29
10,013,04,010,0075,0096,665,29,694,1237,0,11,3,14,7,2,9,0.00,56.10,64.29
10,013,04,010,0075,0097,812,27,839,1397,0,11,3,14,7,2,9,0.00,60.06,64.29
10,013,04,010,0075,0098,697,34,731,1328,0,11,3,14,7,2,9,0.00,55.05,64.29
10,013,04,010,0075,0099,557,24,581,1124,0,11,3,14,7,2,9,0.00,51.69,64.29
10,013,04,010,0066,0100,590,16,606,1081,0,11,3,14,7,2,9,0.00,56.06,64.29
10,013,04,010,0066,0101,518,30,548,1049,0,11,3,14,7,2,9,0.00,52.24,64.29
10,013,04,010,0074,0102,625,23,648,1112,0,11,3,14,7,2,9,0.00,58.27,64.29
10,013,04,010,0074,0103,746,16,762,1324,0,11,3,14,7,2,9,0.00,57.55,64.29
10,013,04,010,0074,0104,645,26,671,1289,0,11,3,14,7,2,9,0.00,52.06,64.29
10,013,04,010,0071,0105,970,29,999,1548,0,11,3,14,7,2,9,0.00,64.53,64.29
10,013,04,010,0071,0106,680,37,717,1270,0,11,3,14,7,2,9,0.00,56.46,64.29
10,013,04,010,0065,0107,462,26,488,1503,0,11,3,14,7,2,9,0.00,32.47,64.29
10,013,04,010,0065,0108,693,49,742,1335,0,11,3,14,7,2,9,0.00,55.58,64.29
10,013,04,010,0065,0109,691,39,730,1271,0,11,3,14,7,2,9,0.00,57.44,64.29
10,013,04,010,0065,0110,738,38,776,1400,0,11,3,14,7,2,9,0.00,55.43,64.29
10,013,04,010,0059,0111,451,29,480,809,0,11,3,14,7,2,9,0.00,59.33,64.29
10,013,04,010,0059,0112,631,36,667,1068,0,11,3,14,7,2,9,0.00,62.45,64.29
10,013,04,010,0060,0113,686,39,725,1204,0,11,3,14,7,2,9,0.00,60.22,64.29
10,013,04,010,0060,0114,660,25,685,1110,0,11,3,14,7,2,9,0.00,61.71,64.29
10,013,04,010,0060,0115,644,37,681,1121,0,11,3,14,7,2,9,0.00,60.75,64.29
10,013,04,010,0060,0116,677,43,720,1224,0,11,3,14,7,2,9,0.00,58.82,64.29
10,013,04,010,0067,0117,535,40,575,1026,0,11,3,14,7,2,9,0.00,56.04,64.29
10,013,04,010,0067,0118,587,30,617,1062,0,11,3,14,7,2,9,0.00,58.10,64.29
10,013,04,010,0084,0119,556,40,596,931,0,11,3,14,7,2,9,0.00,64.02,64.29
10,013,04,010,0084,0120,511,53,564,946,0,11,3,14,7,2,9,0.00,59.62,64.29
10,013,04,010,0070,0121,502,40,542,930,0,11,3,14,7,2,9,0.00,58.28,64.29
10,013,04,010,0070,0122,568,42,610,976,0,11,3,14,7,2,9,0.00,62.50,64.29
10,013,04,010,0069,0123,633,35,668,1159,0,11,3,14,7,2,9,0.00,57.64,64.29
10,013,04,010,0069,0124,690,32,722,1172,0,11,3,14,7,2,9,0.00,61.60,64.29
10,013,04,010,0069,0125,618,24,642,1129,0,11,3,14,7,2,9,0.00,56.86,64.29
10,013,04,010,0069,0126,655,27,682,1221,0,11,3,14,7,2,9,0.00,55.86,64.29
10,013,04,010,0069,0127,664,31,695,1191,0,11,3,14,7,2,9,0.00,58.35,64.29
10,013,04,010,0068,0128,707,40,747,1226,0,11,3,14,7,2,9,0.00,60.93,64.29
10,013,04,010,0068,0129,555,32,587,1012,0,11,3,14,7,2,9,0.00,58.00,64.29
10,013,04,010,0064,0130,818,45,863,1437,0,11,3,14,7,2,9,0.00,60.06,64.29
10,013,04,010,0064,0131,699,42,741,1340,0,11,3,14,7,2,9,0.00,55.30,64.29
10,013,04,010,0064,0132,795,43,838,1469,0,11,3,14,7,2,9,0.00,57.05,64.29
10,013,04,010,0076,0133,847,20,867,1291,0,11,3,14,7,2,9,0.00,67.16,64.29
10,013,04,010,0077,0134,636,28,664,828,0,11,3,14,7,2,9,0.00,80.19,64.29
10,013,04,010,0078,0135,669,29,698,1056,0,11,3,14,7,2,9,0.00,66.10,64.29
10,013,04,010,0080,0136,1052,22,1074,1511,0,11,3,14,7,2,9,0.00,71.08,64.29
10,013,04,010,0079,0137,661,42,703,953,0,11,3,14,7,2,9,0.00,73.77,64.29
10,013,04,010,0059,0000,1082,65,1147,1877,0,11,3,14,7,2,9,0.00,61.11,64.29
10,013,04,010,0060,0000,2667,144,2811,4659,0,11,3,14,7,2,9,0.00,60.33,64.29
10,013,04,010,0064,0000,2312,130,2442,4246,0,11,3,14,7,2,9,0.00,57.51,64.29
10,013,04,010,0065,0000,2584,152,2736,5509,0,11,3,14,7,2,9,0.00,49.66,64.29
10,013,04,010,0066,0000,1108,46,1154,2130,0,11,3,14,7,2,9,0.00,54.18,64.29
10,013,04,010,0067,0000,1122,70,1192,2088,0,11,3,14,7,2,9,0.00,57.09,64.29
10,013,04,010,0068,0000,1262,72,1334,2238,0,11,3,14,7,2,9,0.00,59.61,64.29
10,013,04,010,0069,0000,3260,149,3409,5872,0,11,3,14,7,2,9,0.00,58.06,64.29
10,013,04,010,0070,0000,1070,82,1152,1906,0,11,3,14,7,2,9,0.00,60.44,64.29
10,013,04,010,0071,0000,1650,66,1716,2818,0,11,3,14,7,2,9,0.00,60.89,64.29
10,013,04,010,0073,0000,4258,144,4402,7611,0,11,3,14,7,2,9,0.00,57.84,64.29
10,013,04,010,0074,0000,2016,65,2081,3725,0,11,3,14,7,2,9,0.00,55.87,64.29
10,013,04,010,0075,0000,2731,114,2845,5086,0,11,3,14,7,2,9,0.00,55.94,64.29
10,013,04,010,0076,0000,847,20,867,1291,0,11,3,14,7,2,9,0.00,67.16,64.29
10,013,04,010,0077,0000,636,28,664,828,0,11,3,14,7,2,9,0.00,80.19,64.29
10,013,04,010,0078,0000,669,29,698,1056,0,11,3,14,7,2,9,0.00,66.10,64.29
10,013,04,010,0079,0000,661,42,703,953,0,11,3,14,7,2,9,0.00,73.77,64.29
10,013,04,010,0080,0000,1052,22,1074,1511,0,11,3,14,7,2,9,0.00,71.08,64.29
10,013,04,010,0083,0000,3795,143,3938,6814,0,11,3,14,7,2,9,0.00,57.79,64.29
10,013,04,010,0084,0000,1067,93,1160,1877,0,11,3,14,7,2,9,0.00,61.80,64.29
10,013,04,030,0016,0000,1379,54,1433,2239,0,6,0,6,3,0,3,0.00,64.00,50.00
10,013,04,030,0017,0000,1285,35,1320,1836,0,6,0,6,3,0,3,0.00,71.90,50.00
10,013,04,030,0018,0000,940,25,965,1459,0,6,0,6,3,0,3,0.00,66.14,50.00
10,013,04,030,0021,0000,708,31,739,1025,0,6,0,6,3,0,3,0.00,72.10,50.00
10,013,04,030,0024,0214,654,27,681,956,0,6,0,6,3,0,3,0.00,71.23,50.00
10,013,04,030,0024,0215,544,31,575,890,0,6,0,6,3,0,3,0.00,64.61,50.00
10,013,04,030,0024,0216,575,58,633,944,0,6,0,6,3,0,3,0.00,67.06,50.00
10,013,04,030,0016,0217,673,28,701,1087,0,6,0,6,3,0,3,0.00,64.49,50.00
10,013,04,030,0016,0218,706,26,732,1152,0,6,0,6,3,0,3,0.00,63.54,50.00
10,013,04,030,0017,0219,657,16,673,920,0,6,0,6,3,0,3,0.00,73.15,50.00
10,013,04,030,0022,0000,412,23,435,696,0,6,0,6,3,0,3,0.00,62.50,50.00
10,013,04,030,0017,0220,628,19,647,916,0,6,0,6,3,0,3,0.00,70.63,50.00
10,013,04,030,0018,0221,506,13,519,779,0,6,0,6,3,0,3,0.00,66.62,50.00
10,013,04,030,0018,0222,434,12,446,680,0,6,0,6,3,0,3,0.00,65.59,50.00
10,013,04,030,0021,0223,708,31,739,1025,0,6,0,6,3,0,3,0.00,72.10,50.00
10,013,04,030,0022,0224,412,23,435,696,0,6,0,6,3,0,3,0.00,62.50,50.00
10,013,04,030,0024,0000,1773,116,1889,2790,0,6,0,6,3,0,3,0.00,67.71,50.00
10,013,04,040,0004,0000,2243,66,2309,4021,0,5,1,6,3,0,3,0.00,57.42,50.00
10,013,04,040,0015,0000,907,30,937,1607,0,5,1,6,3,0,3,0.00,58.31,50.00
10,013,04,040,0016,0000,795,30,825,1143,0,5,1,6,3,0,3,0.00,72.18,50.00
10,013,04,040,0017,0000,622,14,636,1039,0,5,1,6,3,0,3,0.00,61.21,50.00
10,013,04,040,0004,0245,642,19,661,1124,0,5,1,6,3,0,3,0.00,58.81,50.00
10,013,04,040,0004,0246,532,15,547,923,0,5,1,6,3,0,3,0.00,59.26,50.00
10,013,04,040,0004,0247,574,17,591,995,0,5,1,6,3,0,3,0.00,59.40,50.00
10,013,04,040,0004,0248,495,15,510,979,0,5,1,6,3,0,3,0.00,52.09,50.00
10,013,04,040,0015,0249,445,16,461,770,0,5,1,6,3,0,3,0.00,59.87,50.00
10,013,04,040,0015,0250,462,14,476,837,0,5,1,6,3,0,3,0.00,56.87,50.00
10,013,04,040,0016,0251,390,14,404,562,0,5,1,6,3,0,3,0.00,71.89,50.00
10,013,04,040,0016,0252,405,16,421,581,0,5,1,6,3,0,3,0.00,72.46,50.00
10,013,04,040,0017,0253,622,14,636,1039,0,5,1,6,3,0,3,0.00,61.21,50.00
10,013,04,050,0009,0000,1511,41,1552,2211,0,3,1,4,2,1,3,0.00,70.19,75.00
10,013,04,050,0014,0000,637,31,668,796,0,3,1,4,2,1,3,0.00,83.92,75.00
10,013,04,050,0015,0000,814,54,868,1195,0,3,1,4,2,1,3,0.00,72.64,75.00
10,013,04,050,0016,0000,1021,19,1040,1442,0,3,1,4,2,1,3,0.00,72.12,75.00
10,013,04,050,0017,0000,665,32,697,920,0,3,1,4,2,1,3,0.00,75.76,75.00
10,013,04,050,0018,0000,1210,36,1246,1926,0,3,1,4,2,1,3,0.00,64.69,75.00
10,013,04,050,0019,0000,918,32,950,1587,0,3,1,4,2,1,3,0.00,59.86,75.00
10,013,04,050,0020,0000,1108,54,1162,1635,0,3,1,4,2,1,3,0.00,71.07,75.00
10,013,04,050,0014,0286,637,31,668,796,0,3,1,4,2,1,3,0.00,83.92,75.00
10,013,04,050,0015,0287,814,54,868,1195,0,3,1,4,2,1,3,0.00,72.64,75.00
10,013,04,050,0016,0288,1021,19,1040,1442,0,3,1,4,2,1,3,0.00,72.12,75.00
10,013,04,050,0017,0289,665,32,697,920,0,3,1,4,2,1,3,0.00,75.76,75.00
10,013,04,050,0018,0290,539,9,548,800,0,3,1,4,2,1,3,0.00,68.50,75.00
10,013,04,050,0018,0291,671,27,698,1126,0,3,1,4,2,1,3,0.00,61.99,75.00
10,013,04,050,0020,0292,555,27,582,800,0,3,1,4,2,1,3,0.00,72.75,75.00
10,013,04,050,0020,0293,553,27,580,835,0,3,1,4,2,1,3,0.00,69.46,75.00
10,013,04,050,0019,0294,546,18,564,917,0,3,1,4,2,1,3,0.00,61.50,75.00
10,013,04,050,0019,0295,372,14,386,670,0,3,1,4,2,1,3,0.00,57.61,75.00
10,013,04,050,0009,0296,724,19,743,1003,0,3,1,4,2,1,3,0.00,74.08,75.00
10,013,04,050,0009,0297,787,22,809,1208,0,3,1,4,2,1,3,0.00,66.97,75.00
10,013,04,070,0005,0000,812,19,831,1155,0,5,0,5,3,0,3,0.00,71.95,60.00
10,013,04,070,0006,0000,561,12,573,830,0,5,0,5,3,0,3,0.00,69.04,60.00
10,013,04,070,0007,0000,435,10,445,637,0,5,0,5,3,0,3,0.00,69.86,60.00
10,013,04,070,0005,0327,812,19,831,1155,0,5,0,5,3,0,3,0.00,71.95,60.00
10,013,04,070,0006,0328,561,12,573,830,0,5,0,5,3,0,3,0.00,69.04,60.00
10,013,04,070,0007,0329,435,10,445,637,0,5,0,5,3,0,3,0.00,69.86,60.00
10,013,04,080,0007,0000,1267,33,1300,1694,0,3,0,3,2,0,2,0.00,76.74,66.67
10,013,04,080,0009,0000,1120,31,1151,1482,0,3,0,3,2,0,2,0.00,77.67,66.67
10,013,04,080,0007,0344,1267,33,1300,1694,0,3,0,3,2,0,2,0.00,76.74,66.67
10,013,04,080,0009,0345,1120,31,1151,1482,0,3,0,3,2,0,2,0.00,77.67,66.67
10,013,04,090,0011,0000,1301,43,1344,1935,0,4,1,5,1,1,2,0.00,69.46,40.00
10,013,04,090,0012,0000,1244,37,1281,1740,0,4,1,5,1,1,2,0.00,73.62,40.00
10,013,04,090,0013,0000,553,25,578,913,0,4,1,5,1,1,2,0.00,63.31,40.00
10,013,04,090,0014,0000,361,15,376,496,0,4,1,5,1,1,2,0.00,75.81,40.00
10,013,04,090,0011,0360,1009,35,1044,1453,0,4,1,5,1,1,2,0.00,71.85,40.00
10,013,04,090,0011,0361,292,8,300,482,0,4,1,5,1,1,2,0.00,62.24,40.00
10,013,04,090,0012,0362,546,18,564,777,0,4,1,5,1,1,2,0.00,72.59,40.00
10,013,04,090,0012,0363,698,19,717,963,0,4,1,5,1,1,2,0.00,74.45,40.00
10,013,04,090,0013,0364,553,25,578,913,0,4,1,5,1,1,2,0.00,63.31,40.00
10,013,04,090,0014,0365,361,15,376,496,0,4,1,5,1,1,2,0.00,75.81,40.00
10,013,04,100,0008,0000,427,12,439,539,0,5,0,5,2,0,2,0.00,81.45,40.00
10,013,04,100,0010,0000,1108,35,1143,1530,0,5,0,5,2,0,2,0.00,74.71,40.00
10,013,04,100,0012,0000,690,23,713,933,0,5,0,5,2,0,2,0.00,76.42,40.00
10,013,04,100,0012,0385,690,23,713,933,0,5,0,5,2,0,2,0.00,76.42,40.00
10,013,04,100,0010,0386,508,14,522,687,0,5,0,5,2,0,2,0.00,75.98,40.00
10,013,04,100,0010,0387,600,21,621,843,0,5,0,5,2,0,2,0.00,73.67,40.00
10,013,04,100,0008,0388,427,12,439,539,0,5,0,5,2,0,2,0.00,81.45,40.00
10,013,04,110,0016,0000,682,27,709,967,0,3,1,4,2,0,2,0.00,73.32,50.00
10,013,04,110,0017,0000,726,16,742,998,0,3,1,4,2,0,2,0.00,74.35,50.00
10,013,04,110,0018,0000,802,22,824,1116,0,3,1,4,2,0,2,0.00,73.84,50.00
10,013,04,110,0019,0000,969,15,984,1421,0,3,1,4,2,0,2,0.00,69.25,50.00
10,013,04,110,0016,0407,682,27,709,967,0,3,1,4,2,0,2,0.00,73.32,50.00
10,013,04,110,0017,0408,726,16,742,998,0,3,1,4,2,0,2,0.00,74.35,50.00
10,013,04,110,0018,0409,527,10,537,673,0,3,1,4,2,0,2,0.00,79.79,50.00
10,013,04,110,0018,0410,275,12,287,443,0,3,1,4,2,0,2,0.00,64.79,50.00
10,013,04,110,0019,0411,428,6,434,648,0,3,1,4,2,0,2,0.00,66.98,50.00
10,013,04,110,0019,0412,541,9,550,773,0,3,1,4,2,0,2,0.00,71.15,50.00
10,013,04,120,0011,0000,1046,24,1070,1603,0,2,3,5,2,2,4,0.00,66.75,80.00
10,013,04,120,0012,0000,899,24,923,1323,0,2,3,5,2,2,4,0.00,69.77,80.00
10,013,04,120,0013,0000,872,35,907,1174,0,2,3,5,2,2,4,0.00,77.26,80.00
10,013,04,120,0014,0000,814,28,842,1113,0,2,3,5,2,2,4,0.00,75.65,80.00
10,013,04,120,0011,0426,491,14,505,785,0,2,3,5,2,2,4,0.00,64.33,80.00
10,013,04,120,0011,0427,555,10,565,818,0,2,3,5,2,2,4,0.00,69.07,80.00
10,013,04,120,0012,0428,899,24,923,1323,0,2,3,5,2,2,4,0.00,69.77,80.00
10,013,04,120,0013,0429,872,35,907,1174,0,2,3,5,2,2,4,0.00,77.26,80.00
10,013,04,120,0014,0430,422,13,435,555,0,2,3,5,2,2,4,0.00,78.38,80.00
10,013,04,120,0014,0431,392,15,407,558,0,2,3,5,2,2,4,0.00,72.94,80.00
10,013,04,130,0015,0000,1152,25,1177,2162,0,5,2,7,3,1,4,0.00,54.44,57.14
10,013,04,130,0016,0000,963,26,989,1452,0,5,2,7,3,1,4,0.00,68.11,57.14
10,013,04,130,0017,0000,1251,38,1289,2298,0,5,2,7,3,1,4,0.00,56.09,57.14
10,013,04,130,0018,0000,1126,46,1172,2227,0,5,2,7,3,1,4,0.00,52.63,57.14
10,013,04,130,0019,0000,483,17,500,733,0,5,2,7,3,1,4,0.00,68.21,57.14
10,013,04,130,0020,0000,1022,23,1045,1639,0,5,2,7,3,1,4,0.00,63.76,57.14
10,013,04,130,0021,0000,1371,36,1407,2289,0,5,2,7,3,1,4,0.00,61.47,57.14
10,013,04,130,0022,0000,777,29,806,1205,0,5,2,7,3,1,4,0.00,66.89,57.14
10,013,04,130,0023,0000,415,24,439,753,0,5,2,7,3,1,4,0.00,58.30,57.14
10,013,04,130,0015,0459,569,11,580,1027,0,5,2,7,3,1,4,0.00,56.48,57.14
10,013,04,130,0015,0460,583,14,597,1135,0,5,2,7,3,1,4,0.00,52.60,57.14
10,013,04,130,0016,0461,963,26,989,1452,0,5,2,7,3,1,4,0.00,68.11,57.14
10,013,04,130,0017,0462,669,21,690,1154,0,5,2,7,3,1,4,0.00,59.79,57.14
10,013,04,130,0017,0463,582,17,599,1144,0,5,2,7,3,1,4,0.00,52.36,57.14
10,013,04,130,0018,0464,675,31,706,1270,0,5,2,7,3,1,4,0.00,55.59,57.14
10,013,04,130,0018,0465,451,15,466,957,0,5,2,7,3,1,4,0.00,48.69,57.14
10,013,04,130,0019,0466,483,17,500,733,0,5,2,7,3,1,4,0.00,68.21,57.14
10,013,04,130,0020,0467,536,5,541,843,0,5,2,7,3,1,4,0.00,64.18,57.14
10,013,04,130,0020,0468,486,18,504,796,0,5,2,7,3,1,4,0.00,63.32,57.14
10,013,04,130,0021,0469,662,18,680,1141,0,5,2,7,3,1,4,0.00,59.60,57.14
10,013,04,130,0021,0470,709,18,727,1148,0,5,2,7,3,1,4,0.00,63.33,57.14
10,013,04,130,0022,0471,777,29,806,1205,0,5,2,7,3,1,4,0.00,66.89,57.14
10,013,04,130,0023,0472,415,24,439,753,0,5,2,7,3,1,4,0.00,58.30,57.14
10,013,04,170,0013,0000,1801,35,1836,2638,0,1,4,5,0,3,3,0.00,69.60,60.00
10,013,04,170,0014,0000,2685,50,2735,4165,0,1,4,5,0,3,3,0.00,65.67,60.00
10,013,04,170,0015,0000,1455,29,1484,2176,0,1,4,5,0,3,3,0.00,68.20,60.00
10,013,04,170,0013,0546,620,11,631,830,0,1,4,5,0,3,3,0.00,76.02,60.00
10,013,04,170,0013,0547,621,7,628,902,0,1,4,5,0,3,3,0.00,69.62,60.00
10,013,04,170,0013,0548,560,17,577,906,0,1,4,5,0,3,3,0.00,63.69,60.00
10,013,04,170,0014,0549,842,22,864,1353,0,1,4,5,0,3,3,0.00,63.86,60.00
10,013,04,170,0014,0550,507,6,513,773,0,1,4,5,0,3,3,0.00,66.36,60.00
10,013,04,170,0014,0551,589,11,600,867,0,1,4,5,0,3,3,0.00,69.20,60.00
10,013,04,170,0014,0552,747,11,758,1172,0,1,4,5,0,3,3,0.00,64.68,60.00
10,013,04,170,0015,0553,693,11,704,1039,0,1,4,5,0,3,3,0.00,67.76,60.00
10,013,04,170,0015,0554,762,18,780,1137,0,1,4,5,0,3,3,0.00,68.60,60.00
10,013,04,180,0007,0000,623,24,647,876,0,5,1,6,2,1,3,0.00,73.86,50.00
10,013,04,180,0008,0000,1243,22,1265,1757,0,5,1,6,2,1,3,0.00,72.00,50.00
10,013,04,180,0007,0564,623,24,647,876,0,5,1,6,2,1,3,0.00,73.86,50.00
10,013,04,180,0008,0565,579,13,592,843,0,5,1,6,2,1,3,0.00,70.23,50.00
10,013,04,180,0008,0566,664,9,673,914,0,5,1,6,2,1,3,0.00,73.63,50.00
10,013,04,200,0009,0000,648,18,666,943,0,3,0,3,2,0,2,0.00,70.63,66.67
10,013,04,200,0010,0000,353,9,362,499,0,3,0,3,2,0,2,0.00,72.55,66.67
10,013,04,200,0009,0593,648,18,666,943,0,3,0,3,2,0,2,0.00,70.63,66.67
10,013,04,200,0010,0594,353,9,362,499,0,3,0,3,2,0,2,0.00,72.55,66.67
10,013,04,210,0011,0000,627,24,651,1015,0,3,0,3,2,0,2,0.00,64.14,66.67
10,013,04,210,0012,0000,1281,69,1350,2248,0,3,0,3,2,0,2,0.00,60.05,66.67
10,013,04,210,0011,0608,627,24,651,1015,0,3,0,3,2,0,2,0.00,64.14,66.67
10,013,04,210,0012,0609,661,36,697,1171,0,3,0,3,2,0,2,0.00,59.52,66.67
10,013,04,210,0012,0610,620,33,653,1077,0,3,0,3,2,0,2,0.00,60.63,66.67
10,013,04,220,0007,0000,1137,17,1154,1615,0,4,2,6,3,0,3,0.00,71.46,50.00
10,013,04,220,0008,0000,602,8,610,862,0,4,2,6,3,0,3,0.00,70.77,50.00
10,013,04,220,0007,0618,1137,17,1154,1615,0,4,2,6,3,0,3,0.00,71.46,50.00
10,013,04,220,0008,0619,602,8,610,862,0,4,2,6,3,0,3,0.00,70.77,50.00
10,013,04,230,0008,0000,339,6,345,411,0,3,0,3,2,0,2,0.00,83.94,66.67
10,013,04,230,0009,0000,392,6,398,466,0,3,0,3,2,0,2,0.00,85.41,66.67
10,013,04,230,0010,0000,437,13,450,516,0,3,0,3,2,0,2,0.00,87.21,66.67
10,013,04,230,0011,0000,320,9,329,409,0,3,0,3,2,0,2,0.00,80.44,66.67
10,013,04,230,0008,0629,339,6,345,411,0,3,0,3,2,0,2,0.00,83.94,66.67
10,013,04,230,0009,0630,392,6,398,466,0,3,0,3,2,0,2,0.00,85.41,66.67
10,013,04,230,0010,0631,437,13,450,516,0,3,0,3,2,0,2,0.00,87.21,66.67
10,013,04,230,0011,0632,320,9,329,409,0,3,0,3,2,0,2,0.00,80.44,66.67
10,013,00,050,0000,0000,28111,1559,29670,41766,49483,12,5,17,8,3,11,84.40,71.04,64.71
10,013,01,050,0000,0000,5797,223,6020,8203,9598,2,1,3,2,0,2,85.47,73.39,66.67
10,013,02,050,0000,0000,10039,399,10438,14998,17939,5,3,8,2,2,4,83.61,69.60,50.00
10,013,03,050,0000,0000,4391,638,5029,6853,8086,2,0,2,2,0,2,84.75,73.38,100.00
10,013,04,050,0000,0000,7884,299,8183,11712,13860,3,1,4,2,1,3,84.50,69.87,75.00
10,013,00,060,0000,0000,16557,484,17041,25404,29172,12,2,14,9,2,11,87.08,67.08,78.57
10,013,01,060,0000,0000,7179,199,7378,11599,13421,4,2,6,3,2,5,86.42,63.61,83.33
10,013,02,060,0000,0000,4507,148,4655,6722,7511,4,0,4,3,0,3,89.50,69.25,75.00
10,013,03,060,0000,0000,4871,137,5008,7083,8240,4,0,4,3,0,3,85.96,70.70,75.00
10,013,00,070,0000,0000,6321,200,6521,9422,10577,14,3,17,9,2,11,89.08,69.21,64.71
10,013,01,070,0000,0000,1436,42,1478,2045,2284,3,1,4,2,0,2,89.54,72.27,50.00
10,013,02,070,0000,0000,1596,46,1642,2291,2580,4,0,4,3,0,3,88.80,71.67,75.00
10,013,03,070,0000,0000,1481,71,1552,2464,2811,2,2,4,1,2,3,87.66,62.99,75.00
10,013,04,070,0000,0000,1808,41,1849,2622,2902,5,0,5,3,0,3,90.35,70.52,60.00
10,013,00,080,0000,0000,12473,867,13340,18547,21636,10,4,14,9,2,11,85.72,71.93,78.57
10,013,01,080,0000,0000,3807,144,3951,5425,6379,2,3,5,2,1,3,85.04,72.83,60.00
10,013,02,080,0000,0000,4535,425,4960,7231,8431,3,1,4,3,1,4,85.77,68.59,100.00
10,013,03,080,0000,0000,1744,234,1978,2715,3147,2,0,2,2,0,2,86.27,72.85,100.00
10,013,04,080,0000,0000,2387,64,2451,3176,3679,3,0,3,2,0,2,86.33,77.17,66.67
10,013,00,090,0000,0000,14320,512,14832,21365,25643,17,1,18,10,1,11,83.32,69.42,61.11
10,013,01,090,0000,0000,4005,191,4196,6120,7532,4,0,4,3,0,3,81.25,68.56,75.00
10,013,02,090,0000,0000,3387,85,3472,5124,6181,5,0,5,3,0,3,82.90,67.76,60.00
10,013,03,090,0000,0000,3469,116,3585,5037,5977,4,0,4,3,0,3,84.27,71.17,75.00
10,013,04,090,0000,0000,3459,120,3579,5084,5953,4,1,5,1,1,2,85.40,70.40,40.00
10,013,00,100,0000,0000,15160,562,15722,21037,24332,16,3,19,10,1,11,86.46,74.73,57.89
10,013,01,100,0000,0000,6626,256,6882,9207,10715,4,3,7,4,1,5,85.93,74.75,71.43
10,013,02,100,0000,0000,1922,95,2017,2575,2902,2,0,2,1,0,1,88.73,78.33,50.00
10,013,03,100,0000,0000,4387,141,4528,6253,7307,5,0,5,3,0,3,85.58,72.41,60.00
10,013,04,100,0000,0000,2225,70,2295,3002,3408,5,0,5,2,0,2,88.09,76.45,40.00
10,013,00,110,0000,0000,14309,408,14717,20424,23253,13,4,17,9,2,11,87.83,72.06,64.71
10,013,01,110,0000,0000,4948,120,5068,7076,8112,4,2,6,3,1,4,87.23,71.62,66.67
10,013,02,110,0000,0000,2571,93,2664,3827,4274,3,0,3,2,0,2,89.54,69.61,66.67
10,013,03,110,0000,0000,3611,115,3726,5019,5734,3,1,4,2,1,3,87.53,74.24,75.00
10,013,04,110,0000,0000,3179,80,3259,4502,5133,3,1,4,2,0,2,87.71,72.39,50.00
10,013,00,120,0000,0000,10787,457,11244,16791,19522,11,6,17,7,4,11,86.01,66.96,64.71
10,013,01,120,0000,0000,3193,105,3298,4770,5522,4,2,6,2,1,3,86.38,69.14,50.00
10,013,02,120,0000,0000,2084,99,2183,3339,3809,4,0,4,2,0,2,87.66,65.38,50.00
10,013,03,120,0000,0000,1879,142,2021,3469,4073,1,1,2,1,1,2,85.17,58.26,100.00
10,013,04,120,0000,0000,3631,111,3742,5213,6118,2,3,5,2,2,4,85.21,71.78,80.00
10,013,00,130,0000,0000,25864,920,26784,45273,52229,14,6,20,9,4,13,86.68,59.16,65.00
10,013,01,130,0000,0000,9762,373,10135,17749,20554,3,3,6,3,2,5,86.35,57.10,83.33
10,013,02,130,0000,0000,4827,168,4995,8145,9313,4,1,5,2,1,3,87.46,61.33,60.00
10,013,03,130,0000,0000,2715,115,2830,4621,5231,2,0,2,1,0,1,88.34,61.24,50.00
10,013,04,130,0000,0000,8560,264,8824,14758,17131,5,2,7,3,1,4,86.15,59.79,57.14
10,013,00,140,0000,0000,10182,302,10484,14318,16111,13,4,17,8,3,11,88.87,73.22,64.71
10,013,01,140,0000,0000,4485,159,4644,6209,6962,5,3,8,2,3,5,89.18,74.79,62.50
10,013,02,140,0000,0000,2758,74,2832,4008,4514,5,0,5,3,0,3,88.79,70.66,60.00
10,013,03,140,0000,0000,2939,69,3008,4101,4635,3,1,4,3,0,3,88.48,73.35,75.00
10,013,00,150,0000,0000,6112,150,6262,8570,9712,16,5,21,8,3,11,88.24,73.07,52.38
10,013,01,150,0000,0000,3155,84,3239,4543,5083,9,3,12,4,2,6,89.38,71.30,50.00
10,013,02,150,0000,0000,2957,66,3023,4027,4629,7,2,9,4,1,5,87.00,75.07,55.56
10,013,00,160,0000,0000,13183,590,13773,19979,22998,13,5,18,6,5,11,86.87,68.94,61.11
10,013,01,160,0000,0000,6250,111,6361,8945,10428,9,2,11,3,2,5,85.78,71.11,45.45
10,013,02,160,0000,0000,3947,367,4314,6618,7483,2,2,4,2,2,4,88.44,65.19,100.00
10,013,03,160,0000,0000,2986,112,3098,4416,5087,2,1,3,1,1,2,86.81,70.15,66.67
10,013,00,170,0000,0000,19804,505,20309,28898,33115,16,4,20,8,3,11,87.27,70.28,55.00
10,013,01,170,0000,0000,4928,110,5038,6858,8055,5,0,5,3,0,3,85.14,73.46,60.00
10,013,02,170,0000,0000,4905,129,5034,7081,8102,5,0,5,3,0,3,87.40,71.09,60.00
10,013,03,170,0000,0000,4030,152,4182,5980,6728,5,0,5,2,0,2,88.88,69.93,40.00
10,013,04,170,0000,0000,5941,114,6055,8979,10230,1,4,5,0,3,3,87.77,67.44,60.00
10,013,00,180,0000,0000,7916,194,8110,11554,15074,14,7,21,6,5,11,76.65,70.19,52.38
10,013,01,180,0000,0000,2724,58,2782,4115,5564,2,4,6,1,3,4,73.96,67.61,66.67
10,013,02,180,0000,0000,1694,51,1745,2379,3133,2,1,3,1,1,2,75.93,73.35,66.67
10,013,03,180,0000,0000,1632,39,1671,2427,3015,5,1,6,2,0,2,80.50,68.85,33.33
10,013,04,180,0000,0000,1866,46,1912,2633,3362,5,1,6,2,1,3,78.32,72.62,50.00
10,013,00,190,0000,0000,10641,228,10869,14606,16785,12,6,18,8,3,11,87.02,74.41,61.11
10,013,01,190,0000,0000,4843,102,4945,6464,7428,6,4,10,4,1,5,87.02,76.50,50.00
10,013,02,190,0000,0000,3955,72,4027,5303,6167,3,2,5,2,2,4,85.99,75.94,80.00
10,013,03,190,0000,0000,1843,54,1897,2839,3190,3,0,3,2,0,2,89.00,66.82,66.67
10,013,00,200,0000,0000,6367,131,6498,8936,10064,16,8,24,6,5,11,88.79,72.72,45.83
10,013,01,200,0000,0000,3117,62,3179,4379,4951,7,6,13,2,3,5,88.45,72.60,38.46
10,013,02,200,0000,0000,795,16,811,1105,1216,1,1,2,0,1,1,90.87,73.39,50.00
10,013,03,200,0000,0000,1454,26,1480,2010,2275,5,1,6,2,1,3,88.35,73.63,50.00
10,013,04,200,0000,0000,1001,27,1028,1442,1622,3,0,3,2,0,2,88.90,71.29,66.67
10,013,00,210,0000,0000,10447,359,10806,15914,18099,15,3,18,9,2,11,87.93,67.90,61.11
10,013,01,210,0000,0000,3520,102,3622,5138,5787,4,2,6,2,2,4,88.79,70.49,66.67
10,013,02,210,0000,0000,2641,80,2721,3835,4356,5,0,5,3,0,3,88.04,70.95,60.00
10,013,03,210,0000,0000,2378,84,2462,3678,4148,3,1,4,2,0,2,88.67,66.94,50.00
10,013,04,210,0000,0000,1908,93,2001,3263,3808,3,0,3,2,0,2,85.69,61.32,66.67
10,013,00,220,0000,0000,7279,188,7467,10531,12226,15,2,17,11,0,11,86.14,70.90,64.71
10,013,01,220,0000,0000,2278,45,2323,3239,3703,5,0,5,3,0,3,87.47,71.72,60.00
10,013,02,220,0000,0000,1885,26,1911,2609,3068,4,0,4,3,0,3,85.04,73.25,75.00
10,013,03,220,0000,0000,1377,92,1469,2206,2555,2,0,2,2,0,2,86.34,66.59,100.00
10,013,04,220,0000,0000,1739,25,1764,2477,2900,4,2,6,3,0,3,85.41,71.22,50.00
10,013,00,230,0000,0000,5104,390,5494,7250,8254,11,1,12,7,0,7,87.84,75.78,58.33
10,013,01,230,0000,0000,653,271,924,1287,1452,1,0,1,1,0,1,88.64,71.79,100.00
10,013,02,230,0000,0000,2153,59,2212,2992,3438,5,1,6,3,0,3,87.03,73.93,50.00
10,013,03,230,0000,0000,810,26,836,1169,1328,2,0,2,1,0,1,88.03,71.51,50.00
10,013,04,230,0000,0000,1488,34,1522,1802,2036,3,0,3,2,0,2,88.51,84.46,66.67
10,013,00,240,0000,0000,4227,63,4290,5541,6195,8,3,11,4,2,6,89.44,77.42,54.55
10,013,01,240,0000,0000,1579,21,1600,1988,2234,4,0,4,2,0,2,88.99,80.48,50.00
10,013,02,240,0000,0000,1357,25,1382,1913,2100,2,1,3,1,1,2,91.10,72.24,66.67
10,013,03,240,0000,0000,1291,17,1308,1640,1861,2,2,4,1,1,2,88.12,79.76,50.00
10,013,00,250,0000,0000,3741,85,3826,4559,5153,9,1,10,6,1,7,88.47,83.92,70.00
10,013,01,250,0000,0000,798,18,816,972,1099,2,0,2,1,0,1,88.44,83.95,50.00
10,013,02,250,0000,0000,1512,37,1549,1808,2077,3,1,4,2,1,3,87.05,85.67,75.00
10,013,03,250,0000,0000,1431,30,1461,1779,1977,4,0,4,3,0,3,89.98,82.12,75.00
10,013,00,260,0000,0000,5267,94,5361,6350,7809,11,5,16,4,3,7,81.32,84.43,43.75
10,013,01,260,0000,0000,2394,43,2437,2957,3588,4,3,7,1,2,3,82.41,82.41,42.86
10,013,02,260,0000,0000,2873,51,2924,3393,4221,7,2,9,3,1,4,80.38,86.18,44.44
10,013,00,270,0000,0000,2549,24,2573,2903,3341,8,2,10,5,2,7,86.89,88.63,70.00
10,013,01,270,0000,0000,1406,7,1413,1630,1840,3,2,5,2,2,4,88.59,86.69,80.00
10,013,02,270,0000,0000,1143,17,1160,1273,1501,5,0,5,3,0,3,84.81,91.12,60.00
10,013,00,280,0000,0000,4657,50,4707,5568,6812,14,2,16,6,1,7,81.74,84.54,43.75
10,013,01,280,0000,0000,2708,27,2735,3251,3921,8,2,10,3,1,4,82.91,84.13,40.00
10,013,02,280,0000,0000,1949,23,1972,2317,2891,6,0,6,3,0,3,80.15,85.11,50.00
10,013,00,290,0000,0000,3526,48,3574,4206,5352,7,4,11,6,1,7,78.59,84.97,63.64
10,013,01,290,0000,0000,2572,38,2610,3063,3979,5,3,8,4,1,5,76.98,85.21,62.50
10,013,02,290,0000,0000,954,10,964,1143,1373,2,1,3,2,0,2,83.25,84.34,66.67
10,013,00,300,0000,0000,4894,52,4946,6084,7442,10,3,13,6,1,7,81.75,81.30,53.85
10,013,01,300,0000,0000,2656,27,2683,3273,3993,5,3,8,3,1,4,81.97,81.97,50.00
10,013,02,300,0000,0000,2238,25,2263,2811,3449,5,0,5,3,0,3,81.50,80.51,60.00
10,013,00,310,0000,0000,3014,69,3083,3839,4914,6,2,8,5,2,7,78.12,80.31,87.50
10,013,01,310,0000,0000,1471,24,1495,1829,2380,3,1,4,2,1,3,76.85,81.74,75.00
10,013,02,310,0000,0000,1543,45,1588,2010,2534,3,1,4,3,1,4,79.32,79.00,100.00
10,013,00,320,0000,0000,3254,51,3305,4076,4906,9,3,12,6,1,7,83.08,81.08,58.33
10,013,01,320,0000,0000,1803,25,1828,2305,2726,4,2,6,3,1,4,84.56,79.31,66.67
10,013,02,320,0000,0000,1451,26,1477,1771,2180,5,1,6,3,0,3,81.24,83.40,50.00
10,013,00,330,0000,0000,3062,60,3122,4050,4866,8,3,11,5,2,7,83.23,77.09,63.64
10,013,01,330,0000,0000,2233,50,2283,2958,3584,5,2,7,4,1,5,82.53,77.18,71.43
10,013,02,330,0000,0000,829,10,839,1092,1282,3,1,4,1,1,2,85.18,76.83,50.00
10,014,00,000,0000,0000,83340,3950,87290,133208,158274,125,35,160,76,22,98,84.16,65.53,61.25
10,014,01,160,0001,0000,732,13,745,1271,0,11,4,15,5,2,7,0.00,58.62,46.67
10,014,01,160,0002,0000,409,13,422,752,0,11,4,15,5,2,7,0.00,56.12,46.67
10,014,01,160,0003,0000,664,16,680,1256,0,11,4,15,5,2,7,0.00,54.14,46.67
10,014,01,160,0004,0000,454,16,470,932,0,11,4,15,5,2,7,0.00,50.43,46.67
10,014,01,160,0004,0233,454,16,470,932,0,11,4,15,5,2,7,0.00,50.43,46.67
10,014,01,160,0003,0234,664,16,680,1256,0,11,4,15,5,2,7,0.00,54.14,46.67
10,014,01,160,0001,0235,732,13,745,1271,0,11,4,15,5,2,7,0.00,58.62,46.67
10,014,01,160,0002,0236,409,13,422,752,0,11,4,15,5,2,7,0.00,56.12,46.67
10,014,00,010,0000,0000,41140,2618,43758,69390,83758,17,6,23,13,2,15,82.85,63.06,65.22
10,014,01,010,0000,0000,5730,861,6591,10210,12146,2,0,2,2,0,2,84.06,64.55,100.00
10,014,02,010,0000,0000,16513,745,17258,27487,34062,7,3,10,5,1,6,80.70,62.79,60.00
10,014,03,010,0000,0000,14796,630,15426,24503,29345,6,3,9,4,1,5,83.50,62.96,55.56
10,014,04,010,0000,0000,4101,382,4483,7190,8205,2,0,2,2,0,2,87.63,62.35,100.00
10,014,01,010,0023,0001,332,56,388,807,0,2,0,2,2,0,2,0.00,48.08,100.00
10,014,01,010,0023,0002,358,81,439,667,0,2,0,2,2,0,2,0.00,65.82,100.00
10,014,01,010,0015,0003,626,69,695,1057,0,2,0,2,2,0,2,0.00,65.75,100.00
10,014,01,010,0015,0004,439,57,496,698,0,2,0,2,2,0,2,0.00,71.06,100.00
10,014,01,010,0024,0005,486,86,572,853,0,2,0,2,2,0,2,0.00,67.06,100.00
10,014,01,010,0024,0006,483,68,551,837,0,2,0,2,2,0,2,0.00,65.83,100.00
10,014,01,010,0020,0007,596,60,656,1030,0,2,0,2,2,0,2,0.00,63.69,100.00
10,014,01,010,0020,0008,523,74,597,932,0,2,0,2,2,0,2,0.00,64.06,100.00
10,014,01,010,0022,0009,457,80,537,817,0,2,0,2,2,0,2,0.00,65.73,100.00
10,014,01,010,0022,0010,475,97,572,842,0,2,0,2,2,0,2,0.00,67.93,100.00
10,014,01,010,0017,0011,452,68,520,803,0,2,0,2,2,0,2,0.00,64.76,100.00
10,014,01,010,0017,0012,503,65,568,867,0,2,0,2,2,0,2,0.00,65.51,100.00
10,014,01,010,0015,0000,1065,126,1191,1755,0,2,0,2,2,0,2,0.00,67.86,100.00
10,014,01,010,0017,0000,955,133,1088,1670,0,2,0,2,2,0,2,0.00,65.15,100.00
10,014,01,010,0020,0000,1119,134,1253,1962,0,2,0,2,2,0,2,0.00,63.86,100.00
10,014,01,010,0022,0000,932,177,1109,1659,0,2,0,2,2,0,2,0.00,66.85,100.00
10,014,01,010,0023,0000,690,137,827,1474,0,2,0,2,2,0,2,0.00,56.11,100.00
10,014,01,010,0024,0000,969,154,1123,1690,0,2,0,2,2,0,2,0.00,66.45,100.00
10,014,01,020,0001,0000,33,0,33,54,0,9,2,11,3,2,5,0.00,61.11,45.45
10,014,01,020,0002,0000,156,7,163,326,0,9,2,11,3,2,5,0.00,50.00,45.45
10,014,01,020,0003,0000,213,7,220,376,0,9,2,11,3,2,5,0.00,58.51,45.45
10,014,01,020,0004,0000,768,19,787,1150,0,9,2,11,3,2,5,0.00,68.43,45.45
10,014,01,020,0005,0000,1072,22,1094,1553,0,9,2,11,3,2,5,0.00,70.44,45.45
10,014,01,020,0006,0000,1075,29,1104,1569,0,9,2,11,3,2,5,0.00,70.36,45.45
10,014,01,020,0007,0000,72,2,74,134,0,9,2,11,3,2,5,0.00,55.22,45.45
10,014,01,020,0008,0000,196,5,201,402,0,9,2,11,3,2,5,0.00,50.00,45.45
10,014,01,020,0008,0092,63,1,64,142,0,9,2,11,3,2,5,0.00,45.07,45.45
10,014,01,020,0008,0093,93,2,95,185,0,9,2,11,3,2,5,0.00,51.35,45.45
10,014,01,020,0008,0094,40,2,42,75,0,9,2,11,3,2,5,0.00,56.00,45.45
10,014,01,020,0007,0095,72,2,74,134,0,9,2,11,3,2,5,0.00,55.22,45.45
10,014,01,020,0006,0096,50,4,54,100,0,9,2,11,3,2,5,0.00,54.00,45.45
10,014,01,020,0006,0097,533,7,540,760,0,9,2,11,3,2,5,0.00,71.05,45.45
10,014,01,020,0006,0098,492,18,510,709,0,9,2,11,3,2,5,0.00,71.93,45.45
10,014,01,020,0005,0099,546,11,557,787,0,9,2,11,3,2,5,0.00,70.78,45.45
10,014,01,020,0005,0100,526,11,537,766,0,9,2,11,3,2,5,0.00,70.10,45.45
10,014,01,020,0004,0101,310,8,318,487,0,9,2,11,3,2,5,0.00,65.30,45.45
10,014,01,020,0004,0102,458,11,469,663,0,9,2,11,3,2,5,0.00,70.74,45.45
10,014,01,020,0003,0103,102,3,105,174,0,9,2,11,3,2,5,0.00,60.34,45.45
10,014,01,020,0003,0104,111,4,115,202,0,9,2,11,3,2,5,0.00,56.93,45.45
10,014,01,020,0002,0105,78,2,80,156,0,9,2,11,3,2,5,0.00,51.28,45.45
10,014,01,020,0002,0106,78,5,83,170,0,9,2,11,3,2,5,0.00,48.82,45.45
10,014,01,020,0001,0107,22,0,22,35,0,9,2,11,3,2,5,0.00,62.86,45.45
10,014,01,020,0001,0108,11,0,11,19,0,9,2,11,3,2,5,0.00,57.89,45.45
10,014,01,030,0002,0000,672,19,691,969,0,3,1,4,2,1,3,0.00,71.31,75.00
10,014,01,030,0004,0000,517,14,531,709,0,3,1,4,2,1,3,0.00,74.89,75.00
10,014,01,030,0005,0000,847,20,867,1330,0,3,1,4,2,1,3,0.00,65.19,75.00
10,014,01,030,0005,0109,531,12,543,787,0,3,1,4,2,1,3,0.00,69.00,75.00
10,014,01,030,0005,0110,316,8,324,543,0,3,1,4,2,1,3,0.00,59.67,75.00
10,014,01,030,0004,0111,517,14,531,709,0,3,1,4,2,1,3,0.00,74.89,75.00
10,014,01,030,0002,0113,672,19,691,969,0,3,1,4,2,1,3,0.00,71.31,75.00
10,014,01,040,0002,0000,166,6,172,233,0,4,2,6,3,2,5,0.00,73.82,83.33
10,014,01,040,0003,0000,173,11,184,284,0,4,2,6,3,2,5,0.00,64.79,83.33
10,014,01,040,0004,0000,218,12,230,303,0,4,2,6,3,2,5,0.00,75.91,83.33
10,014,01,040,0008,0000,1056,32,1088,1587,0,4,2,6,3,2,5,0.00,68.56,83.33
10,014,01,040,0009,0000,403,13,416,618,0,4,2,6,3,2,5,0.00,67.31,83.33
10,014,01,040,0010,0000,1488,40,1528,2358,0,4,2,6,3,2,5,0.00,64.80,83.33
10,014,01,040,0011,0000,212,13,225,369,0,4,2,6,3,2,5,0.00,60.98,83.33
10,014,01,040,0008,0118,571,20,591,817,0,4,2,6,3,2,5,0.00,72.34,83.33
10,014,01,040,0008,0119,485,12,497,770,0,4,2,6,3,2,5,0.00,64.55,83.33
10,014,01,040,0012,0000,112,10,122,190,0,4,2,6,3,2,5,0.00,64.21,83.33
10,014,01,040,0010,0129,692,21,713,1114,0,4,2,6,3,2,5,0.00,64.00,83.33
10,014,01,040,0013,0000,614,32,646,945,0,4,2,6,3,2,5,0.00,68.36,83.33
10,014,01,040,0010,0130,365,7,372,523,0,4,2,6,3,2,5,0.00,71.13,83.33
10,014,01,040,0010,0131,431,12,443,721,0,4,2,6,3,2,5,0.00,61.44,83.33
10,014,01,040,0009,0132,403,13,416,618,0,4,2,6,3,2,5,0.00,67.31,83.33
10,014,01,040,0011,0133,212,13,225,369,0,4,2,6,3,2,5,0.00,60.98,83.33
10,014,01,040,0012,0134,112,10,122,190,0,4,2,6,3,2,5,0.00,64.21,83.33
10,014,01,040,0013,0135,526,26,552,810,0,4,2,6,3,2,5,0.00,68.15,83.33
10,014,01,040,0013,0136,88,6,94,135,0,4,2,6,3,2,5,0.00,69.63,83.33
10,014,01,040,0003,0137,173,11,184,284,0,4,2,6,3,2,5,0.00,64.79,83.33
10,014,01,040,0004,0138,218,12,230,303,0,4,2,6,3,2,5,0.00,75.91,83.33
10,014,01,040,0002,0139,166,6,172,233,0,4,2,6,3,2,5,0.00,73.82,83.33
10,014,01,050,0004,0000,677,11,688,968,0,5,0,5,3,0,3,0.00,71.07,60.00
10,014,01,050,0006,0000,435,9,444,651,0,5,0,5,3,0,3,0.00,68.20,60.00
10,014,01,050,0007,0000,688,15,703,962,0,5,0,5,3,0,3,0.00,73.08,60.00
10,014,01,050,0006,0140,112,4,116,175,0,5,0,5,3,0,3,0.00,66.29,60.00
10,014,01,050,0006,0141,323,5,328,476,0,5,0,5,3,0,3,0.00,68.91,60.00
10,014,01,050,0007,0142,688,15,703,962,0,5,0,5,3,0,3,0.00,73.08,60.00
10,014,01,050,0004,0143,585,9,594,798,0,5,0,5,3,0,3,0.00,74.44,60.00
10,014,01,050,0004,0144,92,2,94,170,0,5,0,5,3,0,3,0.00,55.29,60.00
10,014,01,060,0001,0000,508,20,528,857,0,3,1,4,2,1,3,0.00,61.61,75.00
10,014,01,060,0004,0000,271,9,280,388,0,3,1,4,2,1,3,0.00,72.16,75.00
10,014,01,060,0005,0000,1106,27,1133,1684,0,3,1,4,2,1,3,0.00,67.28,75.00
10,014,01,060,0007,0000,431,12,443,673,0,3,1,4,2,1,3,0.00,65.82,75.00
10,014,01,060,0005,0150,519,15,534,844,0,3,1,4,2,1,3,0.00,63.27,75.00
10,014,01,060,0005,0151,587,12,599,840,0,3,1,4,2,1,3,0.00,71.31,75.00
10,014,01,060,0001,0152,250,11,261,395,0,3,1,4,2,1,3,0.00,66.08,75.00
10,014,01,060,0001,0153,258,9,267,462,0,3,1,4,2,1,3,0.00,57.79,75.00
10,014,01,060,0004,0156,271,9,280,388,0,3,1,4,2,1,3,0.00,72.16,75.00
10,014,01,060,0007,0157,431,12,443,673,0,3,1,4,2,1,3,0.00,65.82,75.00
10,014,01,070,0001,0000,408,7,415,854,0,3,2,5,1,2,3,0.00,48.59,60.00
10,014,01,070,0002,0000,271,7,278,407,0,3,2,5,1,2,3,0.00,68.30,60.00
10,014,01,070,0003,0000,172,6,178,307,0,3,2,5,1,2,3,0.00,57.98,60.00
10,014,01,070,0004,0000,97,1,98,163,0,3,2,5,1,2,3,0.00,60.12,60.00
10,014,01,070,0005,0000,110,1,111,186,0,3,2,5,1,2,3,0.00,59.68,60.00
10,014,01,070,0006,0000,358,6,364,532,0,3,2,5,1,2,3,0.00,68.42,60.00
10,014,01,070,0007,0000,708,18,726,1071,0,3,2,5,1,2,3,0.00,67.79,60.00
10,014,01,070,0007,0162,266,4,270,434,0,3,2,5,1,2,3,0.00,62.21,60.00
10,014,01,070,0007,0163,227,4,231,314,0,3,2,5,1,2,3,0.00,73.57,60.00
10,014,01,070,0007,0164,215,10,225,323,0,3,2,5,1,2,3,0.00,69.66,60.00
10,014,01,070,0006,0165,358,6,364,532,0,3,2,5,1,2,3,0.00,68.42,60.00
10,014,01,070,0005,0166,110,1,111,186,0,3,2,5,1,2,3,0.00,59.68,60.00
10,014,01,070,0003,0167,172,6,178,307,0,3,2,5,1,2,3,0.00,57.98,60.00
10,014,01,070,0002,0168,271,7,278,407,0,3,2,5,1,2,3,0.00,68.30,60.00
10,014,01,070,0001,0169,153,4,157,480,0,3,2,5,1,2,3,0.00,32.71,60.00
10,014,01,070,0001,0170,103,2,105,154,0,3,2,5,1,2,3,0.00,68.18,60.00
10,014,01,070,0001,0171,152,1,153,220,0,3,2,5,1,2,3,0.00,69.55,60.00
10,014,01,070,0004,0172,97,1,98,163,0,3,2,5,1,2,3,0.00,60.12,60.00
10,014,01,080,0001,0000,115,4,119,188,0,2,1,3,2,1,3,0.00,63.30,100.00
10,014,01,080,0002,0000,127,11,138,325,0,2,1,3,2,1,3,0.00,42.46,100.00
10,014,01,080,0003,0000,217,13,230,381,0,2,1,3,2,1,3,0.00,60.37,100.00
10,014,01,080,0004,0000,591,26,617,1083,0,2,1,3,2,1,3,0.00,56.97,100.00
10,014,01,080,0005,0000,145,8,153,279,0,2,1,3,2,1,3,0.00,54.84,100.00
10,014,01,080,0006,0000,112,7,119,240,0,2,1,3,2,1,3,0.00,49.58,100.00
10,014,01,080,0006,0173,40,0,40,78,0,2,1,3,2,1,3,0.00,51.28,100.00
10,014,01,080,0006,0174,72,7,79,162,0,2,1,3,2,1,3,0.00,48.77,100.00
10,014,01,080,0005,0175,145,8,153,279,0,2,1,3,2,1,3,0.00,54.84,100.00
10,014,01,080,0004,0176,512,19,531,900,0,2,1,3,2,1,3,0.00,59.00,100.00
10,014,01,080,0004,0177,79,7,86,183,0,2,1,3,2,1,3,0.00,46.99,100.00
10,014,01,080,0003,0178,217,13,230,381,0,2,1,3,2,1,3,0.00,60.37,100.00
10,014,01,080,0002,0179,60,9,69,166,0,2,1,3,2,1,3,0.00,41.57,100.00
10,014,01,080,0002,0180,27,1,28,52,0,2,1,3,2,1,3,0.00,53.85,100.00
10,014,01,080,0002,0181,40,1,41,107,0,2,1,3,2,1,3,0.00,38.32,100.00
10,014,01,080,0001,0182,8,0,8,20,0,2,1,3,2,1,3,0.00,40.00,100.00
10,014,01,080,0001,0183,107,4,111,168,0,2,1,3,2,1,3,0.00,66.07,100.00
10,014,01,090,0001,0000,568,7,575,885,0,4,0,4,3,0,3,0.00,64.97,75.00
10,014,01,090,0002,0000,348,10,358,542,0,4,0,4,3,0,3,0.00,66.05,75.00
10,014,01,090,0003,0000,373,6,379,581,0,4,0,4,3,0,3,0.00,65.23,75.00
10,014,01,090,0004,0000,209,5,214,335,0,4,0,4,3,0,3,0.00,63.88,75.00
10,014,01,090,0001,0184,376,3,379,570,0,4,0,4,3,0,3,0.00,66.49,75.00
10,014,01,090,0001,0185,192,4,196,315,0,4,0,4,3,0,3,0.00,62.22,75.00
10,014,01,090,0002,0186,348,10,358,542,0,4,0,4,3,0,3,0.00,66.05,75.00
10,014,01,090,0003,0187,373,6,379,581,0,4,0,4,3,0,3,0.00,65.23,75.00
10,014,01,090,0004,0188,209,5,214,335,0,4,0,4,3,0,3,0.00,63.88,75.00
10,014,01,100,0001,0000,52,1,53,90,0,5,0,5,3,0,3,0.00,58.89,60.00
10,014,01,100,0002,0000,56,2,58,83,0,5,0,5,3,0,3,0.00,69.88,60.00
10,014,01,100,0003,0000,511,10,521,744,0,5,0,5,3,0,3,0.00,70.03,60.00
10,014,01,100,0004,0000,668,12,680,1050,0,5,0,5,3,0,3,0.00,64.76,60.00
10,014,01,100,0005,0000,186,2,188,259,0,5,0,5,3,0,3,0.00,72.59,60.00
10,014,01,100,0005,0199,186,2,188,259,0,5,0,5,3,0,3,0.00,72.59,60.00
10,014,01,100,0004,0200,668,12,680,1050,0,5,0,5,3,0,3,0.00,64.76,60.00
10,014,01,100,0003,0201,511,10,521,744,0,5,0,5,3,0,3,0.00,70.03,60.00
10,014,01,100,0002,0202,56,2,58,83,0,5,0,5,3,0,3,0.00,69.88,60.00
10,014,01,100,0001,0203,16,1,17,24,0,5,0,5,3,0,3,0.00,70.83,60.00
10,014,01,100,0001,0204,36,0,36,66,0,5,0,5,3,0,3,0.00,54.55,60.00
10,014,01,110,0003,0000,885,219,1104,1670,0,2,1,3,2,1,3,0.00,66.11,100.00
10,014,01,110,0003,0205,885,219,1104,1670,0,2,1,3,2,1,3,0.00,66.11,100.00
10,014,01,120,0002,0000,180,8,188,245,0,1,1,2,0,1,1,0.00,76.73,50.00
10,014,01,120,0003,0000,182,5,187,250,0,1,1,2,0,1,1,0.00,74.80,50.00
10,014,01,120,0002,0213,180,8,188,245,0,1,1,2,0,1,1,0.00,76.73,50.00
10,014,01,120,0003,0214,182,5,187,250,0,1,1,2,0,1,1,0.00,74.80,50.00
10,014,01,130,0003,0000,318,5,323,398,0,5,2,7,3,1,4,0.00,81.16,57.14
10,014,01,130,0005,0000,752,31,783,1005,0,5,2,7,3,1,4,0.00,77.91,57.14
10,014,01,130,0005,0215,752,31,783,1005,0,5,2,7,3,1,4,0.00,77.91,57.14
10,014,01,130,0003,0216,318,5,323,398,0,5,2,7,3,1,4,0.00,81.16,57.14
10,014,01,140,0003,0000,961,11,972,1147,0,5,0,5,3,0,3,0.00,84.74,60.00
10,014,01,140,0003,0220,492,5,497,592,0,5,0,5,3,0,3,0.00,83.95,60.00
10,014,01,140,0003,0221,469,6,475,555,0,5,0,5,3,0,3,0.00,85.59,60.00
10,014,01,150,0005,0000,294,7,301,365,0,3,1,4,1,1,2,0.00,82.47,50.00
10,014,01,150,0006,0000,229,4,233,298,0,3,1,4,1,1,2,0.00,78.19,50.00
10,014,01,150,0006,0228,229,4,233,298,0,3,1,4,1,1,2,0.00,78.19,50.00
10,014,01,150,0005,0229,294,7,301,365,0,3,1,4,1,1,2,0.00,82.47,50.00
10,014,00,020,0000,0000,3585,91,3676,5564,6365,9,2,11,3,2,5,87.42,66.07,45.45
10,014,01,020,0000,0000,3585,91,3676,5564,6365,9,2,11,3,2,5,87.42,66.07,45.45
10,014,02,010,0001,0000,806,49,855,1414,0,7,3,10,5,1,6,0.00,60.47,60.00
10,014,02,010,0013,0013,411,37,448,703,0,7,3,10,5,1,6,0.00,63.73,60.00
10,014,02,010,0013,0014,396,14,410,692,0,7,3,10,5,1,6,0.00,59.25,60.00
10,014,02,010,0013,0015,443,23,466,743,0,7,3,10,5,1,6,0.00,62.72,60.00
10,014,02,010,0012,0016,524,30,554,917,0,7,3,10,5,1,6,0.00,60.41,60.00
10,014,02,010,0012,0017,571,24,595,965,0,7,3,10,5,1,6,0.00,61.66,60.00
10,014,02,010,0012,0018,541,30,571,909,0,7,3,10,5,1,6,0.00,62.82,60.00
10,014,02,010,0011,0019,419,12,431,681,0,7,3,10,5,1,6,0.00,63.29,60.00
10,014,02,010,0011,0020,507,22,529,866,0,7,3,10,5,1,6,0.00,61.09,60.00
10,014,02,010,0011,0021,485,13,498,769,0,7,3,10,5,1,6,0.00,64.76,60.00
10,014,02,010,0010,0022,576,22,598,974,0,7,3,10,5,1,6,0.00,61.40,60.00
10,014,02,010,0010,0023,594,23,617,1023,0,7,3,10,5,1,6,0.00,60.31,60.00
10,014,02,010,0008,0024,469,12,481,748,0,7,3,10,5,1,6,0.00,64.30,60.00
10,014,02,010,0008,0025,454,11,465,695,0,7,3,10,5,1,6,0.00,66.91,60.00
10,014,02,010,0008,0026,601,16,617,966,0,7,3,10,5,1,6,0.00,63.87,60.00
10,014,02,010,0009,0027,688,36,724,1073,0,7,3,10,5,1,6,0.00,67.47,60.00
10,014,02,010,0047,0028,527,18,545,922,0,7,3,10,5,1,6,0.00,59.11,60.00
10,014,02,010,0047,0029,522,21,543,893,0,7,3,10,5,1,6,0.00,60.81,60.00
10,014,02,010,0003,0000,978,62,1040,1837,0,7,3,10,5,1,6,0.00,56.61,60.00
10,014,02,010,0047,0030,489,14,503,781,0,7,3,10,5,1,6,0.00,64.40,60.00
10,014,02,010,0007,0031,593,20,613,996,0,7,3,10,5,1,6,0.00,61.55,60.00
10,014,02,010,0007,0032,584,37,621,1003,0,7,3,10,5,1,6,0.00,61.91,60.00
10,014,02,010,0007,0033,478,19,497,819,0,7,3,10,5,1,6,0.00,60.68,60.00
10,014,02,010,0006,0034,457,22,479,681,0,7,3,10,5,1,6,0.00,70.34,60.00
10,014,02,010,0006,0035,305,19,324,476,0,7,3,10,5,1,6,0.00,68.07,60.00
10,014,02,010,0006,0036,316,29,345,487,0,7,3,10,5,1,6,0.00,70.84,60.00
10,014,02,010,0003,0037,515,25,540,897,0,7,3,10,5,1,6,0.00,60.20,60.00
10,014,02,010,0003,0038,463,37,500,940,0,7,3,10,5,1,6,0.00,53.19,60.00
10,014,02,010,0005,0039,499,18,517,794,0,7,3,10,5,1,6,0.00,65.11,60.00
10,014,02,010,0004,0000,1067,52,1119,1799,0,7,3,10,5,1,6,0.00,62.20,60.00
10,014,02,010,0005,0040,535,23,558,814,0,7,3,10,5,1,6,0.00,68.55,60.00
10,014,02,010,0005,0041,678,17,695,1047,0,7,3,10,5,1,6,0.00,66.38,60.00
10,014,02,010,0004,0042,390,20,410,633,0,7,3,10,5,1,6,0.00,64.77,60.00
10,014,02,010,0004,0043,312,12,324,516,0,7,3,10,5,1,6,0.00,62.79,60.00
10,014,02,010,0004,0044,365,20,385,650,0,7,3,10,5,1,6,0.00,59.23,60.00
10,014,02,010,0001,0045,389,18,407,583,0,7,3,10,5,1,6,0.00,69.81,60.00
10,014,02,010,0001,0046,219,16,235,434,0,7,3,10,5,1,6,0.00,54.15,60.00
10,014,02,010,0001,0047,198,15,213,397,0,7,3,10,5,1,6,0.00,53.65,60.00
10,014,02,010,0005,0000,1712,58,1770,2655,0,7,3,10,5,1,6,0.00,66.67,60.00
10,014,02,010,0006,0000,1078,70,1148,1644,0,7,3,10,5,1,6,0.00,69.83,60.00
10,014,02,010,0007,0000,1655,76,1731,2818,0,7,3,10,5,1,6,0.00,61.43,60.00
10,014,02,010,0008,0000,1524,39,1563,2409,0,7,3,10,5,1,6,0.00,64.88,60.00
10,014,02,010,0009,0000,688,36,724,1073,0,7,3,10,5,1,6,0.00,67.47,60.00
10,014,02,010,0010,0000,1170,45,1215,1997,0,7,3,10,5,1,6,0.00,60.84,60.00
10,014,02,010,0011,0000,1411,47,1458,2316,0,7,3,10,5,1,6,0.00,62.95,60.00
10,014,02,010,0012,0000,1636,84,1720,2791,0,7,3,10,5,1,6,0.00,61.63,60.00
10,014,02,010,0013,0000,1250,74,1324,2138,0,7,3,10,5,1,6,0.00,61.93,60.00
10,014,02,010,0047,0000,1538,53,1591,2596,0,7,3,10,5,1,6,0.00,61.29,60.00
10,014,02,030,0001,0000,802,18,820,1063,0,2,0,2,1,0,1,0.00,77.14,50.00
10,014,02,030,0003,0000,449,11,460,591,0,2,0,2,1,0,1,0.00,77.83,50.00
10,014,02,030,0003,0112,449,11,460,591,0,2,0,2,1,0,1,0.00,77.83,50.00
10,014,02,030,0001,0115,295,6,301,399,0,2,0,2,1,0,1,0.00,75.44,50.00
10,014,02,030,0001,0116,507,12,519,664,0,2,0,2,1,0,1,0.00,78.16,50.00
10,014,02,040,0001,0000,90,4,94,154,0,3,0,3,2,0,2,0.00,61.04,66.67
10,014,02,040,0005,0000,537,25,562,817,0,3,0,3,2,0,2,0.00,68.79,66.67
10,014,02,040,0006,0000,564,15,579,813,0,3,0,3,2,0,2,0.00,71.22,66.67
10,014,02,040,0007,0000,573,19,592,904,0,3,0,3,2,0,2,0.00,65.49,66.67
10,014,02,040,0007,0120,116,3,119,193,0,3,0,3,2,0,2,0.00,61.66,66.67
10,014,02,040,0007,0121,247,15,262,391,0,3,0,3,2,0,2,0.00,67.01,66.67
10,014,02,040,0007,0122,210,1,211,320,0,3,0,3,2,0,2,0.00,65.94,66.67
10,014,02,040,0006,0123,318,13,331,468,0,3,0,3,2,0,2,0.00,70.73,66.67
10,014,02,040,0006,0124,246,2,248,345,0,3,0,3,2,0,2,0.00,71.88,66.67
10,014,02,040,0005,0125,387,17,404,568,0,3,0,3,2,0,2,0.00,71.13,66.67
10,014,02,040,0005,0126,150,8,158,249,0,3,0,3,2,0,2,0.00,63.45,66.67
10,014,02,040,0001,0127,75,2,77,134,0,3,0,3,2,0,2,0.00,57.46,66.67
10,014,02,040,0001,0128,15,2,17,20,0,3,0,3,2,0,2,0.00,85.00,66.67
10,014,02,050,0001,0000,213,3,216,301,0,3,0,3,2,0,2,0.00,71.76,66.67
10,014,02,050,0002,0000,520,26,546,776,0,3,0,3,2,0,2,0.00,70.36,66.67
10,014,02,050,0003,0000,320,7,327,484,0,3,0,3,2,0,2,0.00,67.56,66.67
10,014,02,050,0005,0000,381,17,398,593,0,3,0,3,2,0,2,0.00,67.12,66.67
10,014,02,050,0005,0145,381,17,398,593,0,3,0,3,2,0,2,0.00,67.12,66.67
10,014,02,050,0003,0146,320,7,327,484,0,3,0,3,2,0,2,0.00,67.56,66.67
10,014,02,050,0001,0147,213,3,216,301,0,3,0,3,2,0,2,0.00,71.76,66.67
10,014,02,050,0002,0148,231,12,243,358,0,3,0,3,2,0,2,0.00,67.88,66.67
10,014,02,050,0002,0149,289,14,303,418,0,3,0,3,2,0,2,0.00,72.49,66.67
10,014,02,060,0002,0000,435,14,449,552,0,1,1,2,1,0,1,0.00,81.34,50.00
10,014,02,060,0003,0000,59,3,62,86,0,1,1,2,1,0,1,0.00,72.09,50.00
10,014,02,060,0002,0154,435,14,449,552,0,1,1,2,1,0,1,0.00,81.34,50.00
10,014,02,060,0003,0155,59,3,62,86,0,1,1,2,1,0,1,0.00,72.09,50.00
10,014,02,090,0005,0000,664,14,678,1041,0,2,2,4,2,1,3,0.00,65.13,75.00
10,014,02,090,0006,0000,690,13,703,1125,0,2,2,4,2,1,3,0.00,62.49,75.00
10,014,02,090,0007,0000,236,8,244,386,0,2,2,4,2,1,3,0.00,63.21,75.00
10,014,02,090,0008,0000,191,9,200,363,0,2,2,4,2,1,3,0.00,55.10,75.00
10,014,02,090,0009,0000,127,7,134,208,0,2,2,4,2,1,3,0.00,64.42,75.00
10,014,02,090,0006,0189,316,3,319,491,0,2,2,4,2,1,3,0.00,64.97,75.00
10,014,02,090,0006,0190,374,10,384,634,0,2,2,4,2,1,3,0.00,60.57,75.00
10,014,02,090,0005,0191,343,9,352,534,0,2,2,4,2,1,3,0.00,65.92,75.00
10,014,02,090,0005,0192,321,5,326,507,0,2,2,4,2,1,3,0.00,64.30,75.00
10,014,02,090,0007,0193,186,3,189,291,0,2,2,4,2,1,3,0.00,64.95,75.00
10,014,02,090,0007,0194,50,5,55,95,0,2,2,4,2,1,3,0.00,57.89,75.00
10,014,02,090,0008,0195,88,4,92,158,0,2,2,4,2,1,3,0.00,58.23,75.00
10,014,02,090,0008,0196,103,5,108,205,0,2,2,4,2,1,3,0.00,52.68,75.00
10,014,02,090,0009,0197,10,1,11,16,0,2,2,4,2,1,3,0.00,68.75,75.00
10,014,02,090,0009,0198,117,6,123,192,0,2,2,4,2,1,3,0.00,64.06,75.00
10,014,02,110,0002,0000,741,11,752,1025,0,3,0,3,2,0,2,0.00,73.37,66.67
10,014,02,110,0002,0206,741,11,752,1025,0,3,0,3,2,0,2,0.00,73.37,66.67
10,014,02,120,0001,0000,462,7,469,707,0,6,2,8,3,1,4,0.00,66.34,50.00
10,014,02,120,0004,0000,594,15,609,931,0,6,2,8,3,1,4,0.00,65.41,50.00
10,014,02,120,0004,0211,594,15,609,931,0,6,2,8,3,1,4,0.00,65.41,50.00
10,014,02,120,0001,0212,462,7,469,707,0,6,2,8,3,1,4,0.00,66.34,50.00
10,014,02,130,0001,0000,387,21,408,572,0,2,0,2,2,0,2,0.00,71.33,100.00
10,014,02,130,0002,0000,238,23,261,313,0,2,0,2,2,0,2,0.00,83.39,100.00
10,014,02,130,0002,0217,238,23,261,313,0,2,0,2,2,0,2,0.00,83.39,100.00
10,014,02,130,0001,0218,387,21,408,572,0,2,0,2,2,0,2,0.00,71.33,100.00
10,014,02,140,0001,0000,404,2,406,457,0,3,1,4,2,0,2,0.00,88.84,50.00
10,014,02,140,0002,0000,434,1,435,525,0,3,1,4,2,0,2,0.00,82.86,50.00
10,014,02,140,0002,0222,434,1,435,525,0,3,1,4,2,0,2,0.00,82.86,50.00
10,014,02,140,0001,0223,404,2,406,457,0,3,1,4,2,0,2,0.00,88.84,50.00
10,014,02,150,0003,0000,301,2,303,347,0,3,0,3,2,0,2,0.00,87.32,66.67
10,014,02,150,0004,0000,402,8,410,543,0,3,0,3,2,0,2,0.00,75.51,66.67
10,014,02,150,0004,0226,158,5,163,231,0,3,0,3,2,0,2,0.00,70.56,66.67
10,014,02,150,0004,0227,244,3,247,312,0,3,0,3,2,0,2,0.00,79.17,66.67
10,014,02,150,0003,0230,301,2,303,347,0,3,0,3,2,0,2,0.00,87.32,66.67
10,014,00,030,0000,0000,3840,96,3936,5415,6250,7,1,8,4,1,5,86.64,72.69,62.50
10,014,01,030,0000,0000,2036,53,2089,3008,3553,3,1,4,2,1,3,84.66,69.45,75.00
10,014,02,030,0000,0000,1251,29,1280,1654,1877,2,0,2,1,0,1,88.12,77.39,50.00
10,014,03,030,0000,0000,553,14,567,753,820,2,0,2,1,0,1,91.83,75.30,50.00
10,014,03,010,0037,0048,417,13,430,647,0,6,3,9,4,1,5,0.00,66.46,55.56
10,014,03,010,0037,0049,297,15,312,520,0,6,3,9,4,1,5,0.00,60.00,55.56
10,014,03,010,0036,0050,561,25,586,931,0,6,3,9,4,1,5,0.00,62.94,55.56
10,014,03,010,0036,0051,538,26,564,844,0,6,3,9,4,1,5,0.00,66.82,55.56
10,014,03,010,0033,0052,315,13,328,520,0,6,3,9,4,1,5,0.00,63.08,55.56
10,014,03,010,0033,0053,447,17,464,716,0,6,3,9,4,1,5,0.00,64.80,55.56
10,014,03,010,0032,0054,431,25,456,745,0,6,3,9,4,1,5,0.00,61.21,55.56
10,014,03,010,0032,0055,389,26,415,718,0,6,3,9,4,1,5,0.00,57.80,55.56
10,014,03,010,0032,0056,349,30,379,679,0,6,3,9,4,1,5,0.00,55.82,55.56
10,014,03,010,0031,0057,317,15,332,559,0,6,3,9,4,1,5,0.00,59.39,55.56
10,014,03,010,0031,0058,467,32,499,845,0,6,3,9,4,1,5,0.00,59.05,55.56
10,014,03,010,0031,0059,420,23,443,710,0,6,3,9,4,1,5,0.00,62.39,55.56
10,014,03,010,0035,0060,787,23,810,1111,0,6,3,9,4,1,5,0.00,72.91,55.56
10,014,03,010,0034,0061,322,12,334,561,0,6,3,9,4,1,5,0.00,59.54,55.56
10,014,03,010,0034,0062,427,13,440,686,0,6,3,9,4,1,5,0.00,64.14,55.56
10,014,03,010,0034,0063,462,28,490,704,0,6,3,9,4,1,5,0.00,69.60,55.56
10,014,03,010,0048,0064,472,20,492,826,0,6,3,9,4,1,5,0.00,59.56,55.56
10,014,03,010,0048,0065,422,10,432,707,0,6,3,9,4,1,5,0.00,61.10,55.56
10,014,03,010,0048,0066,487,19,506,809,0,6,3,9,4,1,5,0.00,62.55,55.56
10,014,03,010,0038,0067,547,20,567,920,0,6,3,9,4,1,5,0.00,61.63,55.56
10,014,03,010,0038,0068,474,14,488,805,0,6,3,9,4,1,5,0.00,60.62,55.56
10,014,03,010,0038,0069,515,22,537,838,0,6,3,9,4,1,5,0.00,64.08,55.56
10,014,03,010,0049,0070,532,23,555,923,0,6,3,9,4,1,5,0.00,60.13,55.56
10,014,03,010,0049,0071,641,23,664,1043,0,6,3,9,4,1,5,0.00,63.66,55.56
10,014,03,010,0049,0072,473,14,487,807,0,6,3,9,4,1,5,0.00,60.35,55.56
10,014,03,010,0039,0073,392,14,406,751,0,6,3,9,4,1,5,0.00,54.06,55.56
10,014,03,010,0039,0074,510,17,527,881,0,6,3,9,4,1,5,0.00,59.82,55.56
10,014,03,010,0039,0075,485,15,500,853,0,6,3,9,4,1,5,0.00,58.62,55.56
10,014,03,010,0040,0076,629,29,658,978,0,6,3,9,4,1,5,0.00,67.28,55.56
10,014,03,010,0040,0077,555,19,574,802,0,6,3,9,4,1,5,0.00,71.57,55.56
10,014,03,010,0041,0078,374,18,392,534,0,6,3,9,4,1,5,0.00,73.41,55.56
10,014,03,010,0041,0079,342,17,359,530,0,6,3,9,4,1,5,0.00,67.74,55.56
10,014,03,010,0031,0000,1204,70,1274,2114,0,6,3,9,4,1,5,0.00,60.26,55.56
10,014,03,010,0032,0000,1169,81,1250,2142,0,6,3,9,4,1,5,0.00,58.36,55.56
10,014,03,010,0033,0000,762,30,792,1236,0,6,3,9,4,1,5,0.00,64.08,55.56
10,014,03,010,0034,0000,1211,53,1264,1951,0,6,3,9,4,1,5,0.00,64.79,55.56
10,014,03,010,0035,0000,787,23,810,1111,0,6,3,9,4,1,5,0.00,72.91,55.56
10,014,03,010,0036,0000,1099,51,1150,1775,0,6,3,9,4,1,5,0.00,64.79,55.56
10,014,03,010,0037,0000,714,28,742,1167,0,6,3,9,4,1,5,0.00,63.58,55.56
10,014,03,010,0038,0000,1536,56,1592,2563,0,6,3,9,4,1,5,0.00,62.11,55.56
10,014,03,010,0039,0000,1387,46,1433,2485,0,6,3,9,4,1,5,0.00,57.67,55.56
10,014,03,010,0040,0000,1184,48,1232,1780,0,6,3,9,4,1,5,0.00,69.21,55.56
10,014,03,010,0041,0000,716,35,751,1064,0,6,3,9,4,1,5,0.00,70.58,55.56
10,014,03,010,0048,0000,1381,49,1430,2342,0,6,3,9,4,1,5,0.00,61.06,55.56
10,014,03,010,0049,0000,1646,60,1706,2773,0,6,3,9,4,1,5,0.00,61.52,55.56
10,014,03,030,0006,0000,123,4,127,177,0,2,0,2,1,0,1,0.00,71.75,50.00
10,014,03,030,0007,0000,430,10,440,576,0,2,0,2,1,0,1,0.00,76.39,50.00
10,014,03,030,0007,0114,430,10,440,576,0,2,0,2,1,0,1,0.00,76.39,50.00
10,014,03,030,0006,0117,123,4,127,177,0,2,0,2,1,0,1,0.00,71.75,50.00
10,014,03,060,0006,0000,217,2,219,311,0,1,1,2,0,1,1,0.00,70.42,50.00
10,014,03,060,0008,0000,218,7,225,287,0,1,1,2,0,1,1,0.00,78.40,50.00
10,014,03,060,0009,0000,179,2,181,245,0,1,1,2,0,1,1,0.00,73.88,50.00
10,014,03,060,0010,0000,77,3,80,120,0,1,1,2,0,1,1,0.00,66.67,50.00
10,014,03,060,0006,0158,217,2,219,311,0,1,1,2,0,1,1,0.00,70.42,50.00
10,014,03,060,0008,0159,218,7,225,287,0,1,1,2,0,1,1,0.00,78.40,50.00
10,014,03,060,0009,0160,179,2,181,245,0,1,1,2,0,1,1,0.00,73.88,50.00
10,014,03,060,0010,0161,77,3,80,120,0,1,1,2,0,1,1,0.00,66.67,50.00
10,014,03,110,0001,0000,671,14,685,977,0,3,0,3,2,0,2,0.00,70.11,66.67
10,014,03,110,0001,0207,515,12,527,779,0,3,0,3,2,0,2,0.00,67.65,66.67
10,014,03,110,0001,0208,156,2,158,198,0,3,0,3,2,0,2,0.00,79.80,66.67
10,014,03,120,0005,0000,392,14,406,579,0,3,1,4,1,1,2,0.00,70.12,50.00
10,014,03,120,0006,0000,337,8,345,483,0,3,1,4,1,1,2,0.00,71.43,50.00
10,014,03,120,0006,0209,337,8,345,483,0,3,1,4,1,1,2,0.00,71.43,50.00
10,014,03,120,0005,0210,392,14,406,579,0,3,1,4,1,1,2,0.00,70.12,50.00
10,014,03,130,0004,0000,454,10,464,572,0,2,1,3,1,0,1,0.00,81.12,33.33
10,014,03,130,0004,0219,454,10,464,572,0,2,1,3,1,0,1,0.00,81.12,33.33
10,014,03,140,0004,0000,238,5,243,278,0,2,0,2,1,0,1,0.00,87.41,50.00
10,014,03,140,0005,0000,244,4,248,289,0,2,0,2,1,0,1,0.00,85.81,50.00
10,014,03,140,0004,0224,238,5,243,278,0,2,0,2,1,0,1,0.00,87.41,50.00
10,014,03,140,0005,0225,244,4,248,289,0,2,0,2,1,0,1,0.00,85.81,50.00
10,014,03,150,0001,0000,482,4,486,594,0,2,2,4,2,1,3,0.00,81.82,75.00
10,014,03,150,0002,0000,683,8,691,837,0,2,2,4,2,1,3,0.00,82.56,75.00
10,014,03,150,0001,0231,482,4,486,594,0,2,2,4,2,1,3,0.00,81.82,75.00
10,014,03,150,0002,0232,683,8,691,837,0,2,2,4,2,1,3,0.00,82.56,75.00
10,014,00,040,0000,0000,6206,232,6438,9575,10846,7,2,9,5,2,7,88.28,67.24,77.78
10,014,01,040,0000,0000,4442,169,4611,6887,7807,4,2,6,3,2,5,88.22,66.95,83.33
10,014,02,040,0000,0000,1764,63,1827,2688,3039,3,0,3,2,0,2,88.45,67.97,66.67
10,014,04,010,0030,0080,507,45,552,916,0,2,0,2,2,0,2,0.00,60.26,100.00
10,014,04,010,0030,0081,598,58,656,946,0,2,0,2,2,0,2,0.00,69.34,100.00
10,014,04,010,0029,0082,227,22,249,394,0,2,0,2,2,0,2,0.00,63.20,100.00
10,014,04,010,0029,0083,294,32,326,507,0,2,0,2,2,0,2,0.00,64.30,100.00
10,014,04,010,0042,0084,79,14,93,175,0,2,0,2,2,0,2,0.00,53.14,100.00
10,014,04,010,0042,0085,270,28,298,501,0,2,0,2,2,0,2,0.00,59.48,100.00
10,014,04,010,0043,0086,672,56,728,1063,0,2,0,2,2,0,2,0.00,68.49,100.00
10,014,04,010,0045,0087,261,17,278,445,0,2,0,2,2,0,2,0.00,62.47,100.00
10,014,04,010,0045,0088,198,2,200,350,0,2,0,2,2,0,2,0.00,57.14,100.00
10,014,04,010,0045,0089,365,33,398,601,0,2,0,2,2,0,2,0.00,66.22,100.00
10,014,04,010,0046,0090,348,43,391,747,0,2,0,2,2,0,2,0.00,52.34,100.00
10,014,04,010,0046,0091,282,32,314,545,0,2,0,2,2,0,2,0.00,57.61,100.00
10,014,04,010,0029,0000,521,54,575,901,0,2,0,2,2,0,2,0.00,63.82,100.00
10,014,04,010,0030,0000,1105,103,1208,1862,0,2,0,2,2,0,2,0.00,64.88,100.00
10,014,04,010,0042,0000,349,42,391,676,0,2,0,2,2,0,2,0.00,57.84,100.00
10,014,04,010,0043,0000,672,56,728,1063,0,2,0,2,2,0,2,0.00,68.49,100.00
10,014,04,010,0045,0000,824,52,876,1396,0,2,0,2,2,0,2,0.00,62.75,100.00
10,014,04,010,0046,0000,630,75,705,1292,0,2,0,2,2,0,2,0.00,54.57,100.00
10,014,00,050,0000,0000,3234,88,3322,4735,5290,8,0,8,5,0,5,89.51,70.16,62.50
10,014,01,050,0000,0000,1800,35,1835,2581,2897,5,0,5,3,0,3,89.09,71.10,60.00
10,014,02,050,0000,0000,1434,53,1487,2154,2393,3,0,3,2,0,2,90.01,69.03,66.67
10,014,00,060,0000,0000,3501,99,3600,5203,6005,5,3,8,3,2,5,86.64,69.19,62.50
10,014,01,060,0000,0000,2316,68,2384,3602,4201,3,1,4,2,1,3,85.74,66.19,75.00
10,014,02,060,0000,0000,494,17,511,638,725,1,1,2,1,0,1,88.00,80.09,50.00
10,014,03,060,0000,0000,691,14,705,963,1079,1,1,2,0,1,1,89.25,73.21,50.00
10,014,00,070,0000,0000,2124,46,2170,3520,3914,3,2,5,1,2,3,89.93,61.65,60.00
10,014,01,070,0000,0000,2124,46,2170,3520,3914,3,2,5,1,2,3,89.93,61.65,60.00
10,014,00,080,0000,0000,1307,69,1376,2496,2795,2,1,3,2,1,3,89.30,55.13,100.00
10,014,01,080,0000,0000,1307,69,1376,2496,2795,2,1,3,2,1,3,89.30,55.13,100.00
10,014,00,090,0000,0000,3406,79,3485,5466,6207,6,2,8,5,1,6,88.06,63.76,75.00
10,014,01,090,0000,0000,1498,28,1526,2343,2619,4,0,4,3,0,3,89.46,65.13,75.00
10,014,02,090,0000,0000,1908,51,1959,3123,3588,2,2,4,2,1,3,87.04,62.73,75.00
10,014,00,100,0000,0000,1473,27,1500,2226,2563,5,0,5,3,0,3,86.85,67.39,60.00
10,014,01,100,0000,0000,1473,27,1500,2226,2563,5,0,5,3,0,3,86.85,67.39,60.00
10,014,00,110,0000,0000,2297,244,2541,3672,4282,8,1,9,6,1,7,85.75,69.20,77.78
10,014,01,110,0000,0000,885,219,1104,1670,1907,2,1,3,2,1,3,87.57,66.11,100.00
10,014,02,110,0000,0000,741,11,752,1025,1215,3,0,3,2,0,2,84.36,73.37,66.67
10,014,03,110,0000,0000,671,14,685,977,1160,3,0,3,2,0,2,84.22,70.11,66.67
10,014,00,120,0000,0000,2147,57,2204,3195,4197,10,4,14,4,3,7,76.13,68.98,50.00
10,014,01,120,0000,0000,362,13,375,495,664,1,1,2,0,1,1,74.55,75.76,50.00
10,014,02,120,0000,0000,1056,22,1078,1638,2140,6,2,8,3,1,4,76.54,65.81,50.00
10,014,03,120,0000,0000,729,22,751,1062,1393,3,1,4,1,1,2,76.24,70.72,50.00
10,014,00,130,0000,0000,2149,90,2239,2860,3645,9,3,12,6,1,7,78.46,78.29,58.33
10,014,01,130,0000,0000,1070,36,1106,1403,1790,5,2,7,3,1,4,78.38,78.83,57.14
10,014,02,130,0000,0000,625,44,669,885,1149,2,0,2,2,0,2,77.02,75.59,100.00
10,014,03,130,0000,0000,454,10,464,572,706,2,1,3,1,0,1,81.02,81.12,33.33
10,014,00,140,0000,0000,2281,23,2304,2696,3395,10,1,11,6,0,6,79.41,85.46,54.55
10,014,01,140,0000,0000,961,11,972,1147,1474,5,0,5,3,0,3,77.82,84.74,60.00
10,014,02,140,0000,0000,838,3,841,982,1238,3,1,4,2,0,2,79.32,85.64,50.00
10,014,03,140,0000,0000,482,9,491,567,683,2,0,2,1,0,1,83.02,86.60,50.00
10,014,00,150,0000,0000,2391,33,2424,2984,3496,8,3,11,5,2,7,85.35,81.23,63.64
10,014,01,150,0000,0000,523,11,534,663,759,3,1,4,1,1,2,87.35,80.54,50.00
10,014,02,150,0000,0000,703,10,713,890,1044,3,0,3,2,0,2,85.25,80.11,66.67
10,014,03,150,0000,0000,1165,12,1177,1431,1693,2,2,4,2,1,3,84.52,82.25,75.00
10,014,00,160,0000,0000,2259,58,2317,4211,5266,11,4,15,5,2,7,79.97,55.02,46.67
10,014,01,160,0000,0000,2259,58,2317,4211,5266,11,4,15,5,2,7,79.97,55.02,46.67
10,015,00,000,0000,0000,120204,6354,126558,219633,262821,119,49,168,71,35,106,83.57,57.62,63.10
10,015,00,010,0000,0000,35654,2516,38170,72657,89768,13,7,20,11,6,17,80.94,52.53,85.00
10,015,01,010,0000,0000,8688,761,9449,18513,22441,3,1,4,3,1,4,82.50,51.04,100.00
10,015,02,010,0000,0000,1197,324,1521,2709,3490,1,0,1,1,0,1,77.62,56.15,100.00
10,015,03,010,0000,0000,10232,586,10818,19966,25392,4,2,6,3,2,5,78.63,54.18,83.33
10,015,04,010,0000,0000,15537,845,16382,31469,38445,5,4,9,4,3,7,81.85,52.06,77.78
10,015,01,010,0009,0001,323,27,350,654,0,3,1,4,3,1,4,0.00,53.52,100.00
10,015,01,010,0009,0002,341,41,382,692,0,3,1,4,3,1,4,0.00,55.20,100.00
10,015,01,010,0018,0003,384,35,419,860,0,3,1,4,3,1,4,0.00,48.72,100.00
10,015,01,010,0018,0004,341,41,382,834,0,3,1,4,3,1,4,0.00,45.80,100.00
10,015,01,010,0018,0005,440,44,484,972,0,3,1,4,3,1,4,0.00,49.79,100.00
10,015,01,010,0010,0006,131,16,147,331,0,3,1,4,3,1,4,0.00,44.41,100.00
10,015,01,010,0010,0007,323,31,354,726,0,3,1,4,3,1,4,0.00,48.76,100.00
10,015,01,010,0010,0008,317,7,324,576,0,3,1,4,3,1,4,0.00,56.25,100.00
10,015,01,010,0025,0009,409,38,447,828,0,3,1,4,3,1,4,0.00,53.99,100.00
10,015,01,010,0001,0000,592,46,638,1378,0,3,1,4,3,1,4,0.00,46.30,100.00
10,015,01,010,0033,0010,357,32,389,841,0,3,1,4,3,1,4,0.00,46.25,100.00
10,015,01,010,0033,0011,383,25,408,810,0,3,1,4,3,1,4,0.00,50.37,100.00
10,015,01,010,0033,0012,354,49,403,842,0,3,1,4,3,1,4,0.00,47.86,100.00
10,015,01,010,0045,0013,445,27,472,931,0,3,1,4,3,1,4,0.00,50.70,100.00
10,015,01,010,0045,0014,426,24,450,892,0,3,1,4,3,1,4,0.00,50.45,100.00
10,015,01,010,0045,0015,485,37,522,936,0,3,1,4,3,1,4,0.00,55.77,100.00
10,015,01,010,0002,0016,459,58,517,956,0,3,1,4,3,1,4,0.00,54.08,100.00
10,015,01,010,0002,0017,378,30,408,786,0,3,1,4,3,1,4,0.00,51.91,100.00
10,015,01,010,0017,0018,374,19,393,805,0,3,1,4,3,1,4,0.00,48.82,100.00
10,015,01,010,0017,0019,426,35,461,803,0,3,1,4,3,1,4,0.00,57.41,100.00
10,015,01,010,0002,0000,837,88,925,1742,0,3,1,4,3,1,4,0.00,53.10,100.00
10,015,01,010,0017,0020,370,20,390,771,0,3,1,4,3,1,4,0.00,50.58,100.00
10,015,01,010,0017,0021,407,47,454,812,0,3,1,4,3,1,4,0.00,55.91,100.00
10,015,01,010,0001,0022,361,25,386,732,0,3,1,4,3,1,4,0.00,52.73,100.00
10,015,01,010,0001,0023,231,21,252,646,0,3,1,4,3,1,4,0.00,39.01,100.00
10,015,01,010,0026,0024,223,32,255,477,0,3,1,4,3,1,4,0.00,53.46,100.00
10,015,01,010,0009,0000,664,68,732,1346,0,3,1,4,3,1,4,0.00,54.38,100.00
10,015,01,010,0010,0000,771,54,825,1633,0,3,1,4,3,1,4,0.00,50.52,100.00
10,015,01,010,0017,0000,1577,121,1698,3191,0,3,1,4,3,1,4,0.00,53.21,100.00
10,015,01,010,0018,0000,1165,120,1285,2666,0,3,1,4,3,1,4,0.00,48.20,100.00
10,015,01,010,0025,0000,409,38,447,828,0,3,1,4,3,1,4,0.00,53.99,100.00
10,015,01,010,0026,0000,223,32,255,477,0,3,1,4,3,1,4,0.00,53.46,100.00
10,015,01,010,0033,0000,1094,106,1200,2493,0,3,1,4,3,1,4,0.00,48.13,100.00
10,015,01,010,0045,0000,1356,88,1444,2759,0,3,1,4,3,1,4,0.00,52.34,100.00
10,015,01,020,0001,0000,789,18,807,1086,0,8,4,12,3,3,6,0.00,74.31,50.00
10,015,01,020,0002,0000,378,11,389,568,0,8,4,12,3,3,6,0.00,68.49,50.00
10,015,01,020,0003,0000,434,4,438,530,0,8,4,12,3,3,6,0.00,82.64,50.00
10,015,01,020,0004,0000,711,13,724,950,0,8,4,12,3,3,6,0.00,76.21,50.00
10,015,01,020,0005,0000,532,10,542,781,0,8,4,12,3,3,6,0.00,69.40,50.00
10,015,01,020,0006,0000,88,7,95,142,0,8,4,12,3,3,6,0.00,66.90,50.00
10,015,01,020,0007,0000,748,16,764,1061,0,8,4,12,3,3,6,0.00,72.01,50.00
10,015,01,020,0001,0226,789,18,807,1086,0,8,4,12,3,3,6,0.00,74.31,50.00
10,015,01,020,0002,0227,378,11,389,568,0,8,4,12,3,3,6,0.00,68.49,50.00
10,015,01,020,0003,0228,434,4,438,530,0,8,4,12,3,3,6,0.00,82.64,50.00
10,015,01,020,0004,0229,711,13,724,950,0,8,4,12,3,3,6,0.00,76.21,50.00
10,015,01,020,0005,0230,194,4,198,307,0,8,4,12,3,3,6,0.00,64.50,50.00
10,015,01,020,0005,0231,338,6,344,474,0,8,4,12,3,3,6,0.00,72.57,50.00
10,015,01,020,0006,0232,64,6,70,95,0,8,4,12,3,3,6,0.00,73.68,50.00
10,015,01,020,0006,0233,24,1,25,47,0,8,4,12,3,3,6,0.00,53.19,50.00
10,015,01,020,0007,0234,427,8,435,595,0,8,4,12,3,3,6,0.00,73.11,50.00
10,015,01,020,0007,0235,321,8,329,466,0,8,4,12,3,3,6,0.00,70.60,50.00
10,015,01,030,0001,0000,2691,82,2773,4440,0,9,3,12,4,3,7,0.00,62.45,58.33
10,015,01,030,0002,0000,730,25,755,1318,0,9,3,12,4,3,7,0.00,57.28,58.33
10,015,01,030,0003,0000,481,20,501,977,0,9,3,12,4,3,7,0.00,51.28,58.33
10,015,01,030,0004,0000,435,12,447,1085,0,9,3,12,4,3,7,0.00,41.20,58.33
10,015,01,030,0005,0000,657,18,675,1041,0,9,3,12,4,3,7,0.00,64.84,58.33
10,015,01,030,0006,0000,573,18,591,949,0,9,3,12,4,3,7,0.00,62.28,58.33
10,015,01,030,0007,0000,195,6,201,354,0,9,3,12,4,3,7,0.00,56.78,58.33
10,015,01,030,0014,0000,443,19,462,778,0,9,3,12,4,3,7,0.00,59.38,58.33
10,015,01,030,0015,0000,474,14,488,779,0,9,3,12,4,3,7,0.00,62.64,58.33
10,015,01,030,0001,0285,482,15,497,845,0,9,3,12,4,3,7,0.00,58.82,58.33
10,015,01,030,0001,0286,487,15,502,772,0,9,3,12,4,3,7,0.00,65.03,58.33
10,015,01,030,0001,0287,369,9,378,560,0,9,3,12,4,3,7,0.00,67.50,58.33
10,015,01,030,0001,0288,416,19,435,725,0,9,3,12,4,3,7,0.00,60.00,58.33
10,015,01,030,0001,0289,427,10,437,683,0,9,3,12,4,3,7,0.00,63.98,58.33
10,015,01,030,0001,0290,510,14,524,855,0,9,3,12,4,3,7,0.00,61.29,58.33
10,015,01,030,0005,0291,657,18,675,1041,0,9,3,12,4,3,7,0.00,64.84,58.33
10,015,01,030,0002,0292,396,11,407,693,0,9,3,12,4,3,7,0.00,58.73,58.33
10,015,01,030,0002,0293,334,14,348,625,0,9,3,12,4,3,7,0.00,55.68,58.33
10,015,01,030,0004,0294,234,8,242,475,0,9,3,12,4,3,7,0.00,50.95,58.33
10,015,01,030,0004,0295,201,4,205,610,0,9,3,12,4,3,7,0.00,33.61,58.33
10,015,01,030,0003,0296,196,8,204,374,0,9,3,12,4,3,7,0.00,54.55,58.33
10,015,01,030,0003,0297,285,12,297,603,0,9,3,12,4,3,7,0.00,49.25,58.33
10,015,01,030,0006,0298,573,18,591,949,0,9,3,12,4,3,7,0.00,62.28,58.33
10,015,01,030,0007,0299,195,6,201,354,0,9,3,12,4,3,7,0.00,56.78,58.33
10,015,01,030,0014,0308,443,19,462,778,0,9,3,12,4,3,7,0.00,59.38,58.33
10,015,01,030,0015,0309,474,14,488,779,0,9,3,12,4,3,7,0.00,62.64,58.33
10,015,01,040,0001,0000,727,37,764,1076,0,2,0,2,1,0,1,0.00,71.00,50.00
10,015,01,040,0002,0000,535,25,560,770,0,2,0,2,1,0,1,0.00,72.73,50.00
10,015,01,040,0001,0094,215,12,227,307,0,2,0,2,1,0,1,0.00,73.94,50.00
10,015,01,040,0001,0095,512,25,537,769,0,2,0,2,1,0,1,0.00,69.83,50.00
10,015,01,040,0002,0096,359,20,379,517,0,2,0,2,1,0,1,0.00,73.31,50.00
10,015,01,040,0002,0097,176,5,181,253,0,2,0,2,1,0,1,0.00,71.54,50.00
10,015,01,050,0001,0000,2896,207,3103,6370,0,3,2,5,3,2,5,0.00,48.71,100.00
10,015,01,050,0002,0000,2255,103,2358,4563,0,3,2,5,3,2,5,0.00,51.68,100.00
10,015,01,050,0003,0000,1267,92,1359,2935,0,3,2,5,3,2,5,0.00,46.30,100.00
10,015,01,050,0004,0000,1623,149,1772,3814,0,3,2,5,3,2,5,0.00,46.46,100.00
10,015,01,050,0012,0000,1332,87,1419,2870,0,3,2,5,3,2,5,0.00,49.44,100.00
10,015,01,050,0013,0000,1528,90,1618,3039,0,3,2,5,3,2,5,0.00,53.24,100.00
10,015,01,050,0004,0134,373,35,408,923,0,3,2,5,3,2,5,0.00,44.20,100.00
10,015,01,050,0004,0135,406,46,452,939,0,3,2,5,3,2,5,0.00,48.14,100.00
10,015,01,050,0004,0136,403,34,437,927,0,3,2,5,3,2,5,0.00,47.14,100.00
10,015,01,050,0004,0137,441,34,475,1025,0,3,2,5,3,2,5,0.00,46.34,100.00
10,015,01,050,0003,0138,472,28,500,1071,0,3,2,5,3,2,5,0.00,46.69,100.00
10,015,01,050,0003,0139,461,38,499,1032,0,3,2,5,3,2,5,0.00,48.35,100.00
10,015,01,050,0003,0140,334,26,360,832,0,3,2,5,3,2,5,0.00,43.27,100.00
10,015,01,050,0012,0165,339,21,360,707,0,3,2,5,3,2,5,0.00,50.92,100.00
10,015,01,050,0012,0166,369,28,397,773,0,3,2,5,3,2,5,0.00,51.36,100.00
10,015,01,050,0012,0167,291,21,312,697,0,3,2,5,3,2,5,0.00,44.76,100.00
10,015,01,050,0012,0168,333,17,350,693,0,3,2,5,3,2,5,0.00,50.51,100.00
10,015,01,050,0013,0169,412,24,436,831,0,3,2,5,3,2,5,0.00,52.47,100.00
10,015,01,050,0013,0170,377,16,393,765,0,3,2,5,3,2,5,0.00,51.37,100.00
10,015,01,050,0013,0171,342,25,367,711,0,3,2,5,3,2,5,0.00,51.62,100.00
10,015,01,050,0013,0172,397,25,422,732,0,3,2,5,3,2,5,0.00,57.65,100.00
10,015,01,050,0001,0173,352,36,388,907,0,3,2,5,3,2,5,0.00,42.78,100.00
10,015,01,050,0001,0174,469,31,500,955,0,3,2,5,3,2,5,0.00,52.36,100.00
10,015,01,050,0001,0175,456,23,479,945,0,3,2,5,3,2,5,0.00,50.69,100.00
10,015,01,050,0001,0176,392,28,420,873,0,3,2,5,3,2,5,0.00,48.11,100.00
10,015,01,050,0001,0177,439,27,466,929,0,3,2,5,3,2,5,0.00,50.16,100.00
10,015,01,050,0001,0178,379,30,409,861,0,3,2,5,3,2,5,0.00,47.50,100.00
10,015,01,050,0001,0179,409,32,441,900,0,3,2,5,3,2,5,0.00,49.00,100.00
10,015,01,050,0002,0180,574,26,600,1160,0,3,2,5,3,2,5,0.00,51.72,100.00
10,015,01,050,0002,0181,552,26,578,1144,0,3,2,5,3,2,5,0.00,50.52,100.00
10,015,01,050,0002,0182,428,21,449,827,0,3,2,5,3,2,5,0.00,54.29,100.00
10,015,01,050,0002,0183,373,17,390,758,0,3,2,5,3,2,5,0.00,51.45,100.00
10,015,01,050,0002,0184,328,13,341,674,0,3,2,5,3,2,5,0.00,50.59,100.00
10,015,01,060,0006,0000,376,12,388,567,0,3,2,5,3,1,4,0.00,68.43,80.00
10,015,01,060,0007,0000,682,16,698,1034,0,3,2,5,3,1,4,0.00,67.50,80.00
10,015,01,060,0008,0000,82,7,89,134,0,3,2,5,3,1,4,0.00,66.42,80.00
10,015,01,060,0009,0000,274,18,292,425,0,3,2,5,3,1,4,0.00,68.71,80.00
10,015,01,060,0010,0000,671,16,687,1070,0,3,2,5,3,1,4,0.00,64.21,80.00
10,015,01,060,0011,0000,1331,65,1396,2145,0,3,2,5,3,1,4,0.00,65.08,80.00
10,015,01,060,0013,0000,156,3,159,226,0,3,2,5,3,1,4,0.00,70.35,80.00
10,015,01,060,0007,0212,404,9,413,598,0,3,2,5,3,1,4,0.00,69.06,80.00
10,015,01,060,0007,0213,278,7,285,436,0,3,2,5,3,1,4,0.00,65.37,80.00
10,015,01,060,0006,0214,376,12,388,567,0,3,2,5,3,1,4,0.00,68.43,80.00
10,015,01,060,0008,0215,82,7,89,134,0,3,2,5,3,1,4,0.00,66.42,80.00
10,015,01,060,0009,0216,274,18,292,425,0,3,2,5,3,1,4,0.00,68.71,80.00
10,015,01,060,0010,0217,456,12,468,716,0,3,2,5,3,1,4,0.00,65.36,80.00
10,015,01,060,0010,0218,215,4,219,354,0,3,2,5,3,1,4,0.00,61.86,80.00
10,015,01,060,0011,0219,446,14,460,685,0,3,2,5,3,1,4,0.00,67.15,80.00
10,015,01,060,0011,0220,521,32,553,876,0,3,2,5,3,1,4,0.00,63.13,80.00
10,015,01,060,0011,0221,364,19,383,584,0,3,2,5,3,1,4,0.00,65.58,80.00
10,015,01,060,0013,0223,156,3,159,226,0,3,2,5,3,1,4,0.00,70.35,80.00
10,015,01,070,0001,0000,519,4,523,720,0,4,2,6,2,2,4,0.00,72.64,66.67
10,015,01,070,0002,0000,600,11,611,860,0,4,2,6,2,2,4,0.00,71.05,66.67
10,015,01,070,0003,0000,171,2,173,283,0,4,2,6,2,2,4,0.00,61.13,66.67
10,015,01,070,0004,0000,189,4,193,302,0,4,2,6,2,2,4,0.00,63.91,66.67
10,015,01,070,0005,0000,414,10,424,620,0,4,2,6,2,2,4,0.00,68.39,66.67
10,015,01,070,0006,0000,199,7,206,335,0,4,2,6,2,2,4,0.00,61.49,66.67
10,015,01,070,0011,0000,69,0,69,123,0,4,2,6,2,2,4,0.00,56.10,66.67
10,015,01,070,0012,0000,145,4,149,263,0,4,2,6,2,2,4,0.00,56.65,66.67
10,015,01,070,0013,0000,51,0,51,98,0,4,2,6,2,2,4,0.00,52.04,66.67
10,015,01,070,0014,0000,84,2,86,146,0,4,2,6,2,2,4,0.00,58.90,66.67
10,015,01,070,0002,0241,600,11,611,860,0,4,2,6,2,2,4,0.00,71.05,66.67
10,015,01,070,0001,0242,519,4,523,720,0,4,2,6,2,2,4,0.00,72.64,66.67
10,015,01,070,0003,0243,171,2,173,283,0,4,2,6,2,2,4,0.00,61.13,66.67
10,015,01,070,0004,0244,189,4,193,302,0,4,2,6,2,2,4,0.00,63.91,66.67
10,015,01,070,0005,0245,414,10,424,620,0,4,2,6,2,2,4,0.00,68.39,66.67
10,015,01,070,0011,0246,43,0,43,77,0,4,2,6,2,2,4,0.00,55.84,66.67
10,015,01,070,0011,0247,26,0,26,46,0,4,2,6,2,2,4,0.00,56.52,66.67
10,015,01,070,0012,0248,52,1,53,89,0,4,2,6,2,2,4,0.00,59.55,66.67
10,015,01,070,0012,0249,93,3,96,174,0,4,2,6,2,2,4,0.00,55.17,66.67
10,015,01,070,0013,0250,51,0,51,98,0,4,2,6,2,2,4,0.00,52.04,66.67
10,015,01,070,0014,0251,84,2,86,146,0,4,2,6,2,2,4,0.00,58.90,66.67
10,015,01,070,0006,0252,199,7,206,335,0,4,2,6,2,2,4,0.00,61.49,66.67
10,015,01,080,0001,0000,201,24,225,390,0,1,0,1,1,0,1,0.00,57.69,100.00
10,015,01,080,0002,0000,35,5,40,77,0,1,0,1,1,0,1,0.00,51.95,100.00
10,015,01,080,0003,0000,59,13,72,112,0,1,0,1,1,0,1,0.00,64.29,100.00
10,015,01,080,0004,0000,61,11,72,122,0,1,0,1,1,0,1,0.00,59.02,100.00
10,015,01,080,0005,0000,25,0,25,58,0,1,0,1,1,0,1,0.00,43.10,100.00
10,015,01,080,0005,0258,25,0,25,58,0,1,0,1,1,0,1,0.00,43.10,100.00
10,015,01,080,0004,0259,61,11,72,122,0,1,0,1,1,0,1,0.00,59.02,100.00
10,015,01,080,0001,0260,85,13,98,151,0,1,0,1,1,0,1,0.00,64.90,100.00
10,015,01,080,0001,0261,104,7,111,211,0,1,0,1,1,0,1,0.00,52.61,100.00
10,015,01,080,0001,0262,12,4,16,28,0,1,0,1,1,0,1,0.00,57.14,100.00
10,015,01,080,0002,0263,35,5,40,77,0,1,0,1,1,0,1,0.00,51.95,100.00
10,015,01,080,0003,0264,59,13,72,112,0,1,0,1,1,0,1,0.00,64.29,100.00
10,015,01,090,0001,0000,997,21,1018,1521,0,7,2,9,4,2,6,0.00,66.93,66.67
10,015,01,090,0002,0000,951,25,976,1448,0,7,2,9,4,2,6,0.00,67.40,66.67
10,015,01,090,0003,0000,236,6,242,331,0,7,2,9,4,2,6,0.00,73.11,66.67
10,015,01,090,0004,0000,446,11,457,714,0,7,2,9,4,2,6,0.00,64.01,66.67
10,015,01,090,0005,0000,208,4,212,324,0,7,2,9,4,2,6,0.00,65.43,66.67
10,015,01,090,0006,0000,247,9,256,422,0,7,2,9,4,2,6,0.00,60.66,66.67
10,015,01,090,0007,0000,165,6,171,255,0,7,2,9,4,2,6,0.00,67.06,66.67
10,015,01,090,0008,0000,55,3,58,103,0,7,2,9,4,2,6,0.00,56.31,66.67
10,015,01,090,0001,0272,437,11,448,675,0,7,2,9,4,2,6,0.00,66.37,66.67
10,015,01,090,0001,0273,560,10,570,846,0,7,2,9,4,2,6,0.00,67.38,66.67
10,015,01,090,0002,0274,486,6,492,759,0,7,2,9,4,2,6,0.00,64.82,66.67
10,015,01,090,0002,0275,465,19,484,689,0,7,2,9,4,2,6,0.00,70.25,66.67
10,015,01,090,0003,0276,236,6,242,331,0,7,2,9,4,2,6,0.00,73.11,66.67
10,015,01,090,0004,0277,446,11,457,714,0,7,2,9,4,2,6,0.00,64.01,66.67
10,015,01,090,0005,0278,208,4,212,324,0,7,2,9,4,2,6,0.00,65.43,66.67
10,015,01,090,0006,0279,247,9,256,422,0,7,2,9,4,2,6,0.00,60.66,66.67
10,015,01,090,0007,0280,165,6,171,255,0,7,2,9,4,2,6,0.00,67.06,66.67
10,015,01,090,0008,0281,55,3,58,103,0,7,2,9,4,2,6,0.00,56.31,66.67
10,015,01,100,0001,0000,233,6,239,365,0,4,1,5,2,1,3,0.00,65.48,60.00
10,015,01,100,0002,0000,473,21,494,809,0,4,1,5,2,1,3,0.00,61.06,60.00
10,015,01,100,0003,0000,268,5,273,435,0,4,1,5,2,1,3,0.00,62.76,60.00
10,015,01,100,0004,0000,270,10,280,445,0,4,1,5,2,1,3,0.00,62.92,60.00
10,015,01,100,0005,0000,635,9,644,931,0,4,1,5,2,1,3,0.00,69.17,60.00
10,015,01,100,0006,0000,274,6,280,406,0,4,1,5,2,1,3,0.00,68.97,60.00
10,015,01,100,0001,0310,233,6,239,365,0,4,1,5,2,1,3,0.00,65.48,60.00
10,015,01,100,0002,0311,473,21,494,809,0,4,1,5,2,1,3,0.00,61.06,60.00
10,015,01,100,0003,0312,268,5,273,435,0,4,1,5,2,1,3,0.00,62.76,60.00
10,015,01,100,0004,0313,270,10,280,445,0,4,1,5,2,1,3,0.00,62.92,60.00
10,015,01,100,0005,0314,635,9,644,931,0,4,1,5,2,1,3,0.00,69.17,60.00
10,015,01,100,0006,0315,274,6,280,406,0,4,1,5,2,1,3,0.00,68.97,60.00
10,015,01,110,0001,0000,946,19,965,1319,0,11,4,15,4,1,5,0.00,73.16,33.33
10,015,01,110,0002,0000,1268,31,1299,1772,0,11,4,15,4,1,5,0.00,73.31,33.33
10,015,01,110,0003,0000,1120,26,1146,1664,0,11,4,15,4,1,5,0.00,68.87,33.33
10,015,01,110,0009,0000,1081,22,1103,1499,0,11,4,15,4,1,5,0.00,73.58,33.33
10,015,01,110,0009,0116,651,15,666,922,0,11,4,15,4,1,5,0.00,72.23,33.33
10,015,01,110,0009,0117,430,7,437,577,0,11,4,15,4,1,5,0.00,75.74,33.33
10,015,01,110,0001,0118,525,8,533,703,0,11,4,15,4,1,5,0.00,75.82,33.33
10,015,01,110,0001,0119,421,11,432,616,0,11,4,15,4,1,5,0.00,70.13,33.33
10,015,01,110,0002,0120,619,12,631,817,0,11,4,15,4,1,5,0.00,77.23,33.33
10,015,01,110,0002,0121,570,16,586,816,0,11,4,15,4,1,5,0.00,71.81,33.33
10,015,01,110,0002,0122,79,3,82,139,0,11,4,15,4,1,5,0.00,58.99,33.33
10,015,01,110,0003,0123,234,7,241,364,0,11,4,15,4,1,5,0.00,66.21,33.33
10,015,01,110,0003,0124,335,9,344,548,0,11,4,15,4,1,5,0.00,62.77,33.33
10,015,01,110,0003,0125,551,10,561,752,0,11,4,15,4,1,5,0.00,74.60,33.33
10,015,01,120,0001,0000,713,17,730,1012,0,5,0,5,2,0,2,0.00,72.13,40.00
10,015,01,120,0002,0000,371,5,376,487,0,5,0,5,2,0,2,0.00,77.21,40.00
10,015,01,120,0001,0265,713,17,730,1012,0,5,0,5,2,0,2,0.00,72.13,40.00
10,015,01,120,0002,0266,371,5,376,487,0,5,0,5,2,0,2,0.00,77.21,40.00
10,015,01,130,0001,0000,362,9,371,519,0,4,1,5,2,1,3,0.00,71.48,60.00
10,015,01,130,0002,0000,751,9,760,938,0,4,1,5,2,1,3,0.00,81.02,60.00
10,015,01,130,0003,0000,485,15,500,688,0,4,1,5,2,1,3,0.00,72.67,60.00
10,015,01,130,0001,0323,362,9,371,519,0,4,1,5,2,1,3,0.00,71.48,60.00
10,015,01,130,0002,0324,383,8,391,492,0,4,1,5,2,1,3,0.00,79.47,60.00
10,015,01,130,0002,0325,368,1,369,446,0,4,1,5,2,1,3,0.00,82.74,60.00
10,015,01,130,0003,0326,485,15,500,688,0,4,1,5,2,1,3,0.00,72.67,60.00
10,015,00,020,0000,0000,5525,135,5660,7706,8863,13,4,17,6,3,9,86.95,73.45,52.94
10,015,01,020,0000,0000,3680,79,3759,5118,5927,8,4,12,3,3,6,86.35,73.45,50.00
10,015,02,020,0000,0000,1274,36,1310,1732,1988,3,0,3,2,0,2,87.12,75.64,66.67
10,015,03,020,0000,0000,571,20,591,856,948,2,0,2,1,0,1,90.30,69.04,50.00
10,015,02,010,0034,0025,287,51,338,527,0,1,0,1,1,0,1,0.00,64.14,100.00
10,015,02,010,0027,0026,222,45,267,476,0,1,0,1,1,0,1,0.00,56.09,100.00
10,015,02,010,0003,0027,151,54,205,358,0,1,0,1,1,0,1,0.00,57.26,100.00
10,015,02,010,0019,0028,374,119,493,965,0,1,0,1,1,0,1,0.00,51.09,100.00
10,015,02,010,0035,0029,163,55,218,383,0,1,0,1,1,0,1,0.00,56.92,100.00
10,015,02,010,0003,0000,151,54,205,358,0,1,0,1,1,0,1,0.00,57.26,100.00
10,015,02,010,0019,0000,374,119,493,965,0,1,0,1,1,0,1,0.00,51.09,100.00
10,015,02,010,0027,0000,222,45,267,476,0,1,0,1,1,0,1,0.00,56.09,100.00
10,015,02,010,0034,0000,287,51,338,527,0,1,0,1,1,0,1,0.00,64.14,100.00
10,015,02,010,0035,0000,163,55,218,383,0,1,0,1,1,0,1,0.00,56.92,100.00
10,015,02,020,0008,0000,379,5,384,507,0,3,0,3,2,0,2,0.00,75.74,66.67
10,015,02,020,0009,0000,382,11,393,490,0,3,0,3,2,0,2,0.00,80.20,66.67
10,015,02,020,0010,0000,513,20,533,735,0,3,0,3,2,0,2,0.00,72.52,66.67
10,015,02,020,0008,0236,379,5,384,507,0,3,0,3,2,0,2,0.00,75.74,66.67
10,015,02,020,0009,0237,382,11,393,490,0,3,0,3,2,0,2,0.00,80.20,66.67
10,015,02,020,0010,0238,513,20,533,735,0,3,0,3,2,0,2,0.00,72.52,66.67
10,015,02,030,0008,0000,126,40,166,292,0,0,1,1,0,1,1,0.00,56.85,100.00
10,015,02,030,0009,0000,170,36,206,291,0,0,1,1,0,1,1,0.00,70.79,100.00
10,015,02,030,0010,0000,368,63,431,783,0,0,1,1,0,1,1,0.00,55.04,100.00
10,015,02,030,0011,0000,147,27,174,311,0,0,1,1,0,1,1,0.00,55.95,100.00
10,015,02,030,0012,0000,158,16,174,295,0,0,1,1,0,1,1,0.00,58.98,100.00
10,015,02,030,0013,0000,21,2,23,53,0,0,1,1,0,1,1,0.00,43.40,100.00
10,015,02,030,0008,0300,126,40,166,292,0,0,1,1,0,1,1,0.00,56.85,100.00
10,015,02,030,0009,0301,170,36,206,291,0,0,1,1,0,1,1,0.00,70.79,100.00
10,015,02,030,0010,0302,276,55,331,600,0,0,1,1,0,1,1,0.00,55.17,100.00
10,015,02,030,0010,0303,92,8,100,183,0,0,1,1,0,1,1,0.00,54.64,100.00
10,015,02,030,0011,0304,30,5,35,62,0,0,1,1,0,1,1,0.00,56.45,100.00
10,015,02,030,0011,0305,117,22,139,249,0,0,1,1,0,1,1,0.00,55.82,100.00
10,015,02,030,0012,0306,158,16,174,295,0,0,1,1,0,1,1,0.00,58.98,100.00
10,015,02,030,0013,0307,21,2,23,53,0,0,1,1,0,1,1,0.00,43.40,100.00
10,015,02,040,0003,0000,1155,25,1180,1921,0,4,3,7,3,2,5,0.00,61.43,71.43
10,015,02,040,0004,0000,1429,43,1472,2564,0,4,3,7,3,2,5,0.00,57.41,71.43
10,015,02,040,0008,0000,806,33,839,1563,0,4,3,7,3,2,5,0.00,53.68,71.43
10,015,02,040,0009,0000,569,15,584,1094,0,4,3,7,3,2,5,0.00,53.38,71.43
10,015,02,040,0003,0098,404,7,411,688,0,4,3,7,3,2,5,0.00,59.74,71.43
10,015,02,040,0003,0099,408,8,416,636,0,4,3,7,3,2,5,0.00,65.41,71.43
10,015,02,040,0003,0100,343,10,353,597,0,4,3,7,3,2,5,0.00,59.13,71.43
10,015,02,040,0008,0101,277,8,285,526,0,4,3,7,3,2,5,0.00,54.18,71.43
10,015,02,040,0008,0102,389,17,406,763,0,4,3,7,3,2,5,0.00,53.21,71.43
10,015,02,040,0008,0103,140,8,148,274,0,4,3,7,3,2,5,0.00,54.01,71.43
10,015,02,040,0009,0104,259,6,265,507,0,4,3,7,3,2,5,0.00,52.27,71.43
10,015,02,040,0009,0105,310,9,319,587,0,4,3,7,3,2,5,0.00,54.34,71.43
10,015,02,040,0004,0106,486,11,497,815,0,4,3,7,3,2,5,0.00,60.98,71.43
10,015,02,040,0004,0107,488,17,505,839,0,4,3,7,3,2,5,0.00,60.19,71.43
10,015,02,040,0004,0108,455,15,470,910,0,4,3,7,3,2,5,0.00,51.65,71.43
10,015,02,050,0005,0000,2932,288,3220,6204,0,3,0,3,3,0,3,0.00,51.90,100.00
10,015,02,050,0006,0000,2060,242,2302,4747,0,3,0,3,3,0,3,0.00,48.49,100.00
10,015,02,050,0007,0000,1312,127,1439,2600,0,3,0,3,3,0,3,0.00,55.35,100.00
10,015,02,050,0008,0000,648,43,691,1178,0,3,0,3,3,0,3,0.00,58.66,100.00
10,015,02,050,0009,0000,469,20,489,1029,0,3,0,3,3,0,3,0.00,47.52,100.00
10,015,02,050,0005,0141,568,62,630,1145,0,3,0,3,3,0,3,0.00,55.02,100.00
10,015,02,050,0005,0142,423,36,459,973,0,3,0,3,3,0,3,0.00,47.17,100.00
10,015,02,050,0005,0143,454,46,500,907,0,3,0,3,3,0,3,0.00,55.13,100.00
10,015,02,050,0005,0144,501,44,545,1089,0,3,0,3,3,0,3,0.00,50.05,100.00
10,015,02,050,0005,0145,509,51,560,1078,0,3,0,3,3,0,3,0.00,51.95,100.00
10,015,02,050,0005,0146,477,49,526,1012,0,3,0,3,3,0,3,0.00,51.98,100.00
10,015,02,050,0006,0147,385,50,435,920,0,3,0,3,3,0,3,0.00,47.28,100.00
10,015,02,050,0006,0148,258,36,294,537,0,3,0,3,3,0,3,0.00,54.75,100.00
10,015,02,050,0006,0149,359,45,404,762,0,3,0,3,3,0,3,0.00,53.02,100.00
10,015,02,050,0006,0150,336,41,377,749,0,3,0,3,3,0,3,0.00,50.33,100.00
10,015,02,050,0006,0151,287,34,321,804,0,3,0,3,3,0,3,0.00,39.93,100.00
10,015,02,050,0006,0152,435,36,471,975,0,3,0,3,3,0,3,0.00,48.31,100.00
10,015,02,050,0007,0153,483,37,520,951,0,3,0,3,3,0,3,0.00,54.68,100.00
10,015,02,050,0007,0154,419,38,457,845,0,3,0,3,3,0,3,0.00,54.08,100.00
10,015,02,050,0007,0155,410,52,462,804,0,3,0,3,3,0,3,0.00,57.46,100.00
10,015,02,050,0008,0156,287,16,303,517,0,3,0,3,3,0,3,0.00,58.61,100.00
10,015,02,050,0008,0157,361,27,388,661,0,3,0,3,3,0,3,0.00,58.70,100.00
10,015,02,050,0009,0158,469,20,489,1029,0,3,0,3,3,0,3,0.00,47.52,100.00
10,015,02,060,0001,0000,168,9,177,280,0,3,1,4,3,0,3,0.00,63.21,75.00
10,015,02,060,0002,0000,355,17,372,625,0,3,1,4,3,0,3,0.00,59.52,75.00
10,015,02,060,0003,0000,1044,33,1077,1616,0,3,1,4,3,0,3,0.00,66.65,75.00
10,015,02,060,0004,0000,660,26,686,1093,0,3,1,4,3,0,3,0.00,62.76,75.00
10,015,02,060,0005,0000,404,13,417,653,0,3,1,4,3,0,3,0.00,63.86,75.00
10,015,02,060,0012,0000,90,12,102,125,0,3,1,4,3,0,3,0.00,81.60,75.00
10,015,02,060,0002,0205,355,17,372,625,0,3,1,4,3,0,3,0.00,59.52,75.00
10,015,02,060,0001,0206,168,9,177,280,0,3,1,4,3,0,3,0.00,63.21,75.00
10,015,02,060,0003,0207,521,19,540,830,0,3,1,4,3,0,3,0.00,65.06,75.00
10,015,02,060,0003,0208,523,14,537,786,0,3,1,4,3,0,3,0.00,68.32,75.00
10,015,02,060,0004,0209,344,10,354,535,0,3,1,4,3,0,3,0.00,66.17,75.00
10,015,02,060,0004,0210,316,16,332,558,0,3,1,4,3,0,3,0.00,59.50,75.00
10,015,02,060,0005,0211,404,13,417,653,0,3,1,4,3,0,3,0.00,63.86,75.00
10,015,02,060,0012,0222,90,12,102,125,0,3,1,4,3,0,3,0.00,81.60,75.00
10,015,02,070,0007,0000,341,5,346,478,0,2,0,2,1,0,1,0.00,72.38,50.00
10,015,02,070,0008,0000,161,4,165,241,0,2,0,2,1,0,1,0.00,68.46,50.00
10,015,02,070,0009,0000,201,0,201,269,0,2,0,2,1,0,1,0.00,74.72,50.00
10,015,02,070,0010,0000,254,9,263,379,0,2,0,2,1,0,1,0.00,69.39,50.00
10,015,02,070,0007,0253,274,4,278,372,0,2,0,2,1,0,1,0.00,74.73,50.00
10,015,02,070,0007,0254,67,1,68,106,0,2,0,2,1,0,1,0.00,64.15,50.00
10,015,02,070,0008,0255,161,4,165,241,0,2,0,2,1,0,1,0.00,68.46,50.00
10,015,02,070,0009,0256,201,0,201,269,0,2,0,2,1,0,1,0.00,74.72,50.00
10,015,02,070,0010,0257,254,9,263,379,0,2,0,2,1,0,1,0.00,69.39,50.00
10,015,02,090,0009,0000,283,15,298,455,0,2,0,2,1,0,1,0.00,65.49,50.00
10,015,02,090,0010,0000,127,8,135,222,0,2,0,2,1,0,1,0.00,60.81,50.00
10,015,02,090,0011,0000,204,12,216,344,0,2,0,2,1,0,1,0.00,62.79,50.00
10,015,02,090,0009,0282,283,15,298,455,0,2,0,2,1,0,1,0.00,65.49,50.00
10,015,02,090,0010,0283,127,8,135,222,0,2,0,2,1,0,1,0.00,60.81,50.00
10,015,02,090,0011,0284,204,12,216,344,0,2,0,2,1,0,1,0.00,62.79,50.00
10,015,02,100,0007,0000,544,16,560,815,0,3,1,4,2,1,3,0.00,68.71,75.00
10,015,02,100,0008,0000,250,7,257,325,0,3,1,4,2,1,3,0.00,79.08,75.00
10,015,02,100,0009,0000,850,29,879,1232,0,3,1,4,2,1,3,0.00,71.35,75.00
10,015,02,100,0010,0000,271,6,277,414,0,3,1,4,2,1,3,0.00,66.91,75.00
10,015,02,100,0011,0000,137,6,143,226,0,3,1,4,2,1,3,0.00,63.27,75.00
10,015,02,100,0012,0000,234,7,241,389,0,3,1,4,2,1,3,0.00,61.95,75.00
10,015,02,100,0013,0000,340,9,349,491,0,3,1,4,2,1,3,0.00,71.08,75.00
10,015,02,100,0007,0316,544,16,560,815,0,3,1,4,2,1,3,0.00,68.71,75.00
10,015,02,100,0008,0317,250,7,257,325,0,3,1,4,2,1,3,0.00,79.08,75.00
10,015,02,100,0009,0318,850,29,879,1232,0,3,1,4,2,1,3,0.00,71.35,75.00
10,015,02,100,0010,0319,271,6,277,414,0,3,1,4,2,1,3,0.00,66.91,75.00
10,015,02,100,0011,0320,137,6,143,226,0,3,1,4,2,1,3,0.00,63.27,75.00
10,015,02,100,0012,0321,234,7,241,389,0,3,1,4,2,1,3,0.00,61.95,75.00
10,015,02,100,0013,0322,340,9,349,491,0,3,1,4,2,1,3,0.00,71.08,75.00
10,015,02,110,0007,0000,1163,30,1193,1667,0,2,4,6,1,1,2,0.00,71.57,33.33
10,015,02,110,0008,0000,605,8,613,897,0,2,4,6,1,1,2,0.00,68.34,33.33
10,015,02,110,0007,0126,695,24,719,1042,0,2,4,6,1,1,2,0.00,69.00,33.33
10,015,02,110,0007,0127,468,6,474,625,0,2,4,6,1,1,2,0.00,75.84,33.33
10,015,02,110,0008,0128,605,8,613,897,0,2,4,6,1,1,2,0.00,68.34,33.33
10,015,02,120,0003,0000,561,13,574,740,0,2,1,3,1,1,2,0.00,77.57,66.67
10,015,02,120,0004,0000,460,9,469,626,0,2,1,3,1,1,2,0.00,74.92,66.67
10,015,02,120,0003,0267,561,13,574,740,0,2,1,3,1,1,2,0.00,77.57,66.67
10,015,02,120,0004,0268,460,9,469,626,0,2,1,3,1,1,2,0.00,74.92,66.67
10,015,02,130,0004,0000,501,19,520,718,0,3,3,6,2,2,4,0.00,72.42,66.67
10,015,02,130,0005,0000,631,33,664,968,0,3,3,6,2,2,4,0.00,68.60,66.67
10,015,02,130,0006,0000,656,14,670,897,0,3,3,6,2,2,4,0.00,74.69,66.67
10,015,02,130,0004,0327,501,19,520,718,0,3,3,6,2,2,4,0.00,72.42,66.67
10,015,02,130,0005,0328,379,21,400,596,0,3,3,6,2,2,4,0.00,67.11,66.67
10,015,02,130,0005,0329,252,12,264,372,0,3,3,6,2,2,4,0.00,70.97,66.67
10,015,02,130,0006,0330,228,1,229,319,0,3,3,6,2,2,4,0.00,71.79,66.67
10,015,02,130,0006,0331,310,8,318,405,0,3,3,6,2,2,4,0.00,78.52,66.67
10,015,02,130,0006,0332,118,5,123,173,0,3,3,6,2,2,4,0.00,71.10,66.67
10,015,00,030,0000,0000,7669,398,8067,13746,16030,9,4,13,4,4,8,85.75,58.69,61.54
10,015,01,030,0000,0000,6679,214,6893,11721,13772,9,3,12,4,3,7,85.11,58.81,58.33
10,015,02,030,0000,0000,990,184,1174,2025,2258,0,1,1,0,1,1,89.68,57.98,100.00
10,015,03,010,0020,0030,264,13,277,474,0,4,2,6,3,2,5,0.00,58.44,83.33
10,015,03,010,0028,0031,385,25,410,703,0,4,2,6,3,2,5,0.00,58.32,83.33
10,015,03,010,0013,0032,272,15,287,468,0,4,2,6,3,2,5,0.00,61.32,83.33
10,015,03,010,0004,0033,320,23,343,601,0,4,2,6,3,2,5,0.00,57.07,83.33
10,015,03,010,0012,0034,267,20,287,407,0,4,2,6,3,2,5,0.00,70.52,83.33
10,015,03,010,0005,0035,232,13,245,487,0,4,2,6,3,2,5,0.00,50.31,83.33
10,015,03,010,0036,0036,381,32,413,752,0,4,2,6,3,2,5,0.00,54.92,83.33
10,015,03,010,0006,0037,419,37,456,786,0,4,2,6,3,2,5,0.00,58.02,83.33
10,015,03,010,0006,0038,471,34,505,898,0,4,2,6,3,2,5,0.00,56.24,83.33
10,015,03,010,0006,0039,478,23,501,890,0,4,2,6,3,2,5,0.00,56.29,83.33
10,015,03,010,0004,0000,320,23,343,601,0,4,2,6,3,2,5,0.00,57.07,83.33
10,015,03,010,0021,0040,359,22,381,762,0,4,2,6,3,2,5,0.00,50.00,83.33
10,015,03,010,0021,0041,416,17,433,895,0,4,2,6,3,2,5,0.00,48.38,83.33
10,015,03,010,0014,0042,497,22,519,846,0,4,2,6,3,2,5,0.00,61.35,83.33
10,015,03,010,0014,0043,419,20,439,759,0,4,2,6,3,2,5,0.00,57.84,83.33
10,015,03,010,0014,0044,430,21,451,731,0,4,2,6,3,2,5,0.00,61.70,83.33
10,015,03,010,0014,0045,379,15,394,710,0,4,2,6,3,2,5,0.00,55.49,83.33
10,015,03,010,0042,0046,525,34,559,1108,0,4,2,6,3,2,5,0.00,50.45,83.33
10,015,03,010,0042,0047,505,30,535,1085,0,4,2,6,3,2,5,0.00,49.31,83.33
10,015,03,010,0037,0048,372,18,390,777,0,4,2,6,3,2,5,0.00,50.19,83.33
10,015,03,010,0037,0049,354,18,372,724,0,4,2,6,3,2,5,0.00,51.38,83.33
10,015,03,010,0005,0000,232,13,245,487,0,4,2,6,3,2,5,0.00,50.31,83.33
10,015,03,010,0037,0050,356,18,374,890,0,4,2,6,3,2,5,0.00,42.02,83.33
10,015,03,010,0037,0051,499,29,528,982,0,4,2,6,3,2,5,0.00,53.77,83.33
10,015,03,010,0037,0052,499,23,522,894,0,4,2,6,3,2,5,0.00,58.39,83.33
10,015,03,010,0029,0053,396,25,421,756,0,4,2,6,3,2,5,0.00,55.69,83.33
10,015,03,010,0029,0054,366,23,389,758,0,4,2,6,3,2,5,0.00,51.32,83.33
10,015,03,010,0029,0055,371,16,387,823,0,4,2,6,3,2,5,0.00,47.02,83.33
10,015,03,010,0006,0000,1368,94,1462,2574,0,4,2,6,3,2,5,0.00,56.80,83.33
10,015,03,010,0012,0000,267,20,287,407,0,4,2,6,3,2,5,0.00,70.52,83.33
10,015,03,010,0013,0000,272,15,287,468,0,4,2,6,3,2,5,0.00,61.32,83.33
10,015,03,010,0014,0000,1725,78,1803,3046,0,4,2,6,3,2,5,0.00,59.19,83.33
10,015,03,010,0020,0000,264,13,277,474,0,4,2,6,3,2,5,0.00,58.44,83.33
10,015,03,010,0021,0000,775,39,814,1657,0,4,2,6,3,2,5,0.00,49.12,83.33
10,015,03,010,0028,0000,385,25,410,703,0,4,2,6,3,2,5,0.00,58.32,83.33
10,015,03,010,0029,0000,1133,64,1197,2337,0,4,2,6,3,2,5,0.00,51.22,83.33
10,015,03,010,0036,0000,381,32,413,752,0,4,2,6,3,2,5,0.00,54.92,83.33
10,015,03,010,0037,0000,2080,106,2186,4267,0,4,2,6,3,2,5,0.00,51.23,83.33
10,015,03,010,0042,0000,1030,64,1094,2193,0,4,2,6,3,2,5,0.00,49.89,83.33
10,015,03,020,0011,0000,535,20,555,813,0,2,0,2,1,0,1,0.00,68.27,50.00
10,015,03,020,0012,0000,36,0,36,43,0,2,0,2,1,0,1,0.00,83.72,50.00
10,015,03,020,0011,0239,535,20,555,813,0,2,0,2,1,0,1,0.00,68.27,50.00
10,015,03,020,0012,0240,36,0,36,43,0,2,0,2,1,0,1,0.00,83.72,50.00
10,015,03,040,0005,0000,434,24,458,764,0,2,2,4,1,2,3,0.00,59.95,75.00
10,015,03,040,0006,0000,1522,41,1563,2959,0,2,2,4,1,2,3,0.00,52.82,75.00
10,015,03,040,0007,0000,458,24,482,810,0,2,2,4,1,2,3,0.00,59.51,75.00
10,015,03,040,0005,0109,434,24,458,764,0,2,2,4,1,2,3,0.00,59.95,75.00
10,015,03,040,0006,0110,390,14,404,815,0,2,2,4,1,2,3,0.00,49.57,75.00
10,015,03,040,0006,0111,381,12,393,725,0,2,2,4,1,2,3,0.00,54.21,75.00
10,015,03,040,0006,0112,381,7,388,673,0,2,2,4,1,2,3,0.00,57.65,75.00
10,015,03,040,0006,0113,370,8,378,746,0,2,2,4,1,2,3,0.00,50.67,75.00
10,015,03,040,0007,0114,335,18,353,579,0,2,2,4,1,2,3,0.00,60.97,75.00
10,015,03,040,0007,0115,123,6,129,231,0,2,2,4,1,2,3,0.00,55.84,75.00
10,015,03,050,0010,0000,1198,64,1262,2362,0,4,2,6,2,2,4,0.00,53.43,66.67
10,015,03,050,0011,0000,1596,55,1651,2906,0,4,2,6,2,2,4,0.00,56.81,66.67
10,015,03,050,0014,0000,2597,120,2717,4934,0,4,2,6,2,2,4,0.00,55.07,66.67
10,015,03,050,0015,0000,1959,87,2046,3949,0,4,2,6,2,2,4,0.00,51.81,66.67
10,015,03,050,0010,0159,488,22,510,857,0,4,2,6,2,2,4,0.00,59.51,66.67
10,015,03,050,0016,0000,871,40,911,1814,0,4,2,6,2,2,4,0.00,50.22,66.67
10,015,03,050,0010,0160,382,22,404,732,0,4,2,6,2,2,4,0.00,55.19,66.67
10,015,03,050,0010,0161,328,20,348,773,0,4,2,6,2,2,4,0.00,45.02,66.67
10,015,03,050,0011,0162,441,21,462,872,0,4,2,6,2,2,4,0.00,52.98,66.67
10,015,03,050,0011,0163,520,17,537,925,0,4,2,6,2,2,4,0.00,58.05,66.67
10,015,03,050,0011,0164,635,17,652,1109,0,4,2,6,2,2,4,0.00,58.79,66.67
10,015,03,050,0017,0000,1691,88,1779,3476,0,4,2,6,2,2,4,0.00,51.18,66.67
10,015,03,050,0018,0000,830,56,886,1517,0,4,2,6,2,2,4,0.00,58.40,66.67
10,015,03,050,0014,0185,435,20,455,789,0,4,2,6,2,2,4,0.00,57.67,66.67
10,015,03,050,0014,0186,380,22,402,790,0,4,2,6,2,2,4,0.00,50.89,66.67
10,015,03,050,0014,0187,363,12,375,686,0,4,2,6,2,2,4,0.00,54.66,66.67
10,015,03,050,0014,0188,482,31,513,968,0,4,2,6,2,2,4,0.00,53.00,66.67
10,015,03,050,0014,0189,483,21,504,921,0,4,2,6,2,2,4,0.00,54.72,66.67
10,015,03,050,0014,0190,454,14,468,780,0,4,2,6,2,2,4,0.00,60.00,66.67
10,015,03,050,0015,0191,459,27,486,894,0,4,2,6,2,2,4,0.00,54.36,66.67
10,015,03,050,0015,0192,290,13,303,578,0,4,2,6,2,2,4,0.00,52.42,66.67
10,015,03,050,0015,0193,376,11,387,715,0,4,2,6,2,2,4,0.00,54.13,66.67
10,015,03,050,0015,0194,374,21,395,782,0,4,2,6,2,2,4,0.00,50.51,66.67
10,015,03,050,0015,0195,460,15,475,980,0,4,2,6,2,2,4,0.00,48.47,66.67
10,015,03,050,0016,0196,392,18,410,865,0,4,2,6,2,2,4,0.00,47.40,66.67
10,015,03,050,0016,0197,479,22,501,949,0,4,2,6,2,2,4,0.00,52.79,66.67
10,015,03,050,0017,0198,401,24,425,744,0,4,2,6,2,2,4,0.00,57.12,66.67
10,015,03,050,0017,0199,298,16,314,660,0,4,2,6,2,2,4,0.00,47.58,66.67
10,015,03,050,0017,0200,377,15,392,778,0,4,2,6,2,2,4,0.00,50.39,66.67
10,015,03,050,0017,0201,282,14,296,601,0,4,2,6,2,2,4,0.00,49.25,66.67
10,015,03,050,0017,0202,333,19,352,693,0,4,2,6,2,2,4,0.00,50.79,66.67
10,015,03,050,0018,0203,375,30,405,729,0,4,2,6,2,2,4,0.00,55.56,66.67
10,015,03,050,0018,0204,455,26,481,788,0,4,2,6,2,2,4,0.00,61.04,66.67
10,015,03,060,0014,0000,126,44,170,282,0,1,0,1,1,0,1,0.00,60.28,100.00
10,015,03,060,0015,0000,173,41,214,286,0,1,0,1,1,0,1,0.00,74.83,100.00
10,015,03,060,0015,0224,173,41,214,286,0,1,0,1,1,0,1,0.00,74.83,100.00
10,015,03,060,0014,0225,126,44,170,282,0,1,0,1,1,0,1,0.00,60.28,100.00
10,015,03,110,0004,0000,867,20,887,1149,0,4,3,7,2,1,3,0.00,77.20,42.86
10,015,03,110,0005,0000,833,14,847,1144,0,4,3,7,2,1,3,0.00,74.04,42.86
10,015,03,110,0006,0000,798,20,818,1067,0,4,3,7,2,1,3,0.00,76.66,42.86
10,015,03,110,0004,0129,867,20,887,1149,0,4,3,7,2,1,3,0.00,77.20,42.86
10,015,03,110,0005,0130,490,9,499,680,0,4,3,7,2,1,3,0.00,73.38,42.86
10,015,03,110,0005,0131,343,5,348,464,0,4,3,7,2,1,3,0.00,75.00,42.86
10,015,03,110,0006,0132,596,15,611,766,0,4,3,7,2,1,3,0.00,79.77,42.86
10,015,03,110,0006,0133,202,5,207,301,0,4,3,7,2,1,3,0.00,68.77,42.86
10,015,03,120,0005,0000,684,25,709,1041,0,5,0,5,3,0,3,0.00,68.11,60.00
10,015,03,120,0006,0000,732,18,750,1025,0,5,0,5,3,0,3,0.00,73.17,60.00
10,015,03,120,0005,0269,296,10,306,413,0,5,0,5,3,0,3,0.00,74.09,60.00
10,015,03,120,0005,0270,388,15,403,628,0,5,0,5,3,0,3,0.00,64.17,60.00
10,015,03,120,0006,0271,732,18,750,1025,0,5,0,5,3,0,3,0.00,73.17,60.00
10,015,00,040,0000,0000,7635,267,7902,13521,15985,8,5,13,5,4,9,84.59,58.44,69.23
10,015,01,040,0000,0000,1262,62,1324,1846,2104,2,0,2,1,0,1,87.74,71.72,50.00
10,015,02,040,0000,0000,3959,116,4075,7142,8415,4,3,7,3,2,5,84.87,57.06,71.43
10,015,03,040,0000,0000,2414,89,2503,4533,5466,2,2,4,1,2,3,82.93,55.22,75.00
10,015,04,010,0008,0056,495,39,534,881,0,5,4,9,4,3,7,0.00,60.61,77.78
10,015,04,010,0008,0057,530,28,558,1033,0,5,4,9,4,3,7,0.00,54.02,77.78
10,015,04,010,0008,0058,523,34,557,981,0,5,4,9,4,3,7,0.00,56.78,77.78
10,015,04,010,0007,0059,249,8,257,811,0,5,4,9,4,3,7,0.00,31.69,77.78
10,015,04,010,0007,0060,349,18,367,718,0,5,4,9,4,3,7,0.00,51.11,77.78
10,015,04,010,0015,0061,369,28,397,725,0,5,4,9,4,3,7,0.00,54.76,77.78
10,015,04,010,0030,0062,262,16,278,444,0,5,4,9,4,3,7,0.00,62.61,77.78
10,015,04,010,0022,0063,516,34,550,1069,0,5,4,9,4,3,7,0.00,51.45,77.78
10,015,04,010,0039,0064,348,15,363,712,0,5,4,9,4,3,7,0.00,50.98,77.78
10,015,04,010,0038,0065,513,34,547,974,0,5,4,9,4,3,7,0.00,56.16,77.78
10,015,04,010,0038,0066,524,30,554,988,0,5,4,9,4,3,7,0.00,56.07,77.78
10,015,04,010,0031,0067,426,20,446,841,0,5,4,9,4,3,7,0.00,53.03,77.78
10,015,04,010,0031,0068,405,24,429,824,0,5,4,9,4,3,7,0.00,52.06,77.78
10,015,04,010,0023,0069,357,20,377,681,0,5,4,9,4,3,7,0.00,55.36,77.78
10,015,04,010,0007,0000,598,26,624,1529,0,5,4,9,4,3,7,0.00,40.81,77.78
10,015,04,010,0023,0070,490,16,506,899,0,5,4,9,4,3,7,0.00,56.28,77.78
10,015,04,010,0023,0071,465,20,485,912,0,5,4,9,4,3,7,0.00,53.18,77.78
10,015,04,010,0043,0072,338,17,355,755,0,5,4,9,4,3,7,0.00,47.02,77.78
10,015,04,010,0043,0073,340,30,370,740,0,5,4,9,4,3,7,0.00,50.00,77.78
10,015,04,010,0043,0074,336,19,355,803,0,5,4,9,4,3,7,0.00,44.21,77.78
10,015,04,010,0043,0075,357,21,378,782,0,5,4,9,4,3,7,0.00,48.34,77.78
10,015,04,010,0024,0076,331,11,342,652,0,5,4,9,4,3,7,0.00,52.45,77.78
10,015,04,010,0024,0077,407,19,426,835,0,5,4,9,4,3,7,0.00,51.02,77.78
10,015,04,010,0016,0078,423,25,448,829,0,5,4,9,4,3,7,0.00,54.04,77.78
10,015,04,010,0016,0079,414,16,430,843,0,5,4,9,4,3,7,0.00,51.01,77.78
10,015,04,010,0008,0000,1548,101,1649,2895,0,5,4,9,4,3,7,0.00,56.96,77.78
10,015,04,010,0016,0080,419,22,441,830,0,5,4,9,4,3,7,0.00,53.13,77.78
10,015,04,010,0016,0081,421,15,436,819,0,5,4,9,4,3,7,0.00,53.24,77.78
10,015,04,010,0016,0082,490,14,504,965,0,5,4,9,4,3,7,0.00,52.23,77.78
10,015,04,010,0041,0083,438,16,454,911,0,5,4,9,4,3,7,0.00,49.84,77.78
10,015,04,010,0041,0084,401,29,430,876,0,5,4,9,4,3,7,0.00,49.09,77.78
10,015,04,010,0041,0085,467,19,486,966,0,5,4,9,4,3,7,0.00,50.31,77.78
10,015,04,010,0041,0086,411,20,431,836,0,5,4,9,4,3,7,0.00,51.56,77.78
10,015,04,010,0032,0087,441,32,473,866,0,5,4,9,4,3,7,0.00,54.62,77.78
10,015,04,010,0044,0088,472,29,501,920,0,5,4,9,4,3,7,0.00,54.46,77.78
10,015,04,010,0044,0089,491,32,523,1021,0,5,4,9,4,3,7,0.00,51.22,77.78
10,015,04,010,0044,0090,412,30,442,987,0,5,4,9,4,3,7,0.00,44.78,77.78
10,015,04,010,0044,0091,402,23,425,843,0,5,4,9,4,3,7,0.00,50.42,77.78
10,015,04,010,0040,0092,276,6,282,486,0,5,4,9,4,3,7,0.00,58.02,77.78
10,015,04,010,0040,0093,229,16,245,411,0,5,4,9,4,3,7,0.00,59.61,77.78
10,015,04,010,0015,0000,369,28,397,725,0,5,4,9,4,3,7,0.00,54.76,77.78
10,015,04,010,0016,0000,2167,92,2259,4286,0,5,4,9,4,3,7,0.00,52.71,77.78
10,015,04,010,0022,0000,516,34,550,1069,0,5,4,9,4,3,7,0.00,51.45,77.78
10,015,04,010,0023,0000,1312,56,1368,2492,0,5,4,9,4,3,7,0.00,54.90,77.78
10,015,04,010,0024,0000,738,30,768,1487,0,5,4,9,4,3,7,0.00,51.65,77.78
10,015,04,010,0030,0000,262,16,278,444,0,5,4,9,4,3,7,0.00,62.61,77.78
10,015,04,010,0031,0000,831,44,875,1665,0,5,4,9,4,3,7,0.00,52.55,77.78
10,015,04,010,0032,0000,441,32,473,866,0,5,4,9,4,3,7,0.00,54.62,77.78
10,015,04,010,0038,0000,1037,64,1101,1962,0,5,4,9,4,3,7,0.00,56.12,77.78
10,015,04,010,0039,0000,348,15,363,712,0,5,4,9,4,3,7,0.00,50.98,77.78
10,015,04,010,0040,0000,505,22,527,897,0,5,4,9,4,3,7,0.00,58.75,77.78
10,015,04,010,0041,0000,1717,84,1801,3589,0,5,4,9,4,3,7,0.00,50.18,77.78
10,015,04,010,0043,0000,1371,87,1458,3080,0,5,4,9,4,3,7,0.00,47.34,77.78
10,015,04,010,0044,0000,1777,114,1891,3771,0,5,4,9,4,3,7,0.00,50.15,77.78
10,015,00,050,0000,0000,29064,1958,31022,60307,70371,10,4,14,8,4,12,85.70,51.44,85.71
10,015,01,050,0000,0000,10901,728,11629,23591,28330,3,2,5,3,2,5,83.27,49.29,100.00
10,015,02,050,0000,0000,7421,720,8141,15758,18166,3,0,3,3,0,3,86.74,51.66,100.00
10,015,03,050,0000,0000,10742,510,11252,20958,23875,4,2,6,2,2,4,87.78,53.69,66.67
10,015,00,060,0000,0000,6592,332,6924,10561,11964,7,3,10,7,1,8,88.27,65.56,80.00
10,015,01,060,0000,0000,3572,137,3709,5601,6405,3,2,5,3,1,4,87.45,66.22,80.00
10,015,02,060,0000,0000,2721,110,2831,4392,4937,3,1,4,3,0,3,88.96,64.46,75.00
10,015,03,060,0000,0000,299,85,384,568,622,1,0,1,1,0,1,91.32,67.61,100.00
10,015,00,070,0000,0000,3398,62,3460,5117,5697,6,2,8,3,2,5,89.82,67.62,62.50
10,015,01,070,0000,0000,2441,44,2485,3750,4179,4,2,6,2,2,4,89.73,66.27,66.67
10,015,02,070,0000,0000,957,18,975,1367,1518,2,0,2,1,0,1,90.05,71.32,50.00
10,015,00,080,0000,0000,381,53,434,759,832,1,0,1,1,0,1,91.23,57.18,100.00
10,015,01,080,0000,0000,381,53,434,759,832,1,0,1,1,0,1,91.23,57.18,100.00
10,015,00,090,0000,0000,3919,120,4039,6139,6952,9,2,11,5,2,7,88.31,65.79,63.64
10,015,01,090,0000,0000,3305,85,3390,5118,5788,7,2,9,4,2,6,88.42,66.24,66.67
10,015,02,090,0000,0000,614,35,649,1021,1164,2,0,2,1,0,1,87.71,63.57,50.00
10,015,00,100,0000,0000,4779,137,4916,7283,8262,7,2,9,4,2,6,88.15,67.50,66.67
10,015,01,100,0000,0000,2153,57,2210,3391,3848,4,1,5,2,1,3,88.12,65.17,60.00
10,015,02,100,0000,0000,2626,80,2706,3892,4414,3,1,4,2,1,3,88.17,69.53,75.00
10,015,00,110,0000,0000,8681,190,8871,12178,15877,17,11,28,7,3,10,76.70,72.84,35.71
10,015,01,110,0000,0000,4415,98,4513,6254,8150,11,4,15,4,1,5,76.74,72.16,33.33
10,015,02,110,0000,0000,1768,38,1806,2564,3316,2,4,6,1,1,2,77.32,70.44,33.33
10,015,03,110,0000,0000,2498,54,2552,3360,4411,4,3,7,2,1,3,76.17,75.95,42.86
10,015,00,120,0000,0000,3521,87,3608,4931,6171,12,1,13,6,1,7,79.91,73.17,53.85
10,015,01,120,0000,0000,1084,22,1106,1499,1885,5,0,5,2,0,2,79.52,73.78,40.00
10,015,02,120,0000,0000,1021,22,1043,1366,1708,2,1,3,1,1,2,79.98,76.35,66.67
10,015,03,120,0000,0000,1416,43,1459,2066,2578,5,0,5,3,0,3,80.14,70.62,60.00
10,015,00,130,0000,0000,3386,99,3485,4728,6049,7,4,11,4,3,7,78.16,73.71,63.64
10,015,01,130,0000,0000,1598,33,1631,2145,2711,4,1,5,2,1,3,79.12,76.04,60.00
10,015,02,130,0000,0000,1788,66,1854,2583,3338,3,3,6,2,2,4,77.38,71.78,66.67
10,016,00,000,0000,0000,50191,2525,52716,90029,106891,58,25,83,37,13,50,84.23,58.55,60.24
10,016,00,010,0000,0000,28564,1945,30509,52655,63469,13,9,22,7,5,12,82.96,57.94,54.55
10,016,01,010,0000,0000,2177,165,2342,3999,4582,3,1,4,0,1,1,87.28,58.56,25.00
10,016,02,010,0000,0000,11384,632,12016,21362,25757,4,4,8,3,2,5,82.94,56.25,62.50
10,016,03,010,0000,0000,10213,498,10711,18102,22357,4,4,8,2,2,4,80.97,59.17,50.00
10,016,04,010,0000,0000,4790,650,5440,9192,10773,2,0,2,2,0,2,85.32,59.18,100.00
10,016,01,010,0002,0001,175,13,188,456,0,3,1,4,0,1,1,0.00,41.23,25.00
10,016,01,010,0003,0002,275,22,297,511,0,3,1,4,0,1,1,0.00,58.12,25.00
10,016,01,010,0004,0003,321,19,340,519,0,3,1,4,0,1,1,0.00,65.51,25.00
10,016,01,010,0005,0004,470,47,517,847,0,3,1,4,0,1,1,0.00,61.04,25.00
10,016,01,010,0006,0005,547,34,581,893,0,3,1,4,0,1,1,0.00,65.06,25.00
10,016,01,010,0007,0006,389,30,419,773,0,3,1,4,0,1,1,0.00,54.20,25.00
10,016,01,010,0002,0000,175,13,188,456,0,3,1,4,0,1,1,0.00,41.23,25.00
10,016,01,010,0003,0000,275,22,297,511,0,3,1,4,0,1,1,0.00,58.12,25.00
10,016,01,010,0004,0000,321,19,340,519,0,3,1,4,0,1,1,0.00,65.51,25.00
10,016,01,010,0005,0000,470,47,517,847,0,3,1,4,0,1,1,0.00,61.04,25.00
10,016,01,010,0006,0000,547,34,581,893,0,3,1,4,0,1,1,0.00,65.06,25.00
10,016,01,010,0007,0000,389,30,419,773,0,3,1,4,0,1,1,0.00,54.20,25.00
10,016,01,020,0001,0000,667,20,687,1205,0,4,1,5,3,1,4,0.00,57.01,80.00
10,016,01,020,0002,0000,188,2,190,362,0,4,1,5,3,1,4,0.00,52.49,80.00
10,016,01,020,0003,0000,171,3,174,233,0,4,1,5,3,1,4,0.00,74.68,80.00
10,016,01,020,0004,0000,201,9,210,284,0,4,1,5,3,1,4,0.00,73.94,80.00
10,016,01,020,0005,0000,333,5,338,654,0,4,1,5,3,1,4,0.00,51.68,80.00
10,016,01,020,0001,0054,667,20,687,1205,0,4,1,5,3,1,4,0.00,57.01,80.00
10,016,01,020,0002,0055,188,2,190,362,0,4,1,5,3,1,4,0.00,52.49,80.00
10,016,01,020,0003,0056,171,3,174,233,0,4,1,5,3,1,4,0.00,74.68,80.00
10,016,01,020,0004,0057,201,9,210,284,0,4,1,5,3,1,4,0.00,73.94,80.00
10,016,01,020,0005,0058,333,5,338,654,0,4,1,5,3,1,4,0.00,51.68,80.00
10,016,01,020,0006,0059,225,11,236,322,0,4,1,5,3,1,4,0.00,73.29,80.00
10,016,01,020,0006,0000,225,11,236,322,0,4,1,5,3,1,4,0.00,73.29,80.00
10,016,01,020,0007,0060,426,24,450,750,0,4,1,5,3,1,4,0.00,60.00,80.00
10,016,01,020,0008,0061,361,7,368,816,0,4,1,5,3,1,4,0.00,45.10,80.00
10,016,01,020,0007,0000,426,24,450,750,0,4,1,5,3,1,4,0.00,60.00,80.00
10,016,01,020,0008,0000,361,7,368,816,0,4,1,5,3,1,4,0.00,45.10,80.00
10,016,01,030,0001,0000,381,13,394,531,0,2,1,3,2,0,2,0.00,74.20,66.67
10,016,01,030,0002,0000,385,4,389,648,0,2,1,3,2,0,2,0.00,60.03,66.67
10,016,01,030,0003,0000,61,2,63,96,0,2,1,3,2,0,2,0.00,65.63,66.67
10,016,01,030,0004,0000,83,0,83,143,0,2,1,3,2,0,2,0.00,58.04,66.67
10,016,01,030,0005,0000,175,9,184,276,0,2,1,3,2,0,2,0.00,66.67,66.67
10,016,01,030,0001,0077,381,13,394,531,0,2,1,3,2,0,2,0.00,74.20,66.67
10,016,01,030,0002,0078,385,4,389,648,0,2,1,3,2,0,2,0.00,60.03,66.67
10,016,01,030,0003,0079,61,2,63,96,0,2,1,3,2,0,2,0.00,65.63,66.67
10,016,01,030,0004,0080,83,0,83,143,0,2,1,3,2,0,2,0.00,58.04,66.67
10,016,01,030,0005,0081,175,9,184,276,0,2,1,3,2,0,2,0.00,66.67,66.67
10,016,01,030,0015,0092,119,3,122,260,0,2,1,3,2,0,2,0.00,46.92,66.67
10,016,01,030,0015,0000,119,3,122,260,0,2,1,3,2,0,2,0.00,46.92,66.67
10,016,01,040,0001,0000,163,11,174,281,0,2,0,2,2,0,2,0.00,61.92,100.00
10,016,01,040,0002,0000,201,22,223,407,0,2,0,2,2,0,2,0.00,54.79,100.00
10,016,01,040,0003,0000,114,9,123,271,0,2,0,2,2,0,2,0.00,45.39,100.00
10,016,01,040,0004,0000,342,35,377,806,0,2,0,2,2,0,2,0.00,46.77,100.00
10,016,01,040,0001,0093,163,11,174,281,0,2,0,2,2,0,2,0.00,61.92,100.00
10,016,01,040,0002,0094,201,22,223,407,0,2,0,2,2,0,2,0.00,54.79,100.00
10,016,01,040,0004,0095,342,35,377,806,0,2,0,2,2,0,2,0.00,46.77,100.00
10,016,01,040,0003,0096,114,9,123,271,0,2,0,2,2,0,2,0.00,45.39,100.00
10,016,01,050,0001,0000,367,7,374,683,0,1,3,4,1,2,3,0.00,54.76,75.00
10,016,01,050,0002,0000,242,4,246,448,0,1,3,4,1,2,3,0.00,54.91,75.00
10,016,01,050,0003,0000,218,4,222,337,0,1,3,4,1,2,3,0.00,65.88,75.00
10,016,01,050,0004,0000,388,6,394,521,0,1,3,4,1,2,3,0.00,75.62,75.00
10,016,01,050,0001,0105,367,7,374,683,0,1,3,4,1,2,3,0.00,54.76,75.00
10,016,01,050,0002,0106,242,4,246,448,0,1,3,4,1,2,3,0.00,54.91,75.00
10,016,01,050,0003,0107,218,4,222,337,0,1,3,4,1,2,3,0.00,65.88,75.00
10,016,01,050,0004,0108,388,6,394,521,0,1,3,4,1,2,3,0.00,75.62,75.00
10,016,01,060,0001,0000,138,5,143,243,0,1,2,3,1,1,2,0.00,58.85,66.67
10,016,01,060,0002,0000,409,3,412,575,0,1,2,3,1,1,2,0.00,71.65,66.67
10,016,01,060,0001,0115,138,5,143,243,0,1,2,3,1,1,2,0.00,58.85,66.67
10,016,01,060,0002,0116,409,3,412,575,0,1,2,3,1,1,2,0.00,71.65,66.67
10,016,00,020,0000,0000,7682,185,7867,13429,15730,15,4,19,9,2,11,85.37,58.58,57.89
10,016,01,020,0000,0000,2572,81,2653,4626,5434,4,1,5,3,1,4,85.13,57.35,80.00
10,016,02,020,0000,0000,1909,47,1956,3315,3822,7,0,7,3,0,3,86.73,59.00,42.86
10,016,03,020,0000,0000,3201,57,3258,5488,6474,4,3,7,3,1,4,84.77,59.37,57.14
10,016,02,010,0008,0007,503,32,535,889,0,4,4,8,3,2,5,0.00,60.18,62.50
10,016,02,010,0008,0008,502,29,531,962,0,4,4,8,3,2,5,0.00,55.20,62.50
10,016,02,010,0010,0009,598,40,638,1135,0,4,4,8,3,2,5,0.00,56.21,62.50
10,016,02,010,0009,0010,715,19,734,1322,0,4,4,8,3,2,5,0.00,55.52,62.50
10,016,02,010,0009,0011,798,37,835,1375,0,4,4,8,3,2,5,0.00,60.73,62.50
10,016,02,010,0009,0012,692,43,735,1300,0,4,4,8,3,2,5,0.00,56.54,62.50
10,016,02,010,0011,0013,635,36,671,1200,0,4,4,8,3,2,5,0.00,55.92,62.50
10,016,02,010,0011,0014,591,25,616,1152,0,4,4,8,3,2,5,0.00,53.47,62.50
10,016,02,010,0011,0015,727,34,761,1335,0,4,4,8,3,2,5,0.00,57.00,62.50
10,016,02,010,0011,0016,723,41,764,1318,0,4,4,8,3,2,5,0.00,57.97,62.50
10,016,02,010,0012,0017,561,56,617,1126,0,4,4,8,3,2,5,0.00,54.80,62.50
10,016,02,010,0012,0018,661,38,699,1236,0,4,4,8,3,2,5,0.00,56.55,62.50
10,016,02,010,0013,0019,871,43,914,1474,0,4,4,8,3,2,5,0.00,62.01,62.50
10,016,02,010,0014,0020,622,37,659,1113,0,4,4,8,3,2,5,0.00,59.21,62.50
10,016,02,010,0014,0021,813,35,848,1388,0,4,4,8,3,2,5,0.00,61.10,62.50
10,016,02,010,0014,0022,902,48,950,1596,0,4,4,8,3,2,5,0.00,59.52,62.50
10,016,02,010,0014,0023,470,39,509,1441,0,4,4,8,3,2,5,0.00,35.32,62.50
10,016,02,010,0008,0000,1005,61,1066,1851,0,4,4,8,3,2,5,0.00,57.59,62.50
10,016,02,010,0009,0000,2205,99,2304,3997,0,4,4,8,3,2,5,0.00,57.64,62.50
10,016,02,010,0010,0000,598,40,638,1135,0,4,4,8,3,2,5,0.00,56.21,62.50
10,016,02,010,0011,0000,2676,136,2812,5005,0,4,4,8,3,2,5,0.00,56.18,62.50
10,016,02,010,0012,0000,1222,94,1316,2362,0,4,4,8,3,2,5,0.00,55.72,62.50
10,016,02,010,0013,0000,871,43,914,1474,0,4,4,8,3,2,5,0.00,62.01,62.50
10,016,02,010,0014,0000,2807,159,2966,5538,0,4,4,8,3,2,5,0.00,53.56,62.50
10,016,02,020,0009,0062,484,12,496,910,0,7,0,7,3,0,3,0.00,54.51,42.86
10,016,02,020,0010,0063,92,1,93,115,0,7,0,7,3,0,3,0.00,80.87,42.86
10,016,02,020,0015,0064,471,10,481,772,0,7,0,7,3,0,3,0.00,62.31,42.86
10,016,02,020,0011,0065,154,5,159,224,0,7,0,7,3,0,3,0.00,70.98,42.86
10,016,02,020,0013,0066,253,6,259,604,0,7,0,7,3,0,3,0.00,42.88,42.86
10,016,02,020,0012,0067,204,7,211,289,0,7,0,7,3,0,3,0.00,73.01,42.86
10,016,02,020,0014,0068,251,6,257,401,0,7,0,7,3,0,3,0.00,64.09,42.86
10,016,02,020,0009,0000,484,12,496,910,0,7,0,7,3,0,3,0.00,54.51,42.86
10,016,02,020,0010,0000,92,1,93,115,0,7,0,7,3,0,3,0.00,80.87,42.86
10,016,02,020,0011,0000,154,5,159,224,0,7,0,7,3,0,3,0.00,70.98,42.86
10,016,02,020,0012,0000,204,7,211,289,0,7,0,7,3,0,3,0.00,73.01,42.86
10,016,02,020,0013,0000,253,6,259,604,0,7,0,7,3,0,3,0.00,42.88,42.86
10,016,02,020,0014,0000,251,6,257,401,0,7,0,7,3,0,3,0.00,64.09,42.86
10,016,02,020,0015,0000,471,10,481,772,0,7,0,7,3,0,3,0.00,62.31,42.86
10,016,02,030,0006,0000,90,1,91,203,0,3,1,4,3,0,3,0.00,44.83,75.00
10,016,02,030,0007,0000,115,1,116,156,0,3,1,4,3,0,3,0.00,74.36,75.00
10,016,02,030,0008,0000,1084,26,1110,1733,0,3,1,4,3,0,3,0.00,64.05,75.00
10,016,02,030,0006,0082,90,1,91,203,0,3,1,4,3,0,3,0.00,44.83,75.00
10,016,02,030,0007,0083,115,1,116,156,0,3,1,4,3,0,3,0.00,74.36,75.00
10,016,02,030,0008,0084,636,12,648,991,0,3,1,4,3,0,3,0.00,65.39,75.00
10,016,02,030,0008,0085,448,14,462,742,0,3,1,4,3,0,3,0.00,62.26,75.00
10,016,02,030,0009,0086,225,5,230,315,0,3,1,4,3,0,3,0.00,73.02,75.00
10,016,02,030,0009,0000,225,5,230,315,0,3,1,4,3,0,3,0.00,73.02,75.00
10,016,02,030,0013,0090,550,11,561,1108,0,3,1,4,3,0,3,0.00,50.63,75.00
10,016,02,030,0014,0091,150,5,155,267,0,3,1,4,3,0,3,0.00,58.05,75.00
10,016,02,030,0013,0000,550,11,561,1108,0,3,1,4,3,0,3,0.00,50.63,75.00
10,016,02,030,0014,0000,150,5,155,267,0,3,1,4,3,0,3,0.00,58.05,75.00
10,016,02,040,0005,0000,322,4,326,637,0,1,2,3,0,2,2,0.00,51.18,66.67
10,016,02,040,0006,0000,58,0,58,132,0,1,2,3,0,2,2,0.00,43.94,66.67
10,016,02,040,0007,0000,364,13,377,649,0,1,2,3,0,2,2,0.00,58.09,66.67
10,016,02,040,0008,0000,133,3,136,214,0,1,2,3,0,2,2,0.00,63.55,66.67
10,016,02,040,0009,0000,286,8,294,588,0,1,2,3,0,2,2,0.00,50.00,66.67
10,016,02,040,0005,0097,322,4,326,637,0,1,2,3,0,2,2,0.00,51.18,66.67
10,016,02,040,0006,0098,58,0,58,132,0,1,2,3,0,2,2,0.00,43.94,66.67
10,016,02,040,0007,0099,364,13,377,649,0,1,2,3,0,2,2,0.00,58.09,66.67
10,016,02,040,0008,0100,133,3,136,214,0,1,2,3,0,2,2,0.00,63.55,66.67
10,016,02,040,0009,0101,286,8,294,588,0,1,2,3,0,2,2,0.00,50.00,66.67
10,016,02,050,0005,0000,929,24,953,1425,0,3,0,3,1,0,1,0.00,66.88,33.33
10,016,02,050,0005,0109,448,7,455,672,0,3,0,3,1,0,1,0.00,67.71,33.33
10,016,02,050,0005,0110,481,17,498,753,0,3,0,3,1,0,1,0.00,66.14,33.33
10,016,02,060,0003,0000,388,17,405,638,0,3,0,3,2,0,2,0.00,63.48,66.67
10,016,02,060,0004,0000,206,11,217,362,0,3,0,3,2,0,2,0.00,59.94,66.67
10,016,02,060,0003,0117,388,17,405,638,0,3,0,3,2,0,2,0.00,63.48,66.67
10,016,02,060,0004,0118,206,11,217,362,0,3,0,3,2,0,2,0.00,59.94,66.67
10,016,00,030,0000,0000,4953,129,5082,8605,10007,10,2,12,7,0,7,85.99,59.06,58.33
10,016,01,030,0000,0000,1204,31,1235,1954,2268,2,1,3,2,0,2,86.16,63.20,66.67
10,016,02,030,0000,0000,2214,49,2263,3782,4425,3,1,4,3,0,3,85.47,59.84,75.00
10,016,03,030,0000,0000,853,28,881,1486,1722,3,0,3,1,0,1,86.30,59.29,33.33
10,016,04,030,0000,0000,682,21,703,1383,1592,2,0,2,1,0,1,86.87,50.83,50.00
10,016,03,010,0015,0024,514,25,539,959,0,4,4,8,2,2,4,0.00,56.20,50.00
10,016,03,010,0015,0025,579,26,605,1034,0,4,4,8,2,2,4,0.00,58.51,50.00
10,016,03,010,0015,0026,561,30,591,1110,0,4,4,8,2,2,4,0.00,53.24,50.00
10,016,03,010,0016,0027,568,30,598,1014,0,4,4,8,2,2,4,0.00,58.97,50.00
10,016,03,010,0016,0028,619,31,650,1105,0,4,4,8,2,2,4,0.00,58.82,50.00
10,016,03,010,0016,0029,646,24,670,1092,0,4,4,8,2,2,4,0.00,61.36,50.00
10,016,03,010,0017,0030,416,20,436,954,0,4,4,8,2,2,4,0.00,45.70,50.00
10,016,03,010,0017,0031,516,16,532,818,0,4,4,8,2,2,4,0.00,65.04,50.00
10,016,03,010,0018,0032,349,20,369,903,0,4,4,8,2,2,4,0.00,40.86,50.00
10,016,03,010,0019,0033,590,21,611,935,0,4,4,8,2,2,4,0.00,65.35,50.00
10,016,03,010,0020,0034,560,42,602,937,0,4,4,8,2,2,4,0.00,64.25,50.00
10,016,03,010,0020,0035,541,31,572,908,0,4,4,8,2,2,4,0.00,63.00,50.00
10,016,03,010,0020,0036,429,28,457,810,0,4,4,8,2,2,4,0.00,56.42,50.00
10,016,03,010,0021,0037,272,9,281,425,0,4,4,8,2,2,4,0.00,66.12,50.00
10,016,03,010,0022,0038,708,32,740,1159,0,4,4,8,2,2,4,0.00,63.85,50.00
10,016,03,010,0022,0039,556,29,585,954,0,4,4,8,2,2,4,0.00,61.32,50.00
10,016,03,010,0023,0040,396,12,408,646,0,4,4,8,2,2,4,0.00,63.16,50.00
10,016,03,010,0025,0041,732,48,780,1287,0,4,4,8,2,2,4,0.00,60.61,50.00
10,016,03,010,0024,0042,661,24,685,1052,0,4,4,8,2,2,4,0.00,65.11,50.00
10,016,03,010,0015,0000,1654,81,1735,3103,0,4,4,8,2,2,4,0.00,55.91,50.00
10,016,03,010,0016,0000,1833,85,1918,3211,0,4,4,8,2,2,4,0.00,59.73,50.00
10,016,03,010,0017,0000,932,36,968,1772,0,4,4,8,2,2,4,0.00,54.63,50.00
10,016,03,010,0018,0000,349,20,369,903,0,4,4,8,2,2,4,0.00,40.86,50.00
10,016,03,010,0019,0000,590,21,611,935,0,4,4,8,2,2,4,0.00,65.35,50.00
10,016,03,010,0020,0000,1530,101,1631,2655,0,4,4,8,2,2,4,0.00,61.43,50.00
10,016,03,010,0021,0000,272,9,281,425,0,4,4,8,2,2,4,0.00,66.12,50.00
10,016,03,010,0022,0000,1264,61,1325,2113,0,4,4,8,2,2,4,0.00,62.71,50.00
10,016,03,010,0023,0000,396,12,408,646,0,4,4,8,2,2,4,0.00,63.16,50.00
10,016,03,010,0024,0000,661,24,685,1052,0,4,4,8,2,2,4,0.00,65.11,50.00
10,016,03,010,0025,0000,732,48,780,1287,0,4,4,8,2,2,4,0.00,60.61,50.00
10,016,03,020,0016,0069,218,5,223,357,0,4,3,7,3,1,4,0.00,62.46,57.14
10,016,03,020,0017,0070,69,4,73,87,0,4,3,7,3,1,4,0.00,83.91,57.14
10,016,03,020,0018,0071,462,10,472,911,0,4,3,7,3,1,4,0.00,51.81,57.14
10,016,03,020,0019,0072,670,11,681,1018,0,4,3,7,3,1,4,0.00,66.90,57.14
10,016,03,020,0020,0073,398,4,402,665,0,4,3,7,3,1,4,0.00,60.45,57.14
10,016,03,020,0021,0074,493,7,500,892,0,4,3,7,3,1,4,0.00,56.05,57.14
10,016,03,020,0021,0075,466,8,474,828,0,4,3,7,3,1,4,0.00,57.25,57.14
10,016,03,020,0022,0076,425,8,433,730,0,4,3,7,3,1,4,0.00,59.32,57.14
10,016,03,020,0016,0000,218,5,223,357,0,4,3,7,3,1,4,0.00,62.46,57.14
10,016,03,020,0017,0000,69,4,73,87,0,4,3,7,3,1,4,0.00,83.91,57.14
10,016,03,020,0018,0000,462,10,472,911,0,4,3,7,3,1,4,0.00,51.81,57.14
10,016,03,020,0019,0000,670,11,681,1018,0,4,3,7,3,1,4,0.00,66.90,57.14
10,016,03,020,0020,0000,398,4,402,665,0,4,3,7,3,1,4,0.00,60.45,57.14
10,016,03,020,0021,0000,959,15,974,1720,0,4,3,7,3,1,4,0.00,56.63,57.14
10,016,03,020,0022,0000,425,8,433,730,0,4,3,7,3,1,4,0.00,59.32,57.14
10,016,03,030,0010,0087,399,13,412,737,0,3,0,3,1,0,1,0.00,55.90,33.33
10,016,03,030,0011,0088,454,15,469,749,0,3,0,3,1,0,1,0.00,62.62,33.33
10,016,03,030,0010,0000,399,13,412,737,0,3,0,3,1,0,1,0.00,55.90,33.33
10,016,03,030,0011,0000,454,15,469,749,0,3,0,3,1,0,1,0.00,62.62,33.33
10,016,03,040,0010,0000,734,25,759,1245,0,3,2,5,2,1,3,0.00,60.96,60.00
10,016,03,040,0010,0102,734,25,759,1245,0,3,2,5,2,1,3,0.00,60.96,60.00
10,016,03,040,0011,0103,551,13,564,913,0,3,2,5,2,1,3,0.00,61.77,60.00
10,016,03,040,0011,0104,706,8,714,1111,0,3,2,5,2,1,3,0.00,64.27,60.00
10,016,03,040,0011,0000,1257,21,1278,2024,0,3,2,5,2,1,3,0.00,63.14,60.00
10,016,03,050,0006,0000,360,7,367,509,0,2,1,3,2,0,2,0.00,72.10,66.67
10,016,03,050,0007,0000,118,1,119,207,0,2,1,3,2,0,2,0.00,57.49,66.67
10,016,03,050,0008,0000,190,6,196,315,0,2,1,3,2,0,2,0.00,62.22,66.67
10,016,03,050,0009,0000,183,5,188,301,0,2,1,3,2,0,2,0.00,62.46,66.67
10,016,03,050,0008,0111,190,6,196,315,0,2,1,3,2,0,2,0.00,62.22,66.67
10,016,03,050,0006,0112,360,7,367,509,0,2,1,3,2,0,2,0.00,72.10,66.67
10,016,03,050,0007,0113,118,1,119,207,0,2,1,3,2,0,2,0.00,57.49,66.67
10,016,03,050,0009,0114,183,5,188,301,0,2,1,3,2,0,2,0.00,62.46,66.67
10,016,03,060,0005,0000,210,2,212,381,0,4,0,4,3,0,3,0.00,55.64,75.00
10,016,03,060,0006,0000,672,13,685,1141,0,4,0,4,3,0,3,0.00,60.04,75.00
10,016,03,060,0005,0119,210,2,212,381,0,4,0,4,3,0,3,0.00,55.64,75.00
10,016,03,060,0006,0120,672,13,685,1141,0,4,0,4,3,0,3,0.00,60.04,75.00
10,016,00,040,0000,0000,3974,151,4125,7254,8319,6,4,10,4,3,7,87.20,56.87,70.00
10,016,01,040,0000,0000,820,77,897,1765,2005,2,0,2,2,0,2,88.03,50.82,100.00
10,016,02,040,0000,0000,1163,28,1191,2220,2501,1,2,3,0,2,2,88.76,53.65,66.67
10,016,03,040,0000,0000,1991,46,2037,3269,3813,3,2,5,2,1,3,85.73,62.31,60.00
10,016,04,010,0026,0043,349,73,422,657,0,2,0,2,2,0,2,0.00,64.23,100.00
10,016,04,010,0028,0044,773,96,869,1447,0,2,0,2,2,0,2,0.00,60.06,100.00
10,016,04,010,0028,0045,560,74,634,1079,0,2,0,2,2,0,2,0.00,58.76,100.00
10,016,04,010,0027,0046,420,59,479,739,0,2,0,2,2,0,2,0.00,64.82,100.00
10,016,04,010,0027,0047,512,57,569,903,0,2,0,2,2,0,2,0.00,63.01,100.00
10,016,04,010,0029,0048,199,18,217,453,0,2,0,2,2,0,2,0.00,47.90,100.00
10,016,04,010,0030,0049,229,42,271,374,0,2,0,2,2,0,2,0.00,72.46,100.00
10,016,04,010,0031,0050,648,77,725,1161,0,2,0,2,2,0,2,0.00,62.45,100.00
10,016,04,010,0032,0051,732,90,822,1312,0,2,0,2,2,0,2,0.00,62.65,100.00
10,016,04,010,0033,0052,201,38,239,775,0,2,0,2,2,0,2,0.00,30.84,100.00
10,016,04,010,0034,0053,167,26,193,292,0,2,0,2,2,0,2,0.00,66.10,100.00
10,016,04,010,0026,0000,349,73,422,657,0,2,0,2,2,0,2,0.00,64.23,100.00
10,016,04,010,0027,0000,932,116,1048,1642,0,2,0,2,2,0,2,0.00,63.82,100.00
10,016,04,010,0028,0000,1333,170,1503,2526,0,2,0,2,2,0,2,0.00,59.50,100.00
10,016,04,010,0029,0000,199,18,217,453,0,2,0,2,2,0,2,0.00,47.90,100.00
10,016,04,010,0030,0000,229,42,271,374,0,2,0,2,2,0,2,0.00,72.46,100.00
10,016,04,010,0031,0000,648,77,725,1161,0,2,0,2,2,0,2,0.00,62.45,100.00
10,016,04,010,0032,0000,732,90,822,1312,0,2,0,2,2,0,2,0.00,62.65,100.00
10,016,04,010,0033,0000,201,38,239,775,0,2,0,2,2,0,2,0.00,30.84,100.00
10,016,04,010,0034,0000,167,26,193,292,0,2,0,2,2,0,2,0.00,66.10,100.00
10,016,04,030,0012,0089,682,21,703,1383,0,2,0,2,1,0,1,0.00,50.83,50.00
10,016,04,030,0012,0000,682,21,703,1383,0,2,0,2,1,0,1,0.00,50.83,50.00
10,016,00,050,0000,0000,2995,64,3059,4746,5459,6,4,10,4,2,6,86.94,64.45,60.00
10,016,01,050,0000,0000,1215,21,1236,1989,2230,1,3,4,1,2,3,89.19,62.14,75.00
10,016,02,050,0000,0000,929,24,953,1425,1604,3,0,3,1,0,1,88.84,66.88,33.33
10,016,03,050,0000,0000,851,19,870,1332,1625,2,1,3,2,0,2,81.97,65.32,66.67
10,016,00,060,0000,0000,2023,51,2074,3340,3907,8,2,10,6,1,7,85.49,62.10,70.00
10,016,01,060,0000,0000,547,8,555,818,939,1,2,3,1,1,2,87.11,67.85,66.67
10,016,02,060,0000,0000,594,28,622,1000,1160,3,0,3,2,0,2,86.21,62.20,66.67
10,016,03,060,0000,0000,882,15,897,1522,1808,4,0,4,3,0,3,84.18,58.94,75.00
